datetime,put_orders,put_orders_b,put_orders_s,put_vol,put_vol_b,put_vol_s,put_val,put_val_b,put_val_s,cancel_orders,cancel_orders_b,cancel_orders_s,cancel_vol,cancel_vol_b,cancel_vol_s,cancel_val,cancel_val_b,cancel_val_s,put_vwap_b,put_vwap_s,cancel_vwap_b,cancel_vwap_s
2023-08-18 10:00,648,218,430,19330,5938,13392,22381413.0,6258996.0,16122417.0,153,122,31,4981,3417,1564,5550979.0,3754564.0,1796414.0,105.41,120.39,109.88,114.86
2023-08-18 10:05,392,333,59,7099,4542,2557,7546665.0,4914901.0,2631763.0,282,257,25,3509,2741,768,3790113.0,2942222.0,847890.0,108.21,102.92,107.34,110.4
2023-08-18 10:10,169,89,80,6634,4370,2264,7303116.0,4846606.0,2456509.0,72,29,43,1982,1312,670,2161651.0,1408903.0,752748.0,110.91,108.5,107.39,112.35
2023-08-18 10:15,89,56,33,2267,1298,969,2359350.0,1416401.0,942948.0,36,27,9,1450,1384,66,1568244.0,1494980.0,73263.0,109.12,97.31,108.02,111.01
2023-08-18 10:20,169,118,51,3794,2435,1359,3987341.0,2605891.0,1381450.0,85,76,9,2144,1754,390,2299003.0,1868863.0,430139.0,107.02,101.65,106.55,110.29
2023-08-18 10:25,361,128,233,10136,3007,7129,11001264.0,3255773.0,7745491.0,245,64,181,7682,1956,5726,8421616.0,2097856.0,6323759.0,108.27,108.65,107.25,110.44
2023-08-18 10:30,463,393,70,8842,8035,807,9733924.0,8808013.0,925911.0,252,242,10,7099,6872,227,7712494.0,7460046.0,252447.0,109.62,114.73,108.56,111.21
2023-08-18 10:35,521,502,19,10273,9889,384,11229838.0,10790873.0,438965.0,530,494,36,10439,10363,76,11379584.0,11288641.0,90942.0,109.12,114.31,108.93,119.66
2023-08-18 10:40,335,273,62,4843,3691,1152,5293753.0,4021280.0,1272473.0,274,260,14,4190,3651,539,4569410.0,3976086.0,593323.0,108.95,110.46,108.9,110.08
2023-08-18 10:45,58,38,20,1303,517,786,1483889.0,555930.0,927959.0,21,15,6,393,358,35,421292.0,382533.0,38759.0,107.53,118.06,106.85,110.74
2023-08-18 10:50,94,61,33,2358,1101,1257,2558731.0,1172843.0,1385887.0,45,30,15,1450,793,657,1562813.0,847792.0,715021.0,106.53,110.25,106.91,108.83
2023-08-18 10:55,92,61,31,1335,722,613,1437650.0,780060.0,657589.0,46,29,17,582,457,125,626409.0,489689.0,136720.0,108.04,107.27,107.15,109.38
2023-08-18 11:00,71,61,10,1285,1096,189,1399377.0,1194170.0,205207.0,59,53,6,1107,864,243,1199593.0,932554.0,267038.0,108.96,108.58,107.93,109.89
2023-08-18 11:05,40,33,7,2740,2519,221,2966197.0,2702413.0,263784.0,19,14,5,350,241,109,377722.0,257912.0,119810.0,107.28,119.36,107.02,109.92
2023-08-18 11:10,50,42,8,875,573,302,978267.0,637726.0,340540.0,36,31,5,693,643,50,746726.0,691463.0,55263.0,111.3,112.76,107.54,110.53
2023-08-18 11:15,104,83,21,5018,3566,1452,5320676.0,3722812.0,1597863.0,72,55,17,4038,2749,1289,4261260.0,2837254.0,1424006.0,104.4,110.05,103.21,110.47
2023-08-18 11:20,55,46,9,1054,761,293,1160258.0,837748.0,322509.0,29,22,7,1194,912,282,1296452.0,986345.0,310106.0,110.09,110.07,108.15,109.97
2023-08-18 11:25,223,118,105,5519,2264,3255,5761595.0,2452680.0,3308915.0,159,81,78,3937,1894,2043,4274859.0,2040589.0,2234269.0,108.33,101.66,107.74,109.36
2023-08-18 11:30,359,294,65,12457,6298,6159,13540921.0,6800636.0,6740285.0,313,269,44,11571,5755,5816,12574864.0,6200515.0,6374348.0,107.98,109.44,107.74,109.6
2023-08-18 11:35,82,67,15,1784,1605,179,1925819.0,1734104.0,191715.0,54,46,8,1412,1245,167,1521609.0,1337675.0,183934.0,108.04,107.1,107.44,110.14
2023-08-18 11:40,229,219,10,6544,6337,207,7089659.0,6861796.0,227862.0,208,206,2,5657,5655,2,6134334.0,6132078.0,2255.0,108.28,110.08,108.44,112.78
2023-08-18 11:45,548,531,17,15997,15133,864,17382500.0,16428385.0,954114.0,536,523,13,15405,14849,556,16730852.0,16115771.0,615080.0,108.56,110.43,108.53,110.63
2023-08-18 11:50,576,559,17,16378,15823,555,17804284.0,17190112.0,614171.0,565,554,11,16376,15857,519,17794963.0,17218709.0,576253.0,108.64,110.66,108.59,111.03
2023-08-18 11:55,460,361,99,22625,14865,7760,24656628.0,16088055.0,8568572.0,450,352,98,22513,14595,7918,24479164.0,15742218.0,8736946.0,108.23,110.42,107.86,110.34
2023-08-18 12:00,94,56,38,2110,953,1157,2168263.0,1029393.0,1138869.0,49,27,22,1132,610,522,1221764.0,652611.0,569153.0,108.02,98.43,106.99,109.03
2023-08-18 12:05,50,32,18,1322,711,611,1466075.0,769088.0,696987.0,24,15,9,692,461,231,748517.0,493957.0,254560.0,108.17,114.07,107.15,110.2
2023-08-18 12:10,960,437,523,24941,9203,15738,27407124.0,10032017.0,17375107.0,914,406,508,23960,8408,15552,26328304.0,9160356.0,17167948.0,109.01,110.4,108.95,110.39
2023-08-18 12:15,321,181,140,7521,3818,3703,8296023.0,4179636.0,4116387.0,278,155,123,6502,3220,3282,7153433.0,3525314.0,3628118.0,109.47,111.16,109.48,110.55
2023-08-18 12:20,175,107,68,4513,2801,1712,5048443.0,3152136.0,1896307.0,112,74,38,3087,2369,718,3389623.0,2594831.0,794792.0,112.54,110.77,109.53,110.7
2023-08-18 12:25,465,164,301,13389,4058,9331,14448434.0,4444072.0,10004362.0,341,99,242,10093,2439,7654,11117975.0,2655308.0,8462667.0,109.51,107.22,108.87,110.57
2023-08-18 12:30,228,122,106,6687,4336,2351,7414961.0,4764584.0,2650377.0,138,75,63,4584,3155,1429,5076639.0,3462303.0,1614336.0,109.88,112.73,109.74,112.97
2023-08-18 12:35,278,130,148,7729,2933,4796,8721931.0,3212036.0,5509895.0,174,84,90,3940,2001,1939,4345291.0,2192178.0,2153113.0,109.51,114.89,109.55,111.04
2023-08-18 12:40,362,213,149,9554,4566,4988,11162428.0,5021155.0,6141273.0,265,175,90,5544,3881,1663,6104306.0,4258795.0,1845510.0,109.97,123.12,109.73,110.97
2023-08-18 12:45,168,39,129,5111,1161,3950,5622217.0,1267669.0,4354547.0,139,31,108,4790,1378,3412,5282015.0,1506586.0,3775429.0,109.19,110.24,109.33,110.65
2023-08-18 12:50,98,39,59,1983,1079,904,2168627.0,1179232.0,989394.0,61,19,42,1721,918,803,1884503.0,996673.0,887830.0,109.29,109.45,108.57,110.56
2023-08-18 12:55,153,35,118,4621,641,3980,5094694.0,699508.0,4395186.0,124,24,100,3606,560,3046,3966013.0,609257.0,3356756.0,109.13,110.43,108.8,110.2
2023-08-18 13:00,753,228,525,18936,5345,13591,21014067.0,6097357.0,14916709.0,598,144,454,15442,3263,12179,16957148.0,3536887.0,13420261.0,114.08,109.75,108.39,110.19
2023-08-18 13:05,914,283,631,26861,6220,20641,29676464.0,6809699.0,22866765.0,855,249,606,24719,5824,18895,27288428.0,6356411.0,20932017.0,109.48,110.78,109.14,110.78
2023-08-18 13:10,130,93,37,5112,4145,967,5690203.0,4560586.0,1129617.0,92,74,18,2788,2216,572,3082792.0,2419034.0,663757.0,110.03,116.82,109.16,116.04
2023-08-18 13:15,125,70,55,2828,1414,1414,3126202.0,1539680.0,1586522.0,73,50,23,2004,1314,690,2194866.0,1430221.0,764644.0,108.89,112.2,108.84,110.82
2023-08-18 13:20,263,211,52,7742,6122,1620,8583317.0,6731215.0,1852101.0,230,193,37,6266,5330,936,6891965.0,5854457.0,1037508.0,109.95,114.33,109.84,110.84
2023-08-18 13:25,253,31,222,8905,531,8374,9760235.0,577689.0,9182545.0,212,11,201,7973,382,7591,8789794.0,413094.0,8376699.0,108.79,109.66,108.14,110.35
2023-08-18 13:30,306,34,272,11474,556,10918,12652757.0,616378.0,12036379.0,282,22,260,11269,515,10754,12401045.0,556920.0,11844125.0,110.86,110.24,108.14,110.14
2023-08-18 13:35,12893,12304,589,302289,280270,22019,329283408.0,305337333.0,23946075.0,12799,12243,556,299738,279115,20623,326751350.0,304052783.0,22698567.0,108.94,108.75,108.93,110.06
2023-08-18 13:40,23183,23129,54,534893,533507,1386,582779184.0,581238663.0,1540521.0,23133,23107,26,534915,533376,1539,582920366.0,581057629.0,1862737.0,108.95,111.15,108.94,121.04
2023-08-18 13:45,461,391,70,16193,14464,1729,17693000.0,15822639.0,1870361.0,381,350,31,13966,12948,1018,15300646.0,14160244.0,1140401.0,109.39,108.18,109.36,112.02
2023-08-18 13:50,500,486,14,14892,14495,397,16316099.0,15876545.0,439554.0,487,476,11,14056,13684,372,15398761.0,14987241.0,411520.0,109.53,110.72,109.52,110.62
2023-08-18 13:55,377,343,34,13117,12078,1039,14307802.0,13202854.0,1104948.0,337,319,18,11895,11215,680,13033195.0,12280778.0,752417.0,109.31,106.35,109.5,110.65
2023-08-18 14:00,343,312,31,11147,10422,725,12199874.0,11413515.0,786358.0,323,302,21,11611,10907,704,12708226.0,11930578.0,777647.0,109.51,108.46,109.38,110.46
2023-08-18 14:05,437,425,12,22075,21822,253,24167935.0,23885591.0,282343.0,417,411,6,20362,20237,125,22309929.0,22172382.0,137547.0,109.46,111.6,109.56,110.04
2023-08-18 14:10,1025,1006,19,24278,24253,25,26632308.0,26605984.0,26323.0,1002,992,10,24139,24029,110,26444080.0,26314067.0,130013.0,109.7,105.3,109.51,118.19
2023-08-18 14:15,569,391,178,17350,14291,3059,19016840.0,15657346.0,3359493.0,541,374,167,16630,14055,2575,18226458.0,15392234.0,2834223.0,109.56,109.82,109.51,110.07
2023-08-18 14:20,656,622,34,19341,18996,345,21195312.0,20812544.0,382768.0,637,611,26,19585,19319,266,21461982.0,21164577.0,297405.0,109.56,110.95,109.55,111.81
2023-08-18 14:25,920,619,301,27871,17183,10688,30577152.0,18821262.0,11755889.0,891,602,289,27544,17035,10509,30223802.0,18657184.0,11566618.0,109.53,109.99,109.52,110.06
2023-08-18 14:30,53,35,18,1292,1039,253,1414529.0,1134377.0,280152.0,43,25,18,878,579,299,960630.0,627204.0,333425.0,109.18,110.73,108.33,111.51
2023-08-18 14:35,180,173,7,2623,2490,133,2888187.0,2741404.0,146783.0,171,166,5,2904,2802,102,3163065.0,3050380.0,112685.0,110.1,110.36,108.86,110.48
2023-08-18 14:40,439,423,16,8836,8468,368,9702310.0,9306979.0,395331.0,425,416,9,8584,8335,249,9438269.0,9159137.0,279132.0,109.91,107.43,109.89,112.1
2023-08-18 14:45,283,221,62,8136,6237,1899,9034325.0,6902830.0,2131495.0,226,196,30,6395,5352,1043,7044916.0,5880598.0,1164317.0,110.68,112.24,109.88,111.63
2023-08-18 14:50,238,208,30,6487,5575,912,7152687.0,6142065.0,1010621.0,218,199,19,5990,5175,815,6611385.0,5703573.0,907811.0,110.17,110.81,110.21,111.39
2023-08-18 14:55,292,245,47,7627,6719,908,8441035.0,7432838.0,1008197.0,241,212,29,5423,4912,511,5982940.0,5413842.0,569098.0,110.62,111.03,110.22,111.37
2023-08-18 15:00,304,100,204,6557,2031,4526,7286724.0,2242280.0,5044444.0,257,79,178,5796,1870,3926,6412494.0,2049545.0,4362949.0,110.4,111.45,109.6,111.13
2023-08-18 15:05,673,108,565,21090,1890,19200,23271600.0,2067829.0,21203770.0,596,74,522,19910,1682,18228,22028309.0,1838567.0,20189742.0,109.41,110.44,109.31,110.76
2023-08-18 15:10,144,43,101,4686,1318,3368,5124711.0,1433656.0,3691054.0,112,22,90,3945,766,3179,4377297.0,826409.0,3550887.0,108.78,109.59,107.89,111.7
2023-08-18 15:15,996,542,454,30001,16768,13233,33107367.0,18428529.0,14678838.0,958,516,442,29169,16573,12596,32112238.0,18192959.0,13919279.0,109.9,110.93,109.77,110.51
2023-08-18 15:20,808,799,9,24840,24493,347,27296267.0,26904166.0,392100.0,794,789,5,24122,24018,104,26505633.0,26389760.0,115873.0,109.84,113.0,109.87,111.42
2023-08-18 15:25,479,182,297,11032,5777,5255,12154608.0,6366592.0,5788015.0,420,157,263,10466,5622,4844,11521823.0,6161170.0,5360652.0,110.21,110.14,109.59,110.67
2023-08-18 15:30,917,80,837,20713,3200,17513,22861076.0,3511970.0,19349105.0,895,69,826,20661,3079,17582,22803281.0,3377545.0,19425736.0,109.75,110.48,109.7,110.49
2023-08-18 15:35,430,78,352,7821,4567,3254,8555834.0,4961616.0,3594218.0,417,69,348,6422,3327,3095,7042926.0,3623172.0,3419754.0,108.64,110.46,108.9,110.49
2023-08-18 15:40,486,37,449,10909,655,10254,12041784.0,711871.0,11329913.0,455,19,436,10812,671,10141,11934394.0,727423.0,11206971.0,108.68,110.49,108.41,110.51
2023-08-18 15:45,46,34,12,897,624,273,983319.0,680676.0,302643.0,46,38,8,875,769,106,953825.0,836001.0,117824.0,109.08,110.86,108.71,111.15
2023-08-18 15:50,40,19,21,335,192,143,363943.0,208273.0,155669.0,34,14,20,414,179,235,482508.0,194077.0,288431.0,108.48,108.86,108.42,122.74
2023-08-18 15:55,111,22,89,3110,226,2884,3432465.0,245926.0,3186539.0,110,19,91,3040,221,2819,3355784.0,240169.0,3115614.0,108.82,110.49,108.67,110.52
2023-08-18 16:00,570,41,529,18747,645,18102,20712798.0,703144.0,20009653.0,549,27,522,18606,536,18070,20555890.0,580642.0,19975248.0,109.01,110.54,108.33,110.54
2023-08-18 16:05,267,14,253,11119,295,10824,12367369.0,322368.0,12045001.0,256,8,248,10143,151,9992,11217101.0,163527.0,11053574.0,109.28,111.28,108.3,110.62
2023-08-18 16:10,1247,60,1187,47900,1022,46878,52972598.0,1120116.0,51852481.0,1237,55,1182,47570,818,46752,52600610.0,895807.0,51704802.0,109.6,110.61,109.51,110.59
2023-08-18 16:15,230,29,201,9632,499,9133,10649301.0,559387.0,10089914.0,218,21,197,9363,314,9049,10341930.0,342645.0,9999285.0,112.1,110.48,109.12,110.5
2023-08-18 16:20,230,19,211,11418,468,10950,12584584.0,507873.0,12076711.0,217,14,203,11242,405,10837,12392640.0,438398.0,11954241.0,108.52,110.29,108.25,110.31
2023-08-18 16:25,317,105,212,5871,2499,3372,6457230.0,2752577.0,3704652.0,296,91,205,5711,2365,3346,6268695.0,2584830.0,3683864.0,110.15,109.87,109.3,110.1
2023-08-18 16:30,502,16,486,10383,202,10181,11456308.0,219874.0,11236433.0,492,9,483,9995,190,9805,11002387.0,205855.0,10796532.0,108.85,110.37,108.35,110.11
2023-08-18 16:35,18,11,7,912,214,698,1037144.0,233812.0,803331.0,17,12,5,934,229,705,1086833.0,248237.0,838596.0,109.26,115.09,108.4,118.95
2023-08-18 16:40,167,9,158,5150,170,4980,5660646.0,183138.0,5477507.0,165,9,156,5405,277,5128,6013335.0,299668.0,5713667.0,107.73,109.99,108.18,111.42
2023-08-18 16:45,169,127,42,4144,3028,1116,4562404.0,3333351.0,1229053.0,153,115,38,3839,2899,940,4210079.0,3176135.0,1033943.0,110.08,110.13,109.56,109.99
2023-08-18 16:50,304,289,15,7492,7341,151,8219509.0,8052034.0,167474.0,294,285,9,7333,7260,73,8042339.0,7961881.0,80457.0,109.69,110.91,109.67,110.22
2023-08-18 16:55,31,14,17,1039,655,384,1149137.0,723078.0,426059.0,20,7,13,458,220,238,501222.0,238174.0,263047.0,110.39,110.95,108.26,110.52
2023-08-18 17:00,19,14,5,218,193,25,237544.0,209953.0,27590.0,13,9,4,297,274,23,322855.0,297467.0,25388.0,108.78,110.36,108.56,110.38
2023-08-18 17:05,130,97,33,4477,3185,1292,5055192.0,3624438.0,1430754.0,97,75,22,3750,2588,1162,4123663.0,2834183.0,1289480.0,113.8,110.74,109.51,110.97
2023-08-18 17:10,125,103,22,3600,2627,973,3981921.0,2894502.0,1087419.0,110,99,11,2822,2536,286,3105878.0,2786107.0,319771.0,110.18,111.76,109.86,111.81
2023-08-18 17:15,228,216,12,4881,4506,375,5456397.0,5025496.0,430901.0,213,206,7,4883,4331,552,5457530.0,4769857.0,687673.0,111.53,114.91,110.13,124.58
2023-08-18 17:20,392,155,237,10156,4721,5435,11148639.0,5191413.0,5957226.0,358,138,220,9381,4563,4818,10357951.0,5015560.0,5342391.0,109.96,109.61,109.92,110.88
2023-08-18 17:25,572,29,543,12818,731,12087,14192479.0,804202.0,13388277.0,558,22,536,13222,975,12247,14635581.0,1066875.0,13568706.0,110.01,110.77,109.42,110.79
2023-08-18 17:30,390,42,348,6312,856,5456,7007410.0,942587.0,6064822.0,234,28,206,5784,701,5083,6390331.0,763188.0,5627142.0,110.12,111.16,108.87,110.71
2023-08-18 17:35,582,70,512,14598,670,13928,16159066.0,742206.0,15416860.0,568,61,507,14453,578,13875,15989844.0,631460.0,15358384.0,110.78,110.69,109.25,110.69
2023-08-18 17:40,520,238,282,9864,2093,7771,10912527.0,2312004.0,8600523.0,513,231,282,10011,1991,8020,11065325.0,2183587.0,8881738.0,110.46,110.67,109.67,110.74
2023-08-18 17:45,320,302,18,9954,9407,547,10984143.0,10375497.0,608646.0,294,283,11,9079,8778,301,10008706.0,9673947.0,334758.0,110.3,111.27,110.21,111.22
2023-08-18 17:50,477,455,22,14521,14291,230,16020035.0,15765663.0,254372.0,458,444,14,13803,13621,182,15228863.0,15023778.0,205084.0,110.32,110.6,110.3,112.68
2023-08-18 17:55,124,87,37,4600,3841,759,5070310.0,4256786.0,813524.0,78,68,10,3872,3394,478,4267427.0,3734200.0,533226.0,110.82,107.18,110.02,111.55
2023-08-18 18:00,259,248,11,7748,7657,91,8615546.0,8516303.0,99242.0,246,240,6,7140,6979,161,7893021.0,7710583.0,182438.0,111.22,109.06,110.48,113.32
2023-08-18 18:05,239,223,16,7140,6622,518,7952312.0,7363810.0,588501.0,230,222,8,7016,6642,374,7759019.0,7337356.0,421662.0,111.2,113.61,110.47,112.74
2023-08-18 18:10,189,172,17,5226,5127,99,5763219.0,5652994.0,110225.0,175,165,10,4825,4722,103,5336214.0,5221336.0,114877.0,110.26,111.34,110.57,111.53
2023-08-18 18:15,55,39,16,1721,1210,511,1900986.0,1334069.0,566917.0,35,27,8,1303,1166,137,1436609.0,1283406.0,153203.0,110.25,110.94,110.07,111.83
2023-08-18 18:20,314,307,7,9366,9218,148,10403567.0,10238603.0,164964.0,307,299,8,9616,9085,531,10641708.0,10045499.0,596209.0,111.07,111.46,110.57,112.28
2023-08-18 18:25,547,67,480,11048,1929,9119,12155111.0,2126102.0,10029008.0,528,60,468,10483,1837,8646,11623393.0,2024152.0,9599241.0,110.22,109.98,110.19,111.03
2023-08-18 18:30,493,324,169,9411,4661,4750,10400714.0,5146315.0,5254398.0,456,298,158,9161,4436,4725,10133904.0,4890714.0,5243189.0,110.41,110.62,110.25,110.97
2023-08-18 18:35,394,203,191,11294,5869,5425,12509240.0,6531606.0,5977633.0,365,183,182,10459,5138,5321,11588279.0,5665454.0,5922825.0,111.29,110.19,110.27,111.31
2023-08-21 10:00,2338,1541,797,65663,35513,30150,75051059.0,39056219.0,35994839.0,1713,1375,338,42851,30998,11853,47389325.0,34154324.0,13235001.0,109.98,119.39,110.18,111.66
2023-08-21 10:05,660,432,228,20561,15028,5533,22944930.0,16662641.0,6282289.0,484,350,134,16400,13077,3323,18166107.0,14446425.0,3719681.0,110.88,113.54,110.47,111.94
2023-08-21 10:10,388,264,124,11923,7935,3988,13467451.0,8832256.0,4635195.0,239,208,31,8649,7509,1140,9637892.0,8318651.0,1319240.0,111.31,116.23,110.78,115.72
2023-08-21 10:15,667,556,111,31280,22428,8852,34871161.0,24826915.0,10044246.0,570,512,58,28973,21678,7295,32271396.0,24015491.0,8255905.0,110.7,113.47,110.78,113.17
2023-08-21 10:20,720,434,286,40956,22732,18224,45709618.0,25074343.0,20635275.0,409,290,119,38843,21797,17046,43323850.0,24027340.0,19296510.0,110.3,113.23,110.23,113.2
2023-08-21 10:25,327,178,149,29611,15421,14190,32983690.0,16974936.0,16008754.0,251,149,102,28161,15148,13013,31394313.0,16668282.0,14726031.0,110.08,112.82,110.04,113.16
2023-08-21 10:30,260,105,155,24354,11147,13207,27165955.0,12245825.0,14920129.0,212,79,133,22768,10875,11893,25353199.0,11934524.0,13418675.0,109.86,112.97,109.74,112.83
2023-08-21 10:35,558,307,251,45971,24302,21669,51847377.0,26749003.0,25098374.0,470,265,205,42447,22358,20089,47312932.0,24611793.0,22701139.0,110.07,115.83,110.08,113.0
2023-08-21 10:40,172,105,67,13158,7213,5945,14786395.0,8038010.0,6748385.0,127,79,48,11532,6305,5227,12850911.0,6933277.0,5917633.0,111.44,113.51,109.96,113.21
2023-08-21 10:45,290,180,110,26310,14806,11504,31064192.0,16577012.0,14487179.0,178,119,59,23706,11879,11827,27651388.0,13124012.0,14527375.0,111.96,125.93,110.48,122.83
2023-08-21 10:50,1139,654,485,87364,51586,35778,99645914.0,58235186.0,41410727.0,774,540,234,76363,46133,30230,86958587.0,51607381.0,35351206.0,112.89,115.74,111.87,116.94
2023-08-21 10:55,767,400,367,56463,30212,26251,64660165.0,34170944.0,30489220.0,465,294,171,43713,24299,19414,49884044.0,27357068.0,22526976.0,113.1,116.14,112.59,116.03
2023-08-21 11:00,7785,214,7571,248575,20325,228250,285083147.0,22937245.0,262145901.0,7647,191,7456,242849,19532,223317,278567088.0,21985658.0,256581429.0,112.85,114.85,112.56,114.9
2023-08-21 11:05,233,125,108,18594,10217,8377,21288874.0,11630175.0,9658699.0,142,88,54,14636,8138,6498,16676247.0,9161166.0,7515081.0,113.83,115.3,112.57,115.65
2023-08-21 11:10,479,197,282,42224,19885,22339,47623082.0,22214876.0,25408205.0,354,139,215,35262,17097,18165,39952992.0,19098437.0,20854555.0,111.72,113.74,111.71,114.81
2023-08-21 11:15,428,194,234,36354,18111,18243,41134039.0,20268771.0,20865268.0,321,148,173,34636,18141,16495,39173123.0,20240385.0,18932738.0,111.91,114.37,111.57,114.78
2023-08-21 11:20,389,76,313,20456,6851,13605,23194351.0,7670906.0,15523445.0,344,53,291,19620,6449,13171,22220549.0,7190868.0,15029681.0,111.97,114.1,111.5,114.11
2023-08-21 11:25,189,64,125,10908,4730,6178,12373758.0,5293975.0,7079782.0,146,50,96,10676,5035,5641,12087063.0,5625542.0,6461521.0,111.92,114.6,111.73,114.55
2023-08-21 11:30,421,132,289,30724,11673,19051,34684746.0,13009245.0,21675501.0,359,106,253,29338,11140,18198,33167203.0,12413197.0,20754005.0,111.45,113.78,111.43,114.05
2023-08-21 11:35,1057,124,933,60801,11568,49233,68645753.0,12847764.0,55797989.0,1014,103,911,60510,11807,48703,68349532.0,13107034.0,55242497.0,111.06,113.33,111.01,113.43
2023-08-21 11:40,248,128,120,18087,8533,9554,19965272.0,9450689.0,10514582.0,145,74,71,15599,8008,7591,17503881.0,8860461.0,8643419.0,110.75,110.05,110.65,113.86
2023-08-21 11:45,253,134,119,24654,12025,12629,27736783.0,13319644.0,14417139.0,208,107,101,24875,13269,11606,27839439.0,14637897.0,13201542.0,110.77,114.16,110.32,113.75
2023-08-21 11:50,484,198,286,52257,24698,27559,58626763.0,27327486.0,31299277.0,441,173,268,50799,23933,26866,57018713.0,26477822.0,30540891.0,110.65,113.57,110.63,113.68
2023-08-21 11:55,466,218,248,49784,25536,24248,55886753.0,28305508.0,27581244.0,422,200,222,48124,24157,23967,53970418.0,26731383.0,27239035.0,110.85,113.75,110.66,113.65
2023-08-21 12:00,1599,834,765,106597,56993,49604,120434291.0,63795654.0,56638637.0,1455,754,701,102507,53678,48829,115805359.0,59985806.0,55819553.0,111.94,114.18,111.75,114.32
2023-08-21 12:05,1467,284,1183,74195,22074,52121,83813927.0,24636630.0,59177297.0,1434,272,1162,75063,23129,51934,84784630.0,25795580.0,58989049.0,111.61,113.54,111.53,113.58
2023-08-21 12:10,2171,497,1674,127283,34178,93105,143844363.0,38057778.0,105786585.0,2154,491,1663,127360,34299,93061,143928142.0,38187735.0,105740406.0,111.35,113.62,111.34,113.62
2023-08-21 12:15,1531,133,1398,80890,15200,65690,91400761.0,16886831.0,74513930.0,1498,114,1384,80662,14116,66546,91188443.0,15696357.0,75492086.0,111.1,113.43,111.2,113.44
2023-08-21 12:20,1092,610,482,85485,42267,43218,97098422.0,47555784.0,49542637.0,853,479,374,78497,38886,39611,89011709.0,43586877.0,45424831.0,112.51,114.63,112.09,114.68
2023-08-21 12:25,301,212,89,24285,15776,8509,27549745.0,17749246.0,9800499.0,240,177,63,23942,15128,8814,27141683.0,17002853.0,10138830.0,112.51,115.18,112.39,115.03
2023-08-21 12:30,250,162,88,20495,10583,9912,23311061.0,11909411.0,11401649.0,189,130,59,20417,11882,8535,23161219.0,13310169.0,9851050.0,112.53,115.03,112.02,115.42
2023-08-21 12:35,340,198,142,28258,14987,13271,32098524.0,16820101.0,15278422.0,269,153,116,27213,14444,12769,30920819.0,16204721.0,14716097.0,112.23,115.13,112.19,115.25
2023-08-21 12:40,281,211,70,24632,18062,6570,28065866.0,20462887.0,7602979.0,232,192,40,22393,15848,6545,25508942.0,17922268.0,7586674.0,113.29,115.72,113.09,115.92
2023-08-21 12:45,226,143,83,19169,10609,8560,21836919.0,11973865.0,9863053.0,176,126,50,18018,10714,7304,20510211.0,12062130.0,8448081.0,112.87,115.22,112.58,115.66
2023-08-21 12:50,361,267,94,27943,17798,10145,31955481.0,20234775.0,11720706.0,289,226,63,26279,16455,9824,29912442.0,18551501.0,11360940.0,113.69,115.53,112.74,115.64
2023-08-21 12:55,668,506,162,36135,26457,9678,41098331.0,29976635.0,11121696.0,614,472,142,34836,25477,9359,39634287.0,28853585.0,10780702.0,113.3,114.92,113.25,115.19
2023-08-21 13:00,702,623,79,42379,35026,7353,50165775.0,39959572.0,10206202.0,657,590,67,40036,33569,6467,47216187.0,38016357.0,9199830.0,114.09,138.8,113.25,142.26
2023-08-21 13:05,1023,714,309,79325,45763,33562,90812505.0,52120341.0,38692163.0,717,548,169,67629,40413,27216,77283645.0,45717298.0,31566347.0,113.89,115.29,113.13,115.98
2023-08-21 13:10,548,314,234,44648,22408,22240,51094471.0,25207481.0,25886990.0,389,237,152,42006,21737,20269,47836394.0,24362242.0,23474152.0,112.49,116.4,112.08,115.81
2023-08-21 13:15,323,203,120,28340,14563,13777,32313666.0,16372139.0,15941526.0,239,148,91,25689,13692,11997,29219868.0,15365193.0,13854675.0,112.42,115.71,112.22,115.48
2023-08-21 13:20,217,121,96,21662,10824,10838,24721913.0,12229891.0,12492021.0,159,91,68,19857,10078,9779,22864134.0,11334555.0,11529578.0,112.99,115.26,112.47,117.9
2023-08-21 13:25,319,65,254,17773,4411,13362,20251747.0,4955409.0,15296338.0,299,57,242,17880,4543,13337,20388271.0,5102958.0,15285313.0,112.34,114.48,112.33,114.61
2023-08-21 13:30,859,413,446,73337,36665,36672,83078911.0,41143553.0,41935358.0,671,313,358,70475,34705,35770,79961130.0,38819455.0,41141675.0,112.21,114.35,111.86,115.02
2023-08-21 13:35,495,199,296,40693,17666,23027,46725300.0,19803955.0,26921345.0,450,167,283,39530,17017,22513,45431953.0,19060608.0,26371345.0,112.1,116.91,112.01,117.14
2023-08-21 13:40,185,102,83,15448,8364,7084,17543699.0,9398257.0,8145441.0,146,77,69,14512,7522,6990,16483663.0,8424613.0,8059050.0,112.37,114.98,112.0,115.29
2023-08-21 13:45,117,59,58,11057,5633,5424,12564541.0,6316125.0,6248415.0,104,55,49,12758,6157,6601,14655922.0,6904382.0,7751540.0,112.13,115.2,112.14,117.43
2023-08-21 13:50,431,292,139,46890,26414,20476,53572062.0,29741162.0,23830900.0,384,267,117,44957,26005,18952,51156557.0,29267956.0,21888600.0,112.6,116.38,112.55,115.49
2023-08-21 13:55,381,255,126,34439,20033,14406,39226633.0,22585782.0,16640851.0,352,238,114,34075,19841,14234,38799927.0,22358202.0,16441725.0,112.74,115.51,112.69,115.51
2023-08-21 14:00,126,73,53,11658,6372,5286,13260572.0,7171222.0,6089350.0,100,57,43,11898,5808,6090,13582769.0,6512172.0,7070596.0,112.54,115.2,112.12,116.1
2023-08-21 14:05,507,180,327,39489,18807,20682,45063035.0,21187451.0,23875583.0,459,159,300,37568,18084,19484,42777786.0,20317398.0,22460388.0,112.66,115.44,112.35,115.28
2023-08-21 14:10,4110,165,3945,126430,16949,109481,144142472.0,19014093.0,125128378.0,4069,148,3921,126147,16983,109164,143817288.0,19050005.0,124767283.0,112.18,114.29,112.17,114.29
2023-08-21 14:15,122,54,68,7810,3853,3957,8790336.0,4317237.0,4473099.0,77,32,45,6675,3388,3287,7558026.0,3787056.0,3770969.0,112.05,113.04,111.78,114.72
2023-08-21 14:20,2550,49,2501,107352,4819,102533,121959915.0,5382568.0,116577347.0,2531,40,2491,107249,4753,102496,121848081.0,5309849.0,116538231.0,111.69,113.7,111.72,113.7
2023-08-21 14:25,6448,111,6337,226687,11233,215454,257607440.0,12591396.0,245016044.0,6423,89,6334,227276,11352,215924,258265456.0,12695562.0,245569893.0,112.09,113.72,111.84,113.73
2023-08-21 14:30,76,45,31,7038,3598,3440,8004512.0,4035188.0,3969324.0,54,34,20,6159,3575,2584,6978557.0,4002187.0,2976370.0,112.15,115.39,111.95,115.18
2023-08-21 14:35,87,50,37,6680,3408,3272,7591964.0,3823869.0,3768095.0,58,33,25,7328,3233,4095,8555284.0,3620487.0,4934797.0,112.2,115.16,111.99,120.51
2023-08-21 14:40,912,536,376,34996,13753,21243,39854049.0,15618814.0,24235234.0,897,526,371,35044,13704,21340,39899946.0,15519807.0,24380139.0,113.57,114.09,113.25,114.25
2023-08-21 14:45,61,31,30,4333,2129,2204,4944014.0,2404904.0,2539110.0,41,20,21,4054,2054,2000,4606571.0,2303061.0,2303510.0,112.96,115.2,112.13,115.18
2023-08-21 14:50,72,43,29,5512,2955,2557,6278330.0,3331452.0,2946878.0,66,43,23,5486,2932,2554,6238381.0,3287765.0,2950616.0,112.74,115.25,112.13,115.53
2023-08-21 14:55,255,90,165,25921,11618,14303,29450250.0,13020184.0,16430066.0,231,80,151,25671,11538,14133,29199782.0,12930817.0,16268965.0,112.07,114.87,112.07,115.11
2023-08-21 15:00,252,92,160,24176,10290,13886,27520608.0,11532102.0,15988506.0,233,74,159,24771,10219,14552,28236523.0,11451122.0,16785401.0,112.07,115.14,112.06,115.35
2023-08-21 15:05,621,145,476,51358,18787,32571,58558655.0,21055992.0,37502662.0,589,125,464,48423,18036,30387,55150137.0,20221184.0,34928952.0,112.08,115.14,112.12,114.95
2023-08-21 15:10,195,100,95,20380,9590,10790,23190936.0,10766739.0,12424197.0,174,80,94,19789,8978,10811,22572874.0,10062387.0,12510486.0,112.27,115.15,112.08,115.72
2023-08-21 15:15,58,25,33,5086,2437,2649,5813185.0,2732197.0,3080988.0,50,27,23,5085,2733,2352,5780227.0,3063763.0,2716464.0,112.11,116.31,112.1,115.5
2023-08-21 15:20,339,113,226,36027,15827,20200,40969758.0,17744695.0,23225063.0,313,103,210,36047,16428,19619,40968989.0,18399823.0,22569166.0,112.12,114.98,112.0,115.04
2023-08-21 15:25,119,63,56,9585,4376,5209,10917051.0,4925186.0,5991865.0,96,48,48,8986,3915,5071,10220865.0,4392819.0,5828046.0,112.55,115.03,112.2,114.93
2023-08-21 15:30,169,151,18,4618,3383,1235,5918914.0,3827583.0,2091330.0,158,145,13,4590,3528,1062,5202490.0,3978572.0,1223918.0,113.14,169.34,112.77,115.25
2023-08-21 15:35,741,463,278,33867,14017,19850,38541357.0,15787620.0,22753737.0,703,453,250,31409,14062,17347,35674093.0,15841689.0,19832404.0,112.63,114.63,112.66,114.33
2023-08-21 15:40,871,74,797,50928,7382,43546,57891813.0,8240081.0,49651731.0,841,56,785,50052,6796,43256,56906806.0,7581928.0,49324878.0,111.62,114.02,111.56,114.03
2023-08-21 15:45,793,152,641,57385,16182,41203,65123499.0,18085392.0,47038107.0,734,120,614,56053,15557,40496,63667777.0,17377328.0,46290449.0,111.76,114.16,111.7,114.31
2023-08-21 15:50,514,174,340,45530,17970,27560,51675080.0,20116421.0,31558659.0,479,152,327,45232,17816,27416,51319385.0,19919238.0,31400147.0,111.94,114.51,111.81,114.53
2023-08-21 15:55,217,43,174,14781,3126,11655,16803732.0,3504287.0,13299445.0,205,29,176,15206,2913,12293,17290144.0,3257555.0,14032588.0,112.1,114.11,111.83,114.15
2023-08-21 16:00,749,212,537,62251,17471,44780,70776874.0,19578136.0,51198737.0,730,201,529,62346,17318,45028,70878676.0,19391364.0,51487312.0,112.06,114.33,111.97,114.35
2023-08-21 16:05,1170,442,728,67995,18506,49489,77331156.0,20866459.0,56464696.0,1148,428,720,68124,18688,49436,77478702.0,21066243.0,56412459.0,112.76,114.1,112.73,114.11
2023-08-21 16:10,2417,2088,329,220164,158487,61677,250131464.0,179002576.0,71128888.0,2401,2081,320,219485,158206,61279,249393218.0,178686731.0,70706486.0,112.94,115.32,112.95,115.38
2023-08-21 16:15,711,408,303,68503,34523,33980,77771380.0,38720555.0,39050825.0,676,401,275,67066,34467,32599,76147285.0,38660364.0,37486921.0,112.16,114.92,112.17,114.99
2023-08-21 16:20,509,254,255,40722,18865,21857,45974461.0,21126503.0,24847958.0,437,207,230,38938,18182,20756,44137452.0,20352595.0,23784856.0,111.99,113.68,111.94,114.59
2023-08-21 16:25,113,52,61,9830,5115,4715,11220804.0,5804313.0,5416491.0,93,46,47,9358,4688,4670,10604684.0,5239100.0,5365584.0,113.48,114.88,111.76,114.89
2023-08-21 16:30,139,112,27,8872,6227,2645,10054642.0,7014570.0,3040072.0,130,108,22,8704,6086,2618,9863261.0,6853877.0,3009384.0,112.65,114.94,112.62,114.95
2023-08-21 16:35,159,78,81,15057,6612,8445,17003078.0,7375940.0,9627138.0,140,72,68,14506,6608,7898,16415024.0,7373466.0,9041557.0,111.55,114.0,111.58,114.48
2023-08-21 16:40,145,86,59,11352,5691,5661,12811164.0,6338605.0,6472559.0,115,64,51,11021,5412,5609,12445658.0,6023077.0,6422581.0,111.38,114.34,111.29,114.5
2023-08-21 16:45,494,277,217,37627,18365,19262,42784872.0,20718083.0,22066788.0,395,207,188,33494,16306,17188,37959201.0,18255970.0,19703230.0,112.81,114.56,111.96,114.63
2023-08-21 16:50,285,225,60,23746,15276,8470,27117671.0,17334494.0,9783177.0,204,161,43,21836,13698,8138,24835734.0,15441808.0,9393925.0,113.48,115.5,112.73,115.43
2023-08-21 16:55,833,637,196,63367,43871,19496,72597700.0,50083870.0,22513829.0,675,575,100,57736,41227,16509,65790493.0,46675928.0,19114565.0,114.16,115.48,113.22,115.78
2023-08-21 17:00,553,428,125,38930,25396,13534,44350816.0,28762363.0,15588453.0,497,397,100,38208,24547,13661,43511222.0,27730087.0,15781134.0,113.26,115.18,112.97,115.52
2023-08-21 17:05,761,600,161,56512,37311,19201,64255738.0,42157500.0,22098237.0,685,555,130,51138,35282,15856,58154399.0,39842029.0,18312369.0,112.99,115.09,112.92,115.49
2023-08-21 17:10,331,305,26,10967,7836,3131,12403692.0,8840961.0,3562730.0,305,284,21,11518,8596,2922,13001343.0,9629375.0,3371968.0,112.82,113.79,112.02,115.4
2023-08-21 17:15,43,31,12,1081,588,493,1268903.0,682355.0,586548.0,27,22,5,1121,903,218,1268457.0,1017522.0,250934.0,116.05,118.98,112.68,115.11
2023-08-21 17:20,790,465,325,62193,34884,27309,70295185.0,39243653.0,31051532.0,668,390,278,58494,32863,25631,66354665.0,36863099.0,29491565.0,112.5,113.7,112.17,115.06
2023-08-21 17:25,392,362,30,22471,18631,3840,25501226.0,21076373.0,4424852.0,386,363,23,22554,18632,3922,25594256.0,21071136.0,4523120.0,113.13,115.23,113.09,115.33
2023-08-21 17:30,337,306,31,17659,14551,3108,20031381.0,16453340.0,3578040.0,323,301,22,17439,14393,3046,19778946.0,16268054.0,3510892.0,113.07,115.12,113.03,115.26
2023-08-21 17:35,137,104,33,10266,6480,3786,11682680.0,7297479.0,4385201.0,117,92,25,9824,6327,3497,11157729.0,7121169.0,4036559.0,112.62,115.83,112.55,115.43
2023-08-21 17:40,92,62,30,7480,3935,3545,8491358.0,4423848.0,4067509.0,63,44,19,6582,3582,3000,7481675.0,4026667.0,3455007.0,112.42,114.74,112.41,115.17
2023-08-21 17:45,197,146,51,15245,9064,6181,17331276.0,10190815.0,7140461.0,182,134,48,14983,8796,6187,17033100.0,9886770.0,7146330.0,112.43,115.52,112.4,115.51
2023-08-21 17:50,357,259,98,26306,17285,9021,29912716.0,19493664.0,10419051.0,336,247,89,26046,17169,8877,29609199.0,19360460.0,10248738.0,112.78,115.5,112.76,115.45
2023-08-21 17:55,85,60,25,4991,3118,1873,5647985.0,3511559.0,2136426.0,79,55,24,5275,3071,2204,6035017.0,3462108.0,2572909.0,112.62,114.06,112.74,116.74
2023-08-21 18:00,585,546,39,22266,17253,5013,25320736.0,19541125.0,5779611.0,570,536,34,21944,17043,4901,24919172.0,19264633.0,5654539.0,113.26,115.29,113.04,115.38
2023-08-21 18:05,116,86,30,9014,5452,3562,10259006.0,6149350.0,4109655.0,104,77,27,9141,5477,3664,10402179.0,6168354.0,4233825.0,112.79,115.37,112.62,115.55
2023-08-21 18:10,314,239,75,28556,19037,9519,32533099.0,21523701.0,11009397.0,296,225,71,26123,16452,9671,29747635.0,18565829.0,11181806.0,113.06,115.66,112.85,115.62
2023-08-21 18:15,1073,599,474,84706,47149,37557,96533918.0,53184459.0,43349459.0,1040,583,457,83807,46792,37015,95490315.0,52771230.0,42719085.0,112.8,115.42,112.78,115.41
2023-08-21 18:20,377,310,67,23588,17046,6542,26942986.0,19397230.0,7545755.0,339,292,47,21053,15369,5684,24014172.0,17434145.0,6580026.0,113.79,115.34,113.44,115.76
2023-08-21 18:25,92,61,31,5174,3845,1329,5747022.0,4225081.0,1521941.0,46,34,12,3168,2309,859,3586477.0,2591593.0,994884.0,109.89,114.52,112.24,115.82
2023-08-21 18:30,237,208,29,10613,9425,1188,12201117.0,10845658.0,1355459.0,203,191,12,10349,9699,650,11574798.0,10804837.0,769961.0,115.07,114.1,111.4,118.46
2023-08-21 18:35,186,139,47,8143,6435,1708,9218892.0,7309236.0,1909656.0,154,128,26,6679,5464,1215,7579785.0,6183619.0,1396165.0,113.59,111.81,113.17,114.91
2023-08-22 10:00,1193,613,580,39764,19123,20641,47276491.0,21286037.0,25990454.0,505,427,78,17178,13640,3538,19569997.0,15484986.0,4085011.0,111.31,125.92,113.53,115.46
2023-08-22 10:05,645,422,223,24176,16555,7621,27485291.0,18804009.0,8681282.0,457,326,131,18910,14551,4359,21464857.0,16480575.0,4984282.0,113.59,113.91,113.26,114.34
2023-08-22 10:10,705,241,464,29210,8629,20581,33225350.0,9756220.0,23469130.0,566,170,396,28220,6943,21277,32729469.0,7845926.0,24883542.0,113.06,114.03,113.0,116.95
2023-08-22 10:15,876,247,629,36077,11363,24714,41009749.0,12703876.0,28305873.0,573,93,480,33591,10508,23083,38152653.0,11757196.0,26395456.0,111.8,114.53,111.89,114.35
2023-08-22 10:20,331,121,210,22804,9068,13736,25899232.0,10125872.0,15773360.0,241,74,167,20555,8609,11946,23284272.0,9604167.0,13680104.0,111.67,114.83,111.56,114.52
2023-08-22 10:25,479,123,356,31727,10724,21003,35841268.0,11974297.0,23866970.0,403,79,324,30676,10238,20438,34765537.0,11415608.0,23349928.0,111.66,113.64,111.5,114.25
2023-08-22 10:30,749,91,658,42733,7934,34799,48519871.0,8857828.0,39662042.0,672,56,616,39763,7686,32077,45146731.0,8577059.0,36569671.0,111.64,113.97,111.59,114.01
2023-08-22 10:35,478,122,356,28948,10480,18468,32713011.0,11628428.0,21084582.0,406,68,338,25520,7636,17884,28918677.0,8512130.0,20406547.0,110.96,114.17,111.47,114.11
2023-08-22 10:40,305,97,208,21000,7439,13561,23903732.0,8347225.0,15556507.0,260,73,187,19715,6975,12740,22402421.0,7810530.0,14591891.0,112.21,114.72,111.98,114.54
2023-08-22 10:45,419,99,320,39465,14094,25371,44821150.0,15783791.0,29037359.0,393,83,310,39095,13919,25176,44443746.0,15586485.0,28857260.0,111.99,114.45,111.98,114.62
2023-08-22 10:50,250,167,83,15748,9928,5820,17862092.0,11194147.0,6667945.0,210,144,66,15310,9631,5679,17404319.0,10835859.0,6568460.0,112.75,114.57,112.51,115.66
2023-08-22 10:55,219,132,87,20008,11027,8981,22783522.0,12405695.0,10377827.0,167,107,60,18928,10510,8418,21495257.0,11790711.0,9704546.0,112.5,115.55,112.19,115.28
2023-08-22 11:00,275,73,202,16027,6125,9902,18168826.0,6852362.0,11316464.0,244,56,188,15418,5811,9607,17526773.0,6514741.0,11012031.0,111.88,114.28,112.11,114.63
2023-08-22 11:05,300,222,78,29510,17349,12161,33561203.0,19521288.0,14039915.0,281,217,64,28472,16847,11625,32367057.0,18951090.0,13415967.0,112.52,115.45,112.49,115.41
2023-08-22 11:10,473,393,80,30980,20833,10147,35224702.0,23519626.0,11705075.0,434,366,68,30583,20627,9956,34780874.0,23280382.0,11500492.0,112.9,115.36,112.86,115.51
2023-08-22 11:15,167,113,54,12866,7175,5691,14684043.0,8054828.0,6629215.0,145,104,41,11319,6160,5159,12877185.0,6919375.0,5957810.0,112.26,116.49,112.33,115.48
2023-08-22 11:20,481,169,312,37318,16135,21183,42441539.0,18110916.0,24330622.0,432,145,287,35987,15927,20060,40931221.0,17857815.0,23073405.0,112.25,114.86,112.12,115.02
2023-08-22 11:25,125,71,54,13776,6436,7340,16255195.0,7230864.0,9024330.0,92,52,40,9733,5085,4648,11057187.0,5698204.0,5358982.0,112.35,122.95,112.06,115.3
2023-08-22 11:30,210,152,58,16782,10547,6235,19198762.0,11923336.0,7275425.0,163,122,41,14179,8681,5498,16115796.0,9761567.0,6354229.0,113.05,116.69,112.45,115.57
2023-08-22 11:35,586,383,203,56338,30909,25429,64287809.0,34847235.0,29440574.0,482,330,152,55218,30551,24667,62969379.0,34424343.0,28545036.0,112.74,115.78,112.68,115.72
2023-08-22 11:40,258,149,109,21834,11113,10721,24919310.0,12573931.0,12345378.0,196,122,74,22562,10838,11724,26326292.0,12197619.0,14128673.0,113.15,115.15,112.54,120.51
2023-08-22 11:45,255,125,130,27972,13614,14358,31823146.0,15262870.0,16560275.0,210,100,110,26349,13277,13072,29992902.0,14894053.0,15098848.0,112.11,115.34,112.18,115.51
2023-08-22 11:50,231,70,161,21515,10010,11505,24490589.0,11237930.0,13252658.0,209,61,148,22403,10113,12290,25492478.0,11351334.0,14141144.0,112.27,115.19,112.24,115.06
2023-08-22 11:55,540,282,258,45548,23530,22018,51970418.0,26565101.0,25405316.0,480,252,228,44471,22644,21827,50695742.0,25475146.0,25220596.0,112.9,115.38,112.5,115.55
2023-08-22 12:00,147,66,81,14500,7265,7235,16520715.0,8164531.0,8356184.0,117,53,64,14594,7506,7088,16624453.0,8433202.0,8191251.0,112.38,115.5,112.35,115.57
2023-08-22 12:05,204,67,137,16701,7520,9181,19040678.0,8469592.0,10571086.0,175,57,118,16397,7602,8795,18669163.0,8530359.0,10138803.0,112.63,115.14,112.21,115.28
2023-08-22 12:10,211,63,148,13947,6837,7110,15845710.0,7666392.0,8179318.0,114,50,64,13309,6893,6416,15136503.0,7731765.0,7404737.0,112.13,115.04,112.17,115.41
2023-08-22 12:15,627,64,563,34611,6124,28487,39403498.0,6871106.0,32532391.0,593,41,552,34292,5867,28425,39049171.0,6577328.0,32471843.0,112.2,114.2,112.11,114.24
2023-08-22 12:20,385,70,315,26240,6721,19519,30462366.0,7559016.0,22903350.0,344,47,297,23755,6663,17092,27046654.0,7488085.0,19558568.0,112.47,117.34,112.38,114.43
2023-08-22 12:25,63,35,28,5935,3160,2775,6758554.0,3558454.0,3200100.0,50,25,25,5388,2609,2779,6134849.0,2928705.0,3206144.0,112.61,115.32,112.25,115.37
2023-08-22 12:30,101,40,61,9375,4198,5177,10666836.0,4710459.0,5956377.0,96,50,46,9018,4261,4757,10322433.0,4780155.0,5542277.0,112.21,115.05,112.18,116.51
2023-08-22 12:35,429,53,376,16894,3712,13182,19369491.0,4263521.0,15105970.0,396,31,365,16542,3467,13075,18877792.0,3896994.0,14980797.0,114.86,114.6,112.4,114.58
2023-08-22 12:40,366,84,282,19200,6603,12597,21925550.0,7457370.0,14468179.0,333,68,265,18453,6326,12127,21058977.0,7117286.0,13941691.0,112.94,114.85,112.51,114.96
2023-08-22 12:45,146,67,79,15720,6930,8790,18525625.0,7797775.0,10727850.0,110,59,51,15528,7007,8521,18299718.0,7883064.0,10416654.0,112.52,122.05,112.5,122.25
2023-08-22 12:50,122,59,63,12897,7021,5876,14741374.0,7949421.0,6791952.0,97,48,49,11188,5695,5493,12761734.0,6404478.0,6357256.0,113.22,115.59,112.46,115.73
2023-08-22 12:55,187,82,105,18585,9500,9085,21193948.0,10707905.0,10486043.0,144,69,75,18185,9400,8785,20750960.0,10576237.0,10174723.0,112.71,115.42,112.51,115.82
2023-08-22 13:00,254,129,125,22088,11410,10678,25050959.0,12848193.0,12202766.0,182,105,77,20304,11114,9190,23096796.0,12483166.0,10613630.0,112.6,114.28,112.32,115.49
2023-08-22 13:05,264,87,177,14762,5589,9173,16792238.0,6274610.0,10517628.0,216,66,150,13716,5181,8535,15597058.0,5813531.0,9783527.0,112.27,114.66,112.21,114.63
2023-08-22 13:10,202,148,54,13325,8998,4327,15120635.0,10144040.0,4976595.0,173,140,33,12539,8672,3867,14228885.0,9773414.0,4455471.0,112.74,115.01,112.7,115.22
2023-08-22 13:15,325,225,100,24299,15531,8768,27482149.0,17500467.0,9981682.0,270,202,68,23189,15148,8041,26306169.0,17050275.0,9255894.0,112.68,113.84,112.56,115.11
2023-08-22 13:20,86,44,42,5888,2943,2945,6672543.0,3290845.0,3381698.0,76,39,37,5813,2958,2855,6587860.0,3307981.0,3279879.0,111.82,114.83,111.83,114.88
2023-08-22 13:25,73,37,36,5095,2587,2508,5725925.0,2895237.0,2830688.0,49,28,21,4584,2460,2124,5190630.0,2750550.0,2440080.0,111.91,112.87,111.81,114.88
2023-08-22 13:30,1064,303,761,89619,31002,58617,101857345.0,34762136.0,67095209.0,1042,284,758,89036,30460,58576,101207477.0,34144803.0,67062673.0,112.13,114.46,112.1,114.49
2023-08-22 13:35,808,252,556,64724,23105,41619,73133200.0,25913645.0,47219554.0,770,227,543,62863,22714,40149,71435683.0,25451240.0,45984443.0,112.16,113.46,112.05,114.53
2023-08-22 13:40,637,85,552,34993,8398,26595,39616411.0,9382575.0,30233836.0,599,58,541,34266,8003,26263,38877907.0,8935281.0,29942626.0,111.72,113.68,111.65,114.01
2023-08-22 13:45,626,56,570,30354,4775,25579,34385767.0,5326221.0,29059546.0,591,35,556,29558,4679,24879,33515035.0,5214405.0,28300630.0,111.54,113.61,111.44,113.75
2023-08-22 13:50,962,318,644,59854,23135,36719,67814665.0,25959284.0,41855381.0,895,286,609,58168,22360,35808,65918498.0,25085596.0,40832901.0,112.21,113.99,112.19,114.03
2023-08-22 13:55,734,605,129,49577,33048,16529,56199021.0,37189129.0,19009891.0,672,575,97,48058,32199,15859,54467203.0,36220142.0,18247060.0,112.53,115.01,112.49,115.06
2023-08-22 14:00,103,70,33,8426,4638,3788,9550428.0,5199686.0,4350741.0,100,73,27,8343,4723,3620,9459005.0,5295328.0,4163677.0,112.11,114.86,112.12,115.02
2023-08-22 14:05,118,66,52,11144,5576,5568,12578400.0,6228070.0,6350329.0,86,49,37,10471,5437,5034,11845593.0,6067428.0,5778165.0,111.69,114.05,111.6,114.78
2023-08-22 14:10,69,45,24,3705,2122,1583,4208697.0,2400808.0,1807888.0,47,28,19,3507,1835,1672,3958797.0,2046796.0,1912001.0,113.14,114.21,111.54,114.35
2023-08-22 14:15,82,47,35,7057,3615,3442,7958013.0,4044599.0,3913414.0,62,34,28,6452,3223,3229,7295750.0,3597458.0,3698292.0,111.88,113.7,111.62,114.53
2023-08-22 14:20,101,59,42,8347,4326,4021,9446069.0,4839254.0,4606814.0,76,41,35,7841,3943,3898,8872873.0,4405239.0,4467633.0,111.86,114.57,111.72,114.61
2023-08-22 14:25,99,50,49,9108,4330,4778,10258547.0,4833386.0,5425160.0,79,40,39,8640,4185,4455,9777699.0,4671155.0,5106543.0,111.63,113.54,111.62,114.62
2023-08-22 14:30,70,29,41,5276,2331,2945,5952540.0,2599472.0,3353068.0,53,18,35,5170,2283,2887,5846886.0,2544997.0,3301888.0,111.52,113.86,111.48,114.37
2023-08-22 14:35,162,56,106,12668,4774,7894,14381974.0,5365310.0,9016663.0,138,42,96,12350,4546,7804,13984655.0,5070382.0,8914272.0,112.39,114.22,111.54,114.23
2023-08-22 14:40,66,21,45,4732,1925,2807,5354936.0,2148462.0,3206474.0,57,19,38,7177,1955,5222,8732588.0,2180106.0,6552481.0,111.61,114.23,111.51,125.48
2023-08-22 14:45,581,77,504,35926,6742,29184,40658195.0,7520192.0,33138002.0,544,58,486,35228,6673,28555,39935683.0,7438018.0,32497665.0,111.54,113.55,111.46,113.81
2023-08-22 14:50,170,79,91,12280,5305,6975,13924867.0,5945821.0,7979046.0,137,58,79,11876,5008,6868,13442342.0,5586250.0,7856092.0,112.08,114.39,111.55,114.39
2023-08-22 14:55,227,120,107,24892,12459,12433,28187647.0,13913392.0,14274255.0,202,109,93,24576,12402,12174,27829268.0,13846196.0,13983072.0,111.67,114.81,111.64,114.86
2023-08-22 15:00,101,60,41,7733,4134,3599,8747953.0,4622255.0,4125697.0,93,57,36,7657,4069,3588,8661159.0,4547222.0,4113937.0,111.81,114.63,111.75,114.66
2023-08-22 15:05,83,36,47,5889,2921,2968,6651432.0,3265378.0,3386053.0,65,26,39,5647,2777,2870,6382230.0,3098302.0,3283928.0,111.79,114.09,111.57,114.42
2023-08-22 15:10,34,25,9,8409,7622,787,9480718.0,8580535.0,900183.0,22,16,6,8149,7441,708,9183844.0,8372635.0,811209.0,112.58,114.38,112.52,114.58
2023-08-22 15:15,54,28,26,5630,3033,2597,6342144.0,3392161.0,2949982.0,38,18,20,4958,2559,2399,5604018.0,2854368.0,2749650.0,111.84,113.59,111.54,114.62
2023-08-22 15:20,48,24,24,2152,1127,1025,2424999.0,1259388.0,1165610.0,33,16,17,2217,1197,1020,2504077.0,1337683.0,1166393.0,111.75,113.72,111.75,114.35
2023-08-22 15:25,234,24,210,15022,2867,12155,17014121.0,3203183.0,13810937.0,216,16,200,14753,2795,11958,16715189.0,3123275.0,13591913.0,111.73,113.62,111.75,113.66
2023-08-22 15:30,117,62,55,9071,4584,4487,10235425.0,5129467.0,5105957.0,88,47,41,8492,4395,4097,9596853.0,4904569.0,4692284.0,111.9,113.79,111.59,114.53
2023-08-22 15:35,49,27,22,2008,1023,985,2266804.0,1149139.0,1117665.0,27,15,12,1648,969,679,1854370.0,1078044.0,776326.0,112.33,113.47,111.25,114.33
2023-08-22 15:40,59,35,24,2518,1410,1108,2831510.0,1568491.0,1263018.0,33,19,14,2366,1328,1038,2666151.0,1478344.0,1187806.0,111.24,113.99,111.32,114.43
2023-08-22 15:45,65,37,28,3932,1783,2149,4387749.0,1998769.0,2388979.0,39,21,18,3636,1714,1922,4101893.0,1909598.0,2192295.0,112.1,111.17,111.41,114.06
2023-08-22 15:50,320,26,294,17381,1515,15866,19682550.0,1694061.0,17988489.0,302,12,290,17682,1353,16329,20046398.0,1505119.0,18541278.0,111.82,113.38,111.24,113.55
2023-08-22 15:55,38,21,17,4692,2713,1979,5300583.0,3032990.0,2267593.0,27,14,13,3877,1967,1910,4380533.0,2190336.0,2190196.0,111.79,114.58,111.35,114.67
2023-08-22 16:00,37,23,14,2466,1363,1103,2782526.0,1531315.0,1251210.0,26,13,13,2510,1271,1239,2833736.0,1417347.0,1416389.0,112.35,113.44,111.51,114.32
2023-08-22 16:05,199,179,20,10956,8796,2160,12387876.0,9908503.0,2479372.0,178,162,16,10658,8548,2110,12047723.0,9625362.0,2422360.0,112.65,114.79,112.6,114.8
2023-08-22 16:10,1091,323,768,83583,32173,51410,94367511.0,36050980.0,58316531.0,1045,293,752,80048,29957,50091,90567096.0,33479243.0,57087853.0,112.05,113.43,111.76,113.97
2023-08-22 16:15,65,55,10,2137,1828,309,2411375.0,2059652.0,351723.0,57,51,6,2005,1762,243,2263082.0,1983029.0,280053.0,112.67,113.83,112.54,115.25
2023-08-22 16:20,38,32,6,1881,1075,806,2137178.0,1210172.0,927006.0,31,25,6,1863,1061,802,2108525.0,1186022.0,922502.0,112.57,115.01,111.78,115.03
2023-08-22 16:25,48,31,17,4511,2532,1979,5110588.0,2837385.0,2273203.0,38,26,12,4304,2436,1868,4871221.0,2723706.0,2147515.0,112.06,114.87,111.81,114.96
2023-08-22 16:30,73,43,30,7306,3556,3750,8287137.0,3960690.0,4326446.0,48,28,20,5809,3152,2657,6571203.0,3518068.0,3053135.0,111.38,115.37,111.61,114.91
2023-08-22 16:35,39,20,19,2896,1633,1263,3269246.0,1820384.0,1448862.0,26,14,12,3070,1597,1473,3481636.0,1779514.0,1702122.0,111.47,114.72,111.43,115.55
2023-08-22 16:40,16,9,7,575,340,235,652902.0,379979.0,272923.0,11,7,4,524,306,218,591817.0,341515.0,250301.0,111.76,116.14,111.61,114.82
2023-08-22 16:45,31,19,12,2348,1208,1140,2655947.0,1348259.0,1307687.0,26,18,8,2329,1282,1047,2632293.0,1430773.0,1201520.0,111.61,114.71,111.6,114.76
2023-08-22 16:50,26,18,8,1097,627,470,1240442.0,701346.0,539095.0,16,11,5,1036,609,427,1170894.0,680844.0,490050.0,111.86,114.7,111.8,114.77
2023-08-22 16:55,23,17,6,2175,1165,1010,2462322.0,1302642.0,1159680.0,12,7,5,2066,1066,1000,2336064.0,1188024.0,1148040.0,111.81,114.82,111.45,114.8
2023-08-22 17:00,45,24,21,4736,2459,2277,5380596.0,2770028.0,2610567.0,35,22,13,4423,2394,2029,5001078.0,2670849.0,2330229.0,112.65,114.65,111.56,114.85
2023-08-22 17:05,70,34,36,6278,3312,2966,7091499.0,3688117.0,3403381.0,56,29,27,6021,3097,2924,6811298.0,3453727.0,3357570.0,111.36,114.75,111.52,114.83
2023-08-22 17:10,29,17,12,2024,1126,898,2300284.0,1268396.0,1031888.0,26,14,12,2226,1194,1032,2513696.0,1330379.0,1183316.0,112.65,114.91,111.42,114.66
2023-08-22 17:15,26,19,7,2177,1163,1014,2464954.0,1299452.0,1165501.0,24,17,7,2422,1399,1023,2741547.0,1565642.0,1175905.0,111.73,114.94,111.91,114.95
2023-08-22 17:20,260,154,106,19044,10697,8347,21590462.0,12000253.0,9590208.0,220,139,81,18263,10369,7894,20705082.0,11623331.0,9081751.0,112.18,114.89,112.1,115.05
2023-08-22 17:25,481,405,76,29780,19316,10464,33799407.0,21742163.0,12057244.0,453,388,65,29695,19337,10358,33699922.0,21763089.0,11936833.0,112.56,115.23,112.55,115.24
2023-08-22 17:30,219,199,20,7090,5769,1321,8044332.0,6522734.0,1521597.0,215,200,15,7048,5770,1278,7997785.0,6523319.0,1474466.0,113.07,115.19,113.06,115.37
2023-08-22 17:35,66,43,23,4241,2226,2015,4798043.0,2492299.0,2305744.0,45,29,16,3483,2007,1476,3956089.0,2246456.0,1709633.0,111.96,114.43,111.93,115.83
2023-08-22 17:40,126,64,62,10843,5357,5486,12079637.0,5975702.0,6103935.0,96,55,41,9746,5095,4651,11014502.0,5681244.0,5333258.0,111.55,111.26,111.51,114.67
2023-08-22 17:45,70,39,31,7030,3103,3927,7806548.0,3465906.0,4340641.0,61,29,32,5771,3059,2712,6522686.0,3415996.0,3106689.0,111.7,110.53,111.67,114.55
2023-08-22 17:50,40,18,22,2828,1366,1462,3194822.0,1524429.0,1670393.0,29,14,15,2664,1270,1394,3008095.0,1414168.0,1593926.0,111.6,114.25,111.35,114.34
2023-08-22 17:55,139,85,54,12664,6928,5736,14283035.0,7727226.0,6555808.0,106,66,40,12265,6631,5634,13855079.0,7393283.0,6461795.0,111.54,114.29,111.5,114.69
2023-08-22 18:00,54,31,23,4870,2393,2477,5481432.0,2670016.0,2811415.0,45,23,22,4640,2252,2388,5260112.0,2510727.0,2749385.0,111.58,113.5,111.49,115.13
2023-08-22 18:05,303,237,66,23619,14604,9015,26853621.0,16491014.0,10362607.0,278,223,55,23045,14018,9027,26114788.0,15739488.0,10375300.0,112.92,114.95,112.28,114.94
2023-08-22 18:10,735,663,72,39041,28148,10893,44282318.0,31751705.0,12530613.0,714,653,61,38478,27832,10646,43604881.0,31353974.0,12250906.0,112.8,115.03,112.65,115.08
2023-08-22 18:15,56,39,17,3937,2289,1648,4457302.0,2565040.0,1892261.0,52,35,17,3809,2230,1579,4313564.0,2498261.0,1815302.0,112.06,114.82,112.03,114.97
2023-08-22 18:20,333,118,215,33513,15279,18234,37872416.0,17052545.0,20819871.0,318,111,207,33326,15399,17927,37711144.0,17183349.0,20527795.0,111.61,114.18,111.59,114.51
2023-08-22 18:25,55,37,18,4865,2969,1896,5623462.0,3442860.0,2180602.0,53,34,19,4523,2565,1958,5126271.0,2869633.0,2256637.0,115.96,115.01,111.88,115.25
2023-08-22 18:30,455,131,324,44346,19771,24575,50203970.0,22078116.0,28125854.0,442,124,318,44216,19843,24373,50098801.0,22154785.0,27944015.0,111.67,114.45,111.65,114.65
2023-08-22 18:35,63,39,24,2193,1266,927,2479587.0,1427487.0,1052100.0,51,34,17,1688,1269,419,1903738.0,1427873.0,475865.0,112.76,113.5,112.52,113.57
2023-08-23 10:00,861,411,450,32102,17989,14113,39054050.0,20723624.0,18330426.0,285,271,14,14016,13607,409,15758257.0,15289622.0,468634.0,115.2,129.88,112.37,114.58
2023-08-23 10:05,270,189,81,11748,7371,4377,13591982.0,8202165.0,5389817.0,170,155,15,5404,5239,165,6136565.0,5936230.0,200335.0,111.28,123.14,113.31,121.42
2023-08-23 10:10,163,120,43,5243,3809,1434,5963846.0,4302400.0,1661446.0,100,86,14,4328,3611,717,4808893.0,3985430.0,823462.0,112.95,115.86,110.37,114.85
2023-08-23 10:15,98,58,40,3201,1995,1206,3695230.0,2259603.0,1435626.0,44,28,16,2021,1421,600,2289147.0,1602883.0,686263.0,113.26,119.04,112.8,114.38
2023-08-23 10:20,76,38,38,2588,1205,1383,2949819.0,1358830.0,1590989.0,41,27,14,1528,1030,498,1731703.0,1161788.0,569914.0,112.77,115.04,112.8,114.44
2023-08-23 10:25,76,40,36,2450,849,1601,2798727.0,956147.0,1842580.0,38,25,13,1861,721,1140,2111810.0,812139.0,1299670.0,112.62,115.09,112.64,114.01
2023-08-23 10:30,296,155,141,5187,2589,2598,5904545.0,2895687.0,3008857.0,55,28,27,3604,1782,1822,4094960.0,1998956.0,2096004.0,111.85,115.81,112.17,115.04
2023-08-23 10:35,92,42,50,7367,3583,3784,8434504.0,4024278.0,4410226.0,59,29,30,6389,3257,3132,7267776.0,3654905.0,3612871.0,112.32,116.55,112.22,115.35
2023-08-23 10:40,76,36,40,6183,2570,3613,7073782.0,2905327.0,4168454.0,46,24,22,5194,2340,2854,5916344.0,2624423.0,3291921.0,113.05,115.37,112.15,115.34
2023-08-23 10:45,153,93,60,8062,3613,4449,9278901.0,4067980.0,5210920.0,75,39,36,6157,3361,2796,7002257.0,3772815.0,3229442.0,112.59,117.13,112.25,115.5
2023-08-23 10:50,91,45,46,9546,5074,4472,10883139.0,5722612.0,5160527.0,66,32,34,7678,3813,3865,8738117.0,4283832.0,4454285.0,112.78,115.4,112.35,115.25
2023-08-23 10:55,81,49,32,5872,3178,2694,6635935.0,3564431.0,3071504.0,53,35,18,6501,4180,2321,7320800.0,4642399.0,2678401.0,112.16,114.01,111.06,115.4
2023-08-23 11:00,51,27,24,3734,1598,2136,4303763.0,1839933.0,2463830.0,27,16,11,2615,1286,1329,2974623.0,1443734.0,1530889.0,115.14,115.35,112.27,115.19
2023-08-23 11:05,104,49,55,10411,5119,5292,11860204.0,5738504.0,6121700.0,81,37,44,10003,4862,5141,11392674.0,5454687.0,5937987.0,112.1,115.68,112.19,115.5
2023-08-23 11:10,598,129,469,39291,11771,27520,44638188.0,13254712.0,31383476.0,543,95,448,37688,11107,26581,42868542.0,12461830.0,30406712.0,112.6,114.04,112.2,114.39
2023-08-23 11:15,421,404,17,13474,12599,875,15324343.0,14314216.0,1010127.0,387,378,9,13401,12497,904,15214638.0,14173573.0,1041065.0,113.61,115.44,113.42,115.16
2023-08-23 11:20,313,289,24,11101,9508,1593,12687659.0,10808032.0,1879627.0,283,274,9,9619,8583,1036,10927381.0,9731358.0,1196023.0,113.67,117.99,113.38,115.45
2023-08-23 11:25,352,187,165,16328,7754,8574,18738494.0,8883950.0,9854543.0,328,178,150,14691,6901,7790,16737165.0,7791192.0,8945973.0,114.57,114.94,112.9,114.84
2023-08-23 11:30,121,69,52,9169,4674,4495,10491500.0,5300689.0,5190811.0,74,46,28,7747,4449,3298,8818430.0,5001016.0,3817414.0,113.41,115.48,112.41,115.75
2023-08-23 11:35,334,114,220,23914,9217,14697,26948654.0,10353109.0,16595544.0,279,85,194,21372,8857,12515,24299408.0,9930846.0,14368562.0,112.33,112.92,112.12,114.81
2023-08-23 11:40,901,619,282,82002,50930,31072,94074997.0,58267730.0,35807266.0,647,457,190,68649,40876,27773,78935592.0,46206614.0,32728978.0,114.41,115.24,113.04,117.84
2023-08-23 11:45,417,239,178,38193,21289,16904,43794212.0,24259174.0,19535038.0,297,195,102,35266,19877,15389,40341488.0,22484872.0,17856616.0,113.95,115.56,113.12,116.03
2023-08-23 11:50,408,214,194,30922,15719,15203,35289715.0,17817216.0,17472499.0,285,137,148,26797,13417,13380,30592312.0,15109057.0,15483254.0,113.35,114.93,112.61,115.72
2023-08-23 11:55,739,567,172,39327,25966,13361,45028374.0,29545115.0,15483258.0,649,537,112,38457,26087,12370,43955591.0,29604444.0,14351147.0,113.78,115.88,113.48,116.02
2023-08-23 12:00,271,167,104,23367,13869,9498,26793798.0,15772731.0,11021067.0,213,148,65,20356,12150,8206,23297812.0,13762770.0,9535041.0,113.73,116.04,113.27,116.2
2023-08-23 12:05,171,99,72,15793,6968,8825,18431235.0,8003234.0,10428000.0,114,67,47,11145,5674,5471,12773947.0,6413230.0,6360717.0,114.86,118.16,113.03,116.26
2023-08-23 12:10,245,121,124,17150,9452,7698,19725119.0,10820257.0,8904862.0,147,92,55,14952,8252,6700,17119252.0,9329479.0,7789773.0,114.48,115.68,113.06,116.27
2023-08-23 12:15,165,109,56,11625,6710,4915,13448610.0,7734247.0,5714362.0,114,80,34,11820,6983,4837,13545337.0,7919274.0,5626063.0,115.26,116.26,113.41,116.31
2023-08-23 12:20,372,319,53,20297,16043,4254,23254851.0,18293349.0,4961501.0,329,298,31,22647,15670,6977,26294829.0,17858065.0,8436764.0,114.03,116.63,113.96,120.92
2023-08-23 12:25,176,137,39,9555,6892,2663,10915900.0,7847600.0,3068299.0,146,124,22,8752,6400,2352,10023460.0,7282067.0,2741392.0,113.87,115.22,113.78,116.56
2023-08-23 12:30,152,101,51,11684,7149,4535,13403498.0,8156470.0,5247028.0,124,89,35,10652,6352,4300,12213731.0,7205829.0,5007902.0,114.09,115.7,113.44,116.46
2023-08-23 12:35,1370,1138,232,81348,61313,20035,93653866.0,70316046.0,23337820.0,1119,1000,119,73340,56029,17311,84204740.0,64005549.0,20199191.0,114.68,116.49,114.24,116.68
2023-08-23 12:40,467,270,197,38890,21836,17054,44797461.0,24960630.0,19836831.0,321,208,113,32280,17655,14625,37112840.0,20055532.0,17057308.0,114.31,116.32,113.6,116.63
2023-08-23 12:45,341,223,118,24912,14238,10674,28628835.0,16179513.0,12449322.0,275,198,77,25633,15985,9648,29408377.0,18164668.0,11243708.0,113.64,116.63,113.64,116.54
2023-08-23 12:50,349,194,155,32823,15924,16899,37987190.0,18042032.0,19945158.0,306,179,127,30281,15873,14408,34719951.0,17972361.0,16747589.0,113.3,118.03,113.23,116.24
2023-08-23 12:55,119,68,51,9556,5358,4198,10882040.0,6042461.0,4839579.0,97,57,40,9264,5288,3976,10592730.0,5976493.0,4616237.0,112.77,115.28,113.02,116.1
2023-08-23 13:00,224,120,104,18921,9238,9683,21651077.0,10440028.0,11211049.0,181,92,89,18159,8742,9417,20788176.0,9873416.0,10914759.0,113.01,115.78,112.94,115.9
2023-08-23 13:05,121,73,48,9130,4773,4357,10470901.0,5407465.0,5063435.0,97,66,31,11091,4768,6323,13056419.0,5385498.0,7670921.0,113.29,116.21,112.95,121.32
2023-08-23 13:10,105,73,32,3679,2138,1541,4218908.0,2426885.0,1792022.0,86,66,20,3417,2126,1291,3914917.0,2412666.0,1502251.0,113.51,116.29,113.48,116.36
2023-08-23 13:15,156,78,78,13317,7150,6167,15243213.0,8083983.0,7159230.0,121,65,56,12070,6115,5955,13825035.0,6907226.0,6917808.0,113.06,116.09,112.96,116.17
2023-08-23 13:20,102,53,49,7296,3796,3500,8349549.0,4289281.0,4060267.0,88,49,39,7279,3737,3542,8338304.0,4221380.0,4116924.0,112.99,116.01,112.96,116.23
2023-08-23 13:25,89,42,47,6824,3399,3425,7824892.0,3836522.0,3988369.0,78,39,39,6582,3375,3207,7534640.0,3808681.0,3725958.0,112.87,116.45,112.85,116.18
2023-08-23 13:30,72,30,42,4319,1906,2413,4952853.0,2154398.0,2798455.0,49,20,29,3726,1709,2017,4261027.0,1928020.0,2333006.0,113.03,115.97,112.82,115.67
2023-08-23 13:35,145,48,97,11144,4269,6875,12690793.0,4809486.0,7881307.0,118,39,79,10321,3976,6345,11808614.0,4483698.0,7324916.0,112.66,114.64,112.77,115.44
2023-08-23 13:40,175,74,101,13680,6025,7655,15475655.0,6784290.0,8691365.0,114,49,65,11181,5464,5717,12765076.0,6148763.0,6616313.0,112.6,113.54,112.53,115.73
2023-08-23 13:45,197,113,84,15829,8170,7659,17989241.0,9161592.0,8827649.0,144,81,63,15292,8169,7123,17410673.0,9163989.0,8246684.0,112.14,115.26,112.18,115.78
2023-08-23 13:50,91,56,35,5298,3133,2165,5993885.0,3494896.0,2498988.0,64,34,30,4649,2494,2155,5295611.0,2805679.0,2489931.0,111.55,115.43,112.5,115.54
2023-08-23 13:55,32,14,18,915,364,551,1044541.0,410210.0,634330.0,23,9,14,803,341,462,915740.0,383870.0,531869.0,112.7,115.12,112.57,115.12
2023-08-23 14:00,38,15,23,1761,972,789,2008429.0,1099919.0,908510.0,23,7,16,1229,547,682,1402061.0,615295.0,786766.0,113.16,115.15,112.49,115.36
2023-08-23 14:05,76,37,39,5894,2984,2910,6724595.0,3358404.0,3366191.0,60,28,32,5870,2966,2904,6694581.0,3335659.0,3358922.0,112.55,115.68,112.46,115.67
2023-08-23 14:10,111,54,57,8403,4368,4035,9565105.0,4910698.0,4654406.0,87,46,41,8071,4327,3744,9186793.0,4860296.0,4326496.0,112.42,115.35,112.32,115.56
2023-08-23 14:15,236,64,172,15281,6323,8958,17339346.0,7103460.0,10235885.0,200,44,156,14256,5800,8456,16240084.0,6511954.0,9728129.0,112.34,114.27,112.28,115.04
2023-08-23 14:20,506,219,287,47562,22355,25207,53721166.0,24972568.0,28748597.0,371,161,210,45044,22464,22580,51029964.0,25078532.0,25951432.0,111.71,114.05,111.64,114.93
2023-08-23 14:25,283,158,125,32988,15919,17069,37211696.0,17812460.0,19399235.0,237,130,107,27804,14589,13215,31495847.0,16311734.0,15184112.0,111.89,113.65,111.81,114.9
2023-08-23 14:30,365,283,82,28137,16955,11182,31879118.0,19011633.0,12867484.0,315,248,67,30549,16405,14144,34623734.0,18391145.0,16232589.0,112.13,115.07,112.11,114.77
2023-08-23 14:35,97,62,35,8969,4705,4264,10183140.0,5272160.0,4910979.0,78,52,26,8201,4375,3826,9307211.0,4899303.0,4407907.0,112.05,115.17,111.98,115.21
2023-08-23 14:40,185,146,39,10154,6593,3561,11502904.0,7411794.0,4091110.0,169,142,27,9957,6689,3268,11268070.0,7508105.0,3759965.0,112.42,114.89,112.25,115.05
2023-08-23 14:45,89,60,29,6264,3675,2589,7081080.0,4109829.0,2971251.0,68,47,21,6221,3598,2623,7031057.0,4019766.0,3011290.0,111.83,114.76,111.72,114.8
2023-08-23 14:50,90,60,30,7184,3982,3202,8130119.0,4453322.0,3676797.0,73,48,25,6970,3865,3105,7886578.0,4319593.0,3566985.0,111.84,114.83,111.76,114.88
2023-08-23 14:55,207,61,146,12252,5214,7038,13808418.0,5829792.0,7978625.0,190,52,138,12785,5896,6889,14461887.0,6585082.0,7876805.0,111.81,113.36,111.69,114.34
2023-08-23 15:00,82,38,44,6021,2718,3303,6819740.0,3033984.0,3785756.0,68,27,41,5332,2431,2901,6038238.0,2712163.0,3326075.0,111.63,114.62,111.57,114.65
2023-08-23 15:05,281,60,221,14134,4760,9374,16007797.0,5313019.0,10694778.0,268,51,217,13911,4585,9326,15759679.0,5114025.0,10645654.0,111.62,114.09,111.54,114.15
2023-08-23 15:10,306,91,215,21778,9421,12357,24601085.0,10524817.0,14076268.0,271,72,199,21726,9172,12554,24632844.0,10240723.0,14392120.0,111.72,113.91,111.65,114.64
2023-08-23 15:15,367,280,87,26591,13771,12820,30148119.0,15422416.0,14725703.0,342,264,78,25242,13499,11743,28602126.0,15100282.0,13501843.0,111.99,114.87,111.86,114.98
2023-08-23 15:20,259,155,104,18333,7402,10931,20667590.0,8247869.0,12419721.0,193,119,74,17451,6639,10812,19737059.0,7398733.0,12338326.0,111.43,113.62,111.44,114.12
2023-08-23 15:25,495,236,259,35236,16891,18345,39861758.0,18721885.0,21139872.0,286,147,139,28329,14229,14100,31844978.0,15767898.0,16077080.0,110.84,115.24,110.82,114.02
2023-08-23 15:30,851,588,263,62807,36665,26142,70941621.0,41056172.0,29885448.0,761,534,227,58747,36027,22720,66341323.0,40325772.0,26015551.0,111.98,114.32,111.93,114.51
2023-08-23 15:35,1277,1197,80,69062,57923,11139,77862332.0,65127088.0,12735243.0,1226,1168,58,67672,56862,10810,76293210.0,63924617.0,12368593.0,112.44,114.33,112.42,114.42
2023-08-23 15:40,608,479,129,40654,27808,12846,45794570.0,31151709.0,14642860.0,577,465,112,39589,26900,12689,44636272.0,30135267.0,14501005.0,112.02,113.99,112.03,114.28
2023-08-23 15:45,414,240,174,35010,18730,16280,39437599.0,20867406.0,18570192.0,381,221,160,34259,18322,15937,38600718.0,20415213.0,18185504.0,111.41,114.07,111.42,114.11
2023-08-23 15:50,867,577,290,91041,48183,42858,102983379.0,53711640.0,49271739.0,818,553,265,86082,47908,38174,97099727.0,53412223.0,43687504.0,111.47,114.97,111.49,114.44
2023-08-23 15:55,427,320,107,46139,23683,22456,51999699.0,26413108.0,25586591.0,402,302,100,45034,23647,21387,50779578.0,26368256.0,24411321.0,111.53,113.94,111.51,114.14
2023-08-23 16:00,336,198,138,31066,16230,14836,34998786.0,18064817.0,16933969.0,296,187,109,36022,16844,19178,40582680.0,18721817.0,21860863.0,111.31,114.14,111.15,113.99
2023-08-23 16:05,182,94,88,17616,8624,8992,19672126.0,9564287.0,10107839.0,127,69,58,14732,7583,7149,16581269.0,8397195.0,8184074.0,110.9,112.41,110.74,114.48
2023-08-23 16:10,129,71,58,10900,5728,5172,12240881.0,6366805.0,5874076.0,86,39,47,12006,4985,7021,13874449.0,5520340.0,8354109.0,111.15,113.57,110.74,118.99
2023-08-23 16:15,290,187,103,28189,15176,13013,31711795.0,16897642.0,14814152.0,262,170,92,26204,14159,12045,29483688.0,15754645.0,13729043.0,111.34,113.84,111.27,113.98
2023-08-23 16:20,221,102,119,16637,8360,8277,18579301.0,9297315.0,9281985.0,169,78,91,14278,7124,7154,16048482.0,7903576.0,8144905.0,111.21,112.14,110.94,113.85
2023-08-23 16:25,118,64,54,10147,5514,4633,11431813.0,6135990.0,5295823.0,95,51,44,9720,5243,4477,10949817.0,5830363.0,5119454.0,111.28,114.31,111.2,114.35
2023-08-23 16:30,141,90,51,10490,5774,4716,11698820.0,6434216.0,5264603.0,101,65,36,9358,5496,3862,10522800.0,6107271.0,4415528.0,111.43,111.63,111.12,114.33
2023-08-23 16:35,95,55,40,9394,5038,4356,10599369.0,5618895.0,4980473.0,70,39,31,9020,4698,4322,10159915.0,5217895.0,4942019.0,111.53,114.34,111.07,114.35
2023-08-23 16:40,145,89,56,13355,7202,6153,15061096.0,8024256.0,7036840.0,132,82,50,13169,6914,6255,14829521.0,7676822.0,7152699.0,111.42,114.36,111.03,114.35
2023-08-23 16:45,212,125,87,17181,9421,7760,19435778.0,10484388.0,8951389.0,145,91,54,16814,9235,7579,18952758.0,10275760.0,8676997.0,111.29,115.35,111.27,114.49
2023-08-23 16:50,491,285,206,49245,26806,22439,55516457.0,29823751.0,25692706.0,367,220,147,48710,26473,22237,54918900.0,29451893.0,25467007.0,111.26,114.5,111.25,114.53
2023-08-23 16:55,277,125,152,24887,12164,12723,27686822.0,13482576.0,14204245.0,236,100,136,23716,12024,11692,26647560.0,13324261.0,13323298.0,110.84,111.64,110.81,113.95
2023-08-23 17:00,866,383,483,85589,43729,41860,96093034.0,48403819.0,47689215.0,707,298,409,84529,43158,41371,94910009.0,47772244.0,47137764.0,110.69,113.93,110.69,113.94
2023-08-23 17:05,112,52,60,12097,6468,5629,13579722.0,7175194.0,6404527.0,100,46,54,12094,6603,5491,13583559.0,7318362.0,6265196.0,110.93,113.78,110.83,114.1
2023-08-23 17:10,145,92,53,11456,6305,5151,12891179.0,7015288.0,5875891.0,116,75,41,11266,6109,5157,12667093.0,6784284.0,5882809.0,111.27,114.07,111.05,114.07
2023-08-23 17:15,528,487,41,22132,17982,4150,24891173.0,20149439.0,4741734.0,508,475,33,21890,17769,4121,24620963.0,19909862.0,4711101.0,112.05,114.26,112.05,114.32
2023-08-23 17:20,127,114,13,5201,4144,1057,5848956.0,4641268.0,1207688.0,124,112,12,5130,4074,1056,5768557.0,4561976.0,1206581.0,112.0,114.26,111.98,114.26
2023-08-23 17:25,143,88,55,14876,7625,7251,16763429.0,8473181.0,8290248.0,126,75,51,15119,7379,7740,17039331.0,8197072.0,8842258.0,111.12,114.33,111.09,114.24
2023-08-23 17:30,83,61,22,6340,3597,2743,7133786.0,4005108.0,3128677.0,78,55,23,6432,3564,2868,7254060.0,3967637.0,3286422.0,111.35,114.06,111.33,114.59
2023-08-23 17:35,158,100,58,10366,5823,4543,11746287.0,6484786.0,5261501.0,143,94,49,10095,5815,4280,11393884.0,6471901.0,4921982.0,111.37,115.82,111.3,115.0
2023-08-23 17:40,561,67,494,19919,5754,14165,22411430.0,6386793.0,16024637.0,538,55,483,19251,5285,13966,21666578.0,5860759.0,15805819.0,111.0,113.13,110.89,113.17
2023-08-23 17:45,110,82,28,6754,3759,2995,7610093.0,4206222.0,3403870.0,86,61,25,5596,2827,2769,6300141.0,3149650.0,3150491.0,111.9,113.65,111.41,113.78
2023-08-23 17:50,476,256,220,41676,20348,21328,46674234.0,22634103.0,24040131.0,336,163,173,28961,13867,15094,32388643.0,15327776.0,17060866.0,111.24,112.72,110.53,113.03
2023-08-23 17:55,581,423,158,41369,26571,14798,46527006.0,29676680.0,16850325.0,504,386,118,43710,29333,14377,49089884.0,32716633.0,16373251.0,111.69,113.87,111.54,113.89
2023-08-23 18:00,933,492,441,65771,32804,32967,74279500.0,36702380.0,37577120.0,858,452,406,63875,31708,32167,72116725.0,35454723.0,36662001.0,111.88,113.98,111.82,113.97
2023-08-23 18:05,1244,478,766,92821,39893,52928,105101746.0,44701744.0,60400002.0,1105,405,700,86156,36543,49613,97562920.0,40921350.0,56641569.0,112.05,114.12,111.98,114.17
2023-08-23 18:10,271,158,113,24714,13388,11326,27936779.0,14998441.0,12938338.0,232,134,98,20109,11016,9093,22721535.0,12311334.0,10410200.0,112.03,114.24,111.76,114.49
2023-08-23 18:15,142,57,85,11952,5566,6386,13500570.0,6233783.0,7266787.0,120,45,75,10747,5312,5435,12124006.0,5913696.0,6210310.0,112.0,113.79,111.33,114.27
2023-08-23 18:20,94,48,46,7693,3895,3798,8665228.0,4330966.0,4334261.0,85,44,41,8492,4914,3578,9552901.0,5466280.0,4086621.0,111.19,114.12,111.24,114.22
2023-08-23 18:25,178,152,26,7000,5084,1916,7875594.0,5694771.0,2180822.0,158,133,25,7286,3904,3382,8217663.0,4373410.0,3844253.0,112.01,113.82,112.02,113.67
2023-08-23 18:30,106,76,30,4121,1946,2175,4637623.0,2180696.0,2456927.0,78,59,19,2441,1840,601,2740536.0,2058859.0,681677.0,112.06,112.96,111.89,113.42
2023-08-23 18:35,53,36,17,1668,976,692,1884566.0,1102151.0,782414.0,45,32,13,1436,1092,344,1605314.0,1215610.0,389704.0,112.93,113.07,111.32,113.29
2023-08-24 10:00,1215,356,859,36720,11727,24993,42219156.0,12579664.0,29639492.0,463,137,326,13398,4098,9300,14997146.0,4534625.0,10462520.0,107.27,118.59,110.65,112.5
2023-08-24 10:05,438,370,68,18197,15730,2467,20418330.0,17527523.0,2890807.0,336,320,16,14411,14008,403,16082665.0,15630087.0,452578.0,111.43,117.18,111.58,112.3
2023-08-24 10:10,206,141,65,7715,4964,2751,8702052.0,5521760.0,3180292.0,125,106,19,4942,3272,1670,5522373.0,3639815.0,1882557.0,111.24,115.6,111.24,112.73
2023-08-24 10:15,694,202,492,37396,12705,24691,42118754.0,14092832.0,28025922.0,628,167,461,35405,11871,23534,39787184.0,13162286.0,26624898.0,110.92,113.51,110.88,113.13
2023-08-24 10:20,644,202,442,57356,20559,36797,65614061.0,22830245.0,42783816.0,591,179,412,52702,19684,33018,59309117.0,21832726.0,37476391.0,111.05,116.27,110.92,113.5
2023-08-24 10:25,255,202,53,12126,9170,2956,13598341.0,10216770.0,3381571.0,197,176,21,11186,8705,2481,12526043.0,9697976.0,2828066.0,111.42,114.4,111.41,113.99
2023-08-24 10:30,625,385,240,44601,24869,19732,50075125.0,27797958.0,22277167.0,539,344,195,41446,23448,17998,46463314.0,26079091.0,20384223.0,111.78,112.9,111.22,113.26
2023-08-24 10:35,1867,351,1516,114210,28413,85797,128129917.0,31391620.0,96738296.0,1626,222,1404,112923,27564,85359,126712445.0,30461115.0,96251329.0,110.48,112.75,110.51,112.76
2023-08-24 10:40,436,66,370,29235,6759,22476,32808042.0,7471431.0,25336611.0,419,54,365,28884,6515,22369,32418076.0,7201320.0,25216755.0,110.54,112.73,110.53,112.73
2023-08-24 10:45,42,21,21,3408,2045,1363,3804762.0,2255793.0,1548969.0,33,16,17,3826,1488,2338,4290326.0,1644752.0,2645574.0,110.31,113.64,110.53,113.16
2023-08-24 10:50,50,32,18,2265,1137,1128,2594951.0,1264775.0,1330176.0,30,17,13,2305,1401,904,2575895.0,1547408.0,1028487.0,111.24,117.92,110.45,113.77
2023-08-24 10:55,57,42,15,3695,1725,1970,4222646.0,1951103.0,2271542.0,44,32,12,2854,1602,1252,3204361.0,1777266.0,1427095.0,113.11,115.31,110.94,113.99
2023-08-24 11:00,101,77,24,5535,3094,2441,6252548.0,3447675.0,2804872.0,79,65,14,5053,3053,2000,5662344.0,3391749.0,2270595.0,111.43,114.91,111.1,113.53
2023-08-24 11:05,111,79,32,7880,4093,3787,8827235.0,4533621.0,4293613.0,90,65,25,6762,3901,2861,7581475.0,4326855.0,3254619.0,110.77,113.38,110.92,113.76
2023-08-24 11:10,62,43,19,2838,1946,892,3172252.0,2157501.0,1014751.0,34,23,11,2466,1604,862,2756714.0,1775448.0,981265.0,110.87,113.76,110.69,113.84
2023-08-24 11:15,120,73,47,8252,3845,4407,9245351.0,4258686.0,4986665.0,91,54,37,9906,3746,6160,11117248.0,4146429.0,6970818.0,110.76,113.15,110.69,113.16
2023-08-24 11:20,94,65,29,6418,3714,2704,7139906.0,4119063.0,3020843.0,73,50,23,6117,3398,2719,6853355.0,3762007.0,3091348.0,110.91,111.72,110.71,113.69
2023-08-24 11:25,395,351,44,27540,21616,5924,30889398.0,24149241.0,6740157.0,368,339,29,26121,20719,5402,29273038.0,23118008.0,6155030.0,111.72,113.78,111.58,113.94
2023-08-24 11:30,526,477,49,36113,29254,6859,40450173.0,32655037.0,7795135.0,510,466,44,35710,28725,6985,40038335.0,32084326.0,7954008.0,111.63,113.65,111.69,113.87
2023-08-24 11:35,411,374,37,22948,18883,4065,25714839.0,21087964.0,4626874.0,385,359,26,22054,18290,3764,24716102.0,20430428.0,4285674.0,111.68,113.82,111.7,113.86
2023-08-24 11:40,38,26,12,2264,1317,947,2549943.0,1464585.0,1085357.0,29,20,9,1931,1215,716,2159876.0,1345622.0,814254.0,111.21,114.61,110.75,113.72
2023-08-24 11:45,61,39,22,4611,2589,2022,5185448.0,2882546.0,2302901.0,42,29,13,4545,2908,1637,5083872.0,3217839.0,1866032.0,111.34,113.89,110.65,113.99
2023-08-24 11:50,48,31,17,3028,1519,1509,3401810.0,1680991.0,1720819.0,31,16,15,2732,1379,1353,3064076.0,1527547.0,1536529.0,110.66,114.04,110.77,113.56
2023-08-24 11:55,34,21,13,3326,2057,1269,3720230.0,2277886.0,1442344.0,25,16,9,1896,1046,850,2125893.0,1158190.0,967702.0,110.74,113.66,110.73,113.85
2023-08-24 12:00,89,51,38,7509,5028,2481,8339315.0,5507066.0,2832249.0,70,45,25,5392,3195,2197,6043345.0,3541696.0,2501649.0,109.53,114.16,110.85,113.87
2023-08-24 12:05,307,238,69,28864,18090,10774,32381348.0,20106381.0,12274967.0,290,226,64,28652,17776,10876,32144498.0,19758264.0,12386234.0,111.15,113.93,111.15,113.89
2023-08-24 12:10,295,238,57,26727,16416,10311,30073398.0,18262264.0,11811134.0,280,227,53,25901,16360,9541,29062193.0,18197423.0,10864770.0,111.25,114.55,111.23,113.87
2023-08-24 12:15,69,38,31,4887,2497,2390,5462930.0,2768378.0,2694552.0,50,28,22,4537,2392,2145,5082908.0,2645321.0,2437586.0,110.87,112.74,110.59,113.64
2023-08-24 12:20,40,25,15,1975,1222,753,2203476.0,1348285.0,855190.0,28,17,11,1803,1016,787,2015712.0,1122076.0,893636.0,110.33,113.57,110.44,113.55
2023-08-24 12:25,144,70,74,10950,5097,5853,12242519.0,5641319.0,6601199.0,116,52,64,10271,4724,5547,11516789.0,5224641.0,6292148.0,110.68,112.78,110.6,113.43
2023-08-24 12:30,104,37,67,3876,1193,2683,4390985.0,1345329.0,3045655.0,100,38,62,3616,1125,2491,4055341.0,1245820.0,2809520.0,112.77,113.52,110.74,112.79
2023-08-24 12:35,102,46,56,5332,2308,3024,5976866.0,2552037.0,3424828.0,90,37,53,5319,2334,2985,5959270.0,2579719.0,3379550.0,110.57,113.25,110.53,113.22
2023-08-24 12:40,62,33,29,4423,2257,2166,4957343.0,2494998.0,2462344.0,62,30,32,4495,2251,2244,5042930.0,2488469.0,2554461.0,110.54,113.68,110.55,113.84
2023-08-24 12:45,111,61,50,8838,4036,4802,9893394.0,4459464.0,5433930.0,71,33,38,8416,3943,4473,9425023.0,4354412.0,5070611.0,110.49,113.16,110.43,113.36
2023-08-24 12:50,133,86,47,14751,7876,6875,16539188.0,8718241.0,7820946.0,102,62,40,14259,7482,6777,15984593.0,8275390.0,7709202.0,110.69,113.76,110.6,113.76
2023-08-24 12:55,55,37,18,4941,2703,2238,5542839.0,2994208.0,2548630.0,45,31,14,4836,2612,2224,5424821.0,2892062.0,2532759.0,110.77,113.88,110.72,113.88
2023-08-24 13:00,51,36,15,3936,2308,1628,4406622.0,2553163.0,1853458.0,37,27,10,3761,2155,1606,4216591.0,2387337.0,1829253.0,110.62,113.85,110.78,113.9
2023-08-24 13:05,225,104,121,22227,10479,11748,24883924.0,11581450.0,13302474.0,188,89,99,21310,10414,10896,23880089.0,11506870.0,12373219.0,110.52,113.23,110.49,113.56
2023-08-24 13:10,104,65,39,10153,5779,4374,11345188.0,6400078.0,4945109.0,76,46,30,9717,5243,4474,10877618.0,5796218.0,5081400.0,110.75,113.06,110.55,113.58
2023-08-24 13:15,165,79,86,15660,7316,8344,17526874.0,8107983.0,9418890.0,143,75,68,14541,6932,7609,16309880.0,7676220.0,8633660.0,110.83,112.88,110.74,113.47
2023-08-24 13:20,132,84,48,8808,5094,3714,9839303.0,5647335.0,4191967.0,101,70,31,8406,4860,3546,9417986.0,5384333.0,4033653.0,110.86,112.87,110.79,113.75
2023-08-24 13:25,82,48,34,6293,3409,2884,7046547.0,3770589.0,3275958.0,68,40,28,6237,3407,2830,6987362.0,3767725.0,3219637.0,110.61,113.59,110.59,113.77
2023-08-24 13:30,35,21,14,2353,1286,1067,2637727.0,1422761.0,1214966.0,25,15,10,2831,1280,1551,3202994.0,1414319.0,1788674.0,110.63,113.87,110.49,115.32
2023-08-24 13:35,20,14,6,1723,582,1141,1939442.0,644869.0,1294573.0,14,10,4,1019,569,450,1141774.0,630034.0,511740.0,110.8,113.46,110.73,113.72
2023-08-24 13:40,111,71,40,7596,4085,3511,8495907.0,4526260.0,3969647.0,82,60,22,6938,4080,2858,7772957.0,4519327.0,3253630.0,110.8,113.06,110.77,113.84
2023-08-24 13:45,30,19,11,2203,626,1577,2471788.0,694750.0,1777037.0,19,11,8,1579,595,984,1769605.0,658005.0,1111600.0,110.98,112.68,110.59,112.97
2023-08-24 13:50,123,93,30,7942,4054,3888,8897053.0,4493415.0,4403638.0,105,87,18,8127,3896,4231,9101151.0,4312856.0,4788295.0,110.84,113.26,110.7,113.17
2023-08-24 13:55,89,63,26,7231,3729,3502,8097884.0,4128333.0,3969550.0,60,37,23,6888,3375,3513,7716434.0,3731728.0,3984705.0,110.71,113.35,110.57,113.43
2023-08-24 14:00,43,25,18,3570,1759,1811,4003133.0,1945673.0,2057459.0,40,21,19,3707,1764,1943,4157827.0,1950861.0,2206965.0,110.61,113.61,110.59,113.59
2023-08-24 14:05,59,34,25,4713,2568,2145,5280747.0,2850077.0,2430669.0,43,32,11,4003,2286,1717,4480302.0,2528547.0,1951754.0,110.98,113.32,110.61,113.67
2023-08-24 14:10,44,29,15,4600,2553,2047,5156116.0,2826963.0,2329152.0,41,25,16,4592,2547,2045,5142931.0,2816295.0,2326636.0,110.73,113.78,110.57,113.77
2023-08-24 14:15,59,40,19,6645,3250,3395,7481424.0,3600627.0,3880797.0,51,37,14,5901,3463,2438,6611732.0,3838040.0,2773691.0,110.79,114.31,110.83,113.77
2023-08-24 14:20,75,44,31,6731,3443,3288,7538461.0,3807157.0,3731304.0,57,37,20,6233,3094,3139,6985924.0,3421902.0,3564022.0,110.58,113.48,110.6,113.54
2023-08-24 14:25,135,71,64,17096,6403,10693,19180120.0,7084134.0,12095985.0,97,57,40,11573,6042,5531,12975837.0,6677869.0,6297968.0,110.64,113.12,110.52,113.87
2023-08-24 14:30,34,18,16,3868,1859,2009,4338008.0,2054467.0,2283540.0,29,17,12,3661,1854,1807,4105599.0,2049202.0,2056397.0,110.51,113.67,110.53,113.8
2023-08-24 14:35,81,50,31,6940,3459,3481,7766492.0,3823236.0,3943256.0,57,36,21,6024,3169,2855,6745866.0,3504075.0,3241791.0,110.53,113.28,110.57,113.55
2023-08-24 14:40,251,156,95,26140,15893,10247,29190985.0,17604978.0,11586006.0,191,115,76,31200,14879,16321,34911506.0,16469788.0,18441718.0,110.77,113.07,110.69,112.99
2023-08-24 14:45,1015,526,489,71653,35644,36009,80277628.0,39641576.0,40636051.0,912,469,443,67300,34830,32470,75544222.0,38744392.0,36799830.0,111.22,112.85,111.24,113.33
2023-08-24 14:50,860,133,727,41110,7007,34103,46143022.0,7742991.0,38400030.0,840,119,721,40788,6935,33853,45783328.0,7664708.0,38118619.0,110.5,112.6,110.52,112.6
2023-08-24 14:55,89,56,33,7278,3565,3713,8140465.0,3931589.0,4208876.0,73,47,26,6823,3517,3306,7622308.0,3871382.0,3750926.0,110.28,113.36,110.08,113.46
2023-08-24 15:00,72,41,31,3915,1908,2007,4388541.0,2111620.0,2276921.0,59,29,30,3807,1730,2077,4264563.0,1910723.0,2353839.0,110.67,113.45,110.45,113.33
2023-08-24 15:05,49,33,16,2903,1552,1351,3251908.0,1717585.0,1534323.0,43,28,15,2842,1496,1346,3184258.0,1655426.0,1528831.0,110.67,113.57,110.66,113.58
2023-08-24 15:10,41,28,13,2189,1023,1166,2467755.0,1132305.0,1335450.0,26,18,8,2035,1159,876,2274859.0,1279153.0,995705.0,110.68,114.53,110.37,113.67
2023-08-24 15:15,358,29,329,16660,928,15732,18736318.0,1027819.0,17708499.0,348,19,329,16983,907,16076,19097388.0,1003327.0,18094060.0,110.76,112.56,110.62,112.55
2023-08-24 15:20,382,19,363,17228,388,16840,19383308.0,437366.0,18945941.0,370,10,360,16925,198,16727,19039406.0,219251.0,18820155.0,112.72,112.51,110.73,112.51
2023-08-24 15:25,1017,24,993,46846,747,46099,52684567.0,826964.0,51857603.0,1008,16,992,46775,693,46082,52614366.0,767224.0,51847142.0,110.7,112.49,110.71,112.51
2023-08-24 15:30,309,140,169,25714,10139,15575,28786840.0,11245191.0,17541649.0,240,96,144,18774,8593,10181,20994015.0,9481848.0,11512166.0,110.91,112.63,110.34,113.08
2023-08-24 15:35,99,63,36,6253,3353,2900,7008711.0,3723869.0,3284841.0,72,42,30,11704,4012,7692,13099511.0,4447448.0,8652062.0,111.06,113.27,110.85,112.48
2023-08-24 15:40,47,32,15,2721,1599,1122,3042672.0,1773205.0,1269467.0,38,25,13,2872,1931,941,3200113.0,2133541.0,1066571.0,110.89,113.14,110.49,113.34
2023-08-24 15:45,41,19,22,2714,1360,1354,3037336.0,1499842.0,1537493.0,41,21,20,2906,1411,1495,3252882.0,1556470.0,1696412.0,110.28,113.55,110.31,113.47
2023-08-24 15:50,31,19,12,982,729,253,1095209.0,807747.0,287462.0,18,13,5,761,537,224,847084.0,592543.0,254540.0,110.8,113.62,110.34,113.63
2023-08-24 15:55,39,27,12,3065,1956,1109,3422067.0,2164227.0,1257839.0,29,17,12,2693,1385,1308,3016054.0,1532083.0,1483970.0,110.65,113.42,110.62,113.45
2023-08-24 16:00,34,22,12,1632,986,646,1822945.0,1090382.0,732563.0,23,15,8,1925,1241,684,2146228.0,1368801.0,777427.0,110.59,113.4,110.3,113.66
2023-08-24 16:05,37,25,12,2700,1335,1365,2995891.0,1473616.0,1522275.0,20,11,9,2417,1144,1273,2701536.0,1262197.0,1439338.0,110.38,111.52,110.33,113.07
2023-08-24 16:10,134,39,95,9793,3489,6304,10976410.0,3856754.0,7119656.0,110,23,87,8968,3214,5754,10045106.0,3547182.0,6497924.0,110.54,112.94,110.37,112.93
2023-08-24 16:15,53,23,30,3674,1742,1932,4088228.0,1925040.0,2163188.0,39,16,23,3327,1653,1674,3722242.0,1824150.0,1898092.0,110.51,111.97,110.35,113.39
2023-08-24 16:20,84,23,61,5533,2420,3113,6190365.0,2669257.0,3521107.0,59,22,37,5194,2453,2741,5811435.0,2705351.0,3106084.0,110.3,113.11,110.29,113.32
2023-08-24 16:25,23,11,12,1136,532,604,1272656.0,589888.0,682768.0,33,4,29,1250,481,769,1398707.0,530219.0,868487.0,110.88,113.04,110.23,112.94
2023-08-24 16:30,28,19,9,1736,1104,632,1899810.0,1206983.0,692826.0,13,7,6,1091,600,491,1217243.0,660665.0,556578.0,109.33,109.62,110.11,113.36
2023-08-24 16:35,22,12,10,783,449,334,872827.0,495690.0,377136.0,15,8,7,1666,839,827,1888809.0,926429.0,962379.0,110.4,112.92,110.42,116.37
2023-08-24 16:40,39,22,17,1875,1127,748,2085271.0,1242928.0,842343.0,24,12,12,1893,1134,759,2110251.0,1250539.0,859712.0,110.29,112.61,110.28,113.27
2023-08-24 16:45,16,7,9,737,417,320,820127.0,458617.0,361510.0,11,5,6,573,274,299,639941.0,301876.0,338064.0,109.98,112.97,110.17,113.06
2023-08-24 16:50,16,8,8,584,309,275,646261.0,340871.0,305390.0,10,4,6,555,301,254,619730.0,332052.0,287677.0,110.31,111.05,110.32,113.26
2023-08-24 16:55,63,22,41,2992,1345,1647,3333008.0,1480444.0,1852564.0,38,13,25,2836,1317,1519,3163503.0,1449459.0,1714044.0,110.07,112.48,110.06,112.84
2023-08-24 17:00,16,12,4,313,231,82,346659.0,254398.0,92260.0,13,7,6,370,209,161,411263.0,230341.0,180922.0,110.13,112.51,110.21,112.37
2023-08-24 17:05,25,12,13,1328,682,646,1487131.0,757799.0,729331.0,17,9,8,1327,764,563,1478331.0,842307.0,636023.0,111.11,112.9,110.25,112.97
2023-08-24 17:10,100,50,50,12947,4445,8502,14483922.0,4909352.0,9574569.0,75,32,43,7688,3991,3697,8589515.0,4397021.0,4192493.0,110.45,112.62,110.17,113.4
2023-08-24 17:15,32,21,11,3028,1400,1628,3383786.0,1545120.0,1838665.0,23,14,9,2400,1364,1036,2680242.0,1504766.0,1175475.0,110.37,112.94,110.32,113.46
2023-08-24 17:20,100,73,27,5613,3407,2206,6263850.0,3770631.0,2493219.0,85,60,25,9974,3189,6785,11150928.0,3526084.0,7624844.0,110.67,113.02,110.57,112.38
2023-08-24 17:25,118,88,30,7864,4540,3324,8787598.0,5028470.0,3759128.0,99,77,22,7387,4446,2941,8250393.0,4921996.0,3328397.0,110.76,113.09,110.71,113.17
2023-08-24 17:30,37,22,15,4220,2187,2033,4719486.0,2412114.0,2307372.0,35,20,15,4292,2199,2093,4803502.0,2425702.0,2377799.0,110.29,113.5,110.31,113.61
2023-08-24 17:35,30,16,14,4921,1320,3601,5822896.0,1457280.0,4365616.0,24,16,8,2499,1269,1230,2796039.0,1399847.0,1396192.0,110.4,121.23,110.31,113.51
2023-08-24 17:40,16,12,4,915,511,404,1022574.0,563634.0,458940.0,9,5,4,893,486,407,998005.0,535705.0,462299.0,110.3,113.6,110.23,113.59
2023-08-24 17:45,25,14,11,1912,938,974,2145190.0,1035624.0,1109566.0,22,13,9,2037,1185,852,2275232.0,1307983.0,967248.0,110.41,113.92,110.38,113.53
2023-08-24 17:50,16,11,5,982,564,418,1096769.0,622066.0,474703.0,12,8,4,971,555,416,1083525.0,611504.0,472020.0,110.3,113.57,110.18,113.47
2023-08-24 17:55,29,18,11,1541,814,727,1723651.0,900361.0,823289.0,32,20,12,1721,973,748,1921472.0,1073914.0,847558.0,110.61,113.24,110.37,113.31
2023-08-24 18:00,53,29,24,9939,2093,7846,11192087.0,2314223.0,8877864.0,42,28,14,3814,2079,1735,4265769.0,2296909.0,1968860.0,110.57,113.15,110.48,113.48
2023-08-24 18:05,59,46,13,3102,1778,1324,3468880.0,1966557.0,1502323.0,54,41,13,5126,1769,3357,5750501.0,1955792.0,3794709.0,110.61,113.47,110.56,113.04
2023-08-24 18:10,263,226,37,13269,10028,3241,14816529.0,11145901.0,3670628.0,246,217,29,13058,9903,3155,14583122.0,11005406.0,3577716.0,111.15,113.26,111.13,113.4
2023-08-24 18:15,21,13,8,689,301,388,770477.0,332048.0,438429.0,16,10,6,548,291,257,613032.0,320851.0,292181.0,110.32,113.0,110.26,113.69
2023-08-24 18:20,18,14,4,368,322,46,406401.0,354820.0,51580.0,19,15,4,231,215,16,255723.0,237529.0,18194.0,110.19,112.13,110.48,113.71
2023-08-24 18:25,14,11,3,280,268,12,317853.0,304342.0,13511.0,10,6,4,571,364,207,635633.0,400122.0,235511.0,113.56,112.59,109.92,113.77
2023-08-24 18:30,33,24,9,901,723,178,994061.0,808937.0,185124.0,20,15,5,482,390,92,535581.0,432091.0,103489.0,111.89,104.0,110.79,112.49
2023-08-24 18:35,93,78,15,3540,1987,1553,3988606.0,2250870.0,1737736.0,88,78,10,1443,1335,108,1608111.0,1486637.0,121473.0,113.28,111.9,111.36,112.48
2023-08-25 10:00,1109,503,606,38010,18047,19963,45045295.0,19673330.0,25371965.0,529,382,147,19705,13677,6028,22004734.0,15206558.0,6798176.0,109.01,127.09,111.18,112.78
2023-08-25 10:05,325,202,123,11435,8663,2772,12775900.0,9604912.0,3170988.0,208,141,67,9114,7244,1870,10124746.0,8033177.0,2091569.0,110.87,114.39,110.89,111.85
2023-08-25 10:10,177,120,57,4576,3525,1051,5124980.0,3917255.0,1207725.0,105,74,31,3103,2655,448,3454628.0,2946176.0,508451.0,111.13,114.91,110.97,113.49
2023-08-25 10:15,148,82,66,10398,4773,5625,11865094.0,5272936.0,6592158.0,76,45,31,7239,4184,3055,8069508.0,4605654.0,3463853.0,110.47,117.19,110.08,113.38
2023-08-25 10:20,331,171,160,11355,5105,6250,12789338.0,5620057.0,7169280.0,83,52,31,8474,4726,3748,9440461.0,5197359.0,4243102.0,110.09,114.71,109.97,113.21
2023-08-25 10:25,1008,573,435,73407,36748,36659,81484831.0,40717833.0,40766998.0,561,275,286,52215,27194,25021,57641065.0,29665993.0,27975072.0,110.8,111.21,109.09,111.81
2023-08-25 10:30,807,454,353,70791,35594,35197,79146934.0,39599753.0,39547180.0,508,244,264,60767,27118,33649,67718912.0,30230949.0,37487962.0,111.25,112.36,111.48,111.41
2023-08-25 10:35,963,600,363,74005,41695,32310,83112122.0,46704655.0,36407466.0,609,343,266,60601,34429,26172,67703745.0,38279189.0,29424555.0,112.02,112.68,111.18,112.43
2023-08-25 10:40,265,169,96,19236,11249,7987,21204696.0,12277819.0,8926877.0,152,91,61,17931,11310,6621,20174518.0,12764532.0,7409986.0,109.15,111.77,112.86,111.92
2023-08-25 10:45,280,152,128,19827,10493,9334,21929382.0,11481260.0,10448122.0,179,97,82,19240,10366,8874,21251530.0,11305725.0,9945805.0,109.42,111.94,109.07,112.08
2023-08-25 10:50,238,130,108,18342,9949,8393,20262553.0,10879754.0,9382798.0,160,87,73,17212,9499,7713,18997856.0,10354743.0,8643112.0,109.36,111.79,109.01,112.06
2023-08-25 10:55,221,119,102,16297,8936,7361,18060823.0,9802068.0,8258755.0,143,77,66,14767,7948,6819,16326270.0,8672577.0,7653692.0,109.69,112.2,109.12,112.24
2023-08-25 11:00,177,96,81,14370,7923,6447,15941763.0,8727958.0,7213804.0,122,66,56,13409,7303,6106,14838141.0,7975076.0,6863065.0,110.16,111.89,109.2,112.4
2023-08-25 11:05,184,99,85,13631,7482,6149,15128983.0,8215170.0,6913812.0,156,96,60,13658,7754,5904,15104879.0,8467446.0,6637432.0,109.8,112.44,109.2,112.42
2023-08-25 11:10,105,50,55,7554,3546,4008,8393523.0,3895561.0,4497962.0,54,26,28,5960,3086,2874,6603159.0,3371874.0,3231285.0,109.86,112.22,109.26,112.43
2023-08-25 11:15,216,170,46,10181,6414,3767,11263843.0,7015330.0,4248513.0,190,154,36,9564,5979,3585,10595480.0,6564410.0,4031069.0,109.38,112.78,109.79,112.44
2023-08-25 11:20,125,67,58,8685,4375,4310,9593547.0,4782826.0,4810721.0,106,57,49,8515,4351,4164,9426756.0,4751078.0,4675678.0,109.32,111.62,109.2,112.29
2023-08-25 11:25,97,45,52,9487,5799,3688,10450918.0,6282848.0,4168069.0,59,26,33,6679,3499,3180,7383913.0,3812449.0,3571463.0,108.34,113.02,108.96,112.31
2023-08-25 11:30,140,69,71,10944,5557,5387,12090681.0,6062529.0,6028152.0,106,51,55,10636,5424,5212,11759767.0,5911823.0,5847944.0,109.1,111.9,108.99,112.2
2023-08-25 11:35,216,140,76,12583,6393,6190,13965966.0,7031495.0,6934470.0,110,60,50,10576,5607,4969,11710070.0,6127672.0,5582397.0,109.99,112.03,109.29,112.34
2023-08-25 11:40,144,96,48,9782,5185,4597,10863079.0,5686604.0,5176475.0,97,56,41,9464,4902,4562,10484251.0,5356666.0,5127585.0,109.67,112.61,109.28,112.4
2023-08-25 11:45,86,60,26,5509,3552,1957,6123797.0,3927719.0,2196077.0,56,40,16,4927,3161,1766,5436750.0,3450922.0,1985827.0,110.58,112.22,109.17,112.45
2023-08-25 11:50,155,69,86,11830,5908,5922,13114355.0,6466949.0,6647406.0,130,55,75,11804,5941,5863,13074084.0,6489693.0,6584391.0,109.46,112.25,109.24,112.3
2023-08-25 11:55,168,87,81,13549,6683,6866,14973589.0,7300296.0,7673293.0,137,67,70,13213,6605,6608,14631197.0,7214446.0,7416751.0,109.24,111.76,109.23,112.24
2023-08-25 12:00,121,80,41,6091,3614,2477,6654025.0,3894072.0,2759952.0,90,56,34,5635,3288,2347,6205034.0,3572610.0,2632424.0,107.75,111.42,108.66,112.16
2023-08-25 12:05,162,100,62,10415,5817,4598,11555043.0,6415255.0,5139787.0,116,77,39,9862,5594,4268,10918514.0,6121003.0,4797511.0,110.28,111.78,109.42,112.41
2023-08-25 12:10,108,59,49,9360,5731,3629,10263862.0,6241631.0,4022230.0,85,45,40,7006,3589,3417,7760561.0,3923731.0,3836829.0,108.91,110.84,109.33,112.29
2023-08-25 12:15,203,56,147,15520,6497,9023,17164072.0,7086373.0,10077699.0,186,52,134,15337,6340,8997,16977875.0,6915707.0,10062167.0,109.07,111.69,109.08,111.84
2023-08-25 12:20,113,42,71,7507,3350,4157,8354909.0,3656952.0,4697956.0,102,28,74,7423,2911,4512,8243668.0,3168148.0,5075520.0,109.16,113.01,108.83,112.49
2023-08-25 12:25,274,82,192,20572,7731,12841,22757637.0,8445405.0,14312231.0,251,69,182,20193,7573,12620,22366512.0,8271385.0,14095126.0,109.24,111.46,109.22,111.69
2023-08-25 12:30,164,118,46,9905,6001,3904,11107471.0,6717248.0,4390222.0,130,99,31,8861,5167,3694,9818849.0,5661830.0,4157019.0,111.94,112.45,109.58,112.53
2023-08-25 12:35,72,53,19,4518,2686,1832,5004311.0,2942042.0,2062269.0,65,47,18,4260,2503,1757,4708312.0,2733772.0,1974540.0,109.53,112.57,109.22,112.38
2023-08-25 12:40,102,64,38,6394,3704,2690,7071462.0,4052802.0,3018659.0,80,50,30,6027,3494,2533,6664782.0,3819037.0,2845744.0,109.42,112.22,109.3,112.35
2023-08-25 12:45,102,66,36,7167,3616,3551,7948731.0,3956844.0,3991886.0,70,45,25,6802,3559,3243,7541900.0,3890159.0,3651741.0,109.43,112.42,109.3,112.6
2023-08-25 12:50,50,32,18,3776,1962,1814,4184831.0,2142605.0,2042225.0,32,19,13,3940,2295,1645,4358379.0,2508478.0,1849900.0,109.21,112.58,109.3,112.46
2023-08-25 12:55,76,39,37,6729,3279,3450,7466527.0,3588323.0,3878203.0,61,30,31,8209,4892,3317,9067787.0,5334790.0,3732997.0,109.43,112.41,109.05,112.54
2023-08-25 13:00,107,60,47,8199,4178,4021,9087208.0,4570148.0,4517060.0,77,40,37,7659,3870,3789,8504694.0,4226615.0,4278079.0,109.39,112.34,109.21,112.91
2023-08-25 13:05,74,48,26,5571,2918,2653,6175080.0,3192876.0,2982204.0,53,35,18,5347,2841,2506,5925088.0,3105791.0,2819296.0,109.42,112.41,109.32,112.5
2023-08-25 13:10,33,21,12,2705,1491,1214,3000587.0,1634430.0,1366157.0,23,13,10,2742,1439,1303,3040207.0,1571829.0,1468378.0,109.62,112.53,109.23,112.69
2023-08-25 13:15,44,23,21,3035,1413,1622,3364289.0,1544949.0,1819339.0,32,13,19,2898,1375,1523,3212051.0,1502533.0,1709518.0,109.34,112.17,109.28,112.25
2023-08-25 13:20,87,54,33,5925,3153,2772,6617214.0,3491767.0,3125446.0,56,30,26,5317,2784,2533,5883961.0,3038553.0,2845407.0,110.74,112.75,109.14,112.33
2023-08-25 13:25,75,50,25,4475,2514,1961,5000738.0,2796860.0,2203878.0,46,29,17,4266,2348,1918,4726565.0,2568221.0,2158343.0,111.25,112.39,109.38,112.53
2023-08-25 13:30,70,50,20,3984,2196,1788,4420128.0,2408643.0,2011485.0,42,26,16,3957,2153,1804,4383745.0,2354245.0,2029499.0,109.68,112.5,109.35,112.5
2023-08-25 13:35,137,90,47,11024,6045,4979,12263988.0,6659430.0,5604558.0,98,62,36,10904,5971,4933,12097585.0,6535022.0,5562562.0,110.16,112.56,109.45,112.76
2023-08-25 13:40,132,72,60,13409,6926,6483,14916285.0,7583684.0,7332600.0,94,56,38,13464,7108,6356,14960972.0,7760603.0,7200369.0,109.5,113.11,109.18,113.28
2023-08-25 13:45,112,76,36,8772,4874,3898,9729414.0,5342935.0,4386478.0,96,70,26,8638,4821,3817,9584705.0,5282134.0,4302571.0,109.62,112.53,109.57,112.72
2023-08-25 13:50,42,28,14,1722,1048,674,1911498.0,1152981.0,758517.0,29,15,14,1649,981,668,1826136.0,1074124.0,752012.0,110.02,112.54,109.49,112.58
2023-08-25 13:55,129,91,38,9657,5247,4410,10717363.0,5759059.0,4958303.0,98,69,29,9210,5049,4161,10228273.0,5536775.0,4691498.0,109.76,112.43,109.66,112.75
2023-08-25 14:00,130,89,41,12996,6826,6170,14466404.0,7499186.0,6967218.0,115,77,38,12853,6686,6167,14317900.0,7340042.0,6977857.0,109.86,112.92,109.78,113.15
2023-08-25 14:05,70,49,21,5483,2928,2555,6157937.0,3211293.0,2946644.0,47,35,12,5233,3378,1855,5800961.0,3707171.0,2093790.0,109.68,115.33,109.74,112.87
2023-08-25 14:10,85,54,31,8416,4492,3924,9337342.0,4925653.0,4411689.0,71,49,22,8795,4992,3803,9760134.0,5469247.0,4290886.0,109.65,112.43,109.56,112.83
2023-08-25 14:15,104,68,36,11209,5972,5237,12461349.0,6554350.0,5906998.0,89,57,32,11119,5899,5220,12360753.0,6468688.0,5892065.0,109.75,112.79,109.66,112.87
2023-08-25 14:20,78,57,21,6156,3419,2737,6841060.0,3753939.0,3087121.0,58,40,18,5866,3063,2803,6523401.0,3359352.0,3164049.0,109.8,112.79,109.68,112.88
2023-08-25 14:25,71,59,12,4428,2924,1504,4936713.0,3238259.0,1698454.0,51,41,10,3871,2467,1404,4295887.0,2710374.0,1585513.0,110.75,112.93,109.87,112.93
2023-08-25 14:30,76,54,22,3582,2294,1288,3989964.0,2533306.0,1456658.0,43,28,15,3162,1951,1211,3511538.0,2141767.0,1369771.0,110.43,113.09,109.78,113.11
2023-08-25 14:35,334,287,47,19795,13768,6027,22018054.0,15227057.0,6790997.0,299,265,34,19170,13465,5705,21344776.0,14885547.0,6459229.0,110.6,112.68,110.55,113.22
2023-08-25 14:40,260,236,24,12783,10024,2759,14260381.0,11131322.0,3129059.0,230,213,17,12338,9717,2621,13758963.0,10784036.0,2974927.0,111.05,113.41,110.98,113.5
2023-08-25 14:45,192,138,54,11742,7146,4596,13043623.0,7906890.0,5136732.0,156,130,26,11076,7194,3882,12359450.0,7954397.0,4405052.0,110.65,111.77,110.57,113.47
2023-08-25 14:50,172,137,35,9339,5968,3371,10423359.0,6603817.0,3819542.0,138,114,24,8819,5639,3180,9834718.0,6229052.0,3605666.0,110.65,113.31,110.46,113.39
2023-08-25 14:55,315,231,84,27732,16063,11669,30968162.0,17754276.0,13213886.0,274,209,65,27113,16020,11093,30253211.0,17683603.0,12569607.0,110.53,113.24,110.38,113.31
2023-08-25 15:00,180,134,46,13651,7830,5821,15230591.0,8638965.0,6591626.0,149,114,35,14235,8427,5808,15863872.0,9284833.0,6579039.0,110.33,113.24,110.18,113.28
2023-08-25 15:05,357,280,77,23859,14130,9729,26575757.0,15593053.0,10982704.0,306,248,58,23406,13877,9529,26106359.0,15310486.0,10795872.0,110.35,112.89,110.33,113.29
2023-08-25 15:10,331,198,133,27631,14630,13001,30741044.0,16113445.0,14627598.0,276,172,104,26780,14386,12394,29861843.0,15843005.0,14018838.0,110.14,112.51,110.13,113.11
2023-08-25 15:15,190,109,81,18939,10088,8851,21103370.0,11104868.0,9998502.0,160,88,72,17843,9021,8822,19872132.0,9909015.0,9963116.0,110.08,112.96,109.84,112.93
2023-08-25 15:20,920,154,766,57258,15205,42053,63533005.0,16667991.0,46865013.0,838,99,739,55969,14804,41165,62266898.0,16225913.0,46040985.0,109.62,111.44,109.6,111.84
2023-08-25 15:25,571,131,440,47136,17958,29178,52355332.0,19678730.0,32676602.0,529,107,422,46146,17378,28768,51304861.0,19036516.0,32268344.0,109.58,111.99,109.54,112.17
2023-08-25 15:30,297,79,218,22206,8329,13877,24749075.0,9128226.0,15620849.0,273,63,210,21054,7867,13187,23430218.0,8616131.0,14814087.0,109.6,112.57,109.52,112.34
2023-08-25 15:35,149,60,89,11381,5415,5966,12662141.0,5947297.0,6714844.0,128,43,85,11085,5228,5857,12327879.0,5738001.0,6589878.0,109.83,112.55,109.76,112.51
2023-08-25 15:40,126,37,89,7691,3178,4513,8603721.0,3486031.0,5117689.0,108,24,84,7458,3095,4363,8323947.0,3392944.0,4931003.0,109.69,113.4,109.63,113.02
2023-08-25 15:45,135,45,90,11230,5048,6182,12497170.0,5537628.0,6959542.0,114,33,81,11128,4947,6181,12384302.0,5425388.0,6958914.0,109.7,112.58,109.67,112.59
2023-08-25 15:50,70,38,32,5566,2937,2629,6191798.0,3222235.0,2969563.0,51,22,29,5601,2973,2628,6227874.0,3258605.0,2969269.0,109.71,112.95,109.61,112.99
2023-08-25 15:55,101,52,49,8098,4317,3781,9000453.0,4736103.0,4264350.0,84,41,43,8381,4429,3952,9315668.0,4857242.0,4458425.0,109.71,112.78,109.67,112.81
2023-08-25 16:00,83,51,32,6318,3175,3143,7059066.0,3484756.0,3574310.0,55,30,25,6559,3081,3478,7358745.0,3378979.0,3979765.0,109.76,113.72,109.67,114.43
2023-08-25 16:05,205,94,111,18998,9256,9742,20995364.0,10148426.0,10846938.0,163,73,90,18208,9031,9177,20242514.0,9898625.0,10343889.0,109.64,111.34,109.61,112.72
2023-08-25 16:10,92,71,21,4762,3070,1692,5290124.0,3383380.0,1906743.0,63,46,17,4598,2909,1689,5103746.0,3197514.0,1906232.0,110.21,112.69,109.92,112.86
2023-08-25 16:15,192,113,79,17169,8848,8321,19074956.0,9708921.0,9366035.0,152,89,63,16721,8572,8149,18589745.0,9398194.0,9191550.0,109.73,112.56,109.64,112.79
2023-08-25 16:20,97,64,33,8772,4401,4371,9805802.0,4846253.0,4959549.0,78,49,29,8030,4244,3786,8928951.0,4657487.0,4271464.0,110.12,113.46,109.74,112.82
2023-08-25 16:25,175,125,50,13356,7723,5633,14867542.0,8505148.0,6362394.0,159,110,49,13263,7625,5638,14766028.0,8395403.0,6370625.0,110.13,112.95,110.1,112.99
2023-08-25 16:30,211,140,71,14476,8114,6362,16105269.0,8925042.0,7180226.0,169,118,51,14123,8002,6121,15715893.0,8799893.0,6916000.0,110.0,112.86,109.97,112.99
2023-08-25 16:35,88,59,29,4256,2406,1850,4725534.0,2641640.0,2083894.0,70,44,26,4469,2355,2114,4979893.0,2584241.0,2395652.0,109.79,112.64,109.73,113.32
2023-08-25 16:40,113,64,49,6856,3920,2936,7626193.0,4312911.0,3313282.0,94,48,46,6794,3888,2906,7552158.0,4272741.0,3279417.0,110.02,112.85,109.9,112.85
2023-08-25 16:45,431,179,252,30072,13422,16650,33471850.0,14776987.0,18694863.0,367,138,229,28987,13103,15884,32291643.0,14405010.0,17886632.0,110.1,112.28,109.94,112.61
2023-08-25 16:50,374,181,193,28761,14055,14706,32065865.0,15472304.0,16593560.0,345,160,185,29097,14116,14981,32421668.0,15514670.0,16906997.0,110.08,112.84,109.91,112.86
2023-08-25 16:55,279,176,103,17963,9464,8499,20043767.0,10439692.0,9604075.0,257,161,96,17822,9266,8556,19899211.0,10216023.0,9683188.0,110.31,113.0,110.25,113.17
2023-08-25 17:00,380,208,172,35729,18371,17358,39794959.0,20207880.0,19587079.0,314,170,144,35210,18168,17042,39259979.0,19982083.0,19277895.0,110.0,112.84,109.99,113.12
2023-08-25 17:05,256,140,116,21063,11069,9994,23468220.0,12177668.0,11290552.0,219,115,104,20752,10952,9800,23116186.0,12042162.0,11074023.0,110.02,112.97,109.95,113.0
2023-08-25 17:10,166,115,51,10856,5667,5189,12110036.0,6240333.0,5869702.0,145,100,45,10829,5704,5125,12076895.0,6279646.0,5797249.0,110.12,113.12,110.09,113.12
2023-08-25 17:15,116,89,27,6858,4062,2796,7646568.0,4482044.0,3164524.0,94,71,23,6572,3862,2710,7325450.0,4257365.0,3068085.0,110.34,113.18,110.24,113.21
2023-08-25 17:20,436,419,17,21819,20253,1566,24251676.0,22490888.0,1760788.0,423,410,13,21237,20178,1059,23604596.0,22407632.0,1196963.0,111.05,112.44,111.05,113.03
2023-08-25 17:25,172,103,69,14114,7475,6639,15682180.0,8219914.0,7462266.0,129,78,51,11912,6627,5285,13241647.0,7280881.0,5960766.0,109.97,112.4,109.87,112.79
2023-08-25 17:30,161,84,77,14932,7251,7681,16566660.0,7941933.0,8624726.0,117,58,59,15259,7808,7451,17271541.0,8552244.0,8719296.0,109.53,112.29,109.53,117.02
2023-08-25 17:35,97,62,35,7423,3873,3550,8575289.0,4244381.0,4330907.0,69,38,31,7334,3777,3557,8146148.0,4134591.0,4011556.0,109.59,122.0,109.47,112.78
2023-08-25 17:40,119,65,54,11256,5888,5368,12491328.0,6444955.0,6046372.0,89,43,46,10662,5320,5342,11838518.0,5822617.0,6015900.0,109.46,112.64,109.45,112.62
2023-08-25 17:45,47,36,11,1324,728,596,1473679.0,801611.0,672067.0,19,10,9,1022,579,443,1135172.0,634562.0,500610.0,110.11,112.76,109.6,113.0
2023-08-25 17:50,51,40,11,858,683,175,955235.0,759947.0,195288.0,22,14,8,1361,1191,170,1495377.0,1305360.0,190017.0,111.27,111.59,109.6,111.77
2023-08-25 17:55,26,21,5,560,318,242,622999.0,350618.0,272380.0,13,9,4,459,242,217,510077.0,265539.0,244537.0,110.26,112.55,109.73,112.69
2023-08-25 18:00,41,23,18,2493,1398,1095,2763137.0,1529985.0,1233152.0,34,23,11,2576,1528,1048,2854522.0,1673040.0,1181481.0,109.44,112.62,109.49,112.74
2023-08-25 18:05,32,18,14,1566,588,978,1739182.0,645586.0,1093596.0,22,11,11,1882,576,1306,2090998.0,630500.0,1460498.0,109.79,111.82,109.46,111.83
2023-08-25 18:10,227,118,109,9346,3495,5851,10299693.0,3880854.0,6418839.0,206,104,102,8301,2971,5330,9210839.0,3257471.0,5953368.0,111.04,109.7,109.64,111.7
2023-08-25 18:15,61,31,30,4381,2064,2317,4838854.0,2258954.0,2579899.0,51,25,26,4493,2252,2241,4978116.0,2462392.0,2515724.0,109.45,111.35,109.34,112.26
2023-08-25 18:20,47,27,20,2808,1316,1492,3111480.0,1441314.0,1670166.0,34,20,14,2016,1035,981,2234185.0,1131841.0,1102344.0,109.52,111.94,109.36,112.37
2023-08-25 18:25,64,41,23,3581,1775,1806,3979232.0,1951783.0,2027449.0,49,26,23,3593,1646,1947,3990310.0,1798313.0,2191997.0,109.96,112.26,109.25,112.58
2023-08-25 18:30,2337,2274,63,23523,20489,3034,25955131.0,22632042.0,3323089.0,2297,2247,50,22466,20032,2434,24847034.0,22121220.0,2725813.0,110.46,109.53,110.43,111.99
2023-08-25 18:35,606,530,76,10779,8659,2120,12238135.0,9553612.0,2684522.0,574,509,65,9924,7890,2034,11307160.0,8704885.0,2602274.0,110.33,126.63,110.33,127.94
2023-08-28 10:00,1271,711,560,43557,25072,18485,50415955.0,27830007.0,22585948.0,649,597,52,24814,23280,1534,27563069.0,25848588.0,1714481.0,111.0,122.19,111.03,111.77
2023-08-28 10:05,413,355,58,18593,16535,2058,20707297.0,18391339.0,2315958.0,336,316,20,14648,14282,366,16304771.0,15892754.0,412017.0,111.23,112.53,111.28,112.57
2023-08-28 10:10,304,265,39,13590,12014,1576,15178998.0,13362981.0,1816017.0,246,234,12,11341,11153,188,12618500.0,12407820.0,210680.0,111.23,115.23,111.25,112.06
2023-08-28 10:15,97,56,41,2297,1460,837,2598386.0,1620266.0,978119.0,41,32,9,834,744,90,926298.0,825469.0,100829.0,110.98,116.86,110.95,112.03
2023-08-28 10:20,85,59,26,5340,2315,3025,6025624.0,2554680.0,3470944.0,57,39,18,3928,2001,1927,4385218.0,2205402.0,2179815.0,110.35,114.74,110.22,113.12
2023-08-28 10:25,112,70,42,9793,5711,4082,10831394.0,6247051.0,4584342.0,62,39,23,7048,3733,3315,7862850.0,4111001.0,3751849.0,109.39,112.31,110.13,113.18
2023-08-28 10:30,85,43,42,3793,1572,2221,4291579.0,1736161.0,2555417.0,44,33,11,2854,1550,1304,3185283.0,1710189.0,1475094.0,110.44,115.06,110.33,113.12
2023-08-28 10:35,124,74,50,6972,3608,3364,7784558.0,3978711.0,3805847.0,71,42,29,6663,3393,3270,7443216.0,3737932.0,3705284.0,110.27,113.13,110.17,113.31
2023-08-28 10:40,114,79,35,6606,4225,2381,7362096.0,4675036.0,2687059.0,77,61,16,6285,4071,2214,7005446.0,4497071.0,2508374.0,110.65,112.85,110.47,113.3
2023-08-28 10:45,101,67,34,7154,3502,3652,7932653.0,3865039.0,4067613.0,68,50,18,5845,3364,2481,6522113.0,3710703.0,2811409.0,110.37,111.38,110.31,113.32
2023-08-28 10:50,57,35,22,4017,1882,2135,4582241.0,2081239.0,2501002.0,37,24,13,3144,1772,1372,3507370.0,1950008.0,1557362.0,110.59,117.14,110.05,113.51
2023-08-28 10:55,71,41,30,4002,1994,2008,4481492.0,2207421.0,2274070.0,43,28,15,3737,2012,1725,4166479.0,2214338.0,1952140.0,110.7,113.25,110.06,113.17
2023-08-28 11:00,151,104,47,9479,5275,4204,10600669.0,5833892.0,4766776.0,114,82,32,9105,5157,3948,10164856.0,5691933.0,4472922.0,110.6,113.39,110.37,113.3
2023-08-28 11:05,113,78,35,5708,3645,2063,6381586.0,4039680.0,2341906.0,76,55,21,5596,3456,2140,6253105.0,3820528.0,2432577.0,110.83,113.52,110.55,113.67
2023-08-28 11:10,104,74,30,5730,3073,2657,6413741.0,3402035.0,3011706.0,67,50,17,5069,2836,2233,5657624.0,3130109.0,2527514.0,110.71,113.35,110.37,113.19
2023-08-28 11:15,127,79,48,10031,5500,4531,11186063.0,6056238.0,5129824.0,92,62,30,9485,5143,4342,10587644.0,5669194.0,4918449.0,110.11,113.22,110.23,113.28
2023-08-28 11:20,72,49,23,3931,2095,1836,4382791.0,2308709.0,2074081.0,58,42,16,3525,1934,1591,3939198.0,2133330.0,1805867.0,110.2,112.97,110.31,113.51
2023-08-28 11:25,51,38,13,5755,2451,3304,6727813.0,2703420.0,4024392.0,39,28,11,2756,1476,1280,3071095.0,1625426.0,1445669.0,110.3,121.8,110.12,112.94
2023-08-28 11:30,79,56,23,5050,2551,2499,5717592.0,2826121.0,2891471.0,46,33,13,3984,2178,1806,4446024.0,2398987.0,2047037.0,110.78,115.71,110.15,113.35
2023-08-28 11:35,104,78,26,5481,2732,2749,6166878.0,3020277.0,3146601.0,84,70,14,4716,2488,2228,5263283.0,2743904.0,2519379.0,110.55,114.46,110.29,113.08
2023-08-28 11:40,105,61,44,7648,4205,3443,8535369.0,4639444.0,3895925.0,75,46,29,7163,3848,3315,7997245.0,4241595.0,3755650.0,110.33,113.15,110.23,113.29
2023-08-28 11:45,164,147,17,5712,2803,2909,6362541.0,3085491.0,3277050.0,73,62,11,3781,2638,1143,4250522.0,2922032.0,1328490.0,110.08,112.65,110.77,116.23
2023-08-28 11:50,233,87,146,8274,4420,3854,9265615.0,4891033.0,4374582.0,86,59,27,7655,4270,3385,8546213.0,4716737.0,3829476.0,110.66,113.51,110.46,113.13
2023-08-28 11:55,73,48,25,4760,2490,2270,5321681.0,2751932.0,2569748.0,57,38,19,4383,2475,1908,4894038.0,2732062.0,2161976.0,110.52,113.2,110.39,113.31
2023-08-28 12:00,43,27,16,1570,809,761,1765984.0,893787.0,872196.0,31,21,10,1669,728,941,1867521.0,801761.0,1065759.0,110.48,114.61,110.13,113.26
2023-08-28 12:05,80,53,27,4393,2567,1826,4896196.0,2837594.0,2058601.0,60,43,17,3883,2189,1694,4329297.0,2415220.0,1914077.0,110.54,112.74,110.33,112.99
2023-08-28 12:10,44,32,12,1583,914,669,1766054.0,1008555.0,757499.0,34,26,8,1911,1103,808,2132904.0,1216846.0,916058.0,110.35,113.23,110.32,113.37
2023-08-28 12:15,109,90,19,4337,2386,1951,4840225.0,2634110.0,2206114.0,89,76,13,3652,2099,1553,4074432.0,2316404.0,1758027.0,110.4,113.08,110.36,113.2
2023-08-28 12:20,76,52,24,4041,2484,1557,4537781.0,2769930.0,1767850.0,49,38,11,3568,2161,1407,3973332.0,2381182.0,1592150.0,111.51,113.54,110.19,113.16
2023-08-28 12:25,90,64,26,5962,3308,2654,6650150.0,3648035.0,3002115.0,71,51,20,5546,3120,2426,6192925.0,3442905.0,2750020.0,110.28,113.12,110.35,113.36
2023-08-28 12:30,213,172,41,15777,10192,5585,17640428.0,11304519.0,6335908.0,176,151,25,14167,9189,4978,15799673.0,10183380.0,5616293.0,110.92,113.45,110.82,112.82
2023-08-28 12:35,175,155,20,10881,8682,2199,12408329.0,9923680.0,2484649.0,158,143,15,9350,7216,2134,10425708.0,8013225.0,2412482.0,114.3,112.99,111.05,113.05
2023-08-28 12:40,120,95,25,8007,4773,3234,8963868.0,5286980.0,3676887.0,101,81,20,7635,4559,3076,8549508.0,5047564.0,3501944.0,110.77,113.69,110.72,113.85
2023-08-28 12:45,82,58,24,6408,3688,2720,7231690.0,4080696.0,3150994.0,68,54,14,5716,3670,2046,6381913.0,4060642.0,2321271.0,110.65,115.85,110.64,113.45
2023-08-28 12:50,67,49,18,2177,1539,638,2389557.0,1672486.0,717071.0,48,36,12,2411,1514,897,2672278.0,1651297.0,1020980.0,108.67,112.39,109.07,113.82
2023-08-28 12:55,850,716,134,56900,38693,18207,63271100.0,42878866.0,20392234.0,824,699,125,55605,38453,17152,61982833.0,42582045.0,19400788.0,110.82,112.0,110.74,113.11
2023-08-28 13:00,779,760,19,42085,40227,1858,46882167.0,44790922.0,2091245.0,763,749,14,40635,39736,899,45287565.0,44269310.0,1018255.0,111.35,112.55,111.41,113.27
2023-08-28 13:05,634,623,11,34503,32370,2133,38508655.0,36054922.0,2453732.0,626,618,8,34876,32194,2682,38875087.0,35861251.0,3013835.0,111.38,115.04,111.39,112.37
2023-08-28 13:10,1020,1004,16,53822,52352,1470,60010304.0,58319212.0,1691091.0,1013,1002,11,53557,52340,1217,59697772.0,58306043.0,1391728.0,111.4,115.04,111.4,114.36
2023-08-28 13:15,659,646,13,35322,34644,678,39364987.0,38600783.0,764204.0,651,643,8,35367,34603,764,39458372.0,38554986.0,903385.0,111.42,112.71,111.42,118.24
2023-08-28 13:20,46,29,17,4073,1453,2620,4586872.0,1602109.0,2984763.0,33,23,10,2603,1394,1209,2907101.0,1536517.0,1370584.0,110.26,113.92,110.22,113.37
2023-08-28 13:25,99,78,21,5602,3426,2176,6253891.0,3806888.0,2447002.0,81,65,16,5667,3364,2303,6323951.0,3733605.0,2590345.0,111.12,112.45,110.99,112.48
2023-08-28 13:30,79,51,28,6370,3309,3061,7083984.0,3651119.0,3432864.0,69,48,21,7150,3256,3894,7973206.0,3592824.0,4380381.0,110.34,112.15,110.34,112.49
2023-08-28 13:35,81,67,14,4490,3438,1052,4998415.0,3811099.0,1187316.0,72,62,10,4101,3487,614,4559443.0,3864381.0,695061.0,110.85,112.86,110.82,113.2
2023-08-28 13:40,102,82,20,5143,4249,894,5727637.0,4719906.0,1007731.0,84,76,8,4872,4256,616,5424046.0,4727204.0,696842.0,111.08,112.72,111.07,113.12
2023-08-28 13:45,103,84,19,5907,4581,1326,6570998.0,5077892.0,1493106.0,88,77,11,5761,4537,1224,6405579.0,5021628.0,1383950.0,110.85,112.6,110.68,113.07
2023-08-28 13:50,45,25,20,3287,1764,1523,3661987.0,1940408.0,1721578.0,30,17,13,3134,1710,1424,3490360.0,1880171.0,1610189.0,110.0,113.04,109.95,113.08
2023-08-28 13:55,231,215,16,13750,12004,1746,15301408.0,13335459.0,1965949.0,213,202,11,13367,11756,1611,14880486.0,13058995.0,1821491.0,111.09,112.6,111.08,113.07
2023-08-28 14:00,494,473,21,25254,24071,1183,28088479.0,26761089.0,1327390.0,470,460,10,24397,23958,439,27128046.0,26631338.0,496707.0,111.18,112.21,111.16,113.15
2023-08-28 14:05,99,78,21,7553,5228,2325,8396885.0,5779337.0,2617548.0,87,69,18,7277,5014,2263,8099293.0,5541231.0,2558062.0,110.55,112.58,110.52,113.04
2023-08-28 14:10,72,48,24,6180,3640,2540,6893243.0,4026764.0,2866479.0,58,42,16,5968,3564,2404,6646239.0,3927929.0,2718309.0,110.63,112.85,110.21,113.07
2023-08-28 14:15,99,72,27,6205,4236,1969,6892524.0,4673305.0,2219219.0,88,67,21,6037,4163,1874,6717412.0,4593261.0,2124151.0,110.32,112.71,110.34,113.35
2023-08-28 14:20,143,95,48,11528,6379,5149,12779811.0,7061733.0,5718078.0,106,72,34,10691,6173,4518,11896811.0,6794431.0,5102380.0,110.7,111.05,110.07,112.93
2023-08-28 14:25,89,44,45,6878,3336,3542,7655806.0,3663359.0,3992446.0,71,29,42,6948,3170,3778,7738077.0,3480063.0,4258014.0,109.81,112.72,109.78,112.71
2023-08-28 14:30,72,30,42,6316,3432,2884,6963889.0,3763438.0,3200451.0,59,14,45,5217,1944,3273,5805422.0,2129191.0,3676231.0,109.66,110.97,109.53,112.32
2023-08-28 14:35,70,43,27,5880,3494,2386,6503909.0,3833134.0,2670774.0,41,22,19,6659,4272,2387,7355848.0,4665640.0,2690208.0,109.71,111.94,109.21,112.7
2023-08-28 14:40,125,81,44,10604,5451,5153,11813343.0,5998959.0,5814384.0,108,66,42,10332,5272,5060,11496164.0,5785187.0,5710977.0,110.05,112.83,109.73,112.87
2023-08-28 14:45,26,15,11,1478,735,743,1646567.0,809548.0,837019.0,23,14,9,1590,892,698,1768718.0,981894.0,786823.0,110.14,112.65,110.08,112.73
2023-08-28 14:50,49,21,28,3898,1282,2616,4365142.0,1437450.0,2927692.0,43,19,24,3027,1108,1919,3369559.0,1216193.0,2153365.0,112.13,111.91,109.76,112.21
2023-08-28 14:55,54,28,26,3985,1802,2183,4434987.0,1983265.0,2451722.0,32,14,18,4355,1648,2707,4844419.0,1806260.0,3038158.0,110.06,112.31,109.6,112.23
2023-08-28 15:00,74,38,36,6712,3278,3434,7463713.0,3597417.0,3866296.0,51,24,27,7135,3229,3906,7974344.0,3539693.0,4434651.0,109.74,112.59,109.62,113.53
2023-08-28 15:05,1191,1065,126,78000,62589,15411,86921766.0,69480404.0,17441361.0,1113,1024,89,74598,61274,13324,83028732.0,67952127.0,15076605.0,111.01,113.17,110.9,113.15
2023-08-28 15:10,1345,1313,32,70662,66659,4003,78618632.0,74089529.0,4529102.0,1336,1311,25,70494,66669,3825,78424700.0,74099158.0,4325541.0,111.15,113.14,111.14,113.09
2023-08-28 15:15,866,839,27,47296,44959,2337,52631022.0,49986023.0,2644999.0,843,827,16,47064,44795,2269,52367997.0,49800298.0,2567698.0,111.18,113.18,111.17,113.16
2023-08-28 15:20,365,353,12,20224,18836,1388,22510823.0,20946547.0,1564275.0,356,344,12,20036,18699,1337,22283824.0,20776599.0,1507224.0,111.2,112.7,111.11,112.73
2023-08-28 15:25,701,689,12,39732,38691,1041,44154556.0,42975606.0,1178949.0,699,689,10,39175,38152,1023,43546276.0,42387543.0,1158733.0,111.07,113.25,111.1,113.27
2023-08-28 15:30,1124,1101,23,62679,60333,2346,69719945.0,67066104.0,2653840.0,1114,1094,20,62616,60320,2296,69650052.0,67051766.0,2598285.0,111.16,113.12,111.16,113.17
2023-08-28 15:35,1801,1679,122,96827,81976,14851,107392013.0,90813920.0,16578093.0,1738,1643,95,94887,81117,13770,105416769.0,89861473.0,15555296.0,110.78,111.63,110.78,112.97
2023-08-28 15:40,900,862,38,40043,35648,4395,44516581.0,39543979.0,4972602.0,879,848,31,40396,36160,4236,44890115.0,40103086.0,4787029.0,110.93,113.14,110.9,113.01
2023-08-28 15:45,766,740,26,33648,30461,3187,37429061.0,33811293.0,3617768.0,748,730,18,33222,30409,2813,36932051.0,33752350.0,3179701.0,111.0,113.52,110.99,113.04
2023-08-28 15:50,814,692,122,40499,29150,11349,44262102.0,32159902.0,12102199.0,682,588,94,34867,26480,8387,38710070.0,29243014.0,9467056.0,110.33,106.64,110.43,112.88
2023-08-28 15:55,4399,3527,872,180653,115639,65014,196480424.0,126310694.0,70169729.0,3770,3079,691,159479,105550,53929,175216609.0,115233267.0,59983342.0,109.23,107.93,109.17,111.23
2023-08-28 16:00,698,426,272,50863,27958,22905,56155421.0,30592969.0,25562452.0,500,302,198,43789,23340,20449,48244012.0,25403234.0,22840777.0,109.42,111.6,108.84,111.7
2023-08-28 16:05,244,145,99,16821,8339,8482,18513499.0,9093909.0,9419590.0,167,81,86,14816,6484,8332,16342316.0,7057385.0,9284931.0,109.05,111.05,108.84,111.44
2023-08-28 16:10,286,145,141,19490,10001,9489,21483080.0,10941303.0,10541776.0,191,72,119,16893,6683,10210,18651871.0,7270833.0,11381037.0,109.4,111.09,108.8,111.47
2023-08-28 16:15,234,113,121,16183,7556,8627,17942069.0,8300463.0,9641605.0,179,71,108,15280,6854,8426,16893413.0,7471014.0,9422398.0,109.85,111.76,109.0,111.83
2023-08-28 16:20,491,333,158,22194,10750,11444,24277472.0,11757266.0,12520206.0,412,277,135,20898,10605,10293,23099222.0,11581584.0,11517637.0,109.37,109.4,109.21,111.9
2023-08-28 16:25,273,112,161,18974,8269,10705,21038909.0,9057330.0,11981579.0,225,84,141,18695,8355,10340,20695036.0,9118962.0,11576073.0,109.53,111.93,109.14,111.95
2023-08-28 16:30,153,74,79,12905,5761,7144,14298879.0,6296595.0,8002284.0,135,65,70,13031,5928,7103,14427674.0,6469631.0,7958043.0,109.3,112.01,109.14,112.04
2023-08-28 16:35,152,67,85,9776,4310,5466,10838613.0,4725501.0,6113111.0,115,46,69,8724,3708,5016,9662304.0,4047221.0,5615083.0,109.64,111.84,109.15,111.94
2023-08-28 16:40,123,63,60,8662,4416,4246,9596648.0,4837875.0,4758772.0,95,41,54,7606,3377,4229,8429852.0,3688738.0,4741113.0,109.55,112.08,109.23,112.11
2023-08-28 16:45,192,69,123,12102,3818,8284,13437851.0,4181780.0,9256070.0,162,44,118,12047,4193,7854,13355511.0,4572264.0,8783247.0,109.53,111.73,109.05,111.83
2023-08-28 16:50,138,58,80,5442,1234,4208,5948036.0,1357645.0,4590391.0,122,44,78,5199,1486,3713,5766842.0,1628508.0,4138334.0,110.02,109.09,109.59,111.46
2023-08-28 16:55,63,35,28,4853,2295,2558,5370707.0,2506232.0,2864474.0,52,30,22,5030,2778,2252,5553964.0,3028207.0,2525757.0,109.2,111.98,109.01,112.16
2023-08-28 17:00,170,90,80,12512,6762,5750,13809618.0,7383838.0,6425780.0,118,62,56,11721,6476,5245,12949654.0,7069567.0,5880087.0,109.2,111.75,109.17,112.11
2023-08-28 17:05,107,62,45,8764,4175,4589,9675688.0,4574471.0,5101217.0,80,44,36,7429,4036,3393,8205036.0,4401670.0,3803366.0,109.57,111.16,109.06,112.09
2023-08-28 17:10,57,38,19,2199,1143,1056,2458627.0,1271464.0,1187163.0,31,17,14,1398,715,683,1545250.0,779886.0,765364.0,111.24,112.42,109.07,112.06
2023-08-28 17:15,200,122,78,15398,8268,7130,16648529.0,9030011.0,7618518.0,130,72,58,11729,5620,6109,12953195.0,6123873.0,6829321.0,109.22,106.85,108.97,111.79
2023-08-28 17:20,236,135,101,19680,9864,9816,21648252.0,10744642.0,10903610.0,158,73,85,16430,8469,7961,18086673.0,9202377.0,8884295.0,108.93,111.08,108.66,111.6
2023-08-28 17:25,128,90,38,6598,3775,2823,7299102.0,4152696.0,3146406.0,68,39,29,5626,2990,2636,6199019.0,3252865.0,2946154.0,110.01,111.46,108.79,111.77
2023-08-28 17:30,103,68,35,5043,2644,2399,5545170.0,2886424.0,2658746.0,57,29,28,3867,1838,2029,4264439.0,2000674.0,2263764.0,109.17,110.83,108.85,111.57
2023-08-28 17:35,333,190,143,27899,14329,13570,30814045.0,15642233.0,15171812.0,294,163,131,27195,13792,13403,30021016.0,15031990.0,14989026.0,109.16,111.8,108.99,111.83
2023-08-28 17:40,220,121,99,15642,8232,7410,17278597.0,8989896.0,8288701.0,173,86,87,15383,7973,7410,16984973.0,8692157.0,8292815.0,109.21,111.86,109.02,111.91
2023-08-28 17:45,104,67,37,8867,4539,4328,9839204.0,5009530.0,4829673.0,75,43,32,7113,3566,3547,7863725.0,3890673.0,3973052.0,110.37,111.59,109.1,112.01
2023-08-28 17:50,86,41,45,5198,1837,3361,5792860.0,2060999.0,3731861.0,50,17,33,3982,1666,2316,4402032.0,1815806.0,2586226.0,112.19,111.03,108.99,111.67
2023-08-28 17:55,117,66,51,8975,4508,4467,9863152.0,4914040.0,4949112.0,86,46,40,8678,4470,4208,9584453.0,4870363.0,4714089.0,109.01,110.79,108.96,112.03
2023-08-28 18:00,91,47,44,5367,2508,2859,5909695.0,2739173.0,3170521.0,58,23,35,4760,2171,2589,5261904.0,2364354.0,2897549.0,109.22,110.9,108.91,111.92
2023-08-28 18:05,320,156,164,22636,10702,11934,24946232.0,11665233.0,13280998.0,254,111,143,22251,11044,11207,24548761.0,12021991.0,12526770.0,109.0,111.29,108.86,111.78
2023-08-28 18:10,336,164,172,15446,6156,9290,17097912.0,6773199.0,10324712.0,299,134,165,14216,5186,9030,15704796.0,5645757.0,10059039.0,110.03,111.14,108.87,111.4
2023-08-28 18:15,156,82,74,11779,6234,5545,12999961.0,6811197.0,6188764.0,103,56,47,10495,5438,5057,11591658.0,5931965.0,5659693.0,109.26,111.61,109.08,111.92
2023-08-28 18:20,219,113,106,17684,8595,9089,19474850.0,9364571.0,10110279.0,191,96,95,17767,8800,8967,19618545.0,9582987.0,10035557.0,108.95,111.24,108.9,111.92
2023-08-28 18:25,84,49,35,5445,2594,2851,6023670.0,2839216.0,3184454.0,50,25,25,4950,2299,2651,5466139.0,2502394.0,2963744.0,109.45,111.7,108.85,111.8
2023-08-28 18:30,170,87,83,13281,7213,6068,14702066.0,7935334.0,6766731.0,113,55,58,12055,6265,5790,13321322.0,6831803.0,6489518.0,110.01,111.52,109.05,112.08
2023-08-28 18:35,119,82,37,10772,6503,4269,11816697.0,7065877.0,4750820.0,59,36,23,6739,3293,3446,7448184.0,3591360.0,3856823.0,108.66,111.29,109.06,111.92
2023-08-29 10:00,678,148,530,22258,5927,16331,26267774.0,6394398.0,19873376.0,78,43,35,3273,1301,1972,3641045.0,1428458.0,2212586.0,107.89,121.69,109.8,112.2
2023-08-29 10:05,797,498,299,31812,19737,12075,36371269.0,22577378.0,13793891.0,237,158,79,9930,6767,3163,11067751.0,7512073.0,3555678.0,114.39,114.24,111.01,112.41
2023-08-29 10:10,404,186,218,12499,6176,6323,14113845.0,7155927.0,6957917.0,149,70,79,5638,3499,2139,6320379.0,3894412.0,2425966.0,115.87,110.04,111.3,113.42
2023-08-29 10:15,500,248,252,19679,9401,10278,22154762.0,10439418.0,11715343.0,146,79,67,15618,8083,7535,17503563.0,8942123.0,8561439.0,111.05,113.98,110.63,113.62
2023-08-29 10:20,284,131,153,19975,9893,10082,22455948.0,11026756.0,11429191.0,132,59,73,16472,8915,7557,18442389.0,9855855.0,8586534.0,111.46,113.36,110.55,113.62
2023-08-29 10:25,204,119,85,14447,6535,7912,16265283.0,7277192.0,8988091.0,108,64,44,10121,5549,4572,11331378.0,6141480.0,5189898.0,111.36,113.6,110.68,113.51
2023-08-29 10:30,185,89,96,16183,6625,9558,18049560.0,7337642.0,10711917.0,101,47,54,13134,5801,7333,14727001.0,6407669.0,8319331.0,110.76,112.07,110.46,113.45
2023-08-29 10:35,169,87,82,13831,6769,7062,15529839.0,7502452.0,8027386.0,101,51,50,11087,5491,5596,12420784.0,6070627.0,6350157.0,110.84,113.67,110.56,113.48
2023-08-29 10:40,180,118,62,13438,8247,5191,15089257.0,9181159.0,5908098.0,121,85,36,10254,6511,3743,11464655.0,7209616.0,4255039.0,111.33,113.81,110.73,113.68
2023-08-29 10:45,211,113,98,16530,8280,8250,18535930.0,9202318.0,9333612.0,148,88,60,15433,8730,6703,17262410.0,9656923.0,7605487.0,111.14,113.13,110.62,113.46
2023-08-29 10:50,225,130,95,15539,8251,7288,17365145.0,9148003.0,8217141.0,160,93,67,14606,7457,7149,16318781.0,8231680.0,8087101.0,110.87,112.75,110.39,113.12
2023-08-29 10:55,185,111,74,11583,6452,5131,12941930.0,7128383.0,5813546.0,135,86,49,12038,6355,5683,13595983.0,7020767.0,6575215.0,110.48,113.3,110.48,115.7
2023-08-29 11:00,139,58,81,7301,3644,3657,8155889.0,4012638.0,4143251.0,99,36,63,6688,3309,3379,7456818.0,3643175.0,3813643.0,110.12,113.3,110.1,112.86
2023-08-29 11:05,108,56,52,4845,2103,2742,6884912.0,2316344.0,4568567.0,67,27,40,4418,1879,2539,4928278.0,2064699.0,2863579.0,110.14,166.61,109.88,112.78
2023-08-29 11:10,224,120,104,16802,9007,7795,18759287.0,9945605.0,8813682.0,178,90,88,16263,8478,7785,18153768.0,9349563.0,8804205.0,110.42,113.07,110.28,113.09
2023-08-29 11:15,267,136,131,22725,12469,10256,25410490.0,13797556.0,11612934.0,209,104,105,20719,11022,9697,23165656.0,12173299.0,10992357.0,110.65,113.23,110.45,113.36
2023-08-29 11:20,151,74,77,11511,5994,5517,12867084.0,6630127.0,6236956.0,123,73,50,11193,6117,5076,12528600.0,6769931.0,5758669.0,110.61,113.05,110.67,113.45
2023-08-29 11:25,552,221,331,34741,14673,20068,38795905.0,16233266.0,22562639.0,507,198,309,32958,14624,18334,36796157.0,16177478.0,20618679.0,110.63,112.43,110.62,112.46
2023-08-29 11:30,772,64,708,36014,4105,31909,40244471.0,4519651.0,35724820.0,729,40,689,35500,3862,31638,39679342.0,4246774.0,35432568.0,110.1,111.96,109.96,111.99
2023-08-29 11:35,773,55,718,31984,3758,28226,35790550.0,4149074.0,31641476.0,748,39,709,31812,3534,28278,35577186.0,3891481.0,31685705.0,110.41,112.1,110.12,112.05
2023-08-29 11:40,304,48,256,14065,2755,11310,15758248.0,3042349.0,12715898.0,268,29,239,12060,2381,9679,13491185.0,2623611.0,10867574.0,110.43,112.43,110.19,112.28
2023-08-29 11:45,144,39,105,9633,3824,5809,10690129.0,4168588.0,6521540.0,121,25,96,6762,2010,4752,7552818.0,2213005.0,5339813.0,109.01,112.27,110.1,112.37
2023-08-29 11:50,103,66,37,7216,3892,3324,8029986.0,4305073.0,3724913.0,67,39,28,6173,3062,3111,6884972.0,3376352.0,3508620.0,110.61,112.06,110.27,112.78
2023-08-29 11:55,34,30,4,985,953,32,1092932.0,1059638.0,33293.0,28,24,4,937,901,36,1040967.0,1000621.0,40345.0,111.19,104.04,111.06,112.07
2023-08-29 12:00,237,71,166,16054,5273,10781,17778655.0,5809699.0,11968956.0,196,44,152,15749,4898,10851,17568322.0,5386654.0,12181667.0,110.18,111.02,109.98,112.26
2023-08-29 12:05,107,28,79,5762,1011,4751,6450883.0,1117672.0,5333211.0,95,26,69,5620,1202,4418,6271567.0,1322909.0,4948657.0,110.55,112.25,110.06,112.01
2023-08-29 12:10,552,262,290,31357,14533,16824,34988341.0,16156051.0,18832290.0,510,229,281,30811,13885,16926,34360338.0,15400832.0,18959505.0,111.17,111.94,110.92,112.01
2023-08-29 12:15,230,178,52,20643,13660,6983,23070526.0,15126047.0,7944478.0,203,165,38,18988,13114,5874,21156540.0,14520412.0,6636128.0,110.73,113.77,110.72,112.97
2023-08-29 12:20,58,36,22,3840,1987,1853,4252517.0,2194486.0,2058030.0,33,17,16,3667,1670,1997,4087782.0,1836907.0,2250874.0,110.44,111.06,109.99,112.71
2023-08-29 12:25,95,57,38,7538,3833,3705,8421216.0,4234974.0,4186242.0,56,33,23,7032,3748,3284,7839910.0,4125020.0,3714889.0,110.49,112.99,110.06,113.12
2023-08-29 12:30,99,63,36,8316,4921,3395,9310309.0,5471498.0,3838810.0,74,46,28,7890,4723,3167,8797360.0,5214320.0,3583040.0,111.19,113.07,110.4,113.14
2023-08-29 12:35,42,24,18,3722,1647,2075,4182222.0,1841561.0,2340661.0,29,13,16,3327,1521,1806,3710308.0,1672913.0,2037395.0,111.81,112.8,109.99,112.81
2023-08-29 12:40,46,23,23,1889,921,968,2108853.0,1015381.0,1093472.0,25,11,14,1771,836,935,1974830.0,918215.0,1056615.0,110.25,112.96,109.83,113.01
2023-08-29 12:45,51,31,20,3742,1813,1929,4205806.0,2018869.0,2186937.0,26,14,12,2800,1241,1559,3123950.0,1364432.0,1759518.0,111.36,113.37,109.95,112.86
2023-08-29 12:50,44,19,25,2916,1284,1632,3258382.0,1421165.0,1837216.0,28,11,17,2348,1054,1294,2618881.0,1157987.0,1460894.0,110.68,112.57,109.87,112.9
2023-08-29 12:55,31,14,17,2005,852,1153,2240256.0,939842.0,1300413.0,19,9,10,1652,810,842,1841276.0,892382.0,948893.0,110.31,112.79,110.17,112.7
2023-08-29 13:00,67,37,30,5084,2449,2635,5660045.0,2695310.0,2964735.0,45,23,22,4850,2424,2426,5398817.0,2660356.0,2738460.0,110.06,112.51,109.75,112.88
2023-08-29 13:05,143,55,88,10051,4364,5687,11123430.0,4790565.0,6332865.0,101,31,70,9669,4182,5487,10759950.0,4587726.0,6172223.0,109.77,111.36,109.7,112.49
2023-08-29 13:10,142,59,83,8510,3611,4899,9462101.0,3966216.0,5495885.0,102,30,72,8213,3317,4896,9134928.0,3634510.0,5500418.0,109.84,112.18,109.57,112.35
2023-08-29 13:15,274,117,157,23254,9906,13348,25843934.0,10909728.0,14934206.0,193,64,129,21611,9242,12369,24049687.0,10131240.0,13918446.0,110.13,111.88,109.62,112.53
2023-08-29 13:20,67,44,23,4146,2301,1845,4626604.0,2538167.0,2088436.0,40,23,17,3472,1774,1698,3867711.0,1949197.0,1918514.0,110.31,113.19,109.88,112.99
2023-08-29 13:25,161,60,101,13532,5827,7705,15069280.0,6395499.0,8673781.0,129,45,84,13016,5723,7293,14495676.0,6282252.0,8213424.0,109.76,112.57,109.77,112.62
2023-08-29 13:30,113,41,72,8058,2901,5157,8983335.0,3188615.0,5794720.0,94,25,69,7772,2709,5063,8655610.0,2973454.0,5682155.0,109.91,112.37,109.76,112.23
2023-08-29 13:35,163,55,108,16064,9274,6790,17880600.0,10272445.0,7608155.0,149,42,107,16208,9111,7097,18044154.0,10088910.0,7955243.0,110.77,112.05,110.73,112.09
2023-08-29 13:40,141,48,93,10505,4012,6493,11693090.0,4411283.0,7281806.0,114,36,78,10372,4038,6334,11554801.0,4435834.0,7118967.0,109.95,112.15,109.85,112.39
2023-08-29 13:45,137,45,92,9114,2612,6502,10164464.0,2874146.0,7290318.0,108,24,84,8728,2436,6292,9720692.0,2670326.0,7050366.0,110.04,112.12,109.62,112.05
2023-08-29 13:50,108,18,90,6280,1302,4978,6996903.0,1430706.0,5566197.0,90,12,78,6335,1448,4887,7056268.0,1588205.0,5468062.0,109.89,111.82,109.68,111.89
2023-08-29 13:55,137,23,114,7734,1045,6689,8633951.0,1164892.0,7469059.0,122,11,111,7622,954,6668,8498012.0,1048855.0,7449156.0,111.47,111.66,109.94,111.72
2023-08-29 14:00,205,36,169,11616,2338,9278,12879769.0,2572472.0,10307296.0,187,21,166,11577,2117,9460,12909890.0,2322632.0,10587258.0,110.03,111.09,109.71,111.92
2023-08-29 14:05,219,82,137,16116,6244,9872,17925904.0,6860017.0,11065887.0,174,51,123,15633,6084,9549,17394638.0,6670091.0,10724546.0,109.87,112.09,109.63,112.31
2023-08-29 14:10,45,22,23,1404,485,919,1569981.0,537609.0,1032372.0,35,13,22,1189,297,892,1325408.0,326253.0,999154.0,110.85,112.34,109.85,112.01
2023-08-29 14:15,69,31,38,6178,2919,3259,6923430.0,3240671.0,3682759.0,46,18,28,5653,2638,3015,6300406.0,2897105.0,3403301.0,111.02,113.0,109.82,112.88
2023-08-29 14:20,250,177,73,14052,9758,4294,15727357.0,10895124.0,4832232.0,216,155,61,13887,9504,4383,15468302.0,10533988.0,4934313.0,111.65,112.53,110.84,112.58
2023-08-29 14:25,139,68,71,11558,5766,5792,12955075.0,6391123.0,6563952.0,95,50,45,10449,5335,5114,11678155.0,5883804.0,5794351.0,110.84,113.33,110.29,113.3
2023-08-29 14:30,148,81,67,11442,5427,6015,12797360.0,6000651.0,6796709.0,129,65,64,10679,5263,5416,11931615.0,5802900.0,6128714.0,110.57,113.0,110.26,113.16
2023-08-29 14:35,114,49,65,9801,4573,5228,10925210.0,5036038.0,5889172.0,87,36,51,9435,4520,4915,10535947.0,4975713.0,5560234.0,110.13,112.65,110.08,113.13
2023-08-29 14:40,378,51,327,20707,4806,15901,23071398.0,5281264.0,17790133.0,353,40,313,20117,4779,15338,22438667.0,5252407.0,17186259.0,109.89,111.88,109.91,112.05
2023-08-29 14:45,194,35,159,10443,2453,7990,11643348.0,2696626.0,8946722.0,179,27,152,10359,2419,7940,11550561.0,2659328.0,8891233.0,109.93,111.97,109.94,111.98
2023-08-29 14:50,73,36,37,1790,865,925,1985376.0,970083.0,1015292.0,52,16,36,1542,580,962,1718138.0,638275.0,1079862.0,112.15,109.76,110.05,112.25
2023-08-29 14:55,709,44,665,37392,2604,34788,41778574.0,2895341.0,38883233.0,685,23,662,37077,2044,35033,41394726.0,2245816.0,39148909.0,111.19,111.77,109.87,111.75
2023-08-29 15:00,748,70,678,47731,6487,41244,53239087.0,7120017.0,46119070.0,716,47,669,45207,5694,39513,50445465.0,6246360.0,44199105.0,109.76,111.82,109.7,111.86
2023-08-29 15:05,184,61,123,10795,3828,6967,11999473.0,4205325.0,7794147.0,148,35,113,10002,3203,6799,11143260.0,3512610.0,7630649.0,109.86,111.87,109.67,112.23
2023-08-29 15:10,1152,168,984,84118,23025,61093,93635297.0,25247131.0,68388166.0,1117,145,972,83448,22475,60973,92881649.0,24624187.0,68257462.0,109.65,111.94,109.56,111.95
2023-08-29 15:15,386,65,321,29473,7892,21581,32807734.0,8657433.0,24150300.0,362,56,306,29235,7767,21468,32559891.0,8516919.0,24042972.0,109.7,111.91,109.66,111.99
2023-08-29 15:20,393,47,346,23881,3606,20275,26573832.0,3952861.0,22620970.0,362,32,330,23690,3517,20173,26377280.0,3853319.0,22523961.0,109.62,111.57,109.56,111.65
2023-08-29 15:25,144,33,111,10225,3610,6615,11369461.0,3954994.0,7414466.0,134,23,111,10041,3570,6471,11166159.0,3909732.0,7256427.0,109.56,112.09,109.52,112.14
2023-08-29 15:30,85,37,48,4872,1833,3039,5425558.0,2013650.0,3411907.0,64,20,44,4686,1665,3021,5215204.0,1823479.0,3391725.0,109.86,112.27,109.52,112.27
2023-08-29 15:35,76,24,52,3241,1141,2100,3610242.0,1252536.0,2357706.0,50,13,37,3088,1038,2050,3436741.0,1136216.0,2300525.0,109.78,112.27,109.46,112.22
2023-08-29 15:40,351,33,318,19838,2290,17548,22096099.0,2511350.0,19584749.0,338,26,312,19845,2328,17517,22105640.0,2552896.0,19552743.0,109.67,111.61,109.66,111.62
2023-08-29 15:45,177,26,151,10098,1548,8550,11255086.0,1701141.0,9553944.0,165,15,150,9785,1292,8493,10907701.0,1415555.0,9492145.0,109.89,111.74,109.56,111.76
2023-08-29 15:50,581,29,552,32142,1505,30637,35826740.0,1651317.0,34175423.0,568,22,546,31958,1495,30463,35623975.0,1638557.0,33985418.0,109.72,111.55,109.6,111.56
2023-08-29 15:55,765,38,727,44153,2790,41363,49177208.0,3058940.0,46118268.0,753,30,723,44318,2919,41399,49388009.0,3197426.0,46190582.0,109.64,111.5,109.54,111.57
2023-08-29 16:00,848,23,825,48224,1404,46820,53754483.0,1542200.0,52212282.0,884,61,823,48181,1367,46814,53702520.0,1497416.0,52205104.0,109.84,111.52,109.54,111.52
2023-08-29 16:05,91,17,74,5137,1230,3907,5727172.0,1364537.0,4362635.0,87,12,75,4357,449,3908,4856371.0,492563.0,4363808.0,110.94,111.66,109.7,111.66
2023-08-29 16:10,427,63,364,35544,9193,26351,39589793.0,10082096.0,29507697.0,417,58,359,35476,9168,26308,39513746.0,10052849.0,29460897.0,109.67,111.98,109.65,111.98
2023-08-29 16:15,214,43,171,17823,5426,12397,19844705.0,5974630.0,13870074.0,197,32,165,16917,5204,11713,18853953.0,5713009.0,13140944.0,110.11,111.88,109.78,112.19
2023-08-29 16:20,138,44,94,10420,3992,6428,11595169.0,4381947.0,7213221.0,117,32,85,10247,3949,6298,11409593.0,4327621.0,7081971.0,109.77,112.22,109.59,112.45
2023-08-29 16:25,99,33,66,8085,3256,4829,8971358.0,3566441.0,5404916.0,76,26,50,8361,4008,4353,9284089.0,4385611.0,4898478.0,109.53,111.93,109.42,112.53
2023-08-29 16:30,130,58,72,9654,4259,5395,10673282.0,4676741.0,5996540.0,97,34,63,8007,3270,4737,8897773.0,3579864.0,5317909.0,109.81,111.15,109.48,112.26
2023-08-29 16:35,235,142,93,23094,13219,9875,25715016.0,14573881.0,11141135.0,196,123,73,22188,13036,9152,24706452.0,14369115.0,10337337.0,110.25,112.82,110.23,112.95
2023-08-29 16:40,114,62,52,7772,4062,3710,8642609.0,4470708.0,4171900.0,107,60,47,7493,3979,3514,8342616.0,4376165.0,3966451.0,110.06,112.45,109.98,112.88
2023-08-29 16:45,156,53,103,8620,3857,4763,9603539.0,4240532.0,5363007.0,146,51,95,8692,3946,4746,9682863.0,4338743.0,5344119.0,109.94,112.6,109.95,112.6
2023-08-29 16:50,124,65,59,9005,4410,4595,9992457.0,4841505.0,5150952.0,106,52,54,8770,4368,4402,9756196.0,4791460.0,4964736.0,109.78,112.1,109.69,112.78
2023-08-29 16:55,63,26,37,3079,1336,1743,3429266.0,1466950.0,1962315.0,61,26,35,3420,1585,1835,3802479.0,1737477.0,2065002.0,109.8,112.58,109.62,112.53
2023-08-29 17:00,123,59,64,8955,4389,4566,9977839.0,4827891.0,5149948.0,109,51,58,8716,4174,4542,9707196.0,4583707.0,5123488.0,110.0,112.79,109.82,112.8
2023-08-29 17:05,77,37,40,5243,2542,2701,5843965.0,2796466.0,3047499.0,66,29,37,5109,2425,2684,5692616.0,2664113.0,3028503.0,110.01,112.83,109.86,112.84
2023-08-29 17:10,40,26,14,1071,602,469,1191416.0,666065.0,525350.0,25,15,10,978,540,438,1089358.0,594289.0,495068.0,110.64,112.02,110.05,113.03
2023-08-29 17:15,77,26,51,3934,1202,2732,4389468.0,1325818.0,3063650.0,59,16,43,3747,1137,2610,4181559.0,1250050.0,2931508.0,110.3,112.14,109.94,112.32
2023-08-29 17:20,62,31,31,3590,1759,1831,3982866.0,1930874.0,2051992.0,60,34,26,3516,1791,1725,3916327.0,1970234.0,1946093.0,109.77,112.07,110.01,112.82
2023-08-29 17:25,135,56,79,9836,4142,5694,10957053.0,4552172.0,6404881.0,120,48,72,9761,4075,5686,10876921.0,4478805.0,6398115.0,109.9,112.48,109.91,112.52
2023-08-29 17:30,1339,280,1059,108596,30268,78328,120766235.0,33174461.0,87591773.0,1311,259,1052,107802,30026,77776,119966631.0,32907530.0,87059100.0,109.6,111.83,109.6,111.94
2023-08-29 17:35,387,88,299,32742,10198,22544,36436667.0,11179020.0,25257647.0,381,94,287,32525,10164,22361,36192997.0,11138561.0,25054435.0,109.62,112.04,109.59,112.05
2023-08-29 17:40,108,29,79,5531,1335,4196,6160975.0,1465074.0,4695901.0,98,20,78,5492,1294,4198,6117673.0,1417576.0,4700096.0,109.74,111.91,109.55,111.96
2023-08-29 17:45,82,25,57,3328,1297,2031,3698225.0,1428599.0,2269625.0,53,17,36,2824,901,1923,3144670.0,988112.0,2156557.0,110.15,111.75,109.67,112.15
2023-08-29 17:50,46,20,26,2384,681,1703,2648447.0,750313.0,1898134.0,32,14,18,1668,854,814,1852919.0,938803.0,914116.0,110.18,111.46,109.93,112.3
2023-08-29 17:55,128,37,91,8597,2550,6047,9572170.0,2794138.0,6778031.0,113,30,83,8411,2514,5897,9367274.0,2753745.0,6613529.0,109.57,112.09,109.54,112.15
2023-08-29 18:00,165,59,106,14192,5466,8726,15778461.0,5994783.0,9783677.0,148,45,103,13692,4995,8697,15223756.0,5472484.0,9751271.0,109.67,112.12,109.56,112.12
2023-08-29 18:05,831,154,677,68975,18762,50213,76603299.0,20537899.0,56065400.0,819,151,668,68945,19062,49883,76618638.0,20865709.0,55752928.0,109.47,111.66,109.46,111.77
2023-08-29 18:10,552,90,462,36710,5571,31139,39927360.0,6135506.0,33791853.0,504,55,449,29383,4419,24964,32612741.0,4832273.0,27780467.0,110.13,108.52,109.35,111.28
2023-08-29 18:15,169,74,95,13696,6036,7660,15164701.0,6598615.0,8566086.0,131,49,82,12909,5753,7156,14298820.0,6283862.0,8014958.0,109.32,111.83,109.23,112.0
2023-08-29 18:20,156,68,88,11231,5106,6125,12453270.0,5594515.0,6858754.0,113,34,79,10430,4667,5763,11559973.0,5101689.0,6458283.0,109.57,111.98,109.31,112.06
2023-08-29 18:25,32,17,15,1798,971,827,1994882.0,1068070.0,926812.0,21,9,12,1684,976,708,1864903.0,1069839.0,795063.0,110.0,112.07,109.61,112.3
2023-08-29 18:30,110,74,36,9026,5049,3977,9964172.0,5542159.0,4422013.0,82,47,35,8036,4194,3842,8897294.0,4587438.0,4309855.0,109.77,111.19,109.38,112.18
2023-08-29 18:35,71,42,29,4501,2221,2280,5006425.0,2446438.0,2559987.0,73,43,30,4532,2238,2294,5026946.0,2450252.0,2576694.0,110.15,112.28,109.48,112.32
2023-08-30 10:00,1418,491,927,41605,20275,21330,49516780.0,22358770.0,27158010.0,795,393,402,24373,18007,6366,27043156.0,19927583.0,7115572.0,110.28,127.32,110.67,111.77
2023-08-30 10:05,224,103,121,7557,4392,3165,8599281.0,4838666.0,3760614.0,110,64,46,3448,2558,890,3847897.0,2839639.0,1008257.0,110.17,118.82,111.01,113.29
2023-08-30 10:10,124,56,68,4091,1712,2379,4627511.0,1880780.0,2746730.0,44,25,19,861,723,138,960147.0,805123.0,155024.0,109.86,115.46,111.36,112.34
2023-08-30 10:15,85,56,29,3151,1575,1576,3550040.0,1746374.0,1803665.0,31,22,9,1494,995,499,1664659.0,1099426.0,565232.0,110.88,114.45,110.5,113.27
2023-08-30 10:20,395,203,192,18788,9654,9134,21353377.0,10700398.0,10652979.0,112,73,39,11537,6560,4977,12901327.0,7249413.0,5651914.0,110.84,116.63,110.51,113.56
2023-08-30 10:25,176,87,89,11686,5508,6178,13289673.0,6187070.0,7102603.0,81,43,38,7479,4022,3457,8390292.0,4455662.0,3934630.0,112.33,114.97,110.78,113.82
2023-08-30 10:30,110,44,66,6893,3350,3543,7728363.0,3724452.0,4003911.0,56,30,26,6092,3653,2439,6842930.0,4061942.0,2780987.0,111.18,113.01,111.19,114.02
2023-08-30 10:35,171,76,95,12894,6168,6726,14490078.0,6871255.0,7618823.0,102,58,44,13822,6501,7321,15747364.0,7150888.0,8596476.0,111.4,113.27,110.0,117.42
2023-08-30 10:40,145,65,80,11281,5184,6097,12782731.0,5754074.0,7028656.0,94,51,43,9616,4744,4872,10817068.0,5255746.0,5561321.0,111.0,115.28,110.79,114.15
2023-08-30 10:45,129,66,63,9148,4850,4298,10183040.0,5377558.0,4805482.0,82,53,29,8162,4750,3412,9149027.0,5263195.0,3885831.0,110.88,111.81,110.8,113.89
2023-08-30 10:50,151,99,52,10696,6917,3779,11970083.0,7687713.0,4282369.0,125,92,33,10603,6796,3807,11855128.0,7530859.0,4324269.0,111.14,113.32,110.81,113.59
2023-08-30 10:55,167,112,55,12393,7565,4828,13989015.0,8479451.0,5509563.0,132,102,30,10068,6883,3185,11262887.0,7641213.0,3621673.0,112.09,114.12,111.02,113.71
2023-08-30 11:00,116,68,48,7523,4957,2566,8466890.0,5547732.0,2919158.0,89,56,33,6228,3746,2482,6972150.0,4154786.0,2817363.0,111.92,113.76,110.91,113.51
2023-08-30 11:05,548,205,343,42956,22775,20181,48243405.0,25276778.0,22966626.0,506,178,328,42154,22115,20039,47287808.0,24485735.0,22802072.0,110.98,113.8,110.72,113.79
2023-08-30 11:10,117,63,54,11121,4267,6854,12817346.0,4744856.0,8072490.0,72,47,25,7697,4036,3661,8663184.0,4476486.0,4186697.0,111.2,117.78,110.91,114.36
2023-08-30 11:15,123,62,61,9091,4678,4413,10222415.0,5231064.0,4991351.0,88,49,39,10104,4022,6082,11646622.0,4460173.0,7186449.0,111.82,113.11,110.89,118.16
2023-08-30 11:20,85,39,46,6531,2955,3576,7344867.0,3274478.0,4070389.0,61,33,28,6516,2806,3710,7469141.0,3107130.0,4362011.0,110.81,113.83,110.73,117.57
2023-08-30 11:25,81,47,34,6285,3085,3200,7060903.0,3426644.0,3634258.0,59,42,17,5506,3021,2485,6173396.0,3345855.0,2827541.0,111.07,113.57,110.75,113.78
2023-08-30 11:30,90,46,44,7259,3602,3657,8172985.0,3993288.0,4179696.0,71,39,32,6870,3480,3390,7742431.0,3855036.0,3887395.0,110.86,114.29,110.78,114.67
2023-08-30 11:35,72,31,41,4744,2292,2452,5334909.0,2541040.0,2793869.0,52,28,24,4274,2167,2107,4811142.0,2399043.0,2412098.0,110.87,113.94,110.71,114.48
2023-08-30 11:40,76,39,37,6795,3160,3635,7570877.0,3500160.0,4070716.0,52,30,22,5477,2838,2639,6135956.0,3136971.0,2998984.0,110.76,111.99,110.53,113.64
2023-08-30 11:45,1665,486,1179,78597,38291,40306,90427305.0,43937669.0,46489636.0,1338,327,1011,62133,29802,32331,70235140.0,33291447.0,36943692.0,114.75,115.34,111.71,114.27
2023-08-30 11:50,712,333,379,63449,34563,28886,72484753.0,39326498.0,33158254.0,348,199,149,48053,25447,22606,54724472.0,28612519.0,26111953.0,113.78,114.79,112.44,115.51
2023-08-30 11:55,707,349,358,36822,17190,19632,41946400.0,19475198.0,22471201.0,565,299,266,32530,17153,15377,36999265.0,19331281.0,17667984.0,113.29,114.46,112.7,114.9
2023-08-30 12:00,777,493,284,44915,23965,20950,50799375.0,26970911.0,23828464.0,640,432,208,38275,22473,15802,43387946.0,25274127.0,18113818.0,112.54,113.74,112.46,114.63
2023-08-30 12:05,285,157,128,23740,11188,12552,28295276.0,12516765.0,15778510.0,207,119,88,20182,9603,10579,24321383.0,10707425.0,13613958.0,111.88,125.71,111.5,128.69
2023-08-30 12:10,224,105,119,22539,10974,11565,25565911.0,12290869.0,13275041.0,150,77,73,20306,10486,9820,22990605.0,11710819.0,11279786.0,112.0,114.79,111.68,114.87
2023-08-30 12:15,142,62,80,12073,5497,6576,13649082.0,6136258.0,7512824.0,96,48,48,11422,4872,6550,12934658.0,5434451.0,7500207.0,111.63,114.25,111.54,114.51
2023-08-30 12:20,111,55,56,8046,3331,4715,9087062.0,3745897.0,5341164.0,60,29,31,5309,2698,2611,5998379.0,3001537.0,2996842.0,112.46,113.28,111.25,114.78
2023-08-30 12:25,92,49,43,5473,2636,2837,6157340.0,2943684.0,3213656.0,57,30,27,5284,2584,2700,5977910.0,2883682.0,3094228.0,111.67,113.28,111.6,114.6
2023-08-30 12:30,67,43,24,1441,1002,439,3208280.0,1141203.0,2067077.0,27,17,10,957,454,503,2454374.0,508508.0,1945865.0,113.89,470.86,112.01,386.85
2023-08-30 12:35,42,27,15,2026,1100,926,2269456.0,1230857.0,1038599.0,23,13,10,1677,865,812,1897366.0,964917.0,932449.0,111.9,112.16,111.55,114.83
2023-08-30 12:40,66,46,20,1356,795,561,1526251.0,891352.0,634898.0,30,18,12,951,504,447,1075004.0,561889.0,513115.0,112.12,113.17,111.49,114.79
2023-08-30 12:45,47,23,24,2924,1205,1719,3308029.0,1353318.0,1954711.0,31,19,12,2327,1215,1112,2628337.0,1353130.0,1275207.0,112.31,113.71,111.37,114.68
2023-08-30 12:50,102,38,64,7825,2781,5044,8788965.0,3101911.0,5687053.0,54,23,31,5269,2544,2725,5952649.0,2834957.0,3117691.0,111.54,112.75,111.44,114.41
2023-08-30 12:55,57,29,28,3767,1931,1836,4253598.0,2157267.0,2096330.0,34,16,18,3420,1720,1700,3863376.0,1915571.0,1947804.0,111.72,114.18,111.37,114.58
2023-08-30 13:00,64,39,25,3486,1851,1635,3947812.0,2075070.0,1872741.0,43,23,20,3212,1721,1491,3617917.0,1910410.0,1707507.0,112.11,114.54,111.01,114.52
2023-08-30 13:05,95,41,54,7552,3921,3631,8577048.0,4420193.0,4156854.0,66,29,37,7266,3800,3466,8205871.0,4234399.0,3971471.0,112.73,114.48,111.43,114.58
2023-08-30 13:10,140,70,70,12367,6458,5909,13946026.0,7227380.0,6718645.0,103,51,52,11215,5767,5448,12671438.0,6431188.0,6240249.0,111.91,113.7,111.52,114.54
2023-08-30 13:15,447,41,406,13073,4166,8907,14743607.0,4634568.0,10109039.0,428,34,394,13086,4254,8832,14776700.0,4729434.0,10047265.0,111.25,113.5,111.18,113.76
2023-08-30 13:20,254,97,157,11503,5185,6318,13070882.0,5898526.0,7172356.0,215,72,143,10523,4528,5995,11882782.0,5041419.0,6841363.0,113.76,113.52,111.34,114.12
2023-08-30 13:25,111,61,50,8116,3905,4211,9175775.0,4356375.0,4819399.0,86,46,40,7936,3821,4115,8964035.0,4255461.0,4708574.0,111.56,114.45,111.37,114.42
2023-08-30 13:30,153,95,58,12784,6378,6406,14448904.0,7123144.0,7325760.0,125,79,46,12464,6302,6162,14080761.0,7020409.0,7060352.0,111.68,114.36,111.4,114.58
2023-08-30 13:35,66,31,35,4339,1743,2596,4941050.0,1951438.0,2989612.0,39,22,17,4564,1710,2854,5297543.0,1905481.0,3392061.0,111.96,115.16,111.43,118.85
2023-08-30 13:40,101,55,46,7110,3596,3514,7889112.0,4018313.0,3870799.0,73,38,35,6118,2880,3238,6903693.0,3209286.0,3694407.0,111.74,110.15,111.43,114.1
2023-08-30 13:45,52,36,16,2270,1347,923,2573703.0,1519110.0,1054593.0,25,17,8,1707,875,832,1927409.0,974431.0,952977.0,112.78,114.26,111.36,114.54
2023-08-30 13:50,87,58,29,8261,4819,3442,9389518.0,5442680.0,3946837.0,67,46,21,7770,4366,3404,8735450.0,4830574.0,3904876.0,112.94,114.67,110.64,114.71
2023-08-30 13:55,306,104,202,27561,11591,15970,31135119.0,12913487.0,18221631.0,266,83,183,26668,11166,15502,30117240.0,12427271.0,17689968.0,111.41,114.1,111.3,114.11
2023-08-30 14:00,93,39,54,9666,4541,5125,10871475.0,5053706.0,5817769.0,72,29,43,9241,4417,4824,10431159.0,4912234.0,5518924.0,111.29,113.52,111.21,114.41
2023-08-30 14:05,139,34,105,8714,3137,5577,9862307.0,3502407.0,6359899.0,120,24,96,8128,2907,5221,9187860.0,3231715.0,5956144.0,111.65,114.04,111.17,114.08
2023-08-30 14:10,73,37,36,6079,3133,2946,6874556.0,3501610.0,3372945.0,55,26,29,5821,2896,2925,6572753.0,3225287.0,3347465.0,111.77,114.49,111.37,114.44
2023-08-30 14:15,81,42,39,6745,3448,3297,7633147.0,3862179.0,3770967.0,59,30,29,6410,3253,3157,7241526.0,3624117.0,3617408.0,112.01,114.38,111.41,114.58
2023-08-30 14:20,85,34,51,6789,3313,3476,7670618.0,3695883.0,3974735.0,64,29,35,6539,3215,3324,7394168.0,3583997.0,3810171.0,111.56,114.35,111.48,114.63
2023-08-30 14:25,103,64,39,9732,5083,4649,10992867.0,5663061.0,5329805.0,90,56,34,9505,4973,4532,10740324.0,5545508.0,5194816.0,111.41,114.64,111.51,114.63
2023-08-30 14:30,436,174,262,35955,17568,18387,40547729.0,19564238.0,20983490.0,403,155,248,34294,17114,17180,38680913.0,19046333.0,19634579.0,111.36,114.12,111.29,114.29
2023-08-30 14:35,236,177,59,17815,10521,7294,20095430.0,11751758.0,8343672.0,218,171,47,17100,10070,7030,19290153.0,11241949.0,8048203.0,111.7,114.39,111.64,114.48
2023-08-30 14:40,147,65,82,11543,5308,6235,13053105.0,5933556.0,7119548.0,129,52,77,10692,5104,5588,12078327.0,5688959.0,6389368.0,111.79,114.19,111.46,114.34
2023-08-30 14:45,51,38,13,1688,859,829,1940531.0,966380.0,974150.0,30,26,4,998,786,212,1123977.0,881160.0,242816.0,112.5,117.51,112.11,114.54
2023-08-30 14:50,38,24,14,1548,792,756,1736461.0,886403.0,850058.0,21,14,7,1342,737,605,1514746.0,821205.0,693541.0,111.92,112.44,111.43,114.63
2023-08-30 14:55,36,22,14,960,534,426,1082346.0,599176.0,483169.0,22,19,3,820,569,251,924420.0,637582.0,286837.0,112.21,113.42,112.05,114.28
2023-08-30 15:00,65,47,18,2459,1411,1048,2762753.0,1579061.0,1183692.0,34,24,10,2345,1381,964,2642094.0,1539422.0,1102672.0,111.91,112.95,111.47,114.39
2023-08-30 15:05,263,81,182,26450,11366,15084,29776536.0,12625466.0,17151069.0,248,72,176,26099,11220,14879,29422478.0,12460570.0,16961908.0,111.08,113.7,111.06,114.0
2023-08-30 15:10,99,47,52,10119,5678,4441,11402490.0,6328572.0,5073918.0,86,39,47,9470,4979,4491,10672706.0,5540676.0,5132030.0,111.46,114.25,111.28,114.27
2023-08-30 15:15,51,29,22,3519,1811,1708,3979196.0,2024794.0,1954402.0,37,20,17,3742,2043,1699,4210269.0,2266298.0,1943971.0,111.81,114.43,110.93,114.42
2023-08-30 15:20,69,30,39,6328,3219,3109,7142515.0,3587770.0,3554745.0,56,26,30,7372,3200,4172,8347035.0,3565450.0,4781584.0,111.46,114.34,111.42,114.61
2023-08-30 15:25,356,94,262,30255,12226,18029,34023794.0,13575855.0,20447938.0,327,78,249,29411,11819,17592,33154605.0,13126269.0,20028336.0,111.04,113.42,111.06,113.85
2023-08-30 15:30,307,41,266,13254,3739,9515,14971810.0,4155279.0,10816530.0,289,33,256,12355,3362,8993,13923686.0,3730172.0,10193514.0,111.13,113.68,110.95,113.35
2023-08-30 15:35,341,90,251,19835,7465,12370,22342213.0,8298211.0,14044001.0,319,74,245,18921,6581,12340,21325448.0,7306715.0,14018733.0,111.16,113.53,111.03,113.6
2023-08-30 15:40,289,119,170,22983,10246,12737,25897737.0,11391331.0,14506405.0,272,110,162,23300,11000,12300,26233768.0,12221065.0,14012703.0,111.18,113.89,111.1,113.92
2023-08-30 15:45,505,120,385,31321,11952,19369,35283933.0,13274264.0,22009669.0,492,113,379,30963,11641,19322,34890968.0,12925381.0,21965587.0,111.06,113.63,111.03,113.68
2023-08-30 15:50,93,31,62,5511,2299,3212,6210473.0,2556374.0,3654099.0,80,23,57,5353,2249,3104,6033756.0,2500003.0,3533753.0,111.2,113.76,111.16,113.85
2023-08-30 15:55,46,27,19,3045,1670,1375,3429206.0,1860052.0,1569154.0,36,18,18,4890,1583,3307,5521805.0,1759359.0,3762445.0,111.38,114.12,111.14,113.77
2023-08-30 16:00,148,64,84,13561,5573,7988,15176067.0,6184634.0,8991433.0,137,60,77,12343,5559,6784,13892615.0,6166074.0,7726541.0,110.97,112.56,110.92,113.89
2023-08-30 16:05,107,52,55,9477,4561,4916,10671057.0,5065308.0,5605748.0,81,37,44,9414,4684,4730,10592456.0,5194852.0,5397603.0,111.06,114.03,110.91,114.11
2023-08-30 16:10,67,37,30,7162,2249,4913,8451242.0,2500123.0,5951119.0,48,23,25,6561,1883,4678,7678993.0,2088618.0,5590374.0,111.17,121.13,110.92,119.5
2023-08-30 16:15,38,26,12,1568,683,885,1767142.0,772380.0,994761.0,29,16,13,1739,684,1055,1956754.0,760949.0,1195805.0,113.09,112.4,111.25,113.35
2023-08-30 16:20,49,30,19,2413,1232,1181,2726475.0,1379352.0,1347122.0,33,14,19,2574,1095,1479,2909500.0,1216594.0,1692906.0,111.96,114.07,111.1,114.46
2023-08-30 16:25,237,152,85,18288,10357,7931,20769296.0,11706689.0,9062607.0,176,102,74,16655,8854,7801,18780098.0,9862356.0,8917742.0,113.03,114.27,111.39,114.32
2023-08-30 16:30,71,45,26,3340,1982,1358,3782783.0,2232683.0,1550099.0,37,22,15,2319,1347,972,2619107.0,1504734.0,1114372.0,112.65,114.15,111.71,114.65
2023-08-30 16:35,116,63,53,9150,4505,4645,10320469.0,5034931.0,5285538.0,75,35,40,8543,4081,4462,9662547.0,4547205.0,5115342.0,111.76,113.79,111.42,114.64
2023-08-30 16:40,134,75,59,10723,5836,4887,12148788.0,6555913.0,5592875.0,103,62,41,9489,5184,4305,10723510.0,5784744.0,4938765.0,112.34,114.44,111.59,114.72
2023-08-30 16:45,105,76,29,7046,4642,2404,7969308.0,5208160.0,2761147.0,91,70,21,6795,4727,2068,7669779.0,5295354.0,2374424.0,112.2,114.86,112.02,114.82
2023-08-30 16:50,85,41,44,6429,3121,3308,7258050.0,3481963.0,3776086.0,65,36,29,5624,2943,2681,6352724.0,3280119.0,3072604.0,111.57,114.15,111.45,114.61
2023-08-30 16:55,249,156,93,17992,10657,7335,20212759.0,11904934.0,8307824.0,227,147,80,17886,10849,7037,20159469.0,12116289.0,8043180.0,111.71,113.26,111.68,114.3
2023-08-30 17:00,345,221,124,31225,18373,12852,35273673.0,20603821.0,14669851.0,311,202,109,30270,17735,12535,34133162.0,19797144.0,14336017.0,112.14,114.14,111.63,114.37
2023-08-30 17:05,378,335,43,18963,14196,4767,21374858.0,15942433.0,5432425.0,362,329,33,17729,14290,3439,19975035.0,16042363.0,3932671.0,112.3,113.96,112.26,114.36
2023-08-30 17:10,141,95,46,9190,5534,3656,10373881.0,6196541.0,4177340.0,121,91,30,8846,5500,3346,9964548.0,6138925.0,3825623.0,111.97,114.26,111.62,114.33
2023-08-30 17:15,80,49,31,6280,3690,2590,7083624.0,4125804.0,2957819.0,66,40,26,5716,3236,2480,6442093.0,3604873.0,2837220.0,111.81,114.2,111.4,114.4
2023-08-30 17:20,41,21,20,1355,789,566,1525669.0,881666.0,644003.0,24,13,11,1035,588,447,1169364.0,655788.0,513576.0,111.74,113.78,111.53,114.89
2023-08-30 17:25,120,66,54,8772,4622,4150,9872426.0,5149636.0,4722790.0,97,56,41,8762,4560,4202,9870532.0,5077993.0,4792539.0,111.42,113.8,111.36,114.05
2023-08-30 17:30,110,61,49,9563,4765,4798,10797287.0,5324633.0,5472654.0,93,51,42,9236,4536,4700,10404254.0,5040447.0,5363806.0,111.74,114.06,111.12,114.12
2023-08-30 17:35,213,140,73,20931,11530,9401,23591076.0,12849486.0,10741590.0,188,124,64,20166,11027,9139,22746842.0,12280628.0,10466213.0,111.44,114.26,111.37,114.52
2023-08-30 17:40,159,67,92,12497,5764,6733,14083634.0,6436399.0,7647234.0,142,58,84,12070,5659,6411,13616566.0,6299026.0,7317540.0,111.67,113.58,111.31,114.14
2023-08-30 17:45,124,62,62,9947,4828,5119,11166986.0,5395670.0,5771315.0,108,54,54,9439,4664,4775,10636597.0,5185950.0,5450646.0,111.76,112.74,111.19,114.15
2023-08-30 17:50,69,41,28,4919,2614,2305,5542085.0,2913972.0,2628112.0,55,32,23,4506,2308,2198,5081540.0,2568323.0,2513217.0,111.48,114.02,111.28,114.34
2023-08-30 17:55,63,34,29,3988,2089,1899,4482192.0,2324163.0,2158028.0,56,32,24,4611,2009,2602,5199728.0,2236681.0,2963046.0,111.26,113.64,111.33,113.88
2023-08-30 18:00,89,48,41,6340,3384,2956,7136281.0,3768119.0,3368162.0,69,40,29,6240,3339,2901,7030726.0,3713863.0,3316863.0,111.35,113.94,111.23,114.34
2023-08-30 18:05,94,57,37,8142,4314,3828,9182127.0,4806600.0,4375527.0,80,42,38,8121,3973,4148,9169851.0,4417181.0,4752670.0,111.42,114.3,111.18,114.58
2023-08-30 18:10,71,37,34,6374,3554,2820,7210470.0,3989829.0,3220640.0,64,36,28,5926,3037,2889,6683572.0,3380566.0,3303006.0,112.26,114.21,111.31,114.33
2023-08-30 18:15,32,16,16,1836,476,1360,2068690.0,533597.0,1535093.0,26,13,13,1254,754,500,1389977.0,818879.0,571098.0,112.1,112.87,108.6,114.22
2023-08-30 18:20,69,30,39,2761,1360,1401,3112750.0,1548755.0,1563995.0,46,21,25,1431,769,662,1613717.0,859490.0,754227.0,113.88,111.63,111.77,113.93
2023-08-30 18:25,48,27,21,1886,1080,806,2131403.0,1212295.0,919108.0,32,16,16,1519,783,736,1712683.0,872289.0,840393.0,112.25,114.03,111.4,114.18
2023-08-30 18:30,71,45,26,2465,1369,1096,2796479.0,1555335.0,1241144.0,49,29,20,3058,1354,1704,3458311.0,1515507.0,1942803.0,113.61,113.24,111.93,114.01
2023-08-30 18:35,71,43,28,2593,1847,746,2937498.0,2085575.0,851922.0,66,42,24,2355,1608,747,2647713.0,1800070.0,847643.0,112.92,114.2,111.94,113.47
2023-08-31 10:00,1368,629,739,53517,28766,24751,63893759.0,32016550.0,31877208.0,641,483,158,30160,24281,5879,34077586.0,27387134.0,6690451.0,111.3,128.79,112.79,113.8
2023-08-31 10:05,322,49,273,12354,1323,11031,14224483.0,1476511.0,12747972.0,220,19,201,8256,554,7702,9374039.0,621909.0,8752129.0,111.6,115.56,112.26,113.63
2023-08-31 10:10,196,41,155,7066,1882,5184,7930483.0,1943418.0,5987064.0,121,11,110,3949,306,3643,4473260.0,334889.0,4138371.0,103.26,115.49,109.44,113.6
2023-08-31 10:15,102,40,62,8948,4089,4859,10305486.0,4463254.0,5842232.0,48,17,31,5358,3035,2323,5885858.0,3229010.0,2656848.0,109.15,120.24,106.39,114.37
2023-08-31 10:20,284,145,139,5821,2048,3773,7625257.0,2280666.0,5344591.0,46,12,34,3255,1439,1816,3679194.0,1602432.0,2076761.0,111.36,141.65,111.36,114.36
2023-08-31 10:25,93,38,55,11974,6992,4982,13558121.0,7833407.0,5724714.0,50,20,30,9056,6498,2558,10190021.0,7264007.0,2926013.0,112.03,114.91,111.79,114.39
2023-08-31 10:30,183,74,109,15881,7127,8754,17976888.0,7966366.0,10010522.0,126,53,73,14298,6775,7523,16149947.0,7540619.0,8609327.0,111.78,114.35,111.3,114.44
2023-08-31 10:35,182,52,130,9959,3861,6098,11227754.0,4315181.0,6912573.0,135,21,114,8895,3056,5839,10046568.0,3399307.0,6647260.0,111.76,113.36,111.23,113.84
2023-08-31 10:40,131,53,78,12928,5619,7309,14722002.0,6301001.0,8421000.0,88,36,52,10729,5430,5299,12122129.0,6048522.0,6073607.0,112.14,115.21,111.39,114.62
2023-08-31 10:45,109,47,62,9281,4448,4833,10446585.0,4964563.0,5482022.0,77,30,47,8479,4097,4382,9580841.0,4558015.0,5022826.0,111.61,113.43,111.25,114.62
2023-08-31 10:50,76,36,40,5158,2515,2643,5834893.0,2798887.0,3036006.0,55,23,32,5717,2274,3443,6453507.0,2528633.0,3924874.0,111.29,114.87,111.2,114.0
2023-08-31 10:55,97,48,49,8054,3770,4284,9107115.0,4193063.0,4914052.0,67,33,34,7394,3561,3833,8336513.0,3957834.0,4378679.0,111.22,114.71,111.14,114.24
2023-08-31 11:00,102,44,58,7560,3465,4095,8478309.0,3860098.0,4618211.0,65,23,42,6640,3024,3616,7491476.0,3360445.0,4131031.0,111.4,112.78,111.13,114.24
2023-08-31 11:05,405,158,247,41293,19455,21838,46324561.0,21582138.0,24742423.0,320,101,219,37547,16479,21068,42222254.0,18264463.0,23957791.0,110.93,113.3,110.83,113.72
2023-08-31 11:10,153,55,98,9158,3896,5262,10235069.0,4317435.0,5917633.0,113,30,83,9050,4103,4947,10173956.0,4552264.0,5621691.0,110.82,112.46,110.95,113.64
2023-08-31 11:15,106,62,44,8502,4409,4093,9547231.0,4896821.0,4650409.0,63,29,34,8019,3528,4491,9054479.0,3909778.0,5144701.0,111.06,113.62,110.82,114.56
2023-08-31 11:20,184,72,112,14616,7099,7517,16463374.0,7889139.0,8574234.0,144,53,91,14248,6887,7361,16031154.0,7637467.0,8393686.0,111.13,114.06,110.9,114.03
2023-08-31 11:25,60,29,31,4148,1984,2164,4685044.0,2209232.0,2475812.0,30,13,17,3316,1608,1708,3734373.0,1784026.0,1950347.0,111.35,114.41,110.95,114.19
2023-08-31 11:30,79,37,42,6095,3100,2995,6858800.0,3444778.0,3414021.0,51,23,28,5946,2902,3044,6691477.0,3218913.0,3472563.0,111.12,113.99,110.92,114.08
2023-08-31 11:35,57,29,28,3883,2132,1751,4328755.0,2362299.0,1966456.0,43,22,21,3005,1481,1524,3381130.0,1642323.0,1738807.0,110.8,112.3,110.89,114.09
2023-08-31 11:40,60,35,25,4067,1868,2199,4589463.0,2072605.0,2516857.0,35,18,17,3792,1815,1977,4270597.0,2012677.0,2257920.0,110.95,114.45,110.89,114.21
2023-08-31 11:45,47,23,24,3025,1433,1592,3396807.0,1588580.0,1808227.0,28,12,16,2928,1418,1510,3293644.0,1571409.0,1722234.0,110.86,113.58,110.82,114.06
2023-08-31 11:50,61,32,29,5397,2694,2703,6075389.0,2989568.0,3085821.0,41,20,21,5497,2622,2875,6186158.0,2906949.0,3279209.0,110.97,114.16,110.87,114.06
2023-08-31 11:55,48,29,19,1986,1020,966,2245759.0,1136341.0,1109418.0,42,24,18,1955,952,1003,2200243.0,1057252.0,1142991.0,111.41,114.85,111.06,113.96
2023-08-31 12:00,65,25,40,5481,2343,3138,6172486.0,2606789.0,3565696.0,45,20,25,4774,2282,2492,5385756.0,2530650.0,2855106.0,111.26,113.63,110.9,114.57
2023-08-31 12:05,49,17,32,2923,1148,1775,3313404.0,1273878.0,2039525.0,33,12,21,2462,1144,1318,2767438.0,1268217.0,1499220.0,110.97,114.9,110.86,113.75
2023-08-31 12:10,49,16,33,2414,1155,1259,2600599.0,1278264.0,1322335.0,31,8,23,1807,620,1187,2035148.0,686644.0,1348503.0,110.67,105.03,110.75,113.61
2023-08-31 12:15,82,41,41,6503,3317,3186,8931196.0,3682864.0,5248331.0,59,26,33,5846,3065,2781,8226994.0,3399405.0,4827589.0,111.03,164.73,110.91,173.59
2023-08-31 12:20,48,23,25,3859,1926,1933,4322660.0,2138152.0,2184508.0,36,16,20,3437,1730,1707,3864932.0,1918251.0,1946681.0,111.02,113.01,110.88,114.04
2023-08-31 12:25,71,36,35,5522,2649,2873,6169197.0,2951734.0,3217462.0,49,25,24,5095,2493,2602,5727550.0,2760329.0,2967221.0,111.43,111.99,110.72,114.04
2023-08-31 12:30,82,42,40,5504,2777,2727,6211389.0,3108207.0,3103181.0,47,21,26,4868,2399,2469,5475458.0,2660884.0,2814574.0,111.93,113.79,110.92,114.0
2023-08-31 12:35,130,60,70,11801,5631,6170,13139801.0,6283141.0,6856660.0,90,39,51,10834,5317,5517,12190758.0,5899544.0,6291213.0,111.58,111.13,110.96,114.03
2023-08-31 12:40,83,31,52,6380,3279,3101,7163549.0,3634983.0,3528565.0,62,22,40,5649,2610,3039,6352117.0,2893548.0,3458568.0,110.86,113.79,110.86,113.81
2023-08-31 12:45,53,25,28,4487,2070,2417,5031235.0,2295033.0,2736202.0,40,15,25,4403,2017,2386,4952214.0,2233876.0,2718337.0,110.87,113.21,110.75,113.93
2023-08-31 12:50,148,62,86,9590,4697,4893,10868883.0,5304204.0,5564678.0,118,40,78,8323,3597,4726,9359186.0,3989059.0,5370126.0,112.93,113.73,110.9,113.63
2023-08-31 12:55,100,42,58,8197,4342,3855,9274657.0,4873945.0,4400712.0,68,27,41,7064,3589,3475,7953819.0,3995233.0,3958586.0,112.25,114.16,111.32,113.92
2023-08-31 13:00,71,38,33,5584,3205,2379,6308050.0,3595642.0,2712408.0,40,24,16,4604,2635,1969,5188954.0,2938235.0,2250719.0,112.19,114.01,111.51,114.31
2023-08-31 13:05,39,20,19,1275,640,635,1446753.0,718183.0,728570.0,22,9,13,1348,532,816,1522234.0,593796.0,928437.0,112.22,114.74,111.62,113.78
2023-08-31 13:10,949,646,303,81874,48533,33341,93842696.0,55569064.0,38273632.0,609,424,185,69550,40587,28963,78895400.0,45582642.0,33312758.0,114.5,114.79,112.31,115.02
2023-08-31 13:15,613,370,243,51458,26300,25158,58902719.0,29699382.0,29203336.0,402,234,168,46501,24322,22179,53244027.0,27347109.0,25896917.0,112.93,116.08,112.44,116.76
2023-08-31 13:20,344,140,204,21358,9823,11535,24316634.0,11085505.0,13231129.0,271,115,156,20406,9495,10911,23194734.0,10672686.0,12522048.0,112.85,114.7,112.4,114.77
2023-08-31 13:25,1045,875,170,65784,48015,17769,74764849.0,54330765.0,20434084.0,956,839,117,62675,46781,15894,71194778.0,52888380.0,18306397.0,113.15,115.0,113.06,115.18
2023-08-31 13:30,96,51,45,7300,3732,3568,8214822.0,4187134.0,4027687.0,60,33,27,5743,2950,2793,6515856.0,3301627.0,3214228.0,112.2,112.88,111.92,115.08
2023-08-31 13:35,115,59,56,11380,4562,6818,12910640.0,5130778.0,7779862.0,86,39,47,10431,4323,6108,11843534.0,4839006.0,7004528.0,112.47,114.11,111.94,114.68
2023-08-31 13:40,61,39,22,3592,1604,1988,4079376.0,1804947.0,2274429.0,46,26,20,3698,1691,2007,4206134.0,1889252.0,2316881.0,112.53,114.41,111.72,115.44
2023-08-31 13:45,71,39,32,7800,3870,3930,8910195.0,4363967.0,4546228.0,46,26,20,5968,3253,2715,6768407.0,3648427.0,3119979.0,112.76,115.68,112.16,114.92
2023-08-31 13:50,35,18,17,1117,560,557,1279130.0,637678.0,641452.0,14,9,5,850,447,403,964827.0,500458.0,464369.0,113.87,115.16,111.96,115.23
2023-08-31 13:55,41,23,18,2773,903,1870,3186456.0,1014269.0,2172186.0,26,13,13,2139,784,1355,2455792.0,879013.0,1576778.0,112.32,116.16,112.12,116.37
2023-08-31 14:00,161,66,95,14675,5916,8759,16623049.0,6611957.0,10011091.0,128,49,79,13707,5392,8315,15530402.0,6020846.0,9509555.0,111.76,114.29,111.66,114.37
2023-08-31 14:05,89,48,41,8532,4584,3948,9658396.0,5131949.0,4526447.0,65,36,29,7487,3785,3702,8474899.0,4226796.0,4248102.0,111.95,114.65,111.67,114.75
2023-08-31 14:10,95,42,53,9841,3693,6148,11435042.0,4129192.0,7305850.0,81,34,47,10130,3714,6416,11751753.0,4145894.0,7605859.0,111.81,118.83,111.63,118.55
2023-08-31 14:15,229,55,174,16184,6325,9859,18380224.0,7113645.0,11266579.0,205,42,163,13983,4442,9541,15877848.0,4975550.0,10902298.0,112.47,114.28,112.01,114.27
2023-08-31 14:20,120,40,80,9672,3799,5873,10884185.0,4259462.0,6624723.0,86,32,54,10462,3627,6835,12162290.0,4063993.0,8098297.0,112.12,112.8,112.05,118.48
2023-08-31 14:25,469,87,382,39566,13537,26029,44975917.0,15183782.0,29792135.0,464,82,382,39314,13188,26126,44671454.0,14769139.0,29902315.0,112.17,114.46,111.99,114.45
2023-08-31 14:30,406,38,368,19266,3223,16043,21892817.0,3612569.0,18280248.0,394,32,362,18736,3066,15670,21294277.0,3435677.0,17858600.0,112.09,113.95,112.06,113.97
2023-08-31 14:35,324,8,316,14432,221,14211,16410926.0,247256.0,16163669.0,323,11,312,15170,844,14326,17245232.0,950832.0,16294400.0,111.88,113.74,112.66,113.74
2023-08-31 14:40,481,37,444,22784,2547,20237,25939820.0,2928613.0,23011207.0,466,27,439,22364,2247,20117,25421099.0,2517889.0,22903210.0,114.98,113.71,112.06,113.85
2023-08-31 14:45,176,107,69,12662,6316,6346,14368203.0,7090200.0,7278003.0,144,93,51,11139,5810,5329,12647796.0,6518703.0,6129093.0,112.26,114.69,112.2,115.01
2023-08-31 14:50,80,44,36,6093,2910,3183,6921023.0,3271276.0,3649747.0,68,38,30,5430,2532,2898,6163906.0,2832174.0,3331732.0,112.41,114.66,111.86,114.97
2023-08-31 14:55,102,53,49,7882,4028,3854,8908246.0,4493350.0,4414895.0,78,39,39,7690,3714,3976,8705453.0,4140849.0,4564603.0,111.55,114.55,111.49,114.8
2023-08-31 15:00,44,28,16,3053,1374,1679,3489825.0,1541159.0,1948666.0,28,17,11,2517,1298,1219,2852479.0,1450652.0,1401827.0,112.17,116.06,111.76,115.0
2023-08-31 15:05,60,40,20,5024,3131,1893,5717770.0,3542292.0,2175477.0,53,33,20,4549,2607,1942,5157230.0,2923744.0,2233485.0,113.14,114.92,112.15,115.01
2023-08-31 15:10,76,36,40,5860,3107,2753,6618556.0,3482120.0,3136435.0,55,29,26,5751,3311,2440,6519008.0,3714128.0,2804879.0,112.07,113.93,112.18,114.95
2023-08-31 15:15,59,30,29,4575,2411,2164,5193729.0,2712150.0,2481578.0,53,28,25,4141,2340,1801,4691306.0,2622062.0,2069244.0,112.49,114.68,112.05,114.89
2023-08-31 15:20,26,12,14,842,371,471,953275.0,416677.0,536597.0,19,12,7,764,380,384,866056.0,427000.0,439056.0,112.31,113.93,112.37,114.34
2023-08-31 15:25,56,27,29,3844,1889,1955,4369452.0,2117027.0,2252424.0,44,24,20,3636,1828,1808,4121503.0,2044689.0,2076814.0,112.07,115.21,111.85,114.87
2023-08-31 15:30,56,25,31,3148,1485,1663,3565591.0,1663384.0,1902207.0,47,22,25,3061,1476,1585,3470434.0,1652099.0,1818335.0,112.01,114.38,111.93,114.72
2023-08-31 15:35,65,32,33,3720,2102,1618,4201680.0,2356264.0,1845416.0,49,27,22,3501,1967,1534,3967980.0,2204940.0,1763040.0,112.1,114.06,112.1,114.93
2023-08-31 15:40,30,15,15,1735,755,980,1986529.0,856122.0,1130407.0,18,9,9,1388,642,746,1574184.0,717714.0,856469.0,113.39,115.35,111.79,114.81
2023-08-31 15:45,48,25,23,2561,1179,1382,2913303.0,1329029.0,1584273.0,32,15,17,2481,1144,1337,2819157.0,1279762.0,1539394.0,112.73,114.64,111.87,115.14
2023-08-31 15:50,48,21,27,3489,1754,1735,3966799.0,1975672.0,1991127.0,31,16,15,4306,2679,1627,4851515.0,2980795.0,1870719.0,112.64,114.76,111.27,114.98
2023-08-31 15:55,46,25,21,3103,1642,1461,3522261.0,1842897.0,1679363.0,37,17,20,3366,1720,1646,3815534.0,1922892.0,1892641.0,112.23,114.95,111.8,114.98
2023-08-31 16:00,347,41,306,17530,3479,14051,19906467.0,3913167.0,15993299.0,334,32,302,16378,2335,14043,18597771.0,2613825.0,15983945.0,112.48,113.82,111.94,113.82
2023-08-31 16:05,463,23,440,20729,1059,19670,23297337.0,1193223.0,22104114.0,445,17,428,19719,1017,18702,22399395.0,1139854.0,21259541.0,112.67,112.37,112.08,113.68
2023-08-31 16:10,263,111,152,19935,8680,11255,23145576.0,9990497.0,13155079.0,230,85,145,18500,7621,10879,21276996.0,8548482.0,12728514.0,115.1,116.88,112.17,117.0
2023-08-31 16:15,188,86,102,16843,8223,8620,19170856.0,9218886.0,9951970.0,164,76,88,15910,7953,7957,18104281.0,8909214.0,9195067.0,112.11,115.45,112.02,115.56
2023-08-31 16:20,121,54,67,9022,4637,4385,10240064.0,5211878.0,5028185.0,94,44,50,8719,4523,4196,9903651.0,5072007.0,4831643.0,112.4,114.67,112.14,115.15
2023-08-31 16:25,73,40,33,6154,3027,3127,6997228.0,3390551.0,3606677.0,58,34,24,5929,3013,2916,6732293.0,3373120.0,3359173.0,112.01,115.34,111.95,115.2
2023-08-31 16:30,798,80,718,43535,8320,35215,49293614.0,9313996.0,39979617.0,762,60,702,42504,8101,34403,48255676.0,9052839.0,39202837.0,111.95,113.53,111.75,113.95
2023-08-31 16:35,682,21,661,36627,3264,33363,41573202.0,3643975.0,37929226.0,681,21,660,36560,3224,33336,41511185.0,3600206.0,37910979.0,111.64,113.69,111.67,113.72
2023-08-31 16:40,155,51,104,12073,5721,6352,13675135.0,6392216.0,7282918.0,133,32,101,11799,5491,6308,13380749.0,6127983.0,7252765.0,111.73,114.66,111.6,114.98
2023-08-31 16:45,137,47,90,12833,5384,7449,14305776.0,6012939.0,8292836.0,94,32,62,10547,4758,5789,11936899.0,5301459.0,6635439.0,111.68,111.33,111.42,114.62
2023-08-31 16:50,54,14,40,3676,1250,2426,4158819.0,1393323.0,2765496.0,43,12,31,3264,1234,2030,3702344.0,1374757.0,2327586.0,111.47,113.99,111.41,114.66
2023-08-31 16:55,54,23,31,4944,2275,2669,5594972.0,2543323.0,3051648.0,42,13,29,4676,1883,2793,5292013.0,2100193.0,3191820.0,111.79,114.34,111.53,114.28
2023-08-31 17:00,30,14,16,2232,986,1246,2536088.0,1102383.0,1433704.0,26,10,16,2274,1061,1213,2572848.0,1185931.0,1386916.0,111.8,115.06,111.77,114.34
2023-08-31 17:05,159,23,136,9091,2368,6723,10299469.0,2648621.0,7650848.0,147,18,129,8748,1948,6800,9913616.0,2174771.0,7738844.0,111.85,113.8,111.64,113.81
2023-08-31 17:10,48,15,33,3080,953,2127,3509796.0,1066362.0,2443434.0,36,8,28,2672,851,1821,3028650.0,949579.0,2079070.0,111.9,114.88,111.58,114.17
2023-08-31 17:15,56,15,41,3802,1250,2552,4312981.0,1400089.0,2912892.0,44,8,36,3472,1009,2463,3937719.0,1126635.0,2811084.0,112.01,114.14,111.66,114.13
2023-08-31 17:20,83,24,59,5451,1564,3887,6189961.0,1751356.0,4438605.0,66,15,51,4783,1477,3306,5419905.0,1646376.0,3773529.0,111.98,114.19,111.47,114.14
2023-08-31 17:25,41,10,31,4592,666,3926,5498012.0,761685.0,4736326.0,30,5,25,2196,602,1594,2501504.0,672148.0,1829355.0,114.37,120.64,111.65,114.77
2023-08-31 17:30,92,21,71,7111,2176,4935,8063557.0,2432475.0,5631082.0,83,17,66,6853,2054,4799,7771203.0,2293680.0,5477523.0,111.79,114.11,111.67,114.14
2023-08-31 17:35,38,9,29,1993,470,1523,2263787.0,528334.0,1735452.0,40,7,33,2078,413,1665,2360758.0,461101.0,1899657.0,112.41,113.95,111.65,114.09
2023-08-31 17:40,65,24,41,4535,1847,2688,5150020.0,2078784.0,3071236.0,53,15,38,4164,1502,2662,4722976.0,1681463.0,3041512.0,112.55,114.26,111.95,114.26
2023-08-31 17:45,81,30,51,7442,3109,4333,8406466.0,3489083.0,4917382.0,64,22,42,8687,2947,5740,10120658.0,3292522.0,6828135.0,112.23,113.49,111.72,118.96
2023-08-31 17:50,66,24,42,5013,1971,3042,5677226.0,2200654.0,3476572.0,49,17,32,5191,1966,3225,5879156.0,2194542.0,3684614.0,111.65,114.29,111.62,114.25
2023-08-31 17:55,77,37,40,7663,3444,4219,8512280.0,3848447.0,4663832.0,57,25,32,6854,3162,3692,7752953.0,3527163.0,4225790.0,111.74,110.54,111.55,114.46
2023-08-31 18:00,31,13,18,1922,927,995,2173664.0,1031876.0,1141788.0,27,12,15,1716,850,866,1943253.0,947917.0,995335.0,111.31,114.75,111.52,114.93
2023-08-31 18:05,34,16,18,2599,1113,1486,2940036.0,1241803.0,1698233.0,23,10,13,2120,1005,1115,2397705.0,1119685.0,1278020.0,111.57,114.28,111.41,114.62
2023-08-31 18:10,51,22,29,3379,1615,1764,3826409.0,1809691.0,2016717.0,38,14,24,2990,1439,1551,3381463.0,1606213.0,1775250.0,112.06,114.33,111.62,114.46
2023-08-31 18:15,24,12,12,241,44,197,278937.0,57077.0,221860.0,8,2,6,150,2,148,173046.0,2231.0,170814.0,129.72,112.62,111.56,115.42
2023-08-31 18:20,68,34,34,6294,2510,3784,7101058.0,2801393.0,4299664.0,51,23,28,5212,2315,2897,5895651.0,2582115.0,3313536.0,111.61,113.63,111.54,114.38
2023-08-31 18:25,79,39,40,6098,3068,3030,6922072.0,3445576.0,3476496.0,66,30,36,5667,2642,3025,6407385.0,2946434.0,3460950.0,112.31,114.74,111.52,114.41
2023-08-31 18:30,45,18,27,2784,1363,1421,3145715.0,1523030.0,1622684.0,31,14,17,2785,1420,1365,3147363.0,1584407.0,1562956.0,111.74,114.19,111.58,114.5
2023-08-31 18:35,51,25,26,1145,397,748,1254570.0,447013.0,807557.0,29,9,20,1165,309,856,1320578.0,347657.0,972920.0,112.6,107.96,112.51,113.66
2023-09-01 10:00,1148,196,952,43516,9798,33718,51592131.0,10519233.0,41072898.0,503,58,445,20685,1627,19058,23486250.0,1833863.0,21652386.0,107.36,121.81,112.71,113.61
2023-09-01 10:05,793,325,468,34274,16832,17442,40334172.0,20107972.0,20226200.0,303,163,140,11458,7078,4380,13013547.0,7997183.0,5016363.0,119.46,115.96,112.99,114.53
2023-09-01 10:10,410,185,225,13653,6336,7317,15782980.0,7455644.0,8327336.0,140,75,65,5210,2731,2479,5961013.0,3099879.0,2861133.0,117.67,113.81,113.51,115.41
2023-09-01 10:15,850,526,324,55763,30477,25286,64064068.0,34547924.0,29516144.0,475,344,131,46534,28230,18304,53186239.0,31962621.0,21223617.0,113.36,116.73,113.22,115.95
2023-09-01 10:20,890,649,241,57601,41785,15816,66362011.0,48211339.0,18150672.0,654,567,87,49945,36020,13925,57472080.0,41046789.0,16425290.0,115.38,114.76,113.96,117.96
2023-09-01 10:25,622,219,403,50865,18866,31999,58448632.0,21481400.0,36967231.0,458,140,318,44018,16599,27419,50448823.0,18748690.0,31700133.0,113.86,115.53,112.95,115.61
2023-09-01 10:30,783,395,388,66873,36295,30578,77172712.0,41905747.0,35266964.0,404,231,173,55332,30601,24731,63596205.0,34745873.0,28850331.0,115.46,115.33,113.54,116.66
2023-09-01 10:35,537,156,381,34067,11612,22455,39263759.0,13358781.0,25904977.0,391,86,305,30626,9621,21005,35289469.0,10915143.0,24374326.0,115.04,115.36,113.45,116.04
2023-09-01 10:40,539,201,338,37728,16078,21650,42876540.0,18348977.0,24527563.0,383,121,262,30970,13337,17633,35443467.0,15053469.0,20389998.0,114.12,113.29,112.87,115.64
2023-09-01 10:45,310,148,162,26688,13814,12874,30505081.0,15669067.0,14836014.0,206,90,116,23561,12642,10919,26940063.0,14289779.0,12650284.0,113.43,115.24,113.03,115.86
2023-09-01 10:50,262,167,95,20542,11131,9411,23587061.0,12642313.0,10944747.0,191,137,54,19704,11440,8264,22585421.0,12971083.0,9614338.0,113.58,116.3,113.38,116.34
2023-09-01 10:55,148,65,83,9215,4355,4860,12074015.0,6441674.0,5632340.0,91,53,38,7135,3556,3579,8186228.0,4025795.0,4160433.0,147.91,115.89,113.21,116.25
2023-09-01 11:00,158,71,87,9277,4536,4741,10609218.0,5166072.0,5443145.0,100,58,42,7888,4094,3794,9048485.0,4634382.0,4414102.0,113.89,114.81,113.2,116.34
2023-09-01 11:05,253,102,151,21490,9753,11737,24476451.0,11028361.0,13448090.0,172,66,106,19489,9023,10466,22293189.0,10169714.0,12123475.0,113.08,114.58,112.71,115.84
2023-09-01 11:10,300,83,217,20104,9070,11034,22920122.0,10220273.0,12699848.0,243,53,190,19043,8377,10666,21748634.0,9424584.0,12324050.0,112.68,115.1,112.51,115.55
2023-09-01 11:15,133,48,85,9900,4420,5480,11343960.0,4990700.0,6353260.0,95,34,61,9025,4137,4888,10322647.0,4662025.0,5660621.0,112.91,115.94,112.69,115.81
2023-09-01 11:20,75,34,41,5962,2940,3022,6810680.0,3337261.0,3473418.0,50,24,26,5197,2671,2526,5945512.0,3014595.0,2930916.0,113.51,114.94,112.86,116.03
2023-09-01 11:25,161,60,101,13754,5955,7799,15751438.0,6725230.0,9026208.0,120,39,81,13042,5664,7378,14926094.0,6384608.0,8541486.0,112.93,115.74,112.72,115.77
2023-09-01 11:30,94,41,53,5983,2347,3636,6869897.0,2665280.0,4204617.0,59,24,35,4356,2097,2259,4979222.0,2364300.0,2614922.0,113.56,115.64,112.75,115.76
2023-09-01 11:35,131,56,75,9365,4332,5033,10798861.0,5010403.0,5788458.0,86,24,62,7426,3520,3906,8484839.0,3966043.0,4518795.0,115.66,115.01,112.67,115.69
2023-09-01 11:40,95,53,42,6376,3233,3143,7338599.0,3700523.0,3638075.0,50,25,25,5417,2734,2683,6180782.0,3074273.0,3106509.0,114.46,115.75,112.45,115.78
2023-09-01 11:45,103,47,56,6389,3124,3265,7315742.0,3561383.0,3754358.0,55,18,37,5129,2409,2720,5855496.0,2708978.0,3146518.0,114.0,114.99,112.45,115.68
2023-09-01 11:50,56,31,25,2897,1695,1202,3343121.0,1952791.0,1390329.0,36,13,23,2452,1122,1330,2798185.0,1261168.0,1537017.0,115.21,115.67,112.4,115.57
2023-09-01 11:55,99,41,58,4487,2041,2446,5117496.0,2309465.0,2808031.0,75,31,44,3629,1653,1976,4148105.0,1863975.0,2284130.0,113.15,114.8,112.76,115.59
2023-09-01 12:00,90,30,60,5365,1868,3497,6069679.0,2109516.0,3960163.0,53,18,35,4314,1666,2648,4953183.0,1874595.0,3078587.0,112.93,113.24,112.52,116.26
2023-09-01 12:05,291,150,141,22807,10451,12356,25599463.0,11752647.0,13846816.0,198,98,100,19681,9123,10558,22337518.0,10219466.0,12118052.0,112.45,112.07,112.02,114.78
2023-09-01 12:10,162,74,88,12167,6148,6019,13815278.0,6898162.0,6917116.0,117,51,66,11404,5200,6204,12963409.0,5825325.0,7138084.0,112.2,114.92,112.03,115.06
2023-09-01 12:15,128,62,66,9244,4859,4385,10533315.0,5485480.0,5047834.0,86,32,54,8413,4138,4275,9563161.0,4638420.0,4924741.0,112.89,115.12,112.09,115.2
2023-09-01 12:20,32,22,10,1683,633,1050,1918231.0,706697.0,1211534.0,18,11,7,1453,1023,430,1647956.0,1151454.0,496501.0,111.64,115.38,112.56,115.47
2023-09-01 12:25,106,57,49,9054,4847,4207,10345756.0,5488238.0,4857518.0,73,40,33,8668,4105,4563,9882698.0,4612147.0,5270551.0,113.23,115.46,112.35,115.51
2023-09-01 12:30,54,19,35,4586,1540,3046,5284365.0,1734004.0,3550360.0,32,12,20,3093,1418,1675,3524729.0,1591684.0,1933044.0,112.6,116.56,112.25,115.41
2023-09-01 12:35,76,35,41,6714,3252,3462,7602874.0,3663287.0,3939586.0,55,22,33,5873,2773,3100,6699507.0,3113819.0,3585688.0,112.65,113.8,112.29,115.67
2023-09-01 12:40,71,30,41,5790,2516,3274,6598783.0,2827428.0,3771355.0,58,21,37,5823,2489,3334,6635908.0,2794408.0,3841499.0,112.38,115.19,112.27,115.22
2023-09-01 12:45,63,35,28,3700,1809,1891,4210409.0,2033909.0,2176500.0,32,18,14,3445,1766,1679,3921257.0,1982327.0,1938930.0,112.43,115.1,112.25,115.48
2023-09-01 12:50,134,64,70,11190,5340,5850,12748747.0,6011392.0,6737354.0,106,34,72,10798,4683,6115,12299055.0,5254301.0,7044754.0,112.57,115.17,112.2,115.2
2023-09-01 12:55,109,46,63,10864,5162,5702,12387527.0,5817735.0,6569792.0,80,34,46,10054,4887,5167,11456338.0,5489486.0,5966852.0,112.7,115.22,112.33,115.48
2023-09-01 13:00,108,53,55,10553,5165,5388,12031510.0,5822159.0,6209351.0,89,48,41,10041,5090,4951,11437148.0,5722829.0,5714318.0,112.72,115.24,112.43,115.42
2023-09-01 13:05,86,37,49,8564,3996,4568,9691024.0,4485005.0,5206019.0,67,33,34,8027,4000,4027,9138418.0,4489254.0,4649163.0,112.24,113.97,112.23,115.45
2023-09-01 13:10,107,47,60,9084,4255,4829,10347001.0,4777997.0,5569004.0,88,35,53,9224,4469,4755,10503196.0,5018709.0,5484486.0,112.29,115.32,112.3,115.34
2023-09-01 13:15,449,119,330,32070,12996,19074,36176181.0,14550889.0,21625292.0,390,87,303,29882,12144,17738,33926791.0,13594409.0,20332381.0,111.96,113.38,111.94,114.63
2023-09-01 13:20,269,97,172,21432,10073,11359,24231909.0,11270010.0,12961898.0,218,58,160,19740,8958,10782,22374350.0,10005094.0,12369256.0,111.88,114.11,111.69,114.72
2023-09-01 13:25,273,113,160,19444,9686,9758,21976688.0,10849692.0,11126995.0,224,83,141,18760,9555,9205,21258705.0,10695342.0,10563363.0,112.01,114.03,111.93,114.76
2023-09-01 13:30,159,83,76,13019,6894,6125,14780412.0,7733140.0,7047272.0,142,75,67,11517,5948,5569,13071981.0,6663217.0,6408764.0,112.17,115.06,112.02,115.08
2023-09-01 13:35,112,45,67,7598,3471,4127,8635110.0,3912302.0,4722808.0,83,29,54,6392,3468,2924,7250029.0,3890714.0,3359314.0,112.71,114.44,112.19,114.89
2023-09-01 13:40,69,44,25,5237,3117,2120,5962463.0,3536126.0,2426337.0,50,29,21,4290,2343,1947,4862537.0,2624082.0,2238455.0,113.45,114.45,112.0,114.97
2023-09-01 13:45,89,38,51,8343,4590,3753,9474893.0,5165070.0,4309822.0,66,27,39,6796,3442,3354,7714981.0,3858181.0,3856799.0,112.53,114.84,112.09,114.99
2023-09-01 13:50,126,59,67,9740,4186,5554,10824581.0,4703529.0,6121052.0,85,30,55,8361,3884,4477,9495894.0,4345175.0,5150718.0,112.36,110.21,111.87,115.05
2023-09-01 13:55,147,92,55,12554,6420,6134,14233258.0,7186541.0,7046717.0,128,83,45,11864,5944,5920,13453414.0,6648879.0,6804534.0,111.94,114.88,111.86,114.94
2023-09-01 14:00,307,275,32,7576,4906,2670,8586936.0,5521161.0,3065774.0,302,274,28,7279,4613,2666,8243779.0,5182715.0,3061063.0,112.54,114.82,112.35,114.82
2023-09-01 14:05,245,209,36,7792,4643,3149,8857444.0,5236730.0,3620713.0,228,198,30,8024,4968,3056,9099559.0,5583978.0,3515581.0,112.79,114.98,112.4,115.04
2023-09-01 14:10,53,29,24,2737,1507,1230,3106543.0,1695936.0,1410607.0,32,19,13,2369,1279,1090,2688692.0,1434151.0,1254540.0,112.54,114.68,112.13,115.1
2023-09-01 14:15,27,17,10,1691,1365,326,1938465.0,1564612.0,373853.0,15,9,6,498,288,210,564944.0,322862.0,242082.0,114.62,114.68,112.11,115.28
2023-09-01 14:20,94,39,55,6807,2713,4094,7742741.0,3062010.0,4680731.0,82,32,50,6624,2564,4060,7529655.0,2877721.0,4651933.0,112.86,114.33,112.24,114.58
2023-09-01 14:25,76,35,41,4718,2288,2430,5340597.0,2582708.0,2757889.0,55,19,36,3624,1426,2198,4122244.0,1601025.0,2521218.0,112.88,113.49,112.27,114.71
2023-09-01 14:30,54,25,29,4357,2162,2195,4815470.0,2315916.0,2499554.0,45,23,22,4399,2382,2017,4999055.0,2677469.0,2321585.0,107.12,113.87,112.4,115.1
2023-09-01 14:35,119,64,55,11273,5263,6010,12758760.0,5979626.0,6779134.0,83,47,36,10056,5185,4871,11433477.0,5814560.0,5618917.0,113.62,112.8,112.14,115.35
2023-09-01 14:40,33,17,16,1466,559,907,1661454.0,634182.0,1027271.0,24,12,12,1781,931,850,1909718.0,935793.0,973925.0,113.45,113.26,100.51,114.58
2023-09-01 14:45,31,17,14,1875,1541,334,1971613.0,1590240.0,381372.0,20,11,9,734,395,339,834370.0,444465.0,389904.0,103.2,114.18,112.52,115.02
2023-09-01 14:50,24,10,14,571,215,356,611248.0,242808.0,368439.0,10,4,6,523,217,306,596170.0,242650.0,353520.0,112.93,103.49,111.82,115.53
2023-09-01 14:55,48,31,17,3267,1841,1426,3750852.0,2104156.0,1646696.0,29,19,10,2768,1463,1305,3151994.0,1642610.0,1509383.0,114.29,115.48,112.28,115.66
2023-09-01 15:00,81,51,30,7163,4045,3118,8171251.0,4583429.0,3587821.0,63,41,22,6484,3448,3036,7374672.0,3870187.0,3504485.0,113.31,115.07,112.24,115.43
2023-09-01 15:05,232,170,62,15767,9876,5891,18079156.0,11277525.0,6801631.0,203,164,39,14820,9522,5298,16866705.0,10745284.0,6121421.0,114.19,115.46,112.85,115.54
2023-09-01 15:10,55,30,25,4850,2335,2515,5575634.0,2640373.0,2935261.0,40,18,22,4594,2246,2348,5234515.0,2524230.0,2710284.0,113.08,116.71,112.39,115.43
2023-09-01 15:15,321,298,23,15593,13464,2129,17718694.0,15278520.0,2440173.0,294,281,13,15132,13255,1877,17201341.0,15032202.0,2169138.0,113.48,114.62,113.41,115.56
2023-09-01 15:20,62,41,21,4878,2709,2169,5544408.0,3040708.0,2503699.0,50,34,16,4701,2608,2093,5353933.0,2935205.0,2418727.0,112.24,115.43,112.55,115.56
2023-09-01 15:25,42,28,14,1790,1005,785,2056350.0,1148465.0,907885.0,24,19,5,1505,903,602,1713957.0,1017954.0,696003.0,114.28,115.65,112.73,115.62
2023-09-01 15:30,52,32,20,3305,1886,1419,3768420.0,2127289.0,1641130.0,39,25,14,2704,1662,1042,3079986.0,1874872.0,1205114.0,112.79,115.65,112.81,115.65
2023-09-01 15:35,378,356,22,22312,20243,2069,25393856.0,23045258.0,2348597.0,355,341,14,21264,19409,1855,24164909.0,22023006.0,2141903.0,113.84,113.51,113.47,115.47
2023-09-01 15:40,974,951,23,54911,52965,1946,62413766.0,60182190.0,2231575.0,969,950,19,53768,51857,1911,61112979.0,58904167.0,2208811.0,113.63,114.68,113.59,115.58
2023-09-01 15:45,111,97,14,7286,5727,1559,8297711.0,6496805.0,1800906.0,94,84,10,6716,5284,1432,7641591.0,5986038.0,1655552.0,113.44,115.52,113.29,115.61
2023-09-01 15:50,21,13,8,838,424,414,959100.0,483157.0,475942.0,16,9,7,1007,608,399,1143246.0,684345.0,458901.0,113.95,114.96,112.56,115.01
2023-09-01 15:55,62,32,30,4120,1826,2294,4696383.0,2057038.0,2639344.0,38,24,14,3151,1606,1545,3588639.0,1804609.0,1784029.0,112.65,115.05,112.37,115.47
2023-09-01 16:00,63,30,33,4263,2177,2086,4848845.0,2445091.0,2403753.0,40,22,18,4393,2344,2049,4998894.0,2632881.0,2366012.0,112.31,115.23,112.32,115.47
2023-09-01 16:05,86,48,38,9157,4670,4487,10412772.0,5242356.0,5170415.0,74,42,32,8853,4437,4416,10073039.0,4977649.0,5095390.0,112.26,115.23,112.19,115.38
2023-09-01 16:10,44,19,25,3243,1518,1725,3669100.0,1710945.0,1958155.0,31,16,15,3113,1617,1496,3544910.0,1815864.0,1729046.0,112.71,113.52,112.3,115.58
2023-09-01 16:15,64,25,39,6162,2701,3461,7030325.0,3032492.0,3997833.0,57,22,35,5636,2700,2936,6413443.0,3028181.0,3385261.0,112.27,115.51,112.15,115.3
2023-09-01 16:20,99,46,53,11177,5136,6041,12792020.0,5765169.0,7026850.0,87,40,47,10525,5240,5285,11976137.0,5877783.0,6098354.0,112.25,116.32,112.17,115.39
2023-09-01 16:25,99,46,53,9820,4828,4992,11173378.0,5415726.0,5757652.0,104,45,59,10311,4823,5488,11736688.0,5410141.0,6326547.0,112.17,115.34,112.17,115.28
2023-09-01 16:30,64,34,30,5921,2961,2960,6739222.0,3322974.0,3416248.0,52,26,26,5895,2889,3006,6721240.0,3240999.0,3480241.0,112.22,115.41,112.18,115.78
2023-09-01 16:35,106,57,49,9321,4721,4600,10616284.0,5312133.0,5304151.0,84,46,38,8990,4500,4490,10232780.0,5051099.0,5181681.0,112.52,115.31,112.25,115.4
2023-09-01 16:40,52,32,20,3553,1888,1665,4042649.0,2123069.0,1919580.0,41,22,19,3400,1743,1657,3869610.0,1956526.0,1913084.0,112.45,115.29,112.25,115.45
2023-09-01 16:45,88,51,37,8431,4433,3998,9587720.0,4984891.0,4602829.0,70,39,31,7728,3883,3845,8796018.0,4357874.0,4438143.0,112.45,115.13,112.23,115.43
2023-09-01 16:50,78,43,35,6966,3672,3294,7926531.0,4129602.0,3796929.0,67,39,28,7147,3891,3256,8127854.0,4371652.0,3756202.0,112.46,115.27,112.35,115.36
2023-09-01 16:55,53,34,19,4177,2138,2039,4724547.0,2404044.0,2320503.0,42,26,16,4319,2389,1930,4913505.0,2686587.0,2226917.0,112.44,113.81,112.46,115.38
2023-09-01 17:00,60,32,28,5247,2567,2680,6008933.0,2913160.0,3095773.0,48,24,24,4924,2354,2570,5611178.0,2642990.0,2968188.0,113.49,115.51,112.28,115.49
2023-09-01 17:05,72,31,41,4400,2031,2369,5014115.0,2287978.0,2726136.0,61,25,36,4367,2006,2361,4968999.0,2251575.0,2717424.0,112.65,115.08,112.24,115.1
2023-09-01 17:10,59,29,30,4391,2123,2268,4999313.0,2386538.0,2612775.0,54,25,29,4487,2186,2301,5105839.0,2455383.0,2650456.0,112.41,115.2,112.32,115.19
2023-09-01 17:15,47,30,17,2369,1190,1179,2698415.0,1342161.0,1356254.0,33,17,16,2251,1153,1098,2563022.0,1295220.0,1267802.0,112.79,115.03,112.33,115.46
2023-09-01 17:20,39,20,19,2269,958,1311,2584972.0,1077737.0,1507235.0,29,15,14,2171,973,1198,2471918.0,1090083.0,1381835.0,112.5,114.97,112.03,115.35
2023-09-01 17:25,50,30,20,3334,1757,1577,3828794.0,2013510.0,1815283.0,32,18,14,3024,1499,1525,3443978.0,1682259.0,1761719.0,114.6,115.11,112.23,115.52
2023-09-01 17:30,72,42,30,8100,4502,3598,9476797.0,5322366.0,4154430.0,50,29,21,6017,3099,2918,6852929.0,3481292.0,3371636.0,118.22,115.46,112.34,115.55
2023-09-01 17:35,41,19,22,3412,1224,2188,3922053.0,1382725.0,2539328.0,25,12,13,2278,1141,1137,2597221.0,1283335.0,1313885.0,112.97,116.06,112.47,115.56
2023-09-01 17:40,40,21,19,3112,1622,1490,3546642.0,1828942.0,1717699.0,25,13,12,2857,1443,1414,3255758.0,1620558.0,1635200.0,112.76,115.28,112.3,115.64
2023-09-01 17:45,63,30,33,5737,2881,2856,6561477.0,3260668.0,3300808.0,51,27,24,5654,2917,2737,6451694.0,3279318.0,3172375.0,113.18,115.57,112.42,115.91
2023-09-01 17:50,78,44,34,6875,3851,3024,7693143.0,4357012.0,3336131.0,44,21,23,4871,2354,2517,5563957.0,2647542.0,2916415.0,113.14,110.32,112.47,115.87
2023-09-01 17:55,67,35,32,6975,3559,3416,7958624.0,4011508.0,3947115.0,54,31,23,6610,3332,3278,7538945.0,3746330.0,3792615.0,112.71,115.55,112.43,115.7
2023-09-01 18:00,96,53,43,10679,5372,5307,12190094.0,6051682.0,6138412.0,83,49,34,10554,5443,5111,12038123.0,6123393.0,5914730.0,112.65,115.67,112.5,115.73
2023-09-01 18:05,31,18,13,2040,1184,856,2313552.0,1356067.0,957484.0,25,15,10,1544,774,770,1760440.0,871619.0,888821.0,114.53,111.86,112.61,115.43
2023-09-01 18:10,19,9,10,588,264,324,666058.0,297549.0,368509.0,12,6,6,875,583,292,1002588.0,660347.0,342241.0,112.71,113.74,113.27,117.21
2023-09-01 18:15,253,127,126,6685,1698,4987,7625773.0,1935540.0,5690232.0,238,121,117,6224,1447,4777,7100953.0,1642575.0,5458377.0,113.99,114.1,113.52,114.26
2023-09-01 18:20,88,38,50,7975,3884,4091,9127017.0,4410912.0,4716105.0,57,29,28,7344,3742,3602,8372762.0,4206673.0,4166089.0,113.57,115.28,112.42,115.66
2023-09-01 18:25,89,36,53,10206,3533,6673,11606346.0,3968529.0,7637816.0,63,23,40,6995,3329,3666,7964643.0,3736995.0,4227647.0,112.33,114.46,112.26,115.32
2023-09-01 18:30,135,46,89,9591,3553,6038,10909764.0,3996655.0,6913109.0,108,27,81,8799,2181,6618,10065927.0,2444108.0,7621819.0,112.49,114.49,112.06,115.17
2023-09-01 18:35,541,24,517,28241,1120,27121,32174340.0,1276903.0,30897437.0,537,20,517,26901,1148,25753,30653613.0,1288205.0,29365408.0,114.01,113.92,112.21,114.03
2023-09-04 10:00,2574,1518,1056,93987,58135,35852,111041330.0,67847463.0,43193867.0,1156,1037,119,42448,35116,7332,48814473.0,40195285.0,8619187.0,116.71,120.48,114.46,117.56
2023-09-04 10:05,1348,645,703,48430,19105,29325,57263526.0,22933700.0,34329825.0,509,286,223,20361,9312,11049,23768140.0,10795517.0,12972623.0,120.04,117.07,115.93,117.41
2023-09-04 10:10,883,497,386,39342,18447,20895,45983527.0,21925273.0,24058254.0,284,183,101,18647,8234,10413,21693486.0,9527283.0,12166203.0,118.86,115.14,115.71,116.84
2023-09-04 10:15,930,575,355,32465,17597,14868,38367968.0,21009749.0,17358219.0,222,137,85,13089,6125,6964,15346971.0,7129685.0,8217285.0,119.39,116.75,116.4,118.0
2023-09-04 10:20,1403,818,585,82139,47058,35081,97483688.0,56114441.0,41369247.0,723,492,231,60226,36725,23501,70796514.0,42797489.0,27999025.0,119.25,117.92,116.54,119.14
2023-09-04 10:25,864,442,422,61700,28533,33167,71726308.0,33111926.0,38614381.0,457,222,235,52913,25332,27581,61933916.0,29210059.0,32723856.0,116.05,116.42,115.31,118.65
2023-09-04 10:30,720,402,318,57038,28552,28486,66386638.0,32997124.0,33389514.0,437,231,206,50770,25463,25307,59170817.0,29253970.0,29916847.0,115.57,117.21,114.89,118.22
2023-09-04 10:35,390,193,197,26535,12580,13955,30961283.0,14499549.0,16461733.0,227,101,126,23263,11038,12225,27119613.0,12693239.0,14426374.0,115.26,117.96,115.0,118.01
2023-09-04 10:40,368,186,182,32410,15789,16621,37875384.0,18289164.0,19586220.0,238,115,123,26754,12979,13775,31178061.0,14905784.0,16272276.0,115.83,117.84,114.85,118.13
2023-09-04 10:45,389,203,186,32138,16295,15843,37498403.0,18858839.0,18639563.0,229,100,129,26521,12925,13596,30971282.0,14868459.0,16102823.0,115.73,117.65,115.04,118.44
2023-09-04 10:50,1236,1017,219,74963,53386,21577,87478180.0,62094614.0,25383565.0,1103,945,158,72677,52133,20544,84853248.0,60537338.0,24315909.0,116.31,117.64,116.12,118.36
2023-09-04 10:55,12494,688,11806,310764,37125,273639,364113502.0,43540573.0,320572929.0,12361,617,11744,303651,33790,269861,355301177.0,39137843.0,316163333.0,117.28,117.15,115.83,117.16
2023-09-04 11:00,1339,1118,221,81397,59015,22382,95102400.0,68627802.0,26474597.0,1189,1032,157,78964,58174,20790,92217951.0,67576409.0,24641542.0,116.29,118.29,116.16,118.53
2023-09-04 11:05,403,254,149,28276,13611,14665,32395213.0,15753752.0,16641461.0,282,192,90,23002,12822,10180,26882233.0,14816149.0,12066083.0,115.74,113.48,115.55,118.53
2023-09-04 11:10,660,295,365,48800,23794,25006,56765159.0,27431179.0,29333980.0,491,199,292,44774,21284,23490,52136110.0,24436130.0,27699980.0,115.29,117.31,114.81,117.92
2023-09-04 11:15,367,166,201,29039,13424,15615,33855390.0,15439003.0,18416386.0,284,120,164,28136,13271,14865,32798005.0,15250471.0,17547534.0,115.01,117.94,114.92,118.05
2023-09-04 11:20,717,284,433,50517,19560,30957,58872335.0,22539620.0,36332715.0,581,198,383,47920,18282,29638,55869903.0,21009688.0,34860215.0,115.23,117.37,114.92,117.62
2023-09-04 11:25,514,198,316,40484,16670,23814,47017455.0,19216112.0,27801342.0,386,137,249,38271,15959,22312,44609478.0,18339762.0,26269715.0,115.27,116.74,114.92,117.74
2023-09-04 11:30,250,124,126,21242,10056,11186,24721396.0,11553851.0,13167545.0,166,77,89,19693,9615,10078,22906822.0,11026265.0,11880557.0,114.9,117.71,114.68,117.89
2023-09-04 11:35,244,133,111,19360,9170,10190,22489066.0,10540958.0,11948107.0,157,74,83,17288,8298,8990,20106718.0,9516596.0,10590121.0,114.95,117.25,114.69,117.8
2023-09-04 11:40,186,105,81,10480,5167,5313,12284673.0,6043369.0,6241304.0,107,53,54,9275,4356,4919,10804695.0,5004355.0,5800339.0,116.96,117.47,114.88,117.92
2023-09-04 11:45,233,120,113,17258,8244,9014,20130163.0,9534128.0,10596034.0,173,85,88,16374,7788,8586,19100840.0,8961730.0,10139110.0,115.65,117.55,115.07,118.09
2023-09-04 11:50,211,110,101,19575,9961,9614,22855437.0,11471773.0,11383663.0,156,86,70,18562,9525,9037,21662037.0,10962520.0,10699517.0,115.17,118.41,115.09,118.4
2023-09-04 11:55,169,87,82,14316,6599,7717,16703830.0,7619343.0,9084487.0,120,66,54,12613,6588,6025,14702323.0,7571155.0,7131168.0,115.46,117.72,114.92,118.36
2023-09-04 12:00,173,78,95,9538,4393,5145,11214434.0,5132353.0,6082081.0,92,45,47,8170,3486,4684,9568352.0,4019578.0,5548773.0,116.83,118.21,115.31,118.46
2023-09-04 12:05,137,70,67,8829,3726,5103,10322182.0,4308075.0,6014107.0,91,45,46,7061,3433,3628,8253574.0,3959682.0,4293892.0,115.62,117.85,115.34,118.35
2023-09-04 12:10,92,40,52,9666,3541,6125,11249931.0,4123517.0,7126413.0,55,29,26,2884,1408,1476,3378093.0,1625292.0,1752801.0,116.45,116.35,115.43,118.75
2023-09-04 12:15,120,58,62,8088,3408,4680,9422704.0,3963295.0,5459408.0,61,35,26,6376,2664,3712,7451119.0,3070545.0,4380573.0,116.29,116.65,115.26,118.01
2023-09-04 12:20,203,88,115,14966,6684,8282,17538156.0,7784692.0,9753464.0,143,66,77,13248,6196,7052,15468981.0,7135722.0,8333259.0,116.47,117.77,115.17,118.17
2023-09-04 12:25,144,81,63,8418,4306,4112,9838040.0,4980167.0,4857872.0,109,60,49,8139,4152,3987,9502330.0,4783292.0,4719037.0,115.66,118.14,115.2,118.36
2023-09-04 12:30,239,127,112,16847,8318,8529,19730999.0,9633934.0,10097064.0,169,89,80,16149,7997,8152,18889700.0,9219815.0,9669885.0,115.82,118.39,115.29,118.62
2023-09-04 12:35,74,41,33,2024,875,1149,2415593.0,1059600.0,1355992.0,40,24,16,1251,610,641,1464625.0,704116.0,760508.0,121.1,118.02,115.43,118.64
2023-09-04 12:40,221,127,94,13124,6769,6355,15319293.0,7813528.0,7505765.0,165,100,65,12688,6728,5960,14816842.0,7757070.0,7059772.0,115.43,118.11,115.3,118.45
2023-09-04 12:45,138,94,44,10078,5216,4862,11818698.0,6091681.0,5727017.0,78,55,23,6486,3252,3234,7591021.0,3755935.0,3835085.0,116.79,117.79,115.5,118.59
2023-09-04 12:50,204,135,69,11940,6985,4955,14083854.0,8239642.0,5844212.0,123,88,35,9219,5412,3807,10786987.0,6262968.0,4524019.0,117.96,117.95,115.72,118.83
2023-09-04 12:55,661,488,173,50887,36605,14282,59698989.0,42765422.0,16933567.0,479,374,105,40292,27056,13236,47148206.0,31426899.0,15721306.0,116.83,118.57,116.16,118.78
2023-09-04 13:00,630,364,266,47818,25302,22516,56903958.0,30203145.0,26700813.0,343,214,129,39341,22200,17141,46309211.0,25826024.0,20483186.0,119.37,118.59,116.33,119.5
2023-09-04 13:05,424,232,192,31568,16002,15566,37528716.0,18966628.0,18562087.0,248,137,111,26989,13386,13603,31801525.0,15552609.0,16248916.0,118.53,119.25,116.19,119.45
2023-09-04 13:10,433,251,182,34009,17210,16799,40034134.0,20060423.0,19973711.0,284,181,103,29324,14800,14524,34568292.0,17203444.0,17364848.0,116.56,118.9,116.24,119.56
2023-09-04 13:15,266,142,124,19072,8752,10320,22492901.0,10256300.0,12236601.0,153,95,58,15684,8577,7107,18458227.0,9963362.0,8494865.0,117.19,118.57,116.16,119.53
2023-09-04 13:20,369,184,185,28376,13686,14690,33260752.0,15959623.0,17301128.0,265,134,131,25043,12360,12683,29467721.0,14345915.0,15121806.0,116.61,117.77,116.07,119.23
2023-09-04 13:25,223,101,122,14246,7059,7187,16774756.0,8227547.0,8547208.0,129,50,79,11940,5686,6254,14049440.0,6594787.0,7454652.0,116.55,118.93,115.98,119.2
2023-09-04 13:30,221,123,98,15654,8199,7455,18465556.0,9601462.0,8864094.0,167,84,83,14773,7692,7081,17392177.0,8938420.0,8453757.0,117.11,118.9,116.2,119.39
2023-09-04 13:35,313,170,143,22604,10970,11634,26694153.0,12830872.0,13863281.0,232,125,107,21136,9712,11424,24950656.0,11289015.0,13661641.0,116.96,119.16,116.24,119.59
2023-09-04 13:40,264,164,100,14854,8194,6660,17468272.0,9556578.0,7911694.0,174,114,60,12629,6749,5880,14866346.0,7845412.0,7020934.0,116.63,118.79,116.25,119.4
2023-09-04 13:45,280,175,105,24587,13104,11483,29008248.0,15327790.0,13680458.0,192,126,66,22339,11702,10637,26319408.0,13615328.0,12704079.0,116.97,119.14,116.35,119.43
2023-09-04 13:50,190,99,91,17099,10057,7042,20246846.0,11816307.0,8430538.0,110,65,45,15339,9613,5726,18063197.0,11219014.0,6844183.0,117.49,119.72,116.71,119.53
2023-09-04 13:55,202,124,78,16230,8864,7366,19388476.0,10619545.0,8768931.0,142,93,49,14260,7205,7055,16824029.0,8380965.0,8443064.0,119.81,119.05,116.32,119.67
2023-09-04 14:00,233,134,99,18176,8867,9309,21312334.0,10347811.0,10964523.0,146,84,62,15782,7720,8062,18587171.0,8963990.0,9623181.0,116.7,117.78,116.11,119.36
2023-09-04 14:05,75,33,42,4986,1879,3107,5795557.0,2193847.0,3601710.0,49,22,27,5417,1901,3516,6507091.0,2205109.0,4301982.0,116.76,115.92,116.0,122.35
2023-09-04 14:10,100,56,44,4940,2366,2574,5809417.0,2768913.0,3040504.0,54,30,24,4226,2200,2026,4965817.0,2550156.0,2415661.0,117.03,118.12,115.92,119.23
2023-09-04 14:15,201,106,95,14886,7011,7875,17368607.0,8140633.0,9227974.0,132,65,67,13123,6464,6659,15407732.0,7487470.0,7920261.0,116.11,117.18,115.83,118.94
2023-09-04 14:20,243,155,88,20143,11600,8543,23624916.0,13482909.0,10142007.0,188,123,65,19163,11050,8113,22485223.0,12831490.0,9653733.0,116.23,118.72,116.12,118.99
2023-09-04 14:25,520,324,196,38648,22037,16611,45618969.0,25854472.0,19764496.0,359,211,148,36054,19550,16504,42398843.0,22728276.0,19670567.0,117.32,118.98,116.26,119.19
2023-09-04 14:30,228,132,96,13966,6869,7097,16452223.0,8012038.0,8440185.0,166,101,65,12490,6629,5861,14715118.0,7706404.0,7008713.0,116.64,118.93,116.25,119.58
2023-09-04 14:35,107,68,39,4291,2295,1996,5104391.0,2714953.0,2389438.0,69,48,21,3384,1868,1516,3980967.0,2170585.0,1810382.0,118.3,119.71,116.2,119.42
2023-09-04 14:40,194,106,88,14118,7223,6895,16605455.0,8418245.0,8187209.0,129,72,57,13486,6897,6589,15882674.0,8009268.0,7873405.0,116.55,118.74,116.13,119.49
2023-09-04 14:45,176,101,75,10606,5657,4949,12554823.0,6659166.0,5895656.0,135,78,57,10224,5243,4981,12041170.0,6090397.0,5950773.0,117.72,119.13,116.16,119.47
2023-09-04 14:50,236,134,102,20712,10479,10233,24707086.0,12440239.0,12266846.0,189,113,76,18478,9454,9024,21781558.0,10992657.0,10788900.0,118.72,119.88,116.28,119.56
2023-09-04 14:55,133,71,62,7204,3498,3706,8499739.0,4103038.0,4396701.0,87,49,38,5624,2942,2682,6620957.0,3415696.0,3205261.0,117.3,118.64,116.1,119.51
2023-09-04 15:00,113,49,64,6711,3374,3337,12560766.0,4021381.0,8539385.0,80,33,47,6412,2894,3518,7571968.0,3358434.0,4213533.0,119.19,255.9,116.05,119.77
2023-09-04 15:05,185,52,133,8118,3804,4314,9580078.0,4461644.0,5118434.0,137,28,109,7336,3361,3975,8630126.0,3894531.0,4735595.0,117.29,118.65,115.87,119.13
2023-09-04 15:10,83,49,34,5489,3033,2456,6465009.0,3537862.0,2927147.0,60,35,25,5275,2759,2516,10791309.0,3200064.0,7591245.0,116.65,119.18,115.99,301.72
2023-09-04 15:15,91,48,43,6697,2703,3994,7854245.0,3139294.0,4714950.0,52,25,27,5306,2164,3142,6247281.0,2510131.0,3737150.0,116.14,118.05,115.99,118.94
2023-09-04 15:20,331,151,180,25670,11381,14289,35148446.0,13171408.0,21977038.0,236,105,131,21318,10588,10730,27915603.0,12242965.0,15672638.0,115.73,153.8,115.63,146.06
2023-09-04 15:25,328,205,123,27328,14721,12607,34484028.0,17047415.0,17436613.0,271,172,99,26383,13859,12524,35941980.0,16032282.0,19909697.0,115.8,138.31,115.68,158.97
2023-09-04 15:30,512,303,209,42568,25829,16739,55628383.0,30997593.0,24630789.0,282,168,114,32057,17649,14408,40085748.0,20540666.0,19545082.0,120.01,147.15,116.38,135.65
2023-09-04 15:35,321,155,166,29787,12786,17001,35004522.0,14898321.0,20106201.0,192,91,101,22923,11445,11478,29223509.0,13244413.0,15979096.0,116.52,118.26,115.72,139.21
2023-09-04 15:40,288,137,151,21241,9830,11411,24886839.0,11390068.0,13496771.0,221,91,130,20174,9582,10592,23631680.0,11071269.0,12560411.0,115.87,118.28,115.54,118.58
2023-09-04 15:45,573,285,288,44135,21094,23041,53807775.0,26664952.0,27142822.0,486,230,256,41279,19788,21491,48363977.0,22874666.0,25489310.0,126.41,117.8,115.6,118.6
2023-09-04 15:50,366,172,194,29186,13599,15587,34137448.0,15778292.0,18359156.0,266,107,159,27090,11593,15497,31739072.0,13390372.0,18348699.0,116.03,117.79,115.5,118.4
2023-09-04 15:55,165,88,77,15069,6380,8689,17692460.0,7419719.0,10272741.0,121,58,63,13697,5462,8235,16234187.0,6328546.0,9905641.0,116.3,118.23,115.87,120.29
2023-09-04 16:00,191,89,102,15393,6983,8410,18019867.0,8116161.0,9903706.0,136,55,81,14665,6631,8034,17235306.0,7673614.0,9561692.0,116.23,117.76,115.72,119.02
2023-09-04 16:05,126,53,73,8278,4968,3310,9732437.0,5811406.0,3921031.0,112,54,58,6282,3226,3056,7379911.0,3754139.0,3625771.0,116.98,118.46,116.37,118.64
2023-09-04 16:10,143,65,78,9685,5102,4583,11404743.0,5979597.0,5425145.0,106,48,58,8656,4670,3986,10166692.0,5429904.0,4736788.0,117.2,118.38,116.27,118.84
2023-09-04 16:15,115,43,72,8201,4202,3999,9611350.0,4912643.0,4698707.0,77,34,43,7881,4308,3573,9266296.0,5020587.0,4245708.0,116.91,117.5,116.54,118.83
2023-09-04 16:20,108,52,56,8331,4409,3922,9828973.0,5160450.0,4668522.0,84,33,51,10484,4155,6329,14549534.0,7025225.0,7524309.0,117.04,119.03,169.08,118.89
2023-09-04 16:25,133,82,51,11242,7209,4033,13261712.0,8460214.0,4801498.0,96,64,32,10700,7177,3523,12593291.0,8384473.0,4208818.0,117.36,119.06,116.82,119.47
2023-09-04 16:30,225,141,84,14690,8113,6577,17219787.0,9527168.0,7692619.0,176,127,49,12848,7390,5458,15123737.0,8611361.0,6512376.0,117.43,116.96,116.53,119.32
2023-09-04 16:35,125,43,82,11664,5465,6199,13701357.0,6340094.0,7361262.0,107,42,65,11351,5370,5981,13361428.0,6225810.0,7135618.0,116.01,118.75,115.94,119.3
2023-09-04 16:40,88,36,52,5444,2452,2992,6395367.0,2873077.0,3522290.0,56,19,37,5038,2287,2751,5927242.0,2651757.0,3275485.0,117.17,117.72,115.95,119.07
2023-09-04 16:45,68,22,46,3430,1486,1944,4013866.0,1719168.0,2294698.0,49,20,29,3339,1669,1670,3925542.0,1938214.0,1987328.0,115.69,118.04,116.13,119.0
2023-09-04 16:50,47,24,23,937,427,510,1087448.0,499107.0,588341.0,26,17,9,1351,1099,252,1584218.0,1283737.0,300480.0,116.89,115.36,116.81,119.24
2023-09-04 16:55,117,64,53,5093,2545,2548,5997845.0,2975867.0,3021977.0,96,49,47,4601,2375,2226,5407853.0,2759514.0,2648338.0,116.93,118.6,116.19,118.97
2023-09-04 17:00,2762,79,2683,81391,5923,75468,95792322.0,6869912.0,88922409.0,2721,58,2663,80708,5588,75120,95021266.0,6479411.0,88541854.0,115.99,117.83,115.95,117.87
2023-09-04 17:05,129,70,59,7551,3808,3743,8900194.0,4446282.0,4453911.0,98,57,41,6944,3639,3305,8188726.0,4225310.0,3963415.0,116.76,118.99,116.11,119.92
2023-09-04 17:10,206,99,107,13018,6693,6325,15286636.0,7788762.0,7497874.0,168,79,89,12672,6521,6151,14871934.0,7552701.0,7319233.0,116.37,118.54,115.82,118.99
2023-09-04 17:15,177,130,47,10580,5985,4595,12459702.0,6985913.0,5473789.0,144,106,38,10151,5682,4469,11936741.0,6596207.0,5340534.0,116.72,119.12,116.09,119.5
2023-09-04 17:20,128,92,36,10236,6057,4179,12054927.0,7086840.0,4968087.0,99,73,26,9362,5535,3827,10983197.0,6423990.0,4559207.0,117.0,118.88,116.06,119.13
2023-09-04 17:25,92,54,38,5887,3135,2752,6947562.0,3664696.0,3282865.0,71,34,37,5934,2912,3022,6993681.0,3380136.0,3613545.0,116.9,119.29,116.08,119.57
2023-09-04 17:30,228,96,132,12176,6012,6164,14363653.0,7006308.0,7357344.0,176,67,109,11179,5559,5620,13186108.0,6454612.0,6731496.0,116.54,119.36,116.11,119.78
2023-09-04 17:35,268,141,127,22238,11269,10969,26146682.0,13136217.0,13010465.0,199,99,100,21074,10492,10582,24760877.0,12159151.0,12601725.0,116.57,118.61,115.89,119.09
2023-09-04 17:40,181,67,114,13615,6221,7394,15940389.0,7210679.0,8729709.0,148,52,96,13119,5992,7127,15415851.0,6939675.0,8476176.0,115.91,118.06,115.82,118.93
2023-09-04 17:45,125,48,77,9272,4148,5124,10906143.0,4811604.0,6094538.0,109,37,72,9156,4073,5083,10773411.0,4716766.0,6056645.0,116.0,118.94,115.81,119.15
2023-09-04 17:50,46,17,29,2604,1182,1422,3060721.0,1370432.0,1690289.0,39,19,20,2609,1185,1424,3082080.0,1373794.0,1708286.0,115.94,118.87,115.93,119.96
2023-09-04 17:55,76,40,36,5869,3188,2681,6891274.0,3712806.0,3178468.0,49,23,26,5441,2881,2560,6394138.0,3347091.0,3047047.0,116.46,118.56,116.18,119.03
2023-09-04 18:00,173,105,68,13888,7659,6229,16336518.0,8949533.0,7386985.0,124,75,49,11551,5990,5561,13608360.0,6964007.0,6644352.0,116.85,118.59,116.26,119.48
2023-09-04 18:05,267,167,100,19716,11164,8552,23749546.0,13519670.0,10229875.0,177,112,65,15933,8001,7932,18827441.0,9314583.0,9512858.0,121.1,119.62,116.42,119.93
2023-09-04 18:10,1662,853,809,55216,32398,22818,65317519.0,38211430.0,27106088.0,1498,775,723,52670,31345,21325,62192519.0,36805420.0,25387099.0,117.94,118.79,117.42,119.05
2023-09-04 18:15,217,134,83,14473,6912,7561,17296723.0,8196987.0,9099736.0,98,58,40,9767,4776,4991,11548469.0,5569685.0,5978783.0,118.59,120.35,116.62,119.79
2023-09-04 18:20,499,295,204,43970,22137,21833,52106029.0,26049518.0,26056511.0,364,219,145,39228,19497,19731,46502228.0,22750047.0,23752181.0,117.67,119.34,116.68,120.38
2023-09-04 18:25,397,174,223,29653,15061,14592,35342886.0,17931007.0,17411878.0,220,110,110,26611,13138,13473,31561055.0,15345123.0,16215931.0,119.06,119.32,116.8,120.36
2023-09-04 18:30,150,63,87,6709,2771,3938,7960212.0,3372931.0,4587281.0,76,34,42,5146,1933,3213,6301734.0,2260231.0,4041503.0,121.72,116.49,116.93,125.79
2023-09-04 18:35,589,255,334,17443,7064,10379,20652809.0,8448153.0,12204655.0,478,199,279,15448,6079,9369,18259734.0,7159652.0,11100081.0,119.59,117.59,117.78,118.48
2023-09-05 10:00,2686,1031,1655,87723,40906,46817,107014445.0,50114548.0,56899897.0,761,406,355,32553,20240,12313,38960284.0,24087300.0,14872984.0,122.51,121.54,119.01,120.79
2023-09-05 10:05,1875,869,1006,67170,38104,29066,81964373.0,46944051.0,35020322.0,962,447,515,37462,21423,16039,45272437.0,25749297.0,19523140.0,123.2,120.49,120.19,121.72
2023-09-05 10:10,989,471,518,40685,15076,25609,49397902.0,18744341.0,30653560.0,348,189,159,17953,7512,10441,21556859.0,8947939.0,12608919.0,124.33,119.7,119.12,120.76
2023-09-05 10:15,950,594,356,54643,28883,25760,65495552.0,34634484.0,30861068.0,437,290,147,38398,21223,17175,46038839.0,25144618.0,20894220.0,119.91,119.8,118.48,121.65
2023-09-05 10:20,1126,700,426,69571,37893,31678,84315268.0,45436773.0,38878495.0,619,415,204,57947,32669,25278,70066111.0,38813648.0,31252462.0,119.91,122.73,118.81,123.64
2023-09-05 10:25,1273,727,546,98476,48921,49555,117489229.0,58083477.0,59405752.0,852,464,388,84456,42348,42108,101093499.0,50085225.0,51008274.0,118.73,119.88,118.27,121.14
2023-09-05 10:30,1113,707,406,94271,48599,45672,113938471.0,58360919.0,55577551.0,657,458,199,71538,42760,28778,86199501.0,51012148.0,35187353.0,120.09,121.69,119.3,122.27
2023-09-05 10:35,756,408,348,57172,27714,29458,68671611.0,33013194.0,35658417.0,511,277,234,51137,24221,26916,61573360.0,28809812.0,32763548.0,119.12,121.05,118.95,121.73
2023-09-05 10:40,547,258,289,44629,19219,25410,53409691.0,22836101.0,30573589.0,300,126,174,32964,15189,17775,39475920.0,17930452.0,21545467.0,118.82,120.32,118.05,121.21
2023-09-05 10:45,451,269,182,45127,21083,24044,54199037.0,25080852.0,29118185.0,297,153,144,40280,17169,23111,48196722.0,20207611.0,27989111.0,118.96,121.1,117.7,121.11
2023-09-05 10:50,325,166,159,26792,11047,15745,32068295.0,13131621.0,18936674.0,171,82,89,23446,9607,13839,28109812.0,11340769.0,16769043.0,118.87,120.27,118.05,121.17
2023-09-05 10:55,496,288,208,47010,19954,27056,56386261.0,23676667.0,32709593.0,315,194,121,41313,17347,23966,49513922.0,20503508.0,29010413.0,118.66,120.9,118.2,121.05
2023-09-05 11:00,481,260,221,45039,18802,26237,53828972.0,22292867.0,31536105.0,316,180,136,41159,17650,23509,49288175.0,20845742.0,28442433.0,118.57,120.2,118.11,120.99
2023-09-05 11:05,1116,541,575,91002,39461,51541,106839333.0,46275043.0,60564289.0,636,264,372,78661,32493,46168,93474492.0,37977719.0,55496773.0,117.27,117.51,116.88,120.21
2023-09-05 11:10,771,481,290,51175,30252,20923,60903964.0,35735909.0,25168055.0,558,371,187,49552,28156,21396,58912347.0,33109763.0,25802583.0,118.13,120.29,117.59,120.6
2023-09-05 11:15,516,306,210,39082,21539,17543,46900334.0,25644812.0,21255522.0,388,247,141,35081,19990,15091,41920406.0,23613695.0,18306711.0,119.06,121.16,118.13,121.31
2023-09-05 11:20,460,243,217,36592,18590,18002,44031699.0,22063206.0,21968493.0,355,202,153,33456,17785,15671,39999237.0,20986513.0,19012724.0,118.68,122.03,118.0,121.32
2023-09-05 11:25,229,141,88,16248,8762,7486,19571425.0,10523522.0,9047902.0,117,67,50,14548,7705,6843,17426601.0,9109171.0,8317430.0,120.1,120.86,118.22,121.55
2023-09-05 11:30,251,152,99,16633,9133,7500,20045095.0,10967564.0,9077530.0,150,105,45,14915,8531,6384,17853966.0,10099758.0,7754207.0,120.09,121.03,118.39,121.46
2023-09-05 11:35,288,143,145,20539,10376,10163,24464161.0,12285260.0,12178901.0,184,88,96,17445,8871,8574,20855704.0,10474126.0,10381577.0,118.4,119.84,118.07,121.08
2023-09-05 11:40,304,167,137,24567,12566,12001,29284040.0,14805279.0,14478761.0,216,116,100,22843,11515,11328,27218721.0,13527279.0,13691442.0,117.82,120.65,117.48,120.86
2023-09-05 11:45,312,143,169,22148,10536,11612,26594608.0,12546172.0,14048436.0,221,88,133,20021,9598,10423,23966905.0,11357371.0,12609534.0,119.08,120.98,118.33,120.98
2023-09-05 11:50,477,215,262,35365,16585,18780,42127647.0,19624875.0,22502772.0,383,161,222,32637,15901,16736,39007289.0,18754408.0,20252880.0,118.33,119.82,117.94,121.01
2023-09-05 11:55,205,110,95,12554,6305,6249,15053376.0,7494073.0,7559303.0,136,63,73,11501,5551,5950,13763429.0,6546706.0,7216723.0,118.86,120.97,117.94,121.29
2023-09-05 12:00,212,106,106,17154,8047,9107,20520850.0,9521814.0,10999035.0,152,76,76,16993,7727,9266,20343470.0,9118786.0,11224684.0,118.33,120.78,118.01,121.14
2023-09-05 12:05,281,130,151,23560,12253,11307,28202529.0,14547713.0,13654816.0,203,82,121,20560,9760,10800,24595885.0,11508771.0,13087114.0,118.73,120.76,117.92,121.18
2023-09-05 12:10,272,161,111,24331,12495,11836,29045963.0,14797720.0,14248242.0,199,116,83,21210,10906,10304,25382176.0,12880956.0,12501219.0,118.43,120.38,118.11,121.32
2023-09-05 12:15,251,144,107,23657,11058,12599,28194280.0,13163766.0,15030514.0,174,106,68,19771,10385,9386,23659323.0,12278042.0,11381280.0,119.04,119.3,118.23,121.26
2023-09-05 12:20,181,95,86,16773,9020,7753,20072822.0,10718796.0,9354026.0,115,55,60,14147,5511,8636,16938845.0,6494605.0,10444240.0,118.83,120.65,117.85,120.94
2023-09-05 12:25,267,119,148,20524,9917,10607,24558382.0,11774299.0,12784083.0,180,80,100,18359,8912,9447,21982087.0,10520870.0,11461217.0,118.73,120.52,118.05,121.32
2023-09-05 12:30,1036,678,358,84758,52295,32463,104077064.0,64460459.0,39616605.0,613,432,181,57254,33484,23770,69154616.0,39983502.0,29171113.0,123.26,122.04,119.41,122.72
2023-09-05 12:35,895,394,501,77384,35679,41705,92946301.0,42672188.0,50274112.0,568,283,285,68193,32906,35287,82198795.0,39129524.0,43069270.0,119.6,120.55,118.91,122.05
2023-09-05 12:40,1077,465,612,100735,43386,57349,118586205.0,51000029.0,67586176.0,687,272,415,85044,38964,46080,100961423.0,45612320.0,55349103.0,117.55,117.85,117.06,120.12
2023-09-05 12:45,1054,511,543,84446,41790,42656,99895176.0,49030706.0,50864470.0,801,346,455,77077,37472,39605,91281584.0,43787478.0,47494106.0,117.33,119.24,116.85,119.92
2023-09-05 12:50,587,223,364,42329,17742,24587,50207906.0,20872358.0,29335547.0,420,126,294,37928,15940,21988,45064962.0,18690907.0,26374055.0,117.64,119.31,117.26,119.95
2023-09-05 12:55,306,126,180,19192,7377,11815,22907118.0,8809319.0,14097799.0,198,66,132,16545,6195,10350,19728122.0,7266429.0,12461693.0,119.42,119.32,117.3,120.4
2023-09-05 13:00,373,121,252,27048,10627,16421,32071701.0,12490786.0,19580915.0,268,71,197,24067,9546,14521,28581034.0,11168106.0,17412928.0,117.54,119.24,116.99,119.92
2023-09-05 13:05,235,91,144,12962,5757,7205,15528194.0,6877467.0,8650726.0,159,46,113,10990,5061,5929,13031202.0,5914520.0,7116681.0,119.46,120.07,116.86,120.03
2023-09-05 13:10,253,110,143,15542,6642,8900,18411283.0,7822628.0,10588655.0,162,50,112,13085,5710,7375,15521409.0,6670953.0,8850455.0,117.78,118.97,116.83,120.01
2023-09-05 13:15,347,147,200,31035,14833,16202,36588636.0,17378002.0,19210633.0,237,90,147,27880,13307,14573,32977453.0,15512306.0,17465147.0,117.16,118.57,116.57,119.85
2023-09-05 13:20,690,289,401,50557,21695,28862,59978097.0,25802989.0,34175108.0,463,168,295,44625,19758,24867,52654682.0,22999815.0,29654867.0,118.94,118.41,116.41,119.25
2023-09-05 13:25,1069,336,733,79494,30867,48627,94523882.0,36581026.0,57942855.0,942,266,676,74663,27743,46920,88265372.0,32362084.0,55903288.0,118.51,119.16,116.65,119.15
2023-09-05 13:30,420,244,176,39663,22289,17374,47611219.0,26470642.0,21140577.0,330,189,141,37022,20311,16711,44048594.0,23873180.0,20175413.0,118.76,121.68,117.54,120.73
2023-09-05 13:35,359,234,125,28753,14765,13988,34448912.0,17610126.0,16838786.0,249,165,84,26059,13587,12472,31024678.0,15986383.0,15038295.0,119.27,120.38,117.66,120.58
2023-09-05 13:40,417,215,202,35812,18526,17286,42693363.0,21889809.0,20803553.0,302,135,167,30086,15233,14853,35844828.0,17911800.0,17933027.0,118.16,120.35,117.59,120.74
2023-09-05 13:45,174,102,72,13544,6178,7366,16254637.0,7383684.0,8870953.0,111,67,44,13885,7878,6007,16534513.0,9266512.0,7268001.0,119.52,120.43,117.63,120.99
2023-09-05 13:50,426,321,105,28272,17429,10843,33973396.0,20826783.0,13146613.0,357,281,76,26687,15721,10966,31916219.0,18612259.0,13303959.0,119.49,121.25,118.39,121.32
2023-09-05 13:55,133,75,58,9148,4643,4505,10933910.0,5477026.0,5456884.0,104,64,40,8487,4515,3972,10150407.0,5314828.0,4835579.0,117.96,121.13,117.71,121.74
2023-09-05 14:00,146,80,66,11987,5784,6203,14345804.0,6844693.0,7501110.0,101,49,52,11232,5320,5912,13442650.0,6274062.0,7168588.0,118.34,120.93,117.93,121.25
2023-09-05 14:05,94,43,51,6218,3368,2850,7548931.0,4100411.0,3448520.0,63,33,30,6217,3506,2711,7422503.0,4133113.0,3289389.0,121.75,121.0,117.89,121.33
2023-09-05 14:10,199,119,80,15731,8090,7641,18838436.0,9671703.0,9166733.0,134,87,47,13047,6919,6128,15610612.0,8171561.0,7439050.0,119.55,119.97,118.1,121.39
2023-09-05 14:15,130,71,59,13267,5925,7342,15979483.0,7140453.0,8839030.0,72,42,30,10473,5110,5363,12543978.0,6037603.0,6506375.0,120.51,120.39,118.15,121.32
2023-09-05 14:20,133,76,57,15407,7640,7767,18534103.0,9136200.0,9397902.0,83,44,39,12997,5680,7317,15581643.0,6711839.0,8869803.0,119.58,121.0,118.17,121.22
2023-09-05 14:25,111,53,58,10356,4275,6081,12392320.0,5065313.0,7327007.0,71,38,33,10125,4586,5539,12116483.0,5402050.0,6714432.0,118.49,120.49,117.79,121.22
2023-09-05 14:30,82,43,39,6392,3181,3211,7656748.0,3805691.0,3851057.0,38,18,20,5125,2336,2789,6151614.0,2759591.0,3392023.0,119.64,119.93,118.13,121.62
2023-09-05 14:35,110,58,52,10745,4392,6353,12763553.0,5173799.0,7589754.0,61,34,27,9720,3942,5778,11646191.0,4648374.0,6997817.0,117.8,119.47,117.92,121.11
2023-09-05 14:40,287,116,171,19837,8370,11467,23609495.0,9862985.0,13746509.0,215,74,141,18484,7878,10606,22051871.0,9267927.0,12783944.0,117.84,119.88,117.64,120.54
2023-09-05 14:45,178,82,96,11656,5044,6612,13681512.0,5931172.0,7750339.0,125,50,75,10959,4747,6212,13047940.0,5566403.0,7481537.0,117.59,117.22,117.26,120.44
2023-09-05 14:50,353,93,260,20197,8781,11416,23954895.0,10328773.0,13626121.0,289,60,229,17971,6936,11035,21382327.0,8125525.0,13256801.0,117.63,119.36,117.15,120.13
2023-09-05 14:55,244,80,164,20136,8150,11986,23896654.0,9573434.0,14323219.0,181,47,134,18302,7667,10635,21758729.0,8990917.0,12767812.0,117.47,119.5,117.27,120.05
2023-09-05 15:00,93,49,44,5435,2604,2831,6412749.0,3064381.0,3348368.0,55,20,35,4536,2109,2427,5391640.0,2470998.0,2920642.0,117.68,118.28,117.16,120.34
2023-09-05 15:05,96,45,51,8587,4718,3869,10202076.0,5547641.0,4654434.0,68,23,45,7018,3263,3755,8340880.0,3820672.0,4520207.0,117.58,120.3,117.09,120.38
2023-09-05 15:10,282,122,160,21121,10096,11025,25216733.0,11961230.0,13255503.0,217,74,143,19572,8847,10725,23337538.0,10418139.0,12919398.0,118.47,120.23,117.76,120.46
2023-09-05 15:15,130,70,60,10332,5466,4866,12355105.0,6459353.0,5895752.0,103,50,53,9981,5282,4699,11930919.0,6232086.0,5698833.0,118.17,121.16,117.99,121.28
2023-09-05 15:20,75,40,35,6095,2776,3319,7337615.0,3279658.0,4057957.0,52,29,23,4904,2782,2122,5853088.0,3279714.0,2573373.0,118.14,122.26,117.89,121.27
2023-09-05 15:25,124,64,60,8130,4079,4051,9717926.0,4827942.0,4889984.0,89,45,44,7927,3892,4035,9471112.0,4588714.0,4882397.0,118.36,120.71,117.9,121.0
2023-09-05 15:30,163,100,63,12877,6693,6184,15431514.0,7936509.0,7495005.0,117,66,51,12749,6686,6063,15230983.0,7884097.0,7346886.0,118.58,121.2,117.92,121.18
2023-09-05 15:35,198,105,93,16673,8544,8129,19965913.0,10143821.0,9822092.0,139,79,60,15808,8193,7615,18904032.0,9664098.0,9239933.0,118.72,120.83,117.96,121.34
2023-09-05 15:40,159,98,61,10291,5227,5064,12315254.0,6169298.0,6145956.0,138,90,48,11315,6523,4792,13515787.0,7703268.0,5812518.0,118.03,121.37,118.09,121.3
2023-09-05 15:45,68,39,29,4197,2766,1431,5032926.0,3303151.0,1729775.0,42,23,19,2810,1390,1420,3361100.0,1642025.0,1719074.0,119.42,120.88,118.13,121.06
2023-09-05 15:50,86,40,46,6562,3221,3341,7861946.0,3843730.0,4018216.0,50,21,29,5518,2763,2755,6600408.0,3257521.0,3342887.0,119.33,120.27,117.9,121.34
2023-09-05 15:55,72,42,30,2746,1143,1603,3322813.0,1369990.0,1952823.0,31,18,13,1801,862,939,2157022.0,1015348.0,1141673.0,119.86,121.82,117.79,121.58
2023-09-05 16:00,83,44,39,5701,2911,2790,6816739.0,3436089.0,3380649.0,53,24,29,6070,3310,2760,7255646.0,3905924.0,3349721.0,118.04,121.17,118.0,121.37
2023-09-05 16:05,121,70,51,8669,4792,3877,10406811.0,5727156.0,4679655.0,75,45,30,7797,4801,2996,9332540.0,5698288.0,3634251.0,119.51,120.7,118.69,121.3
2023-09-05 16:10,359,198,161,32432,17740,14692,39028221.0,21210448.0,17817773.0,228,128,100,27206,14242,12964,32633806.0,16859875.0,15773931.0,119.56,121.28,118.38,121.67
2023-09-05 16:15,229,135,94,17737,8314,9423,21324128.0,9888456.0,11435672.0,156,94,62,14821,7612,7209,17782119.0,9020223.0,8761896.0,118.94,121.36,118.5,121.54
2023-09-05 16:20,364,234,130,29839,15190,14649,35731123.0,18023606.0,17707517.0,303,198,105,28279,14161,14118,33984266.0,16779221.0,17205044.0,118.65,120.88,118.49,121.87
2023-09-05 16:25,156,95,61,8693,4841,3852,10437692.0,5768459.0,4669233.0,104,63,41,8106,4451,3655,9720112.0,5273880.0,4446232.0,119.16,121.22,118.49,121.65
2023-09-05 16:30,271,131,140,21177,10299,10878,25449014.0,12291256.0,13157758.0,217,108,109,20995,10004,10991,25234933.0,11842144.0,13392789.0,119.34,120.96,118.37,121.85
2023-09-05 16:35,555,140,415,52000,18093,33907,62284058.0,21359229.0,40924829.0,512,121,391,50361,17679,32682,60346316.0,20866156.0,39480159.0,118.05,120.7,118.03,120.8
2023-09-05 16:40,1345,95,1250,93745,13106,80639,112306984.0,15456474.0,96850510.0,1307,76,1231,93025,12750,80275,111459193.0,15029340.0,96429853.0,117.93,120.1,117.88,120.12
2023-09-05 16:45,461,55,406,36266,7583,28683,43436134.0,8947678.0,34488455.0,441,47,394,35576,7452,28124,42617596.0,8784506.0,33833089.0,118.0,120.24,117.88,120.3
2023-09-05 16:50,369,51,318,23966,4834,19132,28677703.0,5704521.0,22973182.0,347,36,311,24509,4717,19792,29511349.0,5564049.0,23947299.0,118.01,120.08,117.96,120.99
2023-09-05 16:55,98,46,52,6078,2172,3906,7316783.0,2606644.0,4710139.0,59,29,30,4717,1984,2733,5661669.0,2342751.0,3318918.0,120.01,120.59,118.08,121.44
2023-09-05 17:00,557,447,110,40883,27133,13750,49199429.0,32499866.0,16699563.0,501,416,85,37914,25286,12628,45375105.0,30041930.0,15333175.0,119.78,121.45,118.81,121.42
2023-09-05 17:05,212,175,37,14154,11477,2677,16964735.0,13711043.0,3253692.0,188,168,20,13546,11325,2221,16212584.0,13514185.0,2698398.0,119.47,121.54,119.33,121.49
2023-09-05 17:10,819,776,43,57131,51766,5365,68357353.0,61872365.0,6484987.0,785,752,33,56716,51709,5007,67858219.0,61771530.0,6086689.0,119.52,120.88,119.46,121.56
2023-09-05 17:15,224,176,48,14853,9826,5027,17945926.0,11843761.0,6102164.0,178,148,30,13119,8766,4353,15717960.0,10422097.0,5295863.0,120.53,121.39,118.89,121.66
2023-09-05 17:20,275,156,119,17273,8095,9178,20450997.0,9597135.0,10853862.0,204,122,82,14440,7124,7316,17281512.0,8420894.0,8860618.0,118.56,118.26,118.2,121.11
2023-09-05 17:25,189,93,96,12396,6140,6256,14812459.0,7254368.0,7558091.0,141,65,76,11959,5698,6261,14291673.0,6721463.0,7570209.0,118.15,120.81,117.96,120.91
2023-09-05 17:30,294,197,97,27789,15231,12558,33228962.0,18022799.0,15206162.0,269,184,85,26992,14643,12349,32264978.0,17293420.0,14971558.0,118.33,121.09,118.1,121.24
2023-09-05 17:35,161,92,69,16360,8318,8042,19566693.0,9828457.0,9738236.0,122,69,53,15544,7808,7736,18584424.0,9204163.0,9380261.0,118.16,121.09,117.88,121.25
2023-09-05 17:40,174,95,79,16563,8145,8418,19801857.0,9614385.0,10187472.0,135,74,61,16314,7969,8345,19514013.0,9395417.0,10118596.0,118.04,121.02,117.9,121.25
2023-09-05 17:45,91,51,40,9177,4552,4625,10987547.0,5391016.0,5596530.0,68,37,31,8592,4218,4374,10270219.0,4972494.0,5297724.0,118.43,121.01,117.89,121.12
2023-09-05 17:50,1182,1047,135,82258,65100,17158,98501597.0,77672547.0,20829050.0,1128,1012,116,78782,63060,15722,94341348.0,75224208.0,19117140.0,119.31,121.4,119.29,121.59
2023-09-05 17:55,696,599,97,47009,34730,12279,56290028.0,41403115.0,14886913.0,674,595,79,46513,34468,12045,55695140.0,41057667.0,14637473.0,119.21,121.24,119.12,121.52
2023-09-05 18:00,489,217,272,38663,16169,22494,46147744.0,19149977.0,26997766.0,415,180,235,35784,15666,20118,42786990.0,18485366.0,24301624.0,118.44,120.02,118.0,120.8
2023-09-05 18:05,204,88,116,19614,8843,10771,23359808.0,10411491.0,12948317.0,179,75,104,18341,8765,9576,21862370.0,10300403.0,11561966.0,117.74,120.21,117.52,120.74
2023-09-05 18:10,108,49,59,6411,2583,3828,7647150.0,3038557.0,4608592.0,81,35,46,6949,2777,4172,8277141.0,3259531.0,5017610.0,117.64,120.39,117.38,120.27
2023-09-05 18:15,178,73,105,17222,8452,8770,20407307.0,9889228.0,10518079.0,135,48,87,15482,6933,8549,18483709.0,8134739.0,10348970.0,117.0,119.93,117.33,121.05
2023-09-05 18:20,247,96,151,26091,12075,14016,31069963.0,14213500.0,16856462.0,220,72,148,24693,11097,13596,29382686.0,13016440.0,16366246.0,117.71,120.27,117.3,120.38
2023-09-05 18:25,120,62,58,9858,4975,4883,11764180.0,5877888.0,5886292.0,84,44,40,9561,5187,4374,11383105.0,6097763.0,5285342.0,118.15,120.55,117.56,120.84
2023-09-05 18:30,79,39,40,4589,1883,2706,5466341.0,2222979.0,3243361.0,62,26,36,4131,1814,2317,4916541.0,2127042.0,2789498.0,118.06,119.86,117.26,120.39
2023-09-05 18:35,240,88,152,11634,4184,7450,13896319.0,5012687.0,8883632.0,180,47,133,11191,3425,7766,13348392.0,4021366.0,9327026.0,119.81,119.24,117.41,120.1
2023-09-06 10:00,1130,337,793,30735,11246,19489,36793910.0,12756359.0,24037550.0,142,42,100,5803,1999,3804,6881734.0,2322197.0,4559537.0,113.43,123.34,116.17,119.86
2023-09-06 10:05,2054,880,1174,73813,32631,41182,87694435.0,38724796.0,48969639.0,1668,676,992,65610,27129,38481,78040387.0,32079272.0,45961114.0,118.67,118.91,118.25,119.44
2023-09-06 10:10,525,131,394,20165,3660,16505,24031627.0,4384556.0,19647071.0,354,53,301,13971,2054,11917,16624321.0,2418052.0,14206268.0,119.8,119.04,117.72,119.21
2023-09-06 10:15,1328,444,884,83802,27465,56337,99058403.0,32167639.0,66890763.0,1011,235,776,78267,24660,53607,92844469.0,28797899.0,64046569.0,117.12,118.73,116.78,119.47
2023-09-06 10:20,5611,2860,2751,315235,174900,140335,385946481.0,214808332.0,171138149.0,2584,1588,996,221331,125345,95986,269127109.0,150883763.0,118243346.0,122.82,121.95,120.37,123.19
2023-09-06 10:25,3810,1744,2066,254673,109443,145230,309336568.0,132738413.0,176598155.0,2284,1042,1242,204842,95559,109283,249403194.0,114804468.0,134598725.0,121.29,121.6,120.14,123.17
2023-09-06 10:30,1592,857,735,123550,60818,62732,148435953.0,72480780.0,75955173.0,1037,548,489,112974,55508,57466,135598982.0,65688243.0,69910739.0,119.18,121.08,118.34,121.66
2023-09-06 10:35,1599,879,720,131101,61867,69234,156967362.0,73414343.0,83553018.0,1146,624,522,120556,58575,61981,144773283.0,69185445.0,75587837.0,118.66,120.68,118.11,121.95
2023-09-06 10:40,872,438,434,70701,32458,38243,83879594.0,38394314.0,45485280.0,566,259,307,61280,28288,32992,73213381.0,33297242.0,39916138.0,118.29,118.94,117.71,120.99
2023-09-06 10:45,1381,775,606,94489,46483,48006,112766957.0,55095489.0,57671468.0,1089,588,501,91026,43430,47596,108531567.0,51123301.0,57408265.0,118.53,120.13,117.71,120.62
2023-09-06 10:50,953,665,288,51000,32762,18238,61032683.0,38987849.0,22044834.0,804,579,225,47013,30372,16641,56173571.0,36034462.0,20139109.0,119.0,120.87,118.64,121.02
2023-09-06 10:55,602,428,174,41205,26259,14946,49506865.0,31337506.0,18169359.0,482,360,122,37563,25432,12131,44916867.0,30189611.0,14727256.0,119.34,121.57,118.71,121.4
2023-09-06 11:00,397,278,119,25515,16253,9262,30494357.0,19355470.0,11138886.0,297,220,77,22707,15374,7333,27169866.0,18279187.0,8890679.0,119.09,120.26,118.9,121.24
2023-09-06 11:05,741,511,230,35106,20180,14926,42042133.0,23995246.0,18046887.0,667,465,202,34269,19397,14872,40951641.0,22993077.0,17958563.0,118.91,120.91,118.54,120.75
2023-09-06 11:10,809,667,142,48272,33000,15272,57913231.0,39371899.0,18541331.0,720,625,95,45430,31616,13814,54323020.0,37556835.0,16766185.0,119.31,121.41,118.79,121.37
2023-09-06 11:15,933,765,168,69952,51015,18937,83660477.0,60746309.0,22914167.0,857,725,132,68283,50472,17811,81702324.0,60071851.0,21630473.0,119.08,121.0,119.02,121.44
2023-09-06 11:20,357,200,157,30345,15958,14387,36257326.0,18912187.0,17345138.0,265,153,112,28909,15206,13703,34538577.0,17929986.0,16608590.0,118.51,120.56,117.91,121.2
2023-09-06 11:25,837,669,168,63637,44479,19158,76325060.0,53076618.0,23248442.0,772,629,143,62363,43278,19085,74661711.0,51469423.0,23192287.0,119.33,121.35,118.93,121.52
2023-09-06 11:30,389,215,174,26724,13952,12772,31937164.0,16547455.0,15389709.0,287,167,120,21708,12893,8815,25925365.0,15266363.0,10659001.0,118.6,120.5,118.41,120.92
2023-09-06 11:35,463,302,161,38666,20535,18131,47483870.0,25561287.0,21922583.0,325,193,132,35442,18776,16666,42280090.0,22112399.0,20167690.0,124.48,120.91,117.77,121.01
2023-09-06 11:40,459,323,136,31986,20161,11825,39282388.0,24855971.0,14426417.0,279,198,81,27290,15959,11331,32754886.0,18951545.0,13803340.0,123.29,122.0,118.75,121.82
2023-09-06 11:45,1352,741,611,104930,60432,44498,129006370.0,74409043.0,54597326.0,828,507,321,82733,45888,36845,100775275.0,55183287.0,45591988.0,123.13,122.7,120.26,123.74
2023-09-06 11:50,2442,1204,1238,158802,62406,96396,193695877.0,75816685.0,117879191.0,1942,936,1006,140646,54707,85939,171651268.0,65954916.0,105696351.0,121.49,122.29,120.56,122.99
2023-09-06 11:55,1176,633,543,104256,58146,46110,127006698.0,70564415.0,56442283.0,883,509,374,95734,54117,41617,116611055.0,65209503.0,51401551.0,121.36,122.41,120.5,123.51
2023-09-06 12:00,1164,806,358,91937,56291,35646,112584122.0,68526481.0,44057641.0,950,694,256,88865,53489,35376,108443112.0,64638624.0,43804488.0,121.74,123.6,120.84,123.83
2023-09-06 12:05,2250,1631,619,129999,77198,52801,159971205.0,94884358.0,65086847.0,996,619,377,98789,56957,41832,121029888.0,69098828.0,51931059.0,122.91,123.27,121.32,124.14
2023-09-06 12:10,1690,975,715,131031,64960,66071,160920688.0,79359238.0,81561450.0,915,496,419,116656,57817,58839,143424815.0,70244976.0,73179839.0,122.17,123.45,121.5,124.37
2023-09-06 12:15,1388,978,410,101256,58250,43006,124649167.0,71306916.0,53342250.0,876,608,268,91293,51688,39605,111997922.0,62714226.0,49283695.0,122.42,124.03,121.33,124.44
2023-09-06 12:20,3343,1780,1563,207180,116552,90628,255343199.0,143805233.0,111537966.0,2615,1368,1247,183482,106636,76846,226299827.0,130546878.0,95752949.0,123.38,123.07,122.42,124.6
2023-09-06 12:25,1393,779,614,102052,49817,52235,124815959.0,60583490.0,64232469.0,953,514,439,90936,46229,44707,111637070.0,56062939.0,55574131.0,121.61,122.97,121.27,124.31
2023-09-06 12:30,1286,763,523,97898,49706,48192,119022769.0,60297623.0,58725146.0,787,438,349,78512,41837,36675,95565759.0,50309645.0,45256113.0,121.31,121.86,120.25,123.4
2023-09-06 12:35,702,496,206,47504,28222,19282,58508316.0,34632494.0,23875821.0,417,293,124,41843,24773,17070,51123486.0,29949076.0,21174409.0,122.71,123.82,120.89,124.04
2023-09-06 12:40,890,605,285,65245,36074,29171,79458697.0,43771765.0,35686931.0,607,420,187,56920,33403,23517,69615757.0,40430808.0,29184948.0,121.34,122.34,121.04,124.1
2023-09-06 12:45,1149,642,507,84398,41386,43012,102979208.0,50023638.0,52955569.0,870,464,406,80204,39493,40711,97859682.0,47591910.0,50267771.0,120.87,123.12,120.51,123.47
2023-09-06 12:50,981,496,485,87108,38277,48831,105973994.0,46076448.0,59897546.0,727,323,404,79159,35772,43387,96385432.0,42969061.0,53416370.0,120.38,122.66,120.12,123.12
2023-09-06 12:55,994,679,315,61077,32731,28346,74105547.0,39469580.0,34635967.0,779,520,259,57578,31063,26515,69976741.0,37350080.0,32626660.0,120.59,122.19,120.24,123.05
2023-09-06 13:00,764,377,387,54065,25066,28999,65578244.0,30121818.0,35456426.0,563,233,330,51576,23459,28117,62689842.0,28115572.0,34574269.0,120.17,122.27,119.85,122.97
2023-09-06 13:05,426,313,113,29973,18312,11661,36578399.0,22120336.0,14458063.0,302,229,73,27560,16521,11039,33659248.0,19954299.0,13704949.0,120.8,123.99,120.78,124.15
2023-09-06 13:10,551,292,259,49714,23595,26119,60696978.0,28570533.0,32126445.0,367,188,179,45468,21941,23527,55677302.0,26431092.0,29246209.0,121.09,123.0,120.46,124.31
2023-09-06 13:15,640,364,276,51714,26919,24795,63271080.0,32775130.0,30495950.0,451,275,176,46268,25128,21140,56583441.0,30375694.0,26207747.0,121.75,122.99,120.88,123.97
2023-09-06 13:20,871,464,407,72480,36801,35679,88171603.0,44475106.0,43696497.0,710,377,333,69710,35590,34120,84991181.0,42882923.0,42108257.0,120.85,122.47,120.49,123.41
2023-09-06 13:25,927,392,535,80989,35503,45486,98451121.0,42656455.0,55794665.0,753,293,460,77095,33810,43285,93795611.0,40538589.0,53257022.0,120.15,122.66,119.9,123.04
2023-09-06 13:30,430,176,254,34270,15285,18985,41470782.0,18305057.0,23165725.0,279,93,186,31491,14284,17207,38212087.0,17075560.0,21136527.0,119.76,122.02,119.54,122.84
2023-09-06 13:35,499,237,262,46418,22142,24276,56322279.0,26623535.0,29698744.0,349,163,186,44101,20551,23550,53508195.0,24560137.0,28948058.0,120.24,122.34,119.51,122.92
2023-09-06 13:40,385,186,199,32649,16694,15955,39700358.0,20087430.0,19612927.0,270,110,160,27911,12903,15008,33895274.0,15443886.0,18451388.0,120.33,122.93,119.69,122.94
2023-09-06 13:45,460,224,236,36542,17701,18841,44445584.0,21296945.0,23148638.0,330,147,183,35871,17369,18502,43635749.0,20822733.0,22813016.0,120.31,122.86,119.88,123.3
2023-09-06 13:50,868,215,653,70991,21136,49855,85737938.0,25348356.0,60389582.0,724,137,587,66874,20928,45946,81253723.0,25053618.0,56200104.0,119.93,121.13,119.71,122.32
2023-09-06 13:55,805,157,648,56906,15423,41483,68986413.0,18452814.0,50533598.0,711,101,610,55272,14366,40906,67054408.0,17144809.0,49909599.0,119.64,121.82,119.34,122.01
2023-09-06 14:00,1119,244,875,72744,19862,52882,88102179.0,23782271.0,64319907.0,1015,186,829,71200,19195,52005,86372081.0,22960806.0,63411275.0,119.74,121.63,119.62,121.93
2023-09-06 14:05,420,182,238,24393,11736,12657,29576040.0,14118477.0,15457563.0,338,140,198,23292,11146,12146,28227226.0,13368945.0,14858281.0,120.3,122.13,119.94,122.33
2023-09-06 14:10,677,314,363,56476,24031,32445,68240312.0,28775956.0,39464356.0,549,229,320,55543,24158,31385,67274653.0,28873583.0,38401069.0,119.75,121.63,119.52,122.35
2023-09-06 14:15,398,229,169,34469,17442,17027,41811025.0,21019381.0,20791643.0,286,166,120,31795,16063,15732,38555883.0,19227064.0,19328819.0,120.51,122.11,119.7,122.86
2023-09-06 14:20,457,202,255,40655,18527,22128,49275180.0,22220338.0,27054842.0,337,132,205,39809,17691,22118,48328686.0,21155280.0,27173405.0,119.93,122.27,119.58,122.86
2023-09-06 14:25,727,201,526,52861,16215,36646,64163161.0,19462716.0,44700445.0,647,156,491,50675,15202,35473,61527553.0,18201827.0,43325725.0,120.03,121.98,119.73,122.14
2023-09-06 14:30,1382,443,939,93432,35765,57667,113629261.0,43186602.0,70442659.0,1281,379,902,91701,34374,57327,111386237.0,41276081.0,70110156.0,120.75,122.15,120.08,122.3
2023-09-06 14:35,671,470,201,53066,30544,22522,64489107.0,36891742.0,27597364.0,550,401,149,50902,29384,21518,61810946.0,35301089.0,26509856.0,120.78,122.54,120.14,123.2
2023-09-06 14:40,848,310,538,68693,27359,41334,83391815.0,32943777.0,50448038.0,745,239,506,66666,26526,40140,80948617.0,31803675.0,49144941.0,120.41,122.05,119.9,122.43
2023-09-06 14:45,506,323,183,35608,18490,17118,43094289.0,22243995.0,20850293.0,402,271,131,33976,17933,16043,41273434.0,21529961.0,19743472.0,120.3,121.8,120.06,123.07
2023-09-06 14:50,576,219,357,51498,22003,29495,62486400.0,26356479.0,36129920.0,513,184,329,50744,21736,29008,61600934.0,26019125.0,35581809.0,119.79,122.5,119.71,122.66
2023-09-06 14:55,836,157,679,56847,12599,44248,69057555.0,15102606.0,53954949.0,768,120,648,54678,12232,42446,66379769.0,14641877.0,51737892.0,119.87,121.94,119.7,121.89
2023-09-06 15:00,545,85,460,40886,9048,31838,49494113.0,10810291.0,38683821.0,498,62,436,39628,8481,31147,48058641.0,10122745.0,37935896.0,119.48,121.5,119.36,121.8
2023-09-06 15:05,276,157,119,21637,11636,10001,26291866.0,14010897.0,12280969.0,193,100,93,20412,10518,9894,24821776.0,12608377.0,12213398.0,120.41,122.8,119.87,123.44
2023-09-06 15:10,275,111,164,21850,11138,10712,26480850.0,13342468.0,13138382.0,225,85,140,21151,10457,10694,25656894.0,12513494.0,13143400.0,119.79,122.65,119.67,122.9
2023-09-06 15:15,356,62,294,11812,4386,7426,14284921.0,5259461.0,9025460.0,305,27,278,10866,3838,7028,13171741.0,4591606.0,8580135.0,119.91,121.54,119.64,122.09
2023-09-06 15:20,280,114,166,17555,8477,9078,21282145.0,10170697.0,11111447.0,210,72,138,17338,8431,8907,21034379.0,10096243.0,10938136.0,119.98,122.4,119.75,122.8
2023-09-06 15:25,420,199,221,35802,18539,17263,43391208.0,22347892.0,21043316.0,333,154,179,34995,18961,16034,42356227.0,22650099.0,19706127.0,120.55,121.9,119.46,122.9
2023-09-06 15:30,472,157,315,47435,20350,27085,57174321.0,24319080.0,32855241.0,402,112,290,45572,19739,25833,55232410.0,23568044.0,31664366.0,119.5,121.3,119.4,122.57
2023-09-06 15:35,508,121,387,41577,12143,29434,50321241.0,14504875.0,35816365.0,447,78,369,39713,11241,28472,48123498.0,13416823.0,34706675.0,119.45,121.68,119.36,121.9
2023-09-06 15:40,815,157,658,65301,17281,48020,79026523.0,20648584.0,58377939.0,744,116,628,63198,16866,46332,76582690.0,20127924.0,56454766.0,119.49,121.57,119.34,121.85
2023-09-06 15:45,774,265,509,58115,21167,36948,69704654.0,25285615.0,44419038.0,586,152,434,54113,19336,34777,65417651.0,23010831.0,42406820.0,119.46,120.22,119.01,121.94
2023-09-06 15:50,316,177,139,26599,14725,11874,31964195.0,17500446.0,14463749.0,231,124,107,25651,14124,11527,30841319.0,16778768.0,14062551.0,118.85,121.81,118.8,122.0
2023-09-06 15:55,300,123,177,25396,11287,14109,30535086.0,13388226.0,17146860.0,239,85,154,22734,9561,13173,27361822.0,11337577.0,16024244.0,118.62,121.53,118.58,121.64
2023-09-06 16:00,348,111,237,27108,9292,17816,32607877.0,11092252.0,21515624.0,302,75,227,25901,8128,17773,31191071.0,9640631.0,21550440.0,119.37,120.77,118.61,121.25
2023-09-06 16:05,488,145,343,34526,10882,23644,41689733.0,12975208.0,28714524.0,418,101,317,34160,10807,23353,41210283.0,12839438.0,28370845.0,119.24,121.45,118.81,121.49
2023-09-06 16:10,720,338,382,54730,24088,30642,65977080.0,28826599.0,37150481.0,620,265,355,51736,22199,29537,62397383.0,26503912.0,35893470.0,119.67,121.24,119.39,121.52
2023-09-06 16:15,176,108,68,13221,6932,6289,15991209.0,8307906.0,7683302.0,137,82,55,13180,7078,6102,15932461.0,8448502.0,7483959.0,119.85,122.17,119.36,122.65
2023-09-06 16:20,363,203,160,26714,14130,12584,32197795.0,16876478.0,15321317.0,309,170,139,26485,14034,12451,31968385.0,16753361.0,15215024.0,119.44,121.75,119.38,122.2
2023-09-06 16:25,372,244,128,27901,18469,9432,33624401.0,22123844.0,11500557.0,326,215,111,28055,18732,9323,33817526.0,22430106.0,11387420.0,119.79,121.93,119.74,122.14
2023-09-06 16:30,127,53,74,10953,5024,5929,13223678.0,5993577.0,7230101.0,105,36,69,10742,4892,5850,12967916.0,5821259.0,7146657.0,119.3,121.94,119.0,122.17
2023-09-06 16:35,172,98,74,15132,7499,7633,18400365.0,8979965.0,9420399.0,130,66,64,14239,7340,6899,17231979.0,8769037.0,8462942.0,119.75,123.42,119.47,122.67
2023-09-06 16:40,129,67,62,10141,4631,5510,12289282.0,5545632.0,6743649.0,96,48,48,9723,4858,4865,11784491.0,5814535.0,5969956.0,119.75,122.39,119.69,122.71
2023-09-06 16:45,150,64,86,15906,7447,8459,19227445.0,8895849.0,10331596.0,129,53,76,15892,7442,8450,19254633.0,8889235.0,10365398.0,119.46,122.14,119.45,122.67
2023-09-06 16:50,204,104,100,21869,11232,10637,26503670.0,13452309.0,13051361.0,163,80,83,21526,11074,10452,26010260.0,13171050.0,12839209.0,119.77,122.7,118.94,122.84
2023-09-06 16:55,243,161,82,20350,11349,9001,24686585.0,13620240.0,11066345.0,197,124,73,20342,11071,9271,24653319.0,13258222.0,11395097.0,120.01,122.95,119.76,122.91
2023-09-06 17:00,237,140,97,19886,11247,8639,24458769.0,13835459.0,10623310.0,174,107,67,16881,9887,6994,20495981.0,11876125.0,8619855.0,123.01,122.97,120.12,123.25
2023-09-06 17:05,278,139,139,25922,12614,13308,31426387.0,15205320.0,16221066.0,203,106,97,24580,12109,12471,29904641.0,14509889.0,15394751.0,120.54,121.89,119.83,123.44
2023-09-06 17:10,212,126,86,14727,7704,7023,17881212.0,9256184.0,8625028.0,166,103,63,13675,7570,6105,16604415.0,9085539.0,7518875.0,120.15,122.81,120.02,123.16
2023-09-06 17:15,722,247,475,63467,24163,39304,76512835.0,28879669.0,47633165.0,639,198,441,60662,23253,37409,73492718.0,27784795.0,45707923.0,119.52,121.19,119.49,122.18
2023-09-06 17:20,570,208,362,43262,17868,25394,52343052.0,21350282.0,30992769.0,500,166,334,42018,17530,24488,50807063.0,20919582.0,29887480.0,119.49,122.05,119.34,122.05
2023-09-06 17:25,1274,194,1080,80236,21729,58507,96992529.0,25880095.0,71112433.0,1221,166,1055,79410,21346,58064,96011460.0,25415914.0,70595546.0,119.1,121.55,119.07,121.58
2023-09-06 17:30,1013,77,936,69037,8855,60182,83404057.0,10547864.0,72856193.0,969,49,920,68683,8470,60213,83044650.0,10070453.0,72974197.0,119.12,121.06,118.9,121.19
2023-09-06 17:35,895,120,775,64844,12448,52396,78358480.0,14812304.0,63546175.0,862,98,764,64746,12336,52410,78246689.0,14672846.0,63573842.0,118.99,121.28,118.94,121.3
2023-09-06 17:40,628,367,261,58495,32706,25789,70788522.0,39252039.0,31536482.0,586,338,248,57502,31838,25664,69462723.0,38064379.0,31398343.0,120.01,122.29,119.56,122.34
2023-09-06 17:45,380,265,115,29273,17561,11712,35425416.0,21060194.0,14365222.0,342,240,102,28995,17417,11578,35161704.0,20876936.0,14284768.0,119.93,122.65,119.87,123.38
2023-09-06 17:50,283,177,106,23893,12479,11414,28919403.0,14943684.0,13975719.0,236,150,86,23648,12439,11209,28666153.0,14882467.0,13783685.0,119.75,122.44,119.64,122.97
2023-09-06 17:55,352,125,227,28356,11445,16911,34299197.0,13676013.0,20623184.0,282,100,182,27076,11316,15760,32757103.0,13490851.0,19266252.0,119.49,121.95,119.22,122.25
2023-09-06 18:00,416,105,311,30385,9870,20515,36554662.0,11727210.0,24827452.0,358,67,291,29271,9404,19867,35286775.0,11158973.0,24127801.0,118.82,121.02,118.66,121.45
2023-09-06 18:05,317,95,222,28122,10707,17415,33927346.0,12776663.0,21150682.0,283,73,210,27424,10094,17330,33058210.0,11983856.0,21074353.0,119.33,121.45,118.72,121.61
2023-09-06 18:10,528,98,430,38247,10644,27603,45986711.0,12634937.0,33351773.0,491,81,410,37815,10908,26907,45570234.0,12936824.0,32633409.0,118.7,120.83,118.6,121.28
2023-09-06 18:15,354,109,245,30040,13294,16746,36022475.0,15719809.0,20302665.0,291,69,222,27069,10937,16132,32567046.0,12967441.0,19599604.0,118.25,121.24,118.56,121.5
2023-09-06 18:20,355,76,279,26442,9237,17205,31783660.0,10944535.0,20839125.0,349,68,281,27515,9356,18159,33145927.0,11052502.0,22093424.0,118.49,121.12,118.13,121.67
2023-09-06 18:25,807,582,225,60473,38510,21963,72939380.0,46129698.0,26809682.0,744,549,195,59800,37984,21816,72021394.0,45376285.0,26645109.0,119.79,122.07,119.46,122.14
2023-09-06 18:30,405,150,255,32126,13972,18154,38676915.0,16608977.0,22067937.0,377,137,240,31891,14070,17821,38429983.0,16725904.0,21704078.0,118.87,121.56,118.88,121.79
2023-09-06 18:35,212,100,112,14414,6451,7963,17344181.0,7693022.0,9651159.0,176,73,103,13606,5886,7720,16375392.0,6994257.0,9381134.0,119.25,121.2,118.83,121.52
2023-09-07 10:00,1429,493,936,36262,13803,22459,46060749.0,15825937.0,30234811.0,269,153,116,11541,6049,5492,13990226.0,7277019.0,6713207.0,114.66,134.62,120.3,122.24
2023-09-07 10:05,582,265,317,11033,3510,7523,13426753.0,4251915.0,9174838.0,286,128,158,5549,1691,3858,6663434.0,2017979.0,4645454.0,121.14,121.96,119.34,120.41
2023-09-07 10:10,552,268,284,12347,5536,6811,14621932.0,6710597.0,7911335.0,265,111,154,4951,2138,2813,5913827.0,2538762.0,3375065.0,121.22,116.16,118.74,119.98
2023-09-07 10:15,903,435,468,50405,24067,26338,59743800.0,28351428.0,31392372.0,473,190,283,45442,22190,23252,54254656.0,26119105.0,28135550.0,117.8,119.19,117.71,121.0
2023-09-07 10:20,789,346,443,64869,31199,33670,77464626.0,36801341.0,40663285.0,573,225,348,62507,29832,32675,74647346.0,35104629.0,39542716.0,117.96,120.77,117.67,121.02
2023-09-07 10:25,833,300,533,58171,25086,33085,68960943.0,29507730.0,39453213.0,579,164,415,51912,22955,28957,61854070.0,26940476.0,34913593.0,117.63,119.25,117.36,120.57
2023-09-07 10:30,449,225,224,35719,17357,18362,42540879.0,20463696.0,22077182.0,293,122,171,32546,16225,16321,38658647.0,19004329.0,19654318.0,117.9,120.23,117.13,120.42
2023-09-07 10:35,769,374,395,59041,27528,31513,70669917.0,32619087.0,38050830.0,639,289,350,56713,26204,30509,67723800.0,30901396.0,36822403.0,118.49,120.75,117.93,120.69
2023-09-07 10:40,460,191,269,33431,15170,18261,39924942.0,17851627.0,22073315.0,376,146,230,30618,14024,16594,36596920.0,16524204.0,20072715.0,117.68,120.88,117.83,120.96
2023-09-07 10:45,27767,241,27526,403260,16029,387231,483147502.0,18983406.0,464164096.0,27664,181,27483,401863,15419,386444,481405477.0,18206362.0,463199114.0,118.43,119.87,118.08,119.86
2023-09-07 10:50,1313,550,763,88811,39397,49414,107493710.0,47440856.0,60052854.0,1074,428,646,82685,35604,47081,99595657.0,42310632.0,57285025.0,120.42,121.53,118.84,121.67
2023-09-07 10:55,675,217,458,51524,21109,30415,62132135.0,25089740.0,37042395.0,585,181,404,48788,20217,28571,58874964.0,24028459.0,34846504.0,118.86,121.79,118.85,121.96
2023-09-07 11:00,518,160,358,34708,12402,22306,41521392.0,14716713.0,26804679.0,416,108,308,32257,11885,20372,38725837.0,14056749.0,24669088.0,118.66,120.17,118.27,121.09
2023-09-07 11:05,1443,218,1225,99908,27752,72156,119993766.0,32891226.0,87102540.0,1360,175,1185,98279,26716,71563,118031407.0,31594030.0,86437376.0,118.52,120.71,118.26,120.79
2023-09-07 11:10,1008,515,493,68756,37619,31137,82405054.0,44781512.0,37623541.0,926,485,441,67176,36874,30302,80535155.0,43851727.0,36683427.0,119.04,120.83,118.92,121.06
2023-09-07 11:15,382,168,214,28356,13742,14614,34082411.0,16322959.0,17759451.0,299,121,178,26250,12584,13666,31518526.0,14901738.0,16616787.0,118.78,121.52,118.42,121.59
2023-09-07 11:20,160,70,90,11949,5592,6357,14319418.0,6629664.0,7689753.0,119,55,64,11840,5773,6067,14227051.0,6834814.0,7392237.0,118.56,120.97,118.39,121.84
2023-09-07 11:25,1972,442,1530,108677,29492,79185,130440877.0,34937163.0,95503713.0,1897,409,1488,106742,28955,77787,128016723.0,34231554.0,93785168.0,118.46,120.61,118.22,120.57
2023-09-07 11:30,1553,257,1296,84636,20235,64401,101398918.0,23942975.0,77455942.0,1460,197,1263,83088,19573,63515,99653810.0,23124960.0,76528850.0,118.32,120.27,118.15,120.49
2023-09-07 11:35,5920,161,5759,187116,15701,171415,224637669.0,18560584.0,206077085.0,5878,141,5737,186846,15402,171444,224333840.0,18201679.0,206132161.0,118.21,120.22,118.18,120.23
2023-09-07 11:40,225,100,125,18268,8743,9525,21870815.0,10335698.0,11535117.0,178,81,97,17889,8603,9286,21431905.0,10159474.0,11272430.0,118.22,121.1,118.09,121.39
2023-09-07 11:45,340,99,241,24404,9843,14561,29181449.0,11612264.0,17569184.0,283,75,208,23965,9812,14153,28683091.0,11570268.0,17112823.0,117.97,120.66,117.92,120.91
2023-09-07 11:50,228,70,158,14053,5185,8868,17883237.0,7212559.0,10670677.0,185,45,140,13036,4886,8150,15603452.0,5763916.0,9839535.0,139.1,120.33,117.97,120.73
2023-09-07 11:55,470,140,330,33011,13390,19621,39568390.0,15897089.0,23671301.0,417,119,298,32068,12903,19165,38410726.0,15238192.0,23172533.0,118.72,120.64,118.1,120.91
2023-09-07 12:00,618,63,555,35215,5510,29705,42198724.0,6500517.0,35698207.0,591,51,540,35007,5478,29529,41942800.0,6452478.0,35490322.0,117.98,120.18,117.79,120.19
2023-09-07 12:05,218,75,143,15498,6836,8662,18512403.0,8062261.0,10450141.0,178,55,123,15471,6936,8535,18492397.0,8173031.0,10319366.0,117.94,120.64,117.83,120.91
2023-09-07 12:10,267,94,173,20190,9041,11149,24031871.0,10644339.0,13387532.0,220,71,149,19247,8508,10739,22980776.0,10011019.0,12969756.0,117.73,120.08,117.67,120.77
2023-09-07 12:15,159,53,106,10148,4107,6041,12065277.0,4832075.0,7233202.0,114,35,79,9281,4026,5255,11073581.0,4732631.0,6340949.0,117.65,119.74,117.55,120.67
2023-09-07 12:20,246,125,121,18424,8706,9718,21842773.0,10243237.0,11599535.0,167,74,93,16450,7901,8549,19620883.0,9290561.0,10330322.0,117.66,119.36,117.59,120.84
2023-09-07 12:25,201,109,92,18054,8911,9143,21547346.0,10496383.0,11050962.0,160,86,74,17484,8739,8745,20848114.0,10275085.0,10573028.0,117.79,120.87,117.58,120.9
2023-09-07 12:30,119,56,63,10826,5099,5727,12877147.0,6003603.0,6873543.0,88,38,50,10210,4724,5486,12174180.0,5548259.0,6625921.0,117.74,120.02,117.45,120.78
2023-09-07 12:35,119,57,62,10328,4630,5698,12300637.0,5458521.0,6842116.0,69,30,39,8614,4371,4243,10276773.0,5142411.0,5134362.0,117.89,120.08,117.65,121.01
2023-09-07 12:40,145,73,72,9076,4377,4699,10778529.0,5185451.0,5593077.0,105,50,55,8187,3919,4268,9756659.0,4605442.0,5151217.0,118.47,119.03,117.52,120.69
2023-09-07 12:45,116,68,48,5171,2592,2579,6142040.0,3061545.0,3080494.0,66,37,29,4420,2203,2217,5272519.0,2591603.0,2680915.0,118.12,119.45,117.64,120.93
2023-09-07 12:50,61,39,22,3808,1889,1919,4560334.0,2240004.0,2320330.0,34,25,9,1655,951,704,1972025.0,1121125.0,850900.0,118.58,120.91,117.89,120.87
2023-09-07 12:55,87,37,50,6412,2824,3588,7519986.0,3322354.0,4197631.0,51,23,28,5643,2728,2915,6733265.0,3203732.0,3529532.0,117.65,116.99,117.44,121.08
2023-09-07 13:00,132,66,66,12388,6047,6341,14721725.0,7114763.0,7606962.0,100,46,54,13459,5908,7551,16039741.0,6934961.0,9104780.0,117.66,119.96,117.38,120.58
2023-09-07 13:05,123,62,61,9705,4212,5493,11519138.0,4953700.0,6565438.0,80,38,42,7886,3836,4050,9393831.0,4504696.0,4889135.0,117.61,119.52,117.43,120.72
2023-09-07 13:10,212,107,105,18993,8823,10170,22426644.0,10361123.0,12065521.0,148,69,79,18343,8666,9677,21832177.0,10167409.0,11664768.0,117.43,118.64,117.33,120.54
2023-09-07 13:15,474,263,211,37651,18699,18952,44542542.0,21991309.0,22551233.0,368,212,156,34614,17742,16872,41129539.0,20808719.0,20320819.0,117.61,118.99,117.29,120.44
2023-09-07 13:20,1500,634,866,114132,48729,65403,131531356.0,56181764.0,75349592.0,689,298,391,79076,37369,41707,92103347.0,42795886.0,49307461.0,115.29,115.21,114.52,118.22
2023-09-07 13:25,1161,645,516,82667,38572,44095,95507578.0,44686456.0,50821122.0,650,312,338,67048,29637,37411,77667917.0,33789360.0,43878557.0,115.85,115.25,114.01,117.29
2023-09-07 13:30,1072,631,441,97396,51620,45776,112850295.0,59510934.0,53339360.0,681,348,333,86731,44211,42520,99960918.0,50227544.0,49733374.0,115.29,116.52,113.61,116.96
2023-09-07 13:35,1159,855,304,84669,54204,30465,98377192.0,62683880.0,35693312.0,893,684,209,78485,51048,27437,91146341.0,58841317.0,32305023.0,115.64,117.16,115.27,117.74
2023-09-07 13:40,553,377,176,44273,23829,20444,52034680.0,27535291.0,24499388.0,435,295,140,39576,22992,16584,46035556.0,26480329.0,19555227.0,115.55,119.84,115.17,117.92
2023-09-07 13:45,910,623,287,52467,31614,20853,61005848.0,36549874.0,24455974.0,766,507,259,50664,29761,20903,58879758.0,34291412.0,24588346.0,115.61,117.28,115.22,117.63
2023-09-07 13:50,749,289,460,47026,18824,28202,54548022.0,21585059.0,32962963.0,648,235,413,46669,17699,28970,54378423.0,20283895.0,34094528.0,114.67,116.88,114.6,117.69
2023-09-07 13:55,1070,390,680,64134,23216,40918,74337867.0,26666946.0,47670920.0,922,286,636,62173,21764,40409,72260185.0,24963702.0,47296482.0,114.86,116.5,114.7,117.04
2023-09-07 14:00,740,334,406,54776,23049,31727,63479540.0,26409757.0,37069783.0,651,264,387,53231,22103,31128,61726376.0,25293139.0,36433236.0,114.58,116.84,114.43,117.04
2023-09-07 14:05,776,235,541,67621,23816,43805,78667519.0,27159100.0,51508419.0,666,170,496,65261,22419,42842,76026763.0,25581631.0,50445132.0,114.04,117.59,114.11,117.75
2023-09-07 14:10,836,408,428,67310,30696,36614,77223572.0,34900134.0,42323438.0,623,284,339,64981,29692,35289,75210357.0,33644067.0,41566290.0,113.7,115.59,113.31,117.79
2023-09-07 14:15,837,523,314,66606,37263,29343,76844342.0,42839989.0,34004353.0,587,370,217,59471,33072,26399,68345776.0,37569217.0,30776558.0,114.97,115.89,113.6,116.58
2023-09-07 14:20,707,235,472,48205,16869,31336,55839671.0,19344106.0,36495565.0,590,172,418,46420,16259,30161,53781511.0,18559934.0,35221576.0,114.67,116.47,114.15,116.78
2023-09-07 14:25,420,312,108,29949,18002,11947,34690463.0,20735268.0,13955195.0,323,243,80,27643,16527,11116,31917673.0,18897975.0,13019697.0,115.18,116.81,114.35,117.13
2023-09-07 14:30,655,541,114,50005,35595,14410,57815734.0,40930529.0,16885204.0,572,480,92,47372,33522,13850,54763000.0,38496465.0,16266534.0,114.99,117.18,114.84,117.45
2023-09-07 14:35,1192,822,370,93300,59343,33957,107712857.0,68220869.0,39491987.0,1022,716,306,88847,56852,31995,102685394.0,65251360.0,37434033.0,114.96,116.3,114.77,117.0
2023-09-07 14:40,422,294,128,38662,23071,15591,45225823.0,26666354.0,18559469.0,326,216,110,35218,20428,14790,40957351.0,23466996.0,17490355.0,115.58,119.04,114.88,118.26
2023-09-07 14:45,1399,654,745,104418,49823,54595,123588263.0,57676082.0,65912181.0,1162,555,607,95541,46461,49080,111721121.0,53677401.0,58043720.0,115.76,120.73,115.53,118.26
2023-09-07 14:50,880,502,378,76949,41727,35222,90008445.0,48263988.0,41744456.0,687,406,281,74283,38809,35474,87196627.0,44960407.0,42236220.0,115.67,118.52,115.85,119.06
2023-09-07 14:55,832,527,305,64339,34596,29743,75520958.0,40158329.0,35362629.0,704,455,249,60398,32465,27933,70896089.0,37625901.0,33270187.0,116.08,118.89,115.9,119.11
2023-09-07 15:00,303,193,110,28323,15577,12746,33231575.0,18071911.0,15159663.0,250,171,79,25225,13901,11324,29609805.0,16118897.0,13490908.0,116.02,118.94,115.95,119.14
2023-09-07 15:05,226,125,101,21660,9730,11930,25394258.0,11306611.0,14087647.0,189,112,77,20326,10284,10042,23857920.0,11907009.0,11950910.0,116.2,118.09,115.78,119.01
2023-09-07 15:10,264,127,137,28721,14407,14314,33619793.0,16692176.0,16927616.0,213,98,115,25781,11485,14296,30216246.0,13278905.0,16937341.0,115.86,118.26,115.62,118.48
2023-09-07 15:15,298,177,121,21460,11131,10329,25122817.0,12869040.0,12253777.0,268,159,109,23499,13378,10121,27469120.0,15459910.0,12009209.0,115.61,118.63,115.56,118.66
2023-09-07 15:20,798,499,299,65024,38569,26455,75476717.0,44533515.0,30943202.0,683,436,247,61477,36639,24838,71627722.0,42283160.0,29344561.0,115.46,116.97,115.4,118.14
2023-09-07 15:25,920,540,380,65018,37169,27849,75750205.0,42974476.0,32775728.0,883,517,366,65796,37443,28353,76800256.0,43235199.0,33565056.0,115.62,117.69,115.47,118.38
2023-09-07 15:30,274,179,95,18398,10409,7989,21562852.0,12037574.0,9525278.0,235,155,80,17127,10251,6876,19962977.0,11847668.0,8115308.0,115.65,119.23,115.58,118.02
2023-09-07 15:35,135,80,55,11028,5811,5217,12866438.0,6695105.0,6171333.0,110,69,41,10421,5618,4803,12155979.0,6467332.0,5688646.0,115.21,118.29,115.12,118.44
2023-09-07 15:40,176,93,83,15677,8188,7489,18288922.0,9432702.0,8856219.0,146,79,67,15449,8057,7392,18029740.0,9276954.0,8752786.0,115.2,118.26,115.14,118.41
2023-09-07 15:45,114,49,65,11327,6327,5000,13172132.0,7283021.0,5889111.0,93,40,53,10149,5650,4499,11813328.0,6497280.0,5316047.0,115.11,117.78,115.0,118.16
2023-09-07 15:50,183,91,92,17059,8181,8878,19881547.0,9404309.0,10477237.0,157,75,82,16346,8074,8272,19059660.0,9285568.0,9774092.0,114.95,118.01,115.01,118.16
2023-09-07 15:55,147,83,64,13146,6940,6206,15304088.0,7999931.0,7304156.0,115,62,53,12391,6402,5989,14446605.0,7370079.0,7076525.0,115.27,117.7,115.12,118.16
2023-09-07 16:00,1174,232,942,73376,17027,56349,85567115.0,19627116.0,65939998.0,1117,211,906,72454,16860,55594,84518624.0,19398921.0,65119703.0,115.27,117.02,115.06,117.13
2023-09-07 16:05,1065,140,925,79258,16063,63195,92437962.0,18443008.0,73994954.0,1026,124,902,78739,15890,62849,91836142.0,18239713.0,73596429.0,114.82,117.09,114.79,117.1
2023-09-07 16:10,512,117,395,37100,9333,27767,43279913.0,10771495.0,32508417.0,480,98,382,36219,8786,27433,42239873.0,10083381.0,32156491.0,115.41,117.08,114.77,117.22
2023-09-07 16:15,1268,609,659,105736,51025,54711,124297107.0,59401379.0,64895727.0,902,431,471,92121,42801,49320,108200587.0,49636681.0,58563906.0,116.42,118.62,115.97,118.74
2023-09-07 16:20,1299,415,884,107172,46509,60663,124614652.0,53300040.0,71314611.0,1001,333,668,99191,43334,55857,115440595.0,49699370.0,65741225.0,114.6,117.56,114.69,117.7
2023-09-07 16:25,455,228,227,42058,19778,22280,48842854.0,22628157.0,26214696.0,366,198,168,39398,18898,20500,45721090.0,21612668.0,24108422.0,114.41,117.66,114.36,117.6
2023-09-07 16:30,291,132,159,29675,14667,15008,34448900.0,16816112.0,17632787.0,265,112,153,27439,13005,14434,31912754.0,14895186.0,17017567.0,114.65,117.49,114.53,117.9
2023-09-07 16:35,276,147,129,30898,15990,14908,35759812.0,18286085.0,17473726.0,227,114,113,29600,15072,14528,34293875.0,17216423.0,17077452.0,114.36,117.21,114.23,117.55
2023-09-07 16:40,266,128,138,28522,14331,14191,33070106.0,16390936.0,16679170.0,243,117,126,29056,14595,14461,35252163.0,16679576.0,18572587.0,114.37,117.53,114.28,128.43
2023-09-07 16:45,296,164,132,31507,16040,15467,39650876.0,18379412.0,21271464.0,256,139,117,30646,15595,15051,37085566.0,17842996.0,19242569.0,114.58,137.53,114.41,127.85
2023-09-07 16:50,110,63,47,9307,4674,4633,10817380.0,5368175.0,5449205.0,91,52,39,8981,4555,4426,10424644.0,5216135.0,5208509.0,114.85,117.62,114.51,117.68
2023-09-07 16:55,441,303,138,33292,18931,14361,38503315.0,21723470.0,16779844.0,411,286,125,33670,19752,13918,39004890.0,22651587.0,16353303.0,114.75,116.84,114.68,117.5
2023-09-07 17:00,262,134,128,23158,11185,11973,26857838.0,12798632.0,14059205.0,201,99,102,22507,10913,11594,26098066.0,12472470.0,13625595.0,114.43,117.42,114.29,117.52
2023-09-07 17:05,292,120,172,29680,13762,15918,34374500.0,15798807.0,18575692.0,241,95,146,28133,13227,14906,32616044.0,15112731.0,17503312.0,114.8,116.7,114.26,117.42
2023-09-07 17:10,315,140,175,28353,14183,14170,32798411.0,16226096.0,16572315.0,269,111,158,27261,13387,13874,31583428.0,15304349.0,16279079.0,114.41,116.95,114.32,117.34
2023-09-07 17:15,393,148,245,35881,16312,19569,40939352.0,18547310.0,22392041.0,294,103,191,32073,15678,16395,36934980.0,17798846.0,19136134.0,113.7,114.43,113.53,116.72
2023-09-07 17:20,315,153,162,27271,13466,13805,31167217.0,15232014.0,15935203.0,231,110,121,25978,12765,13213,29786671.0,14424330.0,15362340.0,113.11,115.43,113.0,116.27
2023-09-07 17:25,383,143,240,34140,15559,18581,39251688.0,17964815.0,21286873.0,299,95,204,31256,14982,16274,35639349.0,16806568.0,18832780.0,115.46,114.56,112.18,115.72
2023-09-07 17:30,320,89,231,21657,8731,12926,24666445.0,9982941.0,14683504.0,240,58,182,18889,7937,10952,21649819.0,8933233.0,12716586.0,114.34,113.6,112.55,116.11
2023-09-07 17:35,943,466,477,72837,34808,38029,82004694.0,38966976.0,43037718.0,605,289,316,64769,32435,32334,73087252.0,36031023.0,37056229.0,111.95,113.17,111.09,114.6
2023-09-07 17:40,316,191,125,27997,14559,13438,31840581.0,16369097.0,15471484.0,223,118,105,26500,12938,13562,30119487.0,14496108.0,15623379.0,112.43,115.13,112.04,115.2
2023-09-07 17:45,470,192,278,44481,20686,23795,50639603.0,23241208.0,27398395.0,376,154,222,40844,19061,21783,46503336.0,21385461.0,25117875.0,112.35,115.14,112.19,115.31
2023-09-07 17:50,261,140,121,25288,13203,12085,28686872.0,14827361.0,13859511.0,207,105,102,23618,11880,11738,26823519.0,13308186.0,13515333.0,112.3,114.68,112.02,115.14
2023-09-07 17:55,398,202,196,37414,18532,18882,42583501.0,20908263.0,21675237.0,311,140,171,35298,16948,18350,40093033.0,18954719.0,21138314.0,112.82,114.79,111.84,115.2
2023-09-07 18:00,389,220,169,35361,17922,17439,40393324.0,20319683.0,20073641.0,329,184,145,33119,17715,15404,37654213.0,19887710.0,17766503.0,113.38,115.11,112.26,115.34
2023-09-07 18:05,162,97,65,15226,7760,7466,17346240.0,8723694.0,8622546.0,132,79,53,14832,7426,7406,16875535.0,8333017.0,8542518.0,112.42,115.49,112.21,115.35
2023-09-07 18:10,222,141,81,15651,8539,7112,17893703.0,9682028.0,8211675.0,131,76,55,14391,7728,6663,16403115.0,8697121.0,7705994.0,113.39,115.46,112.54,115.65
2023-09-07 18:15,274,154,120,25887,13425,12462,29610821.0,15155195.0,14455626.0,212,118,94,24964,13036,11928,28542144.0,14709443.0,13832701.0,112.89,116.0,112.84,115.97
2023-09-07 18:20,191,94,97,18440,8387,10053,21138660.0,9465569.0,11673091.0,159,70,89,17973,8301,9672,20654148.0,9339768.0,11314379.0,112.86,116.12,112.51,116.98
2023-09-07 18:25,200,123,77,13516,7668,5848,15466920.0,8674621.0,6792299.0,134,78,56,12730,6782,5948,14637862.0,7664652.0,6973210.0,113.13,116.15,113.01,117.24
2023-09-07 18:30,183,114,69,5176,3844,1332,5963938.0,4438259.0,1525678.0,117,72,45,4358,3354,1004,4980639.0,3826195.0,1154443.0,115.46,114.54,114.08,114.98
2023-09-07 18:35,185,109,76,4628,2779,1849,5332491.0,3238365.0,2094126.0,128,70,58,3623,2407,1216,4159918.0,2738985.0,1420933.0,116.53,113.26,113.79,116.85
2023-09-08 10:00,1567,698,869,48104,26001,22103,58940273.0,29812584.0,29127688.0,691,514,177,28011,21595,6416,32266715.0,24798502.0,7468212.0,114.66,131.78,114.83,116.4
2023-09-08 10:05,513,183,330,14973,6145,8828,17359485.0,6884572.0,10474913.0,282,104,178,8139,3007,5132,9452792.0,3468814.0,5983978.0,112.04,118.66,115.36,116.6
2023-09-08 10:10,299,148,151,12977,4090,8887,14894100.0,4692134.0,10201966.0,167,93,74,9910,3173,6737,11438032.0,3620720.0,7817312.0,114.72,114.8,114.11,116.04
2023-09-08 10:15,510,259,251,31908,14704,17204,36265202.0,16513977.0,19751225.0,333,155,178,25447,11037,14410,28952853.0,12384088.0,16568765.0,112.31,114.81,112.21,114.98
2023-09-08 10:20,7908,7575,333,89330,73435,15895,100430048.0,82648838.0,17781210.0,7552,7390,162,85215,71778,13437,96198555.0,80786769.0,15411785.0,112.55,111.87,112.55,114.7
2023-09-08 10:25,327,141,186,25735,12180,13555,29051118.0,13557822.0,15493296.0,240,95,145,26180,13059,13121,29542953.0,14533144.0,15009809.0,111.31,114.3,111.29,114.4
2023-09-08 10:30,274,133,141,21617,10405,11212,24406673.0,11575933.0,12830739.0,204,89,115,20832,10004,10828,23491134.0,11113730.0,12377404.0,111.25,114.44,111.09,114.31
2023-09-08 10:35,523,230,293,38898,16037,22861,43216713.0,17760031.0,25456682.0,279,112,167,30681,14089,16592,34450687.0,15576056.0,18874631.0,110.74,111.35,110.55,113.76
2023-09-08 10:40,696,366,330,53387,26805,26582,58829642.0,29282457.0,29547185.0,426,168,258,47502,21101,26401,52573963.0,22977227.0,29596735.0,109.24,111.15,108.89,112.1
2023-09-08 10:45,531,228,303,37537,16390,21147,41476030.0,17940531.0,23535499.0,390,124,266,34848,14935,19913,38590228.0,16291423.0,22298804.0,109.46,111.29,109.08,111.98
2023-09-08 10:50,467,217,250,30305,14903,15402,33586611.0,16379674.0,17206937.0,317,118,199,27370,13255,14115,30365826.0,14511554.0,15854272.0,109.91,111.72,109.48,112.32
2023-09-08 10:55,366,161,205,32512,15768,16744,35892505.0,17105154.0,18787351.0,286,111,175,30466,14158,16308,33872652.0,15509823.0,18362829.0,108.48,112.2,109.55,112.6
2023-09-08 11:00,232,103,129,19612,8809,10803,21753965.0,9629335.0,12124630.0,167,67,100,18156,8666,9490,20155447.0,9480963.0,10674483.0,109.31,112.23,109.4,112.48
2023-09-08 11:05,205,108,97,13298,6713,6585,14688046.0,7354177.0,7333868.0,126,60,66,12108,5994,6114,13398440.0,6542242.0,6856198.0,109.55,111.37,109.15,112.14
2023-09-08 11:10,817,624,193,56431,33946,22485,62998407.0,37604078.0,25394329.0,733,568,165,53178,32058,21120,59140613.0,35298770.0,23841843.0,110.78,112.94,110.11,112.89
2023-09-08 11:15,394,182,212,26737,12129,14608,29775527.0,13346293.0,16429234.0,343,143,200,24940,10860,14080,27764852.0,11924043.0,15840809.0,110.04,112.47,109.8,112.51
2023-09-08 11:20,378,146,232,28765,13287,15478,31947712.0,14576889.0,17370823.0,302,102,200,25953,11525,14428,28842631.0,12617973.0,16224657.0,109.71,112.23,109.48,112.45
2023-09-08 11:25,673,422,251,31732,19609,12123,35659116.0,22005669.0,13653446.0,595,372,223,29380,17860,11520,32736248.0,19730402.0,13005845.0,112.22,112.62,110.47,112.9
2023-09-08 11:30,252,139,113,21022,11125,9897,23472173.0,12286050.0,11186122.0,189,92,97,19331,10159,9172,21564272.0,11189835.0,10374437.0,110.44,113.03,110.15,113.11
2023-09-08 11:35,365,139,226,28278,12803,15475,31648802.0,14172132.0,17476669.0,317,112,205,27673,12489,15184,30980407.0,13785258.0,17195149.0,110.69,112.93,110.38,113.25
2023-09-08 11:40,596,516,80,27650,22158,5492,31029274.0,24783004.0,6246269.0,544,486,58,27332,21941,5391,30638256.0,24481596.0,6156660.0,111.85,113.73,111.58,114.2
2023-09-08 11:45,427,386,41,22114,19328,2786,24764178.0,21612332.0,3151846.0,393,370,23,21442,19346,2096,23995806.0,21608976.0,2386830.0,111.82,113.13,111.7,113.88
2023-09-08 11:50,162,98,64,11222,6558,4664,12716525.0,7416222.0,5300303.0,128,78,50,10094,5621,4473,11335562.0,6238345.0,5097216.0,113.09,113.64,110.98,113.96
2023-09-08 11:55,381,230,151,22933,14961,7972,25684722.0,16665268.0,9019454.0,331,205,126,22554,15060,7494,25288458.0,16772432.0,8516025.0,111.39,113.14,111.37,113.64
2023-09-08 12:00,188,92,96,16275,8477,7798,18224386.0,9386495.0,8837890.0,139,63,76,15167,7856,7311,16987564.0,8687149.0,8300414.0,110.73,113.34,110.58,113.53
2023-09-08 12:05,69,46,23,3855,1942,1913,4307989.0,2156747.0,2151241.0,45,29,16,3080,1695,1385,3455028.0,1874912.0,1580116.0,111.06,112.45,110.61,114.09
2023-09-08 12:10,48,26,22,1584,652,932,1764325.0,735148.0,1029177.0,17,8,9,655,313,342,738934.0,346892.0,392042.0,112.75,110.43,110.83,114.63
2023-09-08 12:15,89,58,31,6033,3248,2785,6772612.0,3613709.0,3158903.0,55,33,22,5865,3105,2760,6580359.0,3432982.0,3147376.0,111.26,113.43,110.56,114.04
2023-09-08 12:20,103,69,34,8203,5226,2977,9217833.0,5820931.0,3396902.0,66,39,27,6057,3178,2879,6795599.0,3518323.0,3277276.0,111.38,114.1,110.71,113.83
2023-09-08 12:25,62,40,22,3555,1880,1675,3980455.0,2090768.0,1889687.0,42,26,16,3150,1695,1455,3535802.0,1877161.0,1658641.0,111.21,112.82,110.75,114.0
2023-09-08 12:30,79,44,35,4216,2082,2134,4758166.0,2327891.0,2430275.0,45,22,23,3929,2043,1886,4411013.0,2263258.0,2147754.0,111.81,113.88,110.78,113.88
2023-09-08 12:35,106,48,58,7839,3921,3918,8806558.0,4350497.0,4456061.0,72,30,42,7574,3751,3823,8509671.0,4153191.0,4356479.0,110.95,113.73,110.72,113.95
2023-09-08 12:40,72,29,43,6760,2573,4187,7679272.0,2868456.0,4810815.0,47,20,27,4200,2239,1961,4720000.0,2484441.0,2235558.0,111.48,114.9,110.96,114.0
2023-09-08 12:45,55,32,23,2737,1541,1196,3114060.0,1757375.0,1356685.0,20,11,9,2134,1124,1010,2397375.0,1245572.0,1151803.0,114.04,113.44,110.82,114.04
2023-09-08 12:50,88,41,47,7647,3665,3982,8538333.0,4068862.0,4469471.0,61,29,32,8726,3524,5202,9825393.0,3901228.0,5924164.0,111.02,112.24,110.7,113.88
2023-09-08 12:55,77,40,37,7191,3632,3559,8072352.0,4026887.0,4045465.0,54,24,30,7046,3548,3498,7913910.0,3927549.0,3986361.0,110.87,113.67,110.7,113.96
2023-09-08 13:00,128,67,61,12129,6107,6022,13656218.0,6796753.0,6859464.0,98,43,55,12332,5793,6539,13944996.0,6417262.0,7527734.0,111.29,113.91,110.78,115.12
2023-09-08 13:05,196,109,87,16934,8746,8188,19063331.0,9737711.0,9325620.0,159,88,71,16752,8671,8081,18861896.0,9633543.0,9228353.0,111.34,113.89,111.1,114.2
2023-09-08 13:10,90,49,41,10606,4275,6331,11926840.0,4744594.0,7182246.0,71,38,33,10080,4244,5836,11363194.0,4706360.0,6656834.0,110.98,113.45,110.89,114.07
2023-09-08 13:15,59,42,17,2661,1560,1101,3004947.0,1748482.0,1256465.0,45,31,14,2575,1501,1074,2883162.0,1658104.0,1225058.0,112.08,114.12,110.47,114.06
2023-09-08 13:20,77,44,33,5914,3079,2835,6639789.0,3413328.0,3226461.0,61,32,29,5780,3077,2703,6495335.0,3411457.0,3083878.0,110.86,113.81,110.87,114.09
2023-09-08 13:25,56,30,26,5411,1759,3652,6132968.0,1952765.0,4180202.0,37,20,17,3383,1722,1661,3806373.0,1910023.0,1896349.0,111.02,114.46,110.92,114.17
2023-09-08 13:30,122,72,50,11823,5310,6513,13250357.0,5889047.0,7361310.0,97,56,41,12507,4967,7540,14078790.0,5508132.0,8570658.0,110.9,113.02,110.89,113.67
2023-09-08 13:35,68,36,32,9326,3351,5975,10486250.0,3715708.0,6770542.0,59,33,26,8828,3018,5810,9929204.0,3344570.0,6584634.0,110.88,113.31,110.82,113.33
2023-09-08 13:40,35,17,18,1521,729,792,1719346.0,810850.0,908496.0,22,8,14,1503,623,880,1689616.0,689575.0,1000041.0,111.23,114.71,110.69,113.64
2023-09-08 13:45,63,42,21,7107,3286,3821,8102236.0,3659113.0,4443123.0,42,24,18,3624,1861,1763,4090928.0,2063672.0,2027256.0,111.35,116.28,110.89,114.99
2023-09-08 13:50,268,140,128,21829,10256,11573,24677838.0,11435416.0,13242422.0,220,108,112,21165,9714,11451,23918186.0,10810666.0,13107520.0,111.5,114.43,111.29,114.47
2023-09-08 13:55,284,94,190,19076,7965,11111,21603251.0,8887484.0,12715766.0,237,70,167,18515,7844,10671,20949778.0,8743408.0,12206370.0,111.58,114.44,111.47,114.39
2023-09-08 14:00,383,223,160,25281,13447,11834,28695080.0,15124769.0,13570311.0,358,210,148,24477,12936,11541,27744630.0,14494254.0,13250375.0,112.48,114.67,112.05,114.81
2023-09-08 14:05,170,138,32,9192,5838,3354,10416324.0,6562803.0,3853521.0,157,129,28,9526,6018,3508,10783755.0,6749740.0,4034014.0,112.42,114.89,112.16,114.99
2023-09-08 14:10,115,65,50,8981,4614,4367,10209754.0,5171659.0,5038094.0,94,56,38,8497,4391,4106,9657136.0,4912963.0,4744173.0,112.09,115.37,111.89,115.54
2023-09-08 14:15,131,70,61,10615,5141,5474,12073055.0,5753847.0,6319208.0,103,58,45,9848,5118,4730,11154931.0,5720304.0,5434627.0,111.92,115.44,111.77,114.9
2023-09-08 14:20,73,41,32,5314,2767,2547,6026238.0,3100540.0,2925697.0,56,30,26,4800,2386,2414,5440589.0,2666005.0,2774584.0,112.05,114.87,111.74,114.94
2023-09-08 14:25,65,36,29,4484,2309,2175,5152698.0,2600890.0,2551807.0,49,26,23,4403,2111,2292,5019618.0,2365994.0,2653624.0,112.64,117.32,112.08,115.78
2023-09-08 14:30,104,36,68,6864,3094,3770,7782475.0,3468606.0,4313868.0,89,31,58,6717,3194,3523,7622300.0,3571667.0,4050632.0,112.11,114.43,111.82,114.98
2023-09-08 14:35,129,52,77,9527,4456,5071,10819202.0,4990571.0,5828631.0,111,39,72,9403,4351,5052,10678539.0,4870451.0,5808087.0,112.0,114.94,111.94,114.97
2023-09-08 14:40,154,83,71,14485,6977,7508,16602780.0,7851463.0,8751317.0,114,58,56,12802,6517,6285,14595410.0,7309926.0,7285484.0,112.53,116.56,112.17,115.92
2023-09-08 14:45,197,86,111,22648,10808,11840,25740563.0,12119913.0,13620650.0,177,75,102,21738,10662,11076,24733094.0,11954482.0,12778611.0,112.14,115.04,112.12,115.37
2023-09-08 14:50,91,48,43,7008,3528,3480,7975334.0,3960324.0,4015010.0,74,38,36,6858,3422,3436,7802438.0,3839573.0,3962864.0,112.25,115.37,112.2,115.33
2023-09-08 14:55,115,78,37,7670,4114,3556,8732049.0,4630785.0,4101263.0,99,66,33,7564,4032,3532,8604189.0,4530690.0,4073498.0,112.56,115.33,112.37,115.33
2023-09-08 15:00,177,125,52,10257,6087,4170,11696844.0,6878361.0,4818482.0,154,117,37,10003,6078,3925,11389032.0,6856327.0,4532704.0,113.0,115.55,112.81,115.48
2023-09-08 15:05,126,94,32,7878,4659,3219,8955969.0,5241873.0,3714096.0,109,81,28,7857,4556,3301,8944895.0,5124407.0,3820488.0,112.51,115.38,112.48,115.74
2023-09-08 15:10,73,35,38,7485,3556,3929,8511525.0,3986238.0,4525287.0,61,28,33,7531,3604,3927,8561877.0,4036103.0,4525774.0,112.1,115.18,111.99,115.25
2023-09-08 15:15,125,84,41,10393,5502,4891,11824622.0,6193912.0,5630710.0,105,75,30,9433,5357,4076,10723619.0,6020625.0,4702993.0,112.58,115.12,112.39,115.38
2023-09-08 15:20,141,89,52,12046,6176,5870,13701133.0,6940449.0,6760684.0,118,77,41,11674,6326,5348,13265185.0,7097945.0,6167239.0,112.38,115.17,112.2,115.32
2023-09-08 15:25,114,77,37,8809,4804,4005,10005764.0,5395984.0,4609779.0,100,73,27,7895,4623,3272,8964053.0,5191335.0,3772717.0,112.32,115.1,112.29,115.3
2023-09-08 15:30,176,147,29,10983,5534,5449,12563836.0,6246588.0,6317248.0,162,141,21,9255,5543,3712,10530777.0,6255510.0,4275266.0,112.88,115.93,112.85,115.17
2023-09-08 15:35,62,49,13,4195,3603,592,6218219.0,3903591.0,2314628.0,55,46,9,3055,2473,582,5040321.0,2704068.0,2336252.0,108.34,390.98,109.34,401.42
2023-09-08 15:40,139,101,38,8667,5038,3629,9825011.0,5666964.0,4158046.0,117,86,31,8835,5344,3491,10021667.0,5992894.0,4028773.0,112.48,114.58,112.14,115.4
2023-09-08 15:45,78,59,19,6096,2881,3215,6950401.0,3239181.0,3711220.0,75,56,19,6034,2925,3109,6884330.0,3287791.0,3596539.0,112.43,115.43,112.4,115.68
2023-09-08 15:50,40,28,12,1901,1154,747,2152015.0,1297857.0,854158.0,40,29,11,3082,2355,727,3486691.0,2645728.0,840963.0,112.47,114.35,112.35,115.68
2023-09-08 15:55,68,42,26,4362,1981,2381,4975783.0,2222335.0,2753448.0,52,33,19,2956,1816,1140,3343737.0,2033746.0,1309991.0,112.18,115.64,111.99,114.91
2023-09-08 16:00,41,24,17,2326,1046,1280,2670679.0,1169669.0,1501010.0,39,23,16,2926,1033,1893,3362199.0,1152183.0,2210016.0,111.82,117.27,111.54,116.75
2023-09-08 16:05,44,28,16,3947,1029,2918,4488825.0,1146436.0,3342389.0,27,19,8,4306,1908,2398,4836363.0,2063687.0,2772675.0,111.41,114.54,108.16,115.62
2023-09-08 16:10,194,100,94,19001,8508,10493,21468555.0,9537656.0,11930899.0,152,77,75,18791,7958,10833,21195567.0,8854498.0,12341068.0,112.1,113.7,111.27,113.92
2023-09-08 16:15,571,143,428,37853,11032,26821,42717506.0,12259014.0,30458492.0,540,118,422,37578,10778,26800,42403524.0,11967353.0,30436171.0,111.12,113.56,111.04,113.57
2023-09-08 16:20,1186,151,1035,62231,11988,50243,70253149.0,13331334.0,56921815.0,1164,132,1032,61783,11586,50197,69760852.0,12878031.0,56882821.0,111.21,113.29,111.15,113.32
2023-09-08 16:25,1373,137,1236,77593,15140,62453,87583129.0,16813277.0,70769852.0,1364,130,1234,77420,15099,62321,87388466.0,16768403.0,70620062.0,111.05,113.32,111.06,113.32
2023-09-08 16:30,1110,163,947,79016,21950,57066,89157519.0,24364955.0,64792563.0,1097,158,939,78870,21910,56960,88992702.0,24319773.0,64672929.0,111.0,113.54,111.0,113.54
2023-09-08 16:35,844,776,68,51459,44062,7397,57937864.0,49468457.0,8469406.0,826,767,59,51195,43953,7242,57640255.0,49343622.0,8296633.0,112.27,114.5,112.26,114.56
2023-09-08 16:40,2032,1195,837,117857,76820,41037,132802750.0,86068922.0,46733827.0,2019,1189,830,117748,76824,40924,132700748.0,86073346.0,46627401.0,112.04,113.88,112.04,113.94
2023-09-08 16:45,1898,1277,621,101355,63406,37949,114166409.0,70940281.0,43226128.0,1879,1263,616,101033,63123,37910,113814593.0,70612075.0,43202518.0,111.88,113.91,111.86,113.96
2023-09-08 16:50,1008,875,133,61995,46606,15389,69895915.0,52225989.0,17669926.0,989,864,125,63458,46535,16923,71509823.0,52146192.0,19363631.0,112.06,114.82,112.06,114.42
2023-09-08 16:55,738,717,21,39230,35965,3265,44215164.0,40441355.0,3773808.0,723,707,16,37579,35828,1751,42349521.0,40285288.0,2064233.0,112.45,115.58,112.44,117.89
2023-09-08 17:00,218,207,11,10346,10003,343,11629922.0,11238738.0,391183.0,212,204,8,10373,10066,307,11670672.0,11309102.0,361570.0,112.35,114.05,112.35,117.78
2023-09-08 17:05,601,513,88,39163,30639,8524,44122858.0,34370424.0,9752433.0,578,503,75,38680,30533,8147,43584014.0,34250894.0,9333120.0,112.18,114.41,112.18,114.56
2023-09-08 17:10,488,447,41,24778,22509,2269,27880318.0,25290048.0,2590270.0,484,448,36,24595,22466,2129,27669773.0,25241552.0,2428221.0,112.36,114.16,112.35,114.05
2023-09-08 17:15,771,743,28,40253,37318,2935,45255242.0,41909860.0,3345382.0,757,735,22,39426,37119,2307,44322796.0,41685226.0,2637569.0,112.3,113.98,112.3,114.33
2023-09-08 17:20,1030,1016,14,49541,48821,720,55683055.0,54860473.0,822582.0,1023,1010,13,50002,48732,1270,56201298.0,54756666.0,1444631.0,112.37,114.25,112.36,113.75
2023-09-08 17:25,904,878,26,38877,37660,1217,43750426.0,42366536.0,1383890.0,891,867,24,38776,37586,1190,43631599.0,42270798.0,1360801.0,112.5,113.71,112.46,114.35
2023-09-08 17:30,692,671,21,24198,22861,1337,27232548.0,25703987.0,1528561.0,685,664,21,23983,22609,1374,26997985.0,25427585.0,1570400.0,112.44,114.33,112.47,114.29
2023-09-08 17:35,75,46,29,6016,3298,2718,6797989.0,3687056.0,3110933.0,71,42,29,6090,3315,2775,6869589.0,3692814.0,3176775.0,111.8,114.46,111.4,114.48
2023-09-08 17:40,267,225,42,16272,13410,2862,18308364.0,15044115.0,3264248.0,247,216,31,15378,12921,2457,17330447.0,14504886.0,2825561.0,112.19,114.05,112.26,115.0
2023-09-08 17:45,232,206,26,13724,11855,1869,15441296.0,13318013.0,2123283.0,219,200,19,13124,11826,1298,14760734.0,13277834.0,1482899.0,112.34,113.61,112.28,114.24
2023-09-08 17:50,221,191,30,14418,11492,2926,16226691.0,12888339.0,3338351.0,208,183,25,14289,11204,3085,16096098.0,12556447.0,3539651.0,112.15,114.09,112.07,114.74
2023-09-08 17:55,184,96,88,13814,6989,6825,15526856.0,7775820.0,7751035.0,148,69,79,12643,6094,6549,14220547.0,6773398.0,7447149.0,111.26,113.57,111.15,113.71
2023-09-08 18:00,175,102,73,14034,7244,6790,15775633.0,8048034.0,7727599.0,134,72,62,13452,6904,6548,15120952.0,7660209.0,7460742.0,111.1,113.81,110.95,113.94
2023-09-08 18:05,113,59,54,9209,4656,4553,10353848.0,5171272.0,5182576.0,102,54,48,9137,4627,4510,10276008.0,5137266.0,5138742.0,111.07,113.83,111.03,113.94
2023-09-08 18:10,94,57,37,7456,3849,3607,8385567.0,4287951.0,4097615.0,85,52,33,7336,3662,3674,8267734.0,4070885.0,4196849.0,111.4,113.6,111.17,114.23
2023-09-08 18:15,110,88,22,5622,2486,3136,6358342.0,2788715.0,3569627.0,88,72,16,6233,2008,4225,7074094.0,2242602.0,4831492.0,112.18,113.83,111.68,114.35
2023-09-08 18:20,159,77,82,13645,6769,6876,15336466.0,7513114.0,7823351.0,148,69,79,13947,6843,7104,15677230.0,7593064.0,8084166.0,110.99,113.78,110.96,113.8
2023-09-08 18:25,123,45,78,10858,4402,6456,12191728.0,4877022.0,7314705.0,100,30,70,9357,4297,5060,10508261.0,4752929.0,5755332.0,110.79,113.3,110.61,113.74
2023-09-08 18:30,124,44,80,9704,3670,6034,10787555.0,4071849.0,6715705.0,102,25,77,10843,3720,7123,12187506.0,4108561.0,8078945.0,110.95,111.3,110.45,113.42
2023-09-08 18:35,162,81,81,4875,2527,2348,5384359.0,2816198.0,2568161.0,99,44,55,2302,1068,1234,2591470.0,1184592.0,1406877.0,111.44,109.38,110.92,114.01
2023-09-11 10:00,1055,359,696,29581,14064,15517,35015056.0,15414066.0,19600990.0,231,216,15,10138,9635,503,11248786.0,10676828.0,571958.0,109.6,126.32,110.81,113.71
2023-09-11 10:05,469,298,171,15557,9041,6516,16637012.0,9927153.0,6709859.0,207,148,59,7860,5702,2158,8706910.0,6289695.0,2417214.0,109.8,102.98,110.31,112.01
2023-09-11 10:10,687,211,476,21250,4699,16551,23745196.0,5258184.0,18487011.0,482,92,390,17844,2490,15354,19848812.0,2722326.0,17126486.0,111.9,111.7,109.33,111.54
2023-09-11 10:15,881,178,703,35340,1498,33842,39265695.0,1666712.0,37598983.0,723,42,681,33362,604,32758,37096875.0,652217.0,36444658.0,111.26,111.1,107.98,111.25
2023-09-11 10:20,377,120,257,8387,1860,6527,9310159.0,2076701.0,7233458.0,154,37,117,7099,838,6261,7930233.0,920450.0,7009782.0,111.65,110.82,109.84,111.96
2023-09-11 10:25,361,251,110,12424,8464,3960,14360900.0,9809808.0,4551091.0,224,152,72,7662,4712,2950,8530068.0,5223838.0,3306229.0,115.9,114.93,110.86,112.08
2023-09-11 10:30,261,169,92,16403,9226,7177,18461202.0,10328309.0,8132893.0,188,121,67,14206,7675,6531,15892852.0,8467673.0,7425179.0,111.95,113.32,110.33,113.69
2023-09-11 10:35,337,156,181,25980,12880,13100,29257580.0,14350255.0,14907324.0,255,124,131,24542,12744,11798,27529691.0,14112164.0,13417527.0,111.42,113.8,110.74,113.73
2023-09-11 10:40,5249,175,5074,145793,13106,132687,164649704.0,14866019.0,149783684.0,5161,132,5029,142644,11816,130828,160709098.0,13126608.0,147582490.0,113.43,112.88,111.09,112.81
2023-09-11 10:45,610,378,232,48564,26019,22545,55211119.0,29297411.0,25913707.0,469,326,143,43888,25522,18366,49788943.0,28584402.0,21204541.0,112.6,114.94,112.0,115.46
2023-09-11 10:50,369,182,187,28894,13777,15117,32708974.0,15359427.0,17349547.0,295,147,148,24895,12514,12381,28080649.0,13934535.0,14146113.0,111.49,114.77,111.35,114.26
2023-09-11 10:55,202,124,78,13481,7821,5660,15249109.0,8752669.0,6496439.0,153,95,58,12366,7367,4999,13958608.0,8235177.0,5723431.0,111.91,114.78,111.78,114.49
2023-09-11 11:00,112,55,57,7541,3258,4283,8503460.0,3638001.0,4865459.0,79,34,45,6906,3096,3810,7815698.0,3449868.0,4365830.0,111.66,113.6,111.43,114.59
2023-09-11 11:05,617,294,323,43273,22094,21179,49628389.0,25013823.0,24614565.0,539,253,286,39971,20849,19122,45306627.0,23365036.0,21941591.0,113.22,116.22,112.07,114.75
2023-09-11 11:10,256,150,106,15800,9442,6358,17929940.0,10598153.0,7331787.0,202,129,73,15127,9390,5737,17176877.0,10538014.0,6638863.0,112.24,115.32,112.23,115.72
2023-09-11 11:15,406,175,231,34214,17354,16860,38704326.0,19412143.0,19292183.0,353,154,199,32139,16416,15723,36366832.0,18342571.0,18024261.0,111.86,114.43,111.74,114.64
2023-09-11 11:20,311,178,133,28191,15897,12294,32150004.0,17941905.0,14208098.0,267,165,102,25568,15169,10399,29051697.0,17062201.0,11989495.0,112.86,115.57,112.48,115.29
2023-09-11 11:25,204,126,78,11619,6781,4838,13099925.0,7605152.0,5494773.0,159,112,47,10655,6869,3786,12067437.0,7709947.0,4357490.0,112.15,113.58,112.24,115.09
2023-09-11 11:30,232,145,87,15222,8608,6614,17229663.0,9639488.0,7590175.0,201,131,70,16587,8739,7848,18789613.0,9780389.0,9009224.0,111.98,114.76,111.92,114.8
2023-09-11 11:35,180,81,99,13485,6706,6779,16813300.0,7475134.0,9338166.0,134,69,65,12981,6520,6461,14662011.0,7265130.0,7396881.0,111.47,137.75,111.43,114.49
2023-09-11 11:40,211,139,72,16692,10042,6650,18782160.0,11201994.0,7580166.0,178,121,57,15979,9653,6326,17988591.0,10757355.0,7231236.0,111.55,113.99,111.44,114.31
2023-09-11 11:45,216,130,86,17295,9513,7782,19464681.0,10603859.0,8860822.0,180,105,75,15770,9222,6548,17763497.0,10280141.0,7483356.0,111.47,113.86,111.47,114.28
2023-09-11 11:50,1378,928,450,134120,80492,53628,152755220.0,91136263.0,61618957.0,1002,677,325,120597,73209,47388,136888634.0,82417975.0,54470659.0,113.22,114.9,112.58,114.95
2023-09-11 11:55,1032,579,453,70364,38932,31432,79707983.0,43832161.0,35875821.0,912,512,400,66453,36592,29861,75307864.0,41120771.0,34187093.0,112.59,114.14,112.38,114.49
2023-09-11 12:00,691,445,246,52120,29546,22574,59721002.0,33592693.0,26128309.0,552,371,181,46774,26415,20359,53382882.0,29796860.0,23586022.0,113.7,115.75,112.8,115.85
2023-09-11 12:05,580,388,192,48693,27069,21624,56022372.0,30964272.0,25058099.0,497,359,138,40157,23083,17074,45856436.0,26060954.0,19795482.0,114.39,115.88,112.9,115.94
2023-09-11 12:10,324,192,132,24047,11495,12552,27302360.0,12994959.0,14307401.0,243,144,99,22891,10989,11902,26141537.0,12375215.0,13766322.0,113.05,113.99,112.61,115.66
2023-09-11 12:15,345,150,195,28296,13720,14576,32386549.0,15549214.0,16837334.0,259,113,146,26561,12984,13577,30335839.0,14618927.0,15716912.0,113.33,115.51,112.59,115.76
2023-09-11 12:20,376,169,207,24865,12130,12735,28431772.0,13689880.0,14741891.0,294,128,166,23981,11666,12315,27394301.0,13122333.0,14271967.0,112.86,115.76,112.48,115.89
2023-09-11 12:25,333,212,121,18661,9673,8988,21428281.0,10993271.0,10435009.0,258,169,89,17675,9199,8476,20198614.0,10375210.0,9823404.0,113.65,116.1,112.79,115.9
2023-09-11 12:30,453,254,199,29483,15137,14346,33396452.0,17004617.0,16391834.0,369,219,150,30225,17056,13169,34386564.0,19188714.0,15197849.0,112.34,114.26,112.5,115.41
2023-09-11 12:35,463,179,284,35387,17136,18251,40123530.0,19190187.0,20933342.0,397,139,258,33380,15990,17390,37829065.0,17873486.0,19955578.0,111.99,114.7,111.78,114.75
2023-09-11 12:40,257,155,102,17994,10509,7485,20350024.0,11760231.0,8589793.0,205,124,81,16548,9369,7179,18739680.0,10486135.0,8253544.0,111.91,114.76,111.92,114.97
2023-09-11 12:45,70,38,32,3678,1734,1944,4188044.0,1952206.0,2235838.0,53,25,28,3758,1929,1829,4267614.0,2163655.0,2103959.0,112.58,115.01,112.16,115.03
2023-09-11 12:50,118,44,74,8428,3938,4490,9586541.0,4436811.0,5149730.0,81,30,51,7802,3703,4099,8852625.0,4139634.0,4712991.0,112.67,114.69,111.79,114.98
2023-09-11 12:55,128,57,71,11352,5467,5885,12866829.0,6118676.0,6748153.0,103,44,59,10384,5163,5221,11776893.0,5775010.0,6001883.0,111.92,114.67,111.85,114.96
2023-09-11 13:00,143,88,55,12322,6228,6094,13982844.0,6980172.0,7002672.0,131,81,50,12155,6318,5837,13788334.0,7074397.0,6713936.0,112.08,114.91,111.97,115.02
2023-09-11 13:05,145,63,82,13744,6752,6992,15597092.0,7569146.0,8027946.0,119,51,68,12911,6509,6402,14646374.0,7281004.0,7365369.0,112.1,114.82,111.86,115.05
2023-09-11 13:10,176,68,108,16798,7213,9585,18976410.0,8031776.0,10944633.0,146,52,94,15394,7068,8326,17446278.0,7889859.0,9556419.0,111.35,114.19,111.63,114.78
2023-09-11 13:15,780,579,201,68787,44841,23946,79318847.0,51821754.0,27497092.0,546,419,127,53553,33992,19561,60880263.0,38326114.0,22554149.0,115.57,114.83,112.75,115.3
2023-09-11 13:20,2285,1274,1011,168257,91397,76860,200582865.0,106016976.0,94565888.0,1562,899,663,143167,78628,64539,165939999.0,90161366.0,75778633.0,116.0,123.04,114.67,117.42
2023-09-11 13:25,1153,472,681,82826,37897,44929,96136959.0,43582735.0,52554223.0,967,391,576,73949,33529,40420,85738419.0,38423957.0,47314462.0,115.0,116.97,114.6,117.06
2023-09-11 13:30,1191,838,353,85056,55233,29823,99215047.0,64119268.0,35095779.0,991,752,239,75223,48177,27046,87511277.0,55616285.0,31894991.0,116.09,117.68,115.44,117.93
2023-09-11 13:35,883,564,319,69005,37074,31931,80450545.0,42889999.0,37560546.0,730,503,227,62362,35533,26829,72568966.0,40922788.0,31646178.0,115.69,117.63,115.17,117.96
2023-09-11 13:40,442,240,202,37149,16126,21023,43373758.0,18625517.0,24748240.0,303,171,132,33608,15301,18307,39068788.0,17537562.0,21531225.0,115.5,117.72,114.62,117.61
2023-09-11 13:45,679,452,227,62205,37260,24945,72876390.0,43469388.0,29407001.0,536,371,165,56781,32508,24273,66173767.0,37455069.0,28718697.0,116.67,117.89,115.22,118.32
2023-09-11 13:50,510,255,255,35804,15627,20177,41947422.0,18101763.0,23845658.0,345,181,164,30329,14159,16170,35446694.0,16294037.0,19152656.0,115.84,118.18,115.08,118.45
2023-09-11 13:55,385,190,195,29520,13753,15767,34357784.0,15829715.0,18528069.0,282,137,145,27351,13153,14198,31828542.0,15101297.0,16727244.0,115.1,117.51,114.81,117.81
2023-09-11 14:00,325,153,172,25148,10534,14614,28952077.0,12057647.0,16894430.0,243,109,134,21470,9920,11550,24891457.0,11320697.0,13570759.0,114.46,115.6,114.12,117.5
2023-09-11 14:05,221,117,104,18907,9153,9754,21819361.0,10437208.0,11382152.0,161,83,78,18654,9383,9271,21554907.0,10692295.0,10862611.0,114.03,116.69,113.95,117.17
2023-09-11 14:10,533,401,132,35277,21253,14024,41065814.0,24514870.0,16550943.0,461,364,97,32413,19436,12977,37678417.0,22363109.0,15315308.0,115.35,118.02,115.06,118.02
2023-09-11 14:15,518,375,143,34992,19576,15416,40740765.0,22543026.0,18197738.0,424,328,96,33090,18450,14640,38540102.0,21231173.0,17308929.0,115.16,118.04,115.07,118.23
2023-09-11 14:20,435,329,106,31035,18574,12461,36109457.0,21427786.0,14681670.0,397,314,83,30756,18411,12345,35802975.0,21207135.0,14595840.0,115.36,117.82,115.19,118.23
2023-09-11 14:25,581,428,153,33768,19286,14482,39372866.0,22277498.0,17095368.0,476,361,115,32440,18642,13798,37783117.0,21477522.0,16305594.0,115.51,118.05,115.21,118.17
2023-09-11 14:30,348,189,159,27416,14186,13230,31940960.0,16336225.0,15604735.0,290,162,128,26179,13770,12409,30491326.0,15829527.0,14661799.0,115.16,117.95,114.96,118.15
2023-09-11 14:35,288,187,101,20515,10685,9830,23865084.0,12275009.0,11590075.0,240,169,71,19537,10605,8932,22695162.0,12180059.0,10515103.0,114.88,117.91,114.85,117.72
2023-09-11 14:40,380,198,182,22217,11442,10775,25720454.0,13086617.0,12633837.0,324,162,162,22238,11279,10959,25754317.0,12890522.0,12863794.0,114.37,117.25,114.29,117.38
2023-09-11 14:45,499,250,249,41322,20973,20349,47947831.0,24034457.0,23913373.0,450,216,234,40071,20228,19843,46470164.0,23147070.0,23323094.0,114.6,117.52,114.43,117.54
2023-09-11 14:50,89,59,30,3694,2211,1483,4271995.0,2535941.0,1736053.0,72,54,18,3538,2130,1408,4104921.0,2448182.0,1656739.0,114.7,117.06,114.94,117.67
2023-09-11 14:55,149,61,88,11768,5234,6534,13524186.0,6011367.0,7512819.0,109,43,66,10276,4867,5409,11920964.0,5565255.0,6355709.0,114.85,114.98,114.35,117.5
2023-09-11 15:00,120,61,59,8668,4300,4368,16108200.0,10969046.0,5139154.0,91,39,52,8150,3978,4172,9455831.0,4548966.0,4906864.0,255.09,117.65,114.35,117.61
2023-09-11 15:05,91,49,42,5292,2706,2586,6142647.0,3095866.0,3046780.0,73,41,32,4982,2552,2430,5779829.0,2920132.0,2859696.0,114.41,117.82,114.43,117.68
2023-09-11 15:10,100,51,49,5835,2586,3249,6796772.0,2977793.0,3818978.0,70,33,37,5161,2392,2769,5997100.0,2738105.0,3258995.0,115.15,117.54,114.47,117.7
2023-09-11 15:15,208,106,102,13197,7528,5669,15556060.0,8899740.0,6656320.0,162,80,82,11969,6321,5648,13896863.0,7264676.0,6632186.0,118.22,117.42,114.93,117.43
2023-09-11 15:20,910,742,168,66343,45769,20574,77387946.0,53023947.0,24363999.0,846,716,130,65074,45392,19682,75899530.0,52582547.0,23316983.0,115.85,118.42,115.84,118.47
2023-09-11 15:25,406,287,119,22652,15537,7115,26343216.0,17972463.0,8370753.0,367,273,94,22511,15692,6819,26197685.0,18151081.0,8046604.0,115.68,117.65,115.67,118.0
2023-09-11 15:30,167,92,75,12573,6533,6040,14619256.0,7509921.0,7109334.0,134,76,58,11974,6282,5692,13918112.0,7209633.0,6708479.0,114.95,117.7,114.77,117.86
2023-09-11 15:35,158,81,77,10415,5259,5156,12112922.0,6051008.0,6061913.0,133,67,66,10280,5193,5087,11963931.0,5968249.0,5995681.0,115.06,117.57,114.93,117.86
2023-09-11 15:40,908,752,156,68105,45450,22655,79365571.0,52587135.0,26778436.0,877,735,142,66311,44062,22249,77288551.0,50971173.0,26317378.0,115.7,118.2,115.68,118.29
2023-09-11 15:45,394,332,62,18693,13961,4732,21790143.0,16188861.0,5601281.0,367,317,50,17911,13685,4226,20864459.0,15869831.0,4994627.0,115.96,118.37,115.97,118.19
2023-09-11 15:50,524,431,93,35531,25721,9810,41342111.0,29819381.0,11522729.0,470,399,71,33605,24166,9439,39164934.0,27987699.0,11177234.0,115.93,117.46,115.81,118.42
2023-09-11 15:55,1043,748,295,79269,49062,30207,92910739.0,57159494.0,35751245.0,794,611,183,72010,45049,26961,84274889.0,52247021.0,32027868.0,116.5,118.35,115.98,118.79
2023-09-11 16:00,1372,1302,70,67260,63761,3499,78618167.0,74473901.0,4144266.0,1287,1256,31,65746,62866,2880,76801843.0,73323490.0,3478353.0,116.8,118.44,116.63,120.78
2023-09-11 16:05,559,403,156,41463,24313,17150,48629262.0,28621552.0,20007710.0,420,316,104,34437,20879,13558,40344446.0,24232808.0,16111637.0,117.72,116.66,116.06,118.83
2023-09-11 16:10,912,726,186,65376,42852,22524,76784248.0,50004538.0,26779709.0,810,676,134,63328,42105,21223,74213254.0,48935006.0,25278247.0,116.69,118.89,116.22,119.11
2023-09-11 16:15,715,561,154,43267,27969,15298,51898073.0,32608062.0,19290011.0,622,522,100,38936,25958,12978,45685135.0,30226465.0,15458669.0,116.59,126.09,116.44,119.11
2023-09-11 16:20,579,394,185,39472,23110,16362,46149332.0,26785757.0,19363574.0,537,369,168,39238,23548,15690,46944134.0,27278967.0,19665167.0,115.91,118.34,115.84,125.34
2023-09-11 16:25,307,154,153,23506,12219,11287,27402259.0,14097594.0,13304664.0,260,130,130,24302,11578,12724,28458459.0,13334545.0,15123914.0,115.37,117.88,115.17,118.86
2023-09-11 16:30,216,118,98,19556,10261,9295,22801594.0,11862250.0,10939344.0,170,91,79,18330,9392,8938,21408362.0,10828127.0,10580235.0,115.61,117.69,115.29,118.37
2023-09-11 16:35,419,193,226,37687,18329,19358,43840552.0,21027934.0,22812617.0,370,171,199,35623,17256,18367,41582494.0,19868055.0,21714439.0,114.72,117.85,115.14,118.23
2023-09-11 16:40,921,347,574,70718,31216,39502,81551019.0,35700991.0,45850027.0,759,262,497,66063,29582,36481,76570407.0,33794929.0,42775478.0,114.37,116.07,114.24,117.25
2023-09-11 16:45,913,434,479,63245,31769,31476,73147528.0,36291607.0,36855921.0,751,348,403,61181,30275,30906,70719384.0,34527167.0,36192217.0,114.24,117.09,114.05,117.1
2023-09-11 16:50,380,140,240,29818,12884,16934,34448403.0,14662727.0,19785676.0,320,107,213,29552,12973,16579,34163816.0,14756313.0,19407503.0,113.81,116.84,113.75,117.06
2023-09-11 16:55,528,300,228,35233,18479,16754,40893740.0,21253360.0,19640379.0,478,268,210,34478,17781,16697,39906420.0,20332598.0,19573822.0,115.01,117.23,114.35,117.23
2023-09-11 17:00,559,296,263,38125,18297,19828,44359490.0,21048173.0,23311317.0,517,276,241,37650,17971,19679,43819621.0,20657742.0,23161878.0,115.04,117.57,114.95,117.7
2023-09-11 17:05,268,147,121,19264,9756,9508,22394533.0,11204509.0,11190024.0,242,137,105,17900,9760,8140,20816554.0,11209188.0,9607365.0,114.85,117.69,114.85,118.03
2023-09-11 17:10,251,86,165,16274,7833,8441,18892300.0,8984309.0,9907990.0,246,86,160,16501,8052,8449,19153680.0,9234471.0,9919208.0,114.7,117.38,114.69,117.4
2023-09-11 17:15,193,115,78,10703,6376,4327,12397783.0,7327554.0,5070229.0,161,101,60,10339,6204,4135,11978283.0,7116367.0,4861916.0,114.92,117.18,114.71,117.58
2023-09-11 17:20,221,111,110,17996,8962,9034,20844988.0,10258731.0,10586257.0,181,88,93,17300,8536,8764,20037553.0,9750704.0,10286849.0,114.47,117.18,114.23,117.38
2023-09-11 17:25,100,63,37,6722,3718,3004,7802552.0,4267188.0,3535364.0,70,48,22,6144,3502,2642,7123148.0,4015949.0,3107198.0,114.77,117.69,114.68,117.61
2023-09-11 17:30,68,39,29,3847,2145,1702,4456673.0,2467102.0,1989571.0,54,32,22,3702,2079,1623,4294127.0,2383249.0,1910878.0,115.02,116.9,114.63,117.74
2023-09-11 17:35,146,70,76,9865,5050,4815,11400587.0,5775625.0,5624961.0,138,67,71,9631,4936,4695,11161703.0,5653584.0,5508118.0,114.37,116.82,114.54,117.32
2023-09-11 17:40,42505,42248,257,420232,389747,30485,485048788.0,449363359.0,35685429.0,42476,42231,245,419335,389399,29936,484047699.0,448964192.0,35083507.0,115.3,117.06,115.3,117.2
2023-09-11 17:45,6295,5960,335,117559,97450,20109,135563416.0,112128253.0,23435162.0,6267,5947,320,117011,97141,19870,134968189.0,111773035.0,23195154.0,115.06,116.54,115.06,116.73
2023-09-11 17:50,125,42,83,9121,4314,4807,10459293.0,4906008.0,5553284.0,104,32,72,9078,4226,4852,10468486.0,4802211.0,5666275.0,113.72,115.52,113.63,116.78
2023-09-11 17:55,138,86,52,10578,5702,4876,12245631.0,6523070.0,5722560.0,125,79,46,10260,5598,4662,11870208.0,6396947.0,5473260.0,114.4,117.36,114.27,117.4
2023-09-11 18:00,310,118,192,24717,10935,13782,28488280.0,12462005.0,16026275.0,256,95,161,22008,10608,11400,25409726.0,12077143.0,13332583.0,113.96,116.28,113.85,116.95
2023-09-11 18:05,391,197,194,32201,15064,17137,36974642.0,17106063.0,19868579.0,306,144,162,29556,14139,15417,33958663.0,16027873.0,17930789.0,113.56,115.94,113.36,116.31
2023-09-11 18:10,933,610,323,54734,28076,26658,61557606.0,31512099.0,30045507.0,705,447,258,48628,25575,23053,55142434.0,28641064.0,26501370.0,112.24,112.71,111.99,114.96
2023-09-11 18:15,311,175,136,26792,14188,12604,30423682.0,15917279.0,14506403.0,235,139,96,25873,13641,12232,29368994.0,15286878.0,14082116.0,112.19,115.09,112.07,115.13
2023-09-11 18:20,167,106,61,14871,8092,6779,16936332.0,9125819.0,7810512.0,147,89,58,14559,7669,6890,16582025.0,8622397.0,7959628.0,112.78,115.22,112.43,115.52
2023-09-11 18:25,168,96,72,14703,6876,7827,16795055.0,7780308.0,9014746.0,130,79,51,12202,6363,5839,13902209.0,7145661.0,6756548.0,113.15,115.17,112.3,115.71
2023-09-11 18:30,144,76,68,3754,2165,1589,4276045.0,2481980.0,1794065.0,106,50,56,4273,2110,2163,4867558.0,2385482.0,2482076.0,114.64,112.91,113.06,114.75
2023-09-11 18:35,129,61,68,4748,1359,3389,5416514.0,1560690.0,3855824.0,107,51,56,5801,1628,4173,6639940.0,1827560.0,4812379.0,114.84,113.77,112.26,115.32
2023-09-12 10:00,904,232,672,21943,9056,12887,26209020.0,9796751.0,16412269.0,124,80,44,3976,2946,1030,4531050.0,3337295.0,1193754.0,108.18,127.36,113.28,115.9
2023-09-12 10:05,623,255,368,19384,5292,14092,27505231.0,9470581.0,18034650.0,366,150,216,14839,7659,7180,16943392.0,8616103.0,8327289.0,178.96,127.98,112.5,115.98
2023-09-12 10:10,910,515,395,27117,14051,13066,32604167.0,17312997.0,15291170.0,706,441,265,22523,12848,9675,26134080.0,14821262.0,11312818.0,123.22,117.03,115.36,116.93
2023-09-12 10:15,439,198,241,30175,12988,17187,35032782.0,14798550.0,20234232.0,285,133,152,24371,11613,12758,28162793.0,13226222.0,14936570.0,113.94,117.73,113.89,117.08
2023-09-12 10:20,521,273,248,24064,11872,12192,27909273.0,13577498.0,14331775.0,237,120,117,21979,10732,11247,25416376.0,12241133.0,13175243.0,114.37,117.55,114.06,117.14
2023-09-12 10:25,473,281,192,31580,16938,14642,36491408.0,19380291.0,17111117.0,397,247,150,30432,16734,13698,35177972.0,19121095.0,16056877.0,114.42,116.86,114.26,117.22
2023-09-12 10:30,208,112,96,17062,9338,7724,19608538.0,10563462.0,9045075.0,154,78,76,13952,6955,6997,16107201.0,7918738.0,8188463.0,113.12,117.1,113.86,117.03
2023-09-12 10:35,219,156,63,15171,8687,6484,17632151.0,9969836.0,7662315.0,178,134,44,14059,8327,5732,16255824.0,9529772.0,6726051.0,114.77,118.17,114.44,117.34
2023-09-12 10:40,275,181,94,20763,10898,9865,24089449.0,12466736.0,11622713.0,235,165,70,20349,11218,9131,23551837.0,12831194.0,10720643.0,114.39,117.82,114.38,117.41
2023-09-12 10:45,232,166,66,16695,9279,7416,19351023.0,10629490.0,8721533.0,195,147,48,16271,9037,7234,18849295.0,10347978.0,8501317.0,114.55,117.6,114.51,117.52
2023-09-12 10:50,195,108,87,18915,9389,9526,21893034.0,10731085.0,11161948.0,157,93,64,18226,9102,9124,21095893.0,10395017.0,10700876.0,114.29,117.17,114.21,117.28
2023-09-12 10:55,330,222,108,22120,11973,10147,25620342.0,13706922.0,11913420.0,274,193,81,21415,11470,9945,24792103.0,13112752.0,11679351.0,114.48,117.41,114.32,117.44
2023-09-12 11:00,356,237,119,28229,16687,11542,32853798.0,19255747.0,13598050.0,292,207,85,27213,15961,11252,31655586.0,18362207.0,13293378.0,115.39,117.81,115.04,118.14
2023-09-12 11:05,239,100,139,18583,8380,10203,21612480.0,9626548.0,11985932.0,173,75,98,16732,7971,8761,19443334.0,9132298.0,10311035.0,114.88,117.47,114.57,117.69
2023-09-12 11:10,303,197,106,24601,13215,11386,28628179.0,15198003.0,13430175.0,255,178,77,24020,12880,11140,27924783.0,14782897.0,13141886.0,115.01,117.95,114.77,117.97
2023-09-12 11:15,184,75,109,13391,5177,8214,15510681.0,5925338.0,9585343.0,127,49,78,10211,4869,5342,11858064.0,5574101.0,6283962.0,114.46,116.7,114.48,117.63
2023-09-12 11:20,364,133,231,27758,11900,15858,32032556.0,13598134.0,18434421.0,307,103,204,26213,11492,14721,30372310.0,13119197.0,17253112.0,114.27,116.25,114.16,117.2
2023-09-12 11:25,237,97,140,18635,8521,10114,21529411.0,9707298.0,11822112.0,219,84,135,18718,8614,10104,21632855.0,9808614.0,11824240.0,113.92,116.89,113.87,117.03
2023-09-12 11:30,270,139,131,23317,11443,11874,27120486.0,13180502.0,13939983.0,214,102,112,20986,10316,10670,24303400.0,11783789.0,12519611.0,115.18,117.4,114.23,117.33
2023-09-12 11:35,231,163,68,17100,9122,7978,19931862.0,10530880.0,9400981.0,197,141,56,16451,8554,7897,19154843.0,9820764.0,9334079.0,115.44,117.84,114.81,118.2
2023-09-12 11:40,89,59,30,5464,2789,2675,6367054.0,3210106.0,3156947.0,72,52,20,4991,2755,2236,5803873.0,3163664.0,2640208.0,115.1,118.02,114.83,118.08
2023-09-12 11:45,62,41,21,3309,1659,1650,3863438.0,1923667.0,1939771.0,52,41,11,3162,1708,1454,3672371.0,1961289.0,1711082.0,115.95,117.56,114.83,117.68
2023-09-12 11:50,192,136,56,16094,8750,7344,18810530.0,10141028.0,8669502.0,160,120,40,15546,8205,7341,18082024.0,9425072.0,8656952.0,115.9,118.05,114.87,117.93
2023-09-12 11:55,175,99,76,15165,6957,8208,17617882.0,7997651.0,9620230.0,148,95,53,15046,6943,8103,17519924.0,7980581.0,9539343.0,114.96,117.21,114.94,117.73
2023-09-12 12:00,104,52,52,6827,3429,3398,7916966.0,3934146.0,3982820.0,80,38,42,6323,3093,3230,7347447.0,3546286.0,3801160.0,114.73,117.21,114.66,117.68
2023-09-12 12:05,85,35,50,5111,1160,3951,5932478.0,1322688.0,4609789.0,61,26,35,3940,991,2949,4583001.0,1137199.0,3445802.0,114.02,116.67,114.75,116.85
2023-09-12 12:10,106,52,54,9621,4753,4868,11164972.0,5432110.0,5732861.0,86,45,41,10178,4716,5462,11819745.0,5390299.0,6429445.0,114.29,117.77,114.3,117.71
2023-09-12 12:15,101,47,54,7377,3516,3861,8526260.0,4007072.0,4519188.0,73,28,45,6488,3046,3442,7513724.0,3478317.0,4035407.0,113.97,117.05,114.19,117.24
2023-09-12 12:20,79,43,36,5211,2845,2366,6047041.0,3260710.0,2786331.0,56,30,26,4723,2459,2264,5473804.0,2811361.0,2662443.0,114.61,117.77,114.33,117.6
2023-09-12 12:25,234,132,102,19934,9313,10621,23024025.0,10647665.0,12376359.0,175,93,82,18874,9068,9806,21838564.0,10350241.0,11488322.0,114.33,116.53,114.14,117.16
2023-09-12 12:30,1223,104,1119,71842,9095,62747,83173537.0,10362470.0,72811067.0,1190,81,1109,71275,8572,62703,82520101.0,9759350.0,72760750.0,113.94,116.04,113.85,116.04
2023-09-12 12:35,952,58,894,51516,5300,46216,59844655.0,6206777.0,53637878.0,927,47,880,51164,5617,45547,59266952.0,6407309.0,52859642.0,117.11,116.06,114.07,116.06
2023-09-12 12:40,725,73,652,49173,9674,39499,56958716.0,11030624.0,45928091.0,727,79,648,49119,9694,39425,56904477.0,11053503.0,45850974.0,114.02,116.28,114.02,116.3
2023-09-12 12:45,516,50,466,32935,6545,26390,38164455.0,7466077.0,30698378.0,508,47,461,32696,6545,26151,37884770.0,7465611.0,30419159.0,114.07,116.33,114.07,116.32
2023-09-12 12:50,1021,74,947,55736,6934,48802,64643997.0,7927277.0,56716720.0,1004,65,939,55547,6792,48755,64577131.0,7915138.0,56661993.0,114.32,116.22,116.54,116.22
2023-09-12 12:55,919,36,883,40997,3051,37946,47571586.0,3499110.0,44072476.0,905,28,877,40758,2963,37795,47276745.0,3382590.0,43894155.0,114.69,116.15,114.16,116.14
2023-09-12 13:00,945,54,891,41537,4569,36968,48181032.0,5224126.0,42956906.0,934,48,886,41466,4531,36935,48091475.0,5172470.0,42919005.0,114.34,116.2,114.16,116.2
2023-09-12 13:05,915,45,870,37150,3353,33797,43085123.0,3830762.0,39254361.0,908,44,864,37111,3348,33763,43040272.0,3825374.0,39214898.0,114.25,116.15,114.26,116.15
2023-09-12 13:10,272,168,104,10445,3421,7024,12155426.0,3931805.0,8223621.0,261,162,99,8475,3384,5091,9823296.0,3886424.0,5936872.0,114.93,117.08,114.85,116.62
2023-09-12 13:15,252,114,138,17539,6736,10803,20371537.0,7710400.0,12661137.0,235,108,127,18843,6718,12125,21905678.0,7689152.0,14216525.0,114.47,117.2,114.46,117.25
2023-09-12 13:20,140,56,84,16474,5348,11126,19185719.0,6115205.0,13070513.0,122,51,71,12837,5251,7586,14910692.0,6001935.0,8908756.0,114.35,117.48,114.3,117.44
2023-09-12 13:25,37,25,12,1771,1044,727,2052208.0,1198853.0,853355.0,28,21,7,1487,863,624,1721580.0,987679.0,733901.0,114.83,117.38,114.45,117.61
2023-09-12 13:30,280,123,157,24419,11077,13342,28282425.0,12660557.0,15621868.0,254,107,147,24769,10900,13869,28763663.0,12454029.0,16309634.0,114.3,117.09,114.26,117.6
2023-09-12 13:35,84,50,34,8674,3893,4781,10072314.0,4447172.0,5625141.0,73,46,27,8378,3863,4515,9720304.0,4413721.0,5306582.0,114.24,117.66,114.26,117.53
2023-09-12 13:40,57,30,27,4210,2260,1950,4856319.0,2581604.0,2274714.0,40,24,16,4102,2238,1864,4746504.0,2555899.0,2190604.0,114.23,116.65,114.2,117.52
2023-09-12 13:45,45,27,18,3917,2030,1887,4529153.0,2320453.0,2208700.0,32,20,12,3871,2020,1851,4479885.0,2305140.0,2174745.0,114.31,117.05,114.12,117.49
2023-09-12 13:50,60,37,23,4502,2298,2204,5215852.0,2637035.0,2578816.0,43,26,17,5062,1758,3304,5866963.0,2009349.0,3857613.0,114.75,117.01,114.3,116.76
2023-09-12 13:55,68,40,28,5954,3116,2838,6886707.0,3564747.0,3321959.0,62,36,26,5649,2968,2681,6521786.0,3380496.0,3141290.0,114.4,117.05,113.9,117.17
2023-09-12 14:00,88,49,39,6631,3082,3549,7666624.0,3521800.0,4144824.0,72,41,31,6891,3322,3569,7966037.0,3793733.0,4172304.0,114.27,116.79,114.2,116.9
2023-09-12 14:05,853,65,788,50380,6907,43473,58282920.0,7864888.0,50418031.0,826,52,774,49983,6658,43325,57834557.0,7581952.0,50252605.0,113.87,115.98,113.88,115.99
2023-09-12 14:10,672,51,621,35696,4065,31631,41320034.0,4637760.0,36682274.0,655,41,614,35405,3855,31550,40975519.0,4387724.0,36587795.0,114.09,115.97,113.82,115.97
2023-09-12 14:15,795,21,774,34696,1014,33682,40189927.0,1156743.0,39033184.0,789,18,771,34965,1032,33933,40528422.0,1177842.0,39350579.0,114.08,115.89,114.13,115.97
2023-09-12 14:20,1027,33,994,46190,2564,43626,53492093.0,2920728.0,50571365.0,1021,29,992,46201,2583,43618,53499768.0,2942407.0,50557361.0,113.91,115.92,113.91,115.91
2023-09-12 14:25,534,75,459,29445,6380,23065,34085621.0,7287995.0,26797625.0,513,62,451,28669,6049,22620,33168610.0,6895338.0,26273271.0,114.23,116.18,113.99,116.15
2023-09-12 14:30,69,53,16,3211,2158,1053,3720488.0,2484328.0,1236160.0,54,46,8,2940,1922,1018,3404859.0,2208266.0,1196593.0,115.12,117.39,114.89,117.54
2023-09-12 14:35,113,85,28,9180,5478,3702,10637406.0,6282309.0,4355097.0,99,78,21,8807,5376,3431,10192425.0,6159536.0,4032889.0,114.68,117.64,114.57,117.54
2023-09-12 14:40,100,75,25,9085,4872,4213,10511483.0,5564456.0,4947027.0,99,74,25,9070,4857,4213,10493497.0,5546789.0,4946707.0,114.21,117.42,114.2,117.42
2023-09-12 14:45,47,39,8,2544,1547,997,2956180.0,1774888.0,1181291.0,47,40,7,4051,1651,2400,4721354.0,1894254.0,2827100.0,114.73,118.48,114.73,117.8
2023-09-12 14:50,77,66,11,3791,2573,1218,4382083.0,2950303.0,1431780.0,66,56,10,3713,2497,1216,4289674.0,2860305.0,1429369.0,114.66,117.55,114.55,117.55
2023-09-12 14:55,1536,305,1231,109838,31402,78436,127045373.0,35778897.0,91266476.0,1516,294,1222,109564,31298,78266,127737534.0,36665732.0,91071801.0,113.94,116.36,117.15,116.36
2023-09-12 15:00,736,20,716,28468,1327,27141,32977370.0,1512807.0,31464562.0,731,16,715,28530,1290,27240,33051552.0,1470076.0,31581476.0,114.0,115.93,113.96,115.94
2023-09-12 15:05,1119,189,930,78889,25211,53678,91228334.0,28715283.0,62513051.0,1112,185,927,78941,25261,53680,91287352.0,28771136.0,62516215.0,113.9,116.46,113.9,116.46
2023-09-12 15:10,816,111,705,38629,8450,30179,44694441.0,9640981.0,35053459.0,815,114,701,38311,8456,29855,44325663.0,9647845.0,34677817.0,114.09,116.15,114.09,116.15
2023-09-12 15:15,860,179,681,50425,15137,35288,58138946.0,17239210.0,40899736.0,832,169,663,49591,15123,34468,57331588.0,17222363.0,40109225.0,113.89,115.9,113.88,116.37
2023-09-12 15:20,490,69,421,28930,5520,23410,33391546.0,6276087.0,27115459.0,470,63,407,28269,5342,22927,32638185.0,6071184.0,26567000.0,113.7,115.83,113.65,115.88
2023-09-12 15:25,182,116,66,12038,6364,5674,13765742.0,7226664.0,6539078.0,129,81,48,11182,5711,5471,12846110.0,6475274.0,6370836.0,113.56,115.25,113.38,116.45
2023-09-12 15:30,95,69,26,5637,3597,2040,6479526.0,4099205.0,2380321.0,83,65,18,5505,3555,1950,6325964.0,4049955.0,2276009.0,113.96,116.68,113.92,116.72
2023-09-12 15:35,59,53,6,3189,2578,611,3656609.0,2941803.0,714805.0,60,55,5,3245,2635,610,3717943.0,3003338.0,714605.0,114.11,116.99,113.98,117.15
2023-09-12 15:40,35,28,7,1113,901,212,1276509.0,1030015.0,246494.0,31,27,4,1257,929,328,1444435.0,1061845.0,382590.0,114.32,116.27,114.3,116.64
2023-09-12 15:45,113,61,52,10115,4993,5122,11553793.0,5657727.0,5896066.0,100,56,44,10235,5260,4975,11754303.0,5959105.0,5795198.0,113.31,115.11,113.29,116.49
2023-09-12 15:50,117,55,62,10531,5145,5386,12082280.0,5821492.0,6260787.0,98,43,55,10332,4972,5360,11858376.0,5623036.0,6235340.0,113.15,116.24,113.09,116.33
2023-09-12 15:55,140,70,70,11165,4786,6379,12840009.0,5441343.0,7398666.0,119,56,63,11080,4703,6377,12729061.0,5326613.0,7402448.0,113.69,115.98,113.26,116.08
2023-09-12 16:00,27,12,15,2061,456,1605,2371784.0,515828.0,1855955.0,15,6,9,972,446,526,1119060.0,505071.0,613989.0,113.12,115.64,113.24,116.73
2023-09-12 16:05,87,54,33,7423,3699,3724,8510591.0,4178921.0,4331669.0,73,42,31,8675,3776,4899,9966501.0,4273867.0,5692634.0,112.97,116.32,113.19,116.2
2023-09-12 16:10,42,26,16,2956,1543,1413,3393724.0,1750729.0,1642995.0,35,23,12,2684,1308,1376,3084420.0,1482352.0,1602068.0,113.46,116.28,113.33,116.43
2023-09-12 16:15,76,46,30,5325,2580,2745,6114626.0,2921536.0,3193089.0,57,31,26,5563,2713,2850,6388306.0,3070672.0,3317634.0,113.24,116.32,113.18,116.41
2023-09-12 16:20,53,28,25,3911,1975,1936,4484505.0,2235997.0,2248507.0,41,21,20,3218,1524,1694,3691170.0,1723070.0,1968100.0,113.22,116.14,113.06,116.18
2023-09-12 16:25,93,54,39,7744,3539,4205,8930785.0,4012147.0,4918638.0,69,37,32,7459,3372,4087,8584249.0,3812854.0,4771394.0,113.37,116.97,113.07,116.75
2023-09-12 16:30,70,38,32,5857,2931,2926,6717630.0,3314353.0,3403276.0,57,30,27,5833,2918,2915,6690206.0,3298349.0,3391857.0,113.08,116.31,113.03,116.36
2023-09-12 16:35,63,36,27,6522,3126,3396,7484894.0,3535919.0,3948974.0,56,32,24,6645,3332,3313,7621058.0,3767073.0,3853984.0,113.11,116.28,113.06,116.33
2023-09-12 16:40,84,44,40,7388,3892,3496,8483941.0,4413713.0,4070228.0,71,33,38,7018,3506,3512,8054067.0,3965073.0,4088993.0,113.4,116.43,113.09,116.43
2023-09-12 16:45,446,80,366,28214,7447,20767,32457114.0,8408590.0,24048524.0,439,74,365,27337,6550,20787,31486657.0,7415644.0,24071013.0,112.91,115.8,113.22,115.8
2023-09-12 16:50,217,17,200,10445,1273,9172,12051740.0,1444823.0,10606916.0,209,13,196,10269,1176,9093,11844981.0,1329613.0,10515368.0,113.5,115.64,113.06,115.64
2023-09-12 16:55,192,26,166,10966,2187,8779,12681973.0,2527128.0,10154845.0,174,13,161,10206,1463,8743,11771378.0,1657488.0,10113890.0,115.55,115.67,113.29,115.68
2023-09-12 17:00,575,146,429,45860,16257,29603,52883307.0,18482812.0,34400495.0,570,142,428,45610,16012,29598,52585853.0,18191891.0,34393962.0,113.69,116.21,113.61,116.2
2023-09-12 17:05,599,300,299,45792,23459,22333,52932785.0,26938632.0,25994153.0,577,286,291,44598,22637,21961,51426859.0,25863686.0,25563173.0,114.83,116.39,114.25,116.4
2023-09-12 17:10,61,48,13,5321,2576,2745,6186575.0,2958103.0,3228472.0,46,40,6,3587,2586,1001,4139612.0,2965555.0,1174057.0,114.83,117.61,114.68,117.29
2023-09-12 17:15,379,352,27,21670,19249,2421,24970239.0,22138074.0,2832165.0,370,347,23,21727,19253,2474,25040660.0,22142606.0,2898053.0,115.01,116.98,115.01,117.14
2023-09-12 17:20,307,264,43,18918,15673,3245,21809325.0,18008012.0,3801313.0,299,261,38,18672,15535,3137,21523440.0,17847454.0,3675986.0,114.9,117.14,114.89,117.18
2023-09-12 17:25,704,676,28,40149,37655,2494,46249715.0,43342895.0,2906819.0,694,676,18,40069,38000,2069,46153639.0,43734937.0,2418701.0,115.11,116.55,115.09,116.9
2023-09-12 17:30,850,832,18,46667,45931,736,53739280.0,52879252.0,860028.0,843,830,13,46645,45837,808,53715075.0,52771423.0,943652.0,115.13,116.85,115.13,116.79
2023-09-12 17:35,738,716,22,41622,39445,2177,47936224.0,45399514.0,2536709.0,729,714,15,41353,39452,1901,47629047.0,45403532.0,2225515.0,115.1,116.52,115.09,117.07
2023-09-12 17:40,38,32,6,879,858,21,1094918.0,1071694.0,23223.0,24,21,3,537,526,11,618377.0,605381.0,12996.0,124.91,110.59,115.09,118.15
2023-09-12 17:45,952,890,62,65793,55687,10106,75833430.0,64011436.0,11821993.0,942,882,60,65681,55531,10150,75699446.0,63814906.0,11884539.0,114.95,116.98,114.92,117.09
2023-09-12 17:50,1018,996,22,57880,55360,2520,66700518.0,63726126.0,2974391.0,1012,993,19,57583,55353,2230,66327290.0,63716346.0,2610944.0,115.11,118.03,115.11,117.08
2023-09-12 17:55,420,409,11,23900,22881,1019,27530987.0,26338116.0,1192871.0,415,408,7,23916,22902,1014,27549575.0,26361550.0,1188025.0,115.11,117.06,115.11,117.16
2023-09-12 18:00,607,588,19,34510,32476,2034,39756161.0,37375930.0,2380231.0,599,583,16,34501,32454,2047,39747422.0,37350345.0,2397076.0,115.09,117.02,115.09,117.1
2023-09-12 18:05,1067,1036,31,65725,57844,7881,75739692.0,66579224.0,9160468.0,1061,1032,29,67241,57841,9400,77532724.0,66574251.0,10958473.0,115.1,116.23,115.1,116.58
2023-09-12 18:10,787,766,21,42925,41050,1875,49466503.0,47268773.0,2197730.0,777,762,15,42911,40978,1933,49441606.0,47176735.0,2264870.0,115.15,117.21,115.13,117.17
2023-09-12 18:15,115,82,33,10646,6129,4517,12281056.0,6999903.0,5281153.0,107,82,25,10596,6192,4404,12228549.0,7063099.0,5165450.0,114.21,116.92,114.07,117.29
2023-09-12 18:20,101,69,32,7827,4464,3363,9056345.0,5117763.0,3938582.0,95,65,30,7770,4436,3334,8980098.0,5068539.0,3911558.0,114.65,117.12,114.26,117.32
2023-09-12 18:25,77,56,21,2775,1289,1486,3170436.0,1480466.0,1689970.0,60,44,16,2072,1196,876,2394188.0,1371735.0,1022453.0,114.85,113.73,114.69,116.72
2023-09-12 18:30,81,46,35,1560,632,928,1808748.0,733373.0,1075375.0,61,34,27,1233,452,781,1425523.0,520077.0,905445.0,116.04,115.88,115.06,115.93
2023-09-12 18:35,34,27,7,652,555,97,821583.0,711148.0,110435.0,24,20,4,208,163,45,239426.0,187180.0,52245.0,128.13,113.85,114.83,116.1
2023-09-13 10:00,1729,800,929,54673,27061,27612,66520563.0,32377091.0,34143471.0,584,505,79,21213,16524,4689,24953971.0,19365185.0,5588786.0,119.64,123.65,117.19,119.19
2023-09-13 10:05,567,276,291,17324,6311,11013,22030760.0,7756213.0,14274546.0,154,112,42,4690,2821,1869,5547782.0,3309921.0,2237861.0,122.9,129.62,117.33,119.74
2023-09-13 10:10,425,232,193,17037,6647,10390,19836263.0,7745484.0,12090779.0,220,118,102,9589,2928,6661,11269238.0,3414281.0,7854956.0,116.53,116.37,116.61,117.92
2023-09-13 10:15,393,245,148,27799,12819,14980,32648580.0,14886935.0,17761645.0,196,113,83,19245,9545,9700,22589927.0,11034508.0,11555419.0,116.13,118.57,115.61,119.13
2023-09-13 10:20,472,218,254,24857,11571,13286,28948713.0,13391620.0,15557093.0,198,103,95,20851,10164,10687,24450950.0,11750291.0,12700658.0,115.73,117.09,115.61,118.84
2023-09-13 10:25,284,172,112,19892,10210,9682,23357429.0,11858979.0,11498449.0,181,100,81,17603,8744,8859,20622324.0,10104254.0,10518069.0,116.15,118.76,115.56,118.73
2023-09-13 10:30,271,153,118,21810,10420,11390,25641541.0,12098081.0,13543459.0,197,112,85,19275,9752,9523,22599925.0,11281682.0,11318242.0,116.1,118.91,115.69,118.85
2023-09-13 10:35,252,126,126,19397,8583,10814,22720710.0,9954832.0,12765877.0,175,83,92,17490,7692,9798,20517309.0,8883389.0,11633920.0,115.98,118.05,115.49,118.74
2023-09-13 10:40,1101,704,397,78280,42561,35719,91227407.0,49258641.0,41968766.0,888,583,305,68155,39993,28162,79493929.0,46192409.0,33301519.0,115.74,117.5,115.5,118.25
2023-09-13 10:45,1410,1309,101,82592,70610,11982,96183789.0,81984345.0,14199443.0,1379,1286,93,82203,69961,12242,95724780.0,81227020.0,14497759.0,116.11,118.51,116.1,118.43
2023-09-13 10:50,401,285,116,29029,16070,12959,33943304.0,18576463.0,15366840.0,325,242,83,25026,15098,9928,29159513.0,17420517.0,11738996.0,115.6,118.58,115.38,118.24
2023-09-13 10:55,154,102,52,8287,4071,4216,9822150.0,4765528.0,5056622.0,103,72,31,7794,3999,3795,9141691.0,4616734.0,4524957.0,117.06,119.94,115.45,119.23
2023-09-13 11:00,156,101,55,10089,5287,4802,11832640.0,6123513.0,5709126.0,93,64,29,9423,4686,4737,11078175.0,5417112.0,5661063.0,115.82,118.89,115.6,119.51
2023-09-13 11:05,92,55,37,5249,2548,2701,6185150.0,2991431.0,3193719.0,52,32,20,4763,2365,2398,5579428.0,2734351.0,2845076.0,117.4,118.24,115.62,118.64
2023-09-13 11:10,153,75,78,12751,5950,6801,14750369.0,6886104.0,7864265.0,107,56,51,11060,5367,5693,12949712.0,6195201.0,6754511.0,115.73,115.63,115.43,118.65
2023-09-13 11:15,164,102,62,11786,6291,5495,13825407.0,7306760.0,6518647.0,116,70,46,10034,5047,4987,11738895.0,5816558.0,5922337.0,116.15,118.63,115.25,118.76
2023-09-13 11:20,109,75,34,6471,3636,2835,7635447.0,4279053.0,3356394.0,64,47,17,4806,2851,1955,5624631.0,3302521.0,2322109.0,117.69,118.39,115.84,118.78
2023-09-13 11:25,122,69,53,7893,4261,3632,9353884.0,5062294.0,4291590.0,82,52,30,6417,3235,3182,7523361.0,3743029.0,3780332.0,118.81,118.16,115.7,118.8
2023-09-13 11:30,232,153,79,19129,10398,8731,22368433.0,12053054.0,10315378.0,167,118,49,18037,9836,8201,21137518.0,11384422.0,9753096.0,115.92,118.15,115.74,118.93
2023-09-13 11:35,120,65,55,10045,4656,5389,11679396.0,5388720.0,6290676.0,84,47,37,9324,4565,4759,10912137.0,5269898.0,5642238.0,115.74,116.73,115.44,118.56
2023-09-13 11:40,59,33,26,6357,2533,3824,7685244.0,2952508.0,4732736.0,45,24,21,3197,1521,1676,3742358.0,1757374.0,1984984.0,116.56,123.76,115.54,118.44
2023-09-13 11:45,108,56,52,9901,4412,5489,11638009.0,5150555.0,6487453.0,80,42,38,9273,4061,5212,10874333.0,4690003.0,6184329.0,116.74,118.19,115.49,118.66
2023-09-13 11:50,99,53,46,10852,3951,6901,12758847.0,4592988.0,8165858.0,70,37,33,10684,3793,6891,12531581.0,4382150.0,8149430.0,116.25,118.33,115.53,118.26
2023-09-13 11:55,86,48,38,6682,3065,3617,7836285.0,3545921.0,4290364.0,62,40,22,5526,2877,2649,6473260.0,3326433.0,3146826.0,115.69,118.62,115.62,118.79
2023-09-13 12:00,67,31,36,3714,1867,1847,4360061.0,2201798.0,2158262.0,36,19,17,3221,1591,1630,3780415.0,1837112.0,1943303.0,117.93,116.85,115.47,119.22
2023-09-13 12:05,89,54,35,6888,3590,3298,8055722.0,4158906.0,3896815.0,68,42,26,6716,3553,3163,7866609.0,4107523.0,3759086.0,115.85,118.16,115.61,118.85
2023-09-13 12:10,153,93,60,14290,7708,6582,16673250.0,8937646.0,7735604.0,115,78,37,12405,6648,5757,14528102.0,7686386.0,6841715.0,115.95,117.53,115.62,118.84
2023-09-13 12:15,225,127,98,24569,10950,13619,28728060.0,12648011.0,16080049.0,170,93,77,23746,10695,13051,27783775.0,12341307.0,15442467.0,115.51,118.07,115.39,118.32
2023-09-13 12:20,309,148,161,26482,11863,14619,30774024.0,13685941.0,17088083.0,234,115,119,24866,11717,13149,29083377.0,13511679.0,15571698.0,115.37,116.89,115.32,118.42
2023-09-13 12:25,292,139,153,21818,9371,12447,25390976.0,10789299.0,14601677.0,195,87,108,18250,8305,9945,21258770.0,9535751.0,11723019.0,115.13,117.31,114.82,117.88
2023-09-13 12:30,248,174,74,18872,10418,8454,22042288.0,12072945.0,9969343.0,175,114,61,17703,9400,8303,20607162.0,10802585.0,9804577.0,115.89,117.92,114.92,118.08
2023-09-13 12:35,144,102,42,10188,5489,4699,11931657.0,6413713.0,5517944.0,92,64,28,8924,4863,4061,10416224.0,5599220.0,4817004.0,116.85,117.43,115.14,118.62
2023-09-13 12:40,109,72,37,8619,4607,4012,10038403.0,5327563.0,4710840.0,74,45,29,9849,4238,5611,11527933.0,4871775.0,6656157.0,115.64,117.42,114.95,118.63
2023-09-13 12:45,66,47,19,2611,1776,835,3051134.0,2081097.0,970037.0,47,30,17,1862,1113,749,2161549.0,1275316.0,886233.0,117.18,116.17,114.58,118.32
2023-09-13 12:50,68,50,18,1233,776,457,1451242.0,921378.0,529864.0,43,36,7,1177,972,205,1350513.0,1106076.0,244437.0,118.73,115.94,113.79,119.24
2023-09-13 12:55,121,66,55,4473,1511,2962,4876779.0,1743563.0,3133216.0,72,25,47,2361,972,1389,2744689.0,1121467.0,1623222.0,115.39,105.78,115.38,116.86
2023-09-13 13:00,582,74,508,25243,1109,24134,29377492.0,1276948.0,28100544.0,531,42,489,23020,888,22132,26797716.0,1019713.0,25778002.0,115.14,116.44,114.83,116.47
2023-09-13 13:05,902,98,804,36087,1252,34835,42004836.0,1470557.0,40534279.0,862,75,787,36190,828,35362,42135527.0,954793.0,41180733.0,117.46,116.36,115.31,116.45
2023-09-13 13:10,8941,37,8904,301028,1345,299683,349094475.0,1543165.0,347551310.0,8907,15,8892,299486,567,298919,347464586.0,652779.0,346811807.0,114.73,115.97,115.13,116.02
2023-09-13 13:15,155,79,76,3655,1184,2471,4137155.0,1364937.0,2772217.0,92,35,57,2370,543,1827,2746064.0,622253.0,2123811.0,115.28,112.19,114.6,116.25
2023-09-13 13:20,76,48,28,2091,873,1218,2394879.0,999203.0,1395676.0,41,17,24,1490,489,1001,1727566.0,561053.0,1166512.0,114.46,114.59,114.73,116.53
2023-09-13 13:25,103,60,43,3798,1364,2434,4341101.0,1579013.0,2762088.0,32,12,20,1756,347,1409,2062827.0,395887.0,1666939.0,115.76,113.48,114.09,118.31
2023-09-13 13:30,117,68,49,2863,1091,1772,3324380.0,1269279.0,2055100.0,74,33,41,2230,622,1608,2583752.0,707855.0,1875896.0,116.34,115.98,113.8,116.66
2023-09-13 13:35,142,65,77,5149,3451,1698,5909442.0,3972617.0,1936824.0,94,32,62,3590,1381,2209,4158997.0,1584975.0,2574021.0,115.11,114.07,114.77,116.52
2023-09-13 13:40,85,32,53,2443,652,1791,2808293.0,745028.0,2063264.0,60,21,39,2135,549,1586,2472446.0,626788.0,1845658.0,114.27,115.2,114.17,116.37
2023-09-13 13:45,72,38,34,1823,357,1466,2106044.0,437335.0,1668709.0,31,14,17,790,152,638,912447.0,174137.0,738310.0,122.5,113.83,114.56,115.72
2023-09-13 13:50,156,74,82,5401,1461,3940,6218745.0,1668029.0,4550716.0,123,54,69,3513,1215,2298,4046641.0,1384240.0,2662401.0,114.17,115.5,113.93,115.86
2023-09-13 13:55,157,75,82,3505,1564,1941,4091333.0,1835130.0,2256202.0,111,53,58,3373,1255,2118,3909753.0,1435813.0,2473940.0,117.34,116.24,114.41,116.81
2023-09-13 14:00,106,50,56,2581,973,1608,2971780.0,1134490.0,1837290.0,70,34,36,3824,2429,1395,4405081.0,2788534.0,1616546.0,116.6,114.26,114.8,115.88
2023-09-13 14:05,81,37,44,2489,1032,1457,2820897.0,1176728.0,1644169.0,54,24,30,1852,636,1216,2134524.0,725182.0,1409342.0,114.02,112.85,114.02,115.9
2023-09-13 14:10,439,97,342,16572,1480,15092,19197699.0,1720598.0,17477101.0,368,49,319,16414,941,15473,18992064.0,1071983.0,17920080.0,116.26,115.8,113.92,115.82
2023-09-13 14:15,906,99,807,39680,1880,37800,45970832.0,2185175.0,43785657.0,862,76,786,38519,1374,37145,44599272.0,1575937.0,43023335.0,116.23,115.84,114.7,115.83
2023-09-13 14:20,279,102,177,10314,1698,8616,11935762.0,2039956.0,9895805.0,218,58,160,8739,1029,7710,10120475.0,1181785.0,8938690.0,120.14,114.85,114.85,115.94
2023-09-13 14:25,450,68,382,19737,1339,18398,22840757.0,1535238.0,21305518.0,416,49,367,19075,1343,17732,22088143.0,1539182.0,20548960.0,114.66,115.8,114.61,115.89
2023-09-13 14:30,45,34,11,667,474,193,802309.0,577870.0,224439.0,27,18,9,363,232,131,416499.0,264452.0,152047.0,121.91,116.29,113.99,116.07
2023-09-13 14:35,49,33,16,451,252,199,521783.0,296707.0,225076.0,25,14,11,901,215,686,1053593.0,245482.0,808110.0,117.74,113.1,114.18,117.8
2023-09-13 14:40,154,59,95,5369,1260,4109,6197696.0,1446928.0,4750767.0,123,48,75,4355,1068,3287,5044458.0,1226051.0,3818407.0,114.84,115.62,114.8,116.17
2023-09-13 14:45,151,78,73,3034,1144,1890,3508399.0,1313967.0,2194432.0,113,58,55,2549,1136,1413,2931195.0,1296503.0,1634691.0,114.86,116.11,114.13,115.69
2023-09-13 14:50,132,46,86,3894,1602,2292,4291161.0,1741877.0,2549283.0,84,16,68,1372,102,1270,1587249.0,116030.0,1471219.0,108.73,111.23,113.76,115.84
2023-09-13 14:55,94,38,56,2128,655,1473,2309736.0,757407.0,1552329.0,62,18,44,840,281,559,966505.0,321760.0,644745.0,115.63,105.39,114.51,115.34
2023-09-13 15:00,148,62,86,5825,2054,3771,6664986.0,2335457.0,4329528.0,88,37,51,3455,1758,1697,3970642.0,1994277.0,1976365.0,113.7,114.81,113.44,116.46
2023-09-13 15:05,140,69,71,7850,3676,4174,8962211.0,4171242.0,4790969.0,100,35,65,8177,3347,4830,9405739.0,3786312.0,5619427.0,113.47,114.78,113.13,116.34
2023-09-13 15:10,344,166,178,25703,11388,14315,28856806.0,12868181.0,15988625.0,202,86,116,20337,8809,11528,23312397.0,9950582.0,13361815.0,113.0,111.69,112.96,115.91
2023-09-13 15:15,408,242,166,33175,19543,13632,40830140.0,25153213.0,15676927.0,288,167,121,28496,15955,12541,32379756.0,17930027.0,14449729.0,128.71,115.0,112.38,115.22
2023-09-13 15:20,284,184,100,21103,11335,9768,27125729.0,15849315.0,11276413.0,204,108,96,21112,10171,10941,26283123.0,13575793.0,12707330.0,139.83,115.44,133.48,116.14
2023-09-13 15:25,89,60,29,6046,3568,2478,8427126.0,5558549.0,2868576.0,52,27,25,5501,2965,2536,6282166.0,3344588.0,2937578.0,155.79,115.76,112.8,115.84
2023-09-13 15:30,295,220,75,21068,14166,6902,24166726.0,16152266.0,8014460.0,255,191,64,22300,16034,6266,25470763.0,18175807.0,7294955.0,114.02,116.12,113.36,116.42
2023-09-13 15:35,924,857,67,59638,50909,8729,68185365.0,58049449.0,10135916.0,911,844,67,59627,50649,8978,68170574.0,57748197.0,10422377.0,114.03,116.12,114.02,116.09
2023-09-13 15:40,269,221,48,17850,13455,4395,20412587.0,15318172.0,5094414.0,246,210,36,17426,13276,4150,19927412.0,15106729.0,4820683.0,113.85,115.91,113.79,116.16
2023-09-13 15:45,255,176,79,20498,13709,6789,23466647.0,15589038.0,7877609.0,237,167,70,19971,13230,6741,22833452.0,15009786.0,7823665.0,113.71,116.03,113.45,116.06
2023-09-13 15:50,106,57,49,9826,4977,4849,11286382.0,5647326.0,5639055.0,80,41,39,9479,4787,4692,10872897.0,5412237.0,5460659.0,113.47,116.29,113.06,116.38
2023-09-13 15:55,88,45,43,7113,3715,3398,8149431.0,4199288.0,3950143.0,68,32,36,7750,3519,4231,8908462.0,3978614.0,4929848.0,113.04,116.25,113.06,116.52
2023-09-13 16:00,213,113,100,18820,8092,10728,21391751.0,9132277.0,12259473.0,181,89,92,17510,7690,9820,20071978.0,8672695.0,11399282.0,112.86,114.28,112.78,116.08
2023-09-13 16:05,93,43,50,8113,4262,3851,9281348.0,4822344.0,4459003.0,80,35,45,7680,3891,3789,8789258.0,4396442.0,4392816.0,113.15,115.79,112.99,115.94
2023-09-13 16:10,38,19,19,1979,758,1221,2287985.0,872180.0,1415805.0,27,11,16,2229,851,1378,2556350.0,961790.0,1594560.0,115.06,115.95,113.02,115.72
2023-09-13 16:15,61,38,23,4018,2212,1806,4578143.0,2521769.0,2056373.0,48,28,20,4187,2017,2170,4801727.0,2286473.0,2515254.0,114.0,113.86,113.36,115.91
2023-09-13 16:20,60,33,27,3962,2139,1823,4588325.0,2481071.0,2107253.0,36,14,22,2952,1345,1607,3386086.0,1521104.0,1864981.0,115.99,115.59,113.09,116.05
2023-09-13 16:25,72,47,25,5860,3007,2853,6716815.0,3425618.0,3291197.0,45,28,17,4974,2699,2275,5703017.0,3056327.0,2646689.0,113.92,115.36,113.24,116.34
2023-09-13 16:30,71,42,29,4610,2732,1878,5263097.0,3105250.0,2157846.0,54,31,23,4371,2387,1984,5010871.0,2706641.0,2304230.0,113.66,114.9,113.39,116.14
2023-09-13 16:35,31,15,16,1941,1114,827,2229152.0,1268007.0,961144.0,22,10,12,1758,980,778,2017747.0,1113106.0,904641.0,113.82,116.22,113.58,116.28
2023-09-13 16:40,43,28,15,2907,1768,1139,3348247.0,2014203.0,1334044.0,27,16,11,2257,1344,913,2589176.0,1526661.0,1062514.0,113.93,117.12,113.59,116.38
2023-09-13 16:45,48,21,27,2619,896,1723,2926289.0,1017292.0,1908996.0,29,11,18,1968,673,1295,2295265.0,761339.0,1533926.0,113.54,110.79,113.13,118.45
2023-09-13 16:50,23,10,13,77,38,39,88515.0,47120.0,41395.0,22,15,7,3021,128,2893,3554125.0,144774.0,3409351.0,124.0,106.14,113.11,117.85
2023-09-13 16:55,15,9,6,171,120,51,194102.0,135217.0,58885.0,8,5,3,63,53,10,71985.0,60353.0,11631.0,112.68,115.46,113.87,116.32
2023-09-13 17:00,28,15,13,318,117,201,365289.0,135767.0,229522.0,10,5,5,145,18,127,166346.0,20391.0,145954.0,116.04,114.19,113.29,114.93
2023-09-13 17:05,23,11,12,739,140,599,938329.0,161484.0,776844.0,13,2,11,530,2,528,645596.0,2266.0,643330.0,115.35,129.69,113.3,121.84
2023-09-13 17:10,34,11,23,2240,839,1401,2569749.0,947679.0,1622069.0,29,10,19,2165,821,1344,2496928.0,926420.0,1570507.0,112.95,115.78,112.84,116.85
2023-09-13 17:15,31,13,18,2373,1053,1320,2720650.0,1189058.0,1531592.0,23,7,16,2382,1002,1380,2737390.0,1131263.0,1606127.0,112.92,116.03,112.9,116.39
2023-09-13 17:20,33,17,16,844,285,559,964279.0,318468.0,645811.0,26,10,16,731,272,459,834669.0,303204.0,531464.0,111.74,115.53,111.47,115.79
2023-09-13 17:25,39,20,19,1430,684,746,1635556.0,776493.0,859063.0,26,7,19,1209,513,696,1385564.0,580131.0,805433.0,113.52,115.16,113.09,115.72
2023-09-13 17:30,32,18,14,973,522,451,1112433.0,593729.0,518704.0,23,12,11,860,426,434,985669.0,480977.0,504691.0,113.74,115.01,112.91,116.29
2023-09-13 17:35,44,29,15,2293,1123,1170,2629998.0,1270874.0,1359124.0,22,10,12,2178,1020,1158,2497885.0,1152624.0,1345261.0,113.17,116.16,113.0,116.17
2023-09-13 17:40,121,54,67,10666,4944,5722,12163617.0,5599953.0,6563664.0,103,41,62,10195,4748,5447,11678327.0,5360800.0,6317527.0,113.27,114.71,112.91,115.98
2023-09-13 17:45,94,38,56,8820,4723,4097,9999919.0,5247229.0,4752689.0,84,29,55,7757,3656,4101,8880882.0,4123974.0,4756908.0,111.1,116.0,112.8,115.99
2023-09-13 17:50,110,47,63,10800,5312,5488,12368645.0,5998746.0,6369898.0,98,39,59,10452,4979,5473,11975029.0,5620397.0,6354632.0,112.93,116.07,112.88,116.11
2023-09-13 17:55,73,29,44,6084,2740,3344,6976885.0,3095326.0,3881558.0,61,22,39,5881,2644,3237,6736764.0,2983692.0,3753072.0,112.97,116.08,112.85,115.94
2023-09-13 18:00,81,39,42,7001,3355,3646,8020968.0,3804688.0,4216280.0,72,35,37,7085,3545,3540,8113910.0,4002611.0,4111299.0,113.4,115.64,112.91,116.14
2023-09-13 18:05,61,35,26,5829,2932,2897,6692032.0,3324403.0,3367628.0,52,25,27,5948,2877,3071,6822381.0,3250062.0,3572318.0,113.38,116.25,112.97,116.32
2023-09-13 18:10,22,10,12,1014,410,604,1163132.0,463835.0,699296.0,13,5,8,968,405,563,1112799.0,457615.0,655184.0,113.13,115.78,112.99,116.37
2023-09-13 18:15,28,16,12,1325,647,678,1520496.0,731420.0,789076.0,23,11,12,2738,632,2106,3198201.0,714292.0,2483909.0,113.05,116.38,113.02,117.94
2023-09-13 18:20,302,127,175,27011,12522,14489,30707679.0,14088259.0,16619420.0,256,100,156,26294,12293,14001,30016683.0,13828065.0,16188617.0,112.51,114.7,112.49,115.62
2023-09-13 18:25,208,74,134,20566,9488,11078,23472569.0,10679190.0,12793379.0,193,61,132,20627,9407,11220,23564881.0,10583491.0,12981390.0,112.55,115.48,112.51,115.7
2023-09-13 18:30,175,73,102,12086,5551,6535,13775258.0,6240381.0,7534877.0,150,49,101,12386,5530,6856,14151332.0,6214477.0,7936854.0,112.42,115.3,112.38,115.77
2023-09-13 18:35,129,33,96,3017,235,2782,3443860.0,267419.0,3176441.0,115,25,90,2875,197,2678,3293893.0,223480.0,3070412.0,113.8,114.18,113.44,114.65
2023-09-14 10:00,1320,241,1079,50540,4619,45921,60686458.0,5022158.0,55664300.0,609,128,481,36565,2440,34125,42004245.0,2737860.0,39266385.0,108.73,121.22,112.21,115.07
2023-09-14 10:05,364,84,280,19120,1981,17139,22281180.0,2246274.0,20034906.0,226,29,197,14194,641,13553,16317396.0,725124.0,15592272.0,113.39,116.9,113.12,115.05
2023-09-14 10:10,477,253,224,23373,11412,11961,26631203.0,13143993.0,13487210.0,322,153,169,15952,6634,9318,18256003.0,7530459.0,10725544.0,115.18,112.76,113.51,115.11
2023-09-14 10:15,1912,1130,782,118696,65880,52816,139275162.0,77502755.0,61772407.0,1060,714,346,89517,52919,36598,104000843.0,60824426.0,43176417.0,117.64,116.96,114.94,117.97
2023-09-14 10:20,1279,512,767,98009,45561,52448,114577941.0,53199682.0,61378259.0,860,400,460,81662,38381,43281,95144536.0,44098899.0,51045636.0,116.77,117.03,114.9,117.94
2023-09-14 10:25,2865,1679,1186,209218,118636,90582,247233733.0,140058735.0,107174998.0,1853,1227,626,159353,90489,68864,187275963.0,105095371.0,82180592.0,118.06,118.32,116.14,119.34
2023-09-14 10:30,4050,1731,2319,242836,110121,132715,289820529.0,131765787.0,158054742.0,2659,1130,1529,182149,86385,95764,216681471.0,101685755.0,114995716.0,119.66,119.09,117.71,120.08
2023-09-14 10:35,1789,1051,738,68140,39876,28264,79567310.0,46269278.0,33298032.0,1173,714,459,45595,27230,18365,53442618.0,31446055.0,21996562.0,116.03,117.81,115.48,119.77
2023-09-14 10:40,768,346,422,26190,14732,11458,31526524.0,17424935.0,14101589.0,492,184,308,19633,10760,8873,23919501.0,12474433.0,11445067.0,118.28,123.07,115.93,128.99
2023-09-14 10:45,856,300,556,29623,8691,20932,33899855.0,10096592.0,23803263.0,521,158,363,16790,5376,11414,19567973.0,6202143.0,13365830.0,116.17,113.72,115.37,117.1
2023-09-14 10:50,3568,2713,855,106444,76836,29608,121729003.0,87487806.0,34241197.0,2917,2320,597,82064,64723,17341,95143751.0,73446469.0,21697282.0,113.86,115.65,113.48,125.12
2023-09-14 10:55,5478,4710,768,183259,139427,43832,205190546.0,157436659.0,47753887.0,4946,4411,535,163850,132499,31351,185307237.0,149409598.0,35897639.0,112.92,108.95,112.76,114.5
2023-09-14 11:00,1430,881,549,81698,40395,41303,93509389.0,46455831.0,47053558.0,1129,671,458,72157,35770,36387,82176774.0,39959752.0,42217021.0,115.0,113.92,111.71,116.02
2023-09-14 11:05,1005,509,496,69558,35831,33727,78748286.0,40873237.0,37875049.0,791,405,386,61913,32152,29761,70223426.0,36398104.0,33825322.0,114.07,112.3,113.21,113.66
2023-09-14 11:10,877,599,278,64382,41270,23112,72058868.0,45888968.0,26169900.0,749,523,226,59229,38474,20755,66335988.0,42710804.0,23625184.0,111.19,113.23,111.01,113.83
2023-09-14 11:15,380,168,212,32612,16223,16389,36395393.0,17837509.0,18557883.0,299,112,187,27837,12570,15267,31283820.0,13913559.0,17370261.0,109.95,113.23,110.69,113.78
2023-09-14 11:20,274,117,157,23069,10904,12165,25835702.0,12097997.0,13737705.0,200,81,119,21076,10335,10741,23652547.0,11423790.0,12228756.0,110.95,112.93,110.53,113.85
2023-09-14 11:25,178,78,100,12935,5614,7321,14587930.0,6264415.0,8323515.0,134,51,83,12163,5201,6962,13714205.0,5758314.0,7955890.0,111.59,113.69,110.72,114.28
2023-09-14 11:30,235,112,123,15996,7382,8614,19184301.0,9416259.0,9768042.0,205,89,116,14561,6849,7712,16373531.0,7606112.0,8767419.0,127.56,113.4,111.05,113.69
2023-09-14 11:35,514,238,276,39116,17175,21941,43251631.0,18917044.0,24334587.0,401,159,242,36004,16462,19542,40239815.0,18117011.0,22122804.0,110.14,110.91,110.05,113.21
2023-09-14 11:40,336,129,207,29331,13194,16137,32653245.0,14487097.0,18166148.0,283,92,191,27960,12836,15124,31202528.0,14095707.0,17106821.0,109.8,112.57,109.81,113.11
2023-09-14 11:45,649,298,351,53985,25806,28179,59989655.0,28939212.0,31050443.0,440,151,289,46305,21750,24555,52568383.0,24907890.0,27660492.0,112.14,110.19,114.52,112.65
2023-09-14 11:50,372,191,181,25644,11692,13952,28361816.0,12767463.0,15594353.0,277,126,151,24752,12551,12201,27350365.0,13653225.0,13697140.0,109.2,111.77,108.78,112.26
2023-09-14 11:55,313,131,182,26075,11920,14155,28909861.0,13080327.0,15829534.0,233,77,156,23548,10413,13135,26187527.0,11340153.0,14847373.0,109.73,111.83,108.9,113.04
2023-09-14 12:00,238,112,126,17717,8083,9634,19955441.0,9247202.0,10708239.0,164,60,104,16848,7395,9453,19090558.0,8444208.0,10646349.0,114.4,111.15,114.19,112.62
2023-09-14 12:05,240,127,113,22332,11997,10335,24665593.0,13099955.0,11565638.0,195,91,104,20547,9741,10806,22724552.0,10609116.0,12115436.0,109.19,111.91,108.91,112.12
2023-09-14 12:10,132,62,70,8565,3495,5070,9478071.0,3811977.0,5666094.0,94,35,59,8196,3927,4269,9062278.0,4283490.0,4778788.0,109.07,111.76,109.08,111.94
2023-09-14 12:15,262,106,156,20468,9124,11344,22416033.0,9927364.0,12488669.0,157,48,109,14830,6559,8271,16353007.0,7118934.0,9234072.0,108.8,110.09,108.54,111.64
2023-09-14 12:20,235,116,119,18415,7748,10667,19970331.0,8408066.0,11562265.0,187,81,106,16949,8037,8912,18661113.0,8718897.0,9942216.0,108.52,108.39,108.48,111.56
2023-09-14 12:25,8515,8016,499,252190,219137,33053,270899519.0,235359090.0,35540429.0,7947,7681,266,226444,204055,22389,243578294.0,218816747.0,24761546.0,107.4,107.53,107.23,110.6
2023-09-14 12:30,1466,167,1299,59339,13797,45542,64017055.0,14834828.0,49182227.0,1356,90,1266,56904,13858,43046,61777591.0,14771627.0,47005963.0,107.52,107.99,106.59,109.2
2023-09-14 12:35,286,127,159,20697,9784,10913,22377946.0,10405549.0,11972397.0,217,85,132,19655,9881,9774,21345353.0,10530489.0,10814864.0,106.35,109.71,106.57,110.65
2023-09-14 12:40,631,158,473,58703,18022,40681,63364736.0,19264657.0,44100079.0,539,115,424,56401,17213,39188,61471702.0,18395657.0,43076045.0,106.9,108.4,106.87,109.92
2023-09-14 12:45,2242,1433,809,110340,54590,55750,114249056.0,56440737.0,57808318.0,1512,1002,510,84811,44284,40527,89048869.0,45630915.0,43417953.0,103.39,103.69,103.04,107.13
2023-09-14 12:50,9329,1329,8000,239793,42109,197684,240554265.0,42587066.0,197967199.0,8277,747,7530,208597,26808,181789,209061982.0,26309998.0,182751984.0,101.14,100.14,98.14,100.53
2023-09-14 12:55,3430,878,2552,125317,56478,68839,131250063.0,58351523.0,72898540.0,3077,657,2420,111824,51228,60596,117097996.0,52805298.0,64292698.0,103.32,105.9,103.08,106.1
2023-09-14 13:00,1562,930,632,86291,47276,39015,90869116.0,49382918.0,41486197.0,1415,789,626,81302,43940,37362,85487973.0,45667845.0,39820128.0,104.46,106.33,103.93,106.58
2023-09-14 13:05,654,436,218,39044,19811,19233,41357671.0,20684977.0,20672694.0,429,256,173,35659,17699,17960,37674178.0,18443094.0,19231084.0,104.41,107.49,104.2,107.08
2023-09-14 13:10,555,360,195,35548,20276,15272,37887493.0,21505857.0,16381635.0,379,227,152,30359,16488,13871,32118742.0,17217356.0,14901386.0,106.07,107.27,104.42,107.43
2023-09-14 13:15,525,358,167,40901,25792,15109,43986666.0,27528481.0,16458184.0,356,233,123,36046,21644,14402,38612585.0,22914721.0,15697864.0,106.73,108.93,105.87,109.0
2023-09-14 13:20,580,255,325,39090,14289,24801,41745967.0,15197395.0,26548572.0,400,147,253,29182,11409,17773,31167182.0,12213299.0,18953882.0,106.36,107.05,107.05,106.64
2023-09-14 13:25,252,134,118,7594,2498,5096,8191246.0,2668103.0,5523142.0,144,49,95,6265,1387,4878,6716994.0,1436462.0,5280531.0,106.81,108.38,103.57,108.25
2023-09-14 13:30,583,337,246,53081,24378,28703,57857307.0,26438572.0,31418734.0,478,273,205,49092,22238,26854,53181175.0,23770759.0,29410416.0,108.45,109.46,106.89,109.52
2023-09-14 13:35,651,353,298,59556,28593,30963,64945129.0,30692900.0,34252228.0,545,294,251,51127,27306,23821,55248188.0,29115905.0,26132283.0,107.34,110.62,106.63,109.7
2023-09-14 13:40,516,252,264,32799,15406,17393,35606696.0,16466616.0,19140080.0,431,192,239,31163,14457,16706,33764879.0,15413191.0,18351687.0,106.88,110.04,106.61,109.85
2023-09-14 13:45,441,309,132,31795,19172,12623,34459376.0,20593755.0,13865620.0,373,265,108,30528,18416,12112,33088631.0,19751628.0,13337003.0,107.42,109.84,107.25,110.11
2023-09-14 13:50,318,189,129,22618,12168,10450,24428961.0,12992797.0,11436164.0,259,152,107,21299,11744,9555,22996901.0,12520299.0,10476602.0,106.78,109.44,106.61,109.65
2023-09-14 13:55,273,187,86,18881,10868,8013,20351306.0,11637500.0,8713806.0,205,134,71,17528,9838,7690,18873995.0,10462490.0,8411505.0,107.08,108.75,106.35,109.38
2023-09-14 14:00,584,274,310,40692,18326,22366,43346185.0,19374367.0,23971818.0,505,217,288,38843,16819,22024,41585241.0,17746728.0,23838513.0,105.72,107.18,105.52,108.24
2023-09-14 14:05,378,211,167,28232,13896,14336,30293649.0,14752296.0,15541353.0,316,153,163,26686,13291,13395,28611536.0,14064222.0,14547314.0,106.16,108.41,105.82,108.6
2023-09-14 14:10,354,179,175,31842,14439,17403,34257707.0,15326751.0,18930956.0,286,128,158,31184,14256,16928,33474157.0,15079364.0,18394792.0,106.15,108.78,105.78,108.66
2023-09-14 14:15,285,127,158,22822,9684,13138,24342042.0,10174844.0,14167198.0,229,90,139,23214,9544,13670,24983141.0,10019354.0,14963787.0,105.07,107.83,104.98,109.46
2023-09-14 14:20,281,149,132,23198,10798,12400,24538467.0,11279921.0,13258546.0,208,91,117,21934,10173,11761,23228285.0,10593678.0,12634606.0,104.46,106.92,104.14,107.43
2023-09-14 14:25,255,155,100,20643,10714,9929,21887236.0,11197798.0,10689437.0,182,94,88,19163,9477,9686,20326935.0,9905488.0,10421447.0,104.52,107.66,104.52,107.59
2023-09-14 14:30,418,158,260,36029,15338,20691,38373431.0,16126990.0,22246441.0,377,134,243,35530,15716,19814,37783667.0,16471558.0,21312108.0,105.14,107.52,104.81,107.56
2023-09-14 14:35,481,417,64,24797,19341,5456,26413969.0,20504332.0,5909637.0,453,395,58,24328,18908,5420,25893167.0,20015956.0,5877210.0,106.01,108.31,105.86,108.44
2023-09-14 14:40,137,68,69,7400,3856,3544,7892630.0,4061246.0,3831384.0,109,47,62,7325,3814,3511,7813449.0,4017476.0,3795972.0,105.32,108.11,105.33,108.12
2023-09-14 14:45,180,121,59,15065,8527,6538,16192065.0,9061126.0,7130939.0,147,96,51,13924,8080,5844,14892293.0,8540474.0,6351818.0,106.26,109.07,105.7,108.69
2023-09-14 14:50,368,265,103,28394,17884,10510,30668661.0,19188419.0,11480242.0,335,244,91,27211,17165,10046,29276719.0,18295193.0,10981525.0,107.29,109.23,106.58,109.31
2023-09-14 14:55,469,240,229,38197,19642,18555,41058836.0,20888637.0,20170199.0,429,219,210,37564,19049,18515,40417518.0,20253308.0,20164210.0,106.35,108.7,106.32,108.91
2023-09-14 15:00,265,158,107,21315,12190,9125,23023453.0,12998755.0,10024698.0,227,142,85,20925,12372,8553,22557456.0,13186865.0,9370591.0,106.63,109.86,106.59,109.56
2023-09-14 15:05,504,341,163,44872,29271,15601,49275789.0,32071557.0,17204232.0,307,201,106,32993,19979,13014,35830500.0,21476300.0,14354200.0,109.57,110.28,107.49,110.3
2023-09-14 15:10,1331,866,465,95838,52879,42959,106412280.0,58012353.0,48399927.0,1038,706,332,88781,49673,39108,97806548.0,53505216.0,44301332.0,109.71,112.67,107.71,113.28
2023-09-14 15:15,592,356,236,52744,28551,24193,57819899.0,30954562.0,26865337.0,439,261,178,45649,24851,20798,49920413.0,26842862.0,23077550.0,108.42,111.05,108.02,110.96
2023-09-14 15:20,548,294,254,39136,19696,19440,42931673.0,21487301.0,21444372.0,489,258,231,36543,18976,17567,39968754.0,20511440.0,19457314.0,109.09,110.31,108.09,110.76
2023-09-14 15:25,481,289,192,36872,21009,15863,40210327.0,22695769.0,17514558.0,427,263,164,36123,20597,15526,39543104.0,22232368.0,17310735.0,108.03,110.41,107.94,111.5
2023-09-14 15:30,993,336,657,64871,21953,42918,70228344.0,23554868.0,46673476.0,846,254,592,62144,20721,41423,67464786.0,22225293.0,45239493.0,107.3,108.75,107.26,109.21
2023-09-14 15:35,1775,482,1293,112362,34149,78213,122032150.0,36631617.0,85400533.0,1706,433,1273,111158,33257,77901,120717857.0,35661414.0,85056443.0,107.27,109.19,107.23,109.19
2023-09-14 15:40,559,368,191,41623,24858,16765,45499808.0,26989935.0,18509872.0,505,334,171,39939,23715,16224,43507238.0,25574219.0,17933018.0,108.58,110.41,107.84,110.53
2023-09-14 15:45,210,162,48,10551,7726,2825,11644927.0,8410091.0,3234836.0,175,147,28,9585,7672,1913,10433197.0,8312982.0,2120215.0,108.85,114.51,108.35,110.83
2023-09-14 15:50,503,384,119,39422,25401,14021,43160285.0,27610655.0,15549630.0,475,368,107,38846,25005,13841,42435474.0,27082091.0,15353383.0,108.7,110.9,108.31,110.93
2023-09-14 15:55,275,195,80,20349,13001,7348,22430116.0,14259991.0,8170124.0,241,180,61,18686,12000,6686,20438132.0,12993806.0,7444326.0,109.68,111.19,108.28,111.34
2023-09-14 16:00,297,181,116,24189,13599,10590,26500691.0,14740157.0,11760533.0,261,162,99,23990,13828,10162,26264952.0,14968273.0,11296679.0,108.39,111.05,108.25,111.17
2023-09-14 16:05,292,173,119,21157,11871,9286,23088332.0,12825836.0,10262495.0,259,156,103,20263,11215,9048,22137517.0,12111557.0,10025960.0,108.04,110.52,107.99,110.81
2023-09-14 16:10,102,53,49,7186,3231,3955,7842244.0,3473601.0,4368643.0,81,42,39,7309,3883,3426,7970344.0,4183225.0,3787118.0,107.51,110.46,107.73,110.54
2023-09-14 16:15,73,42,31,4015,1868,2147,4373665.0,2007244.0,2366420.0,62,32,30,3981,1571,2410,4385359.0,1686516.0,2698842.0,107.45,110.22,107.35,111.99
2023-09-14 16:20,261,186,75,21217,13617,7600,23278290.0,14861041.0,8417248.0,204,145,59,17563,10625,6938,19212390.0,11524948.0,7687442.0,109.14,110.75,108.47,110.8
2023-09-14 16:25,258,146,112,16719,8786,7933,18329442.0,9540262.0,8789180.0,208,120,88,17078,9644,7434,18696256.0,10439829.0,8256426.0,108.58,110.79,108.25,111.06
2023-09-14 16:30,202,167,35,9894,6913,2981,10828341.0,7514956.0,3313385.0,178,149,29,9457,6559,2898,10326922.0,7104284.0,3222637.0,108.71,111.15,108.31,111.2
2023-09-14 16:35,258,162,96,23721,15340,8381,25569941.0,16259980.0,9309960.0,222,139,83,17122,9310,7812,18805838.0,10060932.0,8744905.0,106.0,111.08,108.07,111.94
2023-09-14 16:40,443,395,48,19370,15500,3870,21225826.0,16915853.0,4309973.0,404,373,31,18525,14877,3648,20261322.0,16188006.0,4073315.0,109.13,111.37,108.81,111.66
2023-09-14 16:45,370,299,71,24851,16719,8132,27314938.0,18258189.0,9056748.0,320,258,62,23781,15575,8206,26073535.0,16930887.0,9142648.0,109.21,111.37,108.71,111.41
2023-09-14 16:50,573,400,173,49191,28698,20493,54324716.0,31439295.0,22885420.0,501,357,144,47387,27715,19672,52196865.0,30194006.0,22002858.0,109.55,111.67,108.94,111.85
2023-09-14 16:55,373,202,171,33594,18527,15067,37927078.0,21015857.0,16911221.0,269,170,99,29322,15908,13414,32435911.0,17351674.0,15084237.0,113.43,112.24,109.08,112.45
2023-09-14 17:00,231,97,134,20371,8082,12289,22571324.0,8833812.0,13737512.0,192,76,116,17323,7394,9929,19171209.0,8057935.0,11113274.0,109.3,111.79,108.98,111.93
2023-09-14 17:05,516,120,396,28613,10443,18170,31529056.0,11353223.0,20175833.0,467,96,371,27763,10000,17763,30545844.0,10814353.0,19731490.0,108.72,111.04,108.14,111.08
2023-09-14 17:10,308,80,228,19994,6702,13292,22031296.0,7288864.0,14742432.0,279,64,215,20092,6427,13665,22181677.0,6981585.0,15200092.0,108.76,110.91,108.63,111.23
2023-09-14 17:15,943,160,783,68099,14355,53744,74558743.0,15478619.0,59080124.0,847,110,737,62156,13261,48895,68303689.0,14306048.0,53997641.0,107.83,109.93,107.88,110.44
2023-09-14 17:20,392,215,177,19573,9279,10294,20719105.0,9942824.0,10776280.0,198,77,121,11600,5818,5782,12560375.0,6223444.0,6336931.0,107.15,104.69,106.97,109.6
2023-09-14 17:25,395,140,255,13576,2920,10656,14799241.0,3237779.0,11561462.0,319,101,218,13097,3246,9851,14236085.0,3478890.0,10757195.0,110.88,108.5,107.17,109.2
2023-09-14 17:30,623,177,446,28531,2525,26006,31196003.0,2751459.0,28444544.0,600,169,431,28194,2368,25826,30794513.0,2557227.0,28237286.0,108.97,109.38,107.99,109.34
2023-09-14 17:35,1851,72,1779,63754,1173,62581,69636259.0,1276767.0,68359491.0,1824,54,1770,63488,1190,62298,69342669.0,1279188.0,68063481.0,108.85,109.23,107.49,109.25
2023-09-14 17:40,186,118,68,4953,2392,2561,5399838.0,2594119.0,2805719.0,168,106,62,4769,2441,2328,5192756.0,2642704.0,2550052.0,108.45,109.56,108.26,109.54
2023-09-14 17:45,234,162,72,8005,6026,1979,8659512.0,6558338.0,2101173.0,202,146,56,9963,7601,2362,10675024.0,8084195.0,2590829.0,108.83,106.17,106.36,109.69
2023-09-14 17:50,254,222,32,8950,8351,599,9719927.0,9064459.0,655467.0,238,207,31,8678,8111,567,9391770.0,8772179.0,619591.0,108.54,109.43,108.15,109.28
2023-09-14 17:55,373,268,105,14754,9531,5223,16063224.0,10346906.0,5716317.0,352,254,98,14574,9565,5009,15833645.0,10352884.0,5480760.0,108.56,109.45,108.24,109.42
2023-09-14 18:00,207,132,75,9012,4731,4281,9869662.0,5169892.0,4699770.0,189,119,70,7694,4414,3280,8358790.0,4768586.0,3590204.0,109.28,109.78,108.03,109.46
2023-09-14 18:05,557,40,517,22808,1436,21372,24940669.0,1556293.0,23384376.0,537,30,507,22676,777,21899,24815229.0,833273.0,23981955.0,108.38,109.42,107.24,109.51
2023-09-14 18:10,77,27,50,4644,678,3966,5087858.0,739787.0,4348070.0,57,14,43,3197,375,2822,3517862.0,405099.0,3112763.0,109.11,109.63,108.03,110.3
2023-09-14 18:15,43,22,21,1017,159,858,1136822.0,198573.0,938249.0,20,7,13,534,112,422,585413.0,120853.0,464560.0,124.89,109.35,107.91,110.09
2023-09-14 18:20,772,318,454,37408,12087,25321,40922905.0,13182379.0,27740526.0,746,295,451,37177,11219,25958,40630688.0,12180704.0,28449984.0,109.06,109.56,108.57,109.6
2023-09-14 18:25,177,56,121,6611,1449,5162,7346040.0,1671976.0,5674064.0,138,36,102,5794,956,4838,6379107.0,1034425.0,5344681.0,115.39,109.92,108.2,110.47
2023-09-14 18:30,893,406,487,31120,7187,23933,33686978.0,7734514.0,25952463.0,816,359,457,28623,6578,22045,31114778.0,7044245.0,24070533.0,107.62,108.44,107.09,109.19
2023-09-14 18:35,596,96,500,27229,2900,24329,29667184.0,3142422.0,26524761.0,551,59,492,27002,2302,24700,29401268.0,2451852.0,26949416.0,108.36,109.03,106.51,109.11
2023-09-15 10:00,2429,911,1518,98578,39840,58738,110822806.0,43418542.0,67404264.0,1244,626,618,63963,30264,33699,70528500.0,33386593.0,37141907.0,108.98,114.75,110.32,110.22
2023-09-15 10:05,1055,418,637,37945,15913,22032,43379356.0,17303158.0,26076197.0,745,287,458,29251,14218,15033,32086003.0,15460727.0,16625276.0,108.74,118.36,108.74,110.59
2023-09-15 10:10,696,158,538,20054,4493,15561,22193080.0,4846885.0,17346195.0,550,94,456,14213,2695,11518,15581308.0,2912089.0,12669219.0,107.88,111.47,108.06,109.99
2023-09-15 10:15,632,412,220,24487,16192,8295,27036504.0,17673451.0,9363053.0,568,379,189,19885,14819,5066,21696046.0,16115960.0,5580085.0,109.15,112.88,108.75,110.15
2023-09-15 10:20,625,375,250,14155,10011,4144,15496297.0,10876756.0,4619540.0,358,249,109,14742,9791,4951,16153569.0,10653564.0,5500005.0,108.65,111.48,108.81,111.09
2023-09-15 10:25,233,133,100,6685,3545,3140,7401032.0,3889878.0,3511154.0,164,100,64,4889,2578,2311,5380513.0,2805242.0,2575271.0,109.73,111.82,108.81,111.44
2023-09-15 10:30,612,428,184,29651,20027,9624,32575645.0,21857984.0,10717661.0,512,373,139,25431,17687,7744,27868013.0,19249111.0,8618901.0,109.14,111.36,108.83,111.3
2023-09-15 10:35,795,428,367,62969,32452,30517,69163282.0,35250206.0,33913075.0,659,337,322,60665,30544,30121,66662173.0,33139740.0,33522432.0,108.62,111.13,108.5,111.29
2023-09-15 10:40,265,118,147,16767,7995,8772,18442949.0,8707019.0,9735930.0,182,74,108,16200,8163,8037,17840727.0,8875986.0,8964741.0,108.91,110.99,108.73,111.54
2023-09-15 10:45,149,88,61,9409,4830,4579,10447060.0,5321167.0,5125893.0,96,55,41,8412,4408,4004,9257884.0,4788854.0,4469030.0,110.17,111.94,108.64,111.61
2023-09-15 10:50,101,55,46,6363,3245,3118,7076993.0,3568844.0,3508149.0,66,38,28,6044,3111,2933,6652965.0,3369297.0,3283668.0,109.98,112.51,108.3,111.96
2023-09-15 10:55,129,57,72,9390,4207,5183,10272472.0,4570185.0,5702287.0,98,43,55,8664,4092,4572,9542933.0,4439754.0,5103178.0,108.63,110.02,108.5,111.62
2023-09-15 11:00,690,105,585,34461,9055,25406,37386937.0,9445653.0,27941284.0,624,69,555,31698,7208,24490,34801071.0,7796522.0,27004549.0,104.31,109.98,108.16,110.27
2023-09-15 11:05,891,242,649,30859,10269,20590,33815542.0,11166081.0,22649460.0,860,223,637,30433,9981,20452,33373054.0,10847532.0,22525521.0,108.74,110.0,108.68,110.14
2023-09-15 11:10,1052,645,407,52013,31550,20463,57198636.0,34490400.0,22708236.0,955,579,376,49573,30098,19475,54415107.0,32798551.0,21616555.0,109.32,110.97,108.97,111.0
2023-09-15 11:15,653,444,209,49149,27968,21181,54283565.0,30586436.0,23697128.0,569,408,161,45807,26842,18965,50564117.0,29329050.0,21235066.0,109.36,111.88,109.27,111.97
2023-09-15 11:20,17767,808,16959,338054,50820,287234,373210965.0,55473420.0,317737545.0,17706,790,16916,336378,50432,285946,371332227.0,55037834.0,316294393.0,109.16,110.62,109.13,110.61
2023-09-15 11:25,552,442,110,29496,21233,8263,32381377.0,23174304.0,9207072.0,515,410,105,28976,20626,8350,31818233.0,22512390.0,9305842.0,109.14,111.43,109.15,111.45
2023-09-15 11:30,233,171,62,16839,10667,6172,18553565.0,11649805.0,6903760.0,187,140,47,16183,10187,5996,17801535.0,11106443.0,6695092.0,109.21,111.86,109.03,111.66
2023-09-15 11:35,227,122,105,14872,8439,6433,16365573.0,9229091.0,7136482.0,192,111,81,15106,8316,6790,16620353.0,9040126.0,7580227.0,109.36,110.94,108.71,111.64
2023-09-15 11:40,197,118,79,14776,6799,7977,16455628.0,7395373.0,9060255.0,167,100,67,17137,6502,10635,19314509.0,7075155.0,12239354.0,108.77,113.58,108.82,115.09
2023-09-15 11:45,394,146,248,23078,11486,11592,25259565.0,12374804.0,12884761.0,366,128,238,22378,10820,11558,24641542.0,11771668.0,12869874.0,107.74,111.15,108.8,111.35
2023-09-15 11:50,370,80,290,17222,5525,11697,18923602.0,5997151.0,12926450.0,334,62,272,15932,5150,10782,17529054.0,5579737.0,11949317.0,108.55,110.51,108.34,110.83
2023-09-15 11:55,1415,836,579,51927,31997,19930,57945726.0,35796809.0,22148916.0,1318,800,518,47482,29567,17915,52320364.0,32423584.0,19896779.0,111.88,111.13,109.66,111.06
2023-09-15 12:00,633,494,139,22160,19546,2614,24334566.0,21438783.0,2895783.0,598,464,134,20387,16790,3597,22635947.0,18636849.0,3999098.0,109.68,110.78,111.0,111.18
2023-09-15 12:05,689,468,221,23284,17842,5442,26367010.0,20306944.0,6060066.0,577,418,159,20520,16435,4085,22687819.0,18139725.0,4548094.0,113.82,111.36,110.37,111.34
2023-09-15 12:10,439,347,92,12927,9616,3311,14312054.0,10626599.0,3685455.0,391,324,67,11744,9327,2417,13021016.0,10305267.0,2715748.0,110.51,111.31,110.49,112.36
2023-09-15 12:15,187,124,63,5847,3086,2761,6463653.0,3383643.0,3080009.0,169,112,57,5036,2846,2190,5585025.0,3132027.0,2452998.0,109.64,111.55,110.05,112.01
2023-09-15 12:20,217,109,108,12774,7305,5469,14078366.0,7982333.0,6096033.0,176,93,83,10768,6544,4224,11860225.0,7145374.0,4714851.0,109.27,111.47,109.19,111.62
2023-09-15 12:25,137,59,78,8500,2769,5731,9399752.0,3027166.0,6372586.0,108,43,65,5198,2617,2581,5742490.0,2858008.0,2884482.0,109.32,111.2,109.21,111.76
2023-09-15 12:30,386,266,120,31944,16671,15273,35372538.0,18207629.0,17164909.0,364,257,107,30830,16714,14116,34021898.0,18260913.0,15760985.0,109.22,112.39,109.26,111.65
2023-09-15 12:35,903,487,416,55981,30959,25022,61897274.0,33942644.0,27954630.0,839,452,387,55255,30221,25034,61130650.0,33129782.0,28000868.0,109.64,111.72,109.63,111.85
2023-09-15 12:40,717,607,110,39217,26920,12297,43420844.0,29632155.0,13788689.0,669,581,88,38457,26384,12073,42536233.0,28995826.0,13540406.0,110.07,112.13,109.9,112.15
2023-09-15 12:45,351,285,66,24071,15712,8359,26608898.0,17238405.0,9370492.0,324,271,53,23938,15710,8228,26447701.0,17223553.0,9224147.0,109.71,112.1,109.63,112.11
2023-09-15 12:50,3438,608,2830,150493,40943,109550,166342723.0,44777571.0,121565152.0,3410,588,2822,149994,40679,109315,165879205.0,44496298.0,121382907.0,109.37,110.97,109.38,111.04
2023-09-15 12:55,1520,201,1319,95415,17877,77538,105458754.0,19444210.0,86014544.0,1497,190,1307,95596,17934,77662,105662634.0,19503795.0,86158839.0,108.77,110.93,108.75,110.94
2023-09-15 13:00,676,213,463,44647,18764,25883,49164124.0,20375945.0,28788179.0,602,181,421,42139,17781,24358,46408214.0,19296090.0,27112124.0,108.59,111.22,108.52,111.31
2023-09-15 13:05,232,138,94,20248,10350,9898,22241578.0,11215880.0,11025698.0,219,130,89,20762,10864,9898,22815670.0,11787707.0,11027963.0,108.37,111.39,108.5,111.42
2023-09-15 13:10,648,190,458,32878,14518,18360,36168145.0,15765481.0,20402663.0,620,173,447,32535,14328,18207,35779935.0,15544190.0,20235745.0,108.59,111.13,108.49,111.14
2023-09-15 13:15,350,144,206,16427,7768,8659,18067530.0,8453029.0,9614501.0,324,124,200,16115,7532,8583,17717213.0,8187904.0,9529308.0,108.82,111.03,108.71,111.03
2023-09-15 13:20,109,79,30,6367,3764,2603,7005860.0,4104213.0,2901646.0,99,73,26,5868,3652,2216,6460828.0,3984672.0,2476155.0,109.04,111.47,109.11,111.74
2023-09-15 13:25,283,159,124,19437,8885,10552,21299545.0,9602471.0,11697073.0,251,138,113,19363,8652,10711,21320553.0,9385040.0,11935513.0,108.08,110.85,108.47,111.43
2023-09-15 13:30,680,570,110,39788,28422,11366,43685153.0,31046202.0,12638950.0,616,515,101,39105,27784,11321,42893776.0,30237204.0,12656571.0,109.23,111.2,108.83,111.8
2023-09-15 13:35,392,303,89,26155,15505,10650,29061478.0,17034118.0,12027359.0,317,247,70,26851,16244,10607,29373149.0,17422811.0,11950338.0,109.86,112.93,107.26,112.66
2023-09-15 13:40,174,114,60,11540,6323,5217,12859933.0,6988255.0,5871678.0,134,98,36,10350,6129,4221,11447955.0,6693084.0,4754871.0,110.52,112.55,109.2,112.65
2023-09-15 13:45,184,120,64,15811,8142,7669,17626107.0,8981378.0,8644729.0,133,86,47,15652,7204,8448,17462325.0,7864474.0,9597851.0,110.31,112.72,109.17,113.61
2023-09-15 13:50,220,109,111,20304,10065,10239,22455174.0,11046036.0,11409138.0,178,88,90,19128,9479,9649,21196283.0,10338948.0,10857335.0,109.75,111.43,109.07,112.52
2023-09-15 13:55,241,125,116,18881,10219,8662,21129209.0,11389923.0,9739285.0,176,88,88,17139,8774,8365,19026519.0,9614087.0,9412432.0,111.46,112.44,109.57,112.52
2023-09-15 14:00,551,326,225,48340,25294,23046,54457195.0,28353266.0,26103929.0,323,196,127,37816,19968,17848,42303529.0,22088458.0,20215071.0,112.09,113.27,110.62,113.26
2023-09-15 14:05,1395,843,552,107670,57810,49860,121587782.0,64887496.0,56700286.0,892,543,349,95803,51528,44275,107629573.0,57205280.0,50424292.0,112.24,113.72,111.02,113.89
2023-09-15 14:10,322,203,119,29851,14909,14942,33851110.0,16780311.0,17070799.0,262,171,91,26700,12835,13865,30079338.0,14253115.0,15826222.0,112.55,114.25,111.05,114.15
2023-09-15 14:15,216,139,77,21003,10400,10603,23694905.0,11650087.0,12044817.0,150,101,49,19172,9076,10096,21645250.0,10098767.0,11546482.0,112.02,113.6,111.27,114.37
2023-09-15 14:20,215,128,87,17700,9357,8343,19903620.0,10400801.0,9502819.0,154,104,50,15736,8253,7483,17696490.0,9155388.0,8541102.0,111.16,113.9,110.93,114.14
2023-09-15 14:25,214,124,90,16957,8404,8553,19073879.0,9348742.0,9725136.0,170,109,61,15617,7957,7660,17614051.0,8840471.0,8773579.0,111.24,113.7,111.1,114.54
2023-09-15 14:30,135,79,56,11166,5656,5510,12544461.0,6313332.0,6231128.0,117,65,52,11265,5241,6024,12695867.0,5808052.0,6887815.0,111.62,113.09,110.82,114.34
2023-09-15 14:35,1211,619,592,49743,27301,22442,57453542.0,31822058.0,25631483.0,1068,554,514,39509,21614,17895,44616310.0,24290464.0,20325845.0,116.56,114.21,112.38,113.58
2023-09-15 14:40,363,107,256,10979,3162,7817,12485963.0,3618933.0,8867030.0,277,72,205,8267,1773,6494,9362611.0,1989604.0,7373007.0,114.45,113.43,112.22,113.54
2023-09-15 14:45,137,83,54,8188,4121,4067,9250416.0,4605846.0,4644570.0,99,50,49,9110,4197,4913,10329281.0,4684641.0,5644640.0,111.77,114.2,111.62,114.89
2023-09-15 14:50,637,140,497,45616,12761,32855,51317178.0,14182669.0,37134508.0,563,108,455,43742,12286,31456,49352148.0,13646946.0,35705202.0,111.14,113.03,111.08,113.51
2023-09-15 14:55,452,262,190,31407,16230,15177,35634194.0,18352711.0,17281482.0,384,226,158,28914,14689,14225,32590090.0,16390999.0,16199090.0,113.08,113.87,111.59,113.88
2023-09-15 15:00,949,801,148,60111,44103,16008,67873729.0,49485968.0,18387761.0,899,779,120,57725,43890,13835,65056448.0,49229979.0,15826469.0,112.21,114.87,112.17,114.39
2023-09-15 15:05,275,210,65,19259,13824,5435,21671698.0,15465718.0,6205980.0,243,194,49,17613,11940,5673,19833787.0,13346439.0,6487347.0,111.88,114.19,111.78,114.35
2023-09-15 15:10,809,627,182,57116,39795,17321,64569366.0,44738529.0,19830837.0,757,603,154,56142,39061,17081,63379989.0,43794574.0,19585415.0,112.42,114.49,112.12,114.66
2023-09-15 15:15,928,826,102,54623,44738,9885,61777158.0,50324134.0,11453024.0,897,816,81,52486,44491,7995,59185279.0,50028897.0,9156381.0,112.49,115.86,112.45,114.53
2023-09-15 15:20,358,259,99,27681,17818,9863,31238284.0,19952340.0,11285943.0,344,258,86,27333,17915,9418,30752406.0,19987043.0,10765363.0,111.98,114.43,111.57,114.31
2023-09-15 15:25,123,73,50,8301,4412,3889,9311694.0,4917962.0,4393731.0,102,69,33,9965,6451,3514,11217809.0,7158945.0,4058864.0,111.47,112.98,110.97,115.51
2023-09-15 15:30,206,56,150,14272,5461,8811,15989412.0,6036861.0,9952551.0,170,37,133,11668,3229,8439,13170570.0,3573502.0,9597067.0,110.54,112.96,110.67,113.72
2023-09-15 15:35,274,85,189,20189,7721,12468,22739113.0,8562836.0,14176277.0,240,67,173,19012,6974,12038,21387260.0,7725667.0,13661592.0,110.9,113.7,110.78,113.49
2023-09-15 15:40,280,91,189,22317,8410,13907,24939691.0,9309486.0,15630204.0,253,81,172,21042,8283,12759,23646148.0,9168040.0,14478107.0,110.7,112.39,110.69,113.47
2023-09-15 15:45,228,88,140,18246,7920,10326,20454012.0,8764363.0,11689649.0,196,67,129,17573,7407,10166,19728659.0,8189701.0,11538958.0,110.66,113.21,110.57,113.51
2023-09-15 15:50,428,366,62,22600,19367,3233,25833208.0,22160384.0,3672824.0,366,334,32,19377,17017,2360,21760155.0,19070334.0,2689821.0,114.42,113.6,112.07,113.98
2023-09-15 15:55,307,221,86,13467,10423,3044,15365804.0,11982194.0,3383610.0,194,160,34,8659,7344,1315,9769822.0,8255718.0,1514104.0,114.96,111.16,112.41,115.14
2023-09-15 16:00,252,110,142,7475,2231,5244,8487105.0,2513674.0,5973431.0,218,95,123,7489,2503,4986,8497186.0,2809876.0,5687310.0,112.67,113.91,112.26,114.07
2023-09-15 16:05,155,70,85,5288,1951,3337,6130567.0,2212152.0,3918415.0,121,60,61,3745,1825,1920,4239230.0,2052106.0,2187123.0,113.39,117.42,112.44,113.91
2023-09-15 16:10,256,103,153,15979,6111,9868,18066854.0,6824217.0,11242636.0,211,96,115,14256,6076,8180,16100146.0,6770866.0,9329280.0,111.67,113.93,111.44,114.05
2023-09-15 16:15,113,56,57,8944,5005,3939,10044740.0,5571009.0,4473731.0,86,40,46,7854,4135,3719,8826785.0,4590131.0,4236653.0,111.31,113.58,111.01,113.92
2023-09-15 16:20,1398,1208,190,96945,76182,20763,110017825.0,86138545.0,23879280.0,1322,1169,153,94637,74698,19939,107186311.0,84212128.0,22974183.0,113.07,115.01,112.74,115.22
2023-09-15 16:25,778,690,88,52914,40626,12288,59801279.0,45702214.0,14099064.0,745,670,75,52037,40270,11767,58800582.0,45285615.0,13514967.0,112.49,114.74,112.45,114.85
2023-09-15 16:30,1134,1043,91,63762,55323,8439,71942098.0,62272353.0,9669744.0,1099,1028,71,63493,55330,8163,71640131.0,62281519.0,9358612.0,112.56,114.58,112.56,114.65
2023-09-15 16:35,446,362,84,32547,22512,10035,36857853.0,25376420.0,11481433.0,419,347,72,33738,23741,9997,38072539.0,26605109.0,11467429.0,112.72,114.41,112.06,114.71
2023-09-15 16:40,2187,1456,731,138462,86797,51665,157301747.0,98133133.0,59168614.0,2143,1434,709,136682,85825,50857,155065247.0,96793241.0,58272006.0,113.06,114.52,112.78,114.58
2023-09-15 16:45,930,385,545,53867,28490,25377,64306897.0,35037263.0,29269634.0,632,285,347,43408,26406,17002,52255012.0,32695802.0,19559209.0,122.98,115.34,123.82,115.04
2023-09-15 16:50,339,207,132,8533,5717,2816,9696635.0,6511270.0,3185365.0,229,170,59,8071,5788,2283,9201202.0,6531432.0,2669770.0,113.89,113.12,112.84,116.94
2023-09-15 16:55,175,112,63,10319,5691,4628,11777021.0,6422652.0,5354369.0,139,90,49,9285,5405,3880,10626179.0,6101406.0,4524773.0,112.86,115.7,112.88,116.62
2023-09-15 17:00,218,180,38,10334,6864,3470,11789189.0,7770993.0,4018196.0,189,161,28,8869,6274,2595,10086619.0,7082293.0,3004326.0,113.21,115.8,112.88,115.77
2023-09-15 17:05,164,122,42,12854,7481,5373,14769329.0,8457822.0,6311507.0,135,103,32,10515,6826,3689,11976254.0,7702889.0,4273365.0,113.06,117.47,112.85,115.84
2023-09-15 17:10,135,105,30,6378,4737,1641,7241010.0,5349051.0,1891959.0,122,101,21,6428,4634,1794,7323404.0,5236359.0,2087045.0,112.92,115.29,113.0,116.33
2023-09-15 17:15,157,114,43,10969,6829,4140,12459368.0,7695413.0,4763955.0,148,110,38,12103,7467,4636,13745423.0,8377064.0,5368359.0,112.69,115.07,112.19,115.8
2023-09-15 17:20,92,54,38,6635,3667,2968,7544120.0,4118097.0,3426023.0,84,50,34,6906,3689,3217,7893314.0,4142034.0,3751279.0,112.3,115.43,112.28,116.61
2023-09-15 17:25,158,77,81,14546,7354,7192,16553358.0,8261070.0,8292287.0,141,71,70,13877,7098,6779,15795002.0,7969963.0,7825039.0,112.33,115.3,112.28,115.43
2023-09-15 17:30,227,124,103,20678,10969,9709,23569927.0,12391598.0,11178329.0,202,112,90,19713,10642,9071,22429469.0,11963739.0,10465730.0,112.97,115.13,112.42,115.38
2023-09-15 17:35,201,135,66,15103,9326,5777,17173784.0,10507647.0,6666137.0,176,119,57,15056,9226,5830,17123768.0,10392136.0,6731631.0,112.67,115.39,112.64,115.47
2023-09-15 17:40,138,98,40,10804,6771,4033,12254927.0,7634138.0,4620789.0,127,94,33,10244,6356,3888,11648743.0,7159670.0,4489072.0,112.75,114.57,112.64,115.46
2023-09-15 17:45,271,195,76,22401,12886,9515,25682204.0,14634995.0,11047209.0,233,175,58,20881,12209,8672,23801529.0,13759183.0,10042346.0,113.57,116.1,112.7,115.8
2023-09-15 17:50,157,117,40,12351,7918,4433,14052027.0,8930872.0,5121155.0,147,107,40,12014,7702,4312,13679299.0,8687733.0,4991566.0,112.79,115.52,112.8,115.76
2023-09-15 17:55,178,89,89,14721,7643,7078,16717044.0,8566723.0,8150320.0,164,82,82,14593,7632,6961,16617585.0,8584027.0,8033558.0,112.09,115.15,112.47,115.41
2023-09-15 18:00,346,179,167,26461,12229,14232,29719088.0,13703531.0,16015556.0,300,156,144,23079,11311,11768,26205433.0,12669419.0,13536014.0,112.06,112.53,112.01,115.02
2023-09-15 18:05,204,103,101,13230,6065,7165,14992988.0,6801353.0,8191634.0,167,79,88,11977,5167,6810,13569837.0,5748588.0,7821248.0,112.14,114.33,111.26,114.85
2023-09-15 18:10,278,79,199,18405,5866,12539,20898526.0,6576015.0,14322511.0,252,63,189,17908,5738,12170,20388716.0,6424549.0,13964167.0,112.1,114.22,111.96,114.74
2023-09-15 18:15,114,22,92,6576,1702,4874,7457695.0,1918214.0,5539480.0,95,13,82,6330,1520,4810,7192866.0,1708562.0,5484304.0,112.7,113.65,112.41,114.02
2023-09-15 18:20,35231,138,35093,1206592,12707,1193885,1374413200.0,14276954.0,1360136246.0,35203,124,35079,1206410,12951,1193459,1374184676.0,14527807.0,1359656869.0,112.36,113.93,112.18,113.93
2023-09-15 18:25,167,97,70,14994,8623,6371,17199205.0,9855703.0,7343502.0,147,89,58,14208,8175,6033,16176740.0,9204336.0,6972404.0,114.3,115.26,112.59,115.57
2023-09-15 18:30,86,67,19,4551,3054,1497,5204992.0,3462930.0,1742061.0,67,56,11,3611,2983,628,4099468.0,3374008.0,725460.0,113.39,116.37,113.11,115.52
2023-09-15 18:35,120,64,56,4352,2521,1831,4741150.0,2860646.0,1880503.0,105,58,47,3870,2543,1327,4396615.0,2876952.0,1519663.0,113.47,102.7,113.13,114.52
2023-09-18 10:00,2497,1618,879,69687,45608,24079,80350476.0,51105029.0,29245446.0,1531,1378,153,44394,37685,6709,50607143.0,42886878.0,7720265.0,112.05,121.46,113.8,115.07
2023-09-18 10:05,373,159,214,9994,3481,6513,11585074.0,3952020.0,7633054.0,208,82,126,7202,2424,4778,8235490.0,2748969.0,5486521.0,113.53,117.2,113.41,114.83
2023-09-18 10:10,479,228,251,5610,2880,2730,6453383.0,3299643.0,3153740.0,119,57,62,2347,1315,1032,2684358.0,1494780.0,1189577.0,114.57,115.52,113.67,115.27
2023-09-18 10:15,242,128,114,19493,10601,8892,22410091.0,12070157.0,10339934.0,144,83,61,17206,9208,7998,19743019.0,10423244.0,9319774.0,113.86,116.28,113.2,116.53
2023-09-18 10:20,680,378,302,54731,28629,26102,63327382.0,32768077.0,30559304.0,467,275,192,44961,24397,20564,51826134.0,27779858.0,24046276.0,114.46,117.08,113.87,116.93
2023-09-18 10:25,401,208,193,32379,14931,17448,37420596.0,16993513.0,20427082.0,274,144,130,27584,13204,14380,31741667.0,14979370.0,16762296.0,113.81,117.07,113.45,116.57
2023-09-18 10:30,238,92,146,20904,8647,12257,25689814.0,10855240.0,14834574.0,165,67,98,17433,8257,9176,20080108.0,9369403.0,10710705.0,125.54,121.03,113.47,116.73
2023-09-18 10:35,6094,114,5980,186058,13150,172908,214136054.0,14928665.0,199207388.0,6028,88,5940,184683,12726,171957,212634521.0,14435546.0,198198975.0,113.53,115.21,113.43,115.26
2023-09-18 10:40,7054,331,6723,200692,27165,173527,231268657.0,31001636.0,200267021.0,6911,261,6650,197304,25507,171797,227293308.0,29063623.0,198229685.0,114.12,115.41,113.94,115.39
2023-09-18 10:45,446,181,265,34467,15710,18757,39629396.0,17837199.0,21792196.0,341,142,199,31551,15027,16524,36356098.0,17080884.0,19275213.0,113.54,116.18,113.67,116.65
2023-09-18 10:50,232,115,117,17689,8804,8885,20311124.0,9999558.0,10311566.0,173,80,93,16566,7730,8836,19024105.0,8753163.0,10270942.0,113.58,116.06,113.24,116.24
2023-09-18 10:55,382,219,163,32194,17756,14438,37079478.0,20232229.0,16847248.0,290,169,121,29616,15730,13886,34148158.0,17902964.0,16245194.0,113.95,116.69,113.81,116.99
2023-09-18 11:00,3236,1878,1358,221370,129378,91992,264481316.0,152949977.0,111531338.0,1972,1166,806,170934,99265,71669,201760458.0,115270248.0,86490210.0,118.22,121.24,116.12,120.68
2023-09-18 11:05,1330,688,642,101069,49142,51927,119348549.0,57474931.0,61873617.0,872,457,415,88584,47490,41094,105397419.0,55262955.0,50134463.0,116.96,119.16,116.37,122.0
2023-09-18 11:10,12764,433,12331,390338,30407,359931,459089894.0,35497979.0,423591914.0,12528,328,12200,382958,29417,353541,450161645.0,34092520.0,416069124.0,116.74,117.69,115.89,117.69
2023-09-18 11:15,517,312,205,39221,23882,15339,46182569.0,27948038.0,18234531.0,368,232,136,36375,22410,13965,42678785.0,26036770.0,16642014.0,117.03,118.88,116.18,119.17
2023-09-18 11:20,963,520,443,66767,33281,33486,77716005.0,38557046.0,39158959.0,710,390,320,60163,30034,30129,70479111.0,34702209.0,35776902.0,115.85,116.94,115.54,118.75
2023-09-18 11:25,653,290,363,47054,22684,24370,54835529.0,26150593.0,28684936.0,523,223,300,46521,22075,24446,54262037.0,25419507.0,28842529.0,115.28,117.71,115.15,117.98
2023-09-18 11:30,347,167,180,26797,13169,13628,32690476.0,15159408.0,17531067.0,290,144,146,27391,13237,14154,31999027.0,15215370.0,16783657.0,115.11,128.64,114.95,118.58
2023-09-18 11:35,215,129,86,12090,6865,5225,13968453.0,7920072.0,6048380.0,120,75,45,10716,6215,4501,12515409.0,7148528.0,5366881.0,115.37,115.76,115.02,119.24
2023-09-18 11:40,186,129,57,10435,6950,3485,12185932.0,8063542.0,4122389.0,130,95,35,9373,6167,3206,10911815.0,7115726.0,3796089.0,116.02,118.29,115.38,118.41
2023-09-18 11:45,201,119,82,14903,8938,5965,17321164.0,10348029.0,6973135.0,171,108,63,14268,8657,5611,16626580.0,9985600.0,6640979.0,115.78,116.9,115.35,118.36
2023-09-18 11:50,377,219,158,28643,15414,13229,33367649.0,17768363.0,15599285.0,302,184,118,27604,14962,12642,32118476.0,17196490.0,14921986.0,115.27,117.92,114.93,118.04
2023-09-18 11:55,338,210,128,26083,15087,10996,30385675.0,17394396.0,12991279.0,308,212,96,25028,14477,10551,29128852.0,16669104.0,12459747.0,115.29,118.15,115.14,118.09
2023-09-18 12:00,275,180,95,20131,11607,8524,23428313.0,13384132.0,10044181.0,239,167,72,18783,11575,7208,21846743.0,13330716.0,8516026.0,115.31,117.83,115.17,118.15
2023-09-18 12:05,170,100,70,13081,6684,6397,15149131.0,7668036.0,7481095.0,135,85,50,12619,6876,5743,16135796.0,7877223.0,8258573.0,114.72,116.95,114.56,143.8
2023-09-18 12:10,532,290,242,39971,19364,20607,46272327.0,22132575.0,24139751.0,396,208,188,37531,18405,19126,43433913.0,21002781.0,22431132.0,114.3,117.14,114.11,117.28
2023-09-18 12:15,267,129,138,21606,10691,10915,25041160.0,12242260.0,12798899.0,209,102,107,20805,10284,10521,24099411.0,11742220.0,12357190.0,114.51,117.26,114.18,117.45
2023-09-18 12:20,216,130,86,18932,10365,8567,21970647.0,11920530.0,10050117.0,156,88,68,17308,8989,8319,20066687.0,10283851.0,9782836.0,115.01,117.31,114.4,117.6
2023-09-18 12:25,363,171,192,29907,14865,15042,34695995.0,17064197.0,17631797.0,307,153,154,29463,15421,14042,34234347.0,17697739.0,16536608.0,114.79,117.22,114.76,117.77
2023-09-18 12:30,350,132,218,35286,15169,20117,41771349.0,17578406.0,24192942.0,295,104,191,30665,13539,17126,35722996.0,15507769.0,20215226.0,115.88,120.26,114.54,118.04
2023-09-18 12:35,280,131,149,21456,11251,10205,24876288.0,12889755.0,11986532.0,222,110,112,22543,10608,11935,26706253.0,12140460.0,14565792.0,114.57,117.46,114.45,122.04
2023-09-18 12:40,287,90,197,18720,8901,9819,21720537.0,10175482.0,11545055.0,244,70,174,18106,8669,9437,20997663.0,9906188.0,11091475.0,114.32,117.58,114.27,117.53
2023-09-18 12:45,236,73,163,13790,6409,7381,15977363.0,7320017.0,8657346.0,193,50,143,12558,6062,6496,14568524.0,6933688.0,7634836.0,114.21,117.29,114.38,117.53
2023-09-18 12:50,309,94,215,23072,11050,12022,26770593.0,12661859.0,14108734.0,258,74,184,21867,10292,11575,25375211.0,11763035.0,13612176.0,114.59,117.36,114.29,117.6
2023-09-18 12:55,914,696,218,36761,28996,7765,43685385.0,34556655.0,9128730.0,749,621,128,31011,24790,6221,36091267.0,28760346.0,7330921.0,119.18,117.56,116.02,117.84
2023-09-18 13:00,634,414,220,45372,27319,18053,52916061.0,31594997.0,21321064.0,561,404,157,43425,27035,16390,50670320.0,31268542.0,19401778.0,115.65,118.1,115.66,118.38
2023-09-18 13:05,541,267,274,45564,21256,24308,52629455.0,24338483.0,28290972.0,436,222,214,43190,21133,22057,50100646.0,24165261.0,25935384.0,114.5,116.39,114.35,117.58
2023-09-18 13:10,233,96,137,16349,7535,8814,18956366.0,8620652.0,10335713.0,187,66,121,15887,7281,8606,18428450.0,8320083.0,10108367.0,114.41,117.26,114.27,117.46
2023-09-18 13:15,346,96,250,23274,9628,13646,27016606.0,11022658.0,15993948.0,313,76,237,22850,9398,13452,26524646.0,10743284.0,15781361.0,114.49,117.21,114.31,117.32
2023-09-18 13:20,131,68,63,10614,5337,5277,12337362.0,6130268.0,6207094.0,95,48,47,10790,5100,5690,12542337.0,5836439.0,6705898.0,114.86,117.63,114.44,117.85
2023-09-18 13:25,84,39,45,7018,3318,3700,8133279.0,3793420.0,4339858.0,67,36,31,6935,3363,3572,8046581.0,3844923.0,4201657.0,114.33,117.29,114.33,117.63
2023-09-18 13:30,129,52,77,11088,5103,5985,12827372.0,5824139.0,7003233.0,110,46,64,11168,5433,5735,12943994.0,6204463.0,6739530.0,114.13,117.01,114.2,117.52
2023-09-18 13:35,157,90,67,13635,7016,6619,15772272.0,8025846.0,7746426.0,112,55,57,11987,5853,6134,13880162.0,6677189.0,7202973.0,114.39,117.03,114.08,117.43
2023-09-18 13:40,83,50,33,5332,2851,2481,6206752.0,3292320.0,2914431.0,61,30,31,5022,2528,2494,5827332.0,2892408.0,2934924.0,115.48,117.47,114.41,117.68
2023-09-18 13:45,112,66,46,7401,3912,3489,8592632.0,4486078.0,4106554.0,89,56,33,7936,3803,4133,9238082.0,4364500.0,4873582.0,114.67,117.7,114.76,117.92
2023-09-18 13:50,70,31,39,4797,2145,2652,5557768.0,2455265.0,3102502.0,46,22,24,4228,2102,2126,4905381.0,2404680.0,2500700.0,114.46,116.99,114.4,117.62
2023-09-18 13:55,228,164,64,16941,9790,7151,19769193.0,11340339.0,8428854.0,195,140,55,16469,9278,7191,19140587.0,10652639.0,8487947.0,115.84,117.87,114.82,118.04
2023-09-18 14:00,200,129,71,17072,8863,8209,19997319.0,10313946.0,9683373.0,164,110,54,14288,7655,6633,16626893.0,8798562.0,7828330.0,116.37,117.96,114.94,118.02
2023-09-18 14:05,145,95,50,10858,6128,4730,12655116.0,7069367.0,5585749.0,128,90,38,10976,5716,5260,12805621.0,6586387.0,6219234.0,115.36,118.09,115.23,118.24
2023-09-18 14:10,484,316,168,31978,17946,14032,36398617.0,20667206.0,15731410.0,382,258,124,28213,16819,11394,32749000.0,19341044.0,13407955.0,115.16,112.11,115.0,117.68
2023-09-18 14:15,1149,974,175,58250,42483,15767,67424367.0,48939793.0,18484574.0,1109,958,151,57678,42955,14723,66743266.0,49481220.0,17262045.0,115.2,117.24,115.19,117.25
2023-09-18 14:20,938,761,177,66987,42170,24817,77588554.0,48435626.0,29152927.0,911,751,160,66932,42451,24481,77537715.0,48760967.0,28776747.0,114.86,117.47,114.86,117.55
2023-09-18 14:25,309,90,219,25167,10386,14781,29087915.0,11843303.0,17244612.0,267,76,191,24233,10077,14156,28039115.0,11475226.0,16563888.0,114.03,116.67,113.88,117.01
2023-09-18 14:30,377,173,204,32831,15430,17401,37739603.0,17506105.0,20233498.0,287,131,156,30664,14732,15932,35346038.0,16724727.0,18621310.0,113.45,116.28,113.53,116.88
2023-09-18 14:35,258,137,121,18376,8878,9498,21186915.0,10107688.0,11079226.0,165,82,83,18304,8428,9876,21108606.0,9574040.0,11534565.0,113.85,116.65,113.6,116.79
2023-09-18 14:40,130,66,64,8610,4167,4443,9898057.0,4744921.0,5153135.0,109,56,53,8128,4003,4125,9369764.0,4550109.0,4819655.0,113.87,115.98,113.67,116.84
2023-09-18 14:45,261,116,145,18329,8282,10047,20988235.0,9397835.0,11590400.0,208,87,121,17142,7749,9393,19694613.0,8774702.0,10919911.0,113.47,115.36,113.24,116.26
2023-09-18 14:50,295,201,94,21573,11630,9943,24832258.0,13264986.0,11567271.0,244,169,75,20613,11181,9432,23685899.0,12691838.0,10994061.0,114.06,116.34,113.51,116.56
2023-09-18 14:55,182,125,57,10577,5227,5350,12180628.0,5943452.0,6237176.0,169,116,53,10262,5176,5086,11812485.0,5878371.0,5934113.0,113.71,116.58,113.57,116.68
2023-09-18 15:00,109,49,60,7584,3282,4302,8689099.0,3720802.0,4968297.0,104,56,48,7164,3353,3811,8244416.0,3805418.0,4438997.0,113.37,115.49,113.49,116.48
2023-09-18 15:05,234,128,106,19009,9524,9485,22698121.0,11807330.0,10890791.0,171,90,81,17434,8648,8786,19984382.0,9786762.0,10197620.0,123.97,114.82,113.17,116.07
2023-09-18 15:10,204,98,106,19635,9180,10455,22281345.0,10403031.0,11878313.0,170,79,91,17889,8739,9150,20462063.0,9852509.0,10609554.0,113.32,113.61,112.74,115.95
2023-09-18 15:15,160,77,83,14364,7048,7316,16362051.0,7948126.0,8413924.0,135,66,69,14560,7312,7248,16634517.0,8224847.0,8409669.0,112.77,115.01,112.48,116.03
2023-09-18 15:20,378,183,195,31272,14470,16802,35606376.0,16297291.0,19309085.0,279,119,160,28965,13377,15588,33029395.0,15014583.0,18014811.0,112.63,114.92,112.24,115.57
2023-09-18 15:25,176,100,76,14751,7599,7152,16826808.0,8572977.0,8253831.0,131,66,65,13122,6352,6770,14972785.0,7143356.0,7829429.0,112.82,115.41,112.46,115.65
2023-09-18 15:30,579,308,271,39022,20811,18211,47232600.0,23945854.0,23286745.0,521,277,244,36696,19219,17477,43262863.0,21872481.0,21390382.0,115.06,127.87,113.81,122.39
2023-09-18 15:35,576,105,471,37023,9735,27288,42720363.0,11059239.0,31661123.0,548,94,454,37124,9586,27538,42848242.0,10886636.0,31961606.0,113.6,116.03,113.57,116.06
2023-09-18 15:40,160,72,88,15970,7912,8058,18350913.0,8965984.0,9384929.0,134,59,75,15599,7651,7948,17938079.0,8667476.0,9270602.0,113.32,116.47,113.29,116.64
2023-09-18 15:45,104,58,46,7948,4385,3563,9100774.0,4967139.0,4133634.0,84,47,37,7866,4401,3465,9021164.0,4991084.0,4030079.0,113.28,116.02,113.41,116.31
2023-09-18 15:50,105,58,47,7566,3954,3612,8722512.0,4540614.0,4181897.0,75,35,40,7058,3790,3268,8073272.0,4266350.0,3806921.0,114.84,115.78,112.57,116.49
2023-09-18 15:55,161,90,71,12669,6303,6366,14537515.0,7153449.0,7384066.0,139,82,57,11842,6261,5581,13591766.0,7088167.0,6503599.0,113.49,115.99,113.21,116.53
2023-09-18 16:00,115,66,49,6731,3562,3169,7716314.0,4039594.0,3676719.0,97,57,40,5902,3497,2405,6749470.0,3961370.0,2788099.0,113.41,116.02,113.28,115.93
2023-09-18 16:05,185,81,104,21209,10190,11019,24244023.0,11492033.0,12751989.0,164,67,97,21284,10196,11088,24368192.0,11501355.0,12866836.0,112.78,115.73,112.8,116.04
2023-09-18 16:10,107,52,55,8613,4065,4548,9847611.0,4586940.0,5260670.0,101,46,55,8535,4062,4473,9776327.0,4583192.0,5193135.0,112.84,115.67,112.83,116.1
2023-09-18 16:15,164,58,106,16780,7742,9038,19152498.0,8718408.0,10434090.0,151,60,91,17196,7852,9344,19674723.0,8845182.0,10829541.0,112.61,115.45,112.65,115.9
2023-09-18 16:20,199,84,115,16247,7874,8373,18484056.0,8835356.0,9648700.0,143,56,87,14277,6544,7733,16258530.0,7338103.0,8920427.0,112.21,115.24,112.13,115.36
2023-09-18 16:25,65,39,26,4873,2526,2347,6586287.0,3871382.0,2714905.0,38,24,14,4640,2424,2216,5288757.0,2724295.0,2564461.0,153.26,115.68,112.39,115.72
2023-09-18 16:30,54,24,30,3752,1882,1870,4273183.0,2119039.0,2154143.0,44,24,20,3591,1792,1799,4097141.0,2015589.0,2081552.0,112.6,115.19,112.48,115.71
2023-09-18 16:35,42,24,18,2407,1303,1104,2755127.0,1471667.0,1283460.0,43,23,20,2713,1442,1271,4139386.0,2644243.0,1495143.0,112.94,116.26,183.37,117.64
2023-09-18 16:40,65,30,35,6497,2563,3934,7435438.0,2889491.0,4545947.0,61,30,31,6063,2494,3569,6935588.0,2807002.0,4128586.0,112.74,115.56,112.55,115.68
2023-09-18 16:45,124,44,80,10348,4639,5709,11797551.0,5206612.0,6590938.0,102,33,69,10571,4512,6059,12064525.0,5070955.0,6993570.0,112.24,115.45,112.39,115.42
2023-09-18 16:50,92,45,47,7340,3236,4104,8292273.0,3634055.0,4658217.0,77,28,49,6642,3082,3560,7589437.0,3460450.0,4128986.0,112.3,113.5,112.28,115.98
2023-09-18 16:55,66,43,23,7696,6655,1041,8429842.0,7233791.0,1196051.0,36,14,22,7929,6790,1139,8627897.0,7314368.0,1313529.0,108.7,114.89,107.72,115.32
2023-09-18 17:00,87,52,35,5738,2880,2858,6541736.0,3238240.0,3303496.0,62,32,30,5633,2752,2881,6418712.0,3089540.0,3329171.0,112.44,115.59,112.27,115.56
2023-09-18 17:05,115,54,61,9422,4505,4917,10749881.0,5069164.0,5680717.0,86,39,47,8803,4213,4590,10040518.0,4733886.0,5306632.0,112.52,115.53,112.36,115.61
2023-09-18 17:10,59,27,32,3512,1600,1912,4015764.0,1803920.0,2211844.0,50,22,28,3275,1475,1800,3746462.0,1661857.0,2084604.0,112.75,115.68,112.67,115.81
2023-09-18 17:15,120,50,70,9415,4085,5330,10694774.0,4584935.0,6109839.0,108,42,66,9716,4238,5478,11083577.0,4761017.0,6322559.0,112.24,114.63,112.34,115.42
2023-09-18 17:20,417,290,127,26927,18565,8362,30988299.0,21280521.0,9707778.0,371,260,111,25107,17266,7841,28714501.0,19609690.0,9104810.0,114.63,116.09,113.57,116.12
2023-09-18 17:25,700,198,502,50161,18862,31299,56968140.0,21196517.0,35771622.0,631,163,468,48009,18367,29642,54749648.0,20634525.0,34115122.0,112.38,114.29,112.35,115.09
2023-09-18 17:30,126,33,93,10522,4977,5545,11983431.0,5593152.0,6390278.0,119,32,87,9687,4286,5401,11034762.0,4806608.0,6228154.0,112.38,115.24,112.15,115.31
2023-09-18 17:35,327,12,315,8483,159,8324,9716788.0,180457.0,9536331.0,326,9,317,8589,226,8363,9839757.0,256501.0,9583256.0,113.49,114.56,113.5,114.59
2023-09-18 17:40,106,33,73,7519,3807,3712,8482093.0,4204499.0,4277594.0,87,21,66,6447,2756,3691,7351009.0,3094450.0,4256559.0,110.44,115.24,112.28,115.32
2023-09-18 17:45,53,19,34,4396,1921,2475,5010768.0,2157892.0,2852875.0,47,14,33,4605,2029,2576,5249806.0,2278239.0,2971567.0,112.33,115.27,112.28,115.36
2023-09-18 17:50,213,54,159,20049,7637,12412,22839085.0,8567285.0,14271799.0,197,47,150,18798,7379,11419,21416525.0,8275054.0,13141471.0,112.18,114.98,112.14,115.08
2023-09-18 17:55,133,40,93,10325,4152,6173,11759111.0,4656554.0,7102556.0,112,28,84,10383,4073,6310,11823977.0,4564980.0,7258997.0,112.15,115.06,112.08,115.04
2023-09-18 18:00,130,36,94,7172,2425,4747,8152372.0,2726187.0,5426184.0,101,21,80,6690,2152,4538,7639477.0,2412308.0,5227169.0,112.42,114.31,112.1,115.19
2023-09-18 18:05,273,140,133,25735,12938,12797,29341173.0,14565812.0,14775360.0,248,131,117,25461,12683,12778,28987765.0,14236432.0,14751333.0,112.58,115.46,112.25,115.44
2023-09-18 18:10,210,87,123,17623,8705,8918,20089028.0,9787465.0,10301563.0,187,78,109,17467,8574,8893,19910970.0,9637784.0,10273186.0,112.43,115.51,112.41,115.52
2023-09-18 18:15,146,45,101,13363,6013,7350,15217607.0,6746497.0,8471109.0,152,46,106,13418,6019,7399,15281267.0,6751167.0,8530100.0,112.2,115.25,112.16,115.29
2023-09-18 18:20,262,88,174,23840,11049,12791,27086094.0,12400026.0,14686068.0,235,79,156,23798,10992,12806,27123655.0,12323792.0,14799863.0,112.23,114.82,112.12,115.57
2023-09-18 18:25,326,102,224,27463,12158,15305,31266223.0,13647833.0,17618390.0,299,85,214,26579,12050,14529,30270697.0,13524351.0,16746346.0,112.25,115.12,112.24,115.26
2023-09-18 18:30,188,63,125,13949,5563,8386,15681674.0,6223134.0,9458540.0,135,42,93,11893,5050,6843,13504152.0,5644456.0,7859696.0,111.87,112.79,111.77,114.86
2023-09-18 18:35,177,50,127,7280,2536,4744,9164459.0,2859886.0,6304573.0,140,32,108,4849,1241,3608,6567237.0,1389124.0,5178112.0,112.77,132.9,111.94,143.52
2023-09-19 10:00,1843,744,1099,51480,23652,27828,58560221.0,25651940.0,32908280.0,556,365,191,19217,10866,8351,21535119.0,12060047.0,9475072.0,108.46,118.26,110.99,113.46
2023-09-19 10:05,346,161,185,9677,4636,5041,11931739.0,6355191.0,5576548.0,150,37,113,4251,1338,2913,4761853.0,1484262.0,3277591.0,137.08,110.62,110.93,112.52
2023-09-19 10:10,446,281,165,10625,6143,4482,11858691.0,6812659.0,5046032.0,166,79,87,7675,4269,3406,8565864.0,4733438.0,3832426.0,110.9,112.58,110.88,112.52
2023-09-19 10:15,213,115,98,11386,6141,5245,12809381.0,6825889.0,5983492.0,103,54,49,9083,4240,4843,10261728.0,4712651.0,5549077.0,111.15,114.08,111.15,114.58
2023-09-19 10:20,122,67,55,6707,3612,3095,7571267.0,4021335.0,3549932.0,77,48,29,6337,3741,2596,7126427.0,4163889.0,2962538.0,111.33,114.7,111.3,114.12
2023-09-19 10:25,119,64,55,10892,5010,5882,12584513.0,5587884.0,6996629.0,68,35,33,8511,4345,4166,9577659.0,4815605.0,4762054.0,111.53,118.95,110.83,114.31
2023-09-19 10:30,401,192,209,31148,16226,14922,35608100.0,18317888.0,17290211.0,249,142,107,27801,14677,13124,31579481.0,16444387.0,15135094.0,112.89,115.87,112.04,115.32
2023-09-19 10:35,204,102,102,16444,7505,8939,18715788.0,8429452.0,10286336.0,140,61,79,14362,7093,7269,16352110.0,7955615.0,8396495.0,112.32,115.07,112.16,115.51
2023-09-19 10:40,195,68,127,16430,7627,8803,18534664.0,8534650.0,10000014.0,150,59,91,15937,7721,8216,18097876.0,8640741.0,9457135.0,111.9,113.6,111.91,115.11
2023-09-19 10:45,288,194,94,26388,12866,13522,30729966.0,14478252.0,16251713.0,247,171,76,21963,11987,9976,24891010.0,13415516.0,11475494.0,112.53,120.19,111.92,115.03
2023-09-19 10:50,249,125,124,24171,12060,12111,27407643.0,13504540.0,13903103.0,202,102,100,23883,12126,11757,27113014.0,13560639.0,13552374.0,111.98,114.8,111.83,115.27
2023-09-19 10:55,140,59,81,12424,5786,6638,14113084.0,6450800.0,7662284.0,100,43,57,11083,5342,5741,12539244.0,5954466.0,6584777.0,111.49,115.43,111.47,114.7
2023-09-19 11:00,202,65,137,15795,7047,8748,17733862.0,7810909.0,9922953.0,178,55,123,15200,7069,8131,17130552.0,7851141.0,9279410.0,110.84,113.43,111.06,114.12
2023-09-19 11:05,674,228,446,23063,10208,12855,26342258.0,11699958.0,14642300.0,593,194,399,20070,8169,11901,22741672.0,9158212.0,13583460.0,114.62,113.9,112.11,114.14
2023-09-19 11:10,143,81,62,5205,3068,2137,5886115.0,3429791.0,2456324.0,100,61,39,3613,2518,1095,4079580.0,2823182.0,1256398.0,111.79,114.94,112.12,114.74
2023-09-19 11:15,539,193,346,29065,13141,15924,32683374.0,14627805.0,18055568.0,500,181,319,27470,12358,15112,31070119.0,13802241.0,17267878.0,111.31,113.39,111.69,114.27
2023-09-19 11:20,253,85,168,20205,8106,12099,22702152.0,8965005.0,13737147.0,187,60,127,17176,7751,9425,19317654.0,8590629.0,10727024.0,110.6,113.54,110.83,113.81
2023-09-19 11:25,237,92,145,18532,7910,10622,20560397.0,8701117.0,11859280.0,177,66,111,16845,7536,9309,18805563.0,8280148.0,10525415.0,110.0,111.65,109.87,113.07
2023-09-19 11:30,410,158,252,29208,14159,15049,32605770.0,15646718.0,16959052.0,318,96,222,24614,10951,13663,27475728.0,12056212.0,15419515.0,110.51,112.69,110.09,112.86
2023-09-19 11:35,125,63,62,9535,4674,4861,10714308.0,5202547.0,5511761.0,77,35,42,8925,4326,4599,9991117.0,4770837.0,5220280.0,111.31,113.39,110.28,113.51
2023-09-19 11:40,4494,804,3690,104854,57589,47265,118083495.0,64364633.0,53718861.0,4447,775,3672,103028,56745,46283,115972484.0,63367920.0,52604564.0,111.77,113.65,111.67,113.66
2023-09-19 11:45,337,247,90,27343,16972,10371,30776356.0,18915544.0,11860811.0,319,247,72,26706,17046,9660,30019255.0,18988377.0,11030878.0,111.45,114.37,111.39,114.19
2023-09-19 11:50,139,77,62,12613,6569,6044,14126099.0,7261173.0,6864925.0,123,68,55,12580,6536,6044,14109579.0,7229022.0,6880557.0,110.54,113.58,110.6,113.84
2023-09-19 11:55,285,130,155,28222,12386,15836,31487905.0,13620539.0,17867366.0,227,97,130,26313,11551,14762,29344576.0,12704628.0,16639947.0,109.97,112.83,109.99,112.72
2023-09-19 12:00,205,87,118,17330,7815,9515,19337324.0,8597162.0,10740161.0,177,66,111,17037,7569,9468,19025145.0,8323853.0,10701291.0,110.01,112.88,109.97,113.03
2023-09-19 12:05,148,60,88,13783,6067,7716,15384733.0,6670281.0,8714451.0,135,50,85,13570,6066,7504,15134237.0,6660164.0,8474072.0,109.94,112.94,109.79,112.93
2023-09-19 12:10,1111,840,271,85485,54499,30986,95975345.0,60742123.0,35233222.0,1019,775,244,81225,53042,28183,91202069.0,59106502.0,32095566.0,111.46,113.71,111.43,113.88
2023-09-19 12:15,463,417,46,21119,15644,5475,23723611.0,17416597.0,6307014.0,452,416,36,19900,15984,3916,22350792.0,17851024.0,4499768.0,111.33,115.2,111.68,114.91
2023-09-19 12:20,843,782,61,48055,41747,6308,54118160.0,46917072.0,7201088.0,795,755,40,46598,41170,5428,52382392.0,46160644.0,6221748.0,112.38,114.16,112.12,114.62
2023-09-19 12:25,637,375,262,44784,26575,18209,49879172.0,29468808.0,20410364.0,529,326,203,42193,25428,16765,47197381.0,28220466.0,18976915.0,110.89,112.09,110.98,113.19
2023-09-19 12:30,273,156,117,22063,11448,10615,24680780.0,12659935.0,12020845.0,212,108,104,21132,10822,10310,23598290.0,11922967.0,11675323.0,110.59,113.24,110.17,113.24
2023-09-19 12:35,426,109,317,30137,13610,16527,33654232.0,15012413.0,18641819.0,403,98,305,29927,13723,16204,33485611.0,15125117.0,18360493.0,110.3,112.8,110.22,113.31
2023-09-19 12:40,222,78,144,15644,6426,9218,17445023.0,7110242.0,10334780.0,205,69,136,15187,6506,8681,17006170.0,7167618.0,9838552.0,110.65,112.12,110.17,113.33
2023-09-19 12:45,507,259,248,39973,19598,20375,43779540.0,21271137.0,22508403.0,415,207,208,36897,17752,19145,40914591.0,19379203.0,21535387.0,108.54,110.47,109.17,112.49
2023-09-19 12:50,420,130,290,29883,12057,17826,32469754.0,13129420.0,19340334.0,340,95,245,27650,11833,15817,30550716.0,12890220.0,17660495.0,108.89,108.5,108.93,111.66
2023-09-19 12:55,381,155,226,30838,14260,16578,33934200.0,15506781.0,18427419.0,292,101,191,28960,13210,15750,31923574.0,14344206.0,17579368.0,108.74,111.16,108.59,111.62
2023-09-19 13:00,376,81,295,20509,7249,13260,22519833.0,7865823.0,14654010.0,336,54,282,19758,7125,12633,21788095.0,7719358.0,14068736.0,108.51,110.51,108.34,111.36
2023-09-19 13:05,227,66,161,12571,5069,7502,13844217.0,5499967.0,8344250.0,188,35,153,11493,3853,7640,12723379.0,4186065.0,8537313.0,108.5,111.23,108.64,111.74
2023-09-19 13:10,195,62,133,13670,5470,8200,15018452.0,5934571.0,9083881.0,152,38,114,12749,5088,7661,14067824.0,5524061.0,8543762.0,108.49,110.78,108.57,111.52
2023-09-19 13:15,283,122,161,28729,13533,15196,31512209.0,14711856.0,16800353.0,242,94,148,29856,13379,16477,32963509.0,14519361.0,18444147.0,108.71,110.56,108.52,111.94
2023-09-19 13:20,10976,10812,164,292719,275092,17627,322279991.0,302778221.0,19501769.0,10892,10748,144,290881,274236,16645,320426880.0,301809397.0,18617482.0,110.06,110.64,110.05,111.85
2023-09-19 13:25,130,81,49,7872,4081,3791,8732502.0,4475810.0,4256691.0,84,54,30,7334,3560,3774,8125526.0,3890043.0,4235483.0,109.67,112.28,109.27,112.23
2023-09-19 13:30,143,76,67,13498,6752,6746,15009917.0,7402571.0,7607346.0,113,59,54,13504,6635,6869,15008017.0,7264045.0,7743972.0,109.64,112.77,109.48,112.74
2023-09-19 13:35,7484,7368,116,216637,205497,11140,239192653.0,226771302.0,12421351.0,7441,7335,106,215885,205358,10527,238429442.0,226614441.0,11815001.0,110.35,111.5,110.35,112.24
2023-09-19 13:40,323,258,65,20649,12616,8033,22873729.0,13859498.0,9014230.0,292,235,57,19831,12016,7815,21990054.0,13181269.0,8808785.0,109.86,112.21,109.7,112.72
2023-09-19 13:45,227,141,86,17099,9437,7662,18979706.0,10367417.0,8612288.0,206,130,76,15776,8196,7580,17507661.0,8982683.0,8524978.0,109.86,112.4,109.6,112.47
2023-09-19 13:50,620,492,128,29632,19638,9994,32830322.0,21611794.0,11218528.0,596,471,125,29972,19986,9986,33214726.0,22005846.0,11208880.0,110.05,112.25,110.11,112.25
2023-09-19 13:55,291,275,16,9180,8540,640,10179616.0,9454051.0,725565.0,270,262,8,8882,8392,490,9847202.0,9295443.0,551758.0,110.7,113.37,110.77,112.6
2023-09-19 14:00,895,876,19,35271,33601,1670,39103482.0,37220522.0,1882960.0,882,865,17,34759,33301,1458,38536454.0,36890194.0,1646260.0,110.77,112.75,110.78,112.91
2023-09-19 14:05,274,245,29,12596,10293,2303,13972090.0,11377055.0,2595034.0,264,238,26,12471,10288,2183,13825405.0,11365867.0,2459537.0,110.53,112.68,110.48,112.67
2023-09-19 14:10,115,88,27,6128,4394,1734,6805073.0,4850729.0,1954343.0,104,85,19,5816,4293,1523,6462520.0,4738458.0,1724061.0,110.39,112.71,110.38,113.2
2023-09-19 14:15,566,504,62,38184,28856,9328,42331816.0,31825346.0,10506469.0,558,501,57,38125,28844,9281,42277795.0,31813341.0,10464454.0,110.29,112.63,110.29,112.75
2023-09-19 14:20,975,911,64,43576,38889,4687,48250258.0,42973616.0,5276641.0,961,902,59,43406,38656,4750,48092108.0,42741297.0,5350811.0,110.5,112.58,110.57,112.65
2023-09-19 14:25,525,436,89,27452,21481,5971,30430312.0,23707947.0,6722365.0,505,426,79,27140,21475,5665,30072930.0,23702116.0,6370813.0,110.37,112.58,110.37,112.46
2023-09-19 14:30,672,572,100,33796,25053,8743,37382471.0,27566565.0,9815906.0,661,564,97,33137,24590,8547,36673862.0,27074601.0,9599261.0,110.03,112.27,110.1,112.31
2023-09-19 14:35,915,349,566,52643,20641,32002,58365981.0,22636763.0,35729218.0,878,327,551,51767,20070,31697,57403447.0,22011571.0,35391876.0,109.67,111.65,109.67,111.66
2023-09-19 14:40,1037,507,530,57984,30346,27638,64340511.0,33513335.0,30827175.0,999,486,513,57312,29887,27425,63565999.0,32955834.0,30610165.0,110.44,111.54,110.27,111.61
2023-09-19 14:45,390,52,338,26135,6111,20024,29010363.0,6675361.0,22335001.0,379,44,335,25831,5922,19909,28668469.0,6466372.0,22202096.0,109.24,111.54,109.19,111.52
2023-09-19 14:50,465,58,407,27988,4817,23171,31081516.0,5267082.0,25814433.0,445,47,398,27878,4796,23082,30955722.0,5237553.0,25718169.0,109.34,111.41,109.21,111.42
2023-09-19 14:55,262,82,180,17608,7049,10559,19544431.0,7744147.0,11800284.0,248,77,171,17383,6883,10500,19298532.0,7550239.0,11748293.0,109.86,111.76,109.69,111.89
2023-09-19 15:00,175,85,90,14478,6949,7529,16729739.0,8238431.0,8491307.0,161,81,80,13345,7145,6200,16014659.0,9058985.0,6955673.0,118.56,112.78,126.79,112.19
2023-09-19 15:05,59,25,34,3174,1644,1530,4134790.0,2418025.0,1716764.0,48,18,30,2746,1277,1469,3043460.0,1394253.0,1649207.0,147.08,112.21,109.18,112.27
2023-09-19 15:10,86,36,50,7773,3555,4218,8626840.0,3911619.0,4715221.0,71,25,46,7354,3405,3949,8145627.0,3717591.0,4428035.0,110.03,111.79,109.18,112.13
2023-09-19 15:15,186,88,98,16848,7876,8972,18509621.0,8562966.0,9946655.0,134,62,72,15885,7733,8152,17547929.0,8411981.0,9135947.0,108.72,110.86,108.78,112.07
2023-09-19 15:20,161,54,107,12724,5376,7348,13905856.0,5831138.0,8074718.0,128,40,88,11679,5317,6362,12857233.0,5760130.0,7097103.0,108.47,109.89,108.33,111.55
2023-09-19 15:25,115,62,53,6804,3564,3240,7406259.0,3827333.0,3578926.0,80,41,39,6108,3055,3053,6703055.0,3305691.0,3397363.0,107.39,110.46,108.21,111.28
2023-09-19 15:30,10320,10123,197,92694,75260,17434,100423663.0,81598607.0,18825055.0,10193,10053,140,84071,69575,14496,92093330.0,76001408.0,16091922.0,108.42,107.98,109.24,111.01
2023-09-19 15:35,341,142,199,29251,13684,15567,31795976.0,14663752.0,17132224.0,260,91,169,26862,12460,14402,29309067.0,13386206.0,15922860.0,107.16,110.05,107.43,110.56
2023-09-19 15:40,143,85,58,10775,6024,4751,11774098.0,6530384.0,5243714.0,95,46,49,10140,5316,4824,11087681.0,5736244.0,5351437.0,108.41,110.37,107.91,110.93
2023-09-19 15:45,61,44,17,2461,1344,1117,2681552.0,1458228.0,1223323.0,37,24,13,2256,1138,1118,2464923.0,1224343.0,1240579.0,108.5,109.52,107.59,110.96
2023-09-19 15:50,233,87,146,19185,8046,11139,20453427.0,8691619.0,11761808.0,146,63,83,14919,7363,7556,16194478.0,7880224.0,8314253.0,108.02,105.59,107.02,110.04
2023-09-19 15:55,165,76,89,15275,7564,7711,16481799.0,8081388.0,8400411.0,124,54,70,14273,7010,7263,15465960.0,7481459.0,7984501.0,106.84,108.94,106.73,109.93
2023-09-19 16:00,231,124,107,19429,10946,8483,20981144.0,11732925.0,9248218.0,170,84,86,18404,10261,8143,19924813.0,10982985.0,8941827.0,107.19,109.02,107.04,109.81
2023-09-19 16:05,117,88,29,6800,4435,2365,7352677.0,4762008.0,2590669.0,83,61,22,6659,4257,2402,7208276.0,4565972.0,2642304.0,107.37,109.54,107.26,110.0
2023-09-19 16:10,105,59,46,7316,3752,3564,10138347.0,4050806.0,6087540.0,68,33,35,7090,3368,3722,7704200.0,3607455.0,4096744.0,107.96,170.81,107.11,110.07
2023-09-19 16:15,106,65,41,8499,4681,3818,9212766.0,5004801.0,4207965.0,76,42,34,8190,4294,3896,8882203.0,4587722.0,4294480.0,106.92,110.21,106.84,110.23
2023-09-19 16:20,126,80,46,10034,5814,4220,11586823.0,6298013.0,5288809.0,90,47,43,9267,5077,4190,10102267.0,5466617.0,4635650.0,108.32,125.33,107.67,110.64
2023-09-19 16:25,423,230,193,33437,18375,15062,36589842.0,19920365.0,16669477.0,354,180,174,31628,16818,14810,34530772.0,18138216.0,16392556.0,108.41,110.67,107.85,110.69
2023-09-19 16:30,269,82,187,17477,7500,9977,19126696.0,8098794.0,11027902.0,232,61,171,16527,6534,9993,18094037.0,7045646.0,11048391.0,107.98,110.53,107.83,110.56
2023-09-19 16:35,756,517,239,62327,38590,23737,68343994.0,41983785.0,26360208.0,722,491,231,61928,38206,23722,67897613.0,41552928.0,26344685.0,108.79,111.05,108.76,111.06
2023-09-19 16:40,198,82,116,17739,8554,9185,20040920.0,9865805.0,10175115.0,175,73,102,17976,8913,9063,19699403.0,9641854.0,10057549.0,115.34,110.78,108.18,110.97
2023-09-19 16:45,903,110,793,44632,8848,35784,48927809.0,9558444.0,39369365.0,879,90,789,43573,7521,36052,47818832.0,8131294.0,39687538.0,108.03,110.02,108.11,110.08
2023-09-19 16:50,692,579,113,46236,35698,10538,50849435.0,39056132.0,11793302.0,606,522,84,43208,33341,9867,47482564.0,36442037.0,11040526.0,109.41,111.91,109.3,111.89
2023-09-19 16:55,682,421,261,61799,37774,24025,68808040.0,41664578.0,27143462.0,506,307,199,57636,35708,21928,63739235.0,38963437.0,24775797.0,110.3,112.98,109.12,112.99
2023-09-19 17:00,959,561,398,73893,43629,30264,84183715.0,49669344.0,34514371.0,695,446,249,66175,38796,27379,74389103.0,43121638.0,31267464.0,113.84,114.04,111.15,114.2
2023-09-19 17:05,465,294,171,39848,22608,17240,44928685.0,25218654.0,19710031.0,364,246,118,36421,20637,15784,41021481.0,22960251.0,18061229.0,111.55,114.33,111.26,114.43
2023-09-19 17:10,411,235,176,30172,16187,13985,33996210.0,18063181.0,15933029.0,360,187,173,30139,16185,13954,33876172.0,17972931.0,15903240.0,111.59,113.93,111.05,113.97
2023-09-19 17:15,9502,2567,6935,453320,211538,241782,533533295.0,249158619.0,284374676.0,7588,1637,5951,345629,148485,197144,404171874.0,171167668.0,233004206.0,117.78,117.62,115.28,118.19
2023-09-19 17:20,3829,2190,1639,299824,170419,129405,354078790.0,200436038.0,153642751.0,2715,1673,1042,242215,140801,101414,285310257.0,164086543.0,121223714.0,117.61,118.73,116.54,119.53
2023-09-19 17:25,9460,1642,7818,331397,127508,203889,391273881.0,149817304.0,241456576.0,8646,1244,7402,302994,115463,187531,356708910.0,134245516.0,222463394.0,117.5,118.43,116.27,118.63
2023-09-19 17:30,2399,1371,1028,163113,83499,79614,188764958.0,96810062.0,91954895.0,1518,841,677,135601,71686,63915,158154110.0,82506934.0,75647176.0,115.94,115.5,115.09,118.36
2023-09-19 17:35,2126,753,1373,123271,56923,66348,143661274.0,65787714.0,77873560.0,1755,562,1193,112844,53319,59525,131616534.0,61340225.0,70276309.0,115.57,117.37,115.04,118.06
2023-09-19 17:40,1939,497,1442,125650,43162,82488,143764942.0,49235171.0,94529770.0,1613,312,1301,108860,35053,73807,125891780.0,39875468.0,86016312.0,114.07,114.6,113.76,116.54
2023-09-19 17:45,439,232,207,33848,16848,17000,39118226.0,19242969.0,19875257.0,343,184,159,32106,16594,15512,37047812.0,18887499.0,18160312.0,114.22,116.91,113.82,117.07
2023-09-19 17:50,18122,671,17451,738989,37180,701809,862487711.0,43498969.0,818988741.0,17783,505,17278,724798,29667,695131,845427168.0,34060928.0,811366240.0,117.0,116.7,114.81,116.72
2023-09-19 17:55,1199,576,623,54833,20277,34556,64037063.0,23632035.0,40405028.0,905,383,522,50154,19001,31153,58406068.0,21869339.0,36536728.0,116.55,116.93,115.1,117.28
2023-09-19 18:00,1291,995,296,53786,38625,15161,64473376.0,46798779.0,17674597.0,1141,923,218,48893,37257,11636,56628566.0,43061710.0,13566856.0,121.16,116.58,115.58,116.59
2023-09-19 18:05,1699,1464,235,97392,79068,18324,113633718.0,92106697.0,21527021.0,1537,1377,160,88187,74384,13803,102728380.0,86371858.0,16356521.0,116.49,117.48,116.12,118.5
2023-09-19 18:10,2181,1496,685,169316,108131,61185,200130859.0,127619956.0,72510903.0,1839,1338,501,156712,102098,54614,183756978.0,118842327.0,64914651.0,118.02,118.51,116.4,118.86
2023-09-19 18:15,4179,1089,3090,140278,75055,65223,165737726.0,87715003.0,78022722.0,3905,952,2953,128623,67621,61002,150749262.0,78472806.0,72276456.0,116.87,119.62,116.05,118.48
2023-09-19 18:20,1267,561,706,97648,43490,54158,114225683.0,50606291.0,63619392.0,1000,476,524,85381,39776,45605,102259896.0,48174846.0,54085049.0,116.36,117.47,121.12,118.59
2023-09-19 18:25,1077,274,803,85825,27567,58258,101288645.0,32442541.0,68846104.0,986,216,770,77843,21224,56619,91579238.0,24595315.0,66983923.0,117.69,118.17,115.88,118.31
2023-09-19 18:30,9433,882,8551,405556,58133,347423,481210472.0,69904031.0,411306440.0,8837,581,8256,373101,38860,334241,441779560.0,45654585.0,396124975.0,120.25,118.39,117.48,118.51
2023-09-19 18:35,1037,662,375,58511,35040,23471,69056789.0,42235024.0,26821765.0,572,429,143,34495,23999,10496,41935801.0,29378651.0,12557150.0,120.53,114.28,122.42,119.64
2023-09-20 10:00,5974,2286,3688,227196,102278,124918,267530982.0,120867017.0,146663964.0,3200,1259,1941,126604,54581,72023,151065212.0,64612365.0,86452847.0,118.17,117.41,118.38,120.04
2023-09-20 10:05,1354,516,838,65538,24889,40649,75787874.0,29305266.0,46482608.0,801,320,481,32585,10564,22021,38454674.0,12250106.0,26204568.0,117.74,114.35,115.96,119.0
2023-09-20 10:10,3779,2412,1367,107365,54901,52464,124311277.0,63012108.0,61299169.0,3158,2068,1090,87354,46811,40543,100249582.0,52662317.0,47587264.0,114.77,116.84,112.5,117.37
2023-09-20 10:15,2665,1571,1094,103665,54836,48829,118747874.0,62279823.0,56468050.0,2192,1233,959,91548,47641,43907,104861481.0,53982786.0,50878695.0,113.57,115.64,113.31,115.88
2023-09-20 10:20,1131,635,496,30859,16211,14648,35171680.0,18487606.0,16684074.0,889,513,376,24142,13596,10546,27620754.0,15452624.0,12168130.0,114.04,113.9,113.66,115.38
2023-09-20 10:25,1505,1107,398,41420,29960,11460,47365409.0,34261222.0,13104186.0,1238,942,296,35182,25177,10005,40283065.0,28718666.0,11564399.0,114.36,114.35,114.07,115.59
2023-09-20 10:30,1260,286,974,55001,16378,38623,63003879.0,18489626.0,44514252.0,1076,200,876,50019,14852,35167,57416202.0,16762067.0,40654135.0,112.89,115.25,112.86,115.6
2023-09-20 10:35,1370,493,877,90777,35834,54943,103162624.0,40206850.0,62955773.0,1047,311,736,78707,29764,48943,89463361.0,33277502.0,56185859.0,112.2,114.58,111.8,114.8
2023-09-20 10:40,1913,1000,913,97650,46526,51124,111330097.0,52590640.0,58739456.0,1732,886,846,94428,44193,50235,107585111.0,49777842.0,57807268.0,113.03,114.9,112.64,115.07
2023-09-20 10:45,5853,3749,2104,259134,146584,112550,293943265.0,165598157.0,128345108.0,5750,3703,2047,256470,146115,110355,290888144.0,164991126.0,125897017.0,112.97,114.03,112.92,114.08
2023-09-20 10:50,3316,522,2794,102778,31756,71022,114667529.0,35180087.0,79487442.0,3050,363,2687,92632,28040,64592,104130674.0,31045807.0,73084867.0,110.78,111.92,110.72,113.15
2023-09-20 10:55,995,742,253,62421,40015,22406,70545562.0,44898628.0,25646933.0,808,633,175,57986,38333,19653,65366941.0,42866420.0,22500520.0,112.2,114.46,111.83,114.49
2023-09-20 11:00,1973,934,1039,106152,49746,56406,120715493.0,55970070.0,64745423.0,1820,853,967,102564,48871,53693,116552593.0,54986601.0,61565991.0,112.51,114.78,112.51,114.66
2023-09-20 11:05,1172,750,422,73667,44129,29538,86017908.0,49848708.0,36169200.0,1125,722,403,71129,43198,27931,82782182.0,48624996.0,34157186.0,112.96,122.45,112.56,122.29
2023-09-20 11:10,2524,1565,959,155012,85788,69224,175678095.0,96479520.0,79198575.0,2417,1502,915,149566,82106,67460,169447653.0,92274843.0,77172809.0,112.46,114.41,112.39,114.4
2023-09-20 11:15,2143,1080,1063,120510,67105,53405,136618529.0,75430258.0,61188271.0,2052,1041,1011,120328,67466,52862,136348986.0,75768050.0,60580936.0,112.41,114.57,112.31,114.6
2023-09-20 11:20,1885,348,1537,105447,30235,75212,119500223.0,33798822.0,85701400.0,1825,312,1513,105123,29994,75129,119242899.0,33469603.0,85773295.0,111.79,113.95,111.59,114.17
2023-09-20 11:25,1804,247,1557,91657,21000,70657,104105423.0,23504417.0,80601005.0,1774,234,1540,91651,21028,70623,104100554.0,23534905.0,80565649.0,111.93,114.07,111.92,114.08
2023-09-20 11:30,607,148,459,35519,10643,24876,40612534.0,11907944.0,28704590.0,583,146,437,33775,10192,23583,38317228.0,11389221.0,26928007.0,111.89,115.39,111.75,114.18
2023-09-20 11:35,829,287,542,36400,12319,24081,40245762.0,13699334.0,26546427.0,640,176,464,28068,7955,20113,31683877.0,8842641.0,22841235.0,111.2,110.24,111.16,113.56
2023-09-20 11:40,950,440,510,76499,35734,40765,85228125.0,39371684.0,45856441.0,811,368,443,72593,35183,37410,80990046.0,38740524.0,42249522.0,110.18,112.49,110.11,112.94
2023-09-20 11:45,1792,1402,390,100081,69244,30837,111784063.0,76937780.0,34846283.0,1647,1311,336,97372,67951,29421,108610516.0,75334462.0,33276053.0,111.11,113.0,110.87,113.1
2023-09-20 11:50,670,419,251,53476,30546,22930,61164620.0,34764511.0,26400109.0,541,336,205,50289,28443,21846,57088495.0,31897576.0,25190919.0,113.81,115.13,112.15,115.31
2023-09-20 11:55,718,490,228,50423,29500,20923,58012955.0,33625701.0,24387253.0,608,431,177,45924,28048,17876,52542248.0,31742735.0,20799513.0,113.99,116.56,113.17,116.35
2023-09-20 12:00,738,424,314,58073,32059,26014,67129755.0,36877026.0,30252728.0,589,355,234,53737,29554,24183,61734377.0,33508513.0,28225863.0,115.03,116.29,113.38,116.72
2023-09-20 12:05,692,351,341,45572,21496,24076,52397674.0,24487142.0,27910532.0,596,295,301,43470,20094,23376,50012595.0,22822801.0,27189794.0,113.91,115.93,113.58,116.31
2023-09-20 12:10,371,172,199,35585,16568,19017,40618981.0,18796362.0,21822618.0,307,135,172,30824,14258,16566,35394481.0,16119365.0,19275116.0,113.45,114.75,113.05,116.35
2023-09-20 12:15,378,211,167,28361,14238,14123,32701270.0,16246593.0,16454677.0,318,167,151,30094,15374,14720,34662863.0,17470595.0,17192268.0,114.11,116.51,113.64,116.8
2023-09-20 12:20,337,197,140,32302,16760,15542,37261302.0,19133322.0,18127980.0,278,177,101,29240,15632,13608,33729059.0,17792486.0,15936573.0,114.16,116.64,113.82,117.11
2023-09-20 12:25,535,323,212,38873,20145,18728,45029693.0,23070279.0,21959414.0,426,268,158,35687,19306,16381,41236584.0,22025582.0,19211002.0,114.52,117.25,114.09,117.28
2023-09-20 12:30,459,226,233,35540,17842,17698,40844597.0,20304502.0,20540094.0,394,193,201,35190,17717,17473,40478511.0,20117845.0,20360665.0,113.8,116.06,113.55,116.53
2023-09-20 12:35,694,318,376,55057,26072,28985,63235580.0,29622328.0,33613251.0,653,299,354,53985,25735,28250,62080511.0,29237027.0,32843483.0,113.62,115.97,113.61,116.26
2023-09-20 12:40,815,638,177,50384,33057,17327,58037064.0,37786527.0,20250536.0,769,612,157,48533,32303,16230,55774971.0,36865537.0,18909434.0,114.31,116.87,114.12,116.51
2023-09-20 12:45,284,210,74,17893,11395,6498,20563264.0,12981210.0,7582054.0,256,197,59,17848,11594,6254,20510504.0,13196265.0,7314239.0,113.92,116.68,113.82,116.95
2023-09-20 12:50,608,329,279,27755,15793,11962,31428684.0,17975399.0,13453285.0,440,235,205,20301,12930,7371,23115681.0,14625419.0,8490262.0,113.82,112.47,113.11,115.18
2023-09-20 12:55,556,454,102,19411,17471,1940,22281550.0,20049013.0,2232536.0,500,420,80,18477,16511,1966,21113870.0,18838776.0,2275093.0,114.76,115.08,114.1,115.72
2023-09-20 13:00,257,110,147,6250,3474,2776,7290976.0,4050307.0,3240668.0,193,65,128,6541,3268,3273,7627612.0,3675936.0,3951676.0,116.59,116.74,112.48,120.74
2023-09-20 13:05,177,119,58,4751,3295,1456,5539057.0,3772003.0,1767054.0,129,93,36,3518,2787,731,4007366.0,3158826.0,848539.0,114.48,121.36,113.34,116.08
2023-09-20 13:10,200,121,79,12689,7229,5460,14578078.0,8234557.0,6343521.0,173,116,57,12546,7882,4664,14380654.0,8929523.0,5451131.0,113.91,116.18,113.29,116.88
2023-09-20 13:15,164,91,73,16550,7554,8996,19203360.0,8566235.0,10637125.0,132,80,52,13640,7339,6301,15706118.0,8334692.0,7371426.0,113.4,118.24,113.57,116.99
2023-09-20 13:20,5378,73,5305,239058,6590,232468,275548833.0,7506643.0,268042190.0,5327,47,5280,235791,4829,230962,271866395.0,5479226.0,266387169.0,113.91,115.3,113.47,115.34
2023-09-20 13:25,349,222,127,27416,15010,12406,31439680.0,17042322.0,14397357.0,311,197,114,27103,14937,12166,31114028.0,16956504.0,14157524.0,113.54,116.05,113.52,116.37
2023-09-20 13:30,538,359,179,42795,24167,18628,49043824.0,27403807.0,21640016.0,522,352,170,43504,24366,19138,49862363.0,27619155.0,22243207.0,113.39,116.17,113.35,116.23
2023-09-20 13:35,893,197,696,60064,17554,42510,68573293.0,19909379.0,48663913.0,779,122,657,57370,15786,41584,65646136.0,17873023.0,47773113.0,113.42,114.48,113.22,114.88
2023-09-20 13:40,772,181,591,47003,16576,30427,53876611.0,18750093.0,35126518.0,732,160,572,46269,16232,30037,53013856.0,18323307.0,34690549.0,113.12,115.45,112.88,115.49
2023-09-20 13:45,366,137,229,13486,7080,6406,15405588.0,8017748.0,7387840.0,345,126,219,13967,7156,6811,16005866.0,8089150.0,7916715.0,113.25,115.33,113.04,116.23
2023-09-20 13:50,1717,453,1264,100580,35098,65482,114536292.0,39540752.0,74995539.0,1629,402,1227,97600,33418,64182,111264460.0,37619057.0,73645403.0,112.66,114.53,112.57,114.74
2023-09-20 13:55,1151,121,1030,59257,9069,50188,67574443.0,10216701.0,57357742.0,1115,97,1018,58368,8380,49988,66531047.0,9397302.0,57133744.0,112.66,114.29,112.14,114.29
2023-09-20 14:00,908,489,419,58729,31254,27475,67145181.0,35540041.0,31605140.0,844,445,399,56954,30440,26514,64929318.0,34412675.0,30516643.0,113.71,115.03,113.05,115.1
2023-09-20 14:05,635,402,233,46662,28355,18307,53147592.0,32091119.0,21056473.0,578,376,202,46127,28316,17811,52587189.0,31989374.0,20597814.0,113.18,115.02,112.97,115.65
2023-09-20 14:10,1549,574,975,114996,46013,68983,130692626.0,51763321.0,78929305.0,1497,549,948,114126,46166,67960,129760592.0,51902010.0,77858582.0,112.5,114.42,112.42,114.57
2023-09-20 14:15,1479,1037,442,105288,72430,32858,119795738.0,81867598.0,37928140.0,1388,983,405,103540,71478,32062,117744286.0,80723768.0,37020517.0,113.03,115.43,112.94,115.47
2023-09-20 14:20,1100,205,895,58554,17706,40848,66691921.0,19901976.0,46789944.0,1076,201,875,58262,17734,40528,66392392.0,19902220.0,46490172.0,112.4,114.55,112.23,114.71
2023-09-20 14:25,880,515,365,72743,38669,34074,83103648.0,43908251.0,39195397.0,820,475,345,71394,37391,34003,81437130.0,42296664.0,39140465.0,113.55,115.03,113.12,115.11
2023-09-20 14:30,632,405,227,57614,32801,24813,65907783.0,37111228.0,28796555.0,576,380,196,56238,32363,23875,64384650.0,36607349.0,27777301.0,113.14,116.05,113.11,116.34
2023-09-20 14:35,1003,538,465,84024,41037,42987,96681510.0,46879745.0,49801764.0,774,355,419,76829,34083,42746,88336867.0,38721671.0,49615196.0,114.24,115.85,113.61,116.07
2023-09-20 14:40,1490,815,675,134004,72150,61854,156151302.0,83758368.0,72392934.0,1098,650,448,123638,68169,55469,143381067.0,78156930.0,65224136.0,116.09,117.04,114.65,117.59
2023-09-20 14:45,785,419,366,67748,33406,34342,78358906.0,38260738.0,40098168.0,674,337,337,64156,31946,32210,74250760.0,36462543.0,37788216.0,114.53,116.76,114.14,117.32
2023-09-20 14:50,1442,445,997,108962,37161,71801,125890397.0,42455541.0,83434856.0,1329,379,950,106397,36002,70395,122875191.0,41022665.0,81852525.0,114.25,116.2,113.95,116.28
2023-09-20 14:55,1191,297,894,71888,22449,49439,82348532.0,25424204.0,56924328.0,1096,248,848,69543,21241,48302,79791199.0,24039106.0,55752093.0,113.25,115.14,113.17,115.42
2023-09-20 15:00,901,227,674,63848,16080,47768,73602308.0,18296626.0,55305682.0,854,191,663,62455,14812,47643,71977864.0,16813095.0,55164768.0,113.78,115.78,113.51,115.79
2023-09-20 15:05,541,258,283,43506,19723,23783,50452734.0,22646356.0,27806378.0,476,227,249,42371,19331,23040,48970277.0,22035581.0,26934695.0,114.82,116.92,113.99,116.9
2023-09-20 15:10,358,195,163,31094,15748,15346,36054707.0,18035000.0,18019706.0,329,184,145,30360,15473,14887,35150896.0,17665327.0,17485568.0,114.52,117.42,114.17,117.46
2023-09-20 15:15,899,422,477,64538,26234,38304,74063514.0,29838076.0,44225438.0,832,397,435,63621,25904,37717,73174888.0,29406060.0,43768828.0,113.74,115.46,113.52,116.05
2023-09-20 15:20,913,838,75,36317,32271,4046,41642556.0,36933276.0,4709280.0,856,802,54,36133,32120,4013,41465658.0,36731684.0,4733973.0,114.45,116.39,114.36,117.97
2023-09-20 15:25,737,499,238,59145,33575,25570,67979001.0,38198679.0,29780321.0,653,438,215,57985,32944,25041,66629167.0,37466020.0,29163147.0,113.77,116.47,113.73,116.46
2023-09-20 15:30,330,142,188,24600,10482,14118,28300854.0,11936921.0,16363933.0,262,104,158,23306,9954,13352,26822879.0,11287753.0,15535126.0,113.88,115.91,113.4,116.35
2023-09-20 15:35,358,227,131,26827,15556,11271,30931894.0,17792443.0,13139450.0,342,216,126,26282,15519,10763,30230110.0,17679902.0,12550207.0,114.38,116.58,113.92,116.61
2023-09-20 15:40,1098,342,756,95466,32612,62854,109348983.0,36920642.0,72428341.0,989,280,709,93764,33152,60612,107499496.0,37361468.0,70138028.0,113.21,115.23,112.7,115.72
2023-09-20 15:45,759,452,307,50482,26321,24161,57684026.0,29741921.0,27942105.0,492,275,217,47236,23802,23434,54003898.0,26838464.0,27165433.0,113.0,115.65,112.76,115.92
2023-09-20 15:50,248,137,111,20115,10153,9962,22951779.0,11475672.0,11476106.0,206,113,93,20870,11352,9518,23823128.0,12805477.0,11017650.0,113.03,115.2,112.8,115.76
2023-09-20 15:55,6782,173,6609,121593,17678,103915,139516693.0,20014373.0,119502319.0,6743,159,6584,120840,17643,103197,138592904.0,19916650.0,118676254.0,113.22,115.0,112.89,115.0
2023-09-20 16:00,321,155,166,24620,12873,11747,28074600.0,14535562.0,13539038.0,246,98,148,21959,10408,11551,25038121.0,11718575.0,13319545.0,112.92,115.26,112.59,115.31
2023-09-20 16:05,333,165,168,25421,12153,13268,29154317.0,13782258.0,15372059.0,255,118,137,23602,11127,12475,27090741.0,12548150.0,14542590.0,113.41,115.86,112.77,116.57
2023-09-20 16:10,413,228,185,37800,19823,17977,43000139.0,22511209.0,20488930.0,335,178,157,34569,18313,16256,39446163.0,20643437.0,18802726.0,113.56,113.97,112.73,115.67
2023-09-20 16:15,291,119,172,22857,11436,11421,26172146.0,12977313.0,13194832.0,217,89,128,21272,10224,11048,24342655.0,11556274.0,12786381.0,113.48,115.53,113.03,115.73
2023-09-20 16:20,1220,204,1016,51608,16064,35544,59932325.0,18852556.0,41079768.0,1091,135,956,48204,14600,33604,55426569.0,16522155.0,38904414.0,117.36,115.57,113.17,115.77
2023-09-20 16:25,1791,194,1597,97108,14651,82457,112470778.0,17770092.0,94700685.0,1711,149,1562,94039,13441,80598,109278504.0,16452839.0,92825664.0,121.29,114.85,122.41,115.17
2023-09-20 16:30,240,117,123,18904,9184,9720,21582012.0,10383374.0,11198637.0,195,87,108,17694,8605,9089,20233832.0,9700141.0,10533691.0,113.06,115.21,112.73,115.89
2023-09-20 16:35,393,216,177,29224,14804,14420,33605386.0,16741013.0,16864373.0,331,187,144,27662,13952,13710,31943362.0,15758254.0,16185108.0,113.08,116.95,112.95,118.05
2023-09-20 16:40,774,545,229,61357,41890,19467,70071032.0,47658489.0,22412543.0,696,492,204,57674,39057,18617,65851620.0,44281621.0,21569999.0,113.77,115.13,113.38,115.86
2023-09-20 16:45,652,486,166,31336,23181,8155,36761156.0,27287137.0,9474018.0,448,368,80,21717,17528,4189,25049936.0,20147753.0,4902182.0,117.71,116.17,114.95,117.03
2023-09-20 16:50,861,415,446,39235,14507,24728,45327704.0,16829628.0,28498076.0,660,321,339,34138,12530,21608,39503461.0,14394841.0,25108620.0,116.01,115.25,114.88,116.2
2023-09-20 16:55,474,339,135,20730,13100,7630,24508343.0,15601284.0,8907059.0,355,275,80,17760,10216,7544,20708555.0,11736073.0,8972482.0,119.09,116.74,114.88,118.94
2023-09-20 17:00,1192,973,219,62852,52068,10784,74136770.0,61515080.0,12621690.0,890,788,102,46053,41178,4875,53464669.0,47686036.0,5778633.0,118.14,117.04,115.8,118.54
2023-09-20 17:05,1196,603,593,73411,40273,33138,87229977.0,48003184.0,39226792.0,892,498,394,64659,35329,29330,75872469.0,41031576.0,34840893.0,119.19,118.37,116.14,118.79
2023-09-20 17:10,1098,428,670,76483,35936,40547,90024831.0,42058872.0,47965959.0,889,339,550,67617,31482,36135,79737467.0,36675703.0,43061763.0,117.04,118.3,116.5,119.17
2023-09-20 17:15,1082,526,556,91133,42403,48730,106839873.0,49294223.0,57545650.0,927,488,439,84864,41605,43259,99758764.0,48311781.0,51446983.0,116.25,118.09,116.12,118.93
2023-09-20 17:20,1002,480,522,67967,33016,34951,79380301.0,38213130.0,41167170.0,842,378,464,63928,29348,34580,74708467.0,33870217.0,40838249.0,115.74,117.79,115.41,118.1
2023-09-20 17:25,383,147,236,33411,14227,19184,39369942.0,16617174.0,22752768.0,300,111,189,30595,12777,17818,36057303.0,14827384.0,21229919.0,116.8,118.6,116.05,119.15
2023-09-20 17:30,374,205,169,27303,13910,13393,32101190.0,16175179.0,15926010.0,290,177,113,24583,13185,11398,28922307.0,15313579.0,13608728.0,116.28,118.91,116.14,119.4
2023-09-20 17:35,569,278,291,45368,22285,23083,52962743.0,25728730.0,27234013.0,476,247,229,43706,21825,21881,51106617.0,25188154.0,25918462.0,115.45,117.98,115.41,118.45
2023-09-20 17:40,218,132,86,14738,7994,6744,17205685.0,9242654.0,7963031.0,167,94,73,13769,7506,6263,16078628.0,8652904.0,7425724.0,115.62,118.08,115.28,118.56
2023-09-20 17:45,365,163,202,31781,15609,16172,36947350.0,17995510.0,18951840.0,303,140,163,28875,14014,14861,33676275.0,16114867.0,17561407.0,115.29,117.19,114.99,118.17
2023-09-20 17:50,227,79,148,16744,7144,9600,19403948.0,8222239.0,11181708.0,197,78,119,17303,7538,9765,20359684.0,8677140.0,11682544.0,115.09,116.48,115.11,119.64
2023-09-20 17:55,252,50,202,18934,5084,13850,22033699.0,5843084.0,16190614.0,217,47,170,17478,4813,12665,20397591.0,5531079.0,14866511.0,114.93,116.9,114.92,117.38
2023-09-20 18:00,482,150,332,37670,15727,21943,43703602.0,18003427.0,25700174.0,426,126,300,33627,12115,21512,39148676.0,13886522.0,25262153.0,114.47,117.12,114.62,117.43
2023-09-20 18:05,473,165,308,33901,14338,19563,39190091.0,16400008.0,22790083.0,418,137,281,33214,14688,18526,38476609.0,16786645.0,21689964.0,114.38,116.5,114.29,117.08
2023-09-20 18:10,473,284,189,34761,19608,15153,40262967.0,22492509.0,17770457.0,429,262,167,38724,23896,14828,44753185.0,27331579.0,17421605.0,114.71,117.27,114.38,117.49
2023-09-20 18:15,412,174,238,38279,17102,21177,44273971.0,19512451.0,24761519.0,346,144,202,37515,16858,20657,43400468.0,19211267.0,24189201.0,114.09,116.93,113.96,117.1
2023-09-20 18:20,233,116,117,16210,7653,8557,18716683.0,8741159.0,9975524.0,205,98,107,15828,7471,8357,18316420.0,8516748.0,9799671.0,114.22,116.58,114.0,117.26
2023-09-20 18:25,242,88,154,18936,8511,10425,21869835.0,9712576.0,12157258.0,195,74,121,18058,8111,9947,20889372.0,9238908.0,11650463.0,114.12,116.62,113.91,117.13
2023-09-20 18:30,254,98,156,24169,11031,13138,28953671.0,13694295.0,15259375.0,194,71,123,20562,9332,11230,23750582.0,10625125.0,13125456.0,124.14,116.15,113.86,116.88
2023-09-20 18:35,93,42,51,6217,2515,3702,7193699.0,2875298.0,4318401.0,82,34,48,6221,2877,3344,7215362.0,3275535.0,3939827.0,114.33,116.65,113.85,117.82
2023-09-21 10:00,1452,514,938,54476,24633,29843,61725049.0,25923142.0,35801907.0,422,132,290,19023,4912,14111,21831228.0,5535524.0,16295704.0,105.24,119.97,112.69,115.48
2023-09-21 10:05,881,499,382,27282,16370,10912,31119656.0,18563638.0,12556017.0,610,357,253,19236,11589,7647,22009779.0,13189727.0,8820052.0,113.4,115.07,113.81,115.34
2023-09-21 10:10,1066,712,354,38494,27683,10811,44393235.0,31755453.0,12637781.0,769,544,225,31863,24186,7677,36601807.0,27709022.0,8892784.0,114.71,116.9,114.57,115.84
2023-09-21 10:15,1369,835,534,111786,60630,51156,131364191.0,70599467.0,60764724.0,1039,703,336,91987,51415,40572,107304340.0,59220783.0,48083557.0,116.44,118.78,115.18,118.51
2023-09-21 10:20,1208,614,594,97641,46372,51269,114959465.0,53994973.0,60964491.0,831,477,354,85643,41748,43895,100958325.0,48461167.0,52497158.0,116.44,118.91,116.08,119.6
2023-09-21 10:25,859,454,405,66064,30376,35688,77715603.0,34925362.0,42790240.0,718,400,318,58228,30271,27957,67880493.0,34813962.0,33066530.0,114.98,119.9,115.01,118.28
2023-09-21 10:30,1420,804,616,93690,50508,43182,108325800.0,57944049.0,50381751.0,1203,676,527,90535,48939,41596,104859269.0,56106549.0,48752719.0,114.72,116.67,114.65,117.21
2023-09-21 10:35,509,191,318,37076,16144,20932,42747751.0,18365327.0,24382424.0,411,130,281,35801,15772,20029,41406769.0,17931266.0,23475502.0,113.76,116.48,113.69,117.21
2023-09-21 10:40,1274,753,521,92658,52036,40622,107068041.0,59634561.0,47433479.0,1035,628,407,86602,49248,37354,100115194.0,56317412.0,43797781.0,114.6,116.77,114.35,117.25
2023-09-21 10:45,920,526,394,66802,38670,28132,77697582.0,44468429.0,33229153.0,837,501,336,63902,37201,26701,74272466.0,42725153.0,31547312.0,114.99,118.12,114.85,118.15
2023-09-21 10:50,553,224,329,49699,19154,30545,58074627.0,22043232.0,36031395.0,451,180,271,47811,18183,29628,55852929.0,20867270.0,34985659.0,115.08,117.96,114.76,118.08
2023-09-21 10:55,797,421,376,65411,31561,33850,76572980.0,36639407.0,39933573.0,652,340,312,62348,29988,32360,72908081.0,34593888.0,38314192.0,116.09,117.97,115.36,118.4
2023-09-21 11:00,483,188,295,34961,15299,19662,40810246.0,17624711.0,23185534.0,351,139,212,33405,15537,17868,39156014.0,17950248.0,21205766.0,115.2,117.92,115.53,118.68
2023-09-21 11:05,579,218,361,33700,14991,18709,39054914.0,17163842.0,21891072.0,398,120,278,30790,14294,16496,35737774.0,16362184.0,19375589.0,114.49,117.01,114.47,117.46
2023-09-21 11:10,138,81,57,7579,3943,3636,8866207.0,4600569.0,4265638.0,73,41,32,5280,2707,2573,6113033.0,3093129.0,3019903.0,116.68,117.32,114.26,117.37
2023-09-21 11:15,493,173,320,33846,14179,19667,38990742.0,16130148.0,22860593.0,391,126,265,32607,14127,18480,37626003.0,16055246.0,21570757.0,113.76,116.24,113.65,116.72
2023-09-21 11:20,295,121,174,23043,10809,12234,26564418.0,12334474.0,14229944.0,249,97,152,22141,10450,11691,25522704.0,11864546.0,13658157.0,114.11,116.31,113.54,116.83
2023-09-21 11:25,539,243,296,24023,11272,12751,27720261.0,12798317.0,14921944.0,245,88,157,21347,10283,11064,24572125.0,11673619.0,12898505.0,113.54,117.03,113.52,116.58
2023-09-21 11:30,136,63,73,10652,5024,5628,12282351.0,5703408.0,6578943.0,100,50,50,9760,4737,5023,11268777.0,5392256.0,5876521.0,113.52,116.9,113.83,116.99
2023-09-21 11:35,277,185,92,21968,12009,9959,25443958.0,13748113.0,11695844.0,238,167,71,21500,11748,9752,24837037.0,13406560.0,11430476.0,114.48,117.44,114.12,117.21
2023-09-21 11:40,227,73,154,11036,4629,6407,12722508.0,5289027.0,7433480.0,187,54,133,10731,4308,6423,12384525.0,4895361.0,7489163.0,114.26,116.02,113.63,116.6
2023-09-21 11:45,423,182,241,31455,13714,17741,35802674.0,15572205.0,20230469.0,331,120,211,29440,12797,16643,33835326.0,14476459.0,19358867.0,113.55,114.03,113.12,116.32
2023-09-21 11:50,801,338,463,57548,26224,31324,65824081.0,29750790.0,36073291.0,567,206,361,48742,22609,26133,55807230.0,25512850.0,30294379.0,113.45,115.16,112.84,115.92
2023-09-21 11:55,364,192,172,29251,15003,14248,33634084.0,17091235.0,16542849.0,318,163,155,27468,13769,13699,31510085.0,15556085.0,15953999.0,113.92,116.11,112.98,116.46
2023-09-21 12:00,867,281,586,69668,25971,43697,80253790.0,29429511.0,50824279.0,812,258,554,67590,25559,42031,77816093.0,28979730.0,48836363.0,113.32,116.31,113.38,116.19
2023-09-21 12:05,317,120,197,26763,11303,15460,30828242.0,12825851.0,18002390.0,270,97,173,26256,11134,15122,30305028.0,12635979.0,17669049.0,113.47,116.44,113.49,116.84
2023-09-21 12:10,402,284,118,24845,11977,12868,28443745.0,13613571.0,14830173.0,357,249,108,23797,11856,11941,27381402.0,13448713.0,13932689.0,113.66,115.25,113.43,116.68
2023-09-21 12:15,502,309,193,39114,18870,20244,44985250.0,21422147.0,23563102.0,407,238,169,37780,17640,20140,43463153.0,20005977.0,23457175.0,113.52,116.4,113.41,116.47
2023-09-21 12:20,447,226,221,31961,15824,16137,36843760.0,18072485.0,18771275.0,342,182,160,30577,14497,16080,35227518.0,16477963.0,18749554.0,114.21,116.32,113.66,116.6
2023-09-21 12:25,712,342,370,51385,26224,25161,59117341.0,29826704.0,29290637.0,533,283,250,50047,25373,24674,57662877.0,28825322.0,28837554.0,113.74,116.41,113.61,116.87
2023-09-21 12:30,833,592,241,67165,43201,23964,77477613.0,49456746.0,28020867.0,756,562,194,65446,42374,23072,75451852.0,48465585.0,26986267.0,114.48,116.93,114.38,116.97
2023-09-21 12:35,329,174,155,20962,11058,9904,24288820.0,12680170.0,11608650.0,267,155,112,19993,11264,8729,23143839.0,12908125.0,10235714.0,114.67,117.21,114.6,117.26
2023-09-21 12:40,518,263,255,35413,16839,18574,40917845.0,19246721.0,21671123.0,467,239,228,33847,16730,17117,39058051.0,19106987.0,19951063.0,114.3,116.67,114.21,116.56
2023-09-21 12:45,819,99,720,56696,12746,43950,65463133.0,14447097.0,51016036.0,789,74,715,55237,11440,43797,63854925.0,13013625.0,50841300.0,113.35,116.08,113.76,116.08
2023-09-21 12:50,639,224,415,57765,24979,32786,67088778.0,28796588.0,38292190.0,540,173,367,52850,22220,30630,61172051.0,25383639.0,35788412.0,115.28,116.79,114.24,116.84
2023-09-21 12:55,750,315,435,56893,28505,28388,66346393.0,33041274.0,33305118.0,628,245,383,54400,26760,27640,63210172.0,30736161.0,32474011.0,115.91,117.32,114.86,117.49
2023-09-21 13:00,535,271,264,45433,22987,22446,52884753.0,26561029.0,26323723.0,459,239,220,42329,21279,21050,49210491.0,24425780.0,24784711.0,115.55,117.28,114.79,117.74
2023-09-21 13:05,1364,581,783,71551,33719,37832,82963729.0,38798015.0,44165714.0,1309,568,741,70733,34197,36536,82050564.0,39316044.0,42734519.0,115.06,116.74,114.97,116.97
2023-09-21 13:10,215,74,141,17146,7047,10099,19903695.0,8064032.0,11839663.0,199,58,141,18322,7633,10689,21292499.0,8749984.0,12542515.0,114.43,117.24,114.63,117.34
2023-09-21 13:15,227,92,135,20582,9269,11313,23913469.0,10622386.0,13291083.0,204,85,119,19538,8963,10575,22686153.0,10258257.0,12427895.0,114.6,117.49,114.45,117.52
2023-09-21 13:20,112,43,69,6623,2878,3745,7681897.0,3299335.0,4382561.0,82,34,48,5926,2761,3165,6875257.0,3161076.0,3714181.0,114.64,117.02,114.49,117.35
2023-09-21 13:25,77,40,37,6551,3287,3264,7614481.0,3777543.0,3836938.0,65,34,31,6345,3206,3139,7355514.0,3666145.0,3689368.0,114.92,117.55,114.35,117.53
2023-09-21 13:30,490,381,109,33469,22406,11063,38885841.0,25849858.0,13035983.0,444,354,90,33025,22342,10683,38249428.0,25658309.0,12591119.0,115.37,117.83,114.84,117.86
2023-09-21 13:35,623,191,432,40303,14841,25462,46719978.0,17020300.0,29699678.0,590,181,409,40547,14982,25565,47046545.0,17183208.0,29863337.0,114.68,116.64,114.69,116.81
2023-09-21 13:40,725,244,481,54211,21470,32741,62803107.0,24553904.0,38249203.0,697,228,469,53177,20851,32326,61543789.0,23787251.0,37756538.0,114.36,116.82,114.08,116.8
2023-09-21 13:45,601,115,486,43218,12283,30935,50166472.0,14094203.0,36072269.0,545,96,449,41992,12272,29720,48798694.0,14052413.0,34746281.0,114.75,116.61,114.51,116.91
2023-09-21 13:50,1120,94,1026,75519,14785,60734,87676248.0,16895067.0,70781180.0,1110,93,1017,74969,14751,60218,87013677.0,16859753.0,70153924.0,114.27,116.54,114.3,116.5
2023-09-21 13:55,215,82,133,19441,8867,10574,22421749.0,10072990.0,12348759.0,177,60,117,18570,8409,10161,21480406.0,9582650.0,11897756.0,113.6,116.78,113.96,117.09
2023-09-21 14:00,380,106,274,26954,11085,15869,31148250.0,12623625.0,18524625.0,343,82,261,26442,10778,15664,30569861.0,12269881.0,18299979.0,113.88,116.73,113.84,116.83
2023-09-21 14:05,125,55,70,10663,5102,5561,12374146.0,5860491.0,6513654.0,110,46,64,11180,5297,5883,12941125.0,6037854.0,6903271.0,114.87,117.13,113.99,117.34
2023-09-21 14:10,284,139,145,26077,12285,13792,30170746.0,14001138.0,16169608.0,230,116,114,23781,11583,12198,27453184.0,13180424.0,14272759.0,113.97,117.24,113.79,117.01
2023-09-21 14:15,303,134,169,27345,12907,14438,31249333.0,14682797.0,16566536.0,231,96,135,25368,12276,13092,29214385.0,13937931.0,15276454.0,113.76,114.74,113.54,116.69
2023-09-21 14:20,266,128,138,23619,11422,12197,27103318.0,12957446.0,14145872.0,228,110,118,23442,11385,12057,26968223.0,12913567.0,14054656.0,113.44,115.98,113.43,116.57
2023-09-21 14:25,210,91,119,20920,9108,11812,24165587.0,10331452.0,13834135.0,171,66,105,17784,8322,9462,20449669.0,9433763.0,11015905.0,113.43,117.12,113.36,116.42
2023-09-21 14:30,205,122,83,19946,10829,9117,22975835.0,12327518.0,10648316.0,176,99,77,18206,9499,8707,20955411.0,10792284.0,10163127.0,113.84,116.8,113.61,116.72
2023-09-21 14:35,227,116,111,21240,10982,10258,24413779.0,12460068.0,11953710.0,193,91,102,21764,11675,10089,25044594.0,13266585.0,11778008.0,113.46,116.53,113.63,116.74
2023-09-21 14:40,308,141,167,22293,10993,11300,25555550.0,12435554.0,13119995.0,283,130,153,22512,11378,11134,25822545.0,12874671.0,12947873.0,113.12,116.11,113.15,116.29
2023-09-21 14:45,651,212,439,53769,23585,30184,61531863.0,26624538.0,34907324.0,555,163,392,50020,22465,27555,57331182.0,25326853.0,32004328.0,112.89,115.65,112.74,116.15
2023-09-21 14:50,456,174,282,31051,14142,16909,35538805.0,16058417.0,19480387.0,352,108,244,30523,13235,17288,35063478.0,14920890.0,20142587.0,113.55,115.21,112.74,116.51
2023-09-21 14:55,281,87,194,19557,8719,10838,22372574.0,9828343.0,12544231.0,244,68,176,19712,8631,11081,22563367.0,9717705.0,12845662.0,112.72,115.74,112.59,115.93
2023-09-21 15:00,594,179,415,41442,13657,27785,47741880.0,15554584.0,32187296.0,553,153,400,41686,14363,27323,47859297.0,16227700.0,31631596.0,113.89,115.84,112.98,115.77
2023-09-21 15:05,1087,519,568,68416,33629,34787,78628882.0,38402384.0,40226498.0,1008,477,531,66267,32651,33616,76174239.0,37242055.0,38932184.0,114.19,115.64,114.06,115.81
2023-09-21 15:10,285,134,151,23798,12353,11445,27399732.0,14063503.0,13336229.0,252,119,133,23096,11743,11353,26575073.0,13338504.0,13236568.0,113.85,116.52,113.59,116.59
2023-09-21 15:15,175,72,103,15415,6840,8575,17983535.0,7816387.0,10167148.0,146,60,86,13949,6851,7098,16039629.0,7766653.0,8272975.0,114.27,118.57,113.37,116.55
2023-09-21 15:20,260,108,152,24724,12621,12103,28206269.0,14184785.0,14021484.0,226,95,131,22939,11121,11818,26307964.0,12570260.0,13737703.0,112.39,115.85,113.03,116.24
2023-09-21 15:25,481,143,338,38546,15304,23242,44015057.0,17202011.0,26813046.0,420,107,313,37373,14866,22507,42739969.0,16684174.0,26055794.0,112.4,115.36,112.23,115.77
2023-09-21 15:30,272,119,153,21547,10075,11472,24316092.0,11379277.0,12936814.0,223,97,126,19807,9746,10061,22669553.0,10998115.0,11671437.0,112.95,112.77,112.85,116.01
2023-09-21 15:35,520,295,225,50821,23467,27354,61014569.0,26568777.0,34445791.0,419,260,159,38528,21602,16926,44077663.0,24445050.0,19632613.0,113.22,125.93,113.16,115.99
2023-09-21 15:40,346,171,175,26441,14266,12175,30260923.0,16147415.0,14113507.0,308,132,176,36032,13900,22132,44145062.0,15692742.0,28452320.0,113.19,115.92,112.9,128.56
2023-09-21 15:45,258,123,135,33664,10969,22695,42173685.0,12379045.0,29794640.0,221,119,102,27236,10812,16424,32951783.0,12196264.0,20755519.0,112.85,131.28,112.8,126.37
2023-09-21 15:50,406,167,239,39454,17593,21861,46375179.0,19831898.0,26543281.0,319,133,186,33700,17013,16687,38825324.0,19176170.0,19649153.0,112.73,121.42,112.71,117.75
2023-09-21 15:55,307,93,214,20541,8654,11887,23379373.0,9716841.0,13662531.0,253,73,180,19540,8651,10889,22268254.0,9671987.0,12596266.0,112.28,114.94,111.8,115.68
2023-09-21 16:00,203,81,122,16153,6742,9411,18320710.0,7540961.0,10779748.0,151,59,92,13417,5982,7435,15283645.0,6709193.0,8574451.0,111.85,114.54,112.16,115.33
2023-09-21 16:05,198,102,96,5516,2826,2690,6225880.0,3190711.0,3035168.0,157,75,82,4762,2533,2229,5426573.0,2861734.0,2564838.0,112.91,112.83,112.98,115.07
2023-09-21 16:10,357,141,216,27083,11393,15690,30896617.0,12786588.0,18110028.0,278,97,181,26733,10698,16035,31047165.0,11990612.0,19056553.0,112.23,115.42,112.08,118.84
2023-09-21 16:15,643,494,149,45619,29045,16574,52401749.0,32937734.0,19464015.0,632,466,166,54093,28523,25570,64773949.0,32228125.0,32545824.0,113.4,117.44,112.99,127.28
2023-09-21 16:20,194,113,81,13696,6960,6736,15649808.0,7846394.0,7803414.0,154,93,61,13099,6840,6259,14970208.0,7710192.0,7260015.0,112.74,115.85,112.72,115.99
2023-09-21 16:25,198,71,127,14646,6325,8321,16739272.0,7142154.0,9597118.0,180,62,118,14489,6199,8290,16579139.0,6980958.0,9598180.0,112.92,115.34,112.61,115.78
2023-09-21 16:30,138,83,55,10592,5550,5042,12115386.0,6272605.0,5842780.0,121,67,54,10448,5334,5114,11888461.0,5963993.0,5924468.0,113.02,115.88,111.81,115.85
2023-09-21 16:35,149,84,65,11664,5999,5665,13382249.0,6798615.0,6583633.0,129,70,59,11716,5927,5789,13429740.0,6701086.0,6728653.0,113.33,116.22,113.06,116.23
2023-09-21 16:40,109,48,61,9014,4084,4930,10363600.0,4633303.0,5730297.0,89,44,45,8525,4070,4455,9799002.0,4610512.0,5188489.0,113.45,116.23,113.28,116.46
2023-09-21 16:45,66,33,33,5917,2931,2986,6799271.0,3323325.0,3475946.0,54,26,28,5745,2754,2991,6603039.0,3120108.0,3482931.0,113.39,116.41,113.29,116.45
2023-09-21 16:50,124,58,66,10923,5129,5794,12568007.0,5824563.0,6743444.0,101,43,58,10506,4963,5543,12085102.0,5625015.0,6460087.0,113.56,116.39,113.34,116.54
2023-09-21 16:55,155,61,94,13033,6191,6842,14864634.0,6999422.0,7865212.0,139,56,83,12368,5923,6445,14180387.0,6696008.0,7484379.0,113.06,114.95,113.05,116.13
2023-09-21 17:00,116,61,55,8278,4379,3899,9487114.0,4962757.0,4524357.0,112,57,55,7865,3881,3984,9015129.0,4390740.0,4624389.0,113.33,116.04,113.13,116.07
2023-09-21 17:05,74,37,37,3990,1617,2373,4585977.0,1834453.0,2751523.0,45,18,27,3156,1678,1478,3621289.0,1900403.0,1720886.0,113.45,115.95,113.25,116.43
2023-09-21 17:10,179,88,91,16927,7936,8991,19422110.0,8976445.0,10445665.0,146,79,67,16619,7861,8758,19074466.0,8890374.0,10184092.0,113.11,116.18,113.09,116.28
2023-09-21 17:15,252,113,139,23259,10835,12424,26752202.0,12364774.0,14387428.0,224,102,122,22826,10275,12551,26228984.0,11631897.0,14597086.0,114.12,115.8,113.21,116.3
2023-09-21 17:20,442,130,312,36108,14500,21608,41257123.0,16333928.0,24923195.0,412,119,293,35192,14522,20670,40215507.0,16358418.0,23857088.0,112.65,115.34,112.65,115.42
2023-09-21 17:25,167,70,97,13737,6389,7348,15664339.0,7181882.0,8482457.0,144,55,89,13379,6199,7180,15257043.0,6965290.0,8291752.0,112.41,115.44,112.36,115.48
2023-09-21 17:30,92,30,62,7879,3468,4411,8989498.0,3897926.0,5091572.0,76,24,52,7610,3483,4127,8681676.0,3914629.0,4767046.0,112.4,115.43,112.39,115.51
2023-09-21 17:35,121,41,80,10710,4525,6185,12209037.0,5082283.0,7126754.0,111,33,78,10498,4369,6129,11965783.0,4903386.0,7062397.0,112.32,115.23,112.23,115.23
2023-09-21 17:40,1141,989,152,86484,65207,21277,98663030.0,73989407.0,24673622.0,1119,978,141,85479,65067,20412,97474400.0,73826775.0,23647625.0,113.47,115.96,113.46,115.85
2023-09-21 17:45,698,573,125,57048,40299,16749,64964579.0,45616234.0,19348345.0,692,576,116,57426,41394,16032,65313821.0,46786516.0,18527304.0,113.19,115.52,113.03,115.56
2023-09-21 17:50,74,43,31,4616,2361,2255,5260510.0,2672331.0,2588178.0,40,19,21,5472,2008,3464,6251701.0,2244103.0,4007597.0,113.19,114.78,111.76,115.69
2023-09-21 17:55,1296,877,419,75520,43574,31946,83397543.0,48527414.0,34870129.0,857,579,278,58075,34448,23627,65149970.0,38253287.0,26896683.0,111.37,109.15,111.05,113.84
2023-09-21 18:00,439,197,242,34751,17519,17232,39116424.0,19522123.0,19594301.0,343,155,188,33882,17979,15903,38092304.0,19949206.0,18143097.0,111.43,113.71,110.96,114.09
2023-09-21 18:05,622,251,371,48143,22751,25392,53143536.0,24979638.0,28163898.0,429,154,275,38402,18276,20126,42792799.0,20023106.0,22769692.0,109.8,110.92,109.56,113.14
2023-09-21 18:10,901,486,415,76874,37817,39057,84446150.0,41148232.0,43297918.0,584,264,320,65871,31524,34347,72436897.0,34169936.0,38266961.0,108.81,110.86,108.39,111.41
2023-09-21 18:15,745,450,295,60346,35023,25323,67390557.0,38750283.0,28640274.0,540,306,234,54851,31205,23646,61216557.0,34423539.0,26793018.0,110.64,113.1,110.31,113.31
2023-09-21 18:20,374,176,198,28596,13116,15480,32402960.0,14697780.0,17705180.0,259,133,126,26088,14089,11999,29457436.0,15679084.0,13778352.0,112.06,114.37,111.29,114.83
2023-09-21 18:25,813,542,271,49212,29964,19248,59783109.0,33248926.0,26534183.0,682,468,214,46010,28057,17953,51533366.0,31130284.0,20403082.0,110.96,137.85,110.95,113.65
2023-09-21 18:30,1010,536,474,40990,21468,19522,46186730.0,24289712.0,21897018.0,870,472,398,36464,18732,17732,40715922.0,20765379.0,19950543.0,113.14,112.17,110.86,112.51
2023-09-21 18:35,1013,470,543,28048,12665,15383,31492410.0,14218220.0,17274190.0,951,435,516,25705,11288,14417,28797392.0,12564836.0,16232556.0,112.26,112.29,111.31,112.59
2023-09-22 10:00,2556,1489,1067,96775,64763,32012,110797237.0,72370250.0,38426986.0,1528,1237,291,62953,50308,12645,71571870.0,56969363.0,14602506.0,111.75,120.04,113.24,115.48
2023-09-22 10:05,912,651,261,38430,24377,14053,49439231.0,28651248.0,20787983.0,648,539,109,30116,20849,9267,34397065.0,23599604.0,10797461.0,117.53,147.93,113.19,116.52
2023-09-22 10:10,380,146,234,15248,5801,9447,17547087.0,6715545.0,10831541.0,235,88,147,7837,2719,5118,8880869.0,3032827.0,5848042.0,115.77,114.66,111.54,114.26
2023-09-22 10:15,142,62,80,10483,4095,6388,11974513.0,4559569.0,7414943.0,96,44,52,7959,3335,4624,9013345.0,3723077.0,5290267.0,111.34,116.08,111.64,114.41
2023-09-22 10:20,277,162,115,23364,12502,10862,26531022.0,13960837.0,12570185.0,198,117,81,21819,11324,10495,24803212.0,12674650.0,12128562.0,111.67,115.73,111.93,115.57
2023-09-22 10:25,432,239,193,16722,8325,8397,19277985.0,9511133.0,9766852.0,123,75,48,13602,6722,6880,15479231.0,7533897.0,7945333.0,114.25,116.31,112.08,115.48
2023-09-22 10:30,1143,909,234,75267,51173,24094,86713457.0,58415645.0,28297812.0,1003,848,155,71381,49685,21696,81682181.0,56448234.0,25233947.0,114.15,117.45,113.61,116.31
2023-09-22 10:35,802,589,213,54538,34094,20444,62432566.0,38793470.0,23639095.0,668,543,125,49024,32880,16144,56167317.0,37392093.0,18775223.0,113.78,115.63,113.72,116.3
2023-09-22 10:40,365,193,172,27727,12184,15543,31798387.0,13740414.0,18057973.0,275,145,130,25063,11637,13426,28630534.0,13109718.0,15520815.0,112.77,116.18,112.66,115.6
2023-09-22 10:45,368,200,168,32224,15260,16964,36808903.0,17071075.0,19737827.0,309,159,150,34037,15206,18831,38704389.0,17008490.0,21695899.0,111.87,116.35,111.85,115.21
2023-09-22 10:50,397,207,190,37662,18699,18963,42707920.0,20927945.0,21779975.0,326,173,153,36308,18192,18116,41176024.0,20339546.0,20836478.0,111.92,114.86,111.8,115.02
2023-09-22 10:55,378,175,203,31294,14425,16869,35302318.0,16080843.0,19221475.0,279,118,161,29785,13924,15861,33678238.0,15516342.0,18161896.0,111.48,113.95,111.44,114.51
2023-09-22 11:00,474,214,260,35470,16553,18917,40098808.0,18519038.0,21579770.0,374,148,226,33355,15042,18313,37640632.0,16724401.0,20916231.0,111.88,114.08,111.18,114.22
2023-09-22 11:05,278,161,117,21102,11107,9995,23962234.0,12442630.0,11519604.0,224,139,85,20112,10727,9385,22816924.0,12010181.0,10806743.0,112.03,115.25,111.96,115.15
2023-09-22 11:10,217,94,123,17290,8210,9080,19554154.0,9183601.0,10370553.0,198,99,99,15924,7954,7970,18026891.0,8876274.0,9150616.0,111.86,114.21,111.6,114.81
2023-09-22 11:15,160,69,91,12121,5647,6474,13731336.0,6300605.0,7430730.0,139,54,85,12676,5706,6970,14424851.0,6367239.0,8057611.0,111.57,114.78,111.59,115.6
2023-09-22 11:20,137,79,58,11015,5706,5309,12540374.0,6430998.0,6109376.0,103,62,41,10514,5663,4851,11915919.0,6334036.0,5581883.0,112.71,115.08,111.85,115.07
2023-09-22 11:25,211,90,121,18487,8881,9606,20998595.0,9944599.0,11053996.0,187,78,109,18236,8793,9443,20713572.0,9840466.0,10873106.0,111.98,115.07,111.91,115.14
2023-09-22 11:30,120,59,61,10337,4648,5689,11747885.0,5202826.0,6545059.0,102,48,54,9462,4461,5001,10765963.0,4996233.0,5769730.0,111.94,115.05,112.0,115.37
2023-09-22 11:35,134,68,66,11162,5605,5557,12693410.0,6289601.0,6403808.0,115,57,58,10364,5000,5364,11762247.0,5595116.0,6167131.0,112.21,115.24,111.9,114.97
2023-09-22 11:40,154,99,55,14387,8021,6366,16371134.0,9018599.0,7352534.0,138,92,46,12825,6839,5986,14575447.0,7672723.0,6902723.0,112.44,115.5,112.19,115.31
2023-09-22 11:45,391,279,112,24253,14026,10227,27531725.0,15768984.0,11762741.0,359,260,99,24306,14198,10108,27607541.0,15983536.0,11624004.0,112.43,115.02,112.58,115.0
2023-09-22 11:50,451,135,316,34917,12738,22179,39683406.0,14280965.0,25402441.0,417,121,296,34253,12551,21702,38906273.0,14049300.0,24856973.0,112.11,114.53,111.94,114.54
2023-09-22 11:55,186,50,136,13816,5565,8251,15556874.0,6207164.0,9349710.0,146,43,103,12517,5237,7280,14176018.0,5839996.0,8336022.0,111.54,113.32,111.51,114.51
2023-09-22 12:00,495,289,206,38029,19395,18634,42790786.0,21531312.0,21259474.0,408,237,171,36385,18468,17917,40989974.0,20521926.0,20468048.0,111.01,114.09,111.12,114.24
2023-09-22 12:05,439,211,228,37568,18282,19286,42229145.0,20259586.0,21969559.0,349,164,185,36732,18073,18659,41307536.0,20018091.0,21289445.0,110.82,113.91,110.76,114.1
2023-09-22 12:10,372,181,191,32570,15728,16842,36721671.0,17463919.0,19257752.0,323,146,177,31564,14962,16602,35619082.0,16621795.0,18997287.0,111.04,114.34,111.09,114.43
2023-09-22 12:15,152,75,77,11778,5861,5917,13327228.0,6534161.0,6793066.0,127,56,71,11231,5509,5722,12698647.0,6136314.0,6562332.0,111.49,114.81,111.39,114.69
2023-09-22 12:20,326,158,168,26585,12206,14379,30390470.0,13671979.0,16718490.0,272,112,160,24571,11377,13194,27875947.0,12715812.0,15160134.0,112.01,116.27,111.77,114.9
2023-09-22 12:25,75,49,26,4516,2367,2149,5136660.0,2668818.0,2467842.0,61,38,23,5097,2140,2957,5812460.0,2399122.0,3413338.0,112.75,114.84,112.11,115.43
2023-09-22 12:30,618,218,400,45827,19185,26642,51660716.0,21365909.0,30294806.0,540,180,360,43886,18627,25259,49610809.0,20740631.0,28870177.0,111.37,113.71,111.35,114.3
2023-09-22 12:35,171,82,89,15240,7432,7808,17207766.0,8282230.0,8925536.0,142,64,78,14511,6987,7524,16403032.0,7778602.0,8624429.0,111.44,114.31,111.33,114.63
2023-09-22 12:40,142,80,62,7152,3689,3463,8126879.0,4153450.0,3973428.0,83,44,39,7487,3465,4022,8664467.0,3848377.0,4816090.0,112.59,114.74,111.06,119.74
2023-09-22 12:45,93,38,55,7606,3643,3963,8583110.0,4065351.0,4517758.0,110,47,63,7633,3596,4037,8645790.0,4012118.0,4633672.0,111.59,114.0,111.57,114.78
2023-09-22 12:50,110,56,54,8637,4475,4162,9760680.0,4990970.0,4769709.0,88,41,47,8152,4131,4021,9210063.0,4597915.0,4612148.0,111.53,114.6,111.3,114.7
2023-09-22 12:55,198,98,100,19782,9694,10088,22353995.0,10809659.0,11544336.0,167,82,85,20381,10189,10192,22942666.0,11250407.0,11692259.0,111.51,114.44,110.42,114.72
2023-09-22 13:00,112,56,56,9828,4876,4952,11119870.0,5441496.0,5678374.0,84,42,42,9406,4582,4824,10640287.0,5107782.0,5532505.0,111.6,114.67,111.47,114.69
2023-09-22 13:05,156,91,65,15713,9402,6311,17784801.0,10541784.0,7243017.0,161,96,65,15406,9058,6348,17434972.0,10150810.0,7284162.0,112.12,114.77,112.06,114.75
2023-09-22 13:10,203,102,101,19443,10862,8581,22015716.0,12164764.0,9850952.0,182,89,93,19095,10370,8725,21642057.0,11623798.0,10018259.0,111.99,114.8,112.09,114.82
2023-09-22 13:15,380,206,174,34209,20520,13689,39038937.0,23246438.0,15792498.0,308,176,132,30309,18469,11840,34549748.0,20864866.0,13684881.0,113.29,115.37,112.97,115.58
2023-09-22 13:20,478,194,284,38436,17489,20947,43548177.0,19569138.0,23979039.0,442,182,260,38411,18033,20378,43562077.0,20198620.0,23363457.0,111.89,114.47,112.01,114.65
2023-09-22 13:25,1676,114,1562,91040,15696,75344,103364675.0,17512806.0,85851868.0,1650,106,1544,90932,15681,75251,103261107.0,17502804.0,85758302.0,111.57,113.95,111.62,113.96
2023-09-22 13:30,305,35,270,15722,2921,12801,17826122.0,3264777.0,14561344.0,284,26,258,15273,2784,12489,17343876.0,3109000.0,14234876.0,111.77,113.75,111.67,113.98
2023-09-22 13:35,64,26,38,5038,2356,2682,5678310.0,2627885.0,3050425.0,51,18,33,4708,2212,2496,5332168.0,2469277.0,2862891.0,111.54,113.74,111.63,114.7
2023-09-22 13:40,85,32,53,8802,3735,5067,9956224.0,4162495.0,5793729.0,79,32,47,8445,3730,4715,9573169.0,4161136.0,5412032.0,111.45,114.34,111.56,114.78
2023-09-22 13:45,122,56,66,10557,5046,5511,11947339.0,5634527.0,6312812.0,99,39,60,9980,4614,5366,11291373.0,5143560.0,6147812.0,111.66,114.55,111.48,114.57
2023-09-22 13:50,74,27,47,7879,3719,4160,8894050.0,4164595.0,4729455.0,66,26,40,7609,3632,3977,8616998.0,4051813.0,4565185.0,111.98,113.69,111.56,114.79
2023-09-22 13:55,57,28,29,4532,2256,2276,5126597.0,2516593.0,2610004.0,48,21,27,4391,2119,2272,4967163.0,2361790.0,2605372.0,111.55,114.68,111.46,114.67
2023-09-22 14:00,61,27,34,4789,2197,2592,5435018.0,2464527.0,2970491.0,49,20,29,4511,2023,2488,5106089.0,2254693.0,2851396.0,112.18,114.6,111.45,114.61
2023-09-22 14:05,83,40,43,8508,4114,4394,9634027.0,4592179.0,5041848.0,74,35,39,8573,4190,4383,9702814.0,4673953.0,5028861.0,111.62,114.74,111.55,114.74
2023-09-22 14:10,74,23,51,5643,2497,3146,6391181.0,2787122.0,3604058.0,63,20,43,5511,2476,3035,6241944.0,2762191.0,3479753.0,111.62,114.56,111.56,114.65
2023-09-22 14:15,72,32,40,4720,2178,2542,5345212.0,2430490.0,2914722.0,58,23,35,4696,2160,2536,5317699.0,2409754.0,2907944.0,111.59,114.66,111.56,114.67
2023-09-22 14:20,34,20,14,2265,1384,881,2558200.0,1541216.0,1016983.0,26,13,13,2214,1293,921,2496971.0,1433416.0,1063555.0,111.36,115.44,110.86,115.48
2023-09-22 14:25,70,26,44,5249,2164,3085,5981680.0,2437796.0,3543884.0,61,21,40,4693,1963,2730,5343206.0,2193140.0,3150065.0,112.65,114.87,111.72,115.39
2023-09-22 14:30,117,56,61,10177,4157,6020,11572911.0,4664740.0,6908171.0,80,32,48,9404,3897,5507,10659370.0,4351793.0,6307577.0,112.21,114.75,111.67,114.54
2023-09-22 14:35,48,19,29,3016,1367,1649,3419700.0,1532610.0,1887089.0,34,11,23,2468,1106,1362,2798908.0,1236148.0,1562759.0,112.11,114.44,111.77,114.74
2023-09-22 14:40,75,30,45,5155,2680,2475,5811642.0,2986968.0,2824674.0,58,20,38,4734,2253,2481,5345266.0,2503357.0,2841909.0,111.45,114.13,111.11,114.55
2023-09-22 14:45,49,18,31,2956,1481,1475,3338322.0,1657884.0,1680438.0,42,13,29,2893,1475,1418,3275304.0,1651564.0,1623739.0,111.94,113.93,111.97,114.51
2023-09-22 14:50,46,21,25,3819,1990,1829,4325071.0,2224468.0,2100602.0,44,21,23,4337,2474,1863,4909961.0,2771243.0,2138718.0,111.78,114.85,112.01,114.8
2023-09-22 14:55,253,49,204,16885,4815,12070,19210873.0,5438332.0,13772540.0,238,38,200,15973,4001,11972,18133677.0,4473541.0,13660135.0,112.95,114.11,111.81,114.1
2023-09-22 15:00,235,43,192,16556,4739,11817,18829971.0,5296791.0,13533180.0,215,38,177,15568,5412,10156,17661264.0,6054761.0,11606503.0,111.77,114.52,111.88,114.28
2023-09-22 15:05,1060,237,823,54658,12919,41739,62032631.0,14541071.0,47491560.0,1041,222,819,54026,12364,41662,61311004.0,13879054.0,47431949.0,112.56,113.78,112.25,113.85
2023-09-22 15:10,241,62,179,17037,6189,10848,19329530.0,6934457.0,12395072.0,233,64,169,17375,6745,10630,19720542.0,7561755.0,12158787.0,112.04,114.26,112.11,114.38
2023-09-22 15:15,1647,717,930,100244,36290,63954,113736808.0,40649383.0,73087424.0,1636,712,924,99948,36054,63894,113400520.0,40377176.0,73023344.0,112.01,114.28,111.99,114.29
2023-09-22 15:20,266,68,198,21668,7546,14122,24587224.0,8447687.0,16139536.0,246,53,193,21593,7570,14023,24517350.0,8474201.0,16043148.0,111.95,114.29,111.94,114.41
2023-09-22 15:25,662,86,576,47234,11710,35524,53651887.0,13096852.0,40555035.0,656,85,571,47283,11785,35498,53707932.0,13182509.0,40525422.0,111.84,114.16,111.86,114.16
2023-09-22 15:30,442,133,309,37256,13245,24011,42128188.0,14788880.0,27339308.0,390,107,283,36202,13057,23145,41017787.0,14566426.0,26451360.0,111.66,113.86,111.56,114.29
2023-09-22 15:35,194,80,114,18737,9483,9254,20988483.0,10570786.0,10417697.0,163,60,103,16677,7971,8706,18815498.0,8862656.0,9952841.0,111.47,112.58,111.19,114.32
2023-09-22 15:40,195,89,106,20899,11073,9826,23615244.0,12382864.0,11232380.0,151,62,89,19092,10870,8222,21565095.0,12152920.0,9412175.0,111.83,114.31,111.8,114.48
2023-09-22 15:45,199,103,96,15076,7214,7862,17191879.0,8065494.0,9126384.0,154,76,78,13925,6488,7437,15786069.0,7227605.0,8558464.0,111.8,116.08,111.4,115.08
2023-09-22 15:50,154,73,81,12374,6207,6167,13995448.0,6938375.0,7057072.0,130,52,78,11815,5732,6083,13349145.0,6384915.0,6964230.0,111.78,114.43,111.39,114.49
2023-09-22 15:55,64,30,34,5569,2844,2725,6276875.0,3179876.0,3096999.0,59,26,33,5891,3034,2857,6660193.0,3387194.0,3272998.0,111.81,113.65,111.64,114.56
2023-09-22 16:00,270,67,203,19993,6419,13574,22682910.0,7186681.0,15496228.0,246,54,192,19677,6414,13263,22332927.0,7177472.0,15155454.0,111.96,114.16,111.9,114.27
2023-09-22 16:05,262,121,141,21590,9894,11696,24525420.0,11106938.0,13418482.0,214,94,120,20740,9403,11337,23541137.0,10543861.0,12997276.0,112.26,114.73,112.13,114.64
2023-09-22 16:10,79,37,42,5910,2562,3348,6729190.0,2871897.0,3857292.0,64,30,34,6067,2523,3544,6905783.0,2825798.0,4079985.0,112.1,115.21,112.0,115.12
2023-09-22 16:15,105,34,71,9945,4315,5630,11310136.0,4830512.0,6479624.0,91,30,61,9807,4317,5490,11144096.0,4820970.0,6323126.0,111.95,115.09,111.67,115.18
2023-09-22 16:20,99,45,54,7619,3568,4051,8716557.0,4035150.0,4681407.0,78,30,48,6983,3091,3892,7984596.0,3469883.0,4514713.0,113.09,115.56,112.26,116.0
2023-09-22 16:25,96,39,57,9777,4093,5684,11158914.0,4589281.0,6569633.0,85,36,49,9761,4089,5672,11140122.0,4580567.0,6559555.0,112.13,115.58,112.02,115.65
2023-09-22 16:30,119,58,61,12132,5616,6516,13744910.0,6301209.0,7443701.0,100,47,53,11716,5373,6343,13306990.0,6013511.0,7293479.0,112.2,114.24,111.92,114.98
2023-09-22 16:35,146,68,78,14915,7593,7322,16929239.0,8504928.0,8424310.0,135,62,73,14382,6987,7395,16325308.0,7818162.0,8507145.0,112.01,115.05,111.9,115.04
2023-09-22 16:40,153,90,63,14393,7644,6749,16335568.0,8563265.0,7772303.0,136,79,57,13791,7309,6482,15635701.0,8173423.0,7462277.0,112.03,115.16,111.83,115.12
2023-09-22 16:45,50,22,28,3734,1816,1918,4244171.0,2039808.0,2204362.0,39,20,19,3424,1507,1917,3891531.0,1687434.0,2204097.0,112.32,114.93,111.97,114.98
2023-09-22 16:50,110,52,58,9060,4399,4661,10285758.0,4939971.0,5345786.0,88,40,48,9427,4488,4939,10703864.0,5025591.0,5678272.0,112.3,114.69,111.98,114.97
2023-09-22 16:55,115,59,56,9274,4540,4734,10495944.0,5088822.0,5407121.0,81,35,46,8683,4171,4512,9887934.0,4668834.0,5219100.0,112.09,114.22,111.94,115.67
2023-09-22 17:00,130,73,57,11635,6314,5321,13224240.0,7099564.0,6124676.0,129,75,54,11546,5989,5557,13204688.0,6718970.0,6485717.0,112.44,115.1,112.19,116.71
2023-09-22 17:05,126,70,56,10732,5726,5006,12234132.0,6469504.0,5764628.0,116,62,54,11019,5675,5344,12535495.0,6373244.0,6162250.0,112.98,115.15,112.3,115.31
2023-09-22 17:10,560,108,452,33507,8263,25244,37973433.0,9236403.0,28737030.0,505,79,426,31038,7778,23260,35212313.0,8681249.0,26531064.0,111.78,113.84,111.61,114.06
2023-09-22 17:15,345,57,288,20707,5072,15635,23469734.0,5667029.0,17802705.0,329,42,287,20345,4841,15504,23055661.0,5399443.0,17656218.0,111.73,113.86,111.54,113.88
2023-09-22 17:20,1045,28,1017,51101,2491,48610,58014521.0,2785289.0,55229232.0,1030,20,1010,51508,2547,48961,58492707.0,2843413.0,55649293.0,111.81,113.62,111.64,113.66
2023-09-22 17:25,922,90,832,65728,15932,49796,74498649.0,17774571.0,56724077.0,912,86,826,65092,15685,49407,73782590.0,17497784.0,56284805.0,111.57,113.91,111.56,113.92
2023-09-22 17:30,62,29,33,4981,2328,2653,5610256.0,2597943.0,3012312.0,49,17,32,4875,2287,2588,5515942.0,2549701.0,2966241.0,111.6,113.54,111.49,114.62
2023-09-22 17:35,37,20,17,2321,1111,1210,2630767.0,1244475.0,1386291.0,27,10,17,2228,1015,1213,2521311.0,1131361.0,1389949.0,112.01,114.57,111.46,114.59
2023-09-22 17:40,119,39,80,11225,4253,6972,12724922.0,4753144.0,7971778.0,93,25,68,8884,3538,5346,10067358.0,3941981.0,6125377.0,111.76,114.34,111.42,114.58
2023-09-22 17:45,92,42,50,8026,3138,4888,9156847.0,3540425.0,5616421.0,66,22,44,7188,2710,4478,8169269.0,3017738.0,5151531.0,112.82,114.9,111.36,115.04
2023-09-22 17:50,178,82,96,17242,8922,8320,19443648.0,9961902.0,9481746.0,148,63,85,16932,8802,8130,19129021.0,9815522.0,9313499.0,111.66,113.96,111.51,114.56
2023-09-22 17:55,316,215,101,26157,16106,10051,29836106.0,18286245.0,11549861.0,276,191,85,24668,14754,9914,27999861.0,16560267.0,11439594.0,113.54,114.91,112.24,115.39
2023-09-22 18:00,648,150,498,52486,17534,34952,59390302.0,19554874.0,39835428.0,596,124,472,50977,16303,34674,57696351.0,18168148.0,39528203.0,111.53,113.97,111.44,114.0
2023-09-22 18:05,348,124,224,31139,12379,18760,35033528.0,13726789.0,21306739.0,272,85,187,28310,10446,17864,31930184.0,11617187.0,20312996.0,110.89,113.58,111.21,113.71
2023-09-22 18:10,576,323,253,46560,23979,22581,52371303.0,26685686.0,25685616.0,511,283,228,44140,22702,21438,49698531.0,25252284.0,24446247.0,111.29,113.75,111.23,114.03
2023-09-22 18:15,880,599,281,58064,37142,20922,65391910.0,41580188.0,23811722.0,835,580,255,57294,36385,20909,64576331.0,40725686.0,23850645.0,111.95,113.81,111.93,114.07
2023-09-22 18:20,764,447,317,57463,33478,23985,64855273.0,37526012.0,27329261.0,704,410,294,57116,33303,23813,64413316.0,37270192.0,27143124.0,112.09,113.94,111.91,113.98
2023-09-22 18:25,948,831,117,61364,46731,14633,69238864.0,52414399.0,16824464.0,921,811,110,59805,46217,13588,67468940.0,51836294.0,15632646.0,112.16,114.98,112.16,115.05
2023-09-22 18:30,354,273,81,21189,15150,6039,23823830.0,16986995.0,6836835.0,295,237,58,19499,14664,4835,21947358.0,16438542.0,5508816.0,112.13,113.21,112.1,113.94
2023-09-22 18:35,146,61,85,4836,1659,3177,5390806.0,1890196.0,3500609.0,101,27,74,3252,604,2648,3669375.0,672152.0,2997223.0,113.94,110.19,111.28,113.19
2023-09-25 10:00,1398,443,955,51631,14939,36692,59243229.0,15170392.0,44072836.0,450,180,270,19882,2518,17364,22544512.0,2821680.0,19722832.0,101.55,120.12,112.06,113.58
2023-09-25 10:05,651,188,463,23505,5622,17883,26691009.0,6308959.0,20382049.0,535,125,410,19809,3967,15842,22360546.0,4450884.0,17909662.0,112.22,113.97,112.2,113.05
2023-09-25 10:10,658,511,147,28240,23152,5088,31900789.0,26056817.0,5843971.0,560,467,93,25600,22586,3014,28814026.0,25385411.0,3428614.0,112.55,114.86,112.39,113.76
2023-09-25 10:15,291,198,93,8144,5093,3051,14183166.0,5727358.0,8455808.0,187,131,56,3513,2582,931,3961534.0,2901714.0,1059819.0,112.46,277.15,112.38,113.84
2023-09-25 10:20,296,166,130,19237,8963,10274,21778847.0,9989734.0,11789113.0,221,128,93,17791,8168,9623,20115351.0,9100251.0,11015100.0,111.46,114.75,111.41,114.47
2023-09-25 10:25,493,240,253,23374,11823,11551,26697203.0,13319576.0,13377627.0,205,104,101,19468,9048,10420,22125046.0,10116575.0,12008471.0,112.66,115.81,111.81,115.24
2023-09-25 10:30,295,128,167,24565,10773,13792,27880529.0,12063886.0,15816643.0,249,107,142,24320,11226,13094,27649157.0,12567878.0,15081279.0,111.98,114.68,111.95,115.18
2023-09-25 10:35,226,81,145,13924,6246,7678,15718914.0,6987256.0,8731658.0,177,61,116,11917,5639,6278,13515424.0,6303116.0,7212308.0,111.87,113.72,111.78,114.88
2023-09-25 10:40,464,278,186,37449,19001,18448,42476536.0,21288851.0,21187684.0,394,243,151,34265,16859,17406,38847799.0,18844665.0,20003134.0,112.04,114.85,111.78,114.92
2023-09-25 10:45,308,160,148,25217,12435,12782,28676417.0,13959626.0,14716790.0,231,122,109,23121,11522,11599,26245930.0,12914521.0,13331409.0,112.26,115.14,112.09,114.94
2023-09-25 10:50,394,212,182,31557,15728,15829,36055821.0,17756317.0,18299504.0,303,164,139,28929,14260,14669,32914340.0,16000939.0,16913400.0,112.9,115.61,112.21,115.3
2023-09-25 10:55,228,108,120,19867,9825,10042,22617093.0,11015961.0,11601131.0,191,93,98,19709,10818,8891,22374674.0,12118878.0,10255796.0,112.12,115.53,112.03,115.35
2023-09-25 11:00,1284,136,1148,62019,13565,48454,70296536.0,15075310.0,55221225.0,1227,99,1128,59086,11341,47745,66970720.0,12557026.0,54413693.0,111.13,113.97,110.72,113.97
2023-09-25 11:05,298,206,92,21449,13253,8196,24357922.0,14951173.0,9406749.0,217,158,59,18401,10551,7850,20901873.0,11854863.0,9047010.0,112.81,114.77,112.36,115.25
2023-09-25 11:10,1112,719,393,91101,47532,43569,104876055.0,54353632.0,50522422.0,751,529,222,71585,38333,33252,82112845.0,43427000.0,38685845.0,114.35,115.96,113.29,116.34
2023-09-25 11:15,305,182,123,27104,13505,13599,31187567.0,15403201.0,15784366.0,232,149,83,24844,13509,11335,28439609.0,15280390.0,13159219.0,114.06,116.07,113.11,116.09
2023-09-25 11:20,288,179,109,23902,11225,12677,27638205.0,12838442.0,14799762.0,212,137,75,22023,10804,11219,25265721.0,12239387.0,13026334.0,114.37,116.74,113.29,116.11
2023-09-25 11:25,250,168,82,18818,9768,9050,21634909.0,11128852.0,10506057.0,191,140,51,17626,9058,8568,20225560.0,10265369.0,9960191.0,113.93,116.09,113.33,116.25
2023-09-25 11:30,169,100,69,11485,5606,5879,13161570.0,6358787.0,6802782.0,111,73,38,10322,5332,4990,11843494.0,6037846.0,5805648.0,113.43,115.71,113.24,116.35
2023-09-25 11:35,301,160,141,24099,12477,11622,27539138.0,14418681.0,13120456.0,212,109,103,19589,9251,10338,22432974.0,10453633.0,11979341.0,115.56,112.89,113.0,115.88
2023-09-25 11:40,1496,849,647,120335,63005,57330,140108658.0,72964152.0,67144506.0,937,563,374,94628,49677,44951,109774985.0,56920693.0,52854292.0,115.81,117.12,114.58,117.58
2023-09-25 11:45,882,535,347,72702,36883,35819,85186288.0,42920075.0,42266213.0,669,428,241,66180,33686,32494,76977992.0,38670782.0,38307209.0,116.37,118.0,114.8,117.89
2023-09-25 11:50,988,671,317,65831,39399,26432,76475877.0,45391023.0,31084854.0,836,617,219,61946,39111,22835,71875772.0,44986036.0,26889736.0,115.21,117.6,115.02,117.76
2023-09-25 11:55,638,414,224,50046,27256,22790,57944788.0,31259597.0,26685191.0,590,391,199,49195,26520,22675,56998953.0,30398988.0,26599964.0,114.69,117.09,114.63,117.31
2023-09-25 12:00,209,122,87,18695,10325,8370,21661681.0,11855401.0,9806279.0,150,95,55,14266,7673,6593,16517820.0,8767462.0,7750357.0,114.82,117.16,114.26,117.55
2023-09-25 12:05,166,99,67,10428,5744,4684,12170384.0,6691406.0,5478978.0,108,72,36,9205,5263,3942,10644061.0,6012318.0,4631743.0,116.49,116.97,114.24,117.5
2023-09-25 12:10,138,64,74,11582,5462,6120,13347481.0,6234526.0,7112955.0,101,50,51,10347,5168,5179,11965745.0,5890070.0,6075674.0,114.14,116.22,113.97,117.31
2023-09-25 12:15,173,89,84,14227,7570,6657,16417370.0,8641078.0,7776292.0,130,72,58,14812,8254,6558,17110941.0,9428609.0,7682332.0,114.15,116.81,114.23,117.14
2023-09-25 12:20,114,64,50,8277,4130,4147,9586335.0,4737609.0,4848725.0,89,50,39,8602,4619,3983,9941554.0,5280422.0,4661132.0,114.71,116.92,114.32,117.03
2023-09-25 12:25,283,157,126,22268,11165,11103,25803691.0,12884611.0,12919080.0,240,128,112,20547,10222,10325,23692551.0,11627013.0,12065537.0,115.4,116.36,113.74,116.86
2023-09-25 12:30,190,117,73,13903,7536,6367,16130167.0,8644030.0,7486136.0,145,92,53,12580,6799,5781,14527505.0,7756839.0,6770666.0,114.7,117.58,114.09,117.12
2023-09-25 12:35,394,235,159,28527,14826,13701,32903130.0,16929572.0,15973557.0,333,211,122,27087,14168,12919,31306674.0,16168982.0,15137691.0,114.19,116.59,114.12,117.17
2023-09-25 12:40,269,140,129,22499,11264,11235,25779295.0,12647523.0,13131771.0,252,139,113,21229,10281,10948,24505122.0,11696298.0,12808824.0,112.28,116.88,113.77,117.0
2023-09-25 12:45,252,123,129,21489,9939,11550,24850403.0,11347850.0,13502553.0,216,102,114,21554,9647,11907,24865620.0,10967228.0,13898391.0,114.17,116.91,113.69,116.72
2023-09-25 12:50,164,79,85,12028,5998,6030,13872054.0,6824479.0,7047575.0,137,62,75,11313,5618,5695,13048319.0,6388374.0,6659944.0,113.78,116.88,113.71,116.94
2023-09-25 12:55,173,81,92,13290,6439,6851,15191111.0,7329567.0,7861543.0,116,63,53,12600,6485,6115,14504622.0,7355613.0,7149008.0,113.83,114.75,113.43,116.91
2023-09-25 13:00,314,183,131,26825,13687,13138,30910513.0,15596494.0,15314018.0,251,152,99,25951,13294,12657,29896499.0,15108680.0,14787818.0,113.95,116.56,113.65,116.84
2023-09-25 13:05,289,122,167,21266,9620,11646,24388262.0,10891910.0,13496352.0,226,100,126,19708,8847,10861,22717900.0,10013587.0,12704312.0,113.22,115.89,113.19,116.97
2023-09-25 13:10,115,65,50,6577,3300,3277,7521109.0,3727106.0,3794003.0,65,39,26,4967,2681,2286,5682494.0,3027889.0,2654605.0,112.94,115.78,112.94,116.12
2023-09-25 13:15,113,61,52,10792,5580,5212,12310437.0,6268286.0,6042151.0,93,46,47,10493,5092,5401,12008372.0,5739577.0,6268795.0,112.33,115.93,112.72,116.07
2023-09-25 13:20,127,59,68,9804,4672,5132,11195566.0,5267383.0,5928182.0,94,44,50,9572,4638,4934,10949155.0,5223653.0,5725501.0,112.74,115.51,112.63,116.04
2023-09-25 13:25,136,74,62,12614,6320,6294,14431431.0,7190504.0,7240927.0,104,60,44,11314,5794,5520,12912283.0,6522400.0,6389882.0,113.77,115.04,112.57,115.76
2023-09-25 13:30,56,28,28,4038,2145,1893,4636141.0,2444955.0,2191186.0,33,13,20,3479,1654,1825,3974005.0,1860779.0,2113225.0,113.98,115.75,112.5,115.79
2023-09-25 13:35,89,48,41,7482,3701,3781,8541341.0,4178199.0,4363141.0,68,35,33,7339,3726,3613,8382633.0,4195922.0,4186711.0,112.89,115.4,112.61,115.88
2023-09-25 13:40,152,111,41,13865,7890,5975,15937368.0,9003948.0,6933419.0,121,82,39,12722,6876,5846,14523936.0,7744167.0,6779768.0,114.12,116.04,112.63,115.97
2023-09-25 13:45,64,38,26,4651,2352,2299,5332400.0,2669335.0,2663064.0,47,30,17,4694,2638,2056,5369350.0,2983613.0,2385737.0,113.49,115.84,113.1,116.04
2023-09-25 13:50,94,52,42,8451,4556,3895,9659174.0,5146141.0,4513033.0,70,43,27,8003,4191,3812,9153927.0,4729948.0,4423979.0,112.95,115.87,112.86,116.05
2023-09-25 13:55,291,155,136,26008,12591,13417,29584779.0,14196120.0,15388658.0,249,130,119,25122,12433,12689,28717972.0,14005152.0,14712820.0,112.75,114.7,112.64,115.95
2023-09-25 14:00,113,64,49,10762,5508,5254,12314353.0,6216240.0,6098113.0,102,62,40,10488,5324,5164,11994100.0,6001424.0,5992676.0,112.86,116.07,112.72,116.05
2023-09-25 14:05,70,38,32,6083,3235,2848,6949601.0,3649456.0,3300144.0,59,33,26,6092,3255,2837,6948376.0,3660558.0,3287818.0,112.81,115.88,112.46,115.89
2023-09-25 14:10,151,96,55,10944,5830,5114,12523463.0,6586770.0,5936692.0,141,92,49,10688,5882,4806,12216121.0,6644573.0,5571547.0,112.98,116.09,112.96,115.93
2023-09-25 14:15,67,40,27,6250,3118,3132,7159897.0,3532783.0,3627114.0,58,36,22,6417,3264,3153,7324648.0,3669773.0,3654874.0,113.3,115.81,112.43,115.92
2023-09-25 14:20,62,39,23,4466,2503,1963,5109792.0,2832976.0,2276815.0,52,36,16,3929,2084,1845,4492266.0,2351595.0,2140670.0,113.18,115.99,112.84,116.03
2023-09-25 14:25,63,39,24,4363,2211,2152,5007611.0,2503544.0,2504066.0,44,27,17,3969,2035,1934,4541734.0,2297648.0,2244086.0,113.23,116.36,112.91,116.03
2023-09-25 14:30,158,105,53,11980,5964,6016,13812024.0,6822436.0,6989587.0,124,81,43,11166,5736,5430,12811637.0,6495432.0,6316205.0,114.39,116.18,113.24,116.32
2023-09-25 14:35,268,169,99,25882,13386,12496,29886566.0,15305927.0,14580639.0,216,141,75,24865,12771,12094,28586766.0,14475564.0,14111201.0,114.34,116.68,113.35,116.68
2023-09-25 14:40,902,865,37,39143,35850,3293,45009678.0,41163267.0,3846410.0,859,838,21,37700,34957,2743,43288776.0,40082657.0,3206118.0,114.82,116.81,114.66,116.88
2023-09-25 14:45,1123,1100,23,48832,46426,2406,56070124.0,53258227.0,2811896.0,1107,1094,13,48509,46307,2202,55678042.0,53105100.0,2572941.0,114.72,116.87,114.68,116.85
2023-09-25 14:50,1298,1280,18,55690,53690,2000,63924947.0,61589676.0,2335271.0,1290,1277,13,55780,53806,1974,64018011.0,61713971.0,2304039.0,114.71,116.76,114.7,116.72
2023-09-25 14:55,386,341,45,17690,14428,3262,20304255.0,16515137.0,3789118.0,351,323,28,16738,13935,2803,19219801.0,15951708.0,3268093.0,114.47,116.16,114.47,116.59
2023-09-25 15:00,55,33,22,2390,1087,1303,2746458.0,1235520.0,1510938.0,42,24,18,2259,922,1337,2594995.0,1046577.0,1548418.0,113.66,115.96,113.51,115.81
2023-09-25 15:05,53,33,20,3559,1755,1804,4064875.0,1994634.0,2070241.0,43,28,15,3038,1496,1542,3495591.0,1695728.0,1799863.0,113.65,114.76,113.35,116.72
2023-09-25 15:10,68,40,28,4384,1848,2536,5047768.0,2105732.0,2942036.0,45,29,16,3184,1661,1523,3656194.0,1881821.0,1774373.0,113.95,116.01,113.29,116.51
2023-09-25 15:15,38,21,17,2599,1272,1327,2988589.0,1441721.0,1546867.0,28,16,12,2432,1185,1247,2795815.0,1343793.0,1452021.0,113.34,116.57,113.4,116.44
2023-09-25 15:20,55,37,18,3558,1878,1680,4078092.0,2133095.0,1944997.0,39,26,13,3367,1650,1717,3875914.0,1869912.0,2006001.0,113.58,115.77,113.33,116.83
2023-09-25 15:25,54,29,25,2925,1496,1429,3387566.0,1745821.0,1641745.0,38,24,14,2678,1500,1178,3071758.0,1698760.0,1372998.0,116.7,114.89,113.25,116.55
2023-09-25 15:30,41,25,16,3578,1241,2337,4200950.0,1406602.0,2794348.0,34,22,12,2429,1277,1152,2788612.0,1447215.0,1341397.0,113.34,119.57,113.33,116.44
2023-09-25 15:35,44,28,16,2179,1247,932,2520471.0,1436585.0,1083885.0,33,19,14,2480,1102,1378,2867161.0,1249919.0,1617242.0,115.2,116.3,113.42,117.36
2023-09-25 15:40,61,39,22,5323,2852,2471,6127237.0,3246358.0,2880879.0,51,31,20,6363,2741,3622,7340656.0,3106677.0,4233979.0,113.83,116.59,113.34,116.9
2023-09-25 15:45,126,71,55,10587,5390,5197,12143679.0,6118200.0,6025479.0,110,62,48,10053,4995,5058,11550146.0,5660557.0,5889589.0,113.51,115.94,113.32,116.44
2023-09-25 15:50,53,32,21,2055,759,1296,2366685.0,867264.0,1499421.0,35,20,15,1456,737,719,1671109.0,835402.0,835706.0,114.26,115.7,113.35,116.23
2023-09-25 15:55,67,38,29,4608,2658,1950,5286080.0,3029356.0,2256724.0,43,27,16,3358,1741,1617,3856169.0,1970498.0,1885671.0,113.97,115.73,113.18,116.62
2023-09-25 16:00,53,27,26,3136,1282,1854,3606710.0,1467928.0,2138782.0,33,20,13,2451,1197,1254,2819359.0,1357357.0,1462002.0,114.5,115.36,113.4,116.59
2023-09-25 16:05,328,186,142,29563,14528,15035,33947088.0,16444648.0,17502440.0,297,167,130,29021,14420,14601,33330438.0,16324641.0,17005797.0,113.19,116.41,113.21,116.47
2023-09-25 16:10,21,12,9,635,360,275,726958.0,408158.0,318800.0,21,14,7,931,366,565,1152881.0,414859.0,738022.0,113.38,115.93,113.35,130.62
2023-09-25 16:15,84,47,37,6231,2635,3596,7127344.0,2982129.0,4145214.0,63,40,23,4963,2423,2540,5665467.0,2722057.0,2943409.0,113.17,115.27,112.34,115.88
2023-09-25 16:20,174,96,78,16915,8831,8084,19330823.0,9974971.0,9355851.0,139,77,62,15849,7859,7990,18106975.0,8850572.0,9256403.0,112.95,115.73,112.62,115.85
2023-09-25 16:25,92,58,34,9104,4785,4319,10408977.0,5398944.0,5010033.0,89,59,30,9601,5297,4304,10975741.0,5983127.0,4992613.0,112.83,116.0,112.95,116.0
2023-09-25 16:30,253,146,107,24022,11005,13017,27469206.0,12426397.0,15042809.0,190,112,78,20157,10258,9899,23024121.0,11554596.0,11469525.0,112.92,115.56,112.64,115.87
2023-09-25 16:35,99,48,51,9118,3506,5612,10441627.0,4024144.0,6417483.0,72,39,33,8093,3009,5084,9221230.0,3382739.0,5838491.0,114.78,114.35,112.42,114.84
2023-09-25 16:40,134,80,54,12540,6536,6004,14267375.0,7362388.0,6904986.0,103,58,45,11322,5337,5985,12892817.0,5995988.0,6896829.0,112.64,115.01,112.35,115.24
2023-09-25 16:45,47,34,13,3390,1937,1453,3862159.0,2181899.0,1680259.0,30,17,13,3387,1733,1654,3863132.0,1948364.0,1914767.0,112.64,115.64,112.43,115.77
2023-09-25 16:50,90,54,36,10168,5474,4694,11597824.0,6168331.0,5429492.0,77,43,34,9785,5108,4677,11160730.0,5747975.0,5412755.0,112.68,115.67,112.53,115.73
2023-09-25 16:55,63,37,26,5701,3036,2665,6503285.0,3419107.0,3084177.0,53,30,23,5547,2642,2905,6351633.0,2973450.0,3378183.0,112.62,115.73,112.55,116.29
2023-09-25 17:00,157,108,49,13671,7149,6522,15681428.0,8108482.0,7572946.0,127,85,42,12686,6666,6020,14521069.0,7526547.0,6994521.0,113.42,116.11,112.91,116.19
2023-09-25 17:05,198,104,94,19109,9745,9364,21865302.0,11004107.0,10861195.0,189,112,77,19189,9938,9251,21959442.0,11221651.0,10737791.0,112.92,115.99,112.92,116.07
2023-09-25 17:10,255,99,156,18169,9297,8872,20797349.0,10497353.0,10299996.0,237,88,149,18210,9311,8899,20842217.0,10511140.0,10331077.0,112.91,116.1,112.89,116.09
2023-09-25 17:15,380,203,177,36772,18469,18303,42007737.0,20833370.0,21174366.0,347,186,161,36338,18357,17981,41578594.0,20704050.0,20874543.0,112.8,115.69,112.79,116.09
2023-09-25 17:20,325,155,170,32708,16189,16519,37464796.0,18279758.0,19185038.0,298,142,156,32848,16369,16479,37616584.0,18476107.0,19140477.0,112.91,116.14,112.87,116.15
2023-09-25 17:25,250,167,83,19206,9335,9871,22023325.0,10545272.0,11478052.0,220,146,74,18487,9073,9414,21181833.0,10248207.0,10933626.0,112.96,116.28,112.95,116.14
2023-09-25 17:30,214,110,104,20186,9977,10209,23066344.0,11253931.0,11812412.0,200,100,100,20064,9941,10123,22958048.0,11212353.0,11745694.0,112.8,115.71,112.79,116.03
2023-09-25 17:35,341,205,136,39286,25368,13918,44984841.0,28841276.0,16143565.0,301,186,115,38395,24932,13463,43975484.0,28340935.0,15634549.0,113.69,115.99,113.67,116.13
2023-09-25 17:40,158,106,52,18470,11817,6653,21223728.0,13439465.0,7784263.0,126,86,40,16888,11616,5272,19334070.0,13208587.0,6125483.0,113.73,117.0,113.71,116.19
2023-09-25 17:45,506,273,233,61750,37949,23801,70735437.0,43153155.0,27582282.0,454,251,203,61599,37706,23893,70561986.0,42873107.0,27688879.0,113.71,115.89,113.7,115.89
2023-09-25 17:50,245,110,135,19865,9261,10604,22586399.0,10442035.0,12144363.0,198,79,119,19379,8946,10433,22187462.0,10084210.0,12103252.0,112.75,114.53,112.72,116.01
2023-09-25 17:55,487,272,215,56287,32665,23622,64310378.0,37035640.0,27274737.0,419,240,179,55460,32288,23172,63370762.0,36601694.0,26769068.0,113.38,115.46,113.36,115.52
2023-09-25 18:00,143,67,76,9993,4758,5235,11392381.0,5357372.0,6035009.0,126,57,69,9747,4657,5090,11127733.0,5242532.0,5885201.0,112.6,115.28,112.57,115.62
2023-09-25 18:05,238,84,154,18812,8423,10389,21465985.0,9477203.0,11988781.0,210,70,140,18643,8280,10363,21277840.0,9311315.0,11966525.0,112.52,115.4,112.46,115.47
2023-09-25 18:10,590,296,294,79232,40974,38258,90547936.0,46512248.0,44035687.0,509,249,260,76277,39374,36903,87254798.0,44681563.0,42573235.0,113.52,115.1,113.48,115.37
2023-09-25 18:15,392,129,263,35137,18942,16195,40097424.0,21418878.0,18678545.0,338,102,236,34531,19268,15263,39401831.0,21784597.0,17617234.0,113.08,115.34,113.06,115.42
2023-09-25 18:20,218,80,138,19631,8696,10935,22383106.0,9770294.0,12612812.0,218,76,142,19662,8787,10875,22415735.0,9870668.0,12545067.0,112.35,115.34,112.33,115.36
2023-09-25 18:25,264,121,143,24536,12329,12207,28029653.0,13903280.0,14126372.0,244,114,130,24297,12125,12172,27758265.0,13668115.0,14090150.0,112.77,115.72,112.73,115.76
2023-09-25 18:30,76,46,30,7191,4012,3179,8220997.0,4535776.0,3685221.0,68,36,32,6598,3333,3265,7543630.0,3758565.0,3785064.0,113.06,115.92,112.77,115.93
2023-09-25 18:35,143,68,75,12935,5774,7161,14816102.0,6537607.0,8278494.0,133,70,63,12673,6014,6659,14472984.0,6749940.0,7723043.0,113.22,115.61,112.24,115.98
2023-09-26 10:00,1977,489,1488,77100,22383,54717,88468084.0,23547233.0,64920851.0,1081,194,887,46141,6410,39731,52958325.0,7304053.0,45654271.0,105.2,118.65,113.95,114.91
2023-09-26 10:05,1684,900,784,58828,27360,31468,66956664.0,31158543.0,35798120.0,1536,814,722,54519,25528,28991,62365027.0,29086276.0,33278751.0,113.88,113.76,113.94,114.79
2023-09-26 10:10,515,194,321,15938,2995,12943,22919994.0,3375088.0,19544905.0,416,144,272,17261,2357,14904,19933935.0,2657194.0,17276740.0,112.69,151.01,112.74,115.92
2023-09-26 10:15,549,187,362,23995,5839,18156,27405383.0,6561632.0,20843751.0,464,152,312,20411,4576,15835,23265038.0,5137947.0,18127090.0,112.38,114.8,112.28,114.47
2023-09-26 10:20,220,130,90,12126,6012,6114,13773609.0,6733178.0,7040431.0,121,67,54,11509,6408,5101,13044568.0,7172282.0,5872286.0,112.0,115.15,111.93,115.12
2023-09-26 10:25,103,53,50,7713,4061,3652,8774549.0,4542936.0,4231613.0,60,32,28,6686,3514,3172,7594768.0,3933145.0,3661622.0,111.87,115.87,111.93,115.44
2023-09-26 10:30,369,181,188,15075,7052,8023,17125818.0,7936261.0,9189557.0,116,58,58,13210,6602,6608,15029218.0,7401209.0,7628009.0,112.54,114.54,112.11,115.44
2023-09-26 10:35,153,90,63,11337,5968,5369,12892018.0,6694759.0,6197258.0,124,72,52,11393,5646,5747,12966783.0,6338780.0,6628003.0,112.18,115.43,112.27,115.33
2023-09-26 10:40,380,170,210,33436,15586,17850,37431909.0,17446231.0,19985677.0,278,112,166,29993,14223,15770,34069350.0,15916093.0,18153257.0,111.94,111.96,111.9,115.11
2023-09-26 10:45,314,190,124,26167,13120,13047,29707996.0,14766554.0,14941442.0,232,137,95,24660,12845,11815,27932870.0,14362454.0,13570416.0,112.55,114.52,111.81,114.86
2023-09-26 10:50,436,357,79,32506,22048,10458,36900308.0,24850821.0,12049487.0,420,351,69,32727,21826,10901,37134738.0,24580605.0,12554132.0,112.71,115.22,112.62,115.16
2023-09-26 10:55,1142,990,152,83066,58215,24851,94318798.0,65666401.0,28652396.0,1098,961,137,81489,57658,23831,92489803.0,65025830.0,27463972.0,112.8,115.3,112.78,115.24
2023-09-26 11:00,1077,881,196,71337,52889,18448,80944358.0,59774763.0,21169595.0,1034,868,166,70383,52403,17980,79868299.0,59221781.0,20646517.0,113.02,114.75,113.01,114.83
2023-09-26 11:05,457,81,376,30429,6624,23805,34567322.0,7411214.0,27156108.0,420,57,363,29764,6190,23574,33815317.0,6920834.0,26894483.0,111.88,114.08,111.81,114.09
2023-09-26 11:10,199,117,82,20303,10685,9618,23026152.0,11968645.0,11057507.0,145,83,62,18056,8874,9182,20478227.0,9924402.0,10553825.0,112.01,114.97,111.84,114.94
2023-09-26 11:15,262,89,173,19003,7077,11926,21396371.0,7909830.0,13486541.0,221,69,152,17868,6951,10917,20287908.0,7767329.0,12520579.0,111.77,113.09,111.74,114.69
2023-09-26 11:20,342,142,200,40110,20521,19589,44711217.0,22304746.0,22406470.0,302,119,183,39458,21737,17721,43745742.0,23406205.0,20339536.0,108.69,114.38,107.68,114.78
2023-09-26 11:25,222,115,107,17867,8621,9246,20087219.0,9567894.0,10519325.0,157,69,88,17549,8236,9313,19835502.0,9161992.0,10673510.0,110.98,113.77,111.24,114.61
2023-09-26 11:30,260,181,79,23514,12699,10815,26671522.0,14249459.0,12422063.0,209,144,65,22703,11952,10751,25710877.0,13366423.0,12344454.0,112.21,114.86,111.83,114.82
2023-09-26 11:35,2275,1140,1135,175677,91284,84393,201532036.0,104151056.0,97380980.0,1662,857,805,145223,76285,68938,165889915.0,86221561.0,79668353.0,114.1,115.39,113.03,115.57
2023-09-26 11:40,563,242,321,44586,17825,26761,50836427.0,20122279.0,30714147.0,442,170,272,41503,16661,24842,47247476.0,18712886.0,28534590.0,112.89,114.77,112.32,114.86
2023-09-26 11:45,899,560,339,64103,37944,26159,73263536.0,43019016.0,30244520.0,774,496,278,62638,36333,26305,71545058.0,41102365.0,30442693.0,113.38,115.62,113.13,115.73
2023-09-26 11:50,1024,795,229,58830,41462,17368,67235679.0,47129157.0,20106521.0,979,774,205,57705,41540,16165,65902378.0,47197329.0,18705049.0,113.67,115.77,113.62,115.71
2023-09-26 11:55,650,289,361,37519,19509,18010,42903890.0,22192597.0,20711292.0,600,269,331,35978,18973,17005,41171373.0,21540174.0,19631199.0,113.76,115.0,113.53,115.44
2023-09-26 12:00,468,187,281,36956,16501,20455,41812937.0,18504277.0,23308659.0,394,149,245,34261,15412,18849,38959930.0,17278206.0,21681724.0,112.14,113.95,112.11,115.03
2023-09-26 12:05,215,96,119,10973,5297,5676,12459463.0,5960643.0,6498819.0,161,61,100,9726,4804,4922,11035045.0,5380252.0,5654793.0,112.53,114.5,112.0,114.89
2023-09-26 12:10,450,294,156,29450,15630,13820,33715116.0,17612042.0,16103073.0,394,266,128,28050,15602,12448,31924942.0,17565419.0,14359522.0,112.68,116.52,112.58,115.36
2023-09-26 12:15,80,36,44,6525,3186,3339,7424624.0,3580712.0,3843912.0,53,21,32,6551,2896,3655,7460095.0,3248198.0,4211897.0,112.39,115.12,112.16,115.24
2023-09-26 12:20,152,101,51,9658,5281,4377,11069132.0,5975149.0,5093982.0,131,94,37,8010,4761,3249,9117721.0,5366859.0,3750862.0,113.14,116.38,112.73,115.45
2023-09-26 12:25,66,37,29,5153,2575,2578,5877951.0,2911438.0,2966513.0,45,27,18,4164,2112,2052,4765883.0,2372599.0,2393284.0,113.07,115.07,112.34,116.63
2023-09-26 12:30,89,41,48,8908,4485,4423,10113284.0,5027999.0,5085285.0,71,33,38,8872,4486,4386,10095792.0,5032169.0,5063623.0,112.11,114.97,112.17,115.45
2023-09-26 12:35,162,119,43,12171,7339,4832,13865716.0,8277563.0,5588153.0,150,117,33,11957,7250,4707,13607189.0,8169434.0,5437754.0,112.79,115.65,112.68,115.52
2023-09-26 12:40,41,24,17,2604,1598,1006,2973034.0,1812112.0,1160922.0,36,22,14,2182,1238,944,2481905.0,1393276.0,1088629.0,113.4,115.4,112.54,115.32
2023-09-26 12:45,38,12,26,2774,959,1815,3158300.0,1076851.0,2081449.0,29,11,18,2794,945,1849,3182669.0,1061762.0,2120906.0,112.29,114.68,112.36,114.71
2023-09-26 12:50,52,23,29,2349,1010,1339,2679302.0,1139157.0,1540144.0,41,16,25,2078,927,1151,2365035.0,1038936.0,1326099.0,112.79,115.02,112.08,115.21
2023-09-26 12:55,28,17,11,1021,502,519,1157046.0,563673.0,593373.0,19,11,8,3219,2274,945,3651172.0,2563346.0,1087825.0,112.29,114.33,112.72,115.11
2023-09-26 13:00,51,27,24,4820,2511,2309,5504272.0,2846327.0,2657945.0,34,17,17,4639,2279,2360,5275295.0,2552726.0,2722568.0,113.35,115.11,112.01,115.36
2023-09-26 13:05,84,49,35,7948,4075,3873,9047421.0,4579323.0,4468097.0,64,31,33,8404,3771,4633,9748572.0,4230478.0,5518094.0,112.38,115.37,112.18,119.1
2023-09-26 13:10,35,19,16,1946,1036,910,2214752.0,1166353.0,1048398.0,22,10,12,1792,908,884,2042142.0,1020926.0,1021216.0,112.58,115.21,112.44,115.52
2023-09-26 13:15,152,98,54,12643,7004,5639,14409081.0,7899671.0,6509410.0,139,84,55,12649,6909,5740,14406783.0,7777109.0,6629674.0,112.79,115.44,112.56,115.5
2023-09-26 13:20,875,733,142,62003,42236,19767,70757637.0,47879293.0,22878343.0,823,700,123,60971,41723,19248,69521673.0,47240275.0,22281398.0,113.36,115.74,113.22,115.76
2023-09-26 13:25,447,353,94,25399,16551,8848,28965284.0,18730012.0,10235272.0,431,351,80,25346,16563,8783,28934480.0,18758735.0,10175744.0,113.17,115.68,113.26,115.86
2023-09-26 13:30,145,93,52,11253,6060,5193,12890065.0,6870924.0,6019141.0,113,75,38,10815,5744,5071,12356720.0,6478768.0,5877951.0,113.38,115.91,112.79,115.91
2023-09-26 13:35,432,383,49,18616,14619,3997,21254955.0,16625544.0,4629411.0,415,382,33,18199,14491,3708,20779138.0,16479125.0,4300013.0,113.73,115.82,113.72,115.97
2023-09-26 13:40,63,39,24,5132,2739,2393,5880923.0,3124632.0,2756291.0,52,29,23,4752,2600,2152,5429242.0,2934932.0,2494310.0,114.08,115.18,112.88,115.91
2023-09-26 13:45,134,104,30,7013,4768,2245,8002367.0,5410244.0,2592123.0,116,91,25,7149,4835,2314,8126682.0,5455221.0,2671461.0,113.47,115.46,112.83,115.45
2023-09-26 13:50,146,135,11,5511,4855,656,6293885.0,5529523.0,764361.0,138,128,10,5115,4460,655,5841404.0,5081983.0,759421.0,113.89,116.52,113.95,115.94
2023-09-26 13:55,205,177,28,12256,10053,2203,13978415.0,11430222.0,2548192.0,200,175,25,12220,10027,2193,13928676.0,11391798.0,2536877.0,113.7,115.67,113.61,115.68
2023-09-26 14:00,67,54,13,3186,2643,543,3631546.0,3004411.0,627135.0,67,55,12,3673,3062,611,4190023.0,3477580.0,712442.0,113.67,115.49,113.57,116.6
2023-09-26 14:05,254,126,128,8356,6257,2099,9467616.0,7113712.0,2353903.0,245,121,124,8358,6110,2248,9549615.0,6945765.0,2603849.0,113.69,112.14,113.68,115.83
2023-09-26 14:10,53,24,29,4228,1977,2251,4788330.0,2220524.0,2567805.0,34,15,19,3881,1918,1963,4423653.0,2154800.0,2268853.0,112.32,114.07,112.35,115.58
2023-09-26 14:15,194,71,123,17178,8046,9132,19619451.0,9056424.0,10563027.0,168,51,117,16386,7553,8833,18688342.0,8492875.0,10195466.0,112.56,115.67,112.44,115.42
2023-09-26 14:20,1160,742,418,92676,56624,36052,105749363.0,64127970.0,41621393.0,1142,732,410,91569,56055,35514,104469952.0,63477451.0,40992501.0,113.25,115.45,113.24,115.43
2023-09-26 14:25,235,198,37,18175,13485,4690,20749632.0,15331133.0,5418498.0,226,197,29,16450,13135,3315,18769521.0,14932129.0,3837391.0,113.69,115.53,113.68,115.76
2023-09-26 14:30,320,256,64,22629,16975,5654,25823305.0,19276533.0,6546772.0,297,242,55,22797,16748,6049,26042152.0,19017829.0,7024322.0,113.56,115.79,113.55,116.12
2023-09-26 14:35,185,71,114,17975,7833,10142,20421297.0,8818575.0,11602722.0,156,58,98,17057,7806,9251,19476992.0,8788098.0,10688893.0,112.58,114.4,112.58,115.54
2023-09-26 14:40,112,50,62,13076,5825,7251,15018668.0,6563878.0,8454790.0,97,39,58,12811,5706,7105,14637601.0,6421914.0,8215687.0,112.68,116.6,112.55,115.63
2023-09-26 14:45,118,53,65,12027,5992,6035,13739118.0,6749110.0,6990007.0,107,47,60,12159,6035,6124,13887782.0,6797308.0,7090474.0,112.64,115.82,112.63,115.78
2023-09-26 14:50,501,298,203,40356,23099,17257,46240755.0,26258447.0,19982307.0,402,221,181,35631,19637,15994,40753255.0,22216451.0,18536804.0,113.68,115.79,113.14,115.9
2023-09-26 14:55,668,429,239,52751,27573,25178,60941859.0,31672746.0,29269113.0,384,230,154,45354,24003,21351,52120622.0,27237416.0,24883206.0,114.87,116.25,113.48,116.54
2023-09-26 15:00,247,139,108,18778,9174,9604,21604465.0,10409108.0,11195356.0,200,110,90,17569,8288,9281,20186148.0,9384588.0,10801560.0,113.46,116.57,113.23,116.38
2023-09-26 15:05,340,185,155,28446,15499,12947,32684013.0,17668581.0,15015431.0,234,133,101,25585,13373,12212,29466892.0,15210203.0,14256688.0,114.0,115.98,113.74,116.74
2023-09-26 15:10,185,94,91,15399,7961,7438,17741592.0,9150889.0,8590703.0,129,74,55,13240,7197,6043,15239246.0,8184404.0,7054841.0,114.95,115.5,113.72,116.74
2023-09-26 15:15,142,70,72,12587,6637,5950,14509357.0,7571244.0,6938112.0,91,47,44,11103,5528,5575,12790767.0,6278344.0,6512422.0,114.08,116.61,113.57,116.81
2023-09-26 15:20,154,84,70,15270,8461,6809,17536042.0,9617050.0,7918992.0,110,56,54,13301,6474,6827,15317769.0,7350921.0,7966848.0,113.66,116.3,113.55,116.7
2023-09-26 15:25,158,48,110,8737,3563,5174,10072136.0,4055316.0,6016819.0,127,34,93,8590,4081,4509,9889623.0,4637683.0,5251940.0,113.82,116.29,113.64,116.48
2023-09-26 15:30,74,31,43,6067,2544,3523,6981836.0,2894131.0,4087704.0,45,19,26,4978,2344,2634,5717969.0,2650969.0,3067000.0,113.76,116.03,113.1,116.44
2023-09-26 15:35,587,418,169,34511,23948,10563,40603658.0,28304088.0,12299569.0,449,367,82,26698,19381,7317,30695079.0,22162761.0,8532318.0,118.19,116.44,114.35,116.61
2023-09-26 15:40,1152,867,285,75607,50875,24732,87207794.0,58322360.0,28885433.0,1118,842,276,75031,50166,24865,86570702.0,57501027.0,29069675.0,114.64,116.79,114.62,116.91
2023-09-26 15:45,277,224,53,10188,6042,4146,11738238.0,6905807.0,4832431.0,251,210,41,10535,6241,4294,12125024.0,7119660.0,5005363.0,114.3,116.56,114.08,116.57
2023-09-26 15:50,73,46,27,4569,2156,2413,5287314.0,2459659.0,2827654.0,66,47,19,4779,3014,1765,5491006.0,3431970.0,2059036.0,114.08,117.18,113.87,116.66
2023-09-26 15:55,266,189,77,13096,6953,6143,15035571.0,7911752.0,7123818.0,217,163,54,12863,6836,6027,14784343.0,7774192.0,7010151.0,113.79,115.97,113.72,116.31
2023-09-26 16:00,65,40,25,5730,2865,2865,6585639.0,3246438.0,3339201.0,53,29,24,5956,2972,2984,6843625.0,3366722.0,3476903.0,113.31,116.55,113.28,116.52
2023-09-26 16:05,145,76,69,12049,5664,6385,13831330.0,6418025.0,7413304.0,122,64,58,11925,5793,6132,13693753.0,6567015.0,7126737.0,113.31,116.1,113.36,116.22
2023-09-26 16:10,81,43,38,8442,3542,4900,9700381.0,4010958.0,5689423.0,75,38,37,8006,3413,4593,9196499.0,3863164.0,5333334.0,113.24,116.11,113.19,116.12
2023-09-26 16:15,74,34,40,6853,3041,3812,7870246.0,3441544.0,4428702.0,68,31,37,6977,3119,3858,8013863.0,3529405.0,4484458.0,113.17,116.18,113.16,116.24
2023-09-26 16:20,77,39,38,7322,3691,3631,8401001.0,4177909.0,4223092.0,67,32,35,7783,3649,4134,8944800.0,4130014.0,4814786.0,113.19,116.31,113.18,116.47
2023-09-26 16:25,46,27,19,3740,1795,1945,4297378.0,2034615.0,2262763.0,32,17,15,3723,1923,1800,4261617.0,2169107.0,2092510.0,113.35,116.34,112.8,116.25
2023-09-26 16:30,36,17,19,3609,1751,1858,4140647.0,1983736.0,2156911.0,33,17,16,3350,1613,1737,3842177.0,1820797.0,2021379.0,113.29,116.09,112.88,116.37
2023-09-26 16:35,33,18,15,1699,833,866,1921245.0,949413.0,971831.0,19,12,7,1473,713,760,1695392.0,801699.0,893693.0,113.98,112.22,112.44,117.59
2023-09-26 16:40,108,51,57,8983,4152,4831,10267262.0,4709830.0,5557431.0,88,40,48,8562,3953,4609,9818638.0,4468129.0,5350508.0,113.44,115.04,113.03,116.09
2023-09-26 16:45,58,35,23,5079,2495,2584,5750489.0,2821205.0,2929283.0,38,23,15,4668,2359,2309,5350256.0,2665918.0,2684337.0,113.07,113.36,113.01,116.26
2023-09-26 16:50,85,46,39,10118,5113,5005,11565699.0,5780125.0,5785573.0,70,40,30,9660,4822,4838,11068933.0,5447188.0,5621744.0,113.05,115.6,112.97,116.2
2023-09-26 16:55,531,376,155,68648,56070,12578,78935548.0,64281202.0,14654346.0,470,341,129,50277,38225,12052,57755787.0,43648025.0,14107762.0,114.64,116.51,114.19,117.06
2023-09-26 17:00,582,371,211,38925,23120,15805,45076723.0,26460176.0,18616547.0,498,337,161,54220,39567,14653,62737297.0,45463196.0,17274101.0,114.45,117.79,114.9,117.89
2023-09-26 17:05,213,140,73,17576,10258,7318,20189012.0,11682087.0,8506925.0,198,137,61,17990,10291,7699,20738231.0,11721698.0,9016532.0,113.88,116.25,113.9,117.11
2023-09-26 17:10,773,495,278,71722,48528,23194,82103327.0,55317341.0,26785985.0,711,468,243,53580,31260,22320,61484841.0,35542078.0,25942763.0,113.99,115.49,113.7,116.23
2023-09-26 17:15,215,120,95,13396,6982,6414,15365207.0,7910508.0,7454699.0,197,110,87,29691,23647,6044,34032098.0,27004939.0,7027159.0,113.3,116.23,114.2,116.27
2023-09-26 17:20,97,34,63,7569,3379,4190,8691371.0,3818378.0,4872993.0,88,34,54,8260,3890,4370,9490026.0,4397867.0,5092159.0,113.0,116.3,113.06,116.53
2023-09-26 17:25,188,84,104,35096,25783,9313,40203088.0,29394248.0,10808840.0,155,71,84,16950,8026,8924,19417922.0,9061169.0,10356753.0,114.01,116.06,112.9,116.06
2023-09-26 17:30,102,42,60,27162,22657,4505,31139443.0,25906069.0,5233374.0,89,33,56,43801,39674,4127,50187966.0,45392244.0,4795722.0,114.34,116.17,114.41,116.2
2023-09-26 17:35,118,51,67,12051,5850,6201,13826223.0,6620043.0,7206179.0,107,44,63,11918,5733,6185,13672438.0,6483103.0,7189334.0,113.16,116.21,113.08,116.24
2023-09-26 17:40,158,67,91,11656,5987,5669,13381478.0,6788616.0,6592861.0,128,64,64,12002,6303,5699,13766313.0,7138565.0,6627747.0,113.39,116.3,113.26,116.3
2023-09-26 17:45,122,41,81,9593,3963,5630,11016962.0,4487931.0,6529031.0,105,35,70,9600,4164,5436,11021455.0,4714564.0,6306891.0,113.25,115.97,113.22,116.02
2023-09-26 17:50,141,68,73,11828,5963,5865,13509468.0,6743920.0,6765547.0,110,51,59,11364,5603,5761,13019201.0,6331607.0,6687593.0,113.1,115.35,113.0,116.08
2023-09-26 17:55,177,77,100,32704,24804,7900,37470933.0,28307925.0,9163008.0,156,60,96,14755,6793,7962,16933892.0,7682528.0,9251364.0,114.13,115.99,113.09,116.19
2023-09-26 18:00,759,79,680,43913,7545,36368,50513439.0,8569067.0,41944371.0,701,69,632,42672,6954,35718,49103068.0,7882843.0,41220224.0,113.57,115.33,113.36,115.4
2023-09-26 18:05,417,309,108,34415,23061,11354,39621002.0,26374551.0,13246451.0,375,285,90,32958,22158,10800,37907869.0,25301741.0,12606127.0,114.37,116.67,114.19,116.72
2023-09-26 18:10,773,304,469,48506,19590,28916,55635764.0,22382076.0,33253687.0,748,290,458,47426,19310,28116,54565883.0,22062013.0,32503870.0,114.25,115.0,114.25,115.61
2023-09-26 18:15,1510,500,1010,93304,33015,60289,107209822.0,37635649.0,69574173.0,1429,455,974,90929,31568,59361,104526425.0,35901646.0,68624779.0,114.0,115.4,113.73,115.61
2023-09-26 18:20,870,160,710,43998,7699,36299,50671420.0,8821195.0,41850225.0,850,152,698,43621,7200,36421,50201815.0,8209706.0,41992109.0,114.58,115.29,114.02,115.3
2023-09-26 18:25,416,71,345,16771,2017,14754,19289364.0,2340530.0,16948833.0,376,47,329,15472,1523,13949,17852758.0,1745459.0,16107298.0,116.04,114.88,114.61,115.47
2023-09-26 18:30,207,60,147,14379,1415,12964,16649515.0,1628213.0,15021301.0,140,35,105,8381,1658,6723,9635828.0,1887036.0,7748792.0,115.07,115.87,113.81,115.26
2023-09-26 18:35,139,39,100,4014,1452,2562,4682603.0,1761801.0,2920802.0,115,24,91,3665,927,2738,4213874.0,1060744.0,3153129.0,121.34,114.0,114.43,115.16
2023-09-27 10:00,2440,1010,1430,86626,36378,50248,104462842.0,40005250.0,64457592.0,1528,705,823,57552,23266,34286,66184028.0,26602466.0,39581562.0,109.97,128.28,114.34,115.45
2023-09-27 10:05,315,142,173,11435,4847,6588,13484717.0,5659391.0,7825325.0,165,95,70,5833,3374,2459,6720294.0,3870956.0,2849338.0,116.76,118.78,114.73,115.87
2023-09-27 10:10,892,387,505,41395,17722,23673,47793181.0,20223134.0,27570046.0,525,216,309,36915,16275,20640,42561584.0,18577779.0,23983805.0,114.11,116.46,114.15,116.2
2023-09-27 10:15,992,494,498,67303,33522,33781,76504538.0,38055298.0,38449240.0,717,325,392,55896,27984,27912,64111862.0,31709617.0,32402245.0,113.52,113.82,113.31,116.09
2023-09-27 10:20,1045,305,740,70538,29784,40754,81172564.0,33886891.0,47285672.0,907,219,688,66033,27320,38713,75923895.0,31003652.0,44920243.0,113.78,116.03,113.48,116.03
2023-09-27 10:25,887,267,620,57515,23214,34301,66381411.0,26390825.0,39990586.0,772,216,556,57184,25117,32067,65864046.0,28552027.0,37312019.0,113.68,116.59,113.68,116.36
2023-09-27 10:30,367,231,136,29474,15431,14043,33957552.0,17583265.0,16374287.0,296,197,99,27093,14571,12522,31176892.0,16558924.0,14617967.0,113.95,116.6,113.64,116.74
2023-09-27 10:35,343,201,142,30133,15981,14152,34763731.0,18249002.0,16514729.0,274,154,120,27765,13656,14109,32018895.0,15520786.0,16498109.0,114.19,116.7,113.66,116.93
2023-09-27 10:40,322,169,153,26382,12918,13464,30613243.0,14863861.0,15749381.0,240,137,103,24579,12623,11956,28411044.0,14400277.0,14010766.0,115.06,116.97,114.08,117.19
2023-09-27 10:45,511,179,332,34065,13853,20212,39393988.0,15787358.0,23606630.0,439,140,299,32260,13169,19091,37313204.0,15058420.0,22254784.0,113.96,116.8,114.35,116.57
2023-09-27 10:50,665,250,415,50169,21429,28740,57993531.0,24431584.0,33561947.0,567,192,375,46020,19565,26455,53143129.0,22251607.0,30891521.0,114.01,116.78,113.73,116.77
2023-09-27 10:55,316,201,115,18582,9911,8671,21548404.0,11443648.0,10104755.0,240,152,88,16182,8248,7934,18664580.0,9404198.0,9260381.0,115.46,116.54,114.02,116.72
2023-09-27 11:00,251,166,85,9097,5381,3716,10545541.0,6227204.0,4318337.0,199,144,55,7351,4291,3060,8526901.0,4949332.0,3577568.0,115.73,116.21,115.34,116.91
2023-09-27 11:05,1890,1089,801,86774,54297,32477,103148811.0,65129205.0,38019606.0,926,585,341,40495,27573,12922,47557064.0,32321953.0,15235110.0,119.95,117.07,117.22,117.9
2023-09-27 11:10,1988,1106,882,89581,56086,33495,109640856.0,66970421.0,42670435.0,1094,689,405,65702,43216,22486,79539725.0,50644908.0,28894816.0,119.41,127.39,117.19,128.5
2023-09-27 11:15,1120,590,530,87164,44355,42809,103276713.0,52186614.0,51090098.0,779,410,369,76838,38241,38597,90823265.0,44593681.0,46229584.0,117.66,119.34,116.61,119.78
2023-09-27 11:20,1075,565,510,76091,38635,37456,88952350.0,45007646.0,43944703.0,772,390,382,69555,36532,33023,81892432.0,42500217.0,39392215.0,116.49,117.32,116.34,119.29
2023-09-27 11:25,962,578,384,85665,54838,30827,106447716.0,64536973.0,41910742.0,670,416,254,62188,36139,26049,78213794.0,42213560.0,36000234.0,117.69,135.95,116.81,138.2
2023-09-27 11:30,606,285,321,40238,18458,21780,47342855.0,21596830.0,25746024.0,433,198,235,35255,15471,19784,41659633.0,18034133.0,23625499.0,117.01,118.21,116.57,119.42
2023-09-27 11:35,634,237,397,40064,16160,23904,47280623.0,18872546.0,28408077.0,493,189,304,35693,15376,20317,42179222.0,17903951.0,24275270.0,116.79,118.84,116.44,119.48
2023-09-27 11:40,710,298,412,54341,26237,28104,63075598.0,30602567.0,32473031.0,492,206,286,45516,22200,23316,53553013.0,25807515.0,27745497.0,116.64,115.55,116.25,119.0
2023-09-27 11:45,653,245,408,45208,21281,23927,52501287.0,24794143.0,27707144.0,518,190,328,41310,20761,20549,48685216.0,24141725.0,24543491.0,116.51,115.8,116.28,119.44
2023-09-27 11:50,411,165,246,28295,13030,15265,33198856.0,15136749.0,18062107.0,289,113,176,25359,11511,13848,29941288.0,13339582.0,16601705.0,116.17,118.32,115.89,119.89
2023-09-27 11:55,462,259,203,40797,23981,16816,48164363.0,28129193.0,20035170.0,307,170,137,35412,22462,12950,41717608.0,26245074.0,15472534.0,117.3,119.14,116.84,119.48
2023-09-27 12:00,493,286,207,33788,18474,15314,40315797.0,22068613.0,18247184.0,313,183,130,28641,15039,13602,33760714.0,17501968.0,16258746.0,119.46,119.15,116.38,119.53
2023-09-27 12:05,1600,968,632,112365,62333,50032,133504841.0,73444866.0,60059975.0,1262,827,435,101277,56531,44746,119926396.0,66221830.0,53704565.0,117.83,120.04,117.14,120.02
2023-09-27 12:10,586,258,328,38287,17511,20776,44917012.0,20442615.0,24474396.0,474,215,259,34884,16182,18702,41180698.0,18856295.0,22324403.0,116.74,117.8,116.53,119.37
2023-09-27 12:15,724,185,539,44673,13809,30864,52708327.0,16102552.0,36605775.0,644,148,496,44148,13466,30682,52142797.0,15674975.0,36467822.0,116.61,118.6,116.4,118.86
2023-09-27 12:20,746,379,367,51554,25857,25697,61131895.0,30424044.0,30707850.0,622,328,294,47844,24187,23657,56579820.0,28271008.0,28308811.0,117.66,119.5,116.89,119.66
2023-09-27 12:25,422,149,273,28641,10291,18350,33585696.0,12024249.0,21561447.0,339,113,226,25821,9364,16457,30528989.0,10916771.0,19612218.0,116.84,117.5,116.58,119.17
2023-09-27 12:30,208,98,110,4188,1379,2809,4884134.0,1679653.0,3204481.0,125,60,65,3293,1455,1838,3890955.0,1708334.0,2182621.0,121.8,114.08,117.41,118.75
2023-09-27 12:35,259,85,174,8149,1477,6672,9610201.0,1737828.0,7872373.0,198,64,134,6665,855,5810,7874231.0,1004935.0,6869295.0,117.66,117.99,117.54,118.23
2023-09-27 12:40,1782,189,1593,26252,7894,18358,30985416.0,9134254.0,21851162.0,1678,132,1546,22054,5035,17019,26115052.0,5944246.0,20170805.0,115.71,119.03,118.06,118.52
2023-09-27 12:45,164,92,72,7104,3540,3564,8444452.0,4228845.0,4215606.0,128,77,51,4199,2494,1705,5005941.0,2942185.0,2063756.0,119.46,118.28,117.97,121.04
2023-09-27 12:50,485,412,73,17272,15598,1674,20624099.0,18597357.0,2026742.0,424,386,38,15226,13941,1285,17988775.0,16449189.0,1539586.0,119.23,121.07,117.99,119.81
2023-09-27 12:55,215,124,91,3555,1925,1630,4114884.0,2271884.0,1843000.0,148,94,54,3091,2051,1040,3638402.0,2401886.0,1236516.0,118.02,113.07,117.11,118.9
2023-09-27 13:00,91,41,50,1691,941,750,1984338.0,1135328.0,849009.0,64,39,25,1502,523,979,1771851.0,609260.0,1162591.0,120.65,113.2,116.49,118.75
2023-09-27 13:05,670,516,154,24353,21490,2863,28775802.0,25434513.0,3341289.0,564,476,88,21726,19778,1948,25659870.0,23343122.0,2316747.0,118.36,116.71,118.03,118.93
2023-09-27 13:10,485,306,179,11710,8958,2752,13881352.0,10576771.0,3304581.0,343,255,88,10431,8312,2119,12337140.0,9810359.0,2526781.0,118.07,120.08,118.03,119.24
2023-09-27 13:15,264,147,117,5900,3758,2142,6970938.0,4433379.0,2537558.0,162,120,42,5233,4094,1139,6187263.0,4830061.0,1357202.0,117.97,118.47,117.98,119.16
2023-09-27 13:20,164,81,83,3675,1487,2188,4350158.0,1748666.0,2601491.0,119,76,43,2300,1547,753,2709248.0,1811138.0,898109.0,117.6,118.9,117.07,119.27
2023-09-27 13:25,154,64,90,3289,2096,1193,3794449.0,2393394.0,1401055.0,97,45,52,3079,2297,782,3523476.0,2598525.0,924951.0,114.19,117.44,113.13,118.28
2023-09-27 13:30,652,422,230,33911,26184,7727,40364116.0,31193253.0,9170862.0,498,335,163,27081,21012,6069,32025213.0,24824885.0,7200328.0,119.13,118.69,118.15,118.64
2023-09-27 13:35,459,291,168,10730,7710,3020,12764225.0,9151188.0,3613037.0,368,253,115,9037,7154,1883,10703728.0,8448378.0,2255350.0,118.69,119.64,118.09,119.77
2023-09-27 13:40,270,93,177,6004,3643,2361,7039648.0,4261209.0,2778438.0,225,79,146,5325,2858,2467,6288852.0,3354575.0,2934277.0,116.97,117.68,117.37,118.94
2023-09-27 13:45,195,72,123,5684,1914,3770,6749237.0,2265947.0,4483290.0,165,71,94,3845,1987,1858,4554917.0,2344946.0,2209971.0,118.39,118.92,118.01,118.94
2023-09-27 13:50,265,100,165,8869,2387,6482,10588813.0,2907821.0,7680991.0,230,98,132,7755,2362,5393,9193074.0,2781488.0,6411585.0,121.82,118.5,117.76,118.89
2023-09-27 13:55,1099,143,956,49112,2290,46822,58116751.0,2699750.0,55417000.0,1025,97,928,48412,2004,46408,57389761.0,2351116.0,55038645.0,117.89,118.36,117.32,118.6
2023-09-27 14:00,1391,256,1135,58027,3694,54333,68796647.0,4361351.0,64435296.0,1336,223,1113,57534,3505,54029,68224830.0,4108872.0,64115958.0,118.07,118.59,117.23,118.67
2023-09-27 14:05,227,157,70,6539,4839,1700,7757338.0,5729193.0,2028145.0,203,156,47,5264,3873,1391,6224078.0,4569792.0,1654285.0,118.4,119.3,117.99,118.93
2023-09-27 14:10,139,60,79,5196,911,4285,6192163.0,1093806.0,5098356.0,86,45,41,3230,1038,2192,3870633.0,1223191.0,2647442.0,120.07,118.98,117.84,120.78
2023-09-27 14:15,270,181,89,9220,7669,1551,10909435.0,9141123.0,1768312.0,245,181,64,8172,7410,762,9662549.0,8758121.0,904428.0,119.2,114.01,118.19,118.69
2023-09-27 14:20,118,74,44,3727,1732,1995,4510474.0,2128585.0,2381889.0,74,52,22,2948,2144,804,3488145.0,2517886.0,970259.0,122.9,119.39,117.44,120.68
2023-09-27 14:25,235,135,100,5076,3039,2037,5959845.0,3583201.0,2376643.0,140,80,60,4064,2471,1593,4800589.0,2905485.0,1895103.0,117.91,116.67,117.58,118.96
2023-09-27 14:30,148,59,89,3576,1297,2279,4315157.0,1615462.0,2699695.0,97,28,69,2328,396,1932,2755006.0,462089.0,2292917.0,124.55,118.46,116.69,118.68
2023-09-27 14:35,259,78,181,7331,1582,5749,8637250.0,1861001.0,6776249.0,207,51,156,6623,1457,5166,7821902.0,1695765.0,6126137.0,117.64,117.87,116.39,118.59
2023-09-27 14:40,106,38,68,2709,464,2245,3189521.0,545212.0,2644309.0,77,28,49,1672,179,1493,1983489.0,209887.0,1773602.0,117.5,117.79,117.26,118.79
2023-09-27 14:45,182,65,117,4821,1269,3552,5732879.0,1502284.0,4230594.0,135,41,94,4329,1138,3191,5120202.0,1341254.0,3778948.0,118.38,119.1,117.86,118.43
2023-09-27 14:50,114,38,76,2659,1171,1488,3087277.0,1380169.0,1707108.0,81,31,50,1993,1113,880,2351460.0,1309790.0,1041669.0,117.86,114.72,117.68,118.37
2023-09-27 14:55,356,105,251,12612,3103,9509,13418593.0,3647705.0,9770888.0,212,38,174,3345,630,2715,3952083.0,739366.0,3212717.0,117.55,102.75,117.36,118.33
2023-09-27 15:00,287,90,197,22245,14746,7499,26066335.0,17287197.0,8779137.0,228,54,174,20178,13512,6666,23903357.0,15804564.0,8098793.0,117.23,117.07,116.97,121.49
2023-09-27 15:05,190,59,131,9608,6892,2716,11352241.0,8171126.0,3181115.0,143,36,107,8825,6520,2305,10407394.0,7678207.0,2729187.0,118.56,117.13,117.76,118.4
2023-09-27 15:10,467,155,312,23348,8016,15332,27113884.0,9389145.0,17724739.0,301,91,210,15314,6894,8420,18005835.0,8064661.0,9941174.0,117.13,115.61,116.98,118.07
2023-09-27 15:15,578,365,213,20993,16196,4797,24885218.0,19203013.0,5682205.0,450,295,155,18887,15458,3429,22188141.0,18116576.0,4071565.0,118.57,118.45,117.2,118.74
2023-09-27 15:20,288,92,196,8545,2979,5566,10057316.0,3495362.0,6561953.0,248,75,173,8188,3188,5000,9650172.0,3734094.0,5916078.0,117.33,117.89,117.13,118.32
2023-09-27 15:25,538,201,337,18445,6815,11630,21143496.0,7910539.0,13232956.0,367,102,265,12588,3460,9128,14768416.0,4013116.0,10755300.0,116.08,113.78,115.99,117.83
2023-09-27 15:30,549,123,426,17542,2653,14889,20588565.0,3096860.0,17491705.0,494,90,404,16223,1904,14319,19053929.0,2215799.0,16838130.0,116.73,117.48,116.38,117.59
2023-09-27 15:35,246,147,99,6690,3890,2800,7884028.0,4585396.0,3298632.0,189,113,76,5863,3475,2388,6875330.0,4062051.0,2813278.0,117.88,117.81,116.89,117.81
2023-09-27 15:40,318,260,58,10427,8654,1773,12262895.0,10167055.0,2095840.0,272,230,42,10991,9028,1963,12879968.0,10555227.0,2324740.0,117.48,118.21,116.92,118.43
2023-09-27 15:45,309,114,195,11305,5226,6079,13232126.0,6104628.0,7127497.0,271,87,184,9697,3770,5927,11396036.0,4413971.0,6982065.0,116.81,117.25,117.08,117.8
2023-09-27 15:50,399,293,106,14829,10915,3914,18106967.0,13125437.0,4981529.0,259,214,45,10447,8104,2343,12440681.0,9490152.0,2950529.0,120.25,127.27,117.1,125.93
2023-09-27 15:55,498,368,130,17065,12349,4716,20246149.0,14703377.0,5542772.0,390,312,78,14705,11162,3543,17368777.0,13145702.0,4223075.0,119.07,117.53,117.77,119.19
2023-09-27 16:00,299,212,87,12833,10344,2489,15298009.0,12403333.0,2894675.0,222,177,45,9874,8981,893,11673055.0,10604880.0,1068175.0,119.91,116.3,118.08,119.62
2023-09-27 16:05,448,317,131,15709,11482,4227,18801336.0,13805870.0,4995466.0,332,277,55,11949,9873,2076,14108786.0,11644459.0,2464326.0,120.24,118.18,117.94,118.71
2023-09-27 16:10,239,109,130,7656,2804,4852,9082704.0,3347500.0,5735203.0,177,81,96,6554,2449,4105,7745712.0,2881955.0,4863757.0,119.38,118.2,117.68,118.48
2023-09-27 16:15,336,220,116,9032,6278,2754,10643424.0,7391162.0,3252262.0,281,188,93,7515,5752,1763,8858514.0,6767100.0,2091414.0,117.73,118.09,117.65,118.63
2023-09-27 16:20,112,49,63,2848,984,1864,3373901.0,1154888.0,2219013.0,90,46,44,2482,907,1575,2943951.0,1064728.0,1879223.0,117.37,119.05,117.39,119.32
2023-09-27 16:25,104,47,57,2785,1599,1186,3278371.0,1883818.0,1394552.0,80,41,39,2266,1391,875,2668946.0,1632010.0,1036935.0,117.81,117.58,117.33,118.51
2023-09-27 16:30,134,98,36,4374,2874,1500,5185491.0,3411432.0,1774059.0,117,91,26,3153,2598,555,3716339.0,3059052.0,657286.0,118.7,118.27,117.75,118.43
2023-09-27 16:35,244,39,205,7958,582,7376,9397901.0,686987.0,8710914.0,218,33,185,8252,1063,7189,9751229.0,1245882.0,8505346.0,118.04,118.1,117.2,118.31
2023-09-27 16:40,164,101,63,3593,1894,1699,4206513.0,2229022.0,1977491.0,101,64,37,1902,996,906,2234673.0,1164218.0,1070454.0,117.69,116.39,116.89,118.15
2023-09-27 16:45,161,57,104,5266,804,4462,6214174.0,941688.0,5272486.0,131,39,92,4982,1048,3934,5871272.0,1226171.0,4645101.0,117.13,118.16,117.0,118.08
2023-09-27 16:50,165,41,124,7090,3393,3697,8303461.0,3974344.0,4329117.0,150,34,116,6395,3151,3244,7510426.0,3679143.0,3831282.0,117.13,117.1,116.76,118.1
2023-09-27 16:55,180,26,154,7016,1346,5670,8261947.0,1576729.0,6685218.0,158,19,139,5890,939,4951,6941712.0,1099650.0,5842061.0,117.14,117.91,117.11,118.0
2023-09-27 17:00,129,35,94,4658,1172,3486,5476109.0,1374478.0,4101631.0,101,20,81,3830,1190,2640,4503509.0,1381312.0,3122196.0,117.28,117.66,116.08,118.27
2023-09-27 17:05,186,84,102,6387,3071,3316,7143914.0,3555442.0,3588472.0,123,43,80,3560,1438,2122,4170914.0,1678739.0,2492175.0,115.77,108.22,116.74,117.44
2023-09-27 17:10,204,56,148,5995,909,5086,6814321.0,1060654.0,5753666.0,168,45,123,4781,809,3972,5601800.0,939561.0,4662239.0,116.68,113.13,116.14,117.38
2023-09-27 17:15,383,124,259,12802,2927,9875,14684558.0,3437378.0,11247180.0,301,90,211,9609,1985,7624,11240199.0,2301034.0,8939164.0,117.44,113.9,115.92,117.25
2023-09-27 17:20,364,211,153,11984,6371,5613,13668271.0,7376987.0,6291283.0,177,112,65,7063,4469,2594,8213595.0,5137923.0,3075672.0,115.79,112.08,114.97,118.57
2023-09-27 17:25,319,144,175,21181,8883,12298,24034025.0,10139343.0,13894681.0,237,100,137,17465,7953,9512,20216181.0,9075520.0,11140660.0,114.14,112.98,114.11,117.12
2023-09-27 17:30,517,245,272,40528,19246,21282,46759735.0,21948578.0,24811157.0,385,154,231,37548,17773,19775,43361409.0,20237359.0,23124049.0,114.04,116.58,113.87,116.94
2023-09-27 17:35,276,129,147,22794,11107,11687,26342247.0,12669858.0,13672389.0,239,103,136,22154,10558,11596,25595165.0,12021149.0,13574016.0,114.07,116.99,113.86,117.06
2023-09-27 17:40,421,198,223,37882,18899,18983,43946133.0,21677729.0,22268403.0,356,159,197,36991,18352,18639,42875013.0,20984821.0,21890191.0,114.7,117.31,114.35,117.44
2023-09-27 17:45,169,113,56,13614,7227,6387,15830708.0,8327796.0,7502912.0,119,72,47,12707,6507,6200,14759602.0,7457912.0,7301689.0,115.23,117.47,114.61,117.77
2023-09-27 17:50,58,19,39,3173,1003,2170,3700503.0,1157739.0,2542763.0,34,11,23,2376,990,1386,2773999.0,1135910.0,1638088.0,115.43,117.18,114.74,118.19
2023-09-27 17:55,66,32,34,4475,2095,2380,5178708.0,2402853.0,2775854.0,50,29,21,4167,2113,2054,4839147.0,2420718.0,2418428.0,114.69,116.63,114.56,117.74
2023-09-27 18:00,108,59,49,6998,3698,3300,8141487.0,4272865.0,3868621.0,80,33,47,6195,2970,3225,7208340.0,3409314.0,3799025.0,115.55,117.23,114.79,117.8
2023-09-27 18:05,98,71,27,6466,4134,2332,7478646.0,4777471.0,2701174.0,79,62,17,4913,3298,1615,5700881.0,3795636.0,1905245.0,115.57,115.83,115.09,117.97
2023-09-27 18:10,106,45,61,9891,4317,5574,11515357.0,4966251.0,6549106.0,95,36,59,9082,3722,5360,10591540.0,4277662.0,6313878.0,115.04,117.49,114.93,117.8
2023-09-27 18:15,427,99,328,20288,6228,14060,23588343.0,7152525.0,16435818.0,394,86,308,19775,6161,13614,22999502.0,7072664.0,15926838.0,114.84,116.9,114.8,116.99
2023-09-27 18:20,305,64,241,17912,5464,12448,20821098.0,6264467.0,14556630.0,283,44,239,18026,5302,12724,20946321.0,6062994.0,14883327.0,114.65,116.94,114.35,116.97
2023-09-27 18:25,174,26,148,9160,2942,6218,10638620.0,3369403.0,7269216.0,172,29,143,9746,3231,6515,11327589.0,3700810.0,7626778.0,114.53,116.91,114.54,117.06
2023-09-27 18:30,244,76,168,6087,1238,4849,6906876.0,1424486.0,5482390.0,175,27,148,4803,823,3980,5568817.0,944561.0,4624256.0,115.06,113.06,114.77,116.19
2023-09-27 18:35,66,36,30,1617,661,956,1841827.0,761732.0,1080095.0,61,37,24,1626,1081,545,1865993.0,1231006.0,634987.0,115.24,112.98,113.88,116.51
2023-09-28 10:00,1173,417,756,40956,17845,23111,47697414.0,18747952.0,28949461.0,288,123,165,12004,3090,8914,13973988.0,3556612.0,10417375.0,105.06,125.26,115.1,116.87
2023-09-28 10:05,278,180,98,6695,3092,3603,7865393.0,3595220.0,4270173.0,146,109,37,3650,2420,1230,4233931.0,2796894.0,1437036.0,116.27,118.52,115.57,116.83
2023-09-28 10:10,727,392,335,15946,8770,7176,21948519.0,11152175.0,10796343.0,353,196,157,11401,7293,4108,13250590.0,8441377.0,4809213.0,127.16,150.45,115.75,117.07
2023-09-28 10:15,255,119,136,6040,2073,3967,7158627.0,2435980.0,4722646.0,158,84,74,3082,1228,1854,3593179.0,1421768.0,2171411.0,117.51,119.05,115.78,117.12
2023-09-28 10:20,196,94,102,13053,6117,6936,15206593.0,7049890.0,8156703.0,118,53,65,11119,5580,5539,12963634.0,6417284.0,6546350.0,115.25,117.6,115.01,118.19
2023-09-28 10:25,276,158,118,23085,11728,11357,26871824.0,13491893.0,13379931.0,199,110,89,22262,11292,10970,25921352.0,12968890.0,12952462.0,115.04,117.81,114.85,118.07
2023-09-28 10:30,171,92,79,12936,7089,5847,15153795.0,8236644.0,6917150.0,115,69,46,11668,5998,5670,13632544.0,6912391.0,6720153.0,116.19,118.3,115.24,118.52
2023-09-28 10:35,222,136,86,15313,8061,7252,18048752.0,9359397.0,8689354.0,146,102,44,13294,7411,5883,15575605.0,8579538.0,6996066.0,116.11,119.82,115.77,118.92
2023-09-28 10:40,313,189,124,23696,12267,11429,27887257.0,14266824.0,13620433.0,209,134,75,21741,11614,10127,25529758.0,13466531.0,12063227.0,116.3,119.17,115.95,119.12
2023-09-28 10:45,185,91,94,15781,7422,8359,18458472.0,8573592.0,9884879.0,143,79,64,14485,7385,7100,16936976.0,8512002.0,8424974.0,115.52,118.25,115.26,118.66
2023-09-28 10:50,126,69,57,11144,5891,5253,13066350.0,6832816.0,6233534.0,90,51,39,9800,5034,4766,11465536.0,5809113.0,5656423.0,115.99,118.67,115.4,118.68
2023-09-28 10:55,143,68,75,13878,6980,6898,16213695.0,8040636.0,8173059.0,109,53,56,13657,7251,6406,15966275.0,8370183.0,7596091.0,115.2,118.48,115.43,118.58
2023-09-28 11:00,126,61,65,11203,4839,6364,13172345.0,5657863.0,7514482.0,98,49,49,10574,4325,6249,12373399.0,4987107.0,7386292.0,116.92,118.08,115.31,118.2
2023-09-28 11:05,183,80,103,18803,8765,10038,21953161.0,10117351.0,11835809.0,142,67,75,17731,8338,9393,20695384.0,9590770.0,11104613.0,115.43,117.91,115.02,118.22
2023-09-28 11:10,52,24,28,3510,1558,1952,4095199.0,1794422.0,2300777.0,40,17,23,3748,1541,2207,4374562.0,1775321.0,2599241.0,115.17,117.87,115.21,117.77
2023-09-28 11:15,167,86,81,11696,5601,6095,13426782.0,6447098.0,6979684.0,105,50,55,9896,4922,4974,11500445.0,5645823.0,5854622.0,115.11,114.51,114.71,117.7
2023-09-28 11:20,237,105,132,18648,8461,10187,21730093.0,9706951.0,12023141.0,193,75,118,17719,8060,9659,20591696.0,9241328.0,11350368.0,114.73,118.02,114.66,117.51
2023-09-28 11:25,524,46,478,25085,2860,22225,29344429.0,3277942.0,26066487.0,501,33,468,23257,2641,20616,27092016.0,3024497.0,24067519.0,114.61,117.28,114.52,116.74
2023-09-28 11:30,555,56,499,33501,4464,29037,38988843.0,5115882.0,33872960.0,527,36,491,32921,4099,28822,38319812.0,4696933.0,33622878.0,114.6,116.65,114.59,116.66
2023-09-28 11:35,309,62,247,21550,6331,15219,25133466.0,7288877.0,17844589.0,288,50,238,20723,6092,14631,24134938.0,6990672.0,17144265.0,115.13,117.25,114.75,117.18
2023-09-28 11:40,128,43,85,10012,5245,4767,11656725.0,6029955.0,5626769.0,102,37,65,9846,5053,4793,11463445.0,5807298.0,5656146.0,114.97,118.04,114.93,118.01
2023-09-28 11:45,144,74,70,10927,5494,5433,12779444.0,6344044.0,6435400.0,116,55,61,10159,5056,5103,11848299.0,5816272.0,6032027.0,115.47,118.45,115.04,118.21
2023-09-28 11:50,65,28,37,6289,2560,3729,7353108.0,2947079.0,4406028.0,51,25,26,5482,2517,2965,6396386.0,2897140.0,3499246.0,115.12,118.16,115.1,118.02
2023-09-28 11:55,65,35,30,5346,2630,2716,6223977.0,3025990.0,3197986.0,53,29,24,5015,2565,2450,5841512.0,2950627.0,2890884.0,115.06,117.75,115.03,118.0
2023-09-28 12:00,35,22,13,2069,1510,559,2410439.0,1749528.0,660910.0,26,17,9,1298,679,619,1512080.0,781925.0,730154.0,115.86,118.23,115.16,117.96
2023-09-28 12:05,393,41,352,21533,2407,19126,24934585.0,2759303.0,22175282.0,365,28,337,21091,2366,18725,24536542.0,2711211.0,21825331.0,114.64,115.94,114.59,116.56
2023-09-28 12:10,366,81,285,27242,6892,20350,31535599.0,7921276.0,23614323.0,338,62,276,25407,6528,18879,29544691.0,7478257.0,22066433.0,114.93,116.04,114.56,116.88
2023-09-28 12:15,74,37,37,6493,3191,3302,7568705.0,3669769.0,3898935.0,77,50,27,5853,2856,2997,6810627.0,3272058.0,3538569.0,115.0,118.08,114.57,118.07
2023-09-28 12:20,55,30,25,3686,1453,2233,4286551.0,1670346.0,2616204.0,38,16,22,3035,1356,1679,3526265.0,1553997.0,1972268.0,114.96,117.16,114.6,117.47
2023-09-28 12:25,49,26,23,2036,890,1146,2330818.0,1023607.0,1307210.0,23,11,12,1450,713,737,1683508.0,816030.0,867478.0,115.01,114.07,114.45,117.7
2023-09-28 12:30,59,35,24,2784,1245,1539,3192724.0,1420213.0,1772511.0,32,16,16,2785,1034,1751,3217687.0,1169822.0,2047865.0,114.07,115.17,113.14,116.95
2023-09-28 12:35,51,32,19,2218,1180,1038,2554739.0,1373186.0,1181553.0,32,20,12,1820,925,895,2112375.0,1058766.0,1053609.0,116.37,113.83,114.46,117.72
2023-09-28 12:40,38,23,15,1866,1012,854,2153489.0,1147902.0,1005587.0,22,12,10,1630,811,819,1892601.0,930761.0,961839.0,113.43,117.75,114.77,117.44
2023-09-28 12:45,64,33,31,2137,776,1361,2475913.0,886717.0,1589195.0,59,31,28,1982,674,1308,2285418.0,757092.0,1528326.0,114.27,116.77,112.33,116.84
2023-09-28 12:50,45,26,19,3375,1736,1639,3920807.0,1991915.0,1928892.0,32,18,14,3154,1566,1588,3663154.0,1794321.0,1868833.0,114.74,117.69,114.58,117.68
2023-09-28 12:55,39,16,23,2707,1161,1546,3141993.0,1322978.0,1819015.0,30,13,17,2532,1091,1441,2946845.0,1249425.0,1697420.0,113.95,117.66,114.52,117.79
2023-09-28 13:00,95,31,64,3725,1077,2648,4320344.0,1240945.0,3079399.0,78,28,50,3518,1228,2290,4080683.0,1409630.0,2671053.0,115.22,116.29,114.79,116.64
2023-09-28 13:05,46,22,24,4006,2081,1925,4656696.0,2398587.0,2258108.0,32,17,15,3407,1831,1576,3953019.0,2100087.0,1852932.0,115.26,117.3,114.7,117.57
2023-09-28 13:10,62,34,28,5347,2724,2623,6197405.0,3123414.0,3073990.0,43,21,22,5653,2512,3141,6589237.0,2873801.0,3715436.0,114.66,117.19,114.4,118.29
2023-09-28 13:15,42,25,17,3321,1659,1662,3828505.0,1900716.0,1927788.0,31,18,13,3068,1553,1515,3563429.0,1778371.0,1785057.0,114.57,115.99,114.51,117.83
2023-09-28 13:20,23,10,13,1579,623,956,1833224.0,713243.0,1119981.0,16,8,8,1678,766,912,1940485.0,867308.0,1073177.0,114.49,117.15,113.23,117.67
2023-09-28 13:25,38,18,20,2075,920,1155,2434156.0,1056727.0,1377429.0,27,17,10,1568,708,860,1819914.0,810987.0,1008926.0,114.86,119.26,114.55,117.32
2023-09-28 13:30,75,44,31,6469,3572,2897,7515028.0,4107142.0,3407886.0,62,35,27,6314,3451,2863,7334102.0,3965704.0,3368398.0,114.98,117.64,114.91,117.65
2023-09-28 13:35,79,33,46,5301,2088,3213,6148488.0,2396326.0,3752162.0,54,19,35,5046,2007,3039,5861602.0,2299373.0,3562228.0,114.77,116.78,114.57,117.22
2023-09-28 13:40,84,46,38,6987,3765,3222,8126037.0,4338187.0,3787849.0,73,38,35,6203,3189,3014,7210696.0,3666535.0,3544160.0,115.22,117.56,114.97,117.59
2023-09-28 13:45,41,21,20,2734,1255,1479,3186501.0,1444287.0,1742213.0,23,12,11,2226,1046,1180,2595268.0,1200213.0,1395055.0,115.08,117.8,114.74,118.22
2023-09-28 13:50,54,31,23,5040,2888,2152,5836091.0,3299354.0,2536736.0,49,30,19,5481,3211,2270,6380083.0,3702247.0,2677836.0,114.24,117.88,115.3,117.97
2023-09-28 13:55,42,24,18,2954,1467,1487,3482792.0,1721791.0,1761000.0,30,15,15,2917,1368,1549,3396590.0,1570151.0,1826438.0,117.37,118.43,114.78,117.91
2023-09-28 14:00,45,22,23,4355,1997,2358,5075121.0,2294527.0,2780594.0,34,18,16,4154,1930,2224,4840321.0,2214804.0,2625516.0,114.9,117.92,114.76,118.05
2023-09-28 14:05,1194,127,1067,79437,14834,64603,92192465.0,16985473.0,75206991.0,1174,114,1060,78289,14362,63927,91016439.0,16434547.0,74581892.0,114.5,116.41,114.43,116.67
2023-09-28 14:10,642,140,502,39731,9951,29780,46241282.0,11483736.0,34757546.0,581,110,471,38384,9121,29263,44600356.0,10457518.0,34142838.0,115.4,116.71,114.65,116.68
2023-09-28 14:15,776,64,712,44189,6186,38003,51391776.0,7086782.0,44304993.0,758,54,704,42691,6133,36558,49621383.0,7018020.0,42603363.0,114.56,116.58,114.43,116.54
2023-09-28 14:20,65,26,39,5640,2076,3564,6546453.0,2375412.0,4171040.0,54,24,30,5557,2054,3503,6451291.0,2350285.0,4101006.0,114.42,117.03,114.42,117.07
2023-09-28 14:25,666,37,629,35651,3893,31758,41433031.0,4439545.0,36993486.0,649,27,622,35086,3450,31636,40784758.0,3940841.0,36843916.0,114.04,116.49,114.23,116.46
2023-09-28 14:30,1307,112,1195,83677,13792,69885,97194781.0,15780194.0,81414587.0,1289,102,1187,82989,13383,69606,96461070.0,15305604.0,81155465.0,114.42,116.5,114.37,116.59
2023-09-28 14:35,849,97,752,59508,14049,45459,69125869.0,16068923.0,53056946.0,833,88,745,59289,13789,45500,68901635.0,15775981.0,53125653.0,114.38,116.71,114.41,116.76
2023-09-28 14:40,80,37,43,6583,3119,3464,7627186.0,3565920.0,4061266.0,61,25,36,6321,2933,3388,7341876.0,3353166.0,3988710.0,114.33,117.24,114.33,117.73
2023-09-28 14:45,104,49,55,6937,2651,4286,8028458.0,3030582.0,4997876.0,62,30,32,5268,2544,2724,6105232.0,2907279.0,3197952.0,114.32,116.61,114.28,117.4
2023-09-28 14:50,91,51,40,6648,3351,3297,7694828.0,3829935.0,3864892.0,73,35,38,7461,3122,4339,8651882.0,3563511.0,5088371.0,114.29,117.22,114.14,117.27
2023-09-28 14:55,308,116,192,27787,10756,17031,31740813.0,12238007.0,19502805.0,197,75,122,21622,9726,11896,24939809.0,11059798.0,13880011.0,113.78,114.51,113.71,116.68
2023-09-28 15:00,197,116,81,15149,7563,7586,17405849.0,8631945.0,8773903.0,107,46,61,11811,5807,6004,13562158.0,6583324.0,6978833.0,114.13,115.66,113.37,116.24
2023-09-28 15:05,398,213,185,34761,17711,17050,40222939.0,20314528.0,19908411.0,304,160,144,33362,16982,16380,38448843.0,19316656.0,19132187.0,114.7,116.76,113.75,116.8
2023-09-28 15:10,140,64,76,13301,7351,5950,15296246.0,8403355.0,6892890.0,121,53,68,12070,6271,5799,13941547.0,7153486.0,6788060.0,114.32,115.85,114.07,117.06
2023-09-28 15:15,73,46,27,5561,3343,2218,6407157.0,3814864.0,2592293.0,66,37,29,7937,3179,4758,9160697.0,3622560.0,5538137.0,114.11,116.88,113.95,116.4
2023-09-28 15:20,76,44,32,6438,3971,2467,7424717.0,4543266.0,2881450.0,62,30,32,6680,4236,2444,7709279.0,4848530.0,2860748.0,114.41,116.8,114.46,117.05
2023-09-28 15:25,66,34,32,4935,2395,2540,5714738.0,2740135.0,2974603.0,49,24,25,4412,2626,1786,5095554.0,3006646.0,2088907.0,114.41,117.11,114.5,116.96
2023-09-28 15:30,140,56,84,13048,6120,6928,15063801.0,6968029.0,8095772.0,121,50,71,12158,5577,6581,14035219.0,6345257.0,7689961.0,113.86,116.86,113.78,116.85
2023-09-28 15:35,49,26,23,4035,1857,2178,4654508.0,2113622.0,2540886.0,36,20,16,3968,2177,1791,4577207.0,2482988.0,2094218.0,113.82,116.66,114.06,116.93
2023-09-28 15:40,69,26,43,4891,2198,2693,5636243.0,2497060.0,3139183.0,61,25,36,4810,2139,2671,5544212.0,2428659.0,3115553.0,113.61,116.57,113.54,116.64
2023-09-28 15:45,87,36,51,8280,3734,4546,9535278.0,4241082.0,5294196.0,74,31,43,8484,4182,4302,9735181.0,4711277.0,5023903.0,113.58,116.46,112.66,116.78
2023-09-28 15:50,152,80,72,9460,4335,5125,10780104.0,4924680.0,5855423.0,95,43,52,8730,3746,4984,10084130.0,4250546.0,5833583.0,113.6,114.25,113.47,117.05
2023-09-28 15:55,122,68,54,8799,4446,4353,10144011.0,5066069.0,5077942.0,88,46,42,8650,4391,4259,9958801.0,4987160.0,4971640.0,113.95,116.65,113.58,116.73
2023-09-28 16:00,50,26,24,3614,1793,1821,4159524.0,2036287.0,2123237.0,40,21,19,3128,1517,1611,3601967.0,1721619.0,1880348.0,113.57,116.6,113.49,116.72
2023-09-28 16:05,76,41,35,6192,3055,3137,7139378.0,3477219.0,3662158.0,55,23,32,6189,2909,3280,7136644.0,3300448.0,3836195.0,113.82,116.74,113.46,116.96
2023-09-28 16:10,32,18,14,1296,787,509,1492839.0,899735.0,593103.0,25,13,12,1097,504,593,1265759.0,572904.0,692854.0,114.32,116.52,113.67,116.84
2023-09-28 16:15,36,22,14,2266,1182,1084,2603927.0,1340994.0,1262933.0,31,15,16,2030,838,1192,2340787.0,951185.0,1389602.0,113.45,116.51,113.51,116.58
2023-09-28 16:20,29,16,13,1581,789,792,1853778.0,929950.0,923827.0,20,8,12,1398,620,778,1611843.0,704066.0,907777.0,117.86,116.64,113.56,116.68
2023-09-28 16:25,36,20,16,2387,1061,1326,2741121.0,1206247.0,1534873.0,27,14,13,2304,1083,1221,2655164.0,1229177.0,1425987.0,113.69,115.75,113.5,116.79
2023-09-28 16:30,75,36,39,7838,3663,4175,8995849.0,4164386.0,4831463.0,58,27,31,7208,3523,3685,8310791.0,4003460.0,4307331.0,113.69,115.72,113.64,116.89
2023-09-28 16:35,100,50,50,11491,5874,5617,13158921.0,6696535.0,6462386.0,71,36,35,9250,4557,4693,10672959.0,5184542.0,5488417.0,114.0,115.05,113.77,116.95
2023-09-28 16:40,88,44,44,6892,3830,3062,7960419.0,4390037.0,3570381.0,65,32,33,5076,2248,2828,5862664.0,2560912.0,3301751.0,114.62,116.6,113.92,116.75
2023-09-28 16:45,105,56,49,9733,4540,5193,11292909.0,5194240.0,6098669.0,85,44,41,9147,4699,4448,10565355.0,5356738.0,5208616.0,114.41,117.44,114.0,117.1
2023-09-28 16:50,41,19,22,3367,1492,1875,3907782.0,1709879.0,2197903.0,42,21,21,3423,1529,1894,3967541.0,1745927.0,2221613.0,114.6,117.22,114.19,117.3
2023-09-28 16:55,55,24,31,4458,2249,2209,5166474.0,2576400.0,2590074.0,47,25,22,4364,2261,2103,5052179.0,2581471.0,2470707.0,114.56,117.25,114.17,117.48
2023-09-28 17:00,52,23,29,2779,1238,1541,3205105.0,1405867.0,1799237.0,34,14,20,2726,1186,1540,3152668.0,1349016.0,1803652.0,113.56,116.76,113.75,117.12
2023-09-28 17:05,76,27,49,5560,2551,3009,6445895.0,2939656.0,3506238.0,66,20,46,5703,2429,3274,6602210.0,2784364.0,3817845.0,115.24,116.53,114.63,116.61
2023-09-28 17:10,248,136,112,12699,7183,5516,15201333.0,8695041.0,6506291.0,151,102,49,9320,5629,3691,10813252.0,6467093.0,4346159.0,121.05,117.95,114.89,117.75
2023-09-28 17:15,84,41,43,6685,2558,4127,7805294.0,2937925.0,4867369.0,73,40,33,5753,2999,2754,6696544.0,3445067.0,3251476.0,114.85,117.94,114.87,118.06
2023-09-28 17:20,53,23,30,3005,1315,1690,3492860.0,1506623.0,1986237.0,36,19,17,2483,1176,1307,2886296.0,1346461.0,1539834.0,114.57,117.53,114.5,117.81
2023-09-28 17:25,103,50,53,11776,7129,4647,13689172.0,8210924.0,5478248.0,82,44,38,12570,8145,4425,14601497.0,9382422.0,5219074.0,115.18,117.89,115.19,117.95
2023-09-28 17:30,89,50,39,7135,3812,3323,8305702.0,4388621.0,3917080.0,73,42,31,7040,3454,3586,8193507.0,3961888.0,4231619.0,115.13,117.88,114.7,118.0
2023-09-28 17:35,69,39,30,5965,3039,2926,6942342.0,3489108.0,3453234.0,56,36,20,5783,3041,2742,6728902.0,3490504.0,3238398.0,114.81,118.02,114.78,118.1
2023-09-28 17:40,110,58,52,8846,4390,4456,10262765.0,5031889.0,5230876.0,87,49,38,8048,4205,3843,9351018.0,4819577.0,4531441.0,114.62,117.39,114.62,117.91
2023-09-28 17:45,349,329,20,20107,18416,1691,23247657.0,21261649.0,1986007.0,337,323,14,19902,18276,1626,23028991.0,21100342.0,1928649.0,115.45,117.45,115.45,118.61
2023-09-28 17:50,338,236,102,32196,19514,12682,37324992.0,22397925.0,14927067.0,305,219,86,31933,19446,12487,37010656.0,22311684.0,14698972.0,114.78,117.7,114.74,117.71
2023-09-28 17:55,69,33,36,6168,3059,3109,7161601.0,3500706.0,3660894.0,62,27,35,6092,2994,3098,7079097.0,3425547.0,3653549.0,114.44,117.75,114.41,117.93
2023-09-28 18:00,144,71,73,15161,7637,7524,17590107.0,8740274.0,8849832.0,125,65,60,16313,7721,8592,18943823.0,8834270.0,10109553.0,114.45,117.62,114.42,117.66
2023-09-28 18:05,133,65,68,14744,6816,7928,16982414.0,7800096.0,9182318.0,100,48,52,12587,6275,6312,14602064.0,7175437.0,7426626.0,114.44,115.82,114.35,117.66
2023-09-28 18:10,407,200,207,82115,58422,23693,95325510.0,67575809.0,27749701.0,345,167,178,76112,52938,23174,88336696.0,61189413.0,27147283.0,115.67,117.12,115.59,117.15
2023-09-28 18:15,823,150,673,61738,18240,43498,71515850.0,20842152.0,50673697.0,764,127,637,64818,22558,42260,75134084.0,25848471.0,49285613.0,114.27,116.5,114.59,116.62
2023-09-28 18:20,1044,77,967,65394,10329,55065,75712327.0,11776921.0,63935406.0,1028,65,963,64771,9813,54958,75020933.0,11178016.0,63842916.0,114.02,116.11,113.91,116.17
2023-09-28 18:25,1017,113,904,79365,19059,60306,91829207.0,21710150.0,70119057.0,1008,108,900,79199,19118,60081,91635739.0,21777224.0,69858515.0,113.91,116.27,113.91,116.27
2023-09-28 18:30,742,103,639,59959,15520,44439,69340802.0,17681237.0,51659565.0,728,97,631,60021,15876,44145,69427598.0,18079006.0,51348591.0,113.93,116.25,113.88,116.32
2023-09-28 18:35,104,57,47,2994,1712,1282,3412675.0,1969239.0,1443436.0,51,29,22,2392,1696,696,2735486.0,1930436.0,805049.0,115.03,112.59,113.82,115.67
2023-09-29 10:00,1475,361,1114,55690,12915,42775,64677285.0,13250603.0,51426682.0,665,114,551,31977,2358,29619,37117090.0,2714998.0,34402092.0,102.6,120.23,115.14,116.15
2023-09-29 10:05,511,92,419,23199,2472,20727,27173608.0,2779884.0,24393723.0,378,37,341,18162,1031,17131,21079579.0,1186587.0,19892992.0,112.45,117.69,115.09,116.12
2023-09-29 10:10,709,198,511,15134,1967,13167,17525719.0,2218237.0,15307481.0,415,53,362,12407,1232,11175,14368703.0,1403576.0,12965127.0,112.77,116.26,113.93,116.02
2023-09-29 10:15,484,267,217,42380,24941,17439,49259363.0,28760538.0,20498824.0,345,190,155,37361,22949,14412,43356779.0,26434671.0,16922108.0,115.31,117.55,115.19,117.42
2023-09-29 10:20,519,258,261,42048,18919,23129,48731910.0,21630597.0,27101313.0,382,189,193,37440,18031,19409,43372403.0,20596485.0,22775917.0,114.33,117.17,114.23,117.35
2023-09-29 10:25,532,97,435,35421,8390,27031,40793300.0,9541362.0,31251937.0,456,60,396,32312,7426,24886,37337266.0,8445829.0,28891436.0,113.72,115.62,113.73,116.1
2023-09-29 10:30,1447,267,1180,111735,34988,76747,128794150.0,39990099.0,88804051.0,1307,189,1118,107479,33412,74067,124031406.0,38171995.0,85859411.0,114.3,115.71,114.25,115.92
2023-09-29 10:35,984,167,817,57117,10411,46706,65743886.0,11824844.0,53919042.0,867,94,773,53145,9164,43981,61267444.0,10393663.0,50873781.0,113.58,115.44,113.42,115.67
2023-09-29 10:40,1019,108,911,53343,8858,44485,61447608.0,10040298.0,51407310.0,958,73,885,53304,8659,44645,61398754.0,9799934.0,51598819.0,113.35,115.56,113.18,115.58
2023-09-29 10:45,173,70,103,13331,5930,7401,15367106.0,6745824.0,8621282.0,120,34,86,11582,4762,6820,13349927.0,5398134.0,7951792.0,113.76,116.49,113.36,116.6
2023-09-29 10:50,154,64,90,12339,5598,6741,14242516.0,6380254.0,7862262.0,109,39,70,11489,5382,6107,13229162.0,6109930.0,7119232.0,113.97,116.63,113.53,116.57
2023-09-29 10:55,376,62,314,20944,4747,16197,24139796.0,5385790.0,18754005.0,333,42,291,20650,4683,15967,23808709.0,5309592.0,18499116.0,113.46,115.79,113.38,115.86
2023-09-29 11:00,192,55,137,11372,3788,7584,13097845.0,4316378.0,8781467.0,158,34,124,10258,3259,6999,11804901.0,3691693.0,8113208.0,113.95,115.79,113.28,115.92
2023-09-29 11:05,145,60,85,11795,5066,6729,13504526.0,5759019.0,7745507.0,96,40,56,10669,4736,5933,12278915.0,5366852.0,6912063.0,113.68,115.11,113.32,116.5
2023-09-29 11:10,119,54,65,6870,2868,4002,7893131.0,3254522.0,4638608.0,73,22,51,6679,2535,4144,7686523.0,2869277.0,4817245.0,113.48,115.91,113.19,116.25
2023-09-29 11:15,128,57,71,8865,3708,5157,10150019.0,4223652.0,5926367.0,79,33,46,7496,3298,4198,8628245.0,3734665.0,4893580.0,113.91,114.92,113.24,116.57
2023-09-29 11:20,87,43,44,4696,2124,2572,5281238.0,2436594.0,2844644.0,49,18,31,3679,1614,2065,4230533.0,1826732.0,2403801.0,114.72,110.6,113.18,116.41
2023-09-29 11:25,438,206,232,40093,20219,19874,46242409.0,23055484.0,23186924.0,333,151,182,37692,19121,18571,43439446.0,21761258.0,21678188.0,114.03,116.67,113.81,116.73
2023-09-29 11:30,278,116,162,23188,10688,12500,26637606.0,12115636.0,14521969.0,211,73,138,22747,10364,12383,26163863.0,11744215.0,14419647.0,113.36,116.18,113.32,116.45
2023-09-29 11:35,233,73,160,17551,7704,9847,20227212.0,8759599.0,11467613.0,199,61,138,16136,7025,9111,18584610.0,7975970.0,10608640.0,113.7,116.46,113.54,116.44
2023-09-29 11:40,126,43,83,7979,3208,4771,9235929.0,3649493.0,5586436.0,92,31,61,7304,2858,4446,8475633.0,3246415.0,5229218.0,113.76,117.09,113.59,117.62
2023-09-29 11:45,91,42,49,7459,3594,3865,8610929.0,4094970.0,4515959.0,66,27,39,6723,3371,3352,7731862.0,3815488.0,3916373.0,113.94,116.84,113.19,116.84
2023-09-29 11:50,45,23,22,3016,2164,852,3430537.0,2445683.0,984854.0,27,16,11,2926,1904,1022,3376674.0,2179538.0,1197135.0,113.02,115.59,114.47,117.14
2023-09-29 11:55,56,30,26,4143,1970,2173,4791683.0,2249469.0,2542213.0,42,16,26,3888,1819,2069,4482408.0,2064817.0,2417591.0,114.19,116.99,113.51,116.85
2023-09-29 12:00,112,51,61,9421,4669,4752,10852497.0,5317802.0,5534694.0,71,31,40,7915,3813,4102,9119816.0,4330413.0,4789402.0,113.9,116.47,113.57,116.76
2023-09-29 12:05,634,299,335,65706,34100,31606,75691766.0,38910715.0,36781051.0,490,219,271,61701,32222,29479,71086476.0,36740784.0,34345692.0,114.11,116.37,114.02,116.51
2023-09-29 12:10,231,99,132,26574,10244,16330,32009514.0,11635626.0,20373888.0,175,61,114,19691,9287,10404,22672478.0,10535076.0,12137401.0,113.58,124.76,113.44,116.66
2023-09-29 12:15,234,96,138,17197,7750,9447,20881932.0,9852914.0,11029018.0,199,72,127,14888,7027,7861,17153208.0,7982473.0,9170734.0,127.13,116.75,113.6,116.66
2023-09-29 12:20,169,60,109,12901,5895,7006,14845366.0,6694930.0,8150435.0,134,40,94,13212,6161,7051,15224841.0,6999098.0,8225743.0,113.57,116.34,113.6,116.66
2023-09-29 12:25,65,38,27,3018,1615,1403,3475093.0,1842493.0,1632599.0,55,33,22,2827,1636,1191,3258832.0,1866456.0,1392375.0,114.09,116.36,114.09,116.91
2023-09-29 12:30,118,40,78,10602,4957,5645,12161829.0,5636359.0,6525470.0,92,33,59,10699,5433,5266,12302977.0,6159168.0,6143808.0,113.71,115.6,113.37,116.67
2023-09-29 12:35,194,67,127,14731,6656,8075,16945573.0,7553904.0,9391669.0,168,55,113,14134,6447,7687,16273012.0,7313896.0,8959116.0,113.49,116.31,113.45,116.55
2023-09-29 12:40,153,37,116,6651,2593,4058,7659587.0,2942349.0,4717238.0,132,20,112,6593,2555,4038,7590563.0,2898557.0,4692005.0,113.47,116.25,113.45,116.2
2023-09-29 12:45,105,38,67,7614,3453,4161,8766244.0,3916629.0,4849615.0,88,26,62,12810,3252,9558,16161033.0,3686943.0,12474090.0,113.43,116.55,113.37,130.51
2023-09-29 12:50,352,208,144,31418,18130,13288,36373028.0,20781438.0,15591590.0,248,149,99,28374,16501,11873,32806999.0,18880200.0,13926799.0,114.62,117.34,114.42,117.3
2023-09-29 12:55,630,361,269,55524,28264,27260,64709758.0,32617292.0,32092466.0,456,244,212,50967,25415,25552,59203093.0,29109156.0,30093936.0,115.4,117.73,114.54,117.78
2023-09-29 13:00,469,346,123,40577,23109,17468,47447199.0,26858686.0,20588513.0,360,271,89,36619,20844,15775,42599807.0,23972345.0,18627461.0,116.23,117.86,115.01,118.08
2023-09-29 13:05,221,149,72,15213,8379,6834,17789306.0,9744401.0,8044905.0,166,125,41,14217,8154,6063,16544067.0,9393707.0,7150360.0,116.3,117.72,115.2,117.93
2023-09-29 13:10,185,108,77,11763,6095,5668,13689478.0,7057777.0,6631701.0,102,65,37,10138,5357,4781,11792805.0,6150957.0,5641847.0,115.8,117.0,114.82,118.01
2023-09-29 13:15,177,120,57,14980,7174,7806,17392872.0,8271133.0,9121738.0,129,87,42,13315,6840,6475,15487431.0,7853810.0,7633621.0,115.29,116.86,114.82,117.89
2023-09-29 13:20,428,345,83,24082,14723,9359,27985326.0,17022636.0,10962690.0,374,320,54,20617,14157,6460,23981424.0,16362101.0,7619322.0,115.62,117.14,115.58,117.95
2023-09-29 13:25,205,105,100,17867,9412,8455,20828617.0,10868886.0,9959730.0,134,69,65,16114,8247,7867,18744262.0,9473037.0,9271224.0,115.48,117.8,114.87,117.85
2023-09-29 13:30,139,90,49,8110,4104,4006,9433899.0,4723110.0,4710789.0,92,63,29,7644,3896,3748,8890791.0,4474102.0,4416688.0,115.09,117.59,114.84,117.84
2023-09-29 13:35,153,78,75,13052,6209,6843,15101511.0,7138859.0,7962652.0,97,53,44,11665,5983,5682,13562686.0,6858063.0,6704623.0,114.98,116.36,114.63,118.0
2023-09-29 13:40,154,87,67,13125,6604,6521,15255438.0,7590296.0,7665142.0,129,68,61,12520,5961,6559,14542439.0,6826026.0,7716412.0,114.93,117.55,114.51,117.65
2023-09-29 13:45,59,36,23,3535,1696,1839,4113975.0,1955217.0,2158757.0,40,26,14,3287,1577,1710,3817883.0,1806120.0,2011762.0,115.28,117.39,114.53,117.65
2023-09-29 13:50,121,68,53,11153,5941,5212,12977123.0,6841086.0,6136037.0,88,54,34,10364,5343,5021,12043625.0,6128094.0,5915530.0,115.15,117.73,114.69,117.82
2023-09-29 13:55,152,94,58,14323,7457,6866,16615852.0,8582354.0,8033497.0,111,72,39,13408,6979,6429,15589078.0,8006242.0,7582836.0,115.09,117.0,114.72,117.95
2023-09-29 14:00,80,48,32,5454,2611,2843,6348486.0,2998018.0,3350467.0,62,40,22,4593,2394,2199,5339533.0,2747547.0,2591986.0,114.82,117.85,114.77,117.87
2023-09-29 14:05,84,49,35,7010,3225,3785,8156154.0,3702928.0,4453226.0,73,49,24,6518,3213,3305,7583566.0,3686994.0,3896572.0,114.82,117.65,114.75,117.9
2023-09-29 14:10,86,49,37,5286,2535,2751,6136242.0,2913398.0,3222843.0,60,35,25,4674,2258,2416,5429690.0,2588494.0,2841196.0,114.93,117.15,114.64,117.6
2023-09-29 14:15,65,37,28,6780,3708,3072,7875116.0,4259413.0,3615703.0,54,30,24,6331,3308,3023,7351328.0,3789412.0,3561916.0,114.87,117.7,114.55,117.83
2023-09-29 14:20,67,34,33,6208,3126,3082,7188805.0,3582217.0,3606587.0,59,40,19,5944,3094,2850,6898178.0,3543797.0,3354381.0,114.59,117.02,114.54,117.7
2023-09-29 14:25,108,55,53,7982,3806,4176,9236338.0,4358974.0,4877364.0,88,43,45,7454,3607,3847,8650613.0,4128766.0,4521847.0,114.53,116.8,114.47,117.54
2023-09-29 14:30,235,112,123,25249,11837,13412,29307053.0,13542357.0,15764696.0,216,96,120,25923,11759,14164,30115054.0,13455341.0,16659713.0,114.41,117.54,114.43,117.62
2023-09-29 14:35,181,88,93,18726,11040,7686,21760462.0,12710846.0,9049616.0,137,63,74,19100,12134,6966,22110563.0,13918860.0,8191703.0,115.13,117.74,114.71,117.6
2023-09-29 14:40,192,96,96,14959,6488,8471,17186905.0,7434780.0,9752124.0,157,80,77,13298,6641,6657,15439027.0,7610276.0,7828751.0,114.59,115.12,114.6,117.6
2023-09-29 14:45,206,105,101,16976,8031,8945,19591161.0,9192293.0,10398867.0,164,74,90,15353,7686,7667,17783872.0,8794557.0,8989315.0,114.46,116.25,114.42,117.25
2023-09-29 14:50,204,110,94,18950,9626,9324,21966178.0,11031991.0,10934187.0,165,81,84,18187,9018,9169,21078344.0,10304836.0,10773507.0,114.61,117.27,114.27,117.5
2023-09-29 14:55,194,116,78,20493,11541,8952,23754757.0,13237390.0,10517366.0,168,108,60,18810,10019,8791,21813609.0,11469303.0,10344305.0,114.7,117.49,114.48,117.67
2023-09-29 15:00,128,67,61,11626,5183,6443,13291537.0,5950805.0,7340731.0,89,50,39,9616,5104,4512,11157462.0,5844853.0,5312608.0,114.81,113.93,114.52,117.74
2023-09-29 15:05,178,105,73,16813,8573,8240,19475133.0,9817925.0,9657208.0,149,86,63,16607,8445,8162,19250560.0,9656107.0,9594453.0,114.52,117.2,114.34,117.55
2023-09-29 15:10,126,73,53,9893,5044,4849,11467182.0,5783295.0,5683887.0,105,61,44,9477,4854,4623,10983645.0,5551724.0,5431920.0,114.66,117.22,114.37,117.5
2023-09-29 15:15,80,48,32,8719,4485,4234,10121082.0,5160934.0,4960148.0,67,42,25,8493,4325,4168,9847580.0,4945664.0,4901916.0,115.07,117.15,114.35,117.61
2023-09-29 15:20,60,38,22,5544,3105,2439,6443962.0,3576087.0,2867874.0,51,34,17,6478,3142,3336,7506504.0,3594529.0,3911974.0,115.17,117.58,114.4,117.27
2023-09-29 15:25,82,47,35,9119,4262,4857,10545231.0,4857474.0,5687757.0,72,41,31,8321,4188,4133,9629792.0,4777406.0,4852386.0,113.97,117.1,114.07,117.41
2023-09-29 15:30,41,20,21,2167,1123,1044,2506199.0,1286145.0,1220054.0,28,17,11,1836,1016,820,2124007.0,1161049.0,962958.0,114.53,116.86,114.28,117.43
2023-09-29 15:35,30,19,11,2642,1433,1209,3059031.0,1638706.0,1420324.0,26,15,11,2646,1431,1215,3061290.0,1634217.0,1427072.0,114.35,117.48,114.2,117.45
2023-09-29 15:40,35,22,13,2489,1175,1314,2884009.0,1341947.0,1542062.0,21,12,9,2160,1057,1103,2502465.0,1206402.0,1296062.0,114.21,117.36,114.13,117.5
2023-09-29 15:45,19,8,11,705,323,382,797035.0,369547.0,427488.0,14,6,8,570,277,293,662974.0,316762.0,346212.0,114.41,111.91,114.35,118.16
2023-09-29 15:50,79,56,23,7057,4230,2827,8171153.0,4848947.0,3322205.0,66,46,20,6357,3543,2814,7357987.0,4051281.0,3306706.0,114.63,117.52,114.35,117.51
2023-09-29 15:55,41,26,15,2913,1781,1132,3365483.0,2036897.0,1328586.0,26,14,12,2511,1243,1268,2908128.0,1418653.0,1489475.0,114.37,117.37,114.13,117.47
2023-09-29 16:00,54,35,19,3805,2323,1482,4394069.0,2651296.0,1742773.0,40,26,14,3577,2080,1497,4134140.0,2373742.0,1760398.0,114.13,117.6,114.12,117.6
2023-09-29 16:05,71,35,36,6589,3326,3263,7628688.0,3803487.0,3825200.0,55,34,21,6858,3808,3050,7918600.0,4332592.0,3586008.0,114.36,117.23,113.78,117.57
2023-09-29 16:10,55,24,31,4202,2171,2031,4844738.0,2483882.0,2360856.0,43,21,22,3962,2060,1902,4590460.0,2355038.0,2235421.0,114.41,116.24,114.32,117.53
2023-09-29 16:15,63,35,28,4721,2577,2144,5460530.0,2947759.0,2512771.0,56,29,27,5431,2723,2708,6314927.0,3117226.0,3197701.0,114.39,117.2,114.48,118.08
2023-09-29 16:20,55,32,23,3362,1745,1617,3888591.0,1996885.0,1891706.0,47,29,18,3182,1742,1440,3685895.0,1994017.0,1691878.0,114.43,116.99,114.47,117.49
2023-09-29 16:25,383,266,117,25721,16122,9599,29495873.0,18468420.0,11027452.0,322,233,89,24524,15877,8647,28292887.0,18187603.0,10105283.0,114.55,114.88,114.55,116.86
2023-09-29 16:30,295,89,206,19950,5896,14054,23048285.0,6713583.0,16334702.0,255,56,199,19714,5580,14134,22766936.0,6339015.0,16427920.0,113.87,116.23,113.6,116.23
2023-09-29 16:35,85,35,50,5386,2469,2917,6207316.0,2814651.0,3392664.0,64,25,39,5477,2687,2790,6313651.0,3061723.0,3251928.0,114.0,116.31,113.95,116.56
2023-09-29 16:40,167,43,124,10544,3312,7232,12137396.0,3775254.0,8362141.0,146,34,112,9737,3031,6706,11235422.0,3441619.0,7793803.0,113.99,115.63,113.55,116.22
2023-09-29 16:45,94,33,61,5787,2494,3293,6630870.0,2829175.0,3801695.0,76,26,50,5310,2378,2932,6113296.0,2700726.0,3412569.0,113.44,115.45,113.57,116.39
2023-09-29 16:50,95,52,43,6090,2802,3288,7016558.0,3186530.0,3830028.0,72,35,37,5753,2734,3019,6631588.0,3108232.0,3523356.0,113.72,116.49,113.69,116.71
2023-09-29 16:55,148,68,80,11871,5365,6506,13750668.0,6153880.0,7596787.0,120,51,69,11063,4834,6229,12765151.0,5499719.0,7265432.0,114.7,116.77,113.77,116.64
2023-09-29 17:00,440,186,254,31425,14826,16599,36251826.0,16983331.0,19268494.0,416,172,244,30213,14000,16213,34901893.0,16032025.0,18869868.0,114.55,116.08,114.51,116.39
2023-09-29 17:05,1126,73,1053,60527,8325,52202,70063163.0,9495407.0,60567756.0,1112,64,1048,60700,8491,52209,70259034.0,9678737.0,60580296.0,114.06,116.03,113.99,116.03
2023-09-29 17:10,270,156,114,25096,13022,12074,29152016.0,14993907.0,14158109.0,237,134,103,24481,12438,12043,28342017.0,14215665.0,14126352.0,115.14,117.26,114.29,117.3
2023-09-29 17:15,75,37,38,6610,3310,3300,7641912.0,3780158.0,3861754.0,59,32,27,6582,3466,3116,7620070.0,3959365.0,3660705.0,114.2,117.02,114.23,117.48
2023-09-29 17:20,77,39,38,7608,3691,3917,8811383.0,4216248.0,4595134.0,70,39,31,8148,3535,4613,9456837.0,4033429.0,5423408.0,114.23,117.31,114.1,117.57
2023-09-29 17:25,76,44,32,6158,3096,3062,7130527.0,3541859.0,3588667.0,61,37,24,5725,2963,2762,6690628.0,3384334.0,3306293.0,114.4,117.2,114.22,119.71
2023-09-29 17:30,651,110,541,43557,12185,31372,50281290.0,13854070.0,36427220.0,610,90,520,42945,12429,30516,49590619.0,14134899.0,35455720.0,113.7,116.11,113.73,116.19
2023-09-29 17:35,1493,57,1436,77831,5172,72659,90039414.0,5890194.0,84149220.0,1483,50,1433,78167,5249,72918,90427972.0,5967616.0,84460356.0,113.89,115.81,113.69,115.83
2023-09-29 17:40,797,378,419,49251,22560,26691,56975437.0,25946809.0,31028628.0,777,361,416,48968,22006,26962,56612559.0,25269947.0,31342612.0,115.01,116.25,114.83,116.25
2023-09-29 17:45,54,26,28,5551,3046,2505,6422761.0,3483008.0,2939753.0,46,21,25,5152,2523,2629,5963279.0,2878155.0,3085124.0,114.35,117.36,114.08,117.35
2023-09-29 17:50,60,24,36,23229,2982,20247,26842395.0,3405813.0,23436582.0,49,21,28,5081,2571,2510,5872867.0,2931455.0,2941411.0,114.21,115.75,114.02,117.19
2023-09-29 17:55,238,98,140,57543,11931,45612,66136148.0,13474369.0,52661778.0,211,77,134,73453,10777,62676,84593583.0,12206251.0,72387331.0,112.94,115.46,113.26,115.49
2023-09-29 18:00,340,193,147,43937,14957,28980,49848940.0,16627067.0,33221873.0,173,86,87,19342,10801,8541,22008989.0,12068844.0,9940144.0,111.17,114.64,111.74,116.38
2023-09-29 18:05,129,78,51,10257,5558,4699,11766638.0,6305507.0,5461130.0,98,48,50,9650,4805,4845,11059658.0,5425678.0,5633979.0,113.45,116.22,112.92,116.28
2023-09-29 18:10,87,57,30,7383,4086,3297,8490743.0,4654679.0,3836064.0,59,33,26,6586,3334,3252,7567022.0,3778285.0,3788736.0,113.92,116.35,113.33,116.5
2023-09-29 18:15,36,19,17,2751,1142,1609,3177115.0,1308792.0,1868322.0,29,15,14,3551,1562,1989,4094933.0,1774405.0,2320528.0,114.61,116.12,113.6,116.67
2023-09-29 18:20,66,41,25,6370,4180,2190,7041400.0,4529729.0,2511671.0,50,28,22,5307,3259,2048,5958093.0,3572721.0,2385371.0,108.37,114.69,109.63,116.47
2023-09-29 18:25,100,51,49,7569,3563,4006,8709238.0,4063277.0,4645961.0,72,41,31,7988,4100,3888,9129490.0,4586106.0,4543384.0,114.04,115.98,111.86,116.86
2023-09-29 18:30,187,90,97,14774,6728,8046,16817045.0,7620602.0,9196443.0,132,52,80,13365,5991,7374,15336114.0,6772583.0,8563531.0,113.27,114.3,113.05,116.13
2023-09-29 18:35,110,66,44,2364,822,1542,2630198.0,945134.0,1685064.0,54,24,30,3306,1727,1579,3798695.0,1911297.0,1887398.0,114.98,109.28,110.67,119.53
2023-10-02 10:00,1025,372,653,35973,17450,18523,41628278.0,18284486.0,23343792.0,181,105,76,9082,5443,3639,10413785.0,6184898.0,4228887.0,104.78,126.03,113.63,116.21
2023-10-02 10:05,571,358,213,26068,16112,9956,30807280.0,19040003.0,11767277.0,293,246,47,12978,10531,2447,15050141.0,12184742.0,2865398.0,118.17,118.19,115.7,117.1
2023-10-02 10:10,442,213,229,19684,9458,10226,23389404.0,11215645.0,12173759.0,205,133,72,12478,8380,4098,14491427.0,9648000.0,4843427.0,118.58,119.05,115.13,118.19
2023-10-02 10:15,249,133,116,10767,4172,6595,12684390.0,4847526.0,7836863.0,120,82,38,4787,2474,2313,5587719.0,2866231.0,2721487.0,116.19,118.83,115.85,117.66
2023-10-02 10:20,193,110,83,5991,2070,3921,6912068.0,2432373.0,4479695.0,81,49,32,3366,2014,1352,3869202.0,2287531.0,1581670.0,117.51,114.25,113.58,116.99
2023-10-02 10:25,276,202,74,8152,6091,2061,9502956.0,7111919.0,2391036.0,175,157,18,6098,5605,493,7089103.0,6510576.0,578526.0,116.76,116.01,116.16,117.35
2023-10-02 10:30,727,174,553,57603,18299,39304,66890622.0,20920308.0,45970314.0,662,147,515,56509,17909,38600,65661490.0,20502574.0,45158915.0,114.32,116.96,114.48,116.99
2023-10-02 10:35,487,178,309,28426,11589,16837,32955966.0,13230205.0,19725761.0,423,147,276,26991,10976,16015,31287708.0,12551333.0,18736375.0,114.16,117.16,114.35,116.99
2023-10-02 10:40,727,246,481,53262,19204,34058,61722092.0,21983384.0,39738708.0,654,201,453,51425,18371,33054,59595598.0,21002703.0,38592894.0,114.47,116.68,114.33,116.76
2023-10-02 10:45,900,211,689,46025,9822,36203,53400986.0,11201380.0,42199606.0,645,75,570,45393,9513,35880,52660021.0,10858311.0,41801709.0,114.04,116.56,114.14,116.5
2023-10-02 10:50,1124,138,986,71984,15158,56826,83523820.0,17318214.0,66205605.0,1086,118,968,70754,14340,56414,82085731.0,16366840.0,65718890.0,114.25,116.51,114.13,116.49
2023-10-02 10:55,430,40,390,24020,2766,21254,27904318.0,3161000.0,24743318.0,401,29,372,23794,2904,20890,27633326.0,3316264.0,24317062.0,114.28,116.42,114.2,116.41
2023-10-02 11:00,448,86,362,33359,8730,24629,38742183.0,10023873.0,28718309.0,414,71,343,32594,8385,24209,37791998.0,9573173.0,28218824.0,114.82,116.6,114.17,116.56
2023-10-02 11:05,1818,378,1440,120302,24696,95606,139661761.0,28283183.0,111378577.0,1773,346,1427,119805,24201,95604,139079035.0,27706195.0,111372840.0,114.53,116.5,114.48,116.49
2023-10-02 11:10,1494,631,863,93835,36962,56873,108963024.0,42522079.0,66440944.0,1464,615,849,92820,36277,56543,107759537.0,41731229.0,66028307.0,115.04,116.82,115.03,116.78
2023-10-02 11:15,630,294,336,36568,15984,20584,42415815.0,18397782.0,24018033.0,604,282,322,36239,15740,20499,42068458.0,18117779.0,23950679.0,115.1,116.68,115.11,116.84
2023-10-02 11:20,48,23,25,3449,1483,1966,4005168.0,1697374.0,2307794.0,33,20,13,2774,1511,1263,3214380.0,1729745.0,1484634.0,114.46,117.39,114.48,117.55
2023-10-02 11:25,62,33,29,3368,1582,1786,3921775.0,1821624.0,2100151.0,41,27,14,2742,1529,1213,3184841.0,1752274.0,1432566.0,115.15,117.59,114.6,118.1
2023-10-02 11:30,3506,526,2980,141788,40583,101205,165244772.0,46895670.0,118349101.0,3352,448,2904,138452,39123,99329,161351045.0,45184146.0,116166899.0,115.55,116.94,115.49,116.95
2023-10-02 11:35,2001,364,1637,126366,25466,100900,147240517.0,29237455.0,118003062.0,1975,353,1622,124263,25210,99053,144706419.0,28937355.0,115769064.0,114.81,116.95,114.79,116.88
2023-10-02 11:40,1240,65,1175,63743,2769,60974,74312155.0,3182370.0,71129785.0,1212,53,1159,63710,2717,60993,74270547.0,3114211.0,71156336.0,114.93,116.66,114.62,116.66
2023-10-02 11:45,762,45,717,40706,2486,38220,47453221.0,2853956.0,44599264.0,740,34,706,40511,2377,38134,47221817.0,2722520.0,44499296.0,114.8,116.69,114.54,116.69
2023-10-02 11:50,1336,904,432,68453,42946,25507,79803216.0,49960187.0,29843028.0,1280,875,405,66384,41770,24614,77225119.0,48358613.0,28866505.0,116.33,117.0,115.77,117.28
2023-10-02 11:55,2162,955,1207,79174,51084,28090,92232834.0,59268189.0,32964645.0,2149,955,1194,76119,50345,25774,88582761.0,58326961.0,30255799.0,116.02,117.35,115.85,117.39
2023-10-02 12:00,1745,1289,456,94512,69503,25009,110006424.0,80573762.0,29432661.0,1717,1277,440,94212,69732,24480,109632829.0,80818500.0,28814329.0,115.93,117.69,115.9,117.71
2023-10-02 12:05,2630,2250,380,179458,136459,42999,208928053.0,158131548.0,50796504.0,2600,2235,365,178651,135927,42724,207974528.0,157511094.0,50463433.0,115.88,118.13,115.88,118.11
2023-10-02 12:10,1221,713,508,80440,45985,34455,93682437.0,53290697.0,40391740.0,1192,705,487,77796,45499,32297,90631579.0,52738327.0,37893252.0,115.89,117.23,115.91,117.33
2023-10-02 12:15,487,119,368,35259,10907,24352,41055007.0,12535050.0,28519957.0,461,104,357,33552,10875,22677,39071364.0,12492785.0,26578579.0,114.93,117.12,114.88,117.21
2023-10-02 12:20,1921,265,1656,117316,25958,91358,136523142.0,29805480.0,106717661.0,1852,211,1641,116256,24944,91312,135276434.0,28633575.0,106642859.0,114.82,116.81,114.79,116.79
2023-10-02 12:25,214,96,118,16075,8996,7079,18690110.0,10310394.0,8379716.0,179,84,95,13489,7275,6214,15738781.0,8386152.0,7352628.0,114.61,118.37,115.27,118.32
2023-10-02 12:30,690,258,432,45418,21272,24146,52358926.0,24182349.0,28176576.0,651,229,422,43187,19028,24159,50063696.0,21870469.0,28193227.0,113.68,116.69,114.94,116.7
2023-10-02 12:35,864,85,779,64190,12753,51437,74555604.0,14591366.0,59964238.0,853,77,776,63933,12684,51249,74256451.0,14510032.0,59746419.0,114.42,116.58,114.4,116.58
2023-10-02 12:40,676,106,570,46694,10499,36195,54233564.0,12027307.0,42206256.0,662,100,562,46813,10345,36468,54362475.0,11839109.0,42523366.0,114.56,116.61,114.44,116.6
2023-10-02 12:45,400,86,314,22088,3559,18529,25692946.0,4100912.0,21592034.0,385,79,306,22140,3489,18651,25753495.0,4018650.0,21734844.0,115.23,116.53,115.18,116.53
2023-10-02 12:50,547,56,491,33658,3426,30232,39175549.0,3943145.0,35232403.0,521,45,476,33204,3215,29989,38644841.0,3692651.0,34952190.0,115.09,116.54,114.86,116.55
2023-10-02 12:55,1063,230,833,71480,19511,51969,83240277.0,22491339.0,60748938.0,1043,223,820,71596,19727,51869,83308919.0,22675206.0,60633713.0,115.28,116.89,114.95,116.9
2023-10-02 13:00,1439,524,915,96226,41068,55158,111919998.0,47298164.0,64621834.0,1413,506,907,95892,40894,54998,111551138.0,47095625.0,64455513.0,115.17,117.16,115.17,117.2
2023-10-02 13:05,1354,145,1209,78626,12830,65796,91336824.0,14710199.0,76626625.0,1345,143,1202,78041,12725,65316,90723107.0,14587904.0,76135203.0,114.65,116.46,114.64,116.56
2023-10-02 13:10,1675,168,1507,113650,20641,93009,132006675.0,23617279.0,108389395.0,1655,156,1499,113149,20365,92784,131471824.0,23293625.0,108178198.0,114.42,116.54,114.38,116.59
2023-10-02 13:15,1038,174,864,70484,13665,56819,81849668.0,15626766.0,66222902.0,1009,154,855,70243,13553,56690,81555890.0,15494999.0,66060890.0,114.36,116.55,114.33,116.53
2023-10-02 13:20,775,95,680,60460,12622,47838,70188859.0,14420358.0,55768501.0,766,94,672,60241,12571,47670,69933507.0,14361242.0,55572264.0,114.25,116.58,114.24,116.58
2023-10-02 13:25,600,79,521,38680,6173,32507,44918273.0,7050054.0,37868219.0,585,66,519,38972,5741,33231,45288076.0,6559035.0,38729040.0,114.21,116.49,114.25,116.54
2023-10-02 13:30,252,32,220,15642,2188,13454,18146352.0,2496600.0,15649752.0,245,29,216,15657,2138,13519,18175318.0,2441863.0,15733454.0,114.1,116.32,114.21,116.38
2023-10-02 13:35,197,36,161,12949,2282,10667,15037105.0,2612006.0,12425099.0,176,23,153,11884,1773,10111,13805174.0,2024380.0,11780794.0,114.46,116.48,114.18,116.51
2023-10-02 13:40,526,62,464,36294,5660,30634,42046826.0,6467874.0,35578951.0,502,49,453,36751,5753,30998,42628252.0,6570135.0,36058117.0,114.27,116.14,114.2,116.32
2023-10-02 13:45,286,37,249,19730,3784,15946,22919437.0,4357507.0,18561929.0,271,30,241,19200,3699,15501,22185246.0,4157541.0,18027705.0,115.16,116.4,112.4,116.3
2023-10-02 13:50,269,29,240,16363,2281,14082,18996030.0,2624770.0,16371259.0,258,22,236,16036,1977,14059,18614362.0,2265957.0,16348405.0,115.07,116.26,114.62,116.28
2023-10-02 13:55,168,21,147,9720,776,8944,11285496.0,890891.0,10394605.0,155,14,141,10192,1342,8850,11827345.0,1542895.0,10284450.0,114.81,116.22,114.97,116.21
2023-10-02 14:00,907,89,818,63121,9975,53146,73320484.0,11419005.0,61901478.0,890,81,809,62509,9384,53125,72606244.0,10728842.0,61877402.0,114.48,116.47,114.33,116.48
2023-10-02 14:05,2028,1110,918,110126,60617,49509,128020603.0,70150869.0,57869733.0,1999,1093,906,107842,58472,49370,125345323.0,67640819.0,57704504.0,115.73,116.89,115.68,116.88
2023-10-02 14:10,3015,2056,959,162260,114333,47927,188600971.0,132431367.0,56169603.0,2979,2041,938,162003,114244,47759,188297102.0,132318632.0,55978469.0,115.83,117.2,115.82,117.21
2023-10-02 14:15,1597,1391,206,113876,95311,18565,132321310.0,110446031.0,21875278.0,1565,1382,183,112011,94556,17455,130182495.0,109566864.0,20615631.0,115.88,117.83,115.88,118.11
2023-10-02 14:20,2398,564,1834,160440,50323,110117,185913899.0,57934363.0,127979536.0,2352,544,1808,157934,50567,107367,183433142.0,58218963.0,125214179.0,115.13,116.22,115.13,116.62
2023-10-02 14:25,2330,188,2142,143805,15143,128662,167022590.0,17305508.0,149717082.0,2288,158,2130,143127,14141,128986,166268802.0,16148984.0,150119818.0,114.28,116.36,114.2,116.38
2023-10-02 14:30,1620,103,1517,96066,12307,83759,111481837.0,14051224.0,97430612.0,1592,94,1498,96194,12620,83574,111631667.0,14398950.0,97232717.0,114.17,116.32,114.1,116.34
2023-10-02 14:35,1438,63,1375,74411,4159,70252,86418700.0,4756855.0,81661845.0,1428,56,1372,74085,3918,70167,86042241.0,4475745.0,81566496.0,114.37,116.24,114.24,116.25
2023-10-02 14:40,1035,32,1003,53742,2317,51425,62444796.0,2645938.0,59798858.0,1009,18,991,52335,2110,50225,60796545.0,2407648.0,58388897.0,114.2,116.28,114.11,116.25
2023-10-02 14:45,1254,117,1137,80188,13644,66544,93031537.0,15577776.0,77453761.0,1243,110,1133,80101,13590,66511,92930458.0,15512303.0,77418155.0,114.17,116.39,114.14,116.4
2023-10-02 14:50,296,42,254,17731,2851,14880,20689546.0,3259701.0,17429845.0,292,41,251,17461,3126,14335,20257086.0,3577579.0,16679506.0,114.34,117.14,114.45,116.36
2023-10-02 14:55,354,13,341,16054,759,15295,18577671.0,868385.0,17709286.0,348,12,336,15752,763,14989,18301030.0,870332.0,17430698.0,114.41,115.78,114.07,116.29
2023-10-02 15:00,820,37,783,45881,3835,42046,53280787.0,4369945.0,48910842.0,812,33,779,45576,3631,41945,52935778.0,4142239.0,48793538.0,113.95,116.33,114.08,116.33
2023-10-02 15:05,252,17,235,12294,529,11765,14291621.0,605723.0,13685898.0,242,13,229,12198,536,11662,14171061.0,613184.0,13557876.0,114.5,116.33,114.4,116.26
2023-10-02 15:10,209,12,197,11083,1168,9915,12882909.0,1351785.0,11531123.0,201,7,194,10512,605,9907,12212725.0,690137.0,11522587.0,115.74,116.3,114.07,116.31
2023-10-02 15:15,217,11,206,10091,188,9903,11720936.0,218045.0,11502891.0,207,4,203,9925,42,9883,11534533.0,48182.0,11486350.0,115.98,116.16,114.72,116.22
2023-10-02 15:20,566,27,539,27268,651,26617,31670473.0,752094.0,30918378.0,570,31,539,27132,631,26501,31526374.0,725967.0,30800407.0,115.53,116.16,115.05,116.22
2023-10-02 15:25,1645,488,1157,93231,35575,57656,108132297.0,40844770.0,67287527.0,1553,427,1126,91568,34661,56907,106245724.0,39794463.0,66451261.0,114.81,116.71,114.81,116.77
2023-10-02 15:30,1185,167,1018,68609,13896,54713,80960611.0,15921903.0,65038708.0,1164,151,1013,62557,13586,48971,72577504.0,15566534.0,57010970.0,114.58,118.87,114.58,116.42
2023-10-02 15:35,848,221,627,48789,16023,32766,56700301.0,18543091.0,38157210.0,832,215,617,49607,17181,32426,57273283.0,19503122.0,37770160.0,115.73,116.45,113.52,116.48
2023-10-02 15:40,1039,903,136,64115,56138,7977,74365987.0,64978212.0,9387775.0,1019,896,123,63814,56067,7747,74000803.0,64881473.0,9119330.0,115.75,117.69,115.72,117.71
2023-10-02 15:45,1789,681,1108,135353,55738,79615,156572812.0,63848937.0,92723875.0,1749,649,1100,131037,51995,79042,151967946.0,59812562.0,92155383.0,114.55,116.47,115.04,116.59
2023-10-02 15:50,981,48,933,63333,4961,58372,73481180.0,5659998.0,67821182.0,972,43,929,63175,4871,58304,73295116.0,5555789.0,67739326.0,114.09,116.19,114.06,116.18
2023-10-02 15:55,1647,55,1592,103956,6095,97861,120689550.0,6964852.0,113724698.0,1623,41,1582,104264,6050,98214,121045567.0,6902882.0,114142684.0,114.27,116.21,114.1,116.22
2023-10-02 16:00,838,248,590,53253,18003,35250,61835379.0,20726918.0,41108461.0,820,246,574,59042,18278,40764,69864102.0,20990120.0,48873982.0,115.13,116.62,114.84,119.89
2023-10-02 16:05,513,133,380,27377,8001,19376,31567540.0,9182131.0,22385408.0,495,121,374,25724,7755,17969,29829978.0,8892064.0,20937914.0,114.76,115.53,114.66,116.52
2023-10-02 16:10,1235,176,1059,51677,7201,44476,59884348.0,8257866.0,51626482.0,1220,169,1051,50963,6960,44003,59099232.0,7979221.0,51120011.0,114.68,116.08,114.64,116.17
2023-10-02 16:15,102,37,65,6673,2948,3725,7693562.0,3365904.0,4327658.0,89,39,50,7352,3391,3961,8505770.0,3864774.0,4640995.0,114.18,116.18,113.97,117.17
2023-10-02 16:20,45,25,20,3867,1940,1927,4453882.0,2197287.0,2256594.0,36,22,14,3269,1743,1526,3778991.0,1989338.0,1789652.0,113.26,117.1,114.13,117.28
2023-10-02 16:25,50,32,18,3095,1731,1364,3583988.0,1992764.0,1591224.0,31,18,13,2903,1583,1320,3356504.0,1808778.0,1547726.0,115.12,116.66,114.26,117.25
2023-10-02 16:30,53,29,24,2280,1349,931,2616781.0,1544534.0,1072247.0,37,26,11,2112,1411,701,2437940.0,1616909.0,821030.0,114.49,115.17,114.59,117.12
2023-10-02 16:35,239,183,56,19793,13634,6159,22971434.0,15792799.0,7178634.0,218,173,45,17554,11707,5847,20315252.0,13454304.0,6860948.0,115.83,116.56,114.93,117.34
2023-10-02 16:40,145,56,89,11295,4557,6738,12985439.0,5193019.0,7792420.0,113,39,74,11093,4452,6641,12840691.0,5068459.0,7772232.0,113.96,115.65,113.85,117.03
2023-10-02 16:45,155,45,110,12215,4831,7384,14041503.0,5495373.0,8546129.0,155,45,110,12247,4853,7394,14126546.0,5521210.0,8605336.0,113.75,115.74,113.77,116.38
2023-10-02 16:50,69,33,36,7152,2881,4271,8255333.0,3277380.0,4977952.0,55,24,31,6992,2823,4169,8075831.0,3209720.0,4866110.0,113.76,116.55,113.7,116.72
2023-10-02 16:55,208,86,122,14341,5985,8356,16510291.0,6797598.0,9712692.0,187,76,111,13298,5326,7972,15334979.0,6059556.0,9275422.0,113.58,116.24,113.77,116.35
2023-10-02 17:00,729,201,528,40696,11446,29250,46943562.0,13042588.0,33900974.0,720,195,525,40521,11366,29155,46735533.0,12940180.0,33795353.0,113.95,115.9,113.85,115.92
2023-10-02 17:05,237,51,186,11511,1784,9727,13226790.0,2028507.0,11198283.0,215,38,177,11131,1634,9497,12842173.0,1855163.0,10987010.0,113.71,115.13,113.54,115.69
2023-10-02 17:10,251,30,221,13944,2030,11914,16078537.0,2305443.0,13773093.0,244,24,220,14261,2065,12196,16427641.0,2328271.0,14099369.0,113.57,115.6,112.75,115.61
2023-10-02 17:15,847,148,699,47237,10241,36996,54476818.0,11661338.0,42815480.0,815,124,691,47037,10144,36893,54240711.0,11531207.0,42709504.0,113.87,115.73,113.68,115.77
2023-10-02 17:20,401,64,337,23828,5663,18165,27514605.0,6445647.0,21068958.0,393,60,333,23978,5436,18542,27691460.0,6185794.0,21505666.0,113.82,115.99,113.79,115.98
2023-10-02 17:25,119,22,97,7790,2392,5398,8995941.0,2719568.0,6276373.0,109,21,88,7735,2397,5338,8932965.0,2725643.0,6207321.0,113.69,116.27,113.71,116.29
2023-10-02 17:30,264,46,218,14121,2504,11617,16298436.0,2848120.0,13450315.0,255,45,210,14624,3074,11550,16893802.0,3492350.0,13401451.0,113.74,115.78,113.61,116.03
2023-10-02 17:35,236,40,196,12313,2395,9918,14236714.0,2732602.0,11504112.0,212,24,188,11858,2039,9819,13707535.0,2313676.0,11393859.0,114.1,115.99,113.47,116.04
2023-10-02 17:40,233,14,219,9953,670,9283,11518682.0,761451.0,10757231.0,223,10,213,9710,429,9281,11243027.0,486451.0,10756576.0,113.65,115.88,113.39,115.9
2023-10-02 17:45,195,48,147,12102,3751,8351,13944264.0,4268033.0,9676230.0,187,39,148,11601,3313,8288,13392056.0,3759285.0,9632771.0,113.78,115.87,113.47,116.23
2023-10-02 17:50,111,40,71,6873,2439,4434,7931894.0,2778264.0,5153629.0,105,38,67,7002,2615,4387,8082158.0,2980362.0,5101796.0,113.91,116.23,113.97,116.29
2023-10-02 17:55,359,37,322,18714,2528,16186,21651116.0,2883710.0,18767405.0,351,31,320,18669,2486,16183,21599338.0,2835537.0,18763801.0,114.07,115.95,114.06,115.95
2023-10-02 18:00,1826,924,902,109257,56661,52596,126226926.0,65094505.0,61132420.0,1796,911,885,109794,57117,52677,126770290.0,65541163.0,61229127.0,114.88,116.23,114.75,116.24
2023-10-02 18:05,2315,1827,488,143262,102463,40799,165428403.0,117763891.0,47664511.0,2312,1832,480,141890,101605,40285,163798914.0,116732951.0,47065963.0,114.93,116.83,114.89,116.83
2023-10-02 18:10,373,180,193,17384,9472,7912,20045964.0,10883735.0,9162229.0,363,174,189,17025,9407,7618,19658864.0,10809230.0,8849634.0,114.9,115.8,114.91,116.17
2023-10-02 18:15,756,148,608,38579,10657,27922,44547681.0,12153938.0,32393743.0,738,140,598,38267,10521,27746,44192321.0,11996999.0,32195322.0,114.05,116.02,114.03,116.04
2023-10-02 18:20,835,230,605,55575,20558,35017,64205667.0,23459268.0,40746398.0,820,222,598,54830,20366,34464,63346372.0,23237333.0,40109039.0,114.11,116.36,114.1,116.38
2023-10-02 18:25,1250,609,641,84711,40787,43924,97313997.0,46819641.0,50494355.0,1188,585,603,84457,42336,42121,97040658.0,48160607.0,48880051.0,114.79,114.96,113.76,116.05
2023-10-02 18:30,204,102,102,7968,3960,4008,9125134.0,4539007.0,4586127.0,171,80,91,7485,3825,3660,8607709.0,4372032.0,4235677.0,114.62,114.42,114.3,115.73
2023-10-02 18:35,301,110,191,9968,2856,7112,11404258.0,3347768.0,8056489.0,277,98,179,10183,2642,7541,11841454.0,3013893.0,8827561.0,117.22,113.28,114.08,117.06
2023-10-03 10:00,2388,1267,1121,84763,51415,33348,98332590.0,57832289.0,40500300.0,1394,942,452,52615,37060,15555,61180954.0,43019378.0,18161576.0,112.48,121.45,116.08,116.76
2023-10-03 10:05,1053,605,448,38890,20540,18350,44868386.0,23570023.0,21298363.0,840,500,340,30965,17328,13637,35844516.0,19950129.0,15894387.0,114.75,116.07,115.13,116.55
2023-10-03 10:10,2084,1658,426,96567,84900,11667,112360776.0,98735237.0,13625538.0,1878,1565,313,87327,79235,8092,101071051.0,91632112.0,9438939.0,116.3,116.79,115.65,116.65
2023-10-03 10:15,1175,685,490,75273,44249,31024,88131855.0,51419036.0,36712818.0,895,574,321,67659,41098,26561,78867871.0,47462163.0,31405708.0,116.2,118.34,115.49,118.24
2023-10-03 10:20,5772,3424,2348,342074,215370,126704,411613411.0,257043140.0,154570271.0,3420,2275,1145,243811,156013,87798,289759015.0,184016328.0,105742687.0,119.35,121.99,117.95,120.44
2023-10-03 10:25,10980,6156,4824,667269,388798,278471,810718165.0,470624346.0,340093819.0,7942,4794,3148,552108,332496,219612,667986777.0,399632718.0,268354059.0,121.05,122.13,120.19,122.19
2023-10-03 10:30,7106,3400,3706,442190,229006,213184,531396390.0,274416527.0,256979862.0,5425,2529,2896,386451,207850,178601,464544254.0,248038541.0,216505713.0,119.83,120.54,119.34,121.22
2023-10-03 10:35,3287,1534,1753,208393,93608,114785,249500939.0,111367287.0,138133652.0,2721,1234,1487,191990,88838,103152,229760143.0,105404068.0,124356074.0,118.97,120.34,118.65,120.56
2023-10-03 10:40,4700,3092,1608,304310,197134,107176,365264118.0,235720364.0,129543754.0,4007,2695,1312,283975,187243,96732,340611820.0,223173845.0,117437975.0,119.57,120.87,119.19,121.41
2023-10-03 10:45,1750,1115,635,113455,63567,49888,136378128.0,75874400.0,60503728.0,1310,862,448,99269,60965,38304,118997536.0,72515469.0,46482066.0,119.36,121.28,118.95,121.35
2023-10-03 10:50,1702,1125,577,112980,72263,40717,135093840.0,86320701.0,48773139.0,1433,989,444,104287,67582,36705,124893640.0,80415069.0,44478571.0,119.45,119.79,118.99,121.18
2023-10-03 10:55,1156,339,817,80249,25644,54605,95580346.0,30293658.0,65286688.0,933,222,711,72442,21733,50709,86769932.0,25607830.0,61162102.0,118.13,119.56,117.83,120.61
2023-10-03 11:00,1895,620,1275,115998,38519,77479,137312679.0,45470303.0,91842376.0,1492,423,1069,104782,34044,70738,124729523.0,40033216.0,84696306.0,118.05,118.54,117.59,119.73
2023-10-03 11:05,2084,1109,975,127427,64787,62640,152516325.0,78385711.0,74130613.0,1869,984,885,119659,60553,59106,141728256.0,71134312.0,70593944.0,120.99,118.34,117.47,119.44
2023-10-03 11:10,2038,992,1046,134331,62245,72086,158066865.0,73160633.0,84906232.0,1534,648,886,118846,54914,63932,140469841.0,64296755.0,76173085.0,117.54,117.78,117.09,119.15
2023-10-03 11:15,3773,2933,840,272981,200258,72723,325310900.0,237345367.0,87965533.0,3276,2663,613,254703,190399,64304,302570340.0,224789727.0,77780612.0,118.52,120.96,118.06,120.96
2023-10-03 11:20,2270,854,1416,142656,57544,85112,169601803.0,67930252.0,101671551.0,2162,810,1352,137210,56928,80282,163121980.0,67129133.0,95992847.0,118.05,119.46,117.92,119.57
2023-10-03 11:25,492,285,207,28866,14635,14231,33981464.0,17173169.0,16808295.0,395,242,153,29579,14501,15078,35036247.0,17008861.0,18027386.0,117.34,118.11,117.29,119.56
2023-10-03 11:30,2152,700,1452,138797,43252,95545,163006425.0,50475908.0,112530517.0,1885,556,1329,128564,39589,88975,151762260.0,46114229.0,105648031.0,116.7,117.78,116.48,118.74
2023-10-03 11:35,2065,748,1317,124336,39622,84714,147337030.0,46409917.0,100927113.0,1767,522,1245,113253,34809,78444,134120400.0,40544932.0,93575468.0,117.13,119.14,116.48,119.29
2023-10-03 11:40,1757,449,1308,106524,29576,76948,124638207.0,34413673.0,90224533.0,1571,331,1240,103296,28216,75080,121403932.0,32774153.0,88629778.0,116.36,117.25,116.15,118.05
2023-10-03 11:45,1110,339,771,73752,20988,52764,86042842.0,24314302.0,61728539.0,968,245,723,68625,19765,48860,80344202.0,22852004.0,57492198.0,115.85,116.99,115.62,117.67
2023-10-03 11:50,527,178,349,34938,10896,24042,41158221.0,12748529.0,28409691.0,453,124,329,31808,9158,22650,37503548.0,10695249.0,26808299.0,117.0,118.17,116.79,118.36
2023-10-03 11:55,702,397,305,42333,21112,21221,50376068.0,24518736.0,25857332.0,555,297,258,39212,18934,20278,46467724.0,21925387.0,24542337.0,116.14,121.85,115.8,121.03
2023-10-03 12:00,603,229,374,41452,16695,24757,48660315.0,19397608.0,29262707.0,487,165,322,35222,14674,20548,41280446.0,16975153.0,24305293.0,116.19,118.2,115.68,118.29
2023-10-03 12:05,1262,794,468,75828,47211,28617,89213759.0,55315932.0,33897826.0,1084,695,389,71887,45531,26356,84438057.0,53176825.0,31261232.0,117.17,118.45,116.79,118.61
2023-10-03 12:10,1382,1040,342,99854,73275,26579,118231099.0,86498861.0,31732238.0,1201,954,247,90956,68086,22870,107211970.0,79845651.0,27366319.0,118.05,119.39,117.27,119.66
2023-10-03 12:15,833,630,203,60025,39994,20031,70978396.0,47018937.0,23959458.0,728,572,156,56296,37777,18519,66485960.0,44321959.0,22164000.0,117.56,119.61,117.33,119.68
2023-10-03 12:20,309,187,122,23728,12879,10849,28191478.0,15214865.0,12976613.0,245,155,90,22052,11782,10270,26069464.0,13775182.0,12294282.0,118.14,119.61,116.92,119.71
2023-10-03 12:25,324,191,133,27509,14642,12867,32756797.0,17239271.0,15517526.0,276,180,96,26308,14687,11621,31170949.0,17210086.0,13960862.0,117.74,120.6,117.18,120.13
2023-10-03 12:30,339,196,143,28303,15272,13031,33587105.0,18019529.0,15567575.0,265,149,116,25533,12768,12765,30311047.0,14965256.0,15345791.0,117.99,119.47,117.21,120.22
2023-10-03 12:35,672,454,218,48668,30455,18213,58319500.0,36326155.0,21993345.0,553,391,162,45782,28412,17370,54527539.0,33561795.0,20965743.0,119.28,120.76,118.13,120.7
2023-10-03 12:40,338,192,146,31282,16019,15263,37239293.0,18891276.0,18348016.0,293,178,115,30417,16362,14055,36233148.0,19274672.0,16958476.0,117.93,120.21,117.8,120.66
2023-10-03 12:45,445,136,309,31480,12156,19324,37401248.0,14344653.0,23056594.0,379,111,268,31588,11711,19877,37621191.0,13756246.0,23864945.0,118.0,119.32,117.46,120.06
2023-10-03 12:50,1321,321,1000,81494,21846,59648,96788253.0,25782448.0,71005804.0,1229,271,958,77629,19946,57683,92188529.0,23412769.0,68775760.0,118.02,119.04,117.38,119.23
2023-10-03 12:55,1739,1178,561,123780,79282,44498,148624217.0,95197297.0,53426919.0,1549,1083,466,110739,67975,42764,131936356.0,80528469.0,51407886.0,120.07,120.07,118.47,120.21
2023-10-03 13:00,1923,1645,278,126946,98167,28779,152856390.0,117737541.0,35118849.0,1773,1592,181,120769,95800,24969,144928774.0,114421988.0,30506785.0,119.94,122.03,119.44,122.18
2023-10-03 13:05,2283,1266,1017,144529,81731,62798,173419466.0,97663948.0,75755518.0,2061,1185,876,133186,76851,56335,159745874.0,91569184.0,68176690.0,119.49,120.63,119.15,121.02
2023-10-03 13:10,2539,578,1961,168717,42351,126366,201654409.0,50235694.0,151418714.0,2404,507,1897,164156,40586,123570,196597876.0,48125037.0,148472839.0,118.62,119.83,118.58,120.15
2023-10-03 13:15,2303,967,1336,130832,58284,72548,156621602.0,69293957.0,87327645.0,2213,920,1293,127927,56646,71281,153149007.0,67225345.0,85923661.0,118.89,120.37,118.68,120.54
2023-10-03 13:20,670,294,376,50457,25365,25092,60487601.0,30060019.0,30427582.0,600,265,335,48834,24542,24292,58511277.0,29055782.0,29455495.0,118.51,121.26,118.39,121.26
2023-10-03 13:25,326,223,103,25515,16989,8526,30540669.0,20211190.0,10329478.0,273,204,69,24769,16818,7951,29648177.0,19968194.0,9679982.0,118.97,121.15,118.73,121.75
2023-10-03 13:30,157,95,62,12418,7202,5216,14890752.0,8640513.0,6250239.0,116,76,40,12338,6948,5390,14796901.0,8223043.0,6573858.0,119.97,119.83,118.35,121.96
2023-10-03 13:35,1656,461,1195,108634,38842,69792,127883468.0,45673750.0,82209718.0,1452,364,1088,99193,35343,63850,118030253.0,41557329.0,76472924.0,117.59,117.79,117.58,119.77
2023-10-03 13:40,430,182,248,30450,14516,15934,36049769.0,16985567.0,19064202.0,355,146,209,29567,14236,15331,34992895.0,16620793.0,18372102.0,117.01,119.64,116.75,119.84
2023-10-03 13:45,310,126,184,24446,11255,13191,28954663.0,13226243.0,15728420.0,288,108,180,24140,11170,12970,28560809.0,13057486.0,15503323.0,117.51,119.24,116.9,119.53
2023-10-03 13:50,175,53,122,12900,4996,7904,15280125.0,5866472.0,9413653.0,146,37,109,10557,2784,7773,12510621.0,3250073.0,9260548.0,117.42,119.1,116.74,119.14
2023-10-03 13:55,1194,154,1040,78115,10136,67979,92492948.0,11818890.0,80674058.0,1144,115,1029,77139,9791,67348,91401045.0,11402857.0,79998188.0,116.6,118.67,116.46,118.78
2023-10-03 14:00,1947,631,1316,131599,44929,86670,155977690.0,52759276.0,103218414.0,1910,616,1294,132174,45782,86392,156574255.0,53676841.0,102897413.0,117.43,119.09,117.24,119.11
2023-10-03 14:05,2269,1252,1017,140010,73280,66730,165605828.0,86153200.0,79452628.0,2240,1239,1001,138237,72332,65905,163650629.0,85029369.0,78621260.0,117.57,119.07,117.55,119.29
2023-10-03 14:10,1252,552,700,81279,36542,44737,96472315.0,43100087.0,53372227.0,1140,472,668,77912,33035,44877,92471144.0,38914780.0,53556363.0,117.95,119.3,117.8,119.34
2023-10-03 14:15,2650,1665,985,158239,103099,55140,188260339.0,122114076.0,66146263.0,2562,1633,929,156552,102894,53658,186145974.0,121769088.0,64376885.0,118.44,119.96,118.34,119.98
2023-10-03 14:20,1458,1032,426,97249,68213,29036,116104779.0,81093605.0,35011173.0,1338,968,370,91934,66445,25489,109573902.0,78868161.0,30705740.0,118.88,120.58,118.7,120.47
2023-10-03 14:25,1756,1590,166,116938,101630,15308,139912137.0,121306770.0,18605367.0,1687,1577,110,112943,99385,13558,134984097.0,118466270.0,16517827.0,119.36,121.54,119.2,121.83
2023-10-03 14:30,1806,1592,214,129406,97467,31939,154890787.0,116094908.0,38795878.0,1712,1544,168,120876,97590,23286,144519894.0,116235697.0,28284197.0,119.11,121.47,119.11,121.46
2023-10-03 14:35,2777,2304,473,166413,135591,30822,199329385.0,161920836.0,37408548.0,2644,2220,424,163239,133074,30165,195340504.0,158718423.0,36622080.0,119.42,121.37,119.27,121.41
2023-10-03 14:40,4147,3269,878,238719,192073,46646,287222412.0,230455317.0,56767095.0,3834,3081,753,229164,185672,43492,275346805.0,222332772.0,53014032.0,119.98,121.7,119.74,121.89
2023-10-03 14:45,1634,1378,256,95516,77564,17952,115629278.0,93707731.0,21921547.0,1401,1274,127,87726,70699,17027,105647366.0,84773995.0,20873370.0,120.81,122.11,119.91,122.59
2023-10-03 14:50,1314,813,501,71764,38819,32945,86339863.0,46403899.0,39935964.0,1168,767,401,68107,39006,29101,81950494.0,46597273.0,35353221.0,119.54,121.22,119.46,121.48
2023-10-03 14:55,1083,827,256,67728,43579,24149,81049710.0,51808610.0,29241099.0,1010,782,228,63805,40167,23638,76397543.0,47725954.0,28671589.0,118.88,121.09,118.82,121.29
2023-10-03 15:00,1163,505,658,75683,31714,43969,90395433.0,37674115.0,52721317.0,1091,456,635,75179,33744,41435,89777338.0,39992514.0,49784823.0,118.79,119.91,118.52,120.15
2023-10-03 15:05,318,141,177,18179,10864,7315,21644136.0,12842075.0,8802060.0,291,128,163,17933,10568,7365,21408282.0,12505733.0,8902548.0,118.21,120.33,118.34,120.88
2023-10-03 15:10,420,351,69,26484,19087,7397,31737822.0,22769399.0,8968422.0,377,323,54,24478,18095,6383,29265552.0,21520848.0,7744704.0,119.29,121.24,118.93,121.33
2023-10-03 15:15,418,218,200,28505,14631,13874,34148937.0,17383909.0,16765027.0,383,200,183,29358,14647,14711,35162372.0,17368463.0,17793908.0,118.82,120.84,118.58,120.96
2023-10-03 15:20,340,228,112,21261,11827,9434,25522958.0,14057469.0,11465489.0,314,210,104,20577,11671,8906,24654142.0,13855262.0,10798880.0,118.86,121.53,118.72,121.25
2023-10-03 15:25,2188,1745,443,140086,100798,39288,168778931.0,120924991.0,47853939.0,2013,1641,372,125813,91072,34741,151287892.0,108958062.0,42329830.0,119.97,121.8,119.64,121.84
2023-10-03 15:30,1331,666,665,99925,53734,46191,120632347.0,64510039.0,56122308.0,1054,540,514,91283,48977,42306,110005074.0,58471137.0,51533936.0,120.05,121.5,119.38,121.81
2023-10-03 15:35,1375,491,884,106835,42107,64728,128784411.0,50305497.0,78478913.0,1186,378,808,104125,40199,63926,125727292.0,47882229.0,77845062.0,119.47,121.24,119.11,121.77
2023-10-03 15:40,1404,893,511,94712,61383,33329,115063588.0,74436324.0,40627263.0,1201,821,380,84493,54286,30207,102080749.0,65210964.0,36869785.0,121.27,121.9,120.12,122.06
2023-10-03 15:45,1190,747,443,90490,53260,37230,109565637.0,64261226.0,45304411.0,943,661,282,77287,50987,26300,93557784.0,61261184.0,32296600.0,120.66,121.69,120.15,122.8
2023-10-03 15:50,1512,380,1132,97956,32706,65250,117948463.0,39096805.0,78851658.0,1403,311,1092,93715,30505,63210,113475379.0,36389242.0,77086136.0,119.54,120.85,119.29,121.95
2023-10-03 15:55,477,226,251,32611,16015,16596,39271416.0,19167382.0,20104034.0,368,171,197,28599,14347,14252,34572378.0,17136774.0,17435604.0,119.68,121.14,119.45,122.34
2023-10-03 16:00,2069,902,1167,126507,50233,76274,152848451.0,61083427.0,91765023.0,1911,813,1098,121125,48187,72938,145984154.0,57496828.0,88487325.0,121.6,120.31,119.32,121.32
2023-10-03 16:05,5129,3633,1496,335873,228188,107685,417078711.0,281708111.0,135370599.0,3541,2696,845,250851,169747,81104,310114082.0,207726189.0,102387892.0,123.45,125.71,122.37,126.24
2023-10-03 16:10,2996,1748,1248,206131,99452,106679,261797996.0,121084134.0,140713862.0,2052,1124,928,180423,88146,92277,231620649.0,107721263.0,123899386.0,121.75,131.9,122.21,134.27
2023-10-03 16:15,4734,3048,1686,279919,157462,122457,356686302.0,193346264.0,163340038.0,3231,2084,1147,234230,130015,104215,299380199.0,158629572.0,140750627.0,122.79,133.39,122.01,135.06
2023-10-03 16:20,2353,1096,1257,188704,83605,105099,245575392.0,101071793.0,144503599.0,1778,752,1026,164286,71268,93018,218198655.0,85967494.0,132231160.0,120.89,137.49,120.63,142.16
2023-10-03 16:25,1383,655,728,89491,41531,47960,113326551.0,50221743.0,63104808.0,1093,485,608,80476,38462,42014,98236968.0,46251579.0,51985389.0,120.93,131.58,120.25,123.73
2023-10-03 16:30,1873,806,1067,122260,47147,75113,151619090.0,56859067.0,94760023.0,1592,628,964,112916,43055,69861,141453486.0,51773154.0,89680332.0,120.6,126.16,120.25,128.37
2023-10-03 16:35,1759,1372,387,106624,76007,30617,133793967.0,92944498.0,40849468.0,1324,1062,262,90293,64192,26101,113199150.0,77914704.0,35284445.0,122.28,133.42,121.38,135.18
2023-10-03 16:40,2788,2032,756,176252,118202,58050,215774949.0,144198941.0,71576008.0,2183,1635,548,159915,109271,50644,198685501.0,132872774.0,65812727.0,121.99,123.3,121.6,129.95
2023-10-03 16:45,1089,691,398,65877,38262,27615,80553531.0,46595036.0,33958494.0,858,560,298,57452,35293,22159,70346136.0,42862167.0,27483969.0,121.78,122.97,121.45,124.03
2023-10-03 16:50,5306,3059,2247,365969,225658,140311,456303708.0,282013539.0,174290169.0,3273,2238,1035,265623,169466,96157,330585376.0,210049517.0,120535858.0,124.97,124.22,123.95,125.35
2023-10-03 16:55,7613,3817,3796,469647,247926,221721,596963288.0,312974487.0,283988801.0,4710,2448,2262,350406,180041,170365,445684982.0,224489782.0,221195200.0,126.24,128.08,124.69,129.84
2023-10-03 17:00,4477,2052,2425,311024,148032,162992,396174814.0,190821746.0,205353068.0,3317,1563,1754,257192,126173,131019,330044828.0,162017138.0,168027690.0,128.91,125.99,128.41,128.25
2023-10-03 17:05,2717,1705,1012,180861,110855,70006,227800094.0,138495960.0,89304134.0,2187,1456,731,171055,106342,64713,215364574.0,132080635.0,83283938.0,124.93,127.57,124.2,128.7
2023-10-03 17:10,3330,1569,1761,255671,102462,153209,317798238.0,127057794.0,190740443.0,2547,1132,1415,208917,87036,121881,260670318.0,107557664.0,153112654.0,124.0,124.5,123.58,125.62
2023-10-03 17:15,3011,1617,1394,242530,123314,119216,304975174.0,155917824.0,149057350.0,2352,1252,1100,212169,110337,101832,263915711.0,135461801.0,128453909.0,126.44,125.03,122.77,126.14
2023-10-03 17:20,1725,966,759,118728,59642,59086,148291016.0,74644146.0,73646869.0,1333,731,602,109120,53651,55469,136314425.0,66925783.0,69388642.0,125.15,124.64,124.74,125.09
2023-10-03 17:25,2458,1407,1051,163829,94872,68957,206540344.0,118526402.0,88013942.0,1744,1132,612,145622,87245,58377,183590999.0,108697209.0,74893790.0,124.93,127.64,124.59,128.29
2023-10-03 17:30,1890,872,1018,117070,51072,65998,149486024.0,62839519.0,86646505.0,1690,749,941,109779,47189,62590,141019604.0,58017907.0,83001697.0,123.04,131.29,122.95,132.61
2023-10-03 17:35,844,326,518,56819,22890,33929,70257935.0,28009956.0,42247979.0,699,222,477,58857,24059,34798,73108034.0,29645308.0,43462726.0,122.37,124.52,123.22,124.9
2023-10-03 17:40,1381,751,630,97962,51711,46251,121925937.0,64054901.0,57871036.0,1091,615,476,95555,50077,45478,118750849.0,61674584.0,57076264.0,123.87,125.12,123.16,125.5
2023-10-03 17:45,1355,793,562,98018,55971,42047,129142049.0,69455096.0,59686953.0,954,584,370,85195,49236,35959,110522932.0,60697568.0,49825364.0,124.09,141.95,123.28,138.56
2023-10-03 17:50,1022,488,534,73006,32639,40367,96838314.0,41531785.0,55306528.0,806,362,444,66141,28777,37364,89623166.0,35452671.0,54170494.0,127.25,137.01,123.2,144.98
2023-10-03 17:55,1818,952,866,146505,63357,83148,181117370.0,77980534.0,103136835.0,1488,762,726,131728,53191,78537,164516920.0,66518336.0,97998584.0,123.08,124.04,125.06,124.78
2023-10-03 18:00,1600,967,633,85209,50530,34679,105588024.0,62372333.0,43215691.0,1526,937,589,85651,51447,34204,106172834.0,63409742.0,42763092.0,123.44,124.62,123.25,125.02
2023-10-03 18:05,765,479,286,54054,31116,22938,66899942.0,38361754.0,28538187.0,644,412,232,50157,29814,20343,62270710.0,36716953.0,25553757.0,123.29,124.41,123.15,125.61
2023-10-03 18:10,2471,848,1623,182512,63593,118919,224953281.0,77797554.0,147155726.0,2049,577,1472,166483,53296,113187,205901656.0,65127194.0,140774462.0,122.34,123.74,122.2,124.37
2023-10-03 18:15,2600,881,1719,188639,60063,128576,230269422.0,73223193.0,157046229.0,2072,553,1519,175796,56645,119151,216675720.0,68980746.0,147694974.0,121.91,122.14,121.78,123.96
2023-10-03 18:20,1731,937,794,127366,61430,65936,156941396.0,75236798.0,81704598.0,1431,746,685,116644,56041,60603,143673031.0,68358580.0,75314451.0,122.48,123.92,121.98,124.28
2023-10-03 18:25,2272,1002,1270,163895,75076,88819,201086056.0,91754978.0,109331077.0,1976,820,1156,155644,70440,85204,191608668.0,86000539.0,105608129.0,122.22,123.09,122.09,123.95
2023-10-03 18:30,1859,1345,514,111716,81191,30525,138808179.0,100856992.0,37951187.0,1415,1087,328,90011,67311,22700,111366040.0,82998367.0,28367672.0,124.22,124.33,123.31,124.97
2023-10-03 18:35,1382,1027,355,81735,64762,16973,101926745.0,81337069.0,20589675.0,856,705,151,63550,55911,7639,78902494.0,69300852.0,9601642.0,125.59,121.31,123.95,125.69
2023-10-04 10:00,8880,3852,5028,381775,161648,220127,473163727.0,199107494.0,274056232.0,5424,2059,3365,262572,98398,164174,328319672.0,121864575.0,206455097.0,123.17,124.5,123.85,125.75
2023-10-04 10:05,6567,4018,2549,274626,171911,102715,340324300.0,213050830.0,127273469.0,5329,3327,2002,233794,154013,79781,290216210.0,190557355.0,99658855.0,123.93,123.91,123.73,124.92
2023-10-04 10:10,3863,1735,2128,165746,57706,108040,202768168.0,70410261.0,132357907.0,2583,922,1661,131215,38160,93055,161023857.0,46356110.0,114667747.0,122.02,122.51,121.48,123.23
2023-10-04 10:15,2954,2183,771,193894,143794,50100,238248680.0,176059269.0,62189411.0,2513,1899,614,180745,135094,45651,222316536.0,165400749.0,56915787.0,122.44,124.13,122.43,124.68
2023-10-04 10:20,1177,682,495,91494,54356,37138,113949988.0,67645143.0,46304845.0,948,570,378,80158,49920,30238,98727932.0,60967115.0,37760817.0,124.45,124.68,122.13,124.88
2023-10-04 10:25,3200,1562,1638,223518,93606,129912,271980392.0,113474798.0,158505594.0,2705,1220,1485,202614,82225,120389,248248972.0,99766727.0,148482244.0,121.23,122.01,121.33,123.34
2023-10-04 10:30,2904,1218,1686,192542,68525,124017,234365693.0,82770734.0,151594958.0,2413,885,1528,181021,62136,118885,220667018.0,74781409.0,145885609.0,120.79,122.24,120.35,122.71
2023-10-04 10:35,3069,1374,1695,188985,83756,105229,231506426.0,101957698.0,129548727.0,2584,1111,1473,179863,79501,100362,220014635.0,96383329.0,123631306.0,121.73,123.11,121.24,123.19
2023-10-04 10:40,2113,923,1190,143004,49897,93107,175103652.0,60553758.0,114549894.0,1861,750,1111,132715,44999,87716,162269084.0,54429168.0,107839916.0,121.36,123.03,120.96,122.94
2023-10-04 10:45,2768,845,1923,156097,54494,101603,191420195.0,66448393.0,124971802.0,2506,688,1818,149902,50052,99850,183726702.0,60717798.0,123008903.0,121.94,123.0,121.31,123.19
2023-10-04 10:50,1252,393,859,80252,25353,54899,98101095.0,30727444.0,67373651.0,1096,310,786,75201,24312,50889,92061885.0,29367557.0,62694328.0,121.2,122.72,120.79,123.2
2023-10-04 10:55,775,289,486,51685,19204,32481,63124169.0,23226290.0,39897878.0,629,185,444,46525,16570,29955,56880186.0,19983651.0,36896534.0,120.95,122.83,120.6,123.17
2023-10-04 11:00,1521,514,1007,96778,33526,63252,117953777.0,40477950.0,77475827.0,1282,340,942,84722,27320,57402,103434988.0,32925347.0,70509640.0,120.74,122.49,120.52,122.83
2023-10-04 11:05,1328,612,716,88118,31158,56960,107169480.0,37555809.0,69613670.0,1070,438,632,81762,27911,53851,99716815.0,33589819.0,66126995.0,120.53,122.22,120.35,122.8
2023-10-04 11:10,1738,1112,626,117925,59393,58532,143956503.0,71822481.0,72134021.0,1477,925,552,113829,57016,56813,138912662.0,68814068.0,70098594.0,120.93,123.24,120.69,123.38
2023-10-04 11:15,2672,1549,1123,143316,76495,66821,175661617.0,93428091.0,82233526.0,2410,1400,1010,139323,74236,65087,170287060.0,90154210.0,80132850.0,122.14,123.07,121.44,123.12
2023-10-04 11:20,1322,387,935,90688,30869,59819,110777591.0,37369919.0,73407672.0,1185,313,872,88971,30686,58285,108886145.0,37085724.0,71800420.0,121.06,122.72,120.86,123.19
2023-10-04 11:25,2292,1673,619,148017,102046,45971,181342964.0,124598837.0,56744127.0,2096,1540,556,144676,99650,45026,176950605.0,121390575.0,55560030.0,122.1,123.43,121.82,123.4
2023-10-04 11:30,548,333,215,49034,34449,14585,59919431.0,41939036.0,17980394.0,478,295,183,46047,33128,12919,56290412.0,40325352.0,15965059.0,121.74,123.28,121.73,123.58
2023-10-04 11:35,1246,410,836,73749,25007,48742,90279769.0,30322563.0,59957206.0,1154,355,799,71860,23972,47888,87862091.0,28960040.0,58902051.0,121.26,123.01,120.81,123.0
2023-10-04 11:40,1256,269,987,79098,13668,65430,96522048.0,16494806.0,80027241.0,1140,197,943,75976,13026,62950,92807400.0,15696666.0,77110734.0,120.68,122.31,120.5,122.5
2023-10-04 11:45,1567,239,1328,107772,15350,92422,132727245.0,18497480.0,114229764.0,1505,200,1305,104647,14807,89840,127796095.0,17820206.0,109975889.0,120.5,123.6,120.35,122.41
2023-10-04 11:50,870,185,685,69034,16108,52926,85313587.0,19391666.0,65921920.0,801,139,662,67505,14840,52665,83476405.0,17859340.0,65617064.0,120.39,124.55,120.35,124.59
2023-10-04 11:55,1647,642,1005,128037,54463,73574,156415905.0,66180403.0,90235502.0,1394,493,901,119830,49699,70131,146395680.0,60181467.0,86214212.0,121.51,122.65,121.09,122.93
2023-10-04 12:00,727,196,531,58446,15924,42522,71043556.0,19207552.0,51836003.0,646,151,495,56443,15292,41151,68902523.0,18375676.0,50526846.0,120.62,121.9,120.17,122.78
2023-10-04 12:05,1180,329,851,79117,17536,61581,97490043.0,22161320.0,75328722.0,1015,213,802,76589,16335,60254,93410413.0,19617493.0,73792919.0,126.38,122.32,120.09,122.47
2023-10-04 12:10,700,224,476,46892,14428,32464,57170734.0,17367922.0,39802812.0,609,167,442,45839,13823,32016,55872339.0,16606384.0,39265955.0,120.38,122.61,120.14,122.64
2023-10-04 12:15,367,138,229,30873,12209,18664,37788646.0,14736863.0,23051782.0,296,92,204,27248,8994,18254,33447724.0,10808850.0,22638873.0,120.7,123.51,120.18,124.02
2023-10-04 12:20,355,174,181,19951,9477,10474,24391371.0,11495487.0,12895883.0,285,120,165,18545,8192,10353,22639673.0,9880287.0,12759385.0,121.3,123.12,120.61,123.24
2023-10-04 12:25,339,109,230,22101,7513,14588,27012754.0,9090068.0,17922686.0,290,80,210,21851,7409,14442,26687907.0,8933886.0,17754021.0,120.99,122.86,120.58,122.93
2023-10-04 12:30,589,127,462,33461,6867,26594,40982314.0,8319993.0,32662320.0,554,108,446,33523,7070,26453,41028563.0,8557492.0,32471071.0,121.16,122.82,121.04,122.75
2023-10-04 12:35,1076,297,779,61179,20987,40192,74864551.0,25470039.0,49394511.0,1012,260,752,59465,19705,39760,72753182.0,23881398.0,48871784.0,121.36,122.9,121.19,122.92
2023-10-04 12:40,1713,1131,582,117455,81569,35886,144111110.0,99640393.0,44470717.0,1558,1071,487,111520,79305,32215,136704607.0,96749930.0,39954676.0,122.15,123.92,122.0,124.03
2023-10-04 12:45,360,218,142,31635,17321,14314,38991362.0,21161299.0,17830063.0,310,203,107,32409,19554,12855,39738527.0,23721458.0,16017068.0,122.17,124.56,121.31,124.6
2023-10-04 12:50,2778,2487,291,225113,193894,31219,278093323.0,239134904.0,38958418.0,2607,2386,221,216383,186854,29529,266255050.0,229368930.0,36886119.0,123.33,124.79,122.75,124.91
2023-10-04 12:55,2145,1771,374,174607,135713,38894,215047883.0,166555773.0,48492110.0,2092,1742,350,171498,133171,38327,211216502.0,163437924.0,47778578.0,122.73,124.68,122.73,124.66
2023-10-04 13:00,1060,255,805,76203,16198,60005,93701546.0,19681475.0,74020071.0,1020,252,768,76224,17242,58982,93770514.0,20910931.0,72859582.0,121.51,123.36,121.28,123.53
2023-10-04 13:05,1087,185,902,73039,12381,60658,90082362.0,15013520.0,75068842.0,1054,168,886,71846,12622,59224,88307630.0,15285529.0,73022100.0,121.26,123.76,121.1,123.3
2023-10-04 13:10,1157,442,715,79869,26277,53592,98057986.0,32010781.0,66047204.0,1120,433,687,76616,25627,50989,94007584.0,31113934.0,62893650.0,121.82,123.24,121.41,123.35
2023-10-04 13:15,516,103,413,38902,8547,30355,47618083.0,10310888.0,37307195.0,484,83,401,39751,8266,31485,48825793.0,10037571.0,38788221.0,120.64,122.9,121.43,123.2
2023-10-04 13:20,1369,80,1289,93712,5847,87865,115237876.0,7069611.0,108168265.0,1354,72,1282,95471,5890,89581,117753684.0,7119458.0,110634225.0,120.91,123.11,120.87,123.5
2023-10-04 13:25,951,185,766,68512,11665,56847,83766748.0,14041819.0,69724929.0,905,155,750,67225,10878,56347,82379838.0,13092417.0,69287421.0,120.38,122.65,120.36,122.97
2023-10-04 13:30,1484,124,1360,102931,11817,91114,126004673.0,14258959.0,111745713.0,1433,97,1336,101751,12103,89648,124597443.0,14605779.0,109991664.0,120.66,122.64,120.68,122.69
2023-10-04 13:35,808,80,728,53591,5974,47617,65648390.0,7206640.0,58441750.0,773,62,711,52302,5071,47231,64122909.0,6116384.0,58006525.0,120.63,122.73,120.61,122.81
2023-10-04 13:40,414,103,311,25549,5699,19850,31274977.0,6909113.0,24365864.0,383,79,304,22912,4113,18799,28050600.0,4961420.0,23089180.0,121.23,122.75,120.63,122.82
2023-10-04 13:45,1328,233,1095,85130,15793,69337,104244694.0,19171150.0,85073544.0,1287,207,1080,84358,15071,69287,103279253.0,18254644.0,85024608.0,121.39,122.7,121.12,122.71
2023-10-04 13:50,904,196,708,63188,18856,44332,77462195.0,22843505.0,54618689.0,826,141,685,60574,17929,42645,74165492.0,21653314.0,52512178.0,121.15,123.2,120.77,123.14
2023-10-04 13:55,112,81,31,7522,5198,2324,9183235.0,6300265.0,2882969.0,105,81,24,7200,5099,2101,8806102.0,6197819.0,2608283.0,121.21,124.05,121.55,124.14
2023-10-04 14:00,577,449,128,44728,35940,8788,54602273.0,43815151.0,10787122.0,553,437,116,44323,36028,8295,54161358.0,43914951.0,10246407.0,121.91,122.75,121.89,123.53
2023-10-04 14:05,721,342,379,49050,23496,25554,60010561.0,28546383.0,31464178.0,683,325,358,46911,22960,23951,57365664.0,27884553.0,29481111.0,121.49,123.13,121.45,123.09
2023-10-04 14:10,417,164,253,33783,9633,24150,41323876.0,11663646.0,29660229.0,406,159,247,33996,9558,24438,41589792.0,11568889.0,30020903.0,121.08,122.82,121.04,122.85
2023-10-04 14:15,996,329,667,83394,24683,58711,102028753.0,29854500.0,72174252.0,979,323,656,83403,24789,58614,102036197.0,29977091.0,72059106.0,120.95,122.93,120.93,122.94
2023-10-04 14:20,2001,279,1722,115816,14079,101737,141609452.0,16976155.0,124633297.0,1946,248,1698,114292,13805,100487,139755316.0,16638883.0,123116433.0,120.58,122.51,120.53,122.52
2023-10-04 14:25,3376,541,2835,223480,37001,186479,273202912.0,44664711.0,228538201.0,3329,509,2820,222074,36707,185367,271465591.0,44287132.0,227178458.0,120.71,122.55,120.65,122.56
2023-10-04 14:30,2464,461,2003,144833,37017,107816,176902922.0,44725755.0,132177166.0,2423,441,1982,143199,36557,106642,174946710.0,44171242.0,130775468.0,120.82,122.6,120.83,122.63
2023-10-04 14:35,2113,380,1733,118274,25200,93074,144329201.0,30376260.0,113952940.0,2062,338,1724,115970,23119,92851,141586803.0,27880844.0,113705959.0,120.54,122.43,120.6,122.46
2023-10-04 14:40,1744,406,1338,122686,33026,89660,149539757.0,39941500.0,109598256.0,1616,330,1286,119116,32573,86543,145335585.0,39215148.0,106120437.0,120.94,122.24,120.39,122.62
2023-10-04 14:45,345,204,141,25406,13167,12239,31034493.0,15881444.0,15153049.0,306,187,119,23768,11904,11864,29059859.0,14365336.0,14694523.0,120.62,123.81,120.68,123.86
2023-10-04 14:50,1419,449,970,91140,30465,60675,111112507.0,36784261.0,74328246.0,1360,413,947,87879,27870,60009,107239452.0,33696261.0,73543191.0,120.74,122.5,120.91,122.55
2023-10-04 14:55,2059,630,1429,138605,45333,93272,167329224.0,54438010.0,112891213.0,1708,416,1292,118664,41496,77168,144136466.0,49766309.0,94370157.0,120.08,121.03,119.93,122.29
2023-10-04 15:00,953,487,466,62484,31240,31244,75461095.0,37535628.0,37925467.0,762,348,414,57752,29783,27969,69966449.0,35701113.0,34265336.0,120.15,121.38,119.87,122.51
2023-10-04 15:05,674,314,360,40373,19857,20516,48836093.0,23802412.0,25033680.0,538,199,339,36469,16602,19867,44146976.0,19880325.0,24266651.0,119.87,122.02,119.75,122.15
2023-10-04 15:10,1255,766,489,79521,46672,32849,96380370.0,56263532.0,40116837.0,1119,669,450,77200,45353,31847,93447751.0,54514710.0,38933040.0,120.55,122.12,120.2,122.25
2023-10-04 15:15,1112,440,672,67062,23713,43349,80809486.0,28410611.0,52398874.0,949,312,637,61917,20570,41347,74981218.0,24659440.0,50321778.0,119.81,120.88,119.88,121.71
2023-10-04 15:20,1281,385,896,79771,23603,56168,96812657.0,28284693.0,68527964.0,1211,353,858,79988,24095,55893,96970628.0,28778543.0,68192085.0,119.84,122.01,119.44,122.0
2023-10-04 15:25,1917,337,1580,140319,24840,115479,170233143.0,29739464.0,140493679.0,1832,286,1546,140575,25297,115278,170484325.0,30282053.0,140202271.0,119.72,121.66,119.71,121.62
2023-10-04 15:30,1737,382,1355,127794,23479,104315,154060413.0,28027291.0,126033121.0,1528,249,1279,121704,23221,98483,147165835.0,27654183.0,119511652.0,119.37,120.82,119.09,121.35
2023-10-04 15:35,1017,377,640,73354,22315,51039,88393073.0,26570808.0,61822265.0,819,218,601,71578,21696,49882,86367724.0,25811181.0,60556543.0,119.07,121.13,118.97,121.4
2023-10-04 15:40,355,170,185,26621,8779,17842,32208487.0,10538962.0,21669524.0,307,130,177,26410,8878,17532,31912129.0,10575771.0,21336358.0,120.05,121.45,119.12,121.7
2023-10-04 15:45,1066,408,658,79481,24399,55082,95725389.0,29055292.0,66670096.0,881,278,603,72948,21505,51443,87910658.0,25537048.0,62373610.0,119.08,121.04,118.75,121.25
2023-10-04 15:50,1340,209,1131,102854,15760,87094,124003767.0,18740500.0,105263267.0,1252,166,1086,101446,16190,85256,122302690.0,19244022.0,103058668.0,118.91,120.86,118.86,120.88
2023-10-04 15:55,1492,400,1092,119467,34410,85057,143626930.0,40987064.0,102639866.0,1344,271,1073,116252,32340,83912,140028227.0,38404457.0,101623769.0,119.11,120.67,118.75,121.11
2023-10-04 16:00,450,222,228,37516,20740,16776,44845007.0,24420757.0,20424249.0,362,163,199,33052,17298,15754,39608282.0,20437975.0,19170307.0,117.75,121.75,118.15,121.69
2023-10-04 16:05,621,231,390,44487,22929,21558,53638946.0,27410905.0,26228040.0,554,206,348,44401,23242,21159,53485713.0,27738154.0,25747559.0,119.55,121.66,119.34,121.69
2023-10-04 16:10,753,401,352,57636,25827,31809,67145517.0,30809166.0,36336351.0,446,227,219,35983,17311,18672,43250994.0,20617198.0,22633796.0,119.29,114.23,119.1,121.22
2023-10-04 16:15,3157,2100,1057,175776,101391,74385,210731103.0,120694560.0,90036543.0,2616,1673,943,168984,95400,73584,202727798.0,113542568.0,89185229.0,119.04,121.04,119.02,121.2
2023-10-04 16:20,1673,471,1202,121237,30109,91128,145231601.0,35728938.0,109502663.0,1478,324,1154,116846,27301,89545,140237833.0,32339035.0,107898797.0,118.67,120.16,118.45,120.5
2023-10-04 16:25,792,337,455,55521,17146,38375,66601260.0,20337091.0,46264169.0,702,265,437,55081,17060,38021,66100430.0,20211434.0,45888995.0,118.61,120.56,118.47,120.69
2023-10-04 16:30,1125,485,640,87635,32931,54704,105401946.0,39232874.0,66169071.0,829,251,578,82258,30427,51831,98896390.0,36106085.0,62790305.0,119.14,120.96,118.66,121.14
2023-10-04 16:35,771,420,351,71632,38781,32851,86472503.0,46481740.0,39990763.0,580,291,289,65446,34582,30864,78594412.0,41014874.0,37579538.0,119.86,121.73,118.6,121.76
2023-10-04 16:40,1644,1281,363,96808,66076,30732,117276455.0,79622709.0,37653746.0,1482,1160,322,92705,64043,28662,111972637.0,76917954.0,35054683.0,120.5,122.52,120.1,122.3
2023-10-04 16:45,2195,833,1362,160387,56195,104192,192437109.0,67199305.0,125237804.0,2033,759,1274,154701,55001,99700,186628860.0,65749171.0,120879689.0,119.58,120.2,119.54,121.24
2023-10-04 16:50,1508,284,1224,94534,23127,71407,113902852.0,27533362.0,86369490.0,1447,265,1182,93191,22577,70614,112424306.0,26883984.0,85540322.0,119.05,120.95,119.08,121.14
2023-10-04 16:55,1806,527,1279,129880,37210,92670,156608873.0,44506002.0,112102871.0,1703,454,1249,126736,35145,91591,152695137.0,41879956.0,110815181.0,119.61,120.97,119.16,120.99
2023-10-04 17:00,1682,304,1378,116180,19653,96527,144367807.0,27795482.0,116572325.0,1602,249,1353,114300,19825,94475,139910877.0,25824429.0,114086447.0,141.43,120.77,130.26,120.76
2023-10-04 17:05,1057,299,758,80487,23414,57073,105418343.0,35323298.0,70095045.0,1025,290,735,81487,24574,56913,106179286.0,37281997.0,68897288.0,150.86,122.82,151.71,121.06
2023-10-04 17:10,1672,1050,622,107836,79405,28431,131792952.0,97111886.0,34681066.0,1553,986,567,104536,77458,27078,129373877.0,96277381.0,33096496.0,122.3,121.98,124.3,122.23
2023-10-04 17:15,459,117,342,28197,12525,15672,34048470.0,14980933.0,19067536.0,474,153,321,28571,13664,14907,34527622.0,16359255.0,18168366.0,119.61,121.67,119.73,121.88
2023-10-04 17:20,1582,1288,294,137189,103348,33841,165425293.0,124133946.0,41291347.0,1565,1283,282,136522,103255,33267,164686403.0,123967390.0,40719012.0,120.11,122.02,120.06,122.4
2023-10-04 17:25,575,114,461,42411,8690,33721,51302449.0,10370899.0,40931550.0,537,84,453,42362,8432,33930,51238123.0,10048107.0,41190016.0,119.34,121.38,119.17,121.4
2023-10-04 17:30,1392,873,519,96605,69537,27068,117414260.0,84273832.0,33140428.0,1244,816,428,91636,66476,25160,111230110.0,80419918.0,30810191.0,121.19,122.43,120.98,122.46
2023-10-04 17:35,2250,1986,264,173746,148968,24778,211401261.0,180822710.0,30578551.0,2184,1961,223,172371,148744,23627,209581350.0,180398991.0,29182358.0,121.38,123.41,121.28,123.51
2023-10-04 17:40,1775,1064,711,123054,78625,44429,149352797.0,95000996.0,54351801.0,1696,1021,675,122442,77715,44727,148647767.0,93822356.0,54825411.0,120.83,122.33,120.73,122.58
2023-10-04 17:45,3111,2361,750,223557,171212,52345,271691841.0,207320307.0,64371533.0,3005,2318,687,217344,169713,47631,264060612.0,205394328.0,58666283.0,121.09,122.98,121.02,123.17
2023-10-04 17:50,522,346,176,38002,26172,11830,46196860.0,31747544.0,14449315.0,444,322,122,35900,25315,10585,43600081.0,30559742.0,13040339.0,121.3,122.14,120.72,123.2
2023-10-04 17:55,892,157,735,69563,14586,54977,84644984.0,17450309.0,67194675.0,835,127,708,67086,13086,54000,81649528.0,15650093.0,65999434.0,119.64,122.22,119.59,122.22
2023-10-04 18:00,390,122,268,32621,8798,23823,39504074.0,10501359.0,29002715.0,363,102,261,32118,8497,23621,38902109.0,10131006.0,28771103.0,119.36,121.74,119.23,121.8
2023-10-04 18:05,699,106,593,54427,11605,42822,65832633.0,13804855.0,52027777.0,650,79,571,55010,12121,42889,66343269.0,14223023.0,52120246.0,118.96,121.5,117.34,121.52
2023-10-04 18:10,1654,108,1546,124952,9868,115084,151160286.0,11744971.0,139415315.0,1590,68,1522,123016,9061,113955,148839109.0,10783657.0,138055451.0,119.02,121.14,119.01,121.15
2023-10-04 18:15,1542,161,1381,123309,21860,101449,149076024.0,26028636.0,123047388.0,1502,135,1367,122551,21019,101532,148186638.0,25015288.0,123171349.0,119.07,121.29,119.01,121.31
2023-10-04 18:20,2548,244,2304,183688,18694,164994,222041775.0,22254306.0,199787469.0,2523,235,2288,183450,18798,164652,221791762.0,22376273.0,199415489.0,119.05,121.09,119.04,121.11
2023-10-04 18:25,3016,287,2729,231647,21524,210123,279824260.0,25654097.0,254170163.0,2992,278,2714,231462,21690,209772,279880779.0,25817369.0,254063410.0,119.19,120.96,119.03,121.11
2023-10-04 18:30,2763,887,1876,162806,52206,110600,201913596.0,63266216.0,138647379.0,2683,839,1844,161421,51254,110167,197354178.0,61664478.0,135689700.0,121.19,125.36,120.31,123.17
2023-10-04 18:35,2441,2287,154,199423,192797,6626,240776636.0,232727973.0,8048662.0,2406,2284,122,198218,195634,2584,239150331.0,235979269.0,3171062.0,120.71,121.47,120.62,122.72
2023-10-05 10:00,2264,929,1335,71733,29006,42727,88089478.0,32557377.0,55532100.0,1047,464,583,46899,13938,32961,57040772.0,16860134.0,40180638.0,112.24,129.97,120.97,121.9
2023-10-05 10:05,724,330,394,30292,7587,22705,36735718.0,9110442.0,27625275.0,574,259,315,25940,4986,20954,31577198.0,6006000.0,25571198.0,120.08,121.67,120.46,122.03
2023-10-05 10:10,1120,181,939,64794,1824,62970,78628291.0,2166940.0,76461351.0,1035,148,887,61986,1106,60880,75213383.0,1317762.0,73895620.0,118.8,121.43,119.15,121.38
2023-10-05 10:15,2598,1503,1095,126629,61523,65106,147806997.0,72716969.0,75090028.0,1420,722,698,84199,41873,42326,100264780.0,49315001.0,50949779.0,118.19,115.34,117.77,120.37
2023-10-05 10:20,1378,952,426,95315,59400,35915,113768428.0,70413121.0,43355307.0,1094,763,331,81265,49164,32101,96882170.0,58085618.0,38796552.0,118.54,120.72,118.15,120.86
2023-10-05 10:25,1736,1245,491,85479,56941,28538,102133733.0,67691850.0,34441883.0,1235,952,283,79126,53099,26027,94627165.0,63072917.0,31554248.0,118.88,120.69,118.78,121.24
2023-10-05 10:30,1614,485,1129,121038,33171,87867,151914647.0,46008354.0,105906292.0,1412,379,1033,101962,33504,68458,125119289.0,42973382.0,82145907.0,138.7,120.53,128.26,119.99
2023-10-05 10:35,929,365,564,61252,24530,36722,74741527.0,31096686.0,43644841.0,659,210,449,53225,21210,32015,64307263.0,25821726.0,38485537.0,126.77,118.85,121.74,120.21
2023-10-05 10:40,1832,340,1492,143265,25314,117951,170521307.0,29735795.0,140785511.0,1636,224,1412,135446,22019,113427,164767170.0,26875956.0,137891214.0,117.47,119.36,122.06,121.57
2023-10-05 10:45,666,174,492,53307,16182,37125,64532596.0,19005561.0,45527035.0,585,144,441,51747,16962,34785,61613900.0,19921667.0,41692232.0,117.45,122.63,117.45,119.86
2023-10-05 10:50,3190,1324,1866,191445,80593,110852,224198146.0,93851422.0,130346724.0,2543,867,1676,160981,59910,101071,190010264.0,69836061.0,120174203.0,116.45,117.59,116.57,118.9
2023-10-05 10:55,1108,646,462,66304,39573,26731,78267270.0,46389738.0,31877532.0,922,538,384,63323,38803,24520,74561468.0,45307016.0,29254452.0,117.23,119.25,116.76,119.31
2023-10-05 11:00,2083,690,1393,125561,46208,79353,148331830.0,54093774.0,94238056.0,1932,589,1343,123869,47352,76517,146252760.0,55362977.0,90889783.0,117.07,118.76,116.92,118.78
2023-10-05 11:05,2594,644,1950,198727,47767,150960,233756540.0,55313988.0,178442551.0,2340,472,1868,190455,41291,149164,224645236.0,47994024.0,176651212.0,115.8,118.21,116.23,118.43
2023-10-05 11:10,3731,2024,1707,255487,136629,118858,296345873.0,159492883.0,136852989.0,2139,1132,1007,187591,100106,87485,218955482.0,115620424.0,103335058.0,116.73,115.14,115.5,118.12
2023-10-05 11:15,1155,792,363,88321,54162,34159,104660648.0,63782122.0,40878525.0,911,601,310,83870,53875,29995,99018755.0,63069756.0,35948998.0,117.76,119.67,117.07,119.85
2023-10-05 11:20,3819,3282,537,249239,211244,37995,292819874.0,246907457.0,45912417.0,3235,2821,414,239043,204311,34732,280777963.0,238545995.0,42231967.0,116.88,120.84,116.76,121.59
2023-10-05 11:25,2596,2055,541,182357,143042,39315,214428297.0,167679033.0,46749264.0,2232,1804,428,177439,141007,36432,208187625.0,164884095.0,43303529.0,117.22,118.91,116.93,118.86
2023-10-05 11:30,1208,601,607,80762,39788,40974,94701687.0,46329744.0,48371943.0,1066,528,538,77061,38499,38562,90371191.0,44677110.0,45694081.0,116.44,118.06,116.05,118.5
2023-10-05 11:35,2028,1287,741,131442,76873,54569,154398145.0,90014938.0,64383207.0,1888,1186,702,123160,69927,53233,144488516.0,81563251.0,62925265.0,117.1,117.98,116.64,118.21
2023-10-05 11:40,271,134,137,15809,7902,7907,18569105.0,9276423.0,9292681.0,189,85,104,14874,7832,7042,17421030.0,9050801.0,8370229.0,117.39,117.52,115.56,118.86
2023-10-05 11:45,271,112,159,17949,8360,9589,21085202.0,9727732.0,11357469.0,193,70,123,16213,7627,8586,19033112.0,8828405.0,10204707.0,116.36,118.44,115.75,118.85
2023-10-05 11:50,238,92,146,17003,6525,10478,19833660.0,7585190.0,12248470.0,153,48,105,12842,5404,7438,15071265.0,6250380.0,8820884.0,116.25,116.9,115.66,118.59
2023-10-05 11:55,124,57,67,6530,2997,3533,7410447.0,3488587.0,3921859.0,92,36,56,5671,2806,2865,6639791.0,3245401.0,3394389.0,116.4,111.01,115.66,118.48
2023-10-05 12:00,701,311,390,49233,26281,22952,57926768.0,30740052.0,27186716.0,664,294,370,51287,29445,21842,60273802.0,34346258.0,25927544.0,116.97,118.45,116.65,118.7
2023-10-05 12:05,634,157,477,44360,15597,28763,52170856.0,18098655.0,34072200.0,587,134,453,42401,14813,27588,49879061.0,17190889.0,32688171.0,116.04,118.46,116.05,118.49
2023-10-05 12:10,639,304,335,48026,25062,22964,56793170.0,29391545.0,27401625.0,525,236,289,48710,26252,22458,57469875.0,30634605.0,26835269.0,117.28,119.32,116.69,119.49
2023-10-05 12:15,468,156,312,31646,9895,21751,37459227.0,11574161.0,25885066.0,412,136,276,32706,11163,21543,38718230.0,13011556.0,25706673.0,116.97,119.01,116.56,119.33
2023-10-05 12:20,286,97,189,20630,6194,14436,24413424.0,7254933.0,17158491.0,250,79,171,19754,5912,13842,23362810.0,6875763.0,16487046.0,117.13,118.86,116.3,119.11
2023-10-05 12:25,265,98,167,19832,7268,12564,23421412.0,8479796.0,14941615.0,233,87,146,19640,7488,12152,23192658.0,8716802.0,14475855.0,116.67,118.92,116.41,119.12
2023-10-05 12:30,145,59,86,10461,4364,6097,12374230.0,5106877.0,7267353.0,104,30,74,9326,2992,6334,11155664.0,3492029.0,7663635.0,117.02,119.2,116.71,120.99
2023-10-05 12:35,144,61,83,9754,3750,6004,11575113.0,4402936.0,7172177.0,106,38,68,10583,4543,6040,12494072.0,5274085.0,7219987.0,117.41,119.46,116.09,119.54
2023-10-05 12:40,1298,847,451,83822,53323,30499,99478217.0,62866204.0,36612013.0,1204,803,401,81193,51557,29636,96261056.0,60738465.0,35522590.0,117.9,120.04,117.81,119.86
2023-10-05 12:45,392,181,211,33660,17541,16119,39870567.0,20632618.0,19237949.0,354,166,188,32745,17224,15521,38853634.0,20253338.0,18600295.0,117.63,119.35,117.59,119.84
2023-10-05 12:50,493,95,398,30739,7877,22862,36412001.0,9234534.0,27177467.0,453,73,380,29650,7555,22095,35178379.0,8856202.0,26322177.0,117.23,118.88,117.22,119.13
2023-10-05 12:55,166,55,111,13512,3407,10105,16012997.0,3980078.0,12032919.0,150,42,108,12829,2981,9848,15217072.0,3482742.0,11734330.0,116.82,119.08,116.83,119.15
2023-10-05 13:00,361,61,300,29175,5537,23638,34505228.0,6458955.0,28046273.0,329,46,283,27961,5410,22551,33137291.0,6308281.0,26829010.0,116.65,118.65,116.6,118.97
2023-10-05 13:05,694,72,622,52925,5435,47490,62628578.0,6335188.0,56293389.0,672,66,606,54722,7157,47565,64679281.0,8282145.0,56397136.0,116.56,118.54,115.72,118.57
2023-10-05 13:10,348,137,211,21711,6802,14909,25563915.0,7921431.0,17642483.0,300,104,196,20766,6300,14466,24489182.0,7334154.0,17155028.0,116.46,118.33,116.42,118.59
2023-10-05 13:15,267,217,50,14675,11778,2897,17281071.0,13835670.0,3445401.0,230,197,33,13685,11273,2412,16105002.0,13229354.0,2875648.0,117.47,118.93,117.35,119.22
2023-10-05 13:20,369,127,242,24210,6837,17373,28415046.0,7938755.0,20476291.0,305,80,225,23713,6774,16939,27978982.0,7857504.0,20121477.0,116.11,117.86,116.0,118.79
2023-10-05 13:25,286,59,227,16200,2504,13696,19119737.0,2929113.0,16190623.0,245,36,209,14654,1468,13186,17279474.0,1711597.0,15567877.0,116.98,118.21,116.59,118.06
2023-10-05 13:30,107,42,65,5920,2427,3493,7061728.0,2886391.0,4175337.0,69,22,47,5058,2043,3015,5955355.0,2371210.0,3584145.0,118.93,119.53,116.07,118.88
2023-10-05 13:35,2184,1786,398,173778,142514,31264,205109206.0,167658329.0,37450877.0,2097,1747,350,171412,141342,30070,202249323.0,166232158.0,36017165.0,117.64,119.79,117.61,119.78
2023-10-05 13:40,692,608,84,56776,49704,7072,66948248.0,58491794.0,8456454.0,686,606,80,55546,48674,6872,65487764.0,57259834.0,8227930.0,117.68,119.58,117.64,119.73
2023-10-05 13:45,321,232,89,25010,19062,5948,29489588.0,22408660.0,7080928.0,318,241,77,25151,19467,5684,29661561.0,22862775.0,6798786.0,117.56,119.05,117.44,119.61
2023-10-05 13:50,78,45,33,9155,6192,2963,10484411.0,6924293.0,3560117.0,72,39,33,5919,3225,2694,7005778.0,3783014.0,3222763.0,111.83,120.15,117.3,119.63
2023-10-05 13:55,418,376,42,33856,29139,4717,39832094.0,34182821.0,5649272.0,416,378,38,33676,29034,4642,39667267.0,34117443.0,5549824.0,117.31,119.76,117.51,119.56
2023-10-05 14:00,580,428,152,56152,43154,12998,66249702.0,50682229.0,15567473.0,573,432,141,56454,43241,13213,66614060.0,50780284.0,15833775.0,117.45,119.77,117.44,119.83
2023-10-05 14:05,491,224,267,24717,17991,6726,29187948.0,21177646.0,8010302.0,491,225,266,25246,18874,6372,29746650.0,22178532.0,7568117.0,117.71,119.09,117.51,118.77
2023-10-05 14:10,521,288,233,28563,21223,7340,33689484.0,24948269.0,8741215.0,516,283,233,28503,21150,7353,33624841.0,24865450.0,8759390.0,117.55,119.09,117.57,119.13
2023-10-05 14:15,436,315,121,28656,22364,6292,33935569.0,26304310.0,7631258.0,415,303,112,28251,22161,6090,33425319.0,26063701.0,7361617.0,117.62,121.29,117.61,120.88
2023-10-05 14:20,747,590,157,55771,46667,9104,65780366.0,54879590.0,10900776.0,701,566,135,55682,46321,9361,65692250.0,54470809.0,11221441.0,117.6,119.74,117.59,119.87
2023-10-05 14:25,857,673,184,68219,55199,13020,80472089.0,64878000.0,15594089.0,842,671,171,68067,55099,12968,80298623.0,64759368.0,15539255.0,117.53,119.77,117.53,119.83
2023-10-05 14:30,578,429,149,44589,32981,11608,52620473.0,38773257.0,13847216.0,571,426,145,44599,33123,11476,52637441.0,38934526.0,13702914.0,117.56,119.29,117.55,119.4
2023-10-05 14:35,926,157,769,72737,10687,62050,85555138.0,12323977.0,73231161.0,845,97,748,70719,9250,61469,83289385.0,10664042.0,72625342.0,115.32,118.02,115.29,118.15
2023-10-05 14:40,699,62,637,55281,5591,49690,65190130.0,6481143.0,58708987.0,649,35,614,54114,5058,49056,63786526.0,5861266.0,57925259.0,115.92,118.15,115.88,118.08
2023-10-05 14:45,5289,144,5145,150144,15444,134700,177050742.0,17949118.0,159101623.0,5262,126,5136,150467,15805,134662,177415367.0,18360797.0,159054569.0,116.22,118.12,116.17,118.11
2023-10-05 14:50,192,48,144,14755,4186,10569,17352568.0,4829656.0,12522912.0,175,37,138,14334,3756,10578,16899059.0,4360635.0,12538423.0,115.38,118.49,116.1,118.53
2023-10-05 14:55,188,51,137,15313,4286,11027,18027234.0,4971354.0,13055880.0,170,43,127,15388,4443,10945,18123379.0,5154675.0,12968704.0,115.99,118.4,116.02,118.49
2023-10-05 15:00,228,61,167,20531,5791,14740,24145698.0,6708005.0,17437692.0,207,52,155,19615,5581,14034,23086133.0,6461592.0,16624540.0,115.84,118.3,115.78,118.46
2023-10-05 15:05,1147,357,790,85807,21927,63880,100106313.0,25352242.0,74754071.0,948,211,737,78065,16764,61301,91684271.0,19389961.0,72294310.0,115.62,117.02,115.66,117.93
2023-10-05 15:10,829,181,648,72329,16054,56275,84830103.0,18556847.0,66273256.0,751,123,628,72401,16219,56182,84911428.0,18732962.0,66178465.0,115.59,117.77,115.5,117.79
2023-10-05 15:15,153,83,70,9894,4482,5412,11577749.0,5186248.0,6391501.0,100,41,59,7872,3204,4668,9215453.0,3688218.0,5527234.0,115.71,118.1,115.11,118.41
2023-10-05 15:20,663,436,227,37915,20991,16924,44391202.0,24438472.0,19952729.0,619,399,220,37273,20869,16404,43653437.0,24282074.0,19371363.0,116.42,117.9,116.35,118.09
2023-10-05 15:25,1850,725,1125,113873,44387,69486,130289417.0,50434005.0,79855412.0,1506,479,1027,97692,36176,61516,113577961.0,41474792.0,72103169.0,113.62,114.92,114.65,117.21
2023-10-05 15:30,473,233,240,31810,16486,15324,37247942.0,19155292.0,18092649.0,397,194,203,30231,15434,14797,35248946.0,17783934.0,17465011.0,116.19,118.07,115.23,118.03
2023-10-05 15:35,363,169,194,24629,11343,13286,28814448.0,13132040.0,15682408.0,296,124,172,22904,10124,12780,26781128.0,11695442.0,15085686.0,115.77,118.04,115.52,118.04
2023-10-05 15:40,583,449,134,35532,22374,13158,41564227.0,26010695.0,15553532.0,492,376,116,37695,24800,12895,43447120.0,28196057.0,15251062.0,116.25,118.21,113.69,118.27
2023-10-05 15:45,3384,867,2517,135134,45353,89781,157789154.0,52543567.0,105245587.0,3270,787,2483,133049,43925,89124,155287499.0,50869907.0,104417592.0,115.85,117.22,115.81,117.16
2023-10-05 15:50,11998,191,11807,149653,17254,132399,175136375.0,19906489.0,155229886.0,11944,176,11768,148897,17743,131154,174168547.0,20456724.0,153711823.0,115.37,117.24,115.29,117.2
2023-10-05 15:55,1487,430,1057,81610,20478,61132,95477960.0,23706436.0,71771524.0,1458,418,1040,80797,20454,60343,94538363.0,23666939.0,70871423.0,115.77,117.4,115.71,117.45
2023-10-05 16:00,1900,708,1192,121106,34630,86476,141495767.0,40006115.0,101489652.0,1876,697,1179,118019,31625,86394,137985390.0,36587130.0,101398260.0,115.52,117.36,115.69,117.37
2023-10-05 16:05,1302,279,1023,74020,19614,54406,86585033.0,22680182.0,63904851.0,1248,248,1000,73492,19168,54324,85942805.0,22136453.0,63806351.0,115.63,117.46,115.49,117.46
2023-10-05 16:10,1721,267,1454,133127,25927,107200,155702360.0,29874742.0,125827618.0,1680,254,1426,133901,26636,107265,156596459.0,30678832.0,125917627.0,115.23,117.38,115.18,117.39
2023-10-05 16:15,2732,691,2041,201584,45152,156432,235301668.0,52008468.0,183293199.0,2664,661,2003,201653,45318,156335,235589365.0,52176511.0,183412854.0,115.19,117.17,115.13,117.32
2023-10-05 16:20,701,294,407,61017,22815,38202,71264687.0,26324110.0,44940577.0,620,242,378,59514,21611,37903,69519017.0,24924728.0,44594288.0,115.38,117.64,115.33,117.65
2023-10-05 16:25,195,123,72,13793,7613,6180,16137851.0,8839709.0,7298142.0,168,104,64,14656,8387,6269,17075823.0,9669581.0,7406242.0,116.11,118.09,115.29,118.14
2023-10-05 16:30,170,126,44,11969,7575,4394,14013473.0,8814637.0,5198836.0,146,116,30,12480,7857,4623,14612769.0,9127855.0,5484914.0,116.36,118.32,116.17,118.64
2023-10-05 16:35,451,148,303,27908,12510,15398,32700735.0,14541405.0,18159329.0,400,120,280,27730,12135,15595,32485278.0,14060504.0,18424774.0,116.24,117.93,115.87,118.15
2023-10-05 16:40,891,249,642,39948,23061,16887,46878576.0,26869324.0,20009252.0,825,222,603,39490,23255,16235,46275856.0,27039585.0,19236271.0,116.51,118.49,116.27,118.49
2023-10-05 16:45,1089,398,691,68605,30121,38484,80091037.0,34775579.0,45315457.0,1046,377,669,65234,28219,37015,76261807.0,32656787.0,43605019.0,115.45,117.75,115.73,117.8
2023-10-05 16:50,1235,199,1036,85556,24659,60897,100237697.0,28516899.0,71720798.0,1225,190,1035,84993,24002,60991,99585970.0,27750473.0,71835497.0,115.64,117.77,115.62,117.78
2023-10-05 16:55,824,383,441,43905,26566,17339,51710444.0,31253388.0,20457055.0,794,372,422,42375,26079,16296,49658660.0,30425256.0,19233403.0,117.64,117.98,116.67,118.03
2023-10-05 17:00,159,105,54,12149,7477,4672,14213111.0,8730214.0,5482897.0,116,81,35,8884,5961,2923,10394593.0,6932101.0,3462491.0,116.76,117.36,116.29,118.46
2023-10-05 17:05,85,51,34,5292,2331,2961,6201915.0,2698778.0,3503137.0,58,29,29,5339,2484,2855,6254932.0,2873662.0,3381269.0,115.78,118.31,115.69,118.43
2023-10-05 17:10,231,155,76,14835,9040,5795,17525173.0,10678958.0,6846214.0,192,123,69,13191,7626,5565,15493615.0,8877198.0,6616417.0,118.13,118.14,116.41,118.89
2023-10-05 17:15,2343,1421,922,118895,91609,27286,139374521.0,107046073.0,32328448.0,2314,1402,912,117322,90199,27123,137387711.0,105247052.0,32140659.0,116.85,118.48,116.68,118.5
2023-10-05 17:20,941,374,567,33495,24950,8545,39219008.0,29110998.0,10108010.0,923,363,560,33788,25617,8171,39476345.0,29795929.0,9680416.0,116.68,118.29,116.31,118.47
2023-10-05 17:25,522,413,109,35675,23572,12103,41779681.0,27425095.0,14354585.0,506,398,108,36121,23418,12703,42308660.0,27237481.0,15071178.0,116.35,118.6,116.31,118.64
2023-10-05 17:30,248,161,87,16845,9183,7662,19772076.0,10755188.0,9016887.0,214,142,72,16170,8934,7236,18941818.0,10383492.0,8558325.0,117.12,117.68,116.22,118.27
2023-10-05 17:35,178,114,64,14097,6979,7118,16532439.0,8103686.0,8428752.0,155,98,57,13812,6968,6844,16168147.0,8061456.0,8106691.0,116.12,118.41,115.69,118.45
2023-10-05 17:40,110,65,45,8279,4883,3396,9711060.0,5685665.0,4025395.0,102,68,34,7526,4305,3221,8817140.0,4991832.0,3825308.0,116.44,118.53,115.95,118.76
2023-10-05 17:45,129,66,63,11491,5311,6180,13492342.0,6178005.0,7314337.0,103,51,52,11518,5532,5986,13504486.0,6400601.0,7103885.0,116.32,118.35,115.7,118.67
2023-10-05 17:50,84,52,32,6477,3387,3090,7634216.0,3955963.0,3678252.0,77,53,24,7284,4323,2961,8561190.0,5030243.0,3530947.0,116.8,119.04,116.36,119.25
2023-10-05 17:55,256,119,137,17037,6620,10417,19937939.0,7691280.0,12246658.0,238,112,126,16444,6426,10018,19275636.0,7464976.0,11810660.0,116.18,117.56,116.17,117.89
2023-10-05 18:00,230,134,96,11438,6361,5077,13416461.0,7431784.0,5984676.0,216,119,97,11118,5974,5144,13032512.0,6963595.0,6068917.0,116.83,117.88,116.57,117.98
2023-10-05 18:05,94,61,33,5553,2965,2588,6517837.0,3453689.0,3064147.0,73,47,26,5143,3040,2103,6023909.0,3528500.0,2495408.0,116.48,118.4,116.07,118.66
2023-10-05 18:10,146,78,68,13579,7456,6123,15935722.0,8661463.0,7274259.0,113,58,55,11846,6137,5709,13892418.0,7114451.0,6777967.0,116.17,118.8,115.93,118.72
2023-10-05 18:15,160,107,53,12634,8505,4129,14847436.0,9941911.0,4905524.0,127,87,40,11931,8262,3669,14010355.0,9637680.0,4372674.0,116.89,118.81,116.65,119.18
2023-10-05 18:20,250,168,82,19753,12948,6805,23180849.0,15110233.0,8070615.0,238,157,81,21988,13122,8866,25854913.0,15305023.0,10549890.0,116.7,118.6,116.64,118.99
2023-10-05 18:25,325,232,93,26616,19292,7324,31318891.0,22647051.0,8671840.0,306,232,74,24534,17851,6683,28709468.0,20774765.0,7934702.0,117.39,118.4,116.38,118.73
2023-10-05 18:30,2059,1419,640,138039,96251,41788,162482298.0,112803367.0,49678930.0,2019,1403,616,137207,95837,41370,161288518.0,112097331.0,49191187.0,117.2,118.88,116.97,118.91
2023-10-05 18:35,1511,1231,280,123687,92810,30877,146241778.0,109326191.0,36915586.0,1369,1162,207,113225,87024,26201,133539765.0,102167194.0,31372570.0,117.8,119.56,117.4,119.74
2023-10-06 10:00,2228,1043,1185,95356,54816,40540,112899573.0,63896934.0,49002639.0,836,488,348,49519,28630,20889,59469067.0,34310833.0,25158233.0,116.57,120.87,119.84,120.44
2023-10-06 10:05,1413,379,1034,53926,7968,45958,63817751.0,9517240.0,54300511.0,1047,240,807,39885,4615,35270,47793229.0,5489777.0,42303451.0,119.44,118.15,118.96,119.94
2023-10-06 10:10,999,546,453,30944,19462,11482,37251940.0,23340041.0,13911898.0,571,344,227,25688,16981,8707,30744275.0,20202302.0,10541973.0,119.93,121.16,118.97,121.07
2023-10-06 10:15,2420,1217,1203,134488,65340,69148,161797941.0,78038115.0,83759826.0,2105,1092,1013,123372,60720,62652,147961577.0,72255623.0,75705954.0,119.43,121.13,119.0,120.84
2023-10-06 10:20,1566,257,1309,90565,20399,70166,108469330.0,24053830.0,84415499.0,1464,224,1240,87075,19499,67576,104261878.0,22990662.0,81271215.0,117.92,120.31,117.91,120.27
2023-10-06 10:25,1785,377,1408,111271,25016,86255,132321716.0,29381337.0,102940379.0,1592,270,1322,109581,25415,84166,130354446.0,29804267.0,100550179.0,117.45,119.34,117.27,119.47
2023-10-06 10:30,1283,351,932,87882,27218,60664,104384736.0,31973718.0,72411017.0,1199,313,886,82933,23460,59473,98541300.0,27577536.0,70963764.0,117.47,119.36,117.55,119.32
2023-10-06 10:35,708,513,195,48524,33526,14998,57660200.0,39646336.0,18013863.0,648,480,168,47575,33321,14254,56539927.0,39398152.0,17141774.0,118.26,120.11,118.24,120.26
2023-10-06 10:40,1596,1373,223,115216,95962,19254,136891792.0,113707018.0,23184774.0,1540,1337,203,113865,94964,18901,135243771.0,112496814.0,22746956.0,118.49,120.42,118.46,120.35
2023-10-06 10:45,1556,1239,317,115028,88311,26717,136815554.0,104561923.0,32253631.0,1491,1209,282,112466,87860,24606,133666255.0,104015882.0,29650373.0,118.4,120.72,118.39,120.5
2023-10-06 10:50,1054,830,224,81826,56031,25795,97237857.0,66171580.0,31066276.0,988,792,196,80229,55799,24430,95298398.0,65899184.0,29399214.0,118.1,120.44,118.1,120.34
2023-10-06 10:55,1206,1046,160,73243,55198,18045,87020176.0,65319859.0,21700317.0,1164,1021,143,72684,55070,17614,86276480.0,65107897.0,21168583.0,118.34,120.26,118.23,120.18
2023-10-06 11:00,853,402,451,64945,24196,40749,77150231.0,28493789.0,48656442.0,768,351,417,62731,22572,40159,74625562.0,26560501.0,48065060.0,117.76,119.41,117.67,119.69
2023-10-06 11:05,909,185,724,70700,10183,60517,84911280.0,11900614.0,73010665.0,833,138,695,65767,9268,56499,78083775.0,10820778.0,67262996.0,116.87,120.64,116.75,119.05
2023-10-06 11:10,886,145,741,68072,11196,56876,80364661.0,13035144.0,67329517.0,792,101,691,64299,9493,54806,76121394.0,11052815.0,65068578.0,116.43,118.38,116.43,118.73
2023-10-06 11:15,716,281,435,43193,14134,29059,50680753.0,16483858.0,34196895.0,575,195,380,39928,12280,27648,47054549.0,14289319.0,32765230.0,116.63,117.68,116.36,118.51
2023-10-06 11:20,550,388,162,33418,18859,14559,39106830.0,21830790.0,17276040.0,474,324,150,30473,15906,14567,35872469.0,18585236.0,17287233.0,115.76,118.66,116.84,118.67
2023-10-06 11:25,2924,1684,1240,172541,102761,69780,204107587.0,121147160.0,82960427.0,2819,1628,1191,169527,101166,68361,200295338.0,119028408.0,81266930.0,117.89,118.89,117.66,118.88
2023-10-06 11:30,4021,2329,1692,219138,133689,85449,259115905.0,157278776.0,101837128.0,3995,2326,1669,219428,133938,85490,259446890.0,157558106.0,101888783.0,117.65,119.18,117.64,119.18
2023-10-06 11:35,970,159,811,68999,16174,52825,81637857.0,18842720.0,62795136.0,955,157,798,67355,14671,52684,79783206.0,17138027.0,62645179.0,116.5,118.87,116.82,118.91
2023-10-06 11:40,545,55,490,33926,2749,31177,40230220.0,3203665.0,37026554.0,529,51,478,33636,2641,30995,39861687.0,3076813.0,36784874.0,116.54,118.76,116.5,118.68
2023-10-06 11:45,562,106,456,43462,6956,36506,51423717.0,8087032.0,43336685.0,543,91,452,42838,6390,36448,50706980.0,7434021.0,43272959.0,116.26,118.71,116.34,118.73
2023-10-06 11:50,604,92,512,48402,7013,41389,57173934.0,8156531.0,49017403.0,574,81,493,47821,6991,40830,56574672.0,8128805.0,48445867.0,116.31,118.43,116.28,118.65
2023-10-06 11:55,2072,365,1707,177679,33322,144357,210017825.0,38769090.0,171248735.0,2069,370,1699,177488,33205,144283,209787805.0,38631900.0,171155905.0,116.35,118.63,116.34,118.63
2023-10-06 12:00,1295,266,1029,110812,24323,86489,130861716.0,28325291.0,102536424.0,1264,247,1017,110746,24145,86601,130814520.0,28110101.0,102704419.0,116.45,118.55,116.42,118.59
2023-10-06 12:05,999,153,846,63805,12931,50874,75332061.0,15089288.0,60242772.0,977,140,837,63033,12674,50359,74466939.0,14772276.0,59694663.0,116.69,118.42,116.56,118.54
2023-10-06 12:10,276,23,253,16157,1511,14646,19097135.0,1762184.0,17334950.0,266,20,246,16060,1442,14618,18985092.0,1679425.0,17305667.0,116.62,118.36,116.47,118.39
2023-10-06 12:15,823,141,682,60197,8009,52188,70989057.0,9289909.0,61699147.0,789,124,665,59194,7651,51543,69869524.0,8877211.0,60992312.0,115.99,118.22,116.03,118.33
2023-10-06 12:20,1122,153,969,97712,14712,83000,115200909.0,17025386.0,98175522.0,1089,133,956,96406,14469,81937,113760267.0,16743262.0,97017005.0,115.72,118.28,115.72,118.4
2023-10-06 12:25,1696,346,1350,135472,21836,113636,159753711.0,25288257.0,134465454.0,1654,319,1335,135091,21617,113474,159324486.0,25024834.0,134299652.0,115.81,118.33,115.76,118.35
2023-10-06 12:30,1906,951,955,104663,41005,63658,123774847.0,48359643.0,75415203.0,1795,903,892,101321,39045,62276,119606819.0,45835475.0,73771343.0,117.94,118.47,117.39,118.46
2023-10-06 12:35,2255,419,1836,178104,33556,144548,209904205.0,38960167.0,170944038.0,2234,404,1830,176824,33321,143503,208514594.0,38678058.0,169836536.0,116.1,118.26,116.08,118.35
2023-10-06 12:40,761,134,627,71147,14711,56436,83947303.0,17104171.0,66843132.0,755,132,623,70548,14393,56155,83241447.0,16727562.0,66513885.0,116.27,118.44,116.22,118.45
2023-10-06 12:45,396,76,320,30406,9140,21266,35834259.0,10633686.0,25200572.0,392,72,320,29778,8811,20967,35137756.0,10249231.0,24888525.0,116.34,118.5,116.32,118.7
2023-10-06 12:50,170,63,107,11153,3744,7409,13160685.0,4380998.0,8779687.0,155,51,104,11252,3777,7475,13289065.0,4402447.0,8886618.0,117.01,118.5,116.56,118.88
2023-10-06 12:55,382,87,295,26085,8572,17513,30736357.0,9969692.0,20766665.0,365,76,289,25846,8434,17412,30450191.0,9803906.0,20646284.0,116.31,118.58,116.24,118.58
2023-10-06 13:00,59,23,36,3984,1048,2936,4726679.0,1238408.0,3488271.0,49,21,28,3826,1357,2469,4511792.0,1577017.0,2934775.0,118.17,118.81,116.21,118.86
2023-10-06 13:05,989,467,522,69058,34825,34233,81349144.0,40785729.0,40563414.0,972,458,514,68928,34550,34378,81186923.0,40439179.0,40747743.0,117.12,118.49,117.05,118.53
2023-10-06 13:10,409,51,358,22103,3407,18696,26052280.0,3962621.0,22089658.0,414,51,363,22346,3413,18933,26340541.0,3969686.0,22370854.0,116.31,118.15,116.31,118.16
2023-10-06 13:15,933,532,401,69307,41908,27399,81694586.0,49133410.0,32561176.0,911,520,391,68747,41635,27112,81024734.0,48790858.0,32233875.0,117.24,118.84,117.19,118.89
2023-10-06 13:20,1976,1760,216,161260,136544,24716,190540843.0,160927636.0,29613206.0,1907,1721,186,160303,135830,24473,189278929.0,159947930.0,29330998.0,117.86,119.81,117.76,119.85
2023-10-06 13:25,1341,1220,121,122150,102217,19933,144501697.0,120562615.0,23939081.0,1322,1211,111,122614,102921,19693,144997662.0,121334157.0,23663505.0,117.95,120.1,117.89,120.16
2023-10-06 13:30,1157,988,169,104083,82312,21771,123163486.0,97057561.0,26105925.0,1137,981,156,103836,82243,21593,122893637.0,96959733.0,25933903.0,117.91,119.91,117.89,120.1
2023-10-06 13:35,1234,870,364,96050,59971,36079,113905822.0,70658938.0,43246883.0,1200,847,353,95395,59882,35513,113015374.0,70488308.0,42527065.0,117.82,119.87,117.71,119.75
2023-10-06 13:40,746,614,132,53808,38590,15218,63687152.0,45449261.0,18237891.0,724,601,123,53099,38389,14710,62799783.0,45200282.0,17599500.0,117.77,119.84,117.74,119.64
2023-10-06 13:45,865,766,99,53824,42733,11091,63566596.0,50333985.0,13232610.0,860,767,93,53683,42861,10822,63423477.0,50482076.0,12941401.0,117.79,119.31,117.78,119.58
2023-10-06 13:50,1150,760,390,71065,42567,28498,83768631.0,50111787.0,33656844.0,1100,734,366,69365,42202,27163,81895648.0,49668038.0,32227610.0,117.72,118.1,117.69,118.65
2023-10-06 13:55,622,84,538,39149,6072,33077,46200434.0,7041301.0,39159133.0,599,70,529,39214,6095,33119,46296788.0,7082690.0,39214098.0,115.96,118.39,116.2,118.4
2023-10-06 14:00,912,657,255,61745,31285,30460,72709185.0,36457865.0,36251320.0,876,633,243,60870,30521,30349,71712336.0,35566338.0,36145998.0,116.53,119.01,116.53,119.1
2023-10-06 14:05,427,232,195,25306,10127,15179,29845802.0,11815349.0,18030453.0,410,222,188,24782,9980,14802,29221495.0,11641736.0,17579758.0,116.67,118.79,116.65,118.77
2023-10-06 14:10,2285,1403,882,157028,82748,74280,185433887.0,97287300.0,88146587.0,2224,1357,867,155543,81425,74118,183573573.0,95566734.0,88006839.0,117.57,118.67,117.37,118.74
2023-10-06 14:15,1533,1423,110,109962,99643,10319,129728775.0,117307484.0,12421291.0,1524,1424,100,108810,100748,8062,128264476.0,118605222.0,9659254.0,117.73,120.37,117.72,119.81
2023-10-06 14:20,1444,1128,316,111574,89759,21815,131775631.0,105757400.0,26018230.0,1423,1121,302,110425,89196,21229,130368751.0,104986360.0,25382390.0,117.82,119.27,117.7,119.56
2023-10-06 14:25,1392,1161,231,128381,98701,29680,151799941.0,116166512.0,35633429.0,1381,1156,225,128680,98872,29808,152153807.0,116364551.0,35789256.0,117.7,120.06,117.69,120.07
2023-10-06 14:30,644,519,125,46477,37139,9338,54912151.0,43738872.0,11173278.0,630,513,117,45886,36806,9080,54214680.0,43349025.0,10865655.0,117.77,119.65,117.78,119.67
2023-10-06 14:35,1267,1104,163,112580,89836,22744,133009195.0,105785093.0,27224101.0,1254,1098,156,111643,88991,22652,131951849.0,104785702.0,27166147.0,117.75,119.7,117.75,119.93
2023-10-06 14:40,515,409,106,43444,31635,11809,51331006.0,37240008.0,14090998.0,504,402,102,43651,31834,11817,51617569.0,37471797.0,14145772.0,117.72,119.32,117.71,119.71
2023-10-06 14:45,2699,1229,1470,162151,57447,104704,191607034.0,67396857.0,124210176.0,2677,1216,1461,161514,57101,104413,190897900.0,66999347.0,123898553.0,117.32,118.63,117.33,118.66
2023-10-06 14:50,476,98,378,29666,4419,25247,35086250.0,5186224.0,29900025.0,475,100,375,31987,6796,25191,37579579.0,7745891.0,29833688.0,117.36,118.43,113.98,118.43
2023-10-06 14:55,1404,306,1098,94773,19299,75474,111942004.0,22569929.0,89372075.0,1384,294,1090,91600,16770,74830,108252960.0,19605822.0,88647138.0,116.95,118.41,116.91,118.46
2023-10-06 15:00,749,97,652,47743,3966,43777,56448422.0,4644505.0,51803916.0,744,94,650,47706,3937,43769,56414418.0,4607068.0,51807350.0,117.11,118.34,117.02,118.37
2023-10-06 15:05,508,50,458,34001,1996,32005,40209749.0,2333850.0,37875898.0,501,43,458,34111,2071,32040,40340323.0,2422503.0,37917819.0,116.93,118.34,116.97,118.35
2023-10-06 15:10,611,76,535,39856,3347,36509,47111072.0,3909407.0,43201665.0,603,72,531,40053,3553,36500,47341358.0,4149177.0,43192181.0,116.8,118.33,116.78,118.33
2023-10-06 15:15,516,68,448,34819,3358,31461,41178412.0,3921396.0,37257016.0,506,63,443,34605,3193,31412,40907768.0,3727297.0,37180470.0,116.78,118.42,116.73,118.36
2023-10-06 15:20,755,204,551,48545,8894,39651,57352222.0,10394846.0,46957376.0,759,212,547,49012,9467,39545,57888847.0,11058343.0,46830504.0,116.87,118.43,116.81,118.42
2023-10-06 15:25,661,163,498,38438,4511,33927,45441840.0,5292723.0,40149116.0,653,159,494,38245,4484,33761,45205354.0,5254633.0,39950721.0,117.33,118.34,117.19,118.33
2023-10-06 15:30,1100,54,1046,78684,7425,71259,93029718.0,8638412.0,84391305.0,1092,46,1046,78100,6505,71595,92352198.0,7560716.0,84791481.0,116.34,118.43,116.23,118.43
2023-10-06 15:35,974,113,861,63146,4379,58767,74693254.0,5133772.0,69559482.0,957,107,850,61801,4647,57154,73092722.0,5442770.0,67649951.0,117.24,118.36,117.12,118.36
2023-10-06 15:40,179,88,91,16109,5658,10451,18954090.0,6583002.0,12371087.0,156,76,80,15659,5346,10313,18449795.0,6234418.0,12215377.0,116.35,118.37,116.62,118.45
2023-10-06 15:45,986,769,217,70172,46449,23723,82524351.0,54390721.0,28133630.0,949,744,205,68527,45016,23511,80582997.0,52643063.0,27939934.0,117.1,118.59,116.94,118.84
2023-10-06 15:50,1132,192,940,88386,16347,72039,104013761.0,19006501.0,85007259.0,1086,153,933,86590,15514,71076,102036399.0,18015113.0,84021285.0,116.27,118.0,116.12,118.21
2023-10-06 15:55,1659,334,1325,132496,27256,105240,155306132.0,31644275.0,123661856.0,1549,276,1273,128754,26625,102129,151649546.0,30903680.0,120745866.0,116.1,117.5,116.07,118.23
2023-10-06 16:00,511,105,406,34350,7225,27125,40320638.0,8354639.0,31965998.0,460,68,392,33924,6808,27116,39849460.0,7859234.0,31990225.0,115.64,117.85,115.44,117.98
2023-10-06 16:05,1519,214,1305,108787,15034,93753,127344410.0,17373462.0,109970948.0,1425,154,1271,102263,13319,88944,119712973.0,15358010.0,104354962.0,115.56,117.3,115.31,117.33
2023-10-06 16:10,652,128,524,45492,8290,37202,53322922.0,9593000.0,43729921.0,612,100,512,45632,7916,37716,53615804.0,9142702.0,44473102.0,115.72,117.55,115.5,117.92
2023-10-06 16:15,232,135,97,14270,6192,8078,16749651.0,7243143.0,9506508.0,189,98,91,12697,5160,7537,14875151.0,5993686.0,8881464.0,116.98,117.68,116.16,117.84
2023-10-06 16:20,450,352,98,33349,23645,9704,39000030.0,27517357.0,11482673.0,390,310,80,32137,22894,9243,37580783.0,26629929.0,10950854.0,116.38,118.33,116.32,118.48
2023-10-06 16:25,143,86,57,11183,7097,4086,13097237.0,8256574.0,4840663.0,118,71,47,9992,5983,4009,11712354.0,6942324.0,4770029.0,116.34,118.47,116.03,118.98
2023-10-06 16:30,67,35,32,5246,2926,2320,6188234.0,3443850.0,2744384.0,56,25,31,4932,2299,2633,5775043.0,2652041.0,3123002.0,117.7,118.29,115.36,118.61
2023-10-06 16:35,255,94,161,14296,6768,7528,16882907.0,7932658.0,8950249.0,196,58,138,12613,5739,6874,14832494.0,6653735.0,8178759.0,117.21,118.89,115.94,118.98
2023-10-06 16:40,573,176,397,41727,14457,27270,48901948.0,16780262.0,32121685.0,545,159,386,39528,14097,25431,46294605.0,16302957.0,29991647.0,116.07,117.79,115.65,117.93
2023-10-06 16:45,1282,396,886,80831,30392,50439,94632950.0,35229897.0,59403053.0,1244,367,877,80316,29976,50340,94053847.0,34746957.0,59306890.0,115.92,117.77,115.92,117.81
2023-10-06 16:50,546,138,408,34170,11803,22367,40053392.0,13714596.0,26338796.0,528,128,400,33399,11132,22267,39113554.0,12895914.0,26217639.0,116.2,117.76,115.85,117.74
2023-10-06 16:55,241,85,156,15112,5211,9901,17686578.0,6037544.0,11649033.0,221,78,143,14640,5146,9494,17153897.0,5964328.0,11189568.0,115.86,117.66,115.9,117.86
2023-10-06 17:00,295,104,191,21175,7829,13346,24759768.0,9071962.0,15687806.0,280,95,185,20848,7789,13059,24399708.0,9022019.0,15377689.0,115.88,117.55,115.83,117.76
2023-10-06 17:05,363,87,276,24011,5746,18265,28116896.0,6648670.0,21468226.0,343,75,268,22874,5350,17524,26791099.0,6195464.0,20595635.0,115.71,117.54,115.8,117.53
2023-10-06 17:10,1134,436,698,46125,11775,34350,54112287.0,13781735.0,40330551.0,1117,422,695,45554,10855,34699,53342762.0,12591301.0,40751460.0,117.04,117.41,116.0,117.44
2023-10-06 17:15,248,63,185,18054,6295,11759,21139853.0,7285180.0,13854673.0,236,55,181,17939,6361,11578,21009810.0,7355988.0,13653822.0,115.73,117.82,115.64,117.93
2023-10-06 17:20,379,136,243,29064,12023,17041,34012467.0,13896093.0,20116374.0,347,114,233,27531,10832,16699,32249835.0,12527697.0,19722137.0,115.58,118.05,115.65,118.1
2023-10-06 17:25,691,498,193,57885,40122,17763,67975225.0,46907349.0,21067876.0,661,485,176,56353,39256,17097,66043370.0,45753651.0,20289718.0,116.91,118.61,116.55,118.67
2023-10-06 17:30,623,550,73,48942,38316,10626,57364226.0,44730181.0,12634044.0,618,546,72,48361,37800,10561,56679257.0,44117914.0,12561343.0,116.74,118.9,116.71,118.94
2023-10-06 17:35,432,375,57,32215,25036,7179,37760505.0,29229344.0,8531160.0,427,378,49,32435,25307,7128,38010065.0,29531263.0,8478802.0,116.75,118.83,116.69,118.95
2023-10-06 17:40,392,307,85,27640,19477,8163,32404241.0,22716915.0,9687325.0,373,298,75,28282,19501,8781,33178128.0,22744142.0,10433986.0,116.63,118.67,116.63,118.82
2023-10-06 17:45,771,569,202,46847,31941,14906,54938726.0,37237501.0,17701224.0,755,559,196,48438,31715,16723,57468758.0,36972141.0,20496617.0,116.58,118.75,116.58,122.57
2023-10-06 17:50,486,418,68,39265,28596,10669,46023383.0,33335885.0,12687498.0,466,403,63,39535,28995,10540,46307853.0,33766009.0,12541843.0,116.58,118.92,116.45,118.99
2023-10-06 17:55,231,171,60,15811,10902,4909,20425923.0,14591986.0,5833937.0,216,160,56,15516,10525,4991,18194221.0,12266140.0,5928080.0,133.85,118.84,116.54,118.78
2023-10-06 18:00,171,122,49,13103,8563,4540,15385556.0,9979595.0,5405961.0,164,120,44,13741,9077,4664,17770681.0,12215613.0,5555068.0,116.54,119.07,134.58,119.11
2023-10-06 18:05,138,111,27,8993,6456,2537,10565918.0,7553542.0,3012376.0,128,108,20,8801,7320,1481,10260746.0,8503775.0,1756971.0,117.0,118.74,116.17,118.63
2023-10-06 18:10,868,178,690,70316,18476,51840,83716823.0,22623567.0,61093256.0,836,168,668,68090,18153,49937,80610582.0,21729171.0,58881410.0,122.45,117.85,119.7,117.91
2023-10-06 18:15,230,53,177,18387,4429,13958,21996912.0,5600574.0,16396338.0,212,45,167,17867,4018,13849,21473995.0,5149842.0,16324152.0,126.45,117.47,128.17,117.87
2023-10-06 18:20,801,579,222,58976,35975,23001,71023917.0,43796721.0,27227195.0,759,551,208,57906,35072,22834,69698615.0,42644239.0,27054375.0,121.74,118.37,121.59,118.48
2023-10-06 18:25,329,207,122,20642,15141,5501,23896067.0,17391947.0,6504119.0,304,196,108,20034,14667,5367,23269153.0,16886710.0,6382442.0,114.87,118.24,115.13,118.92
2023-10-06 18:30,568,198,370,29229,15302,13927,34496124.0,18032165.0,16463958.0,498,184,314,27653,15595,12058,32628596.0,18320756.0,14307839.0,117.84,118.22,117.48,118.66
2023-10-06 18:35,214,138,76,13736,9597,4139,15897233.0,11301929.0,4595303.0,171,123,48,11382,7856,3526,13431825.0,9225404.0,4206421.0,117.77,111.02,117.43,119.3
2023-10-09 10:00,1465,714,751,42940,25277,17663,51342831.0,28979613.0,22363218.0,423,336,87,27466,17546,9920,32215994.0,20307609.0,11908385.0,114.65,126.61,115.74,120.04
2023-10-09 10:05,1888,1515,373,84385,69711,14674,100435845.0,82783017.0,17652828.0,1521,1340,181,65257,57294,7963,77561936.0,68003864.0,9558071.0,118.75,120.3,118.69,120.03
2023-10-09 10:10,956,591,365,31413,15344,16069,37207163.0,18114142.0,19093020.0,586,420,166,24245,15302,8943,28891390.0,18138823.0,10752566.0,118.05,118.82,118.54,120.23
2023-10-09 10:15,797,441,356,34310,16718,17592,40770119.0,19841058.0,20929061.0,624,362,262,29962,14530,15432,35615948.0,17144446.0,18471502.0,118.68,118.97,117.99,119.7
2023-10-09 10:20,717,459,258,56827,30751,26076,68031463.0,36388297.0,31643165.0,575,392,183,54255,29568,24687,64885650.0,34932319.0,29953331.0,118.33,121.35,118.14,121.33
2023-10-09 10:25,792,252,540,40775,13279,27496,48691442.0,15693597.0,32997845.0,705,210,495,37733,12401,25332,44964728.0,14633744.0,30330984.0,118.18,120.01,118.0,119.73
2023-10-09 10:30,1473,562,911,88679,33942,54737,105309810.0,39885894.0,65423915.0,1364,509,855,85418,32098,53320,101553343.0,37695066.0,63858277.0,117.51,119.52,117.44,119.76
2023-10-09 10:35,2308,639,1669,140972,41894,99078,167536987.0,49301482.0,118235504.0,2245,609,1636,138638,40707,97931,164866703.0,47872700.0,116994003.0,117.68,119.34,117.6,119.47
2023-10-09 10:40,1988,1220,768,130433,67382,63051,155344013.0,79413452.0,75930561.0,1868,1162,706,124335,66268,58067,147484053.0,78088846.0,69395207.0,117.86,120.43,117.84,119.51
2023-10-09 10:45,1479,1220,259,82270,59661,22609,98109582.0,70459134.0,27650447.0,1281,1076,205,77903,56352,21551,92772639.0,66526544.0,26246094.0,118.1,122.3,118.06,121.79
2023-10-09 10:50,880,487,393,54566,25901,28665,65382436.0,30585275.0,34797160.0,695,353,342,51351,25301,26050,61600033.0,29827343.0,31772690.0,118.09,121.39,117.89,121.97
2023-10-09 10:55,555,405,150,35209,22900,12309,42045121.0,27201779.0,14843341.0,482,368,114,31393,20521,10872,37382574.0,24256177.0,13126396.0,118.79,120.59,118.2,120.74
2023-10-09 11:00,1199,843,356,83954,51197,32757,101106881.0,61260360.0,39846521.0,895,664,231,73397,44709,28688,88041339.0,53105721.0,34935617.0,119.66,121.64,118.78,121.78
2023-10-09 11:05,819,355,464,62528,26440,36088,75077974.0,31403289.0,43674685.0,679,299,380,59602,26331,33271,71431602.0,31122489.0,40309113.0,118.77,121.02,118.2,121.15
2023-10-09 11:10,1891,1035,856,104888,54420,50468,125067279.0,64503343.0,60563936.0,1776,969,807,102133,53128,49005,121878460.0,62971282.0,58907178.0,118.53,120.0,118.53,120.21
2023-10-09 11:15,3375,1966,1409,232455,125156,107299,277212977.0,148510933.0,128702043.0,3263,1891,1372,230550,123716,106834,274902656.0,146763607.0,128139048.0,118.66,119.95,118.63,119.94
2023-10-09 11:20,2059,1583,476,152359,120221,32138,182186509.0,143350509.0,38836000.0,1978,1546,432,148955,117760,31195,177895709.0,140176540.0,37719168.0,119.24,120.84,119.04,120.91
2023-10-09 11:25,556,101,455,31819,7757,24062,38117393.0,9185047.0,28932346.0,533,98,435,31688,7562,24126,37979756.0,8941456.0,29038300.0,118.41,120.24,118.24,120.36
2023-10-09 11:30,1559,208,1351,130092,25946,104146,156423613.0,30723071.0,125700542.0,1492,182,1310,112353,25180,87173,134600723.0,29735241.0,104865482.0,118.41,120.7,118.09,120.3
2023-10-09 11:35,420,169,251,32934,16270,16664,39393040.0,19268050.0,20124990.0,368,164,204,31894,15763,16131,38173423.0,18663578.0,19509844.0,118.43,120.77,118.4,120.95
2023-10-09 11:40,1529,942,587,97130,69353,27777,116085431.0,82564691.0,33520740.0,1471,923,548,95934,69094,26840,114601359.0,82215912.0,32385447.0,119.05,120.68,118.99,120.66
2023-10-09 11:45,455,182,273,30505,13221,17284,36468773.0,15669141.0,20799632.0,425,169,256,29881,13207,16674,35723266.0,15639577.0,20083689.0,118.52,120.34,118.42,120.45
2023-10-09 11:50,511,330,181,32975,20273,12702,39377552.0,24115522.0,15262030.0,483,321,162,33113,19886,13227,39567153.0,23652522.0,15914631.0,118.95,120.15,118.94,120.32
2023-10-09 11:55,508,134,374,38401,8545,29856,45875435.0,10084321.0,35791113.0,478,118,360,37898,8463,29435,45285763.0,9978528.0,35307234.0,118.01,119.88,117.91,119.95
2023-10-09 12:00,1304,668,636,74436,28031,46405,88860120.0,33198163.0,55661956.0,1279,663,616,72703,28066,44637,86753347.0,33243547.0,53509800.0,118.43,119.95,118.45,119.88
2023-10-09 12:05,1148,588,560,53479,21951,31528,63744026.0,26023976.0,37720050.0,1127,570,557,53775,21883,31892,64107180.0,25940677.0,38166503.0,118.55,119.64,118.54,119.67
2023-10-09 12:10,788,368,420,34171,10954,23217,40747129.0,13023223.0,27723906.0,777,357,420,33787,10521,23266,40292093.0,12505216.0,27786877.0,118.89,119.41,118.86,119.43
2023-10-09 12:15,513,114,399,47972,5110,42862,57129941.0,5993826.0,51136115.0,478,91,387,47096,4649,42447,56197192.0,5453254.0,50743938.0,117.3,119.3,117.3,119.55
2023-10-09 12:20,650,370,280,49596,18242,31354,59292443.0,21741407.0,37551036.0,619,353,266,46872,17071,29801,55863607.0,20159252.0,35704355.0,119.18,119.76,118.09,119.81
2023-10-09 12:25,969,891,78,74298,63484,10814,91446338.0,75425235.0,16021103.0,945,880,65,74308,63297,11011,88475095.0,75190682.0,13284412.0,118.81,148.15,118.79,120.65
2023-10-09 12:30,1130,961,169,81902,69607,12295,97475338.0,82689051.0,14786286.0,1109,953,156,82577,69503,13074,98304557.0,82562108.0,15742449.0,118.79,120.26,118.79,120.41
2023-10-09 12:35,1834,1618,216,116746,98009,18737,138940726.0,116482699.0,22458026.0,1800,1608,192,115913,98019,17894,137979231.0,116469647.0,21509583.0,118.85,119.86,118.82,120.21
2023-10-09 12:40,1382,743,639,93921,43617,50304,111417325.0,51525803.0,59891522.0,1335,724,611,93576,43753,49823,111286461.0,51690870.0,59595591.0,118.13,119.06,118.14,119.61
2023-10-09 12:45,1012,233,779,69661,11500,58161,82823673.0,13534892.0,69288781.0,974,209,765,69812,12289,57523,82982185.0,14411112.0,68571073.0,117.69,119.13,117.27,119.21
2023-10-09 12:50,3505,687,2818,287714,56305,231409,342026948.0,66045278.0,275981669.0,3458,661,2797,287050,56234,230816,341213525.0,65897460.0,275316064.0,117.3,119.26,117.18,119.28
2023-10-09 12:55,2624,331,2293,227312,40123,187189,272762518.0,46865637.0,225896880.0,2587,317,2270,226243,38881,187362,271603545.0,45442470.0,226161074.0,116.8,120.68,116.88,120.71
2023-10-09 13:00,2199,371,1828,197448,36336,161112,234271081.0,42470069.0,191801012.0,2183,356,1827,196942,36127,160815,233659693.0,42218363.0,191441329.0,116.88,119.05,116.86,119.04
2023-10-09 13:05,2768,800,1968,188008,63062,124946,223233036.0,74266964.0,148966072.0,2727,773,1954,186693,62270,124423,221689973.0,73326851.0,148363121.0,117.77,119.22,117.76,119.24
2023-10-09 13:10,1169,337,832,73966,24556,49410,87637378.0,28864187.0,58773191.0,1103,299,804,71604,23745,47859,85050221.0,27896907.0,57153314.0,117.54,118.95,117.49,119.42
2023-10-09 13:15,262,98,164,26168,8345,17823,31199804.0,9777901.0,21421902.0,242,89,153,23455,8240,15215,27872843.0,9651986.0,18220856.0,117.17,120.19,117.14,119.76
2023-10-09 13:20,159,90,69,12565,5192,7373,14914565.0,6090599.0,8823965.0,140,82,58,12167,5002,7165,14443413.0,5860724.0,8582688.0,117.31,119.68,117.17,119.79
2023-10-09 13:25,446,299,147,30170,15612,14558,35804327.0,18368622.0,17435705.0,431,290,141,28264,15143,13121,33504521.0,17807835.0,15696686.0,117.66,119.77,117.6,119.63
2023-10-09 13:30,515,416,99,35734,26062,9672,42390028.0,30777971.0,11612056.0,500,410,90,36571,27106,9465,43285577.0,31929418.0,11356158.0,118.1,120.06,117.79,119.98
2023-10-09 13:35,188,33,155,12907,1076,11831,15513865.0,1270742.0,14243123.0,177,31,146,9822,841,8981,11699465.0,989771.0,10709694.0,118.1,120.39,117.69,119.25
2023-10-09 13:40,69,26,43,5753,582,5171,6946686.0,688922.0,6257763.0,51,16,35,3415,652,2763,4073013.0,769570.0,3303443.0,118.37,121.02,118.03,119.56
2023-10-09 13:45,230,23,207,11264,588,10676,13425438.0,699253.0,12726185.0,220,18,202,10634,477,10157,12658250.0,560324.0,12097926.0,118.92,119.2,117.47,119.11
2023-10-09 13:50,278,51,227,13403,1744,11659,15934196.0,2061253.0,13872943.0,264,41,223,13238,1656,11582,15740781.0,1959858.0,13780923.0,118.19,118.99,118.35,118.99
2023-10-09 13:55,174,50,124,11335,4963,6372,13427964.0,5833254.0,7594710.0,157,43,114,11243,5128,6115,13286624.0,6000094.0,7286530.0,117.53,119.19,117.01,119.16
2023-10-09 14:00,198,58,140,10407,2904,7503,12380378.0,3440421.0,8939957.0,179,41,138,11115,2474,8641,13234364.0,2927534.0,10306830.0,118.47,119.15,118.33,119.28
2023-10-09 14:05,91,13,78,5691,299,5392,6797484.0,356774.0,6440710.0,89,18,71,4659,221,4438,5556200.0,261275.0,5294924.0,119.32,119.45,118.22,119.31
2023-10-09 14:10,294,67,227,15586,4580,11006,18535604.0,5431636.0,13103967.0,274,49,225,15318,4379,10939,18208984.0,5182204.0,13026780.0,118.59,119.06,118.34,119.09
2023-10-09 14:15,204,149,55,10537,8026,2511,12544854.0,9546221.0,2998633.0,164,122,42,9672,7238,2434,11504332.0,8592683.0,2911649.0,118.94,119.42,118.72,119.62
2023-10-09 14:20,281,92,189,13040,6295,6745,15560843.0,7484422.0,8076420.0,261,92,169,11759,6301,5458,14013239.0,7485455.0,6527784.0,118.89,119.74,118.8,119.6
2023-10-09 14:25,213,58,155,8071,2423,5648,9514109.0,2875995.0,6638113.0,194,51,143,7526,2294,5232,8975172.0,2722358.0,6252813.0,118.7,117.53,118.67,119.51
2023-10-09 14:30,1793,542,1251,82288,25265,57023,98005090.0,30044370.0,67960719.0,1764,529,1235,81950,25128,56822,97588180.0,29866242.0,67721938.0,118.92,119.18,118.86,119.18
2023-10-09 14:35,32,13,19,1190,177,1013,1437056.0,210128.0,1226928.0,28,14,14,1071,174,897,1292662.0,205544.0,1087118.0,118.72,121.12,118.13,121.19
2023-10-09 14:40,356,317,39,17569,16286,1283,20909694.0,19378022.0,1531671.0,341,307,34,17498,16183,1315,20820920.0,19249150.0,1571770.0,118.99,119.38,118.95,119.53
2023-10-09 14:45,227,204,23,13684,12615,1069,16231205.0,14943424.0,1287780.0,214,199,15,12375,11351,1024,14718533.0,13488532.0,1230001.0,118.46,120.47,118.83,120.12
2023-10-09 14:50,40,18,22,724,536,188,853405.0,636976.0,216429.0,27,14,13,414,399,15,492563.0,473828.0,18735.0,118.84,115.12,118.75,124.9
2023-10-09 14:55,258,212,46,16234,14368,1866,19267848.0,17072649.0,2195199.0,241,206,35,15695,14224,1471,18669183.0,16892497.0,1776686.0,118.82,117.64,118.76,120.78
2023-10-09 15:00,479,347,132,30634,24670,5964,36399276.0,29276097.0,7123179.0,455,332,123,27557,22476,5081,32775428.0,26712920.0,6062508.0,118.67,119.44,118.85,119.32
2023-10-09 15:05,697,534,163,42804,37566,5238,50932620.0,44664311.0,6268309.0,677,527,150,41849,36657,5192,49797753.0,43592722.0,6205031.0,118.9,119.67,118.92,119.51
2023-10-09 15:10,1078,741,337,69076,57332,11744,82151724.0,68139693.0,14012031.0,1068,739,329,69134,57446,11688,82285077.0,68275308.0,14009769.0,118.85,119.31,118.85,119.86
2023-10-09 15:15,722,707,15,51876,50384,1492,61665463.0,59873944.0,1791519.0,717,703,14,51978,50145,1833,61790736.0,59590361.0,2200375.0,118.84,120.08,118.84,120.04
2023-10-09 15:20,547,494,53,50026,47474,2552,59469658.0,56421266.0,3048392.0,528,482,46,49613,47440,2173,58972773.0,56378917.0,2593856.0,118.85,119.45,118.84,119.37
2023-10-09 15:25,566,551,15,55389,53606,1783,65887928.0,63748288.0,2139639.0,557,546,11,55114,53392,1722,65517518.0,63448153.0,2069365.0,118.92,120.0,118.83,120.17
2023-10-09 15:30,405,389,16,30725,28843,1882,36536444.0,34277430.0,2259013.0,400,390,10,30600,28882,1718,36382120.0,34318663.0,2063456.0,118.84,120.03,118.82,120.11
2023-10-09 15:35,510,173,337,29168,9804,19364,34683572.0,11625135.0,23058437.0,498,166,332,28677,9578,19099,37068785.0,11359318.0,25709467.0,118.58,119.08,118.6,134.61
2023-10-09 15:40,152,19,133,9076,691,8385,10812387.0,820794.0,9991593.0,148,17,131,9130,626,8504,10874371.0,741682.0,10132689.0,118.78,119.16,118.48,119.15
2023-10-09 15:45,180,35,145,10528,1734,8794,12546480.0,2059107.0,10487372.0,175,32,143,11084,1734,9350,13204813.0,2057910.0,11146903.0,118.75,119.26,118.68,119.22
2023-10-09 15:50,299,13,286,17601,160,17441,20994924.0,192718.0,20802205.0,291,6,285,17366,109,17257,20712236.0,128494.0,20583742.0,120.45,119.27,117.88,119.28
2023-10-09 15:55,176,13,163,12704,312,12392,15167848.0,372455.0,14795392.0,172,12,160,11581,598,10983,13803961.0,703688.0,13100273.0,119.38,119.39,117.67,119.28
2023-10-09 16:00,98,15,83,6709,287,6422,8002020.0,340288.0,7661731.0,93,11,82,6601,197,6404,7873742.0,233127.0,7640614.0,118.57,119.3,118.34,119.31
2023-10-09 16:05,447,52,395,27948,2669,25279,33231515.0,3154218.0,30077296.0,427,40,387,28993,2564,26429,34468103.0,3004964.0,31463139.0,118.18,118.98,117.2,119.05
2023-10-09 16:10,641,146,495,33263,3098,30165,39455143.0,3573204.0,35881939.0,623,136,487,31960,1782,30178,37998287.0,2098886.0,35899400.0,115.34,118.95,117.78,118.96
2023-10-09 16:15,1154,193,961,64004,4272,59732,76077545.0,5035059.0,71042486.0,1134,185,949,63208,4083,59125,75133474.0,4806675.0,70326799.0,117.86,118.94,117.72,118.95
2023-10-09 16:20,454,51,403,27519,1129,26390,32699504.0,1329156.0,31370348.0,439,40,399,27717,1134,26583,32954458.0,1334847.0,31619610.0,117.73,118.87,117.71,118.95
2023-10-09 16:25,834,110,724,44557,2936,41621,52962895.0,3468063.0,49494832.0,823,101,722,44560,2815,41745,52960705.0,3310526.0,49650179.0,118.12,118.92,117.6,118.94
2023-10-09 16:30,571,495,76,26037,20978,5059,30994883.0,24956008.0,6038875.0,553,482,71,25522,20646,4876,30319560.0,24501191.0,5818368.0,118.96,119.37,118.67,119.33
2023-10-09 16:35,711,614,97,30573,25105,5468,36344499.0,29804672.0,6539826.0,702,613,89,29374,23943,5431,34924339.0,28421931.0,6502408.0,118.72,119.6,118.71,119.73
2023-10-09 16:40,392,98,294,16177,4904,11273,19229839.0,5772254.0,13457585.0,372,86,286,14093,2721,11372,16814930.0,3222944.0,13591986.0,117.71,119.38,118.45,119.52
2023-10-09 16:45,1094,888,206,60333,54186,6147,71652695.0,64335014.0,7317681.0,1081,888,193,60474,54815,5659,71819411.0,65071735.0,6747676.0,118.73,119.04,118.71,119.24
2023-10-09 16:50,1191,1128,63,71741,68979,2762,85183665.0,81878104.0,3305561.0,1183,1126,57,72628,69871,2757,86227006.0,82928238.0,3298768.0,118.7,119.68,118.69,119.65
2023-10-09 16:55,556,447,109,29332,24475,4857,34858250.0,29054951.0,5803299.0,551,444,107,29294,24500,4794,34811715.0,29083420.0,5728295.0,118.71,119.48,118.71,119.49
2023-10-09 17:00,278,82,196,13906,5145,8761,16551019.0,6100076.0,10450943.0,265,78,187,13789,5091,8698,16401614.0,6021256.0,10380358.0,118.56,119.29,118.27,119.34
2023-10-09 17:05,448,120,328,26854,7824,19030,31945407.0,9296252.0,22649154.0,435,114,321,26267,7475,18792,31272564.0,8871207.0,22401357.0,118.82,119.02,118.68,119.21
2023-10-09 17:10,181,35,146,10803,1512,9291,12877523.0,1794950.0,11082572.0,171,25,146,11000,1489,9511,13118445.0,1767293.0,11351152.0,118.71,119.28,118.69,119.35
2023-10-09 17:15,88,15,73,5958,393,5565,7058434.0,463855.0,6594578.0,91,22,69,6336,413,5923,7577218.0,487616.0,7089602.0,118.03,118.5,118.07,119.7
2023-10-09 17:20,523,510,13,36855,35022,1833,43794715.0,41592880.0,2201834.0,512,503,9,36737,34802,1935,43639318.0,41302660.0,2336658.0,118.76,120.12,118.68,120.76
2023-10-09 17:25,1100,146,954,69901,3578,66323,83115692.0,4209527.0,78906164.0,1088,138,950,69345,3588,65757,82460590.0,4220625.0,78239964.0,117.65,118.97,117.63,118.98
2023-10-09 17:30,2252,260,1992,131110,6801,124309,155735481.0,7998657.0,147736824.0,2231,252,1979,130193,6633,123560,154651072.0,7798881.0,146852190.0,117.61,118.85,117.58,118.85
2023-10-09 17:35,913,171,742,46388,3880,42508,55044852.0,4573071.0,50471781.0,894,158,736,45510,3267,42243,53997417.0,3841842.0,50155574.0,117.86,118.73,117.6,118.73
2023-10-09 17:40,189,79,110,9724,1953,7771,11572652.0,2311107.0,9261545.0,176,66,110,9186,1831,7355,10920188.0,2159358.0,8760830.0,118.34,119.18,117.93,119.11
2023-10-09 17:45,2014,513,1501,105746,16642,89104,125641875.0,19689222.0,105952653.0,1997,506,1491,105649,16564,89085,125534050.0,19596790.0,105937259.0,118.31,118.91,118.31,118.92
2023-10-09 17:50,2433,852,1581,122650,30032,92618,145716169.0,35574570.0,110141598.0,2418,841,1577,122690,29795,92895,145784424.0,35291432.0,110492992.0,118.46,118.92,118.45,118.94
2023-10-09 17:55,1591,705,886,75609,30894,44715,90012385.0,36843266.0,53169118.0,1536,672,864,74268,29751,44517,88227286.0,35269935.0,52957351.0,119.26,118.91,118.55,118.96
2023-10-09 18:00,476,360,116,21327,18563,2764,25474406.0,22172290.0,3302115.0,412,331,81,18809,17617,1192,22364676.0,20934104.0,1430572.0,119.44,119.47,118.83,120.01
2023-10-09 18:05,79,33,46,2120,702,1418,2538323.0,839333.0,1698989.0,64,32,32,1925,665,1260,2296996.0,784536.0,1512459.0,119.56,119.82,117.98,120.04
2023-10-09 18:10,76,26,50,2515,938,1577,2962972.0,1113579.0,1849393.0,59,21,38,2377,669,1708,2840781.0,792939.0,2047842.0,118.72,117.27,118.53,119.9
2023-10-09 18:15,941,137,804,40775,5484,35291,49066817.0,6972360.0,42094457.0,927,130,797,40287,5419,34868,48012573.0,6409343.0,41603230.0,127.14,119.28,118.28,119.32
2023-10-09 18:20,393,73,320,17876,3749,14127,21665909.0,4902901.0,16763007.0,390,82,308,16659,3462,13197,20546096.0,4806392.0,15739703.0,130.78,118.66,138.83,119.27
2023-10-09 18:25,415,135,280,24087,5455,18632,28648099.0,6459150.0,22188949.0,399,130,269,22895,5361,17534,27211987.0,6334789.0,20877197.0,118.41,119.09,118.16,119.07
2023-10-09 18:30,80,52,28,3827,1948,1879,4576623.0,2328993.0,2247629.0,63,42,21,3581,1347,2234,4270828.0,1598517.0,2672311.0,119.56,119.62,118.67,119.62
2023-10-09 18:35,160,50,110,8348,1175,7173,9938011.0,1392732.0,8545278.0,149,43,106,7498,1322,6176,8929088.0,1561857.0,7367231.0,118.53,119.13,118.14,119.29
2023-10-10 10:00,4483,2406,2077,240938,132711,108227,280242046.0,155930278.0,124311768.0,1819,1081,738,112539,61143,51396,130802503.0,71436388.0,59366114.0,117.5,114.86,116.83,115.51
2023-10-10 10:05,934,656,278,51854,31318,20536,61380974.0,36982340.0,24398634.0,533,409,124,37598,26092,11506,45002690.0,31386289.0,13616400.0,118.09,118.81,120.29,118.34
2023-10-10 10:10,1274,781,493,56329,40750,15579,66107047.0,47940343.0,18166704.0,684,457,227,35565,25482,10083,41916973.0,29938632.0,11978341.0,117.65,116.61,117.49,118.8
2023-10-10 10:15,680,373,307,35981,18581,17400,42476536.0,21964020.0,20512516.0,534,275,259,36535,19644,16891,43086006.0,23040767.0,20045239.0,118.21,117.89,117.29,118.67
2023-10-10 10:20,818,508,310,44164,23265,20899,52386011.0,27516285.0,24869726.0,675,427,248,42137,23984,18153,49815677.0,28218035.0,21597641.0,118.27,119.0,117.65,118.98
2023-10-10 10:25,306,155,151,14263,5276,8987,17429990.0,6256818.0,11173172.0,239,137,102,12411,5346,7065,14695602.0,6284522.0,8411079.0,118.59,124.33,117.56,119.05
2023-10-10 10:30,1004,287,717,68450,15793,52657,80654570.0,18615562.0,62039008.0,841,200,641,49500,6728,42772,58615689.0,7927183.0,50688505.0,117.87,117.82,117.82,118.51
2023-10-10 10:35,1789,862,927,83676,42896,40780,99206732.0,50791213.0,48415518.0,1678,794,884,84369,43000,41369,99924325.0,50802301.0,49122024.0,118.41,118.72,118.14,118.74
2023-10-10 10:40,383,211,172,30312,19130,11182,35925762.0,22530263.0,13395498.0,333,199,134,29038,19168,9870,34376971.0,22545091.0,11831879.0,117.77,119.8,117.62,119.88
2023-10-10 10:45,216,135,81,17067,8265,8802,20124974.0,9729282.0,10395692.0,183,122,61,16844,8267,8577,19975840.0,9702629.0,10273211.0,117.72,118.11,117.37,119.78
2023-10-10 10:50,1427,214,1213,111584,21972,89612,131814050.0,25599247.0,106214803.0,1329,139,1190,104896,16841,88055,124074972.0,19621638.0,104453334.0,116.51,118.53,116.51,118.62
2023-10-10 10:55,1279,192,1087,101439,19017,82422,120002123.0,22169465.0,97832657.0,1229,156,1073,100429,18751,81678,118811237.0,21849533.0,96961704.0,116.58,118.7,116.52,118.71
2023-10-10 11:00,1744,310,1434,135212,24117,111095,159336428.0,28092904.0,131243524.0,1662,259,1403,132296,23768,108528,156214219.0,27667096.0,128547123.0,116.49,118.14,116.4,118.45
2023-10-10 11:05,1436,847,589,78319,35241,43078,92209031.0,41201693.0,51007338.0,1307,754,553,74996,33798,41198,88272304.0,39473583.0,48798721.0,116.91,118.41,116.79,118.45
2023-10-10 11:10,126,63,63,8453,4021,4432,9874891.0,4685539.0,5189352.0,76,28,48,6881,2856,4025,8113288.0,3316205.0,4797083.0,116.53,117.09,116.11,119.18
2023-10-10 11:15,375,48,327,24573,3947,20626,28971220.0,4583222.0,24387998.0,347,34,313,24199,4362,19837,28536316.0,5064478.0,23471838.0,116.12,118.24,116.1,118.32
2023-10-10 11:20,776,99,677,58239,11086,47153,68659538.0,12884322.0,55775215.0,746,82,664,57963,10956,47007,68319220.0,12723759.0,55595461.0,116.22,118.29,116.14,118.27
2023-10-10 11:25,429,143,286,35119,14983,20136,41402884.0,17517796.0,23885088.0,389,116,273,34996,15033,19963,41251898.0,17565177.0,23686721.0,116.92,118.62,116.84,118.65
2023-10-10 11:30,157,65,92,18288,11221,7067,21449094.0,13054082.0,8395012.0,134,52,82,21752,15291,6461,25600004.0,17912459.0,7687545.0,116.34,118.79,117.14,118.98
2023-10-10 11:35,477,215,262,31409,12968,18441,36903271.0,15100960.0,21802310.0,439,195,244,31714,13279,18435,37386615.0,15451023.0,21935592.0,116.45,118.23,116.36,118.99
2023-10-10 11:40,1249,189,1060,74204,9431,64773,86872547.0,10962103.0,75910443.0,1157,137,1020,72027,8922,63105,84641442.0,10339490.0,74301952.0,116.23,117.19,115.89,117.74
2023-10-10 11:45,3187,551,2636,238503,34935,203568,279557397.0,40302831.0,239254566.0,3080,470,2610,235441,33165,202276,276270479.0,38288893.0,237981586.0,115.37,117.53,115.45,117.65
2023-10-10 11:50,2431,410,2021,175102,15396,159706,205787725.0,17778902.0,188008823.0,2391,376,2015,169343,15475,153868,198747780.0,17814671.0,180933108.0,115.48,117.72,115.12,117.59
2023-10-10 11:55,832,345,487,69638,25905,43733,81984675.0,30265582.0,51719093.0,764,308,456,67767,24587,43180,79608185.0,28563001.0,51045183.0,116.83,118.26,116.17,118.21
2023-10-10 12:00,262,128,134,22715,12492,10223,26885558.0,14569091.0,12316467.0,243,107,136,28592,10508,18084,33987039.0,12232304.0,21754734.0,116.63,120.48,116.41,120.3
2023-10-10 12:05,697,130,567,47190,11260,35930,55597000.0,13101677.0,42495322.0,684,124,560,44799,11277,33522,52775725.0,13116794.0,39658931.0,116.36,118.27,116.31,118.31
2023-10-10 12:10,2113,659,1454,130022,24847,105175,152870006.0,28859831.0,124010174.0,2079,638,1441,128927,23964,104963,151636104.0,27827134.0,123808970.0,116.15,117.91,116.12,117.95
2023-10-10 12:15,1339,267,1072,88276,10859,77417,104016461.0,12616270.0,91400191.0,1302,239,1063,86425,10723,75702,101762461.0,12442248.0,89320212.0,116.18,118.06,116.03,117.99
2023-10-10 12:20,951,215,736,64899,11136,53763,76133450.0,12877856.0,63255593.0,887,178,709,63347,9247,54100,74492189.0,10700665.0,63791524.0,115.64,117.66,115.72,117.91
2023-10-10 12:25,2276,222,2054,188046,28369,159677,220702216.0,32779867.0,187922349.0,2247,200,2047,188834,29152,159682,221672505.0,33672535.0,187999970.0,115.55,117.69,115.51,117.73
2023-10-10 12:30,2200,247,1953,185232,28347,156885,217480561.0,32745659.0,184734902.0,2171,226,1945,183800,26966,156834,215818068.0,31141758.0,184676310.0,115.52,117.75,115.49,117.75
2023-10-10 12:35,1076,346,730,88666,22994,65672,104496090.0,26805727.0,77690362.0,1038,322,716,79817,22560,57257,93715096.0,26226555.0,67488541.0,116.58,118.3,116.25,117.87
2023-10-10 12:40,683,595,88,36770,30152,6618,43097704.0,35244254.0,7853449.0,650,581,69,36204,29716,6488,42439973.0,34739719.0,7700254.0,116.89,118.67,116.91,118.68
2023-10-10 12:45,418,383,35,23915,21906,2009,28062689.0,25675761.0,2386927.0,406,379,27,23585,21673,1912,27653511.0,25380939.0,2272572.0,117.21,118.81,117.11,118.86
2023-10-10 12:50,1462,1192,270,88076,77354,10722,105590179.0,92845532.0,12744647.0,1242,1101,141,77589,71526,6063,91591581.0,84354634.0,7236947.0,120.03,118.86,117.94,119.36
2023-10-10 12:55,401,306,95,24393,20963,3430,28743916.0,24672792.0,4071124.0,387,306,81,25314,21526,3788,29862295.0,25321866.0,4540428.0,117.7,118.69,117.63,119.86
2023-10-10 13:00,202,131,71,14071,9407,4664,16683969.0,11079957.0,5604012.0,179,126,53,12777,9362,3415,15110390.0,11010629.0,4099760.0,117.78,120.15,117.61,120.05
2023-10-10 13:05,248,161,87,13540,9962,3578,15913902.0,11729166.0,4184735.0,239,153,86,13718,9909,3809,16194875.0,11657762.0,4537113.0,117.74,116.96,117.65,119.12
2023-10-10 13:10,1588,378,1210,85020,29320,55700,100004578.0,34252092.0,65752485.0,1546,353,1193,80773,30417,50356,95051836.0,35533130.0,59518706.0,116.82,118.05,116.82,118.2
2023-10-10 13:15,583,455,128,42254,35101,7153,49577592.0,41104363.0,8473229.0,558,436,122,41045,33660,7385,48175231.0,39420422.0,8754809.0,117.1,118.46,117.11,118.55
2023-10-10 13:20,1157,176,981,58135,12345,45790,68428942.0,14444298.0,53984644.0,1131,160,971,62238,12379,49859,73317107.0,14479440.0,58837666.0,117.01,117.9,116.97,118.01
2023-10-10 13:25,1965,249,1716,115446,18147,97299,135975316.0,21171988.0,114803328.0,1920,229,1691,114371,17601,96770,134700954.0,20518191.0,114182763.0,116.67,117.99,116.57,117.99
2023-10-10 13:30,3227,495,2732,227479,37843,189636,267749988.0,44008030.0,223741958.0,3189,476,2713,226033,37316,188717,266164830.0,43374275.0,222790555.0,116.29,117.98,116.24,118.06
2023-10-10 13:35,2976,757,2219,177377,51413,125964,208937852.0,60015373.0,148922479.0,2948,744,2204,177992,52092,125900,209616039.0,60762980.0,148853059.0,116.73,118.23,116.65,118.23
2023-10-10 13:40,4836,704,4132,322182,82891,239291,379596951.0,96377119.0,283219832.0,4820,691,4129,321462,82312,239150,378754684.0,95702614.0,283052070.0,116.27,118.36,116.27,118.36
2023-10-10 13:45,1380,965,415,115584,78846,36738,136346157.0,92559860.0,43786297.0,1317,936,381,115059,78122,36937,135720282.0,91691075.0,44029206.0,117.39,119.19,117.37,119.2
2023-10-10 13:50,3011,2680,331,261330,214407,46923,308375995.0,252169480.0,56206515.0,2983,2667,316,258998,212940,46058,305648673.0,250455741.0,55192932.0,117.61,119.78,117.62,119.83
2023-10-10 13:55,1673,719,954,114800,52195,62605,135397489.0,61268368.0,74129120.0,1638,707,931,113406,51313,62093,133896292.0,60233046.0,73663245.0,117.38,118.41,117.38,118.63
2023-10-10 14:00,1861,380,1481,136428,20704,115724,160979845.0,24075308.0,136904536.0,1851,369,1482,136747,20963,115784,161362792.0,24380434.0,136982358.0,116.28,118.3,116.3,118.31
2023-10-10 14:05,1274,216,1058,94164,13303,80861,111105342.0,15462152.0,95643190.0,1257,209,1048,93887,13137,80750,110775490.0,15266517.0,95508972.0,116.23,118.28,116.21,118.28
2023-10-10 14:10,1815,196,1619,148194,22681,125513,174766858.0,26339549.0,148427309.0,1812,202,1610,147877,22513,125364,174464737.0,26137982.0,148326754.0,116.13,118.26,116.1,118.32
2023-10-10 14:15,2609,276,2333,197062,26272,170790,232134635.0,30454287.0,201680347.0,2572,245,2327,193165,24410,168755,227614861.0,28320289.0,199294571.0,115.92,118.09,116.02,118.1
2023-10-10 14:20,507,88,419,36643,5959,30684,43144984.0,6933367.0,36211617.0,480,71,409,34123,5680,28443,40201836.0,6592020.0,33609816.0,116.35,118.01,116.06,118.17
2023-10-10 14:25,90,45,45,5929,2410,3519,6993280.0,2838498.0,4154782.0,71,33,38,5705,2455,3250,6703369.0,2842916.0,3860453.0,117.78,118.07,115.8,118.78
2023-10-10 14:30,653,124,529,50020,16502,33518,59016725.0,19275696.0,39741029.0,606,88,518,43474,10444,33030,51295588.0,12138001.0,39157587.0,116.81,118.57,116.22,118.55
2023-10-10 14:35,991,547,444,70899,39195,31704,84316491.0,46491211.0,37825280.0,925,504,421,69023,37913,31110,81660480.0,44539929.0,37120550.0,118.62,119.31,117.48,119.32
2023-10-10 14:40,1038,899,139,84297,72427,11870,99864184.0,85594498.0,14269686.0,980,878,102,83278,72305,10973,98615337.0,85412720.0,13202616.0,118.18,120.22,118.13,120.32
2023-10-10 14:45,82,36,46,5934,1711,4223,7043031.0,2011652.0,5031379.0,52,22,30,5568,1473,4095,6629843.0,1721256.0,4908587.0,117.57,119.14,116.85,119.87
2023-10-10 14:50,175,82,93,19056,9292,9764,22740701.0,11024646.0,11716055.0,137,65,72,17836,8441,9395,21211035.0,9929155.0,11281879.0,118.65,119.99,117.63,120.08
2023-10-10 14:55,918,715,203,75440,54868,20572,89648086.0,64897418.0,24750667.0,849,684,165,74594,54518,20076,88526666.0,64379013.0,24147652.0,118.28,120.31,118.09,120.28
2023-10-10 15:00,2342,1846,496,171091,125757,45334,209392221.0,150487824.0,58904396.0,1932,1678,254,143247,111751,31496,171659883.0,133355605.0,38304278.0,119.67,129.93,119.33,121.62
2023-10-10 15:05,1096,688,408,75049,41184,33865,90392554.0,49181365.0,41211189.0,922,633,289,69923,42478,27445,87337110.0,50631580.0,36705530.0,119.42,121.69,119.19,133.74
2023-10-10 15:10,1702,1256,446,141086,96578,44508,170153563.0,115935317.0,54218246.0,1433,1131,302,128952,89957,38995,155018075.0,107468971.0,47549103.0,120.04,121.82,119.47,121.94
2023-10-10 15:15,603,388,215,57219,34564,22655,70254996.0,41475421.0,28779574.0,460,298,162,61770,33668,28102,74475302.0,40246283.0,34229019.0,120.0,127.03,119.54,121.8
2023-10-10 15:20,1194,755,439,81707,48517,33190,98248989.0,57923986.0,40325002.0,1063,688,375,73216,42559,30657,88105688.0,50817717.0,37287971.0,119.39,121.5,119.41,121.63
2023-10-10 15:25,239,121,118,36903,9564,27339,44893950.0,11412048.0,33481901.0,174,106,68,19827,11211,8616,23894022.0,13350983.0,10543039.0,119.32,122.47,119.09,122.37
2023-10-10 15:30,214,97,117,24283,7375,16908,29126210.0,8659951.0,20466259.0,159,69,90,15074,6780,8294,18118238.0,8028542.0,10089695.0,117.42,121.04,118.42,121.65
2023-10-10 15:35,1375,340,1035,107221,27430,79791,128433001.0,32461134.0,95971867.0,1270,287,983,105077,26667,78410,125896780.0,31469780.0,94427000.0,118.34,120.28,118.01,120.43
2023-10-10 15:40,938,191,747,82009,14393,67616,98587314.0,16962449.0,81624864.0,867,154,713,81034,13923,67111,97539369.0,16403475.0,81135893.0,117.85,120.72,117.82,120.9
2023-10-10 15:45,2155,211,1944,180096,22399,157697,215331896.0,26364211.0,188967684.0,2041,154,1887,179019,21904,157115,214158420.0,25759317.0,188399103.0,117.7,119.83,117.6,119.91
2023-10-10 15:50,748,88,660,65930,10539,55391,78671049.0,12299374.0,66371675.0,696,62,634,65214,10382,54832,77820845.0,12100288.0,65720557.0,116.7,119.82,116.55,119.86
2023-10-10 15:55,862,181,681,69616,15541,54075,83089895.0,18309165.0,64780730.0,815,160,655,69634,15532,54102,83223915.0,18289884.0,64934031.0,117.81,119.8,117.76,120.02
2023-10-10 16:00,1182,266,916,58877,21327,37550,70436109.0,25284130.0,45151978.0,1127,231,896,57526,20390,37136,68777533.0,24122241.0,44655291.0,118.55,120.24,118.3,120.25
2023-10-10 16:05,668,370,298,54206,34704,19502,65032494.0,41395232.0,23637262.0,595,351,244,51382,33427,17955,61603688.0,39818087.0,21785600.0,119.28,121.2,119.12,121.33
2023-10-10 16:10,400,260,140,36064,23171,12893,43289947.0,27610749.0,15679198.0,332,231,101,34528,22840,11688,41430116.0,27194319.0,14235796.0,119.16,121.61,119.06,121.8
2023-10-10 16:15,744,639,105,61088,49347,11741,73312550.0,59023526.0,14289024.0,696,616,80,59323,48066,11257,71199239.0,57487121.0,13712118.0,119.61,121.7,119.6,121.81
2023-10-10 16:20,816,578,238,57698,42859,14839,69556831.0,51601211.0,17955620.0,742,558,184,56147,42344,13803,67471050.0,50675641.0,16795408.0,120.4,121.0,119.68,121.68
2023-10-10 16:25,218,94,124,14352,6322,8030,17644061.0,7938684.0,9705377.0,175,68,107,16039,8497,7542,19174796.0,10008549.0,9166246.0,125.57,120.86,117.79,121.54
2023-10-10 16:30,2413,1458,955,183487,110933,72554,222726697.0,134099831.0,88626866.0,1921,1199,722,151615,87409,64206,183558905.0,105012073.0,78546832.0,120.88,122.15,120.14,122.34
2023-10-10 16:35,3434,2274,1160,227625,132233,95392,284561894.0,161454303.0,123107591.0,2660,1912,748,184896,109349,75547,230927124.0,131888312.0,99038812.0,122.1,129.05,120.61,131.1
2023-10-10 16:40,1174,459,715,104548,38440,66108,127083841.0,46223468.0,80860373.0,1001,363,638,96643,35464,61179,117405111.0,42552515.0,74852595.0,120.25,122.32,119.99,122.35
2023-10-10 16:45,673,307,366,57038,25046,31992,69136113.0,30015372.0,39120741.0,538,247,291,54610,22181,32429,66463949.0,26575341.0,39888607.0,119.84,122.28,119.81,123.0
2023-10-10 16:50,1116,816,300,81705,51313,30392,99414651.0,62012943.0,37401708.0,980,743,237,76855,49856,26999,93362382.0,60175224.0,33187157.0,120.85,123.06,120.7,122.92
2023-10-10 16:55,1650,1022,628,146055,93377,52678,183721934.0,116385668.0,67336265.0,1326,880,446,127690,82777,44913,155855422.0,100256407.0,55599015.0,124.64,127.83,121.12,123.79
2023-10-10 17:00,1403,904,499,128504,80519,47985,157980521.0,98384194.0,59596327.0,1177,814,363,111313,73621,37692,136172566.0,89419917.0,46752648.0,122.19,124.2,121.46,124.04
2023-10-10 17:05,957,588,369,70802,42037,28765,87461320.0,51890449.0,35570870.0,640,441,199,54955,30737,24218,67435787.0,37301056.0,30134730.0,123.44,123.66,121.36,124.43
2023-10-10 17:10,1349,622,727,95672,43690,51982,117707850.0,53699384.0,64008465.0,971,460,511,82160,37948,44212,103262659.0,48422536.0,54840123.0,122.91,123.14,127.6,124.04
2023-10-10 17:15,1076,421,655,78619,27758,50861,95910853.0,33730808.0,62180044.0,885,354,531,70145,26205,43940,86028313.0,31743991.0,54284322.0,121.52,122.25,121.14,123.54
2023-10-10 17:20,1875,585,1290,151345,40630,110715,184521288.0,49157526.0,135363761.0,1655,459,1196,141892,34988,106904,173625867.0,42236971.0,131388896.0,120.99,122.26,120.72,122.9
2023-10-10 17:25,609,183,426,53169,17049,36120,64854328.0,20517780.0,44336547.0,578,152,426,52025,16104,35921,63639827.0,19399229.0,44240597.0,120.35,122.75,120.46,123.16
2023-10-10 17:30,1975,854,1121,128674,53872,74802,155861189.0,64910479.0,90950710.0,1602,640,962,115941,46882,69059,140812933.0,56341896.0,84471036.0,120.49,121.59,120.18,122.32
2023-10-10 17:35,1608,513,1095,133646,40413,93233,161625130.0,48339652.0,113285477.0,1480,449,1031,127025,38372,88653,153965945.0,45898990.0,108066954.0,119.61,121.51,119.62,121.9
2023-10-10 17:40,1087,565,522,87154,39007,48147,105236330.0,46619316.0,58617013.0,914,460,454,81503,35389,46114,98455695.0,42232177.0,56223518.0,119.52,121.75,119.34,121.92
2023-10-10 17:45,2123,1652,471,138259,104705,33554,167594830.0,126513664.0,41081165.0,2034,1626,408,137623,105072,32551,166694053.0,126824733.0,39869320.0,120.83,122.43,120.7,122.48
2023-10-10 17:50,1748,1371,377,120797,90463,30334,145848297.0,109127495.0,36720802.0,1620,1304,316,118291,89981,28310,143073838.0,108484415.0,34589422.0,120.63,121.05,120.56,122.18
2023-10-10 17:55,908,445,463,67617,25649,41968,81626215.0,30644198.0,50982017.0,813,380,433,63865,23152,40713,77115830.0,27655226.0,49460604.0,119.48,121.48,119.45,121.49
2023-10-10 18:00,1474,217,1257,120550,20563,99987,145517767.0,24436449.0,121081317.0,1394,168,1226,119151,19796,99355,143836013.0,23514456.0,120321557.0,118.84,121.1,118.78,121.1
2023-10-10 18:05,575,104,471,48242,9724,38518,58336818.0,11604169.0,46732649.0,542,95,447,47805,9736,38069,57784263.0,11588919.0,46195344.0,119.34,121.33,119.03,121.35
2023-10-10 18:10,1129,360,769,93131,34330,58801,112810315.0,41159287.0,71651027.0,1091,328,763,93221,34053,59168,112904595.0,40789884.0,72114711.0,119.89,121.85,119.78,121.88
2023-10-10 18:15,1585,1091,494,112753,78106,34647,136060517.0,93961641.0,42098875.0,1482,1039,443,111558,78232,33326,134747705.0,94052220.0,40695485.0,120.3,121.51,120.22,122.11
2023-10-10 18:20,1197,783,414,82807,54141,28666,100198271.0,65292690.0,34905580.0,1131,742,389,79229,51444,27785,95806382.0,61876097.0,33930285.0,120.6,121.77,120.28,122.12
2023-10-10 18:25,1933,1470,463,138427,109463,28964,167830848.0,132417091.0,35413757.0,1800,1390,410,136577,108088,28489,165312580.0,130359095.0,34953484.0,120.97,122.27,120.6,122.69
2023-10-10 18:30,1111,756,355,71480,55251,16229,86969278.0,67310612.0,19658666.0,966,703,263,65515,51959,13556,79991404.0,63102537.0,16888866.0,121.83,121.13,121.45,124.59
2023-10-10 18:35,967,567,400,60066,43805,16261,73850951.0,53942463.0,19908488.0,833,525,308,56053,42096,13957,68362783.0,51190669.0,17172114.0,123.14,122.43,121.6,123.04
2023-10-11 10:00,2061,907,1154,79556,29320,50236,102303617.0,39026064.0,63277552.0,871,315,556,42650,12312,30338,56943693.0,19552313.0,37391380.0,133.1,125.96,158.81,123.25
2023-10-11 10:05,775,380,395,25373,10433,14940,33139584.0,14892933.0,18246651.0,493,230,263,20978,8698,12280,27780239.0,12725833.0,15054406.0,142.75,122.13,146.31,122.59
2023-10-11 10:10,3534,2727,807,151905,123010,28895,186961000.0,151196250.0,35764750.0,2844,2434,410,123558,107338,16220,151427011.0,131372643.0,20054367.0,122.91,123.77,122.39,123.64
2023-10-11 10:15,5034,2690,2344,300958,160417,140541,379233533.0,199500851.0,179732681.0,3217,1912,1305,247882,134546,113336,308262137.0,165616647.0,142645489.0,124.36,127.89,123.09,125.86
2023-10-11 10:20,3766,1835,1931,248983,114100,134883,308248575.0,140256922.0,167991652.0,3266,1629,1637,239210,111244,127966,296341066.0,136613783.0,159727282.0,122.92,124.55,122.81,124.82
2023-10-11 10:25,2252,893,1359,157134,53223,103911,192260529.0,64352031.0,127908498.0,1717,579,1138,137125,43379,93746,168195489.0,52448831.0,115746658.0,120.91,123.09,120.91,123.47
2023-10-11 10:30,1703,1076,627,102990,53871,49119,125752945.0,65253540.0,60499405.0,1430,896,534,94434,48951,45483,115277490.0,59277406.0,56000083.0,121.13,123.17,121.1,123.12
2023-10-11 10:35,1431,686,745,103170,42946,60224,130030526.0,56327720.0,73702806.0,1098,482,616,93949,38098,55851,116574377.0,48079404.0,68494973.0,131.16,122.38,126.2,122.64
2023-10-11 10:40,592,297,295,48374,21687,26687,59098745.0,26151071.0,32947673.0,467,237,230,41621,18246,23375,53075412.0,24279227.0,28796185.0,120.58,123.46,133.07,123.19
2023-10-11 10:45,765,216,549,61900,16788,45112,75953026.0,20329572.0,55623454.0,672,164,508,54634,14986,39648,66787266.0,18083147.0,48704118.0,121.1,123.3,120.67,122.84
2023-10-11 10:50,302,134,168,23180,9236,13944,29946119.0,11169277.0,18776842.0,222,101,121,20202,9007,11195,26330598.0,10885996.0,15444602.0,120.93,134.66,120.86,137.96
2023-10-11 10:55,3497,2734,763,202263,161975,40288,242786119.0,195383328.0,47402791.0,2966,2387,579,175193,146722,28471,211946541.0,177129031.0,34817510.0,120.63,117.66,120.72,122.29
2023-10-11 11:00,1439,750,689,79612,32890,46722,96105954.0,39533615.0,56572338.0,1227,619,608,75090,29898,45192,90947714.0,35902288.0,55045426.0,120.2,121.08,120.08,121.8
2023-10-11 11:05,1997,1107,890,131601,57800,73801,159004744.0,69330437.0,89674307.0,1798,973,825,120945,54576,66369,146049146.0,65339161.0,80709985.0,119.95,121.51,119.72,121.61
2023-10-11 11:10,1064,757,307,85735,44985,40750,104194376.0,54041105.0,50153271.0,938,678,260,66941,41889,25052,80800424.0,50247755.0,30552669.0,120.13,123.08,119.95,121.96
2023-10-11 11:15,539,230,309,42970,13824,29146,52043639.0,16630080.0,35413559.0,369,117,252,37513,10427,27086,45418170.0,12404856.0,33013314.0,120.3,121.5,118.97,121.88
2023-10-11 11:20,1449,888,561,101021,54538,46483,121303020.0,65423748.0,55879271.0,1309,803,506,96593,53481,43112,116606168.0,64134333.0,52471834.0,119.96,120.21,119.92,121.71
2023-10-11 11:25,756,215,541,52284,18575,33709,63143246.0,22153986.0,40989259.0,722,189,533,51730,18065,33665,62447352.0,21498911.0,40948441.0,119.27,121.6,119.01,121.64
2023-10-11 11:30,1806,531,1275,111307,38200,73107,134430718.0,45754423.0,88676294.0,1729,481,1248,106357,34589,71768,128512780.0,41439671.0,87073109.0,119.78,121.3,119.81,121.33
2023-10-11 11:35,1603,1081,522,115768,81721,34047,139934893.0,98412944.0,41521948.0,1505,1028,477,113810,79987,33823,137541643.0,96281353.0,41260290.0,120.43,121.95,120.37,121.99
2023-10-11 11:40,1141,755,386,84709,55684,29025,102589993.0,67147578.0,35442414.0,1096,734,362,88517,62080,26437,106850237.0,74571040.0,32279197.0,120.59,122.11,120.12,122.1
2023-10-11 11:45,724,551,173,45174,27293,17881,54677740.0,32783618.0,21894121.0,711,539,172,44904,27447,17457,54288553.0,32924807.0,21363746.0,120.12,122.44,119.96,122.38
2023-10-11 11:50,954,768,186,63964,42743,21221,77455999.0,51366099.0,26089899.0,946,755,191,66607,43854,22753,80496099.0,52640772.0,27855327.0,120.17,122.94,120.04,122.42
2023-10-11 11:55,818,605,213,45243,30203,15040,54638180.0,36278345.0,18359834.0,799,591,208,43971,29266,14705,53126696.0,35175434.0,17951262.0,120.12,122.07,120.19,122.08
2023-10-11 12:00,664,449,215,49115,33687,15428,59633131.0,40796275.0,18836855.0,591,410,181,45892,32123,13769,55615769.0,38736289.0,16879479.0,121.1,122.1,120.59,122.59
2023-10-11 12:05,350,118,232,25212,9805,15407,30653610.0,11779986.0,18873624.0,310,104,206,24512,11548,12964,29578774.0,13722788.0,15855985.0,120.14,122.5,118.83,122.31
2023-10-11 12:10,297,134,163,25845,13931,11914,31513329.0,16826227.0,14687102.0,239,103,136,24970,13210,11760,30356707.0,15907911.0,14448796.0,120.78,123.28,120.42,122.86
2023-10-11 12:15,551,324,227,45731,24700,21031,55759440.0,29936180.0,25823260.0,396,223,173,35158,18009,17149,42831853.0,21713520.0,21118333.0,121.2,122.79,120.57,123.15
2023-10-11 12:20,146,78,68,9663,4243,5420,11752421.0,5123279.0,6629142.0,108,66,42,12049,7444,4605,14704297.0,8996068.0,5708229.0,120.75,122.31,120.85,123.96
2023-10-11 12:25,287,86,201,25399,10174,15225,30877947.0,12208756.0,18669191.0,266,90,176,23889,8823,15066,29064327.0,10583301.0,18481026.0,120.0,122.62,119.95,122.67
2023-10-11 12:30,504,254,250,32882,16987,15895,39906943.0,20465000.0,19441942.0,471,243,228,33820,18911,14909,41053232.0,22784437.0,18268794.0,120.47,122.31,120.48,122.54
2023-10-11 12:35,1277,516,761,88612,34113,54499,107355149.0,41052576.0,66302572.0,1203,473,730,85404,32899,52505,103768898.0,39585995.0,64182903.0,120.34,121.66,120.33,122.24
2023-10-11 12:40,105,55,50,7152,3566,3586,8618599.0,4257958.0,4360641.0,71,36,35,6490,3090,3400,7870697.0,3697582.0,4173114.0,119.4,121.6,119.66,122.74
2023-10-11 12:45,177,111,66,16348,7361,8987,19926695.0,8806263.0,11120432.0,149,89,60,14272,6889,7383,17306715.0,8244732.0,9061983.0,119.63,123.74,119.68,122.74
2023-10-11 12:50,1109,398,711,65047,16822,48225,78995382.0,20251157.0,58744225.0,1073,372,701,63544,16180,47364,77167494.0,19469011.0,57698482.0,120.38,121.81,120.33,121.82
2023-10-11 12:55,2843,1192,1651,168296,55634,112662,204108037.0,66796475.0,137311561.0,2829,1187,1642,168110,53614,114496,204057128.0,64481315.0,139575812.0,120.06,121.88,120.27,121.9
2023-10-11 13:00,599,289,310,30228,9998,20230,36757372.0,12088340.0,24669031.0,556,270,286,29970,10172,19798,36377934.0,12253437.0,24124497.0,120.91,121.94,120.46,121.85
2023-10-11 13:05,1185,228,957,87555,14499,73056,106283008.0,17363703.0,88919304.0,1146,200,946,86122,13411,72711,104581826.0,16044953.0,88536872.0,119.76,121.71,119.64,121.77
2023-10-11 13:10,1286,299,987,91980,25464,66516,111622518.0,30544327.0,81078190.0,1248,281,967,92379,25677,66702,112127489.0,30815066.0,81312423.0,119.95,121.89,120.01,121.9
2023-10-11 13:15,3142,633,2509,255583,61577,194006,310007460.0,73678850.0,236328609.0,3108,611,2497,255722,62382,193340,310287641.0,74618624.0,235669016.0,119.65,121.82,119.62,121.89
2023-10-11 13:20,1959,421,1538,128995,32259,96736,156331156.0,38645049.0,117686107.0,1939,418,1521,127973,31724,96249,155101262.0,37997988.0,117103274.0,119.8,121.66,119.78,121.67
2023-10-11 13:25,643,166,477,45776,9494,36282,55514920.0,11433477.0,44081443.0,625,157,468,45385,9667,35718,55082905.0,11649131.0,43433773.0,120.43,121.5,120.5,121.6
2023-10-11 13:30,28,16,12,1211,359,852,1480462.0,431462.0,1048999.0,16,7,9,572,109,463,710562.0,129721.0,580841.0,120.18,123.12,119.01,125.45
2023-10-11 13:35,2025,431,1594,141388,29528,111860,171242102.0,35332085.0,135910016.0,1992,409,1583,140681,28883,111798,170483237.0,34540717.0,135942519.0,119.66,121.5,119.59,121.6
2023-10-11 13:40,213,63,150,15930,5899,10031,19043624.0,6851030.0,12192594.0,196,51,145,13480,3298,10182,16221380.0,3842414.0,12378966.0,116.14,121.55,116.51,121.58
2023-10-11 13:45,368,29,339,21990,1001,20989,26653901.0,1201564.0,25452336.0,364,27,337,23258,1406,21852,28233530.0,1685248.0,26548281.0,120.04,121.27,119.86,121.49
2023-10-11 13:50,87,42,45,7435,3039,4396,9040651.0,3653560.0,5387091.0,75,27,48,7278,3001,4277,8827253.0,3583225.0,5244028.0,120.22,122.55,119.4,122.61
2023-10-11 13:55,79,31,48,4535,1601,2934,5485780.0,1911614.0,3574165.0,59,25,34,4294,1450,2844,5216176.0,1731388.0,3484787.0,119.4,121.82,119.41,122.53
2023-10-11 14:00,130,59,71,11367,4752,6615,13739094.0,5693550.0,8045544.0,115,51,64,11199,4783,6416,14047581.0,5719363.0,8328218.0,119.81,121.63,119.58,129.8
2023-10-11 14:05,78,36,42,5985,2769,3216,7274948.0,3346033.0,3928914.0,63,30,33,5847,2552,3295,7082044.0,3051196.0,4030847.0,120.84,122.17,119.56,122.33
2023-10-11 14:10,59,26,33,5691,1270,4421,6919639.0,1521397.0,5398242.0,54,20,34,5898,1420,4478,7153598.0,1702155.0,5451442.0,119.8,122.1,119.87,121.74
2023-10-11 14:15,222,119,103,18117,7013,11104,21975788.0,8394077.0,13581711.0,179,95,84,15151,7013,8138,18349453.0,8398992.0,9950460.0,119.69,122.31,119.76,122.27
2023-10-11 14:20,214,75,139,12746,3558,9188,15325987.0,4258456.0,11067530.0,175,55,120,13077,3192,9885,15934913.0,3825301.0,12109612.0,119.69,120.46,119.84,122.5
2023-10-11 14:25,1649,404,1245,110483,29446,81037,133142502.0,35068950.0,98073552.0,1559,342,1217,106970,28588,78382,129200383.0,34003462.0,95196921.0,119.1,121.02,118.94,121.45
2023-10-11 14:30,2278,788,1490,140906,44060,96846,170279293.0,52960134.0,117319159.0,2202,729,1473,138428,42043,96385,167189271.0,50424878.0,116764392.0,120.2,121.14,119.94,121.14
2023-10-11 14:35,2291,605,1686,158594,42880,115714,191469946.0,51380304.0,140089642.0,2254,594,1660,157717,43021,114696,190472470.0,51468884.0,139003586.0,119.82,121.07,119.64,121.19
2023-10-11 14:40,2340,372,1968,172570,28754,143816,208353107.0,34223643.0,174129464.0,2286,337,1949,169554,27177,142377,204867829.0,32372342.0,172495486.0,119.02,121.08,119.12,121.15
2023-10-11 14:45,1739,225,1514,126272,18040,108232,152330231.0,21436197.0,130894033.0,1723,218,1505,125681,17707,107974,151702503.0,21042782.0,130659721.0,118.83,120.94,118.84,121.01
2023-10-11 14:50,1684,247,1437,137770,24734,113036,166050548.0,29373071.0,136677477.0,1644,222,1422,134314,21579,112735,162001566.0,25624297.0,136377268.0,118.76,120.91,118.75,120.97
2023-10-11 14:55,1341,315,1026,111636,28743,82893,134567330.0,34240912.0,100326418.0,1300,284,1016,110441,27938,82503,133131862.0,33254650.0,99877212.0,119.13,121.03,119.03,121.06
2023-10-11 15:00,602,340,262,43303,23128,20175,52237860.0,27723644.0,24514215.0,584,331,253,45340,25227,20113,54626974.0,30186010.0,24440964.0,119.87,121.51,119.66,121.52
2023-10-11 15:05,1780,1130,650,122707,74120,48587,148035255.0,88970520.0,59064734.0,1748,1107,641,121659,73304,48355,146759180.0,87978433.0,58780747.0,120.04,121.56,120.02,121.56
2023-10-11 15:10,1219,688,531,57840,37024,20816,70068448.0,44716982.0,25351465.0,1192,677,515,55211,35263,19948,66740857.0,42557924.0,24182932.0,120.78,121.79,120.69,121.23
2023-10-11 15:15,688,336,352,43226,24231,18995,52054435.0,28932530.0,23121905.0,681,335,346,41570,22640,18930,50241985.0,27196388.0,23045596.0,119.4,121.73,120.13,121.74
2023-10-11 15:20,1485,825,660,102885,65520,37365,124405396.0,78874423.0,45530973.0,1469,819,650,102513,65176,37337,123928713.0,78422192.0,45506520.0,120.38,121.85,120.32,121.88
2023-10-11 15:25,2012,1744,268,164243,133771,30472,198593384.0,161216412.0,37376972.0,1989,1737,252,164605,134815,29790,198963048.0,162309231.0,36653817.0,120.52,122.66,120.39,123.04
2023-10-11 15:30,613,516,97,54648,42830,11818,66285675.0,51653949.0,14631726.0,590,503,87,54890,43745,11145,66374844.0,52674704.0,13700139.0,120.6,123.81,120.41,122.93
2023-10-11 15:35,378,324,54,27605,24009,3596,33375128.0,28958183.0,4416945.0,373,324,49,29423,23991,5432,35619042.0,28936890.0,6682151.0,120.61,122.83,120.62,123.01
2023-10-11 15:40,1557,1290,267,127423,102967,24456,154143405.0,124123941.0,30019464.0,1556,1295,261,127552,103028,24524,154305952.0,124189672.0,30116279.0,120.55,122.75,120.54,122.8
2023-10-11 15:45,326,271,55,25280,20821,4459,30555834.0,25100493.0,5455341.0,312,265,47,25023,20590,4433,30258529.0,24818567.0,5439962.0,120.55,122.34,120.54,122.72
2023-10-11 15:50,223,197,26,17635,16926,709,21228458.0,20366491.0,861967.0,221,199,22,16811,16216,595,20199042.0,19471447.0,727594.0,120.33,121.58,120.08,122.28
2023-10-11 15:55,281,224,57,23171,19133,4038,28011070.0,23096556.0,4914514.0,269,219,50,23311,19122,4189,28204223.0,23069413.0,5134810.0,120.72,121.71,120.64,122.58
2023-10-11 16:00,1568,1321,247,144434,115904,28530,174963785.0,139904566.0,35059218.0,1531,1303,228,144304,115609,28695,174743619.0,139488102.0,35255517.0,120.71,122.89,120.66,122.86
2023-10-11 16:05,1343,1152,191,113205,93825,19380,137139780.0,113337203.0,23802576.0,1326,1150,176,113090,94160,18930,136962354.0,113702471.0,23259882.0,120.8,122.82,120.75,122.87
2023-10-11 16:10,3607,1970,1637,209616,107901,101715,253004918.0,129513264.0,123491654.0,3553,1930,1623,207100,106798,100302,250182331.0,128159043.0,122023288.0,120.03,121.41,120.0,121.66
2023-10-11 16:15,5237,2357,2880,290376,105086,185290,350798724.0,125974571.0,224824153.0,5226,2347,2879,291290,105037,186253,352048079.0,125909122.0,226138956.0,119.88,121.34,119.87,121.41
2023-10-11 16:20,2454,1039,1415,143558,51503,92055,173338858.0,61733921.0,111604937.0,2425,1026,1399,142989,51599,91390,172676156.0,61851408.0,110824747.0,119.86,121.24,119.87,121.27
2023-10-11 16:25,2113,355,1758,156441,23059,133382,188939500.0,27460380.0,161479120.0,2095,343,1752,156561,22814,133747,189171203.0,27158889.0,162012314.0,119.09,121.07,119.04,121.13
2023-10-11 16:30,1826,1376,450,142056,106085,35971,171332641.0,127430321.0,43902319.0,1798,1361,437,141918,105841,36077,171211344.0,127110582.0,44100761.0,120.12,122.05,120.1,122.24
2023-10-11 16:35,547,363,184,42496,29975,12521,51259657.0,36006769.0,15252888.0,524,354,170,42435,30001,12434,51177557.0,36020238.0,15157319.0,120.12,121.82,120.06,121.9
2023-10-11 16:40,690,82,608,41531,6672,34859,50077900.0,7922295.0,42155604.0,667,73,594,40043,6249,33794,48319337.0,7438340.0,40880997.0,118.74,120.93,119.03,120.97
2023-10-11 16:45,1430,165,1265,108385,19572,88813,130730180.0,23251443.0,107478737.0,1396,144,1252,107980,19582,88398,130237637.0,23262347.0,106975290.0,118.8,121.02,118.79,121.02
2023-10-11 16:50,300,92,208,22588,6730,15858,27207363.0,8005773.0,19201590.0,269,78,191,21621,6428,15193,26072160.0,7638328.0,18433832.0,118.96,121.08,118.83,121.33
2023-10-11 16:55,136,68,68,7119,3044,4075,8440202.0,3601317.0,4838884.0,116,53,63,8301,4421,3880,9938203.0,5209036.0,4729166.0,118.31,118.75,117.82,121.89
2023-10-11 17:00,58,30,28,2869,933,1936,3456316.0,1113401.0,2342914.0,34,13,21,1958,749,1209,2361111.0,888352.0,1472759.0,119.34,121.02,118.61,121.82
2023-10-11 17:05,37,18,19,3492,2273,1219,4144800.0,2671301.0,1473499.0,25,10,15,1737,688,1049,2087940.0,809293.0,1278647.0,117.52,120.88,117.63,121.89
2023-10-11 17:10,103,43,60,7477,3317,4160,8987308.0,3939962.0,5047346.0,81,32,49,6106,2818,3288,7323378.0,3325371.0,3998006.0,118.78,121.33,118.0,121.59
2023-10-11 17:15,496,181,315,33667,12855,20812,39950840.0,15211475.0,24739365.0,300,84,216,25523,10423,15100,30657726.0,12326766.0,18330959.0,118.33,118.87,118.27,121.4
2023-10-11 17:20,296,164,132,26531,14135,12396,31689332.0,16674110.0,15015222.0,220,105,115,24395,12429,11966,29150387.0,14663029.0,14487358.0,117.96,121.13,117.97,121.07
2023-10-11 17:25,1666,1060,606,104263,65848,38415,125246364.0,78674005.0,46572359.0,1596,1014,582,102428,65033,37395,122927652.0,77580672.0,45346979.0,119.48,121.23,119.29,121.26
2023-10-11 17:30,1543,88,1455,65799,9492,56307,79071208.0,11280969.0,67790239.0,1517,67,1450,65878,9482,56396,79200052.0,11263275.0,67936777.0,118.85,120.39,118.79,120.46
2023-10-11 17:35,1444,107,1337,64495,10521,53974,77543790.0,12532119.0,65011671.0,1418,95,1323,63286,10216,53070,76094316.0,12157205.0,63937111.0,119.12,120.45,119.0,120.48
2023-10-11 17:40,411,315,96,30620,22113,8507,36787384.0,26432896.0,10354487.0,381,296,85,30508,22264,8244,36663487.0,26608607.0,10054879.0,119.54,121.72,119.51,121.97
2023-10-11 17:45,1821,1562,259,139054,119248,19806,167239588.0,143101192.0,24138396.0,1771,1530,241,136909,117849,19060,164520453.0,141290172.0,23230281.0,120.0,121.87,119.89,121.88
2023-10-11 17:50,1229,1054,175,90757,79808,10949,109118344.0,95799003.0,13319341.0,1198,1036,162,90477,79258,11219,108792894.0,95121392.0,13671502.0,120.04,121.65,120.01,121.86
2023-10-11 17:55,371,306,65,22786,18433,4353,27486663.0,22183514.0,5303148.0,361,303,58,24821,20516,4305,29789443.0,24534962.0,5254480.0,120.35,121.83,119.59,122.06
2023-10-11 18:00,302,149,153,15792,9055,6737,19000361.0,10847100.0,8153261.0,290,146,144,14925,9129,5796,17946797.0,10932394.0,7014403.0,119.79,121.02,119.75,121.02
2023-10-11 18:05,598,278,320,30777,16558,14219,36956592.0,19811854.0,17144737.0,581,268,313,30301,16701,13600,36415649.0,19980137.0,16435512.0,119.65,120.58,119.63,120.85
2023-10-11 18:10,821,364,457,56380,23132,33248,67391564.0,27519211.0,39872352.0,794,356,438,55853,23097,32756,67003503.0,27470289.0,39533214.0,118.97,119.92,118.93,120.69
2023-10-11 18:15,1734,814,920,91740,37978,53762,109971215.0,45218166.0,64753049.0,1711,800,911,89520,35870,53650,107356021.0,42730575.0,64625445.0,119.06,120.44,119.13,120.46
2023-10-11 18:20,1541,1300,241,71969,52737,19232,86333696.0,63116718.0,23216977.0,1529,1290,239,72954,52815,20139,87528398.0,63208348.0,24320049.0,119.68,120.72,119.68,120.76
2023-10-11 18:25,819,407,412,35922,14162,21760,42985584.0,16930867.0,26054717.0,774,378,396,33425,12209,21216,40114215.0,14619681.0,25494533.0,119.55,119.74,119.75,120.17
2023-10-11 18:30,148,31,117,9333,1499,7834,11013625.0,1767433.0,9246192.0,125,17,108,9147,2146,7001,10947799.0,2537801.0,8409998.0,117.91,118.03,118.26,120.13
2023-10-11 18:35,548,67,481,35167,627,34540,42171280.0,748244.0,41423035.0,536,63,473,37312,2374,34938,44693880.0,2779657.0,41914223.0,119.34,119.93,117.09,119.97
2023-10-12 10:00,4322,2109,2213,171419,83938,87481,200294362.0,97554610.0,102739751.0,2781,1417,1364,134144,62417,71727,157043667.0,72588019.0,84455648.0,116.22,117.44,116.3,117.75
2023-10-12 10:05,1485,593,892,59299,22321,36978,70530549.0,26620922.0,43909627.0,1144,398,746,52498,24290,28208,61821660.0,28391535.0,33430125.0,119.26,118.75,116.89,118.51
2023-10-12 10:10,814,550,264,45191,28473,16718,54063575.0,33780233.0,20283342.0,564,400,164,29483,20746,8737,34906535.0,24508625.0,10397909.0,118.64,121.33,118.14,119.01
2023-10-12 10:15,584,179,405,43644,15254,28390,52079241.0,17893902.0,34185339.0,493,141,352,35780,12681,23099,42586935.0,14840624.0,27746311.0,117.31,120.41,117.03,120.12
2023-10-12 10:20,879,376,503,50911,20351,30560,60380155.0,23832672.0,36547482.0,521,195,326,45048,18116,26932,53580999.0,21194060.0,32386938.0,117.11,119.59,116.99,120.25
2023-10-12 10:25,534,342,192,37429,24215,13214,44429189.0,28527721.0,15901468.0,479,316,163,36401,23918,12483,43099766.0,28110936.0,14988830.0,117.81,120.34,117.53,120.07
2023-10-12 10:30,675,530,145,52812,42019,10793,62508967.0,49616123.0,12892843.0,632,506,126,51659,41244,10415,61219242.0,48692566.0,12526675.0,118.08,119.46,118.06,120.28
2023-10-12 10:35,869,272,597,57497,19649,37848,67842359.0,23076125.0,44766234.0,776,215,561,57839,19591,38248,68507804.0,22934508.0,45573296.0,117.44,118.28,117.07,119.15
2023-10-12 10:40,312,81,231,20662,4473,16189,24586346.0,5226883.0,19359463.0,268,50,218,21669,4382,17287,25783878.0,5111959.0,20671919.0,116.85,119.58,116.66,119.58
2023-10-12 10:45,180,79,101,11188,3558,7630,13276013.0,4182876.0,9093136.0,134,49,85,10079,2578,7501,11949456.0,3011594.0,8937862.0,117.56,119.18,116.82,119.16
2023-10-12 10:50,1963,467,1496,144017,29883,114134,169797405.0,34807411.0,134989993.0,1762,320,1442,139074,27280,111794,164200201.0,31771445.0,132428755.0,116.48,118.27,116.46,118.46
2023-10-12 10:55,507,118,389,39961,6973,32988,47254664.0,8120822.0,39133841.0,447,77,370,38657,6146,32511,45721817.0,7155693.0,38566124.0,116.46,118.63,116.43,118.62
2023-10-12 11:00,1115,282,833,87223,19197,68026,102862466.0,22347016.0,80515449.0,1003,216,787,84347,18055,66292,99485622.0,20946896.0,78538726.0,116.41,118.36,116.02,118.47
2023-10-12 11:05,522,218,304,44477,17916,26561,52670354.0,21089207.0,31581147.0,439,170,269,41893,16381,25512,49392551.0,19067040.0,30325511.0,117.71,118.9,116.4,118.87
2023-10-12 11:10,1230,530,700,81464,28102,53362,96397650.0,32877004.0,63520645.0,1153,480,673,80240,27282,52958,94950202.0,31906376.0,63043826.0,116.99,119.04,116.95,119.04
2023-10-12 11:15,688,567,121,36939,24257,12682,43699753.0,28476327.0,15223425.0,647,538,109,32327,21217,11110,38187915.0,24894186.0,13293728.0,117.39,120.04,117.33,119.66
2023-10-12 11:20,764,505,259,53075,30144,22931,62599717.0,35313492.0,27286225.0,691,463,228,50865,28790,22075,60003971.0,33722197.0,26281773.0,117.15,118.99,117.13,119.06
2023-10-12 11:25,1601,533,1068,124113,52005,72108,146943889.0,61156451.0,85787438.0,1403,418,985,119060,49836,69224,141025217.0,58563977.0,82461239.0,117.6,118.97,117.51,119.12
2023-10-12 11:30,716,188,528,46464,13538,32926,54906652.0,15819872.0,39086779.0,631,132,499,44595,12352,32243,52782804.0,14419262.0,38363542.0,116.86,118.71,116.74,118.98
2023-10-12 11:35,477,254,223,26736,10762,15974,31667186.0,12655297.0,19011888.0,460,244,216,27637,11334,16303,32731360.0,13310648.0,19420712.0,117.59,119.02,117.44,119.12
2023-10-12 11:40,531,369,162,27665,15994,11671,32708413.0,18789681.0,13918732.0,510,357,153,26814,15313,11501,31721895.0,17994981.0,13726914.0,117.48,119.26,117.51,119.35
2023-10-12 11:45,1724,1090,634,91937,48164,43773,108760977.0,56661552.0,52099424.0,1664,1050,614,90422,47207,43215,106965440.0,55528959.0,51436480.0,117.64,119.02,117.63,119.02
2023-10-12 11:50,1023,486,537,69719,25790,43929,82525642.0,30257154.0,52268488.0,997,476,521,67095,24834,42261,79410614.0,29122426.0,50288188.0,117.32,118.98,117.27,118.99
2023-10-12 11:55,1049,134,915,74463,14536,59927,88161476.0,16960272.0,71201203.0,1031,128,903,75630,15780,59850,89535531.0,18426083.0,71109447.0,116.68,118.81,116.77,118.81
2023-10-12 12:00,985,212,773,69379,18812,50567,82082105.0,21911930.0,60170175.0,974,207,767,71933,21385,50548,85048427.0,24895980.0,60152447.0,116.48,118.99,116.42,119.0
2023-10-12 12:05,744,605,139,54829,39800,15029,65008293.0,46933249.0,18075044.0,707,581,126,50828,38157,12671,60183038.0,44994489.0,15188548.0,117.92,120.27,117.92,119.87
2023-10-12 12:10,214,147,67,16256,10190,6066,19286629.0,12013860.0,7272768.0,194,136,58,16266,9792,6474,19288623.0,11514366.0,7774257.0,117.9,119.89,117.59,120.08
2023-10-12 12:15,432,327,105,35261,26329,8932,41773508.0,31082904.0,10690604.0,406,314,92,33980,26003,7977,40256891.0,30688434.0,9568457.0,118.06,119.69,118.02,119.95
2023-10-12 12:20,613,145,468,43919,16657,27262,51961507.0,19505107.0,32456400.0,583,126,457,43957,17000,26957,52088697.0,19908082.0,32180614.0,117.1,119.05,117.11,119.38
2023-10-12 12:25,183,53,130,13474,6310,7164,15992316.0,7417608.0,8574708.0,161,42,119,11722,5153,6569,13894888.0,6042151.0,7852737.0,117.55,119.69,117.26,119.54
2023-10-12 12:30,140,63,77,11321,4899,6422,13407932.0,5745585.0,7662346.0,127,58,69,11520,5180,6340,13676248.0,6071986.0,7604261.0,117.28,119.31,117.22,119.94
2023-10-12 12:35,144,56,88,12965,4974,7991,15334517.0,5809796.0,9524720.0,134,49,85,14859,5053,9806,17695753.0,5902184.0,11793569.0,116.8,119.19,116.81,120.27
2023-10-12 12:40,61,38,23,4254,2959,1295,5010477.0,3458841.0,1551636.0,49,29,20,2746,1291,1455,3253335.0,1512016.0,1741319.0,116.89,119.82,117.12,119.68
2023-10-12 12:45,61,22,39,6217,2484,3733,7365246.0,2897975.0,4467270.0,71,29,42,6817,2884,3933,8071557.0,3343846.0,4727711.0,116.67,119.67,115.94,120.21
2023-10-12 12:50,283,54,229,24508,7311,17197,29031085.0,8533363.0,20497721.0,271,50,221,24616,7511,17105,29157417.0,8767182.0,20390235.0,116.72,119.19,116.72,119.21
2023-10-12 12:55,1060,191,869,78132,23401,54731,92650375.0,27508903.0,65141472.0,1027,173,854,75823,22557,53266,89846744.0,26378590.0,63468154.0,117.55,119.02,116.94,119.15
2023-10-12 13:00,410,109,301,31662,10478,21184,37461760.0,12238214.0,25223546.0,399,103,296,31392,10344,21048,37139575.0,12078945.0,25060630.0,116.8,119.07,116.77,119.06
2023-10-12 13:05,634,103,531,47763,9085,38678,56286917.0,10604822.0,45682094.0,594,89,505,46067,8915,37152,54418428.0,10392156.0,44026272.0,116.73,118.11,116.57,118.5
2023-10-12 13:10,1582,168,1414,133230,22215,111015,156810847.0,25775784.0,131035062.0,1495,108,1387,125719,18775,106944,148197554.0,21788383.0,126409170.0,116.03,118.03,116.05,118.2
2023-10-12 13:15,2747,390,2357,240040,46176,193864,282466022.0,53480844.0,228985178.0,2666,338,2328,236624,43741,192883,278551432.0,50713085.0,227838347.0,115.82,118.12,115.94,118.12
2023-10-12 13:20,855,202,653,65698,15173,50525,77379237.0,17615522.0,59763715.0,825,181,644,65239,15240,49999,76804776.0,17681867.0,59122908.0,116.1,118.29,116.02,118.25
2023-10-12 13:25,141,60,81,10114,4798,5316,11809395.0,5566292.0,6243103.0,103,35,68,8744,3754,4990,10283034.0,4351323.0,5931710.0,116.01,117.44,115.91,118.87
2023-10-12 13:30,141,57,84,11565,5470,6095,13585741.0,6353582.0,7232158.0,115,48,67,14048,8077,5971,16386020.0,9286352.0,7099668.0,116.15,118.66,114.97,118.9
2023-10-12 13:35,277,99,178,22211,10379,11832,26102811.0,12023846.0,14078965.0,253,79,174,21774,10021,11753,25574240.0,11597555.0,13976685.0,115.85,118.99,115.73,118.92
2023-10-12 13:40,299,110,189,22546,9154,13392,26566513.0,10669444.0,15897069.0,249,81,168,21820,8805,13015,25648810.0,10197021.0,15451788.0,116.55,118.71,115.81,118.72
2023-10-12 13:45,508,222,286,37764,16190,21574,44468034.0,18832984.0,25635049.0,483,204,279,36614,15537,21077,43119534.0,18060301.0,25059232.0,116.32,118.82,116.24,118.89
2023-10-12 13:50,792,399,393,64366,32977,31389,75976269.0,38598917.0,37377351.0,721,361,360,62293,31915,30378,73486382.0,37236159.0,36250222.0,117.05,119.08,116.67,119.33
2023-10-12 13:55,361,261,100,26410,17467,8943,31115842.0,20429671.0,10686171.0,334,255,79,26064,17593,8471,30701711.0,20575387.0,10126323.0,116.96,119.49,116.95,119.54
2023-10-12 14:00,247,176,71,14160,9552,4608,16673945.0,11180557.0,5493387.0,240,167,73,14746,9520,5226,17374656.0,11134739.0,6239917.0,117.05,119.21,116.96,119.4
2023-10-12 14:05,600,400,200,43494,26539,16955,51376482.0,31067074.0,20309408.0,535,372,163,41050,25205,15845,48478772.0,29500030.0,18978742.0,117.06,119.78,117.04,119.78
2023-10-12 14:10,182,118,64,11564,7694,3870,13666316.0,9036469.0,4629846.0,172,116,56,11351,7548,3803,13404632.0,8856764.0,4547868.0,117.45,119.63,117.34,119.59
2023-10-12 14:15,235,136,99,18085,9750,8335,21307912.0,11379570.0,9928342.0,218,132,86,17668,9724,7944,20843711.0,11351645.0,9492065.0,116.71,119.12,116.74,119.49
2023-10-12 14:20,226,148,78,15159,9157,6002,17883399.0,10716544.0,7166855.0,211,138,73,15081,9070,6011,17783599.0,10608862.0,7174737.0,117.03,119.41,116.97,119.36
2023-10-12 14:25,115,64,51,10582,5386,5196,12574718.0,6282350.0,6292367.0,111,65,46,10801,5741,5060,12830865.0,6697668.0,6133196.0,116.64,121.1,116.66,121.21
2023-10-12 14:30,64,28,36,3228,1446,1782,3826958.0,1701414.0,2125544.0,66,27,39,3118,1322,1796,3683206.0,1540846.0,2142360.0,117.66,119.28,116.55,119.29
2023-10-12 14:35,256,128,128,10244,5073,5171,12263340.0,5964174.0,6299166.0,252,127,125,9852,4725,5127,11802601.0,5557841.0,6244760.0,117.57,121.82,117.63,121.8
2023-10-12 14:40,113,83,30,6933,4538,2395,8199771.0,5329568.0,2870203.0,110,79,31,6968,4463,2505,8225755.0,5226407.0,2999348.0,117.44,119.84,117.11,119.73
2023-10-12 14:45,109,62,47,7790,4477,3313,9280133.0,5296830.0,3983303.0,92,55,37,6844,3954,2890,8098649.0,4631520.0,3467129.0,118.31,120.23,117.14,119.97
2023-10-12 14:50,292,225,67,19494,15602,3892,23028171.0,18393478.0,4634693.0,247,207,40,17535,13707,3828,20738113.0,16144653.0,4593460.0,117.89,119.08,117.78,120.0
2023-10-12 14:55,517,360,157,40096,25913,14183,47819078.0,30746863.0,17072215.0,461,337,124,37556,24427,13129,44605775.0,28781331.0,15824443.0,118.65,120.37,117.83,120.53
2023-10-12 15:00,396,225,171,34150,19271,14879,40569446.0,22660978.0,17908468.0,356,205,151,33490,18850,14640,39805818.0,22180747.0,17625071.0,117.59,120.36,117.67,120.39
2023-10-12 15:05,257,210,47,15524,11245,4279,18427995.0,13275304.0,5152690.0,237,199,38,15457,11438,4019,18337848.0,13496899.0,4840949.0,118.06,120.42,118.0,120.45
2023-10-12 15:10,1046,410,636,73640,30276,43364,86755363.0,35368708.0,51386654.0,949,345,604,69551,27816,41735,82322253.0,32536618.0,49785635.0,116.82,118.5,116.97,119.29
2023-10-12 15:15,615,135,480,45051,14419,30632,53244737.0,16788940.0,36455797.0,602,134,468,45575,15137,30438,53854216.0,17630983.0,36223233.0,116.44,119.01,116.48,119.01
2023-10-12 15:20,980,202,778,65967,15704,50263,77744192.0,18254840.0,59489352.0,939,182,757,64298,15048,49250,75876343.0,17485374.0,58390969.0,116.24,118.36,116.2,118.56
2023-10-12 15:25,814,231,583,67626,21558,46068,79699924.0,25072004.0,54627920.0,768,192,576,68031,21300,46731,80276816.0,24758349.0,55518466.0,116.3,118.58,116.24,118.8
2023-10-12 15:30,513,136,377,26869,7445,19424,31769259.0,8702304.0,23066955.0,487,117,370,26424,7137,19287,31216008.0,8317116.0,22898891.0,116.89,118.75,116.54,118.73
2023-10-12 15:35,380,141,239,26313,9999,16314,31161928.0,11674636.0,19487291.0,366,127,239,25324,9872,15452,29910119.0,11504627.0,18405492.0,116.76,119.45,116.54,119.11
2023-10-12 15:40,347,117,230,23343,8597,14746,27658028.0,10069366.0,17588662.0,321,100,221,22792,7750,15042,26995501.0,9044126.0,17951374.0,117.13,119.28,116.7,119.34
2023-10-12 15:45,479,299,180,36612,23678,12934,42746521.0,27249864.0,15496656.0,469,297,172,34258,21672,12586,40458965.0,25377575.0,15081390.0,115.09,119.81,117.1,119.83
2023-10-12 15:50,337,254,83,23981,15586,8395,28380111.0,18307450.0,10072661.0,333,255,78,23855,15484,8371,28230532.0,18186425.0,10044107.0,117.46,119.98,117.45,119.99
2023-10-12 15:55,461,308,153,39424,23167,16257,46677116.0,27170490.0,19506626.0,459,309,150,39916,23476,16440,47257792.0,27531357.0,19726435.0,117.28,119.99,117.27,119.99
2023-10-12 16:00,364,233,131,32653,18466,14187,38641434.0,21635062.0,17006372.0,359,234,125,32694,18626,14068,38704975.0,21823668.0,16881306.0,117.16,119.87,117.17,120.0
2023-10-12 16:05,280,67,213,19192,6252,12940,22685285.0,7290553.0,15394731.0,268,65,203,19804,6930,12874,23403252.0,8070501.0,15332750.0,116.61,118.97,116.46,119.1
2023-10-12 16:10,259,69,190,21247,7399,13848,25105500.0,8622685.0,16482815.0,247,56,191,21285,7083,14202,25146762.0,8246573.0,16900188.0,116.54,119.03,116.43,119.0
2023-10-12 16:15,278,158,120,19548,10226,9322,23098499.0,11957878.0,11140620.0,259,146,113,19411,10230,9181,22928212.0,11955537.0,10972674.0,116.94,119.51,116.87,119.52
2023-10-12 16:20,338,99,239,25715,10541,15174,30355864.0,12279328.0,18076535.0,329,95,234,25520,10373,15147,30153176.0,12080793.0,18072382.0,116.49,119.13,116.46,119.31
2023-10-12 16:25,151,59,92,9638,4196,5442,11400121.0,4916066.0,6484055.0,135,49,86,8832,3463,5369,10437619.0,4042874.0,6394745.0,117.16,119.15,116.74,119.1
2023-10-12 16:30,244,139,105,17459,8728,8731,20598292.0,10237263.0,10361028.0,216,120,96,16569,8519,8050,19625318.0,9987883.0,9637434.0,117.29,118.67,117.24,119.72
2023-10-12 16:35,334,252,82,19816,13925,5891,23461703.0,16403684.0,7058018.0,313,247,66,19425,13795,5630,22990860.0,16238214.0,6752645.0,117.8,119.81,117.71,119.94
2023-10-12 16:40,419,287,132,35519,22264,13255,42063489.0,26160769.0,15902720.0,395,269,126,35144,22018,13126,41595879.0,25844466.0,15751413.0,117.5,119.98,117.38,120.0
2023-10-12 16:45,397,235,162,32865,18263,14602,38995775.0,21480695.0,17515079.0,374,220,154,32818,18416,14402,38908240.0,21620707.0,17287533.0,117.62,119.95,117.4,120.04
2023-10-12 16:50,243,77,166,18521,8111,10410,21970390.0,9501084.0,12469306.0,241,80,161,18483,8105,10378,21956950.0,9485707.0,12471243.0,117.14,119.78,117.04,120.17
2023-10-12 16:55,136,40,96,11435,4457,6978,13579889.0,5218471.0,8361417.0,128,37,91,11372,4925,6447,13488873.0,5765365.0,7723508.0,117.08,119.83,117.06,119.8
2023-10-12 17:00,114,78,36,9339,5275,4064,11059878.0,6191839.0,4868038.0,111,75,36,10573,5877,4696,12443794.0,6807982.0,5635811.0,117.38,119.78,115.84,120.01
2023-10-12 17:05,108,40,68,9668,3825,5843,11479236.0,4483208.0,6996027.0,107,42,65,9490,3788,5702,11271622.0,4431532.0,6840090.0,117.21,119.73,116.99,119.96
2023-10-12 17:10,99,40,59,7451,3091,4360,8834480.0,3615586.0,5218893.0,92,36,56,7406,3034,4372,8779105.0,3546001.0,5233104.0,116.97,119.7,116.88,119.7
2023-10-12 17:15,487,138,349,33559,10555,23004,39675515.0,12331456.0,27344059.0,417,99,318,32327,10012,22315,38228321.0,11691321.0,26537000.0,116.83,118.87,116.77,118.92
2023-10-12 17:20,413,250,163,29791,15540,14251,35337413.0,18292125.0,17045288.0,398,237,161,29726,15222,14504,35160691.0,17809418.0,17351273.0,117.71,119.61,117.0,119.63
2023-10-12 17:25,410,262,148,28643,15964,12679,33902770.0,18718522.0,15184247.0,385,248,137,27834,15619,12215,32943208.0,18311715.0,14631493.0,117.25,119.76,117.24,119.78
2023-10-12 17:30,349,222,127,26734,14550,12184,31634053.0,17035055.0,14598998.0,342,224,118,26505,14500,12005,31355076.0,16971788.0,14383288.0,117.08,119.82,117.05,119.81
2023-10-12 17:35,60,26,34,3472,1362,2110,4108057.0,1595129.0,2512928.0,57,26,31,3306,1392,1914,3924257.0,1630419.0,2293838.0,117.12,119.1,117.13,119.85
2023-10-12 17:40,262,95,167,18147,6387,11760,21489389.0,7498302.0,13991087.0,217,65,152,17119,5732,11387,20234112.0,6681809.0,13552303.0,117.4,118.97,116.57,119.02
2023-10-12 17:45,511,131,380,32938,10441,22497,38939097.0,12187432.0,26751665.0,461,98,363,32256,9833,22423,38111813.0,11440915.0,26670897.0,116.73,118.91,116.35,118.94
2023-10-12 17:50,291,58,233,12749,3557,9192,15086772.0,4149490.0,10937281.0,278,46,232,12637,3524,9113,14947972.0,4108705.0,10839266.0,116.66,118.99,116.59,118.94
2023-10-12 17:55,182,110,72,9381,4832,4549,11114592.0,5679739.0,5434852.0,170,103,67,8725,4642,4083,10325970.0,5438338.0,4887632.0,117.54,119.47,117.16,119.71
2023-10-12 18:00,158,52,106,10173,3314,6859,12001315.0,3863769.0,8137546.0,139,43,96,9023,3014,6009,10658551.0,3509542.0,7149009.0,116.59,118.64,116.44,118.97
2023-10-12 18:05,188,45,143,11174,2573,8601,13190219.0,2995874.0,10194345.0,176,37,139,11160,2554,8606,13177039.0,2973092.0,10203947.0,116.44,118.53,116.41,118.57
2023-10-12 18:10,207,81,126,17577,7346,10231,20760466.0,8551947.0,12208518.0,198,74,124,17398,7273,10125,20546134.0,8465376.0,12080758.0,116.42,119.33,116.39,119.32
2023-10-12 18:15,130,39,91,9948,3631,6317,11747244.0,4233840.0,7513404.0,119,33,86,9675,3435,6240,11442738.0,4000276.0,7442462.0,116.6,118.94,116.46,119.27
2023-10-12 18:20,239,52,187,16433,4823,11610,19422231.0,5629617.0,13792614.0,222,40,182,15266,3932,11334,18071766.0,4580056.0,13491710.0,116.72,118.8,116.48,119.04
2023-10-12 18:25,253,57,196,17578,4628,12950,20672528.0,5393386.0,15279142.0,216,36,180,17289,4670,12619,20413289.0,5421859.0,14991430.0,116.54,117.99,116.1,118.8
2023-10-12 18:30,470,87,383,35065,10455,24610,41247497.0,12152670.0,29094827.0,440,59,381,31368,9892,21476,36982779.0,11492538.0,25490240.0,116.24,118.22,116.18,118.69
2023-10-12 18:35,609,131,478,41908,14344,27564,49431088.0,16696671.0,32734417.0,581,116,465,41289,14197,27092,48697922.0,16505271.0,32192651.0,116.4,118.76,116.26,118.83
2023-10-13 10:00,1852,562,1290,58645,17273,41372,69454340.0,19430049.0,50024291.0,808,173,635,43130,12112,31018,50680758.0,13961032.0,36719725.0,112.49,120.91,115.27,118.38
2023-10-13 10:05,522,103,419,21590,2679,18911,27956301.0,5393412.0,22562889.0,383,39,344,20380,2172,18208,26378850.0,4779221.0,21599629.0,201.32,119.31,220.04,118.63
2023-10-13 10:10,575,285,290,11472,5535,5937,13704718.0,6495369.0,7209349.0,273,144,129,8217,3864,4353,9750845.0,4562433.0,5188412.0,117.35,121.43,118.08,119.19
2023-10-13 10:15,428,204,224,32161,13378,18783,38853207.0,15977441.0,22875766.0,279,137,142,23222,11067,12155,27815802.0,13015259.0,14800543.0,119.43,121.79,117.6,121.77
2023-10-13 10:20,840,522,318,61180,32517,28663,73042475.0,38432111.0,34610364.0,585,357,228,56797,29038,27759,67761730.0,34214142.0,33547588.0,118.19,120.75,117.83,120.85
2023-10-13 10:25,680,446,234,46908,28947,17961,56013475.0,34250567.0,21762908.0,592,424,168,44859,28745,16114,53466783.0,33978261.0,19488521.0,118.32,121.17,118.21,120.94
2023-10-13 10:30,287,123,164,21175,9555,11620,25143036.0,11210473.0,13932562.0,217,84,133,18539,8395,10144,22043942.0,9839866.0,12204076.0,117.33,119.9,117.21,120.31
2023-10-13 10:35,195,86,109,15347,6911,8436,18240498.0,8115115.0,10125382.0,159,66,93,14256,6708,7548,16964327.0,7874197.0,9090129.0,117.42,120.03,117.39,120.43
2023-10-13 10:40,239,89,150,15989,6031,9958,19000421.0,7068121.0,11932299.0,188,55,133,15437,5721,9716,18367648.0,6695068.0,11672580.0,117.2,119.83,117.03,120.14
2023-10-13 10:45,176,53,123,9444,2843,6601,11358544.0,3336396.0,8022147.0,150,41,109,8650,2737,5913,10272747.0,3203682.0,7069065.0,117.35,121.53,117.05,119.55
2023-10-13 10:50,165,52,113,8461,2963,5498,10066745.0,3475142.0,6591603.0,130,30,100,8588,2735,5853,10215071.0,3204323.0,7010748.0,117.28,119.89,117.16,119.78
2023-10-13 10:55,283,97,186,22885,9011,13874,27151118.0,10544711.0,16606407.0,243,79,164,21940,9603,12337,26016488.0,11221492.0,14794996.0,117.02,119.69,116.85,119.92
2023-10-13 11:00,100,31,69,6726,3468,3258,7973765.0,4067053.0,3906712.0,84,21,63,4836,1712,3124,5740221.0,2006531.0,3733689.0,117.27,119.91,117.2,119.52
2023-10-13 11:05,139,49,90,8632,3616,5016,10270622.0,4253668.0,6016954.0,120,38,82,8789,3816,4973,10420722.0,4457182.0,5963539.0,117.63,119.96,116.8,119.92
2023-10-13 11:10,182,81,101,15054,7342,7712,17892365.0,8656863.0,9235502.0,162,70,92,14642,7116,7526,17385179.0,8344720.0,9040459.0,117.91,119.75,117.27,120.12
2023-10-13 11:15,189,110,79,14407,7666,6741,17111382.0,9008300.0,8103082.0,176,105,71,14076,7489,6587,16717277.0,8796937.0,7920340.0,117.51,120.21,117.46,120.24
2023-10-13 11:20,506,327,179,42578,22722,19856,51275694.0,27136093.0,24139601.0,333,199,134,36154,19489,16665,43106696.0,22958036.0,20148660.0,119.43,121.57,117.8,120.9
2023-10-13 11:25,720,416,304,57763,31371,26392,69272236.0,37288385.0,31983850.0,478,271,207,52134,28221,23913,62337154.0,33288207.0,29048946.0,118.86,121.19,117.96,121.48
2023-10-13 11:30,351,171,180,24467,11548,12919,29257306.0,13649871.0,15607434.0,262,112,150,22596,10454,12142,27020093.0,12331134.0,14688959.0,118.2,120.81,117.96,120.98
2023-10-13 11:35,281,176,105,20234,11881,8353,24378740.0,14239047.0,10139693.0,214,138,76,18573,10673,7900,22261636.0,12658028.0,9603608.0,119.85,121.39,118.6,121.56
2023-10-13 11:40,529,290,239,33184,17911,15273,40056754.0,21529904.0,18526850.0,362,240,122,29113,15891,13222,34986244.0,18889113.0,16097131.0,120.2,121.3,118.87,121.75
2023-10-13 11:45,587,311,276,52991,25443,27548,64039091.0,30551602.0,33487488.0,450,255,195,46071,23364,22707,55418875.0,27758053.0,27660822.0,120.08,121.56,118.81,121.82
2023-10-13 11:50,419,158,261,34456,15074,19382,41280888.0,17991237.0,23289650.0,319,125,194,31020,13893,17127,37253580.0,16452803.0,20800777.0,119.35,120.16,118.43,121.45
2023-10-13 11:55,512,236,276,41158,19841,21317,49600577.0,23674829.0,25925748.0,437,205,232,39391,18904,20487,47363219.0,22461626.0,24901593.0,119.32,121.62,118.82,121.55
2023-10-13 12:00,283,115,168,21067,8601,12466,25363434.0,10191759.0,15171675.0,221,82,139,18414,8157,10257,22167973.0,9667385.0,12500588.0,118.5,121.7,118.52,121.87
2023-10-13 12:05,218,66,152,16639,6436,10203,19944924.0,7610190.0,12334734.0,191,53,138,16021,6244,9777,19218424.0,7383105.0,11835319.0,118.24,120.89,118.24,121.05
2023-10-13 12:10,407,122,285,33036,12980,20056,39791753.0,15371306.0,24420447.0,365,105,260,30689,12180,18509,36885036.0,14412464.0,22472572.0,118.42,121.76,118.33,121.41
2023-10-13 12:15,356,166,190,22617,9963,12654,27133710.0,11822954.0,15310755.0,329,152,177,22724,10404,12320,27242174.0,12325779.0,14916395.0,118.67,121.0,118.47,121.07
2023-10-13 12:20,497,164,333,44010,16281,27729,52732822.0,19268344.0,33464478.0,478,153,325,43733,16284,27449,52429110.0,19258743.0,33170366.0,118.35,120.68,118.27,120.84
2023-10-13 12:25,285,80,205,20246,6301,13945,24250423.0,7460734.0,16789688.0,259,61,198,21754,5990,15764,26087080.0,7086356.0,19000724.0,118.41,120.4,118.3,120.53
2023-10-13 12:30,307,95,212,25234,7890,17344,30225058.0,9326877.0,20898180.0,275,82,193,23355,7704,15651,28045251.0,9105500.0,18939750.0,118.21,120.49,118.19,121.01
2023-10-13 12:35,122,47,75,6856,1520,5336,8274140.0,1815742.0,6458397.0,90,26,64,6670,1010,5660,7992591.0,1194643.0,6797947.0,119.46,121.03,118.28,120.11
2023-10-13 12:40,162,58,104,12838,4205,8633,15371326.0,4971677.0,10399648.0,133,36,97,11975,3743,8232,14346876.0,4415444.0,9931431.0,118.23,120.46,117.97,120.64
2023-10-13 12:45,209,62,147,18746,5852,12894,22215577.0,6910676.0,15304901.0,167,53,114,15124,5833,9291,18049469.0,6863583.0,11185886.0,118.09,118.7,117.67,120.39
2023-10-13 12:50,548,98,450,35921,7669,28252,42898111.0,9021537.0,33876574.0,522,79,443,37860,9817,28043,45185346.0,11566585.0,33618761.0,117.64,119.91,117.82,119.88
2023-10-13 12:55,373,79,294,23230,5422,17808,27723223.0,6390764.0,21332459.0,353,70,283,21614,4319,17295,25799922.0,5080037.0,20719885.0,117.87,119.79,117.62,119.8
2023-10-13 13:00,223,95,128,15182,6589,8593,18099453.0,7765029.0,10334424.0,191,75,116,14804,6449,8355,17658368.0,7596140.0,10062228.0,117.85,120.27,117.79,120.43
2023-10-13 13:05,710,261,449,50201,19995,30206,59617960.0,23527683.0,36090276.0,628,206,422,46687,17984,28703,55656746.0,21152240.0,34504505.0,117.67,119.48,117.62,120.21
2023-10-13 13:10,186,98,88,11261,4588,6673,13430931.0,5409018.0,8021912.0,163,77,86,11750,5100,6650,14003522.0,5994050.0,8009471.0,117.89,120.21,117.53,120.44
2023-10-13 13:15,109,33,76,8983,2437,6546,10693354.0,2864852.0,7828502.0,96,21,75,8703,2043,6660,10393659.0,2396386.0,7997273.0,117.56,119.59,117.3,120.08
2023-10-13 13:20,96,29,67,6808,2194,4614,8088369.0,2575402.0,5512967.0,83,21,62,6944,2200,4744,8280218.0,2582317.0,5697900.0,117.38,119.48,117.38,120.11
2023-10-13 13:25,61,30,31,5015,898,4117,6124213.0,1060033.0,5064179.0,40,12,28,2163,615,1548,2580127.0,720655.0,1859471.0,118.04,123.01,117.18,120.12
2023-10-13 13:30,77,33,44,3069,998,2071,3631173.0,1154109.0,2477064.0,48,11,37,2313,457,1856,2762526.0,539447.0,2223079.0,115.64,119.61,118.04,119.78
2023-10-13 13:35,45,21,24,1175,402,773,1390174.0,474915.0,915258.0,34,16,18,1079,352,727,1284746.0,411551.0,873195.0,118.14,118.4,116.92,120.11
2023-10-13 13:40,55,30,25,1704,604,1100,2032175.0,714407.0,1317768.0,34,14,20,1425,379,1046,1700578.0,446159.0,1254418.0,118.28,119.8,117.72,119.93
2023-10-13 13:45,85,34,51,4726,1897,2829,5629385.0,2245365.0,3384020.0,65,16,49,3623,817,2806,4325803.0,961359.0,3364443.0,118.36,119.62,117.67,119.9
2023-10-13 13:50,85,37,48,4220,1492,2728,5068836.0,1783333.0,3285503.0,64,26,38,4286,1652,2634,5088448.0,1923113.0,3165335.0,119.53,120.44,116.41,120.17
2023-10-13 13:55,219,56,163,14374,3758,10616,17142671.0,4426217.0,12716453.0,198,41,157,13957,3529,10428,16639275.0,4147344.0,12491931.0,117.78,119.79,117.52,119.79
2023-10-13 14:00,368,103,265,24156,7087,17069,28796613.0,8418528.0,20378084.0,331,76,255,23165,5750,17415,27642961.0,6771787.0,20871174.0,118.79,119.39,117.77,119.85
2023-10-13 14:05,497,339,158,41885,24693,17192,50230381.0,29239013.0,20991368.0,468,326,142,39234,24417,14817,46854335.0,28907196.0,17947139.0,118.41,122.1,118.39,121.13
2023-10-13 14:10,296,198,98,21539,14057,7482,25726881.0,16675225.0,9051655.0,280,189,91,21384,13982,7402,25538399.0,16581257.0,8957142.0,118.63,120.98,118.59,121.01
2023-10-13 14:15,246,182,64,15541,10727,4814,18562711.0,12743770.0,5818941.0,225,167,58,15398,10620,4778,18388023.0,12604814.0,5783208.0,118.8,120.88,118.69,121.04
2023-10-13 14:20,308,228,80,18652,12982,5670,22267099.0,15412655.0,6854443.0,284,212,72,18189,12586,5603,21729023.0,14949074.0,6779949.0,118.72,120.89,118.78,121.01
2023-10-13 14:25,271,196,75,18388,11700,6688,21988409.0,13881301.0,8107108.0,242,179,63,18238,11552,6686,21831499.0,13702484.0,8129015.0,118.64,121.22,118.62,121.58
2023-10-13 14:30,84,46,38,6157,3370,2787,7368275.0,3988160.0,3380114.0,59,33,26,5343,2962,2381,6392620.0,3504121.0,2888498.0,118.34,121.28,118.3,121.31
2023-10-13 14:35,121,79,42,9208,6633,2575,10988416.0,7870908.0,3117507.0,101,70,31,10710,5424,5286,12952504.0,6441243.0,6511261.0,118.66,121.07,118.75,123.18
2023-10-13 14:40,229,164,65,17183,11132,6051,20560653.0,13240201.0,7320452.0,207,154,53,17529,11482,6047,21037664.0,13655554.0,7382109.0,118.94,120.98,118.93,122.08
2023-10-13 14:45,279,193,86,19100,12319,6781,22844989.0,14637571.0,8207418.0,253,173,80,18923,12923,6000,22590099.0,15336465.0,7253633.0,118.82,121.04,118.68,120.89
2023-10-13 14:50,340,226,114,25747,15981,9766,30756392.0,18942884.0,11813508.0,319,215,104,25398,15804,9594,30339234.0,18729620.0,11609614.0,118.53,120.97,118.51,121.01
2023-10-13 14:55,224,102,122,15078,7184,7894,18012643.0,8491729.0,9520913.0,213,94,119,15870,8013,7857,18943519.0,9467430.0,9476089.0,118.2,120.61,118.15,120.61
2023-10-13 15:00,239,68,171,20293,7889,12404,24229949.0,9281722.0,14948226.0,214,59,155,19803,7798,12005,23653695.0,9178737.0,14474958.0,117.65,120.51,117.71,120.57
2023-10-13 15:05,178,62,116,13928,5614,8314,16619607.0,6610600.0,10009007.0,156,45,111,13545,5497,8048,16171902.0,6470077.0,9701825.0,117.75,120.39,117.7,120.55
2023-10-13 15:10,243,112,131,20322,9689,10633,24219053.0,11427391.0,12791662.0,223,101,122,19177,8889,10288,22872723.0,10470035.0,12402688.0,117.94,120.3,117.79,120.55
2023-10-13 15:15,302,158,144,24969,12866,12103,29777308.0,15268344.0,14508964.0,292,157,135,23762,12693,11069,28364711.0,14987262.0,13377448.0,118.67,119.88,118.08,120.86
2023-10-13 15:20,311,204,107,20225,12649,7576,24218609.0,15015575.0,9203033.0,288,192,96,19878,12522,7356,23749428.0,14847635.0,8901793.0,118.71,121.48,118.57,121.01
2023-10-13 15:25,231,161,70,16888,10848,6040,20126096.0,12874005.0,7252091.0,202,145,57,17937,10433,7504,21569410.0,12362236.0,9207174.0,118.68,120.07,118.49,122.7
2023-10-13 15:30,141,57,84,11289,4717,6572,13540794.0,5630332.0,7910462.0,123,45,78,10747,4374,6373,12824321.0,5147507.0,7676814.0,119.36,120.37,117.68,120.46
2023-10-13 15:35,70,33,37,4386,2080,2306,5262623.0,2472496.0,2790127.0,53,23,30,4133,1939,2194,4940320.0,2282076.0,2658244.0,118.87,120.99,117.69,121.16
2023-10-13 15:40,76,39,37,5257,2622,2635,6269573.0,3089532.0,3180041.0,70,34,36,5582,2580,3002,6767066.0,3038242.0,3728824.0,117.83,120.68,117.76,124.21
2023-10-13 15:45,76,47,29,4085,2187,1898,4873214.0,2588280.0,2284934.0,67,38,29,4116,2265,1851,4907241.0,2672897.0,2234344.0,118.35,120.39,118.01,120.71
2023-10-13 15:50,75,43,32,5439,2961,2478,6482671.0,3493707.0,2988963.0,63,33,30,5361,2852,2509,6391095.0,3362753.0,3028342.0,117.99,120.62,117.91,120.7
2023-10-13 15:55,107,92,15,4941,4107,834,5891307.0,4888052.0,1003255.0,91,80,11,4507,3943,564,5370908.0,4690153.0,680754.0,119.02,120.29,118.95,120.7
2023-10-13 16:00,79,58,21,3839,3185,654,4567656.0,3780455.0,787200.0,71,50,21,3004,2323,681,3578407.0,2758857.0,819549.0,118.7,120.37,118.76,120.35
2023-10-13 16:05,65,27,38,2101,1082,1019,2525910.0,1304729.0,1221181.0,40,11,29,1493,536,957,1785218.0,634706.0,1150512.0,120.59,119.84,118.42,120.22
2023-10-13 16:10,133,41,92,9126,4178,4948,10891385.0,4918070.0,5973314.0,120,36,84,9478,4428,5050,11307872.0,5209922.0,6097950.0,117.71,120.72,117.66,120.75
2023-10-13 16:15,258,106,152,20704,9978,10726,24731458.0,11763265.0,12968192.0,233,92,141,19852,9635,10217,23719032.0,11360644.0,12358388.0,117.89,120.9,117.91,120.96
2023-10-13 16:20,251,65,186,20048,7904,12144,23914178.0,9311794.0,14602383.0,242,59,183,19600,8115,11485,23395813.0,9553263.0,13842550.0,117.81,120.24,117.72,120.53
2023-10-13 16:25,213,111,102,16404,8706,7698,19580049.0,10301181.0,9278868.0,197,99,98,15554,7983,7571,18536254.0,9404204.0,9132050.0,118.32,120.54,117.8,120.62
2023-10-13 16:30,387,211,176,24767,13390,11377,29536019.0,15844668.0,13691351.0,359,195,164,24785,13762,11023,29566153.0,16272236.0,13293916.0,118.33,120.34,118.24,120.6
2023-10-13 16:35,335,123,212,24366,9460,14906,29080940.0,11145164.0,17935776.0,300,99,201,23746,9055,14691,28350737.0,10654188.0,17696549.0,117.81,120.33,117.66,120.46
2023-10-13 16:40,166,52,114,15921,6565,9356,18976362.0,7709104.0,11267258.0,153,48,105,15842,6502,9340,18895332.0,7639138.0,11256194.0,117.43,120.43,117.49,120.52
2023-10-13 16:45,134,68,66,9306,4217,5089,11370834.0,4993193.0,6377640.0,113,57,56,8694,3871,4823,10460804.0,4571195.0,5889608.0,118.41,125.32,118.09,122.12
2023-10-13 16:50,101,64,37,6474,3851,2623,7770552.0,4598783.0,3171768.0,86,52,34,6289,3567,2722,7506172.0,4213526.0,3292646.0,119.42,120.92,118.13,120.96
2023-10-13 16:55,138,44,94,12056,4710,7346,14296714.0,5543860.0,8752853.0,128,40,88,12578,5676,6902,14967045.0,6647404.0,8319640.0,117.7,119.15,117.11,120.54
2023-10-13 17:00,364,251,113,31727,19169,12558,37949031.0,22749616.0,15199415.0,338,238,100,30585,18774,11811,36509793.0,22206815.0,14302978.0,118.68,121.03,118.28,121.1
2023-10-13 17:05,225,151,74,18207,11678,6529,21745982.0,13845936.0,7900046.0,218,148,70,17950,11663,6287,21434654.0,13824053.0,7610601.0,118.56,121.0,118.53,121.05
2023-10-13 17:10,56,35,21,3768,2627,1141,4524549.0,3121041.0,1403508.0,54,36,18,3427,2031,1396,4082112.0,2398203.0,1683909.0,118.81,123.01,118.08,120.62
2023-10-13 17:15,45,25,20,1423,811,612,1719775.0,989605.0,730170.0,31,16,15,1413,707,706,1701109.0,842245.0,858864.0,122.02,119.31,119.13,121.65
2023-10-13 17:20,63,40,23,4768,3087,1681,5745983.0,3724111.0,2021871.0,44,24,20,3255,1563,1692,3893668.0,1848928.0,2044740.0,120.64,120.28,118.29,120.85
2023-10-13 17:25,52,28,24,2183,983,1200,2593368.0,1170786.0,1422582.0,25,13,12,1665,853,812,1992093.0,1008804.0,983288.0,119.1,118.55,118.27,121.09
2023-10-13 17:30,44,27,17,3140,1782,1358,3761178.0,2118610.0,1642568.0,31,15,16,2804,1456,1348,3356478.0,1718741.0,1637737.0,118.89,120.95,118.05,121.49
2023-10-13 17:35,17,8,9,351,174,177,408357.0,207730.0,200626.0,8,3,5,168,3,165,201214.0,3533.0,197680.0,119.39,113.35,117.78,119.81
2023-10-13 17:40,55,26,29,8817,2267,6550,10648967.0,2682470.0,7966496.0,48,26,22,6525,2058,4467,7857779.0,2428353.0,5429426.0,118.33,121.63,118.0,121.55
2023-10-13 17:45,28,19,9,1983,1052,931,2381377.0,1253230.0,1128146.0,22,14,8,1896,1052,844,2261451.0,1237449.0,1024002.0,119.13,121.18,117.63,121.33
2023-10-13 17:50,44,15,29,3277,1456,1821,3921372.0,1719665.0,2201706.0,29,12,17,2724,1293,1431,3259066.0,1525313.0,1733752.0,118.11,120.91,117.97,121.16
2023-10-13 17:55,49,28,21,4114,2430,1684,4920910.0,2877560.0,2043350.0,34,17,17,4506,2783,1723,5364552.0,3274720.0,2089831.0,118.42,121.34,117.67,121.29
2023-10-13 18:00,93,58,35,6657,3705,2952,8015825.0,4453902.0,3561923.0,68,42,26,5640,2933,2707,6747029.0,3467411.0,3279617.0,120.21,120.66,118.22,121.15
2023-10-13 18:05,124,48,76,15422,4758,10664,18431395.0,5635112.0,12796283.0,109,41,68,11817,4749,7068,14200011.0,5602756.0,8597254.0,118.43,120.0,117.98,121.64
2023-10-13 18:10,220,64,156,17633,6438,11195,21013865.0,7580633.0,13433232.0,207,54,153,17764,6233,11531,21223422.0,7336438.0,13886983.0,117.75,119.99,117.7,120.43
2023-10-13 18:15,441,117,324,34698,10575,24123,41317382.0,12440820.0,28876561.0,376,75,301,33835,9208,24627,40353878.0,10807694.0,29546184.0,117.64,119.71,117.37,119.97
2023-10-13 18:20,661,101,560,40112,6708,33404,47828933.0,7888129.0,39940803.0,636,83,553,39730,6971,32759,47395876.0,8174906.0,39220970.0,117.59,119.57,117.27,119.73
2023-10-13 18:25,726,170,556,40285,9172,31113,48067512.0,10862428.0,37205083.0,710,164,546,40042,8689,31353,47804891.0,10287847.0,37517043.0,118.43,119.58,118.4,119.66
2023-10-13 18:30,564,296,268,42594,22015,20579,50404811.0,25959829.0,24444982.0,524,275,249,40278,21202,19076,47899176.0,24979511.0,22919664.0,117.92,118.79,117.82,120.15
2023-10-13 18:35,615,464,151,43424,29827,13597,51680528.0,35298557.0,16381970.0,612,468,144,43771,30748,13023,52063260.0,36361185.0,15702074.0,118.34,120.48,118.26,120.57
2023-10-16 10:00,1811,731,1080,48115,20734,27381,56311093.0,23561990.0,32749102.0,589,239,350,22651,8588,14063,26765856.0,10075133.0,16690722.0,113.64,119.61,117.32,118.69
2023-10-16 10:05,734,543,191,20192,15852,4340,24073212.0,18856931.0,5216281.0,531,415,116,15644,13215,2429,18468715.0,15574533.0,2894181.0,118.96,120.19,117.85,119.15
2023-10-16 10:10,525,209,316,8184,2446,5738,9896562.0,2875690.0,7020872.0,183,70,113,4724,2011,2713,5625784.0,2357559.0,3268225.0,117.57,122.36,117.23,120.47
2023-10-16 10:15,902,529,373,62630,33440,29190,75072152.0,39769358.0,35302793.0,724,442,282,57948,31573,26375,69171410.0,37274110.0,31897299.0,118.93,120.94,118.06,120.94
2023-10-16 10:20,507,285,222,38858,20659,18199,46694557.0,24574640.0,22119916.0,355,223,132,36663,20252,16411,43800307.0,23845653.0,19954654.0,118.95,121.54,117.74,121.59
2023-10-16 10:25,427,229,198,30743,15363,15380,36866507.0,18191160.0,18675347.0,338,186,152,28411,14594,13817,34059170.0,17277411.0,16781759.0,118.41,121.43,118.39,121.46
2023-10-16 10:30,485,285,200,30919,14520,16399,36939907.0,17180916.0,19758991.0,366,228,138,27288,13980,13308,32633752.0,16508136.0,16125615.0,118.33,120.49,118.08,121.17
2023-10-16 10:35,457,342,115,30303,18747,11556,36409944.0,22345419.0,14064524.0,366,283,83,28218,18053,10165,33726772.0,21392855.0,12333917.0,119.19,121.71,118.5,121.34
2023-10-16 10:40,525,393,132,36535,24737,11798,43704418.0,29394018.0,14310400.0,483,373,110,35399,24075,11324,42345005.0,28598519.0,13746486.0,118.83,121.3,118.79,121.39
2023-10-16 10:45,801,393,408,45744,21882,23862,54491638.0,25905240.0,28586398.0,728,355,373,44933,21622,23311,53617136.0,25511616.0,28105520.0,118.39,119.8,117.99,120.57
2023-10-16 10:50,749,221,528,55955,20419,35536,66603720.0,24033664.0,42570056.0,698,197,501,53524,19605,33919,63847880.0,23064788.0,40783092.0,117.7,119.79,117.65,120.24
2023-10-16 10:55,736,175,561,45038,11015,34023,53613537.0,12958562.0,40654974.0,664,129,535,42801,10054,32747,50981179.0,11793160.0,39188019.0,117.64,119.49,117.3,119.67
2023-10-16 11:00,180,89,91,17447,9765,7682,20803140.0,11513676.0,9289463.0,137,60,77,13155,6165,6990,15654197.0,7234062.0,8420135.0,117.91,120.93,117.34,120.46
2023-10-16 11:05,835,99,736,54528,10833,43695,64783318.0,12730406.0,52052911.0,791,76,715,51266,10521,40745,61163298.0,12356520.0,48806778.0,117.52,119.13,117.45,119.79
2023-10-16 11:10,448,253,195,30494,16237,14257,36398305.0,19178585.0,17219720.0,388,217,171,30119,17015,13104,35881092.0,20072318.0,15808773.0,118.12,120.78,117.97,120.64
2023-10-16 11:15,357,158,199,33388,15760,17628,39868777.0,18558502.0,21310275.0,314,140,174,31183,14950,16233,37244679.0,17579290.0,19665389.0,117.76,120.89,117.59,121.14
2023-10-16 11:20,488,274,214,36095,20670,15425,43090300.0,24435660.0,18654640.0,441,250,191,34044,18902,15142,40657993.0,22331014.0,18326978.0,118.22,120.94,118.14,121.03
2023-10-16 11:25,259,153,106,21720,11276,10444,26270147.0,13367556.0,12902590.0,227,139,88,21818,11462,10356,26347252.0,13533917.0,12813334.0,118.55,123.54,118.08,123.73
2023-10-16 11:30,96,61,35,6439,3462,2977,7691191.0,4094051.0,3597140.0,72,46,26,5621,2996,2625,6714408.0,3540437.0,3173971.0,118.26,120.83,118.17,120.91
2023-10-16 11:35,139,81,58,11232,6118,5114,13431602.0,7229459.0,6202142.0,105,67,38,9413,5395,4018,11224412.0,6365051.0,4859360.0,118.17,121.28,117.98,120.94
2023-10-16 11:40,165,98,67,10195,5980,4215,12125188.0,7053011.0,5072177.0,145,91,54,10334,6302,4032,12323785.0,7453054.0,4870730.0,117.94,120.34,118.26,120.8
2023-10-16 11:45,124,92,32,7770,5693,2077,9298322.0,6790198.0,2508123.0,117,90,27,7581,5553,2028,9026877.0,6575377.0,2451499.0,119.27,120.76,118.41,120.88
2023-10-16 11:50,501,379,122,33469,23200,10269,40246846.0,27819303.0,12427542.0,459,357,102,33168,23245,9923,39588714.0,27572958.0,12015755.0,119.91,121.02,118.62,121.09
2023-10-16 11:55,911,337,574,64281,26167,38114,76637110.0,30865296.0,45771813.0,862,305,557,63496,27027,36469,75758118.0,31881077.0,43877041.0,117.96,120.09,117.96,120.31
2023-10-16 12:00,472,74,398,33306,8846,24460,39739473.0,10446026.0,29293447.0,436,58,378,29183,6678,22505,34834809.0,7854234.0,26980575.0,118.09,119.76,117.61,119.89
2023-10-16 12:05,955,107,848,58473,9880,48593,69880782.0,11630004.0,58250778.0,937,94,843,57354,9728,47626,68494563.0,11445454.0,57049108.0,117.71,119.87,117.65,119.79
2023-10-16 12:10,1268,205,1063,83031,22662,60369,99063909.0,26664588.0,72399321.0,1242,192,1050,82225,22069,60156,98099172.0,25930122.0,72169049.0,117.66,119.93,117.5,119.97
2023-10-16 12:15,570,89,481,34212,7168,27044,40828698.0,8434927.0,32393770.0,560,85,475,34197,7181,27016,40810177.0,8447049.0,32363127.0,117.67,119.78,117.63,119.79
2023-10-16 12:20,771,65,706,38110,3595,34515,45555956.0,4243065.0,41312890.0,752,49,703,38083,3519,34564,45532617.0,4148369.0,41384248.0,118.03,119.7,117.88,119.73
2023-10-16 12:25,518,85,433,33381,7473,25908,39845697.0,8789177.0,31056520.0,500,79,421,29337,5714,23623,35010912.0,6730357.0,28280554.0,117.61,119.87,117.79,119.72
2023-10-16 12:30,126,43,83,9908,4213,5695,11791001.0,4952278.0,6838722.0,113,38,75,9856,4264,5592,11744063.0,5009906.0,6734157.0,117.55,120.08,117.49,120.42
2023-10-16 12:35,201,91,110,15958,7505,8453,19067011.0,8903883.0,10163128.0,184,80,104,15499,7084,8415,18479962.0,8342568.0,10137394.0,118.64,120.23,117.77,120.47
2023-10-16 12:40,73,36,37,5783,3548,2235,6889050.0,4202655.0,2686394.0,54,28,26,3998,1963,2035,4766700.0,2310213.0,2456486.0,118.45,120.2,117.69,120.71
2023-10-16 12:45,140,44,96,8905,3600,5305,10645832.0,4242840.0,6402991.0,117,31,86,8052,3317,4735,9616083.0,3903125.0,5712958.0,117.86,120.7,117.67,120.65
2023-10-16 12:50,106,55,51,5227,2526,2701,6293816.0,3000126.0,3293690.0,71,41,30,4247,2400,1847,5079347.0,2843181.0,2236166.0,118.77,121.94,118.47,121.07
2023-10-16 12:55,234,148,86,15779,8423,7356,18855243.0,9957452.0,8897790.0,211,139,72,15529,8244,7285,18569067.0,9746004.0,8823063.0,118.22,120.96,118.22,121.11
2023-10-16 13:00,94,65,29,4997,2980,2017,5973168.0,3529706.0,2443462.0,68,46,22,4468,2428,2040,5343657.0,2872581.0,2471076.0,118.45,121.14,118.31,121.13
2023-10-16 13:05,105,73,32,4656,3274,1382,5525503.0,3905654.0,1619849.0,69,57,12,3811,2939,872,4556684.0,3498725.0,1057958.0,119.29,117.21,119.04,121.33
2023-10-16 13:10,83,67,16,4891,3350,1541,5874448.0,3996038.0,1878410.0,78,65,13,5034,3426,1608,6041225.0,4081983.0,1959242.0,119.28,121.9,119.15,121.84
2023-10-16 13:15,254,168,86,19872,11689,8183,23795528.0,13885199.0,9910328.0,242,157,85,20251,12048,8203,24227919.0,14284223.0,9943696.0,118.79,121.11,118.56,121.22
2023-10-16 13:20,193,123,70,11380,6792,4588,13609375.0,8053015.0,5556360.0,171,111,60,10944,6522,4422,13087654.0,7730263.0,5357391.0,118.57,121.11,118.53,121.15
2023-10-16 13:25,260,135,125,21639,10885,10754,25884001.0,12883658.0,13000343.0,237,124,113,21344,10698,10646,25514543.0,12621851.0,12892691.0,118.36,120.89,117.98,121.1
2023-10-16 13:30,150,108,42,8273,5209,3064,9887076.0,6177107.0,3709969.0,144,106,38,8197,5180,3017,9793937.0,6140822.0,3653115.0,118.59,121.08,118.55,121.08
2023-10-16 13:35,235,99,136,18330,8416,9914,21963909.0,9946355.0,12017553.0,206,90,116,17507,8289,9218,20920244.0,9779907.0,11140337.0,118.18,121.22,117.99,120.85
2023-10-16 13:40,113,27,86,10185,5103,5082,11924001.0,5819591.0,6104409.0,104,28,76,7511,2370,5141,8981918.0,2788641.0,6193277.0,114.04,120.12,117.66,120.47
2023-10-16 13:45,149,22,127,9058,1313,7745,10799744.0,1551003.0,9248741.0,135,24,111,7208,1355,5853,8668906.0,1596871.0,7072034.0,118.13,119.42,117.85,120.83
2023-10-16 13:50,447,228,219,33116,17298,15818,39647842.0,20528622.0,19119219.0,356,180,176,29456,14398,15058,35269298.0,17044955.0,18224343.0,118.68,120.87,118.38,121.03
2023-10-16 13:55,126,68,58,7522,4374,3148,9011932.0,5196869.0,3815063.0,108,72,36,7123,4383,2740,8530289.0,5204081.0,3326207.0,118.81,121.19,118.73,121.39
2023-10-16 14:00,132,109,23,5367,5001,366,6418998.0,5979127.0,439870.0,115,103,12,5253,4950,303,6284859.0,5917793.0,367065.0,119.56,120.18,119.55,121.14
2023-10-16 14:05,152,112,40,10420,7361,3059,12450528.0,8767452.0,3683075.0,134,107,27,9721,7049,2672,11639852.0,8394560.0,3245291.0,119.11,120.4,119.09,121.46
2023-10-16 14:10,116,52,64,13022,4047,8975,15499370.0,4781143.0,10718226.0,103,47,56,12563,4645,7918,15028895.0,5494099.0,9534796.0,118.14,119.42,118.28,120.42
2023-10-16 14:15,54,24,30,3161,1146,2015,3769366.0,1356021.0,2413345.0,33,13,20,2746,1004,1742,3288035.0,1183234.0,2104800.0,118.33,119.77,117.85,120.83
2023-10-16 14:20,54,24,30,3673,903,2770,4393893.0,1068760.0,3325132.0,30,8,22,2887,530,2357,3455599.0,625373.0,2830226.0,118.36,120.04,117.99,120.08
2023-10-16 14:25,37,13,24,776,207,569,932109.0,254977.0,677131.0,21,5,16,477,50,427,572767.0,59444.0,513323.0,123.18,119.0,118.89,120.22
2023-10-16 14:30,56,24,32,4874,2119,2755,5725900.0,2414995.0,3310905.0,39,11,28,5545,2830,2715,6493846.0,3138008.0,3355838.0,113.97,120.18,110.88,123.6
2023-10-16 14:35,44,7,37,1686,166,1520,2016830.0,195267.0,1821562.0,38,7,31,2015,226,1789,2409342.0,265167.0,2144175.0,117.63,119.84,117.33,119.85
2023-10-16 14:40,80,19,61,4738,792,3946,5656530.0,935931.0,4720599.0,84,31,53,3612,342,3270,4323903.0,405161.0,3918742.0,118.17,119.63,118.47,119.84
2023-10-16 14:45,28,9,19,1402,678,724,1670851.0,798528.0,872323.0,19,8,11,2147,668,1479,2556786.0,786011.0,1770775.0,117.78,120.49,117.67,119.73
2023-10-16 14:50,42,21,21,3056,1573,1483,3634543.0,1846758.0,1787785.0,38,19,19,2682,1215,1467,3198364.0,1429615.0,1768749.0,117.4,120.55,117.66,120.57
2023-10-16 14:55,36,18,18,1431,789,642,1704362.0,929578.0,774784.0,19,11,8,1267,650,617,1510850.0,764261.0,746589.0,117.82,120.68,117.58,121.0
2023-10-16 15:00,46,26,20,2929,1524,1405,3490870.0,1799506.0,1691364.0,37,22,15,3162,1914,1248,3759421.0,2251658.0,1507762.0,118.08,120.38,117.64,120.81
2023-10-16 15:05,19,10,9,853,429,424,1022624.0,509650.0,512974.0,15,6,9,1181,764,417,1397075.0,892664.0,504411.0,118.8,120.98,116.84,120.96
2023-10-16 15:10,82,33,49,4452,1954,2498,5267399.0,2296467.0,2970932.0,63,23,40,3976,1578,2398,4750981.0,1859426.0,2891555.0,117.53,118.93,117.83,120.58
2023-10-16 15:15,53,27,26,4596,2547,2049,5476327.0,3003738.0,2472589.0,38,16,22,4402,2383,2019,5227173.0,2791079.0,2436094.0,117.93,120.67,117.12,120.66
2023-10-16 15:20,87,29,58,4924,1963,2961,5899323.0,2325772.0,3573551.0,64,19,45,4654,1853,2801,5556800.0,2179812.0,3376988.0,118.48,120.69,117.64,120.56
2023-10-16 15:25,33,9,24,2987,1209,1778,3573517.0,1420338.0,2153179.0,31,10,21,3074,1531,1543,3656198.0,1794027.0,1862171.0,117.48,121.1,117.18,120.69
2023-10-16 15:30,35,14,21,1450,711,739,1727867.0,841463.0,886404.0,29,11,18,1510,749,761,1802625.0,883733.0,918891.0,118.35,119.95,117.99,120.75
2023-10-16 15:35,38,19,19,1460,801,659,1738275.0,946804.0,791471.0,26,13,13,1491,884,607,1775123.0,1043401.0,731722.0,118.2,120.1,118.03,120.55
2023-10-16 15:40,84,45,39,6581,3771,2810,7865464.0,4471623.0,3393841.0,69,36,33,5962,3268,2694,7107554.0,3853235.0,3254319.0,118.58,120.78,117.91,120.8
2023-10-16 15:45,30,14,16,2104,1078,1026,2502287.0,1267469.0,1234818.0,22,10,12,2233,1266,967,2647180.0,1482708.0,1164471.0,117.58,120.35,117.12,120.42
2023-10-16 15:50,40,18,22,3092,1565,1527,3680804.0,1839615.0,1841189.0,35,17,18,3089,1232,1857,3702179.0,1449493.0,2252685.0,117.55,120.58,117.65,121.31
2023-10-16 15:55,490,24,466,25404,1776,23628,30383176.0,2115018.0,28268158.0,477,15,462,25486,1686,23800,30460502.0,1984257.0,28476245.0,119.09,119.64,117.69,119.65
2023-10-16 16:00,985,14,971,50620,635,49985,60484982.0,736800.0,59748181.0,977,9,968,50569,562,50007,60425583.0,651732.0,59773851.0,116.03,119.53,115.97,119.53
2023-10-16 16:05,713,15,698,36670,982,35688,43820154.0,1156416.0,42663738.0,698,6,692,36181,605,35576,43239262.0,711014.0,42528248.0,117.76,119.55,117.52,119.54
2023-10-16 16:10,309,30,279,16901,2214,14687,20195879.0,2625153.0,17570725.0,300,24,276,16870,2088,14782,20158251.0,2461156.0,17697095.0,118.57,119.63,117.87,119.72
2023-10-16 16:15,251,30,221,13662,2325,11337,16304883.0,2736341.0,13568542.0,247,32,215,13095,2020,11075,15632152.0,2374824.0,13257328.0,117.69,119.68,117.57,119.7
2023-10-16 16:20,651,52,599,33594,5168,28426,40124010.0,6091739.0,34032271.0,645,49,596,33583,5200,28383,40118809.0,6126416.0,33992393.0,117.87,119.72,117.82,119.76
2023-10-16 16:25,118,50,68,9434,4195,5239,11236060.0,4944097.0,6291962.0,88,30,58,8722,4090,4632,10399471.0,4813072.0,5586399.0,117.86,120.1,117.68,120.6
2023-10-16 16:30,32,14,18,2606,1038,1568,3119402.0,1221477.0,1897924.0,28,13,15,4821,3725,1096,5679751.0,4358133.0,1321618.0,117.68,121.04,117.0,120.59
2023-10-16 16:35,48,22,26,4232,2330,1902,5012446.0,2749264.0,2263182.0,37,18,19,3971,2295,1676,4728621.0,2705946.0,2022675.0,117.99,118.99,117.91,120.68
2023-10-16 16:40,101,37,64,9735,4758,4977,11573461.0,5590408.0,5983053.0,94,35,59,9547,4743,4804,11358787.0,5568137.0,5790650.0,117.49,120.21,117.4,120.54
2023-10-16 16:45,91,42,49,7256,3636,3620,8546732.0,4273703.0,4273029.0,73,30,43,6755,3750,3005,8024705.0,4404835.0,3619870.0,117.54,118.04,117.46,120.46
2023-10-16 16:50,501,244,257,32464,15208,17256,38405758.0,17889782.0,20515976.0,442,204,238,30761,14225,16536,36582758.0,16730494.0,19852263.0,117.63,118.89,117.61,120.05
2023-10-16 16:55,257,95,162,15248,6385,8863,18124829.0,7504608.0,10620220.0,256,100,156,15425,6455,8970,18350645.0,7584817.0,10765828.0,117.53,119.83,117.5,120.02
2023-10-16 17:00,95,45,50,4726,2188,2538,5622414.0,2573655.0,3048759.0,85,38,47,4368,1936,2432,5200882.0,2276701.0,2924180.0,117.63,120.12,117.6,120.24
2023-10-16 17:05,86,38,48,5696,2301,3395,6780932.0,2707696.0,4073235.0,68,29,39,5480,2151,3329,6528831.0,2527716.0,4001115.0,117.67,119.98,117.51,120.19
2023-10-16 17:10,110,42,68,9166,4367,4799,10937733.0,5175687.0,5762046.0,103,45,58,8903,4329,4574,10586967.0,5078702.0,5508265.0,118.52,120.07,117.32,120.43
2023-10-16 17:15,419,238,181,32142,16528,15614,38130291.0,19468756.0,18661534.0,373,207,166,31148,16064,15084,37054807.0,18896542.0,18158264.0,117.79,119.52,117.63,120.38
2023-10-16 17:20,1320,593,727,96266,43981,52285,114379655.0,51647990.0,62731665.0,1261,553,708,94409,42174,52235,112266308.0,49581910.0,62684397.0,117.43,119.98,117.57,120.0
2023-10-16 17:25,338,147,191,25612,12471,13141,30467696.0,14658417.0,15809279.0,320,140,180,25610,12683,12927,30467222.0,14904760.0,15562461.0,117.54,120.3,117.52,120.39
2023-10-16 17:30,398,161,237,25405,11924,13481,30334177.0,14142433.0,16191744.0,372,144,228,24978,11593,13385,29726608.0,13643658.0,16082949.0,118.6,120.11,117.69,120.16
2023-10-16 17:35,170,109,61,13538,7973,5565,16169381.0,9441222.0,6728159.0,148,91,57,12730,7326,5404,15185905.0,8637516.0,6548389.0,118.41,120.9,117.9,121.18
2023-10-16 17:40,501,393,108,35104,26546,8558,41708396.0,31354242.0,10354154.0,473,378,95,34141,25965,8176,40557969.0,30659773.0,9898196.0,118.11,120.99,118.08,121.06
2023-10-16 17:45,818,374,444,63708,31794,31914,75845596.0,37550819.0,38294776.0,802,364,438,63655,31955,31700,75872564.0,37733893.0,38138671.0,118.11,119.99,118.08,120.31
2023-10-16 17:50,927,510,417,74198,40482,33716,88641481.0,47969098.0,40672382.0,895,502,393,72479,39508,32971,86420637.0,46686487.0,39734149.0,118.49,120.63,118.17,120.51
2023-10-16 17:55,593,433,160,39734,26708,13026,47383072.0,31621985.0,15761087.0,575,432,143,39446,26696,12750,47013013.0,31602854.0,15410158.0,118.4,121.0,118.38,120.86
2023-10-16 18:00,825,407,418,49894,22535,27359,59222882.0,26607332.0,32615550.0,778,380,398,48848,22011,26837,58139412.0,25958000.0,32181412.0,118.07,119.21,117.93,119.91
2023-10-16 18:05,527,170,357,30300,9688,20612,36021857.0,11363449.0,24658408.0,506,160,346,29268,9011,20257,34821302.0,10580473.0,24240828.0,117.29,119.63,117.42,119.67
2023-10-16 18:10,599,342,257,34153,14984,19169,40622212.0,17623515.0,22998697.0,576,320,256,33777,14554,19223,40155925.0,17093787.0,23062137.0,117.62,119.98,117.45,119.97
2023-10-16 18:15,344,251,93,17432,10292,7140,20767635.0,12162798.0,8604837.0,340,244,96,18161,10315,7846,21597711.0,12160183.0,9437527.0,118.18,120.52,117.89,120.28
2023-10-16 18:20,203,144,59,12682,8208,4474,15114269.0,9720795.0,5393474.0,195,140,55,12432,7994,4438,14783181.0,9432455.0,5350725.0,118.43,120.55,117.99,120.57
2023-10-16 18:25,145,103,42,7893,5464,2429,9373839.0,6463563.0,2910275.0,132,95,37,8027,5488,2539,9545487.0,6485588.0,3059898.0,118.29,119.81,118.18,120.52
2023-10-16 18:30,158,95,63,7320,5307,2013,8560131.0,6208391.0,2351740.0,139,86,53,5865,4271,1594,6963663.0,5062351.0,1901312.0,116.98,116.83,118.53,119.28
2023-10-16 18:35,370,199,171,15188,6396,8792,17968128.0,7652613.0,10315515.0,337,176,161,12742,5662,7080,15140336.0,6699289.0,8441047.0,119.65,117.33,118.32,119.22
2023-10-17 10:00,1088,317,771,24925,7258,17667,30376510.0,8000193.0,22376317.0,223,54,169,9908,2088,7820,11824251.0,2462945.0,9361306.0,110.23,126.66,117.96,119.71
2023-10-17 10:05,207,105,102,6104,2605,3499,7443518.0,3080075.0,4363443.0,74,40,34,3105,1718,1387,3698641.0,2030327.0,1668314.0,118.24,124.71,118.18,120.28
2023-10-17 10:10,531,207,324,13442,4396,9046,15920174.0,5108543.0,10811631.0,223,63,160,8934,2377,6557,10595061.0,2799189.0,7795871.0,116.21,119.52,117.76,118.89
2023-10-17 10:15,537,174,363,30206,11285,18921,35660125.0,13244104.0,22416020.0,403,99,304,24373,8023,16350,28877919.0,9372680.0,19505239.0,117.36,118.47,116.82,119.3
2023-10-17 10:20,643,214,429,40243,17266,22977,47485968.0,20155059.0,27330909.0,489,115,374,38146,15982,22164,45066809.0,18632153.0,26434656.0,116.73,118.95,116.58,119.27
2023-10-17 10:25,202,73,129,11265,4372,6893,13359170.0,5110115.0,8249055.0,159,50,109,12420,5917,6503,14661912.0,6892965.0,7768947.0,116.88,119.67,116.49,119.47
2023-10-17 10:30,134,59,75,9370,4016,5354,11237190.0,4704045.0,6533144.0,99,32,67,9534,3679,5855,11383253.0,4301326.0,7081927.0,117.13,122.02,116.92,120.96
2023-10-17 10:35,179,81,98,13873,6065,7808,16727020.0,7169378.0,9557642.0,110,47,63,12074,5939,6135,14377625.0,6938747.0,7438877.0,118.21,122.41,116.83,121.25
2023-10-17 10:40,129,62,67,8385,4506,3879,9964413.0,5303111.0,4661301.0,90,46,44,7719,4189,3530,9171711.0,4925210.0,4246500.0,117.69,120.17,117.57,120.3
2023-10-17 10:45,306,100,206,23929,9078,14851,28442217.0,10635728.0,17806488.0,256,79,177,22558,9255,13303,26801912.0,10851548.0,15950364.0,117.16,119.9,117.25,119.9
2023-10-17 10:50,699,137,562,51925,17036,34889,61684941.0,19923997.0,41760943.0,659,110,549,51601,16951,34650,61348546.0,19826269.0,41522277.0,116.95,119.7,116.96,119.83
2023-10-17 10:55,591,91,500,35903,12008,23895,42566629.0,14018848.0,28547780.0,553,66,487,33486,9911,23575,39771352.0,11593392.0,28177959.0,116.75,119.47,116.98,119.52
2023-10-17 11:00,373,97,276,24486,8185,16301,28937976.0,9585458.0,19352517.0,331,66,265,23026,7623,15403,27310562.0,8910801.0,18399760.0,117.11,118.72,116.89,119.46
2023-10-17 11:05,813,123,690,51852,12639,39213,61740826.0,14765231.0,46975594.0,758,93,665,50113,12320,37793,59446545.0,14394012.0,45052532.0,116.82,119.8,116.83,119.21
2023-10-17 11:10,661,124,537,36340,8960,27380,42883179.0,10463956.0,32419222.0,570,76,494,35513,8951,26562,42038160.0,10415731.0,31622429.0,116.79,118.4,116.36,119.05
2023-10-17 11:15,646,106,540,33875,6945,26930,40038677.0,8111919.0,31926758.0,567,50,517,30700,4176,26524,36374494.0,4870312.0,31504181.0,116.8,118.55,116.63,118.78
2023-10-17 11:20,462,93,369,22944,4238,18706,27169668.0,4953195.0,22216473.0,413,52,361,22946,4227,18719,27161188.0,4929758.0,22231429.0,116.88,118.77,116.63,118.76
2023-10-17 11:25,628,174,454,45369,16098,29271,53223888.0,18814961.0,34408926.0,537,112,425,41854,14323,27531,49524935.0,16703629.0,32821306.0,116.88,117.55,116.62,119.22
2023-10-17 11:30,372,130,242,24901,11164,13737,29495695.0,13090995.0,16404700.0,310,92,218,23357,9869,13488,27641511.0,11532830.0,16108681.0,117.26,119.42,116.86,119.43
2023-10-17 11:35,150,80,70,10737,5479,5258,12721104.0,6419571.0,6301533.0,133,66,67,10487,5554,4933,12422308.0,6505999.0,5916309.0,117.17,119.85,117.14,119.93
2023-10-17 11:40,153,70,83,11244,5596,5648,13327976.0,6577221.0,6750755.0,126,58,68,10938,5852,5086,12947386.0,6851250.0,6096135.0,117.53,119.52,117.08,119.86
2023-10-17 11:45,350,143,207,22536,11762,10774,26762873.0,13868421.0,12894451.0,308,115,193,19546,9148,10398,23187339.0,10747127.0,12440212.0,117.91,119.68,117.48,119.64
2023-10-17 11:50,192,135,57,7499,5031,2468,8920549.0,5954028.0,2966521.0,157,110,47,8314,6042,2272,9863270.0,7131223.0,2732047.0,118.35,120.2,118.03,120.25
2023-10-17 11:55,334,153,181,25113,12243,12870,29831909.0,14390160.0,15441748.0,279,123,156,23737,11812,11925,28177368.0,13857292.0,14320076.0,117.54,119.98,117.32,120.08
2023-10-17 12:00,367,255,112,26025,16303,9722,30941038.0,19224751.0,11716286.0,368,263,105,25986,16344,9642,30884185.0,19268865.0,11615320.0,117.92,120.51,117.9,120.47
2023-10-17 12:05,170,121,49,12549,8330,4219,14927516.0,9827976.0,5099539.0,144,103,41,11711,7949,3762,13903547.0,9371255.0,4532292.0,117.98,120.87,117.89,120.48
2023-10-17 12:10,87,52,35,3968,2278,1690,4731496.0,2690293.0,2041203.0,61,41,20,3800,2191,1609,4526800.0,2578030.0,1948770.0,118.1,120.78,117.66,121.12
2023-10-17 12:15,61,42,19,1921,995,926,2301425.0,1197543.0,1103882.0,28,15,13,1319,732,587,1567201.0,861836.0,705365.0,120.36,119.21,117.74,120.16
2023-10-17 12:20,65,30,35,2472,964,1508,2907205.0,1137808.0,1769396.0,43,19,24,2150,980,1170,2559856.0,1151957.0,1407899.0,118.03,117.33,117.55,120.33
2023-10-17 12:25,64,33,31,3034,1739,1295,3607481.0,2058597.0,1548884.0,54,30,24,3128,1761,1367,3715672.0,2072084.0,1643587.0,118.38,119.6,117.67,120.23
2023-10-17 12:30,737,224,513,50891,18452,32439,60133638.0,21586773.0,38546864.0,703,199,504,50711,19095,31616,60148011.0,22332456.0,37815554.0,116.99,118.83,116.95,119.61
2023-10-17 12:35,516,209,307,22890,8682,14208,27174912.0,10200773.0,16974139.0,507,203,304,22200,8320,13880,26355861.0,9775219.0,16580641.0,117.49,119.47,117.49,119.46
2023-10-17 12:40,621,272,349,43413,18450,24963,51499081.0,21607719.0,29891362.0,592,252,340,43010,18144,24866,51016760.0,21241465.0,29775295.0,117.12,119.74,117.07,119.74
2023-10-17 12:45,344,102,242,22583,8304,14279,26778810.0,9717850.0,17060959.0,330,100,230,22675,8539,14136,26887139.0,9995846.0,16891293.0,117.03,119.48,117.06,119.49
2023-10-17 12:50,426,145,281,35846,14748,21098,42434539.0,17181804.0,25252735.0,390,124,266,34971,14004,20967,41456865.0,16355959.0,25100906.0,116.5,119.69,116.79,119.72
2023-10-17 12:55,149,41,108,8552,2579,5973,10138759.0,3015229.0,7123529.0,136,34,102,8351,2519,5832,9900009.0,2943175.0,6956834.0,116.91,119.26,116.84,119.29
2023-10-17 13:00,177,28,149,9643,2174,7469,11439686.0,2543629.0,8896056.0,160,16,144,9647,2138,7509,11441359.0,2497202.0,8944156.0,117.0,119.11,116.8,119.11
2023-10-17 13:05,248,62,186,18513,6773,11740,21957027.0,7918300.0,14038726.0,228,48,180,18258,6647,11611,21649886.0,7765828.0,13884058.0,116.91,119.58,116.83,119.58
2023-10-17 13:10,129,35,94,5683,1709,3974,6742664.0,2001037.0,4741626.0,117,31,86,5574,1753,3821,6608741.0,2049429.0,4559312.0,117.09,119.32,116.91,119.32
2023-10-17 13:15,113,50,63,8785,4074,4711,10418384.0,4774384.0,5644000.0,96,39,57,8614,3981,4633,10209344.0,4655841.0,5553503.0,117.19,119.8,116.95,119.87
2023-10-17 13:20,85,35,50,6533,3490,3043,7733395.0,4088907.0,3644487.0,67,23,44,5299,2238,3061,6282460.0,2615552.0,3666908.0,117.16,119.77,116.87,119.79
2023-10-17 13:25,288,70,218,24549,9137,15412,29074303.0,10673277.0,18401026.0,281,65,216,24496,9168,15328,29044255.0,10709573.0,18334682.0,116.81,119.39,116.81,119.62
2023-10-17 13:30,253,68,185,16795,5794,11001,19960482.0,6778767.0,13181714.0,225,46,179,16373,5681,10692,19421726.0,6641211.0,12780515.0,117.0,119.82,116.9,119.53
2023-10-17 13:35,260,82,178,19932,8084,11848,23648045.0,9463043.0,14185002.0,259,85,174,19855,8109,11746,23557049.0,9491857.0,14065192.0,117.06,119.72,117.05,119.74
2023-10-17 13:40,82,31,51,3088,1311,1777,3661763.0,1534414.0,2127349.0,56,16,40,2694,1019,1675,3194933.0,1192146.0,2002786.0,117.04,119.72,116.99,119.57
2023-10-17 13:45,169,33,136,7486,1715,5771,8863436.0,2009460.0,6853975.0,147,22,125,7576,1858,5718,8981551.0,2175323.0,6806228.0,117.17,118.77,117.08,119.03
2023-10-17 13:50,161,33,128,6968,1323,5645,8286858.0,1558467.0,6728390.0,134,16,118,6724,1161,5563,7992641.0,1354795.0,6637846.0,117.8,119.19,116.69,119.32
2023-10-17 13:55,106,27,79,8063,3062,5001,9585943.0,3582305.0,6003638.0,100,24,76,7969,3064,4905,9452186.0,3582699.0,5869487.0,116.99,120.05,116.93,119.66
2023-10-17 14:00,117,45,72,9650,4377,5273,11433246.0,5121965.0,6311281.0,107,35,72,9478,4250,5228,11244015.0,4970009.0,6274005.0,117.02,119.69,116.94,120.01
2023-10-17 14:05,49,18,31,1407,348,1059,1675321.0,409357.0,1265964.0,32,8,24,971,308,663,1150208.0,358599.0,791609.0,117.63,119.54,116.43,119.4
2023-10-17 14:10,99,35,64,7075,3331,3744,8391659.0,3894968.0,4496691.0,85,27,58,7245,3383,3862,8596007.0,3954798.0,4641209.0,116.93,120.1,116.9,120.18
2023-10-17 14:15,264,64,200,18458,6166,12292,21865160.0,7212121.0,14653038.0,242,50,192,17889,6014,11875,21205303.0,7023756.0,14181547.0,116.97,119.21,116.79,119.42
2023-10-17 14:20,209,23,186,10152,1613,8539,12069442.0,1885067.0,10184375.0,197,16,181,9818,1604,8214,11639217.0,1872543.0,9766674.0,116.87,119.27,116.74,118.9
2023-10-17 14:25,224,61,163,17124,6199,10925,20306997.0,7249781.0,13057216.0,205,49,156,17023,6098,10925,20179555.0,7121354.0,13058200.0,116.95,119.52,116.78,119.53
2023-10-17 14:30,65,25,40,5075,2406,2669,6007335.0,2816127.0,3191208.0,51,19,32,4625,2117,2508,5483235.0,2473411.0,3009824.0,117.05,119.57,116.84,120.01
2023-10-17 14:35,55,19,36,4200,2039,2161,4986654.0,2389465.0,2597188.0,38,12,26,4104,2002,2102,4870602.0,2343267.0,2527335.0,117.19,120.18,117.05,120.23
2023-10-17 14:40,77,24,53,4677,1769,2908,5500350.0,2070332.0,3430018.0,67,21,46,4364,1745,2619,5175022.0,2039249.0,3135773.0,117.03,117.95,116.86,119.73
2023-10-17 14:45,73,31,42,5159,2630,2529,6157366.0,3121074.0,3036291.0,60,26,34,4920,2446,2474,5827146.0,2855970.0,2971176.0,118.67,120.06,116.76,120.1
2023-10-17 14:50,88,19,69,4449,1159,3290,5267677.0,1361205.0,3906472.0,78,14,64,4260,1133,3127,5053398.0,1325547.0,3727851.0,117.45,118.74,116.99,119.21
2023-10-17 14:55,66,10,56,2933,624,2309,3477470.0,728495.0,2748975.0,61,9,52,2946,684,2262,3492983.0,799011.0,2693972.0,116.75,119.05,116.81,119.1
2023-10-17 15:00,68,17,51,2537,683,1854,3009603.0,799697.0,2209905.0,59,9,50,2656,610,2046,3176549.0,712094.0,2464454.0,117.09,119.2,116.74,120.45
2023-10-17 15:05,111,26,85,6669,1961,4708,7908535.0,2292863.0,5615672.0,106,22,84,6781,2062,4719,8038985.0,2409708.0,5629276.0,116.92,119.28,116.86,119.29
2023-10-17 15:10,323,196,127,24185,13411,10774,28719734.0,15763066.0,12956668.0,281,172,109,22297,12622,9675,26458052.0,14827421.0,11630631.0,117.54,120.26,117.47,120.21
2023-10-17 15:15,759,669,90,42898,32118,10780,50932188.0,37944784.0,12987404.0,745,673,72,42206,31858,10348,50106562.0,37633437.0,12473125.0,118.14,120.48,118.13,120.54
2023-10-17 15:20,331,231,100,29899,17210,12689,35470593.0,20228822.0,15241771.0,321,229,92,29500,17147,12353,35016303.0,20138741.0,14877562.0,117.54,120.12,117.45,120.44
2023-10-17 15:25,217,55,162,12876,3520,9356,15277262.0,4125671.0,11151591.0,197,50,147,12110,3387,8723,14357466.0,3949356.0,10408109.0,117.21,119.19,116.6,119.32
2023-10-17 15:30,1446,632,814,46997,13288,33709,55658408.0,15574222.0,40084186.0,1356,588,768,45452,12782,32670,53866324.0,14981474.0,38884849.0,117.21,118.91,117.21,119.02
2023-10-17 15:35,922,260,662,45111,14517,30594,53434946.0,16964123.0,36470823.0,895,247,648,44653,14355,30298,52888792.0,16762140.0,36126651.0,116.86,119.21,116.77,119.24
2023-10-17 15:40,1567,496,1071,80472,22489,57983,95295270.0,26263084.0,69032186.0,1507,461,1046,79174,22023,57151,93758019.0,25711695.0,68046324.0,116.78,119.06,116.75,119.06
2023-10-17 15:45,339,116,223,15943,5994,9949,18870172.0,7006027.0,11864144.0,327,116,211,15742,6001,9741,18634700.0,7009647.0,11625053.0,116.88,119.25,116.81,119.34
2023-10-17 15:50,505,231,274,16750,5524,11226,19832526.0,6461246.0,13371280.0,489,224,265,17081,5882,11199,20218328.0,6877318.0,13341010.0,116.97,119.11,116.92,119.13
2023-10-17 15:55,251,47,204,11483,3559,7924,13610852.0,4161213.0,9449639.0,235,36,199,12249,3718,8531,14513326.0,4339162.0,10174164.0,116.92,119.25,116.71,119.26
2023-10-17 16:00,436,101,335,26152,10183,15969,30976650.0,11889876.0,19086774.0,425,94,331,25724,10371,15353,30469757.0,12111765.0,18357991.0,116.76,119.52,116.78,119.57
2023-10-17 16:05,180,63,117,11995,5360,6635,14202042.0,6260626.0,7941415.0,163,50,113,11445,4881,6564,13554335.0,5695383.0,7858952.0,116.8,119.69,116.68,119.73
2023-10-17 16:10,291,108,183,15629,6641,8988,18500184.0,7755428.0,10744755.0,271,94,177,15234,6292,8942,18033416.0,7342623.0,10690793.0,116.78,119.55,116.7,119.56
2023-10-17 16:15,85,25,60,2686,836,1850,3191578.0,985954.0,2205623.0,78,21,57,2631,753,1878,3119798.0,881038.0,2238759.0,117.94,119.22,117.0,119.21
2023-10-17 16:20,113,40,73,5442,2026,3416,6359992.0,2283292.0,4076699.0,96,27,69,4163,1476,2687,4938270.0,1727388.0,3210882.0,112.7,119.34,117.03,119.5
2023-10-17 16:25,840,227,613,44220,17705,26515,52078495.0,20549356.0,31529139.0,763,175,588,42399,16525,25874,50123127.0,19207397.0,30915730.0,116.07,118.91,116.23,119.49
2023-10-17 16:30,341,91,250,16258,4628,11630,19242533.0,5398890.0,13843642.0,305,71,234,15979,4788,11191,18908267.0,5586383.0,13321884.0,116.66,119.03,116.67,119.04
2023-10-17 16:35,321,118,203,14896,4262,10634,17638520.0,4986291.0,12652228.0,288,92,196,15377,5010,10367,18173980.0,5838384.0,12335596.0,116.99,118.98,116.53,118.99
2023-10-17 16:40,647,199,448,31767,11375,20392,37556071.0,13261403.0,24294667.0,610,183,427,32363,12179,20184,38138654.0,14068222.0,24070432.0,116.58,119.14,115.51,119.26
2023-10-17 16:45,351,94,257,15649,4591,11058,18535950.0,5374833.0,13161117.0,311,67,244,15082,4281,10801,17848407.0,4992183.0,12856224.0,117.07,119.02,116.61,119.03
2023-10-17 16:50,808,326,482,22313,8915,13398,26379873.0,10435065.0,15944808.0,750,297,453,22175,9082,13093,26249314.0,10614105.0,15635209.0,117.05,119.01,116.87,119.42
2023-10-17 16:55,344,87,257,13537,4689,8848,16029954.0,5470768.0,10559186.0,329,75,254,13472,4653,8819,15957570.0,5424647.0,10532923.0,116.67,119.34,116.58,119.43
2023-10-17 17:00,323,115,208,16852,5863,10989,19936913.0,6839463.0,13097449.0,300,100,200,16735,5771,10964,19795177.0,6726451.0,13068725.0,116.65,119.19,116.56,119.2
2023-10-17 17:05,210,53,157,10917,3576,7341,12910907.0,4172488.0,8738419.0,196,47,149,10754,3480,7274,12733364.0,4058562.0,8674802.0,116.68,119.04,116.63,119.26
2023-10-17 17:10,471,242,229,16452,7231,9221,19541480.0,8562495.0,10978984.0,404,198,206,15144,6539,8605,17902453.0,7635033.0,10267420.0,118.41,119.07,116.76,119.32
2023-10-17 17:15,279,168,111,10324,4420,5904,12215221.0,5166190.0,7049031.0,258,159,99,9745,4337,5408,11534043.0,5067640.0,6466403.0,116.88,119.39,116.85,119.57
2023-10-17 17:20,205,65,140,11722,4382,7340,13707135.0,5119295.0,8587840.0,174,50,124,10879,4270,6609,12864974.0,4976583.0,7888391.0,116.83,117.0,116.55,119.36
2023-10-17 17:25,1175,596,579,39532,16556,22976,46481792.0,19358732.0,27123059.0,1106,549,557,38679,16128,22551,45724603.0,18828084.0,26896518.0,116.93,118.05,116.74,119.27
2023-10-17 17:30,179,77,102,9573,3696,5877,11253214.0,4314652.0,6938562.0,156,60,96,8792,3562,5230,10389436.0,4155331.0,6234104.0,116.74,118.06,116.66,119.2
2023-10-17 17:35,171,39,132,7509,1030,6479,8987236.0,1214864.0,7772371.0,144,17,127,6490,1023,5467,7671235.0,1193468.0,6477766.0,117.95,119.96,116.66,118.49
2023-10-17 17:40,144,46,98,9288,3342,5946,10972757.0,3896692.0,7076065.0,130,35,95,9184,3277,5907,10854362.0,3818747.0,7035615.0,116.6,119.01,116.53,119.11
2023-10-17 17:45,90,33,57,5623,1839,3784,6629991.0,2145389.0,4484602.0,75,21,54,4852,1799,3053,5731837.0,2095229.0,3636607.0,116.66,118.51,116.47,119.12
2023-10-17 17:50,73,25,48,2642,898,1744,3119880.0,1056647.0,2063232.0,58,13,45,2731,370,2361,3231910.0,433351.0,2798559.0,117.67,118.3,117.12,118.53
2023-10-17 17:55,44,19,25,1765,702,1063,2088600.0,819863.0,1268737.0,27,10,17,1766,806,960,2088092.0,941901.0,1146190.0,116.79,119.35,116.86,119.39
2023-10-17 18:00,155,88,67,8951,4758,4193,10600507.0,5596852.0,5003654.0,135,72,63,8407,4325,4082,9953077.0,5081009.0,4872067.0,117.63,119.33,117.48,119.35
2023-10-17 18:05,180,96,84,8986,4295,4691,10635693.0,5062137.0,5573556.0,166,86,80,8688,4146,4542,10287117.0,4885172.0,5401944.0,117.86,118.81,117.83,118.93
2023-10-17 18:10,197,122,75,14150,7911,6239,16778477.0,9319092.0,7459385.0,173,113,60,13400,7464,5936,15869695.0,8768946.0,7100749.0,117.8,119.56,117.48,119.62
2023-10-17 18:15,435,367,68,18539,11623,6916,21931599.0,13649824.0,8281774.0,430,367,63,18495,11824,6671,21817252.0,13812289.0,8004963.0,117.44,119.75,116.82,120.0
2023-10-17 18:20,270,217,53,11589,8002,3587,13709412.0,9423928.0,4285484.0,258,209,49,11479,7959,3520,13584948.0,9372159.0,4212789.0,117.77,119.47,117.76,119.68
2023-10-17 18:25,378,214,164,20533,11755,8778,24299377.0,13781053.0,10518324.0,357,207,150,20230,11585,8645,23944440.0,13579752.0,10364688.0,117.24,119.83,117.22,119.89
2023-10-17 18:30,193,76,117,7458,2453,5005,8680924.0,2877772.0,5803151.0,182,68,114,7193,2649,4544,8512100.0,3104955.0,5407145.0,117.32,115.95,117.21,119.0
2023-10-17 18:35,207,66,141,7098,977,6121,8333836.0,1152646.0,7181190.0,199,61,138,6689,873,5816,7914323.0,1022836.0,6891487.0,117.98,117.32,117.16,118.49
2023-10-18 10:00,1801,830,971,52981,29381,23600,63705117.0,34592716.0,29112400.0,858,559,299,37171,22959,14212,44041987.0,27156690.0,16885296.0,117.74,123.36,118.28,118.81
2023-10-18 10:05,622,92,530,25925,1598,24327,30667512.0,1706542.0,28960970.0,536,53,483,23788,1111,22677,28236051.0,1297866.0,26938185.0,106.79,119.05,116.82,118.79
2023-10-18 10:10,760,286,474,15712,5451,10261,18640475.0,6415411.0,12225064.0,430,121,309,11921,3338,8583,14126608.0,3936879.0,10189728.0,117.69,119.14,117.94,118.72
2023-10-18 10:15,303,107,196,16728,7041,9687,19852885.0,8225482.0,11627403.0,240,72,168,13020,5731,7289,15423064.0,6697552.0,8725512.0,116.82,120.03,116.87,119.71
2023-10-18 10:20,548,138,410,21228,8790,12438,25164847.0,10282121.0,14882726.0,499,105,394,20560,8601,11959,24340252.0,10032491.0,14307761.0,116.98,119.66,116.64,119.64
2023-10-18 10:25,1037,503,534,47623,26655,20968,56689128.0,31392395.0,25296732.0,918,450,468,44948,25522,19426,53434558.0,30045561.0,23388997.0,117.77,120.64,117.72,120.4
2023-10-18 10:30,1876,1107,769,83698,47583,36115,102362966.0,58731643.0,43631322.0,1682,1024,658,76326,44151,32175,91090002.0,52214425.0,38875576.0,123.43,120.81,118.26,120.83
2023-10-18 10:35,829,528,301,36260,21633,14627,43204465.0,25527287.0,17677178.0,733,493,240,34659,21491,13168,41290473.0,25369675.0,15920797.0,118.0,120.85,118.05,120.91
2023-10-18 10:40,1607,958,649,84652,46010,38642,100873240.0,54444031.0,46429209.0,1484,909,575,80066,44518,35548,95565139.0,52596612.0,42968526.0,118.33,120.15,118.15,120.87
2023-10-18 10:45,740,340,400,44692,21412,23280,53122488.0,25006373.0,28116115.0,685,316,369,41031,18750,22281,48930930.0,22055262.0,26875668.0,116.79,120.77,117.63,120.62
2023-10-18 10:50,896,310,586,29856,12352,17504,35804467.0,14597315.0,21207152.0,841,289,552,26245,11700,14545,32204093.0,14679575.0,17524518.0,118.18,121.16,125.47,120.48
2023-10-18 10:55,570,224,346,20044,7524,12520,23864523.0,8862460.0,15002063.0,540,213,327,19532,7775,11757,23283333.0,9161219.0,14122113.0,117.79,119.82,117.83,120.12
2023-10-18 11:00,558,300,258,19635,9458,10177,23361144.0,11154669.0,12206474.0,521,277,244,18871,9080,9791,22466461.0,10678997.0,11787464.0,117.94,119.94,117.61,120.39
2023-10-18 11:05,312,145,167,13332,5987,7345,15817440.0,7050873.0,8766566.0,308,153,155,13330,5959,7371,15931655.0,7000817.0,8930838.0,117.77,119.35,117.48,121.16
2023-10-18 11:10,622,206,416,32157,13837,18320,38203243.0,16232145.0,21971097.0,573,187,386,29790,13406,16384,35393948.0,15725643.0,19668305.0,117.31,119.93,117.3,120.05
2023-10-18 11:15,557,158,399,24908,11290,13618,29543309.0,13246077.0,16297232.0,539,156,383,23692,11259,12433,28138220.0,13207556.0,14930664.0,117.33,119.67,117.31,120.09
2023-10-18 11:20,197,66,131,11934,3890,8044,14205492.0,4572369.0,9633123.0,182,60,122,12185,3943,8242,14488448.0,4616133.0,9872314.0,117.54,119.76,117.07,119.78
2023-10-18 11:25,442,266,176,12958,4341,8617,15289269.0,5098738.0,10190530.0,418,255,163,12397,4307,8090,14717023.0,5059768.0,9657255.0,117.46,118.26,117.48,119.37
2023-10-18 11:30,1035,624,411,32865,10176,22689,38860586.0,11926759.0,26933826.0,993,598,395,32300,9946,22354,38317814.0,11654158.0,26663655.0,117.2,118.71,117.17,119.28
2023-10-18 11:35,743,244,499,34627,10138,24489,41079907.0,11853715.0,29226191.0,703,219,484,33427,9839,23588,39639836.0,11501971.0,28137865.0,116.92,119.34,116.9,119.29
2023-10-18 11:40,452,127,325,22295,6248,16047,26497262.0,7319750.0,19177511.0,424,111,313,21250,6086,15164,25192540.0,7111186.0,18081354.0,117.15,119.51,116.84,119.24
2023-10-18 11:45,271,127,144,13324,5234,8090,15801321.0,6134538.0,9666783.0,245,111,134,13083,5004,8079,15502881.0,5847036.0,9655845.0,117.21,119.49,116.85,119.52
2023-10-18 11:50,161,57,104,8345,3903,4442,9915862.0,4597364.0,5318497.0,150,56,94,7719,3457,4262,9159879.0,4041862.0,5118017.0,117.79,119.73,116.92,120.08
2023-10-18 11:55,94,33,61,3694,1728,1966,4349790.0,2028073.0,2321716.0,81,28,53,2776,1389,1387,3290410.0,1627641.0,1662768.0,117.37,118.09,117.18,119.88
2023-10-18 12:00,42,20,22,2778,1501,1277,3285565.0,1761994.0,1523571.0,28,14,14,4041,3163,878,4552633.0,3497623.0,1055010.0,117.39,119.31,110.58,120.16
2023-10-18 12:05,29,17,12,273,195,78,326452.0,231414.0,95037.0,23,8,15,1072,95,977,1276744.0,112264.0,1164480.0,118.67,121.84,118.17,119.19
2023-10-18 12:10,42,22,20,1055,291,764,1241773.0,356693.0,885080.0,22,10,12,709,135,574,843684.0,158421.0,685263.0,122.57,115.85,117.35,119.38
2023-10-18 12:15,86,41,45,5066,2229,2837,5870024.0,2616349.0,3253674.0,53,22,31,4526,2062,2464,5373972.0,2411153.0,2962819.0,117.38,114.69,116.93,120.24
2023-10-18 12:20,43,26,17,1942,916,1026,2314905.0,1078671.0,1236234.0,26,17,9,1989,1446,543,2316734.0,1665922.0,650811.0,117.76,120.49,115.21,119.85
2023-10-18 12:25,76,36,40,7551,2349,5202,8940874.0,2745486.0,6195387.0,57,26,31,5039,2177,2862,5976110.0,2540045.0,3436065.0,116.88,119.1,116.68,120.06
2023-10-18 12:30,126,50,76,6867,3891,2976,8150329.0,4568999.0,3581329.0,105,40,65,5683,2727,2956,6736844.0,3188723.0,3548121.0,117.42,120.34,116.93,120.03
2023-10-18 12:35,1688,979,709,71663,49370,22293,85050517.0,58260331.0,26790186.0,1656,968,688,70781,49699,21082,83995673.0,58646458.0,25349215.0,118.01,120.17,118.0,120.24
2023-10-18 12:40,1194,806,388,51253,35762,15491,60853311.0,42200957.0,18652354.0,1177,798,379,53757,35650,18107,63829949.0,42065528.0,21764421.0,118.01,120.41,118.0,120.2
2023-10-18 12:45,529,300,229,14767,9540,5227,17549432.0,11297739.0,6251693.0,521,295,226,14809,9467,5342,17585489.0,11198047.0,6387442.0,118.42,119.6,118.29,119.57
2023-10-18 12:50,1516,1331,185,48688,40953,7735,57752610.0,48445359.0,9307250.0,1503,1326,177,48627,40884,7743,57704069.0,48375783.0,9328286.0,118.3,120.33,118.32,120.47
2023-10-18 12:55,1219,708,511,57491,37038,20453,68222547.0,43694899.0,24527648.0,1183,690,493,53951,36526,17425,64001413.0,43075036.0,20926377.0,117.97,119.92,117.93,120.09
2023-10-18 13:00,819,432,387,40184,21642,18542,47718714.0,25486460.0,22232253.0,808,428,380,40145,21697,18448,47658532.0,25537994.0,22120538.0,117.76,119.9,117.7,119.91
2023-10-18 13:05,977,697,280,33678,22098,11580,39971336.0,26088769.0,13882567.0,954,682,272,33326,21896,11430,39545199.0,25845034.0,13700165.0,118.06,119.88,118.04,119.86
2023-10-18 13:10,137,86,51,6256,4153,2103,7430210.0,4900989.0,2529221.0,120,75,45,4939,2865,2074,5865545.0,3371129.0,2494415.0,118.01,120.27,117.67,120.27
2023-10-18 13:15,590,225,365,11892,5537,6355,14150182.0,6526426.0,7623756.0,564,214,350,11598,5410,6188,13790514.0,6370048.0,7420466.0,117.87,119.96,117.75,119.92
2023-10-18 13:20,217,107,110,22979,12928,10051,27393422.0,15268504.0,12124918.0,178,89,89,18916,9162,9754,22526970.0,10756244.0,11770725.0,118.1,120.63,117.4,120.68
2023-10-18 13:25,699,262,437,27275,9218,18057,32468264.0,10873405.0,21594858.0,661,251,410,29846,12694,17152,35525807.0,15007317.0,20518489.0,117.96,119.59,118.22,119.63
2023-10-18 13:30,2114,180,1934,93374,15395,77979,111034078.0,18045475.0,92988602.0,2109,174,1935,93101,15180,77921,110717583.0,17796996.0,92920586.0,117.22,119.25,117.24,119.25
2023-10-18 13:35,1411,83,1328,51128,6197,44931,60798737.0,7279075.0,53519662.0,1395,75,1320,51085,6211,44874,60760707.0,7286265.0,53474442.0,117.46,119.12,117.31,119.17
2023-10-18 13:40,176,98,78,7711,3490,4221,9149048.0,4106242.0,5042806.0,159,93,66,7493,3418,4075,8901616.0,4018606.0,4883009.0,117.66,119.47,117.57,119.83
2023-10-18 13:45,1490,882,608,70032,37398,32634,83201893.0,44176409.0,39025484.0,1482,875,607,70159,37273,32886,83369749.0,43995156.0,39374592.0,118.13,119.59,118.03,119.73
2023-10-18 13:50,1929,1575,354,74977,55527,19450,89007541.0,65672881.0,23334660.0,1906,1568,338,74503,55413,19090,88474510.0,65538425.0,22936085.0,118.27,119.97,118.27,120.15
2023-10-18 13:55,476,81,395,14148,4313,9835,16783165.0,5053618.0,11729546.0,459,71,388,14575,4300,10275,17323244.0,5038373.0,12284871.0,117.17,119.26,117.17,119.56
2023-10-18 14:00,403,17,386,12760,193,12567,15319302.0,229364.0,15089937.0,397,15,382,12207,143,12064,14517370.0,169080.0,14348289.0,118.84,120.08,118.24,118.93
2023-10-18 14:05,2225,599,1626,87950,27454,60496,103663452.0,32163751.0,71499701.0,2006,464,1542,80139,23661,56478,94997498.0,27738257.0,67259240.0,117.16,118.19,117.23,119.09
2023-10-18 14:10,1099,182,917,42260,11104,31156,49910006.0,12946481.0,36963524.0,1022,126,896,40761,9852,30909,48162781.0,11474936.0,36687845.0,116.59,118.64,116.47,118.7
2023-10-18 14:15,1230,344,886,38128,14785,23343,45076014.0,17304994.0,27771019.0,1198,319,879,37744,14605,23139,44624358.0,17088908.0,27535449.0,117.04,118.97,117.01,119.0
2023-10-18 14:20,527,202,325,23108,8165,14943,27350247.0,9552248.0,17797998.0,511,196,315,23645,8780,14865,27943716.0,10236443.0,17707272.0,116.99,119.11,116.59,119.12
2023-10-18 14:25,408,123,285,20094,6628,13466,23780624.0,7743091.0,16037533.0,390,110,280,23478,7495,15983,27806563.0,8758547.0,19048016.0,116.82,119.1,116.86,119.18
2023-10-18 14:30,139,41,98,5416,1075,4341,6418375.0,1258024.0,5160351.0,129,34,95,5229,1070,4159,6198382.0,1250547.0,4947834.0,117.03,118.87,116.87,118.97
2023-10-18 14:35,353,44,309,12210,2515,9695,14459488.0,2928709.0,11530779.0,340,38,302,9683,2765,6918,11440227.0,3212057.0,8228169.0,116.45,118.94,116.17,118.94
2023-10-18 14:40,193,135,58,5048,2117,2931,6053731.0,2519630.0,3534101.0,169,119,50,3807,2026,1781,4500683.0,2378299.0,2122383.0,119.02,120.58,117.39,119.17
2023-10-18 14:45,543,401,142,35774,20089,15685,42415381.0,23630906.0,18784475.0,522,393,129,35360,19766,15594,41924535.0,23177415.0,18747120.0,117.63,119.76,117.26,120.22
2023-10-18 14:50,1016,894,122,43553,32765,10788,51530585.0,38587789.0,12942796.0,1000,882,118,42577,31811,10766,50374532.0,37457811.0,12916721.0,117.77,119.97,117.75,119.98
2023-10-18 14:55,1126,945,181,60185,38855,21330,71280907.0,45664577.0,25616330.0,1124,948,176,59284,38956,20328,70177247.0,45780597.0,24396650.0,117.53,120.1,117.52,120.02
2023-10-18 15:00,126,65,61,7100,3433,3667,8392261.0,4011356.0,4380905.0,119,61,58,6794,3151,3643,8040969.0,3683965.0,4357004.0,116.85,119.47,116.91,119.6
2023-10-18 15:05,1654,1103,551,69672,49726,19946,85997235.0,59756992.0,26240243.0,1625,1093,532,69447,49788,19659,82320978.0,58725445.0,23595532.0,120.17,131.56,117.95,120.02
2023-10-18 15:10,1555,850,705,56680,35809,20871,67198639.0,42183998.0,25014640.0,1538,842,696,55797,35714,20083,66146204.0,42069630.0,24076574.0,117.8,119.85,117.8,119.89
2023-10-18 15:15,1951,1467,484,100218,68676,31542,118818418.0,80896879.0,37921538.0,1929,1456,473,99972,68457,31515,118528298.0,80637792.0,37890505.0,117.79,120.23,117.79,120.23
2023-10-18 15:20,1138,981,157,53570,39677,13893,63514132.0,46795473.0,16718659.0,1115,973,142,51223,39592,11631,60697006.0,46700505.0,13996500.0,117.94,120.34,117.95,120.34
2023-10-18 15:25,115,58,57,4739,2468,2271,5597231.0,2875821.0,2721409.0,107,53,54,4823,2058,2765,5868670.0,2410037.0,3458633.0,116.52,119.83,117.11,125.09
2023-10-18 15:30,580,414,166,25346,16115,9231,30012345.0,18926744.0,11085600.0,572,414,158,26750,16152,10598,31685997.0,18970574.0,12715423.0,117.45,120.09,117.45,119.98
2023-10-18 15:35,421,234,187,24093,12953,11140,28511984.0,15188356.0,13323627.0,416,230,186,24402,13415,10987,28893649.0,15721429.0,13172219.0,117.26,119.6,117.19,119.89
2023-10-18 15:40,465,185,280,17074,8456,8618,20224965.0,9914304.0,10310661.0,453,185,268,17464,8898,8566,20667289.0,10417952.0,10249337.0,117.25,119.64,117.08,119.65
2023-10-18 15:45,657,565,92,10496,6511,3985,12428886.0,7683093.0,4745792.0,658,569,89,10650,6672,3978,12604294.0,7866343.0,4737951.0,118.0,119.09,117.9,119.1
2023-10-18 15:50,1215,522,693,58076,24388,33688,68744790.0,28499049.0,40245740.0,1209,523,686,57942,24336,33606,68588001.0,28437366.0,40150635.0,116.86,119.47,116.85,119.47
2023-10-18 15:55,792,477,315,29506,12841,16665,34896414.0,15002986.0,19893428.0,772,463,309,30155,12840,17315,35695785.0,15004643.0,20691141.0,116.84,119.37,116.86,119.5
2023-10-18 16:00,1382,930,452,53037,23298,29739,62388522.0,27180569.0,35207952.0,1325,900,425,50101,22138,27963,59125296.0,25815076.0,33310220.0,116.66,118.39,116.61,119.12
2023-10-18 16:05,582,290,292,34582,14841,19741,40770407.0,17253353.0,23517054.0,560,280,280,34671,14568,20103,40897516.0,16941271.0,23956244.0,116.25,119.13,116.29,119.17
2023-10-18 16:10,627,372,255,24384,10375,14009,28706450.0,12074959.0,16631491.0,578,340,238,24917,11284,13633,29312842.0,13112885.0,16199957.0,116.39,118.72,116.21,118.83
2023-10-18 16:15,395,260,135,18165,8208,9957,21433385.0,9581517.0,11851867.0,369,240,129,17489,7632,9857,20603851.0,8868382.0,11735469.0,116.73,119.03,116.2,119.06
2023-10-18 16:20,380,278,102,13439,6214,7225,15816428.0,7239201.0,8577226.0,354,257,97,12636,5647,6989,14886933.0,6564467.0,8322465.0,116.5,118.72,116.25,119.08
2023-10-18 16:25,595,263,332,29722,11499,18223,34942236.0,13385097.0,21557139.0,559,238,321,29059,11281,17778,34259245.0,13107972.0,21151273.0,116.4,118.3,116.2,118.97
2023-10-18 16:30,259,148,111,13422,6375,7047,15801925.0,7406677.0,8395248.0,229,130,99,12754,6095,6659,15012188.0,7074117.0,7938070.0,116.18,119.13,116.06,119.21
2023-10-18 16:35,174,124,50,3962,2157,1805,4665487.0,2519432.0,2146054.0,162,111,51,3786,2057,1729,4459321.0,2400144.0,2059177.0,116.8,118.9,116.68,119.1
2023-10-18 16:40,550,192,358,15222,7678,7544,17913412.0,8948408.0,8965004.0,488,145,343,14600,7219,7381,17192852.0,8409300.0,8783552.0,116.55,118.84,116.49,119.0
2023-10-18 16:45,110,49,61,4135,1928,2207,4873380.0,2249404.0,2623976.0,109,43,66,3786,1572,2214,4461704.0,1829726.0,2631978.0,116.67,118.89,116.39,118.88
2023-10-18 16:50,128,74,54,5784,3307,2477,6835845.0,3883653.0,2952192.0,102,61,41,5274,2877,2397,6212715.0,3354492.0,2858222.0,117.44,119.18,116.6,119.24
2023-10-18 16:55,462,133,329,19726,8410,11316,23256118.0,9815788.0,13440330.0,443,114,329,18417,7723,10694,21729739.0,8998132.0,12731607.0,116.72,118.77,116.51,119.05
2023-10-18 17:00,397,96,301,21535,6495,15040,25425537.0,7550759.0,17874777.0,375,89,286,21505,6517,14988,25389063.0,7576675.0,17812388.0,116.25,118.85,116.26,118.84
2023-10-18 17:05,151,27,124,8554,2113,6441,10099174.0,2455610.0,7643564.0,144,24,120,8371,2058,6313,9883230.0,2390856.0,7492374.0,116.21,118.67,116.17,118.68
2023-10-18 17:10,806,441,365,33486,12273,21213,39496928.0,14339118.0,25157809.0,759,411,348,33392,11826,21566,39450829.0,13777198.0,25673631.0,116.83,118.6,116.5,119.05
2023-10-18 17:15,318,69,249,17072,3544,13528,20149621.0,4121513.0,16028108.0,303,66,237,16898,3564,13334,19953421.0,4143134.0,15810286.0,116.3,118.48,116.25,118.57
2023-10-18 17:20,276,79,197,16796,5159,11637,19845412.0,6024231.0,13821181.0,247,63,184,16414,4892,11522,19372209.0,5684458.0,13687750.0,116.77,118.77,116.2,118.8
2023-10-18 17:25,407,124,283,15127,7543,7584,17875495.0,8846808.0,9028687.0,398,116,282,14592,7077,7515,17214412.0,8267486.0,8946926.0,117.29,119.05,116.82,119.05
2023-10-18 17:30,328,96,232,17143,6768,10375,20237530.0,7871137.0,12366392.0,312,87,225,15565,6557,9008,18384086.0,7645509.0,10738577.0,116.3,119.19,116.6,119.21
2023-10-18 17:35,447,192,255,19516,9080,10436,23005603.0,10575632.0,12429970.0,426,171,255,18485,8106,10379,21817499.0,9435272.0,12382226.0,116.47,119.11,116.4,119.3
2023-10-18 17:40,298,55,243,6441,1659,4782,7595255.0,1933755.0,5661499.0,292,52,240,8132,2171,5961,9619745.0,2536363.0,7083381.0,116.56,118.39,116.83,118.83
2023-10-18 17:45,421,77,344,13664,4838,8826,16134671.0,5638814.0,10495857.0,409,70,339,13455,4716,8739,15887195.0,5494680.0,10392515.0,116.55,118.92,116.51,118.92
2023-10-18 17:50,306,35,271,8268,2786,5482,9744413.0,3230595.0,6513818.0,298,28,270,8176,2701,5475,9653694.0,3146035.0,6507659.0,115.96,118.82,116.48,118.86
2023-10-18 17:55,310,94,216,19515,8698,10817,23009244.0,10107845.0,12901399.0,289,78,211,19288,8390,10898,22778210.0,9782086.0,12996124.0,116.21,119.27,116.59,119.25
2023-10-18 18:00,419,230,189,25637,17196,8441,30779999.0,20678108.0,10101891.0,386,218,168,23062,15302,7760,27282349.0,17985987.0,9296362.0,120.25,119.68,117.54,119.8
2023-10-18 18:05,2076,1274,802,132875,86326,46549,157571108.0,101704154.0,55866953.0,1949,1219,730,128166,83454,44712,151845875.0,98149032.0,53696843.0,117.81,120.02,117.61,120.09
2023-10-18 18:10,774,219,555,33958,17539,16419,40332895.0,20627025.0,19705870.0,738,215,523,32925,17393,15532,39048831.0,20426963.0,18621867.0,117.61,120.02,117.44,119.89
2023-10-18 18:15,1040,408,632,50248,25373,24875,59970288.0,30197081.0,29773207.0,1009,391,618,47997,24283,23714,56947802.0,28584621.0,28363181.0,119.01,119.69,117.71,119.61
2023-10-18 18:20,318,246,72,17310,14166,3144,20523210.0,16737382.0,3785828.0,299,240,59,16270,13623,2647,19311494.0,16118981.0,3192513.0,118.15,120.41,118.32,120.61
2023-10-18 18:25,521,442,79,17845,14726,3119,21204307.0,17430251.0,3774056.0,507,444,63,17891,15161,2730,21216408.0,17936811.0,3279597.0,118.36,121.0,118.31,120.13
2023-10-18 18:30,715,608,107,37839,25820,12019,44862186.0,30427064.0,14435122.0,694,602,92,36089,25282,10807,42802323.0,29796281.0,13006042.0,117.84,120.1,117.86,120.35
2023-10-18 18:35,657,453,204,21478,14632,6846,25417175.0,17271390.0,8145785.0,648,455,193,19208,13890,5318,22765937.0,16384944.0,6380993.0,118.04,118.99,117.96,119.99
2023-10-19 10:00,3380,1600,1780,68428,47857,20571,81689505.0,55975804.0,25713700.0,2505,1343,1162,54876,43457,11419,64974738.0,51400730.0,13574007.0,116.96,125.0,118.28,118.87
2023-10-19 10:05,1813,911,902,47000,19963,27037,55637533.0,23567241.0,32070291.0,1708,866,842,42437,18783,23654,50219447.0,22173922.0,28045525.0,118.05,118.62,118.05,118.57
2023-10-19 10:10,965,570,395,21599,7742,13857,25554401.0,9100881.0,16453520.0,913,545,368,19710,7150,12560,23340485.0,8437384.0,14903101.0,117.55,118.74,118.01,118.66
2023-10-19 10:15,554,387,167,15492,6558,8934,20704716.0,7679740.0,13024976.0,513,371,142,13177,6267,6910,15580849.0,7339456.0,8241392.0,117.1,145.79,117.11,119.27
2023-10-19 10:20,1131,356,775,39569,13466,26103,46856300.0,15681111.0,31175189.0,851,223,628,38154,12855,25299,45205334.0,14978961.0,30226373.0,116.45,119.43,116.52,119.48
2023-10-19 10:25,436,165,271,20022,7816,12206,23564269.0,9012873.0,14551396.0,411,150,261,19837,7129,12708,23477773.0,8314749.0,15163024.0,115.31,119.22,116.63,119.32
2023-10-19 10:30,751,476,275,19385,7829,11556,22909215.0,9143730.0,13765484.0,697,465,232,17279,7144,10135,20422328.0,8342040.0,12080288.0,116.79,119.12,116.77,119.19
2023-10-19 10:35,951,674,277,21751,9043,12708,25401249.0,10584405.0,14816844.0,892,641,251,21280,8570,12710,25162201.0,10019009.0,15143192.0,117.05,116.59,116.91,119.14
2023-10-19 10:40,362,134,228,16888,7558,9330,19976214.0,8832951.0,11143263.0,322,112,210,16530,7541,8989,19528048.0,8794541.0,10733507.0,116.87,119.43,116.62,119.41
2023-10-19 10:45,296,193,103,11373,5342,6031,13427669.0,6230298.0,7197371.0,263,173,90,11191,5192,5999,13216672.0,6057158.0,7159514.0,116.63,119.34,116.66,119.35
2023-10-19 10:50,916,342,574,41363,9794,31569,48892552.0,11415546.0,37477006.0,890,327,563,40717,9496,31221,48144656.0,11073532.0,37071123.0,116.56,118.71,116.61,118.74
2023-10-19 10:55,163,89,74,7061,3804,3257,8255055.0,4422727.0,3832328.0,112,46,66,6329,2885,3444,7464377.0,3358708.0,4105669.0,116.27,117.66,116.42,119.21
2023-10-19 11:00,545,405,140,21003,10062,10941,24714628.0,11707983.0,13006645.0,502,374,128,21296,9883,11413,25113573.0,11496643.0,13616930.0,116.36,118.88,116.33,119.31
2023-10-19 11:05,527,226,301,33983,14836,19147,39994222.0,17228692.0,22765529.0,473,185,288,33020,14392,18628,38904616.0,16710028.0,22194587.0,116.13,118.9,116.11,119.15
2023-10-19 11:10,1029,194,835,41647,14426,27221,49003609.0,16705480.0,32298129.0,986,163,823,39363,12780,26583,46384726.0,14831690.0,31553035.0,115.8,118.65,116.05,118.7
2023-10-19 11:15,197,94,103,8983,3897,5086,10586701.0,4536525.0,6050176.0,175,87,88,8263,3790,4473,9728628.0,4401800.0,5326828.0,116.41,118.96,116.14,119.09
2023-10-19 11:20,336,143,193,19147,8092,11055,22523529.0,9390628.0,13132900.0,316,130,186,17537,8107,9430,20626694.0,9406270.0,11220423.0,116.05,118.8,116.03,118.99
2023-10-19 11:25,341,194,147,18643,7996,10647,21899992.0,9313498.0,12586493.0,307,164,143,18081,7629,10452,21286118.0,8859624.0,12426494.0,116.48,118.22,116.13,118.89
2023-10-19 11:30,247,154,93,13717,7497,6220,16138723.0,8724754.0,7413968.0,199,126,73,12690,6772,5918,14930900.0,7870964.0,7059936.0,116.38,119.2,116.23,119.3
2023-10-19 11:35,1148,870,278,41778,30898,10880,49177981.0,36252761.0,12925219.0,1122,855,267,41235,30719,10516,48518745.0,36034793.0,12483951.0,117.33,118.8,117.3,118.71
2023-10-19 11:40,331,275,56,16226,11987,4239,19108857.0,14064691.0,5044166.0,313,263,50,15961,11835,4126,18785320.0,13873756.0,4911564.0,117.33,118.99,117.23,119.04
2023-10-19 11:45,1062,427,635,46767,19293,27474,55124507.0,22615761.0,32508746.0,1023,410,613,44552,18763,25789,52426601.0,21996073.0,30430528.0,117.22,118.33,117.23,118.0
2023-10-19 11:50,734,305,429,27462,10851,16611,32290577.0,12736853.0,19553723.0,705,286,419,26849,10719,16130,31593647.0,12578177.0,19015470.0,117.38,117.72,117.34,117.89
2023-10-19 11:55,1011,308,703,32291,8575,23716,38000682.0,10050757.0,27949924.0,994,294,700,31929,8378,23551,37577995.0,9820891.0,27757104.0,117.21,117.85,117.22,117.86
2023-10-19 12:00,1112,608,504,44208,21808,22400,51998127.0,25539206.0,26458921.0,1080,585,495,43495,21457,22038,51156844.0,25118282.0,26038562.0,117.11,118.12,117.06,118.15
2023-10-19 12:05,930,113,817,36031,6302,29729,42293654.0,7338892.0,34954761.0,891,84,807,34861,5547,29314,41002848.0,6453926.0,34548922.0,116.45,117.58,116.35,117.86
2023-10-19 12:10,779,276,503,25997,9727,16270,30578425.0,11405274.0,19173151.0,782,260,522,28071,9936,18135,33033292.0,11647129.0,21386163.0,117.25,117.84,117.22,117.93
2023-10-19 12:15,961,839,122,31079,26240,4839,36555360.0,30818159.0,5737200.0,930,828,102,30539,26147,4392,35920892.0,30709435.0,5211456.0,117.45,118.56,117.45,118.66
2023-10-19 12:20,381,334,47,12383,10281,2102,14563464.0,12064518.0,2498946.0,358,322,36,12418,10215,2203,14643677.0,11982612.0,2661065.0,117.35,118.88,117.3,120.79
2023-10-19 12:25,78,44,34,3071,1672,1399,3614460.0,1955601.0,1658859.0,59,28,31,2745,1365,1380,3227521.0,1590203.0,1637318.0,116.96,118.57,116.5,118.65
2023-10-19 12:30,1250,1202,48,42992,40380,2612,50542407.0,47442453.0,3099954.0,1238,1192,46,42431,40245,2186,49883309.0,47284301.0,2599007.0,117.49,118.68,117.49,118.89
2023-10-19 12:35,659,619,40,23530,21711,1819,27662115.0,25500950.0,2161165.0,652,616,36,24570,22717,1853,28821087.0,26619760.0,2201327.0,117.46,118.81,117.18,118.8
2023-10-19 12:40,87,43,44,4497,2376,2121,5295777.0,2786719.0,2509057.0,62,28,34,3778,2098,1680,4444164.0,2444862.0,1999301.0,117.29,118.3,116.53,119.01
2023-10-19 12:45,257,223,34,8550,6624,1926,10060232.0,7770978.0,2289253.0,246,216,30,8462,6567,1895,9950647.0,7696810.0,2253836.0,117.32,118.86,117.2,118.94
2023-10-19 12:50,378,328,50,16591,12692,3899,19496828.0,14858079.0,4638748.0,359,317,42,16327,12466,3861,19194322.0,14594471.0,4599851.0,117.07,118.97,117.07,119.14
2023-10-19 12:55,133,57,76,5659,2391,3268,6662764.0,2786910.0,3875854.0,113,42,71,4872,2231,2641,5726867.0,2599223.0,3127643.0,116.56,118.6,116.5,118.43
2023-10-19 13:00,72,37,35,3111,1629,1482,3657622.0,1909732.0,1747889.0,51,25,26,2845,1511,1334,3344478.0,1757866.0,1586612.0,117.23,117.94,116.34,118.94
2023-10-19 13:05,231,28,203,5464,565,4899,6433677.0,674589.0,5759088.0,211,12,199,5123,439,4684,6026660.0,512263.0,5514396.0,119.4,117.56,116.69,117.73
2023-10-19 13:10,660,358,302,26828,12415,14413,31435360.0,14579420.0,16855939.0,611,337,274,23200,11969,11231,27231935.0,13962398.0,13269536.0,117.43,116.95,116.65,118.15
2023-10-19 13:15,232,88,144,9295,3719,5576,10920808.0,4333361.0,6587446.0,206,66,140,8621,3276,5345,10117848.0,3801345.0,6316503.0,116.52,118.14,116.04,118.18
2023-10-19 13:20,534,456,78,16906,12687,4219,19842076.0,14847385.0,4994690.0,508,437,71,16761,12545,4216,19675768.0,14675309.0,5000459.0,117.03,118.39,116.98,118.61
2023-10-19 13:25,495,199,296,17879,7339,10540,20987516.0,8558182.0,12429333.0,446,168,278,16358,6462,9896,19214301.0,7530917.0,11683383.0,116.61,117.93,116.54,118.06
2023-10-19 13:30,447,319,128,17512,12577,4935,20564959.0,14729165.0,5835793.0,418,297,121,16848,12252,4596,19775573.0,14318898.0,5456675.0,117.11,118.25,116.87,118.73
2023-10-19 13:35,492,164,328,24956,9705,15251,29354042.0,11317086.0,18036956.0,472,146,326,24640,9395,15245,28945584.0,10915132.0,18030452.0,116.61,118.27,116.18,118.27
2023-10-19 13:40,1920,1640,280,97931,76643,21288,115155325.0,89838148.0,25317177.0,1885,1618,267,96674,75763,20911,113675618.0,88804115.0,24871503.0,117.22,118.93,117.21,118.94
2023-10-19 13:45,1167,934,233,40984,32319,8665,48196647.0,37956669.0,10239977.0,1167,942,225,41375,33004,8371,48650909.0,38755970.0,9894938.0,117.44,118.18,117.43,118.2
2023-10-19 13:50,206,164,42,8989,6481,2508,10573234.0,7594162.0,2979071.0,195,155,40,8652,6148,2504,10175503.0,7200491.0,2975012.0,117.18,118.78,117.12,118.81
2023-10-19 13:55,181,116,65,12834,7336,5498,15111609.0,8567435.0,6544174.0,159,104,55,12202,7100,5102,14364650.0,8282170.0,6082480.0,116.79,119.03,116.65,119.22
2023-10-19 14:00,105,56,49,7205,3512,3693,8527135.0,4117108.0,4410026.0,78,46,32,6548,3404,3144,7709828.0,3961099.0,3748728.0,117.23,119.42,116.37,119.23
2023-10-19 14:05,361,274,87,16613,10114,6499,19544439.0,11848245.0,7696194.0,352,270,82,14903,9795,5108,17540679.0,11475109.0,6065569.0,117.15,118.42,117.15,118.75
2023-10-19 14:10,132,83,49,5289,2742,2547,6223874.0,3202903.0,3020971.0,110,70,40,4996,2740,2256,5871938.0,3197463.0,2674474.0,116.81,118.61,116.7,118.55
2023-10-19 14:15,541,134,407,16770,3907,12863,19702298.0,4569387.0,15132911.0,532,129,403,16736,3869,12867,19663164.0,4525120.0,15138043.0,116.95,117.65,116.96,117.65
2023-10-19 14:20,1103,131,972,33601,4329,29272,39459483.0,5055070.0,34404413.0,1102,133,969,33301,4147,29154,39125964.0,4842858.0,34283105.0,116.77,117.53,116.78,117.59
2023-10-19 14:25,451,129,322,11944,3733,8211,14023987.0,4365159.0,9658827.0,436,115,321,11862,3651,8211,13925706.0,4266948.0,9658757.0,116.93,117.63,116.87,117.63
2023-10-19 14:30,185,28,157,7380,1626,5754,8675913.0,1887656.0,6788257.0,176,20,156,7256,1562,5694,8525258.0,1809754.0,6715504.0,116.09,117.97,115.86,117.94
2023-10-19 14:35,34,20,14,3305,2556,749,3865781.0,2975437.0,890344.0,25,14,11,3269,2545,724,3824755.0,2963946.0,860809.0,116.41,118.87,116.46,118.9
2023-10-19 14:40,54,36,18,1189,644,545,1397515.0,752797.0,644718.0,41,25,16,1164,603,561,1367754.0,704221.0,663532.0,116.89,118.3,116.79,118.28
2023-10-19 14:45,830,40,790,28196,2347,25849,33134624.0,2723413.0,30411211.0,824,33,791,28684,2304,26380,33759593.0,2672745.0,31086847.0,116.04,117.65,116.0,117.84
2023-10-19 14:50,71,28,43,4193,1816,2377,4926410.0,2104048.0,2822361.0,52,18,34,3922,1732,2190,4607015.0,2005774.0,2601240.0,115.86,118.74,115.81,118.78
2023-10-19 14:55,50,27,23,2660,1356,1304,3125018.0,1574655.0,1550363.0,40,20,20,2520,1282,1238,2958706.0,1487048.0,1471657.0,116.12,118.89,115.99,118.87
2023-10-19 15:00,659,62,597,22926,3382,19544,26956658.0,3936212.0,23020446.0,649,55,594,22317,3283,19034,26234725.0,3810312.0,22424413.0,116.39,117.79,116.06,117.81
2023-10-19 15:05,443,39,404,17853,3522,14331,20969377.0,4079604.0,16889773.0,422,32,390,17292,3441,13851,20309806.0,3984522.0,16325283.0,115.83,117.85,115.8,117.86
2023-10-19 15:10,95,33,62,5280,2097,3183,6202716.0,2443688.0,3759027.0,83,26,57,5049,1880,3169,5935370.0,2179359.0,3756010.0,116.53,118.1,115.92,118.52
2023-10-19 15:15,41,19,22,1528,644,884,1758535.0,754143.0,1004392.0,26,9,17,2605,729,1876,3057013.0,850307.0,2206706.0,117.1,113.62,116.64,117.63
2023-10-19 15:20,791,380,411,25395,12733,12662,29804948.0,14912681.0,14892267.0,771,364,407,24941,12385,12556,29293188.0,14504758.0,14788430.0,117.12,117.61,117.12,117.78
2023-10-19 15:25,71,43,28,3734,2506,1228,4381535.0,2924125.0,1457409.0,61,35,26,2713,1492,1221,3185570.0,1735762.0,1449808.0,116.68,118.68,116.34,118.74
2023-10-19 15:30,74,41,33,4410,2147,2263,5182682.0,2498210.0,2684472.0,65,34,31,3852,1882,1970,4531594.0,2185709.0,2345885.0,116.36,118.62,116.14,119.08
2023-10-19 15:35,203,73,130,9524,4025,5499,11140848.0,4674127.0,6466721.0,186,61,125,9219,3943,5276,10821860.0,4574938.0,6246922.0,116.13,117.6,116.03,118.4
2023-10-19 15:40,62,35,27,4808,2431,2377,5644588.0,2818144.0,2826444.0,53,28,25,4570,2200,2370,5366565.0,2548098.0,2818466.0,115.93,118.91,115.82,118.92
2023-10-19 15:45,68,33,35,4629,2547,2082,5433827.0,2965820.0,2468007.0,63,30,33,4700,2636,2064,5520905.0,3061715.0,2459190.0,116.44,118.54,116.15,119.15
2023-10-19 15:50,102,63,39,7226,3632,3594,8509281.0,4230540.0,4278740.0,87,48,39,7020,3424,3596,8246852.0,3970949.0,4275903.0,116.48,119.05,115.97,118.91
2023-10-19 15:55,283,42,241,8601,2261,6340,10129044.0,2649781.0,7479263.0,260,27,233,8257,2043,6214,9708610.0,2369164.0,7339445.0,117.2,117.97,115.96,118.11
2023-10-19 16:00,46,26,20,1828,879,949,2183932.0,1061591.0,1122341.0,28,12,16,1611,705,906,1895205.0,817890.0,1077314.0,120.77,118.27,116.01,118.91
2023-10-19 16:05,128,74,54,6900,3849,3051,8102551.0,4486929.0,3615622.0,112,65,47,6439,3509,2930,7565746.0,4086915.0,3478830.0,116.57,118.51,116.47,118.73
2023-10-19 16:10,650,602,48,21460,19406,2054,25211942.0,22778813.0,2433129.0,636,590,46,21403,19345,2058,25145064.0,22705971.0,2439093.0,117.38,118.46,117.37,118.52
2023-10-19 16:15,373,237,136,16643,10442,6201,19531533.0,12241576.0,7289957.0,364,232,132,16350,10301,6049,19211721.0,12071383.0,7140338.0,117.23,117.56,117.19,118.04
2023-10-19 16:20,1298,987,311,65511,46989,18522,77119701.0,55146866.0,21972835.0,1283,976,307,63752,45182,18570,75033645.0,53016548.0,22017097.0,117.36,118.63,117.34,118.56
2023-10-19 16:25,2404,2185,219,121332,97862,23470,142908141.0,114889143.0,28018997.0,2367,2175,192,120206,97339,22867,141539098.0,114242039.0,27297058.0,117.4,119.38,117.37,119.37
2023-10-19 16:30,1626,1522,104,61899,55291,6608,72880853.0,65011383.0,7869470.0,1603,1509,94,61311,55164,6147,72186339.0,64861129.0,7325209.0,117.58,119.09,117.58,119.17
2023-10-19 16:35,964,654,310,31369,22353,9016,36930177.0,26272698.0,10657479.0,945,647,298,31133,22315,8818,36653431.0,26227307.0,10426124.0,117.54,118.21,117.53,118.24
2023-10-19 16:40,1110,447,663,45681,20480,25201,53685890.0,23967415.0,29718474.0,1088,436,652,44952,20319,24633,52893557.0,23762657.0,29130899.0,117.03,117.93,116.95,118.26
2023-10-19 16:45,646,97,549,32453,9044,23409,38184764.0,10495568.0,27689196.0,634,91,543,32177,8894,23283,37859787.0,10319215.0,27540572.0,116.05,118.28,116.02,118.29
2023-10-19 16:50,867,622,245,29921,18533,11388,35264059.0,21763949.0,13500110.0,841,602,239,29351,18079,11272,34532208.0,21162205.0,13370003.0,117.43,118.55,117.05,118.61
2023-10-19 16:55,723,630,93,28640,22553,6087,33703657.0,26449554.0,7254103.0,712,627,85,28571,22536,6035,33626983.0,26428587.0,7198395.0,117.28,119.17,117.27,119.28
2023-10-19 17:00,1052,939,113,30071,26195,3876,35353361.0,30757289.0,4596072.0,1049,935,114,30360,26528,3832,35588419.0,31044003.0,4544416.0,117.42,118.58,117.02,118.59
2023-10-19 17:05,1296,951,345,34728,25015,9713,40808541.0,29338509.0,11470032.0,1287,947,340,34830,25012,9818,40946321.0,29333510.0,11612811.0,117.28,118.09,117.28,118.28
2023-10-19 17:10,145,39,106,7238,1693,5545,8508252.0,1965594.0,6542658.0,131,29,102,6712,1664,5048,7899544.0,1931114.0,5968429.0,116.1,117.99,116.05,118.23
2023-10-19 17:15,651,473,178,14853,6749,8104,17477527.0,7895569.0,9581958.0,630,459,171,14710,6654,8056,17310968.0,7781674.0,9529294.0,116.99,118.24,116.95,118.29
2023-10-19 17:20,137,46,91,6488,2079,4409,7622368.0,2414822.0,5207546.0,123,40,83,6031,2026,4005,7090401.0,2352984.0,4737417.0,116.15,118.11,116.14,118.29
2023-10-19 17:25,95,53,42,3839,1618,2221,4452531.0,1882210.0,2570320.0,73,38,35,4601,2703,1898,5355351.0,3105991.0,2249360.0,116.33,115.73,114.91,118.51
2023-10-19 17:30,1769,749,1020,47516,7679,39837,55732734.0,8905110.0,46827624.0,1748,734,1014,45207,5532,39675,53128222.0,6449297.0,46678925.0,115.97,117.55,116.58,117.65
2023-10-19 17:35,88,31,57,4870,1629,3241,5744754.0,1910513.0,3834240.0,80,24,56,4763,1526,3237,5599313.0,1769675.0,3829638.0,117.28,118.3,115.97,118.31
2023-10-19 17:40,297,35,262,9904,1709,8195,11645151.0,1992976.0,9652174.0,282,24,258,9643,1410,8233,11334521.0,1637762.0,9696758.0,116.62,117.78,116.15,117.78
2023-10-19 17:45,51,11,40,2194,271,1923,2584642.0,315862.0,2268779.0,42,7,35,1925,257,1668,2266593.0,298079.0,1968514.0,116.55,117.98,115.98,118.02
2023-10-19 17:50,169,51,118,7399,2008,5391,8717117.0,2353621.0,6363496.0,147,38,109,7093,1826,5267,8342991.0,2122523.0,6220468.0,117.21,118.04,116.24,118.1
2023-10-19 17:55,326,37,289,10961,1398,9563,12894267.0,1629916.0,11264351.0,309,30,279,10313,1191,9122,12126694.0,1384066.0,10742627.0,116.59,117.79,116.21,117.77
2023-10-19 18:00,787,26,761,28503,2411,26092,33399240.0,2793694.0,30605545.0,774,24,750,27993,2414,25579,32915779.0,2796347.0,30119432.0,115.87,117.3,115.84,117.75
2023-10-19 18:05,983,20,963,30779,1575,29204,36181356.0,1824597.0,34356759.0,985,19,966,30559,1530,29029,35922021.0,1771133.0,34150888.0,115.85,117.64,115.76,117.64
2023-10-19 18:10,992,42,950,31772,2487,29285,37368419.0,2894402.0,34474017.0,978,30,948,31541,2235,29306,37088970.0,2590307.0,34498662.0,116.38,117.72,115.9,117.72
2023-10-19 18:15,623,345,278,16877,5176,11701,19827253.0,6007099.0,13820153.0,616,344,272,16726,5087,11639,19660410.0,5902301.0,13758109.0,116.06,118.11,116.03,118.21
2023-10-19 18:20,327,63,264,11468,2264,9204,13476989.0,2631134.0,10845855.0,320,59,261,11747,2422,9325,13807624.0,2812575.0,10995049.0,116.22,117.84,116.13,117.91
2023-10-19 18:25,1020,45,975,29433,668,28765,34593106.0,783509.0,33809597.0,1006,36,970,29356,697,28659,34510521.0,817757.0,33692763.0,117.29,117.54,117.33,117.56
2023-10-19 18:30,484,53,431,13689,840,12849,16087011.0,986568.0,15100442.0,475,46,429,13290,652,12638,15624002.0,765028.0,14858974.0,117.45,117.52,117.34,117.57
2023-10-19 18:35,1246,179,1067,34420,2303,32117,40156285.0,2710473.0,37445812.0,1198,149,1049,32443,2110,30333,38092774.0,2472943.0,35619831.0,117.69,116.59,117.2,117.43
2023-10-20 10:00,2757,1543,1214,58144,37503,20641,69246894.0,43708105.0,25538789.0,1791,1295,496,44147,32946,11201,51862024.0,38664480.0,13197544.0,116.55,123.73,117.36,117.82
2023-10-20 10:05,917,377,540,18117,4839,13278,21398470.0,5619360.0,15779109.0,688,253,435,11681,2688,8993,13698068.0,3122640.0,10575428.0,116.13,118.84,116.17,117.6
2023-10-20 10:10,217,121,96,3839,1345,2494,4532079.0,1562796.0,2969282.0,157,93,64,1972,996,976,2290116.0,1141455.0,1148661.0,116.19,119.06,114.6,117.69
2023-10-20 10:15,503,228,275,11541,4901,6640,13519964.0,5671109.0,7848854.0,226,104,122,9175,3678,5497,10775536.0,4261464.0,6514072.0,115.71,118.21,115.86,118.5
2023-10-20 10:20,1369,539,830,58256,25734,32522,68360587.0,29901132.0,38459455.0,1280,486,794,56730,25105,31625,66538627.0,29107450.0,37431176.0,116.19,118.26,115.94,118.36
2023-10-20 10:25,1104,665,439,42368,20271,22097,48880052.0,23351924.0,25528128.0,853,488,365,35052,16747,18305,40910248.0,19280600.0,21629648.0,115.2,115.53,115.13,118.16
2023-10-20 10:30,825,479,346,28055,14703,13352,32735864.0,16948409.0,15787454.0,689,387,302,25416,13802,11614,29633894.0,15918354.0,13715540.0,115.27,118.24,115.33,118.09
2023-10-20 10:35,859,398,461,43347,20817,22530,50547380.0,24001289.0,26546090.0,796,356,440,43115,20833,22282,50326721.0,24009240.0,26317481.0,115.3,117.83,115.25,118.11
2023-10-20 10:40,469,119,350,15582,5753,9829,18090162.0,6577766.0,11512396.0,424,80,344,15658,5979,9679,18230057.0,6839152.0,11390905.0,114.34,117.13,114.39,117.69
2023-10-20 10:45,904,234,670,36485,12455,24030,42340365.0,14306636.0,28033728.0,811,173,638,34062,11407,22655,39675221.0,13096377.0,26578844.0,114.87,116.66,114.81,117.32
2023-10-20 10:50,739,284,455,32866,13602,19264,38270500.0,15641433.0,22629067.0,651,226,425,31106,11779,19327,36222883.0,13526296.0,22696587.0,114.99,117.47,114.83,117.43
2023-10-20 10:55,673,301,372,21068,9279,11789,24558406.0,10689699.0,13868706.0,628,265,363,20086,8827,11259,23417635.0,10164661.0,13252974.0,115.2,117.64,115.15,117.71
2023-10-20 11:00,738,505,233,29754,18670,11084,34683389.0,21579461.0,13103928.0,645,455,190,27267,16503,10764,31823521.0,19090964.0,12732557.0,115.58,118.22,115.68,118.29
2023-10-20 11:05,939,255,684,31852,10814,21038,37120187.0,12452277.0,24667909.0,866,216,650,31318,10603,20715,36517580.0,12206035.0,24311545.0,115.15,117.25,115.12,117.36
2023-10-20 11:10,349,206,143,19876,9969,9907,23208011.0,11524233.0,11683778.0,293,173,120,18092,8915,9177,21076996.0,10252275.0,10824721.0,115.6,117.93,115.0,117.95
2023-10-20 11:15,609,227,382,21917,9253,12664,25326187.0,10616793.0,14709394.0,555,190,365,21212,8936,12276,24663583.0,10247348.0,14416234.0,114.74,116.15,114.67,117.43
2023-10-20 11:20,1180,249,931,39886,14197,25689,46389241.0,16278229.0,30111012.0,1118,206,912,39010,13727,25283,45378059.0,15738842.0,29639216.0,114.66,117.21,114.66,117.23
2023-10-20 11:25,281,105,176,13117,5781,7336,15171156.0,6618608.0,8552547.0,237,68,169,12438,5380,7058,14449269.0,6162461.0,8286808.0,114.49,116.58,114.54,117.41
2023-10-20 11:30,208,71,137,9303,3829,5474,10805956.0,4392266.0,6413689.0,145,37,108,8665,3323,5342,10079186.0,3804849.0,6274337.0,114.71,117.17,114.5,117.45
2023-10-20 11:35,575,181,394,28067,10402,17665,32610525.0,11967396.0,20643129.0,481,120,361,26977,9985,16992,31317778.0,11405259.0,19912518.0,115.05,116.86,114.22,117.19
2023-10-20 11:40,355,147,208,17315,6489,10826,20183168.0,7536411.0,12646756.0,289,91,198,14675,5516,9159,17068887.0,6334992.0,10733895.0,116.14,116.82,114.85,117.2
2023-10-20 11:45,1276,1092,184,63601,40499,23102,73970490.0,46704748.0,27265742.0,1232,1063,169,63244,40357,22887,73553557.0,46536471.0,27017085.0,115.32,118.02,115.31,118.05
2023-10-20 11:50,491,406,85,16267,11585,4682,18899948.0,13382664.0,5517284.0,451,381,70,14849,10311,4538,17262151.0,11910669.0,5351481.0,115.52,117.84,115.51,117.93
2023-10-20 11:55,338,144,194,9498,5488,4010,11052691.0,6328379.0,4724312.0,323,137,186,9202,5264,3938,10718074.0,6070345.0,4647728.0,115.31,117.81,115.32,118.02
2023-10-20 12:00,293,264,29,4774,2994,1780,5552823.0,3461460.0,2091363.0,276,253,23,4143,2894,1249,4818145.0,3344397.0,1473748.0,115.61,117.49,115.56,117.99
2023-10-20 12:05,52,30,22,2918,1424,1494,3394990.0,1635752.0,1759237.0,41,24,17,2851,1368,1483,3317181.0,1570614.0,1746567.0,114.87,117.75,114.81,117.77
2023-10-20 12:10,58,34,24,1967,1045,922,2290034.0,1205135.0,1084898.0,41,21,20,1724,774,950,2006799.0,889892.0,1116906.0,115.32,117.67,114.97,117.57
2023-10-20 12:15,593,322,271,27273,10675,16598,31160903.0,12252137.0,18908766.0,417,234,183,20857,7587,13270,24203640.0,8704034.0,15499606.0,114.77,113.92,114.72,116.8
2023-10-20 12:20,610,296,314,32967,15870,17097,38074283.0,18116086.0,19958196.0,433,164,269,31020,14621,16399,35875423.0,16675389.0,19200033.0,114.15,116.74,114.05,117.08
2023-10-20 12:25,1017,315,702,44897,19105,25792,51443524.0,21785863.0,29657660.0,844,164,680,37911,16368,21543,43647945.0,18607600.0,25040344.0,114.03,114.99,113.68,116.23
2023-10-20 12:30,807,417,390,29237,13880,15357,33710690.0,15831198.0,17879492.0,677,338,339,27853,13310,14543,32102959.0,15151703.0,16951256.0,114.06,116.43,113.84,116.56
2023-10-20 12:35,690,245,445,26108,9647,16461,30116527.0,11020307.0,19096219.0,630,202,428,26492,9766,16726,30513340.0,11109393.0,19403946.0,114.24,116.01,113.76,116.01
2023-10-20 12:40,102,50,52,4039,1910,2129,4648015.0,2176263.0,2471751.0,77,37,40,3993,1981,2012,4602967.0,2253227.0,2349740.0,113.94,116.1,113.74,116.79
2023-10-20 12:45,496,313,183,11663,6244,5419,13423870.0,7128524.0,6295346.0,457,278,179,11851,6641,5210,13627516.0,7571265.0,6056250.0,114.17,116.17,114.01,116.24
2023-10-20 12:50,743,364,379,25730,10095,15635,29601445.0,11495244.0,18106201.0,669,301,368,24088,9477,14611,27714359.0,10770203.0,16944155.0,113.87,115.81,113.65,115.97
2023-10-20 12:55,717,554,163,17032,10590,6442,19578607.0,12114461.0,7464146.0,628,478,150,14302,8718,5584,16441816.0,9963384.0,6478432.0,114.4,115.87,114.29,116.02
2023-10-20 13:00,685,342,343,22641,11669,10972,26050567.0,13356022.0,12694544.0,628,296,332,20311,10349,9962,23357574.0,11798047.0,11559526.0,114.46,115.7,114.0,116.04
2023-10-20 13:05,404,259,145,12374,7425,4949,14292423.0,8518848.0,5773574.0,344,216,128,10296,5702,4594,11866362.0,6510721.0,5355641.0,114.73,116.66,114.18,116.58
2023-10-20 13:10,784,280,504,27173,12610,14563,31401734.0,14430435.0,16971299.0,708,237,471,26251,11866,14385,30318766.0,13548529.0,16770237.0,114.44,116.54,114.18,116.58
2023-10-20 13:15,2017,649,1368,73112,26218,46894,84588294.0,30007136.0,54581157.0,1972,630,1342,72055,26010,46045,83373914.0,29768175.0,53605739.0,114.45,116.39,114.45,116.42
2023-10-20 13:20,1431,598,833,45675,23263,22412,52880327.0,26710224.0,26170103.0,1386,584,802,44704,22586,22118,51742933.0,25914726.0,25828207.0,114.82,116.77,114.74,116.77
2023-10-20 13:25,1395,980,415,51558,33928,17630,59820285.0,39126463.0,20693822.0,1327,939,388,50574,33789,16785,58614577.0,38899637.0,19714940.0,115.32,117.38,115.13,117.46
2023-10-20 13:30,382,296,86,24902,16337,8565,28885180.0,18802576.0,10082603.0,344,269,75,24670,16156,8514,28612813.0,18586955.0,10025857.0,115.09,117.72,115.05,117.76
2023-10-20 13:35,1228,570,658,59377,29578,29799,68969916.0,33964530.0,35005386.0,1201,558,643,57663,29532,28131,66891190.0,33911477.0,32979713.0,114.83,117.47,114.83,117.24
2023-10-20 13:40,962,302,660,47619,18766,28853,55248880.0,21526642.0,33722237.0,954,297,657,47720,18873,28847,55362541.0,21648216.0,33714324.0,114.71,116.88,114.7,116.87
2023-10-20 13:45,459,190,269,24630,11454,13176,28589355.0,13153147.0,15436208.0,437,180,257,24488,11499,12989,28414400.0,13196333.0,15218067.0,114.83,117.15,114.76,117.16
2023-10-20 13:50,597,373,224,23476,13068,10408,27241862.0,15055987.0,12185874.0,572,364,208,23211,13281,9930,26903798.0,15281054.0,11622744.0,115.21,117.08,115.06,117.05
2023-10-20 13:55,476,401,75,16016,11987,4029,18533486.0,13820842.0,4712644.0,460,389,71,16113,11431,4682,18660486.0,13183424.0,5477062.0,115.3,116.97,115.33,116.98
2023-10-20 14:00,686,160,526,22222,9931,12291,25729198.0,11355803.0,14373395.0,652,138,514,22084,9892,12192,25572794.0,11312931.0,14259863.0,114.35,116.94,114.36,116.96
2023-10-20 14:05,823,220,603,42780,18314,24466,49558391.0,20932918.0,28625473.0,781,204,577,42380,18038,24342,49103186.0,20614537.0,28488649.0,114.3,117.0,114.28,117.03
2023-10-20 14:10,718,161,557,37379,14436,22943,43291426.0,16482189.0,26809237.0,698,147,551,36880,14144,22736,42718772.0,16148427.0,26570345.0,114.17,116.85,114.17,116.86
2023-10-20 14:15,297,106,191,20242,8883,11359,23436347.0,10135541.0,13300806.0,276,95,181,19872,8809,11063,23000458.0,10047745.0,12952712.0,114.1,117.09,114.06,117.08
2023-10-20 14:20,135,40,95,6573,1689,4884,7616631.0,1931551.0,5685080.0,113,23,90,6540,1685,4855,7581353.0,1923830.0,5657522.0,114.36,116.4,114.17,116.53
2023-10-20 14:25,212,69,143,10218,3296,6922,11838305.0,3767221.0,8071084.0,165,39,126,9958,3155,6803,11535911.0,3602238.0,7933673.0,114.3,116.6,114.18,116.62
2023-10-20 14:30,97,57,40,3790,2167,1623,4374799.0,2476400.0,1898399.0,67,36,31,3595,2008,1587,4154077.0,2297247.0,1856829.0,114.28,116.97,114.4,117.0
2023-10-20 14:35,56,27,29,3180,1240,1940,3683379.0,1418917.0,2264462.0,44,20,24,3078,1157,1921,3564116.0,1318458.0,2245658.0,114.43,116.72,113.95,116.9
2023-10-20 14:40,130,40,90,8875,2146,6729,10298511.0,2450261.0,7848250.0,121,33,88,6607,2057,4550,7648867.0,2345713.0,5303154.0,114.18,116.63,114.04,116.55
2023-10-20 14:45,188,73,115,11947,5275,6672,13739781.0,6012898.0,7726883.0,166,60,106,11344,5083,6261,13113687.0,5797419.0,7316268.0,113.99,115.81,114.06,116.85
2023-10-20 14:50,799,79,720,35098,11079,24019,40535867.0,12608779.0,27927087.0,772,61,711,33753,9747,24006,39004160.0,11090951.0,27913208.0,113.81,116.27,113.79,116.28
2023-10-20 14:55,776,72,704,35910,11707,24203,41486623.0,13313819.0,28172804.0,764,66,698,35693,11683,24010,41239507.0,13292093.0,27947413.0,113.73,116.4,113.77,116.4
2023-10-20 15:00,501,69,432,23004,8692,14312,26640491.0,9959037.0,16681454.0,487,60,427,23175,8624,14551,26785277.0,9812532.0,16972745.0,114.58,116.56,113.78,116.64
2023-10-20 15:05,114,43,71,7968,3492,4476,9251535.0,3982243.0,5269291.0,91,31,60,9112,3332,5780,10555387.0,3800681.0,6754705.0,114.04,117.72,114.07,116.86
2023-10-20 15:10,120,41,79,6176,2555,3621,7132263.0,2907621.0,4224642.0,84,22,62,5947,2443,3504,6868050.0,2778062.0,4089988.0,113.8,116.67,113.72,116.72
2023-10-20 15:15,131,57,74,10870,5104,5766,12511091.0,5805561.0,6705530.0,108,45,63,10744,5262,5482,12389746.0,5985366.0,6404379.0,113.75,116.29,113.75,116.83
2023-10-20 15:20,143,60,83,9450,4790,4660,10894778.0,5452228.0,5442550.0,111,39,72,9276,4518,4758,10690567.0,5134788.0,5555778.0,113.83,116.79,113.65,116.77
2023-10-20 15:25,183,74,109,8770,4749,4021,10120466.0,5426799.0,4693667.0,140,56,84,7836,3963,3873,9038963.0,4516489.0,4522473.0,114.27,116.73,113.97,116.77
2023-10-20 15:30,248,72,176,14570,4680,9890,16855967.0,5342784.0,11513182.0,222,58,164,14160,4435,9725,16384188.0,5058107.0,11326081.0,114.16,116.41,114.05,116.46
2023-10-20 15:35,1309,372,937,71896,23387,48509,83140657.0,26657457.0,56483199.0,1297,366,931,71536,23436,48100,82722672.0,26710477.0,56012194.0,113.98,116.44,113.97,116.45
2023-10-20 15:40,1881,437,1444,134727,45697,89030,155872359.0,52085757.0,103786602.0,1876,432,1444,135078,45875,89203,156276647.0,52286687.0,103989960.0,113.98,116.57,113.98,116.58
2023-10-20 15:45,1250,211,1039,63436,20876,42560,73396891.0,23810223.0,49586667.0,1237,200,1037,62942,20565,42377,72824241.0,23452849.0,49371392.0,114.06,116.51,114.04,116.51
2023-10-20 15:50,1228,427,801,67325,20935,46390,77775238.0,23869108.0,53906130.0,1212,418,794,66300,20856,45444,76648707.0,23774649.0,52874058.0,114.02,116.2,113.99,116.35
2023-10-20 15:55,1703,510,1193,97113,29209,67904,112259292.0,33274395.0,78984897.0,1693,503,1190,97332,29249,68083,112511282.0,33316587.0,79194695.0,113.92,116.32,113.91,116.32
2023-10-20 16:00,1829,660,1169,76816,20335,56481,88834426.0,23196055.0,65638371.0,1796,634,1162,77083,20434,56649,89153169.0,23323205.0,65829964.0,114.07,116.21,114.14,116.21
2023-10-20 16:05,1897,659,1238,81708,18588,63120,94496457.0,21209993.0,73286464.0,1888,653,1235,81783,19268,62515,94579739.0,21994042.0,72585696.0,114.11,116.11,114.15,116.11
2023-10-20 16:10,902,409,493,40227,10125,30102,46539004.0,11550624.0,34988380.0,887,401,486,37806,9887,27919,43714749.0,11273691.0,32441058.0,114.08,116.23,114.03,116.2
2023-10-20 16:15,248,95,153,11850,3517,8333,13709535.0,4022452.0,9687083.0,237,91,146,12468,4215,8253,14398568.0,4804146.0,9594422.0,114.37,116.25,113.98,116.25
2023-10-20 16:20,152,67,85,9673,5245,4428,11167874.0,6004857.0,5163017.0,136,51,85,8235,3862,4373,9512586.0,4410135.0,5102451.0,114.49,116.6,114.19,116.68
2023-10-20 16:25,807,174,633,44742,18566,26176,51667505.0,21130488.0,30537016.0,797,162,635,44448,18156,26292,51326329.0,20655499.0,30670829.0,113.81,116.66,113.77,116.65
2023-10-20 16:30,394,115,279,27801,10750,17051,32176816.0,12238608.0,19938207.0,386,107,279,27234,10664,16570,31467097.0,12136346.0,19330750.0,113.85,116.93,113.81,116.66
2023-10-20 16:35,255,107,148,19868,8619,11249,22954315.0,9819155.0,13135159.0,251,107,144,20178,8989,11189,23297427.0,10232663.0,13064763.0,113.92,116.77,113.84,116.76
2023-10-20 16:40,407,131,276,28723,11395,17328,33233006.0,12971382.0,20261624.0,391,126,265,28216,11398,16818,32591063.0,12974429.0,19616633.0,113.83,116.93,113.83,116.64
2023-10-20 16:45,525,203,322,22188,7846,14342,25573087.0,8928049.0,16645037.0,463,170,293,20689,7273,13416,23865248.0,8271443.0,15593805.0,113.79,116.06,113.73,116.23
2023-10-20 16:50,1307,365,942,51419,14536,36883,59298361.0,16509588.0,42788773.0,1221,315,906,50456,14321,36135,58167899.0,16259208.0,41908691.0,113.58,116.01,113.53,115.98
2023-10-20 16:55,1548,1094,454,88613,49151,39462,102474562.0,56178416.0,46296145.0,1518,1066,452,87159,48671,38488,100477867.0,55592449.0,44885418.0,114.3,117.32,114.22,116.62
2023-10-20 17:00,578,382,196,36118,21474,14644,41631739.0,24521117.0,17110622.0,573,373,200,35557,20909,14648,40999648.0,23883760.0,17115888.0,114.19,116.84,114.23,116.85
2023-10-20 17:05,935,361,574,42925,20756,22169,49396504.0,23683536.0,25712968.0,901,343,558,42308,20666,21642,48766698.0,23576323.0,25190375.0,114.1,115.99,114.08,116.4
2023-10-20 17:10,1129,294,835,45918,15376,30542,52908069.0,17468765.0,35439304.0,1067,253,814,46939,14757,32182,54125093.0,16755488.0,37369604.0,113.61,116.03,113.54,116.12
2023-10-20 17:15,664,272,392,31547,9643,21904,36371751.0,10967172.0,25404578.0,617,242,375,31274,9567,21707,36064403.0,10884815.0,25179588.0,113.73,115.98,113.77,116.0
2023-10-20 17:20,907,349,558,47784,15880,31904,55058571.0,18051600.0,37006971.0,862,319,543,47711,16002,31709,55003894.0,18184870.0,36819023.0,113.68,115.99,113.64,116.12
2023-10-20 17:25,960,315,645,39403,8997,30406,45525486.0,10274433.0,35251052.0,922,293,629,39063,8843,30220,45131238.0,10096212.0,35035025.0,114.2,115.93,114.17,115.93
2023-10-20 17:30,1728,462,1266,106124,36181,69943,122616252.0,41196337.0,81419914.0,1690,438,1252,105712,35854,69858,122141007.0,40818857.0,81322149.0,113.86,116.41,113.85,116.41
2023-10-20 17:35,898,118,780,42425,10306,32119,49048223.0,11746197.0,37302025.0,871,101,770,42418,10308,32110,49032896.0,11741785.0,37291111.0,113.97,116.14,113.91,116.14
2023-10-20 17:40,591,104,487,26920,7726,19194,31161554.0,8837873.0,22323680.0,565,96,469,26643,7590,19053,30808359.0,8648435.0,22159923.0,114.39,116.31,113.95,116.31
2023-10-20 17:45,1474,180,1294,62453,17498,44955,72144171.0,19932373.0,52211798.0,1455,167,1288,62252,17427,44825,71941549.0,19841938.0,52099610.0,113.91,116.14,113.86,116.23
2023-10-20 17:50,192,83,109,13963,6128,7835,16129299.0,6983279.0,9146020.0,170,67,103,13049,5146,7903,15091984.0,5854982.0,9237002.0,113.96,116.73,113.78,116.88
2023-10-20 17:55,81,48,33,7359,3857,3502,8488142.0,4398969.0,4089173.0,70,39,31,7211,3848,3363,8313287.0,4387587.0,3925700.0,114.05,116.77,114.02,116.73
2023-10-20 18:00,1458,169,1289,62894,13390,49504,72521170.0,15211879.0,57309291.0,1428,150,1278,62371,13267,49104,71947373.0,15070780.0,56876593.0,113.61,115.77,113.6,115.83
2023-10-20 18:05,888,166,722,51272,13654,37618,59142000.0,15518434.0,43623566.0,853,143,710,50979,13421,37558,58807130.0,15240371.0,43566758.0,113.65,115.96,113.56,116.0
2023-10-20 18:10,524,129,395,37177,11250,25927,42908430.0,12794421.0,30114008.0,518,127,391,37474,11506,25968,43282050.0,13084066.0,30197984.0,113.73,116.15,113.72,116.29
2023-10-20 18:15,393,99,294,15035,4551,10484,17365324.0,5193387.0,12171937.0,380,90,290,15462,5031,10431,17846956.0,5731316.0,12115640.0,114.12,116.1,113.92,116.15
2023-10-20 18:20,239,94,145,10477,3584,6893,12118572.0,4130083.0,7988489.0,228,86,142,10152,3211,6941,11731459.0,3684345.0,8047114.0,115.24,115.89,114.74,115.94
2023-10-20 18:25,219,59,160,6659,1217,5442,7695794.0,1403260.0,6292534.0,195,47,148,6511,1253,5258,7521493.0,1440943.0,6080550.0,115.3,115.63,115.0,115.64
2023-10-20 18:30,482,124,358,9560,3792,5768,10978857.0,4358584.0,6620273.0,436,102,334,7767,2379,5388,8965672.0,2734943.0,6230728.0,114.94,114.78,114.96,115.64
2023-10-20 18:35,997,558,439,23499,16138,7361,27194808.0,18669446.0,8525362.0,894,520,374,18726,13143,5583,21659561.0,15171292.0,6488269.0,115.69,115.82,115.43,116.21
2023-10-23 10:00,2833,1935,898,66357,53625,12732,78317193.0,61948105.0,16369087.0,1933,1724,209,53261,50647,2614,61815052.0,58760452.0,3054600.0,115.52,128.57,116.02,116.86
2023-10-23 10:05,2084,1058,1026,50597,40176,10421,58891744.0,46610218.0,12281525.0,1978,1027,951,50822,42395,8427,58949864.0,49115878.0,9833986.0,116.02,117.85,115.85,116.7
2023-10-23 10:10,1671,1276,395,39858,32586,7272,46412554.0,37858516.0,8554037.0,1595,1243,352,37521,31762,5759,43618120.0,36892456.0,6725663.0,116.18,117.63,116.15,116.79
2023-10-23 10:15,1842,1269,573,89957,56787,33170,104611700.0,65419863.0,39191837.0,1618,1145,473,85834,53757,32077,99855860.0,62004604.0,37851255.0,115.2,118.15,115.34,118.0
2023-10-23 10:20,513,212,301,31684,13560,18124,36860373.0,15435411.0,21424962.0,404,179,225,27338,12639,14699,31809568.0,14498750.0,17310817.0,113.83,118.21,114.71,117.77
2023-10-23 10:25,682,288,394,21746,9997,11749,25278215.0,11497027.0,13781188.0,611,237,374,21202,9176,12026,24639593.0,10512061.0,14127531.0,115.0,117.3,114.56,117.47
2023-10-23 10:30,1179,508,671,49106,21890,27216,56796979.0,25026263.0,31770715.0,970,373,597,46663,20757,25906,54024375.0,23725396.0,30298978.0,114.33,116.74,114.3,116.96
2023-10-23 10:35,2262,1767,495,96295,64386,31909,111445268.0,73987810.0,37457458.0,2137,1716,421,93982,63587,30395,108764352.0,73077430.0,35686922.0,114.91,117.39,114.93,117.41
2023-10-23 10:40,1128,621,507,55609,28542,27067,63972654.0,32509777.0,31462877.0,972,513,459,52810,26650,26160,60937251.0,30369505.0,30567746.0,113.9,116.24,113.96,116.85
2023-10-23 10:45,621,474,147,32371,18220,14151,37409035.0,20842962.0,16566073.0,528,432,96,31245,17621,13624,36076266.0,20118135.0,15958130.0,114.4,117.07,114.17,117.13
2023-10-23 10:50,424,178,246,10624,4978,5646,12286163.0,5693387.0,6592776.0,373,147,226,10542,4715,5827,12182882.0,5380444.0,6802438.0,114.37,116.77,114.11,116.74
2023-10-23 10:55,251,130,121,11072,5608,5464,12791331.0,6411590.0,6379741.0,217,114,103,10560,5369,5191,12193941.0,6123498.0,6070442.0,114.33,116.76,114.05,116.94
2023-10-23 11:00,1134,988,146,41354,29005,12349,47800980.0,33324972.0,14476008.0,1080,962,118,41028,28880,12148,47356925.0,33116984.0,14239941.0,114.89,117.22,114.67,117.22
2023-10-23 11:05,329,198,131,14158,7889,6269,16363794.0,9031848.0,7331945.0,296,178,118,13820,7631,6189,15971194.0,8727227.0,7243966.0,114.49,116.96,114.37,117.05
2023-10-23 11:10,722,352,370,19130,12087,7043,22098441.0,13884111.0,8214330.0,702,338,364,18909,11911,6998,21845297.0,13682972.0,8162325.0,114.87,116.63,114.88,116.64
2023-10-23 11:15,1024,791,233,39123,28186,10937,45172959.0,32436367.0,12736592.0,971,764,207,37541,27030,10511,43384661.0,31087252.0,12297409.0,115.08,116.45,115.01,117.0
2023-10-23 11:20,951,824,127,36319,25407,10912,42055423.0,29247234.0,12808188.0,919,809,110,35929,25235,10694,41596072.0,29039596.0,12556475.0,115.11,117.38,115.08,117.42
2023-10-23 11:25,1962,1781,181,71106,56510,14596,82317666.0,65176652.0,17141014.0,1921,1756,165,68795,55668,13127,79605387.0,64201383.0,15404003.0,115.34,117.44,115.33,117.35
2023-10-23 11:30,1046,965,81,32669,28167,4502,37813344.0,32529063.0,5284281.0,1026,958,68,32583,28151,4432,37710818.0,32507694.0,5203124.0,115.49,117.38,115.48,117.4
2023-10-23 11:35,1767,1687,80,58165,50817,7348,67347816.0,58711097.0,8636718.0,1744,1674,70,58196,50905,7291,67381921.0,58812088.0,8569833.0,115.53,117.54,115.53,117.54
2023-10-23 11:40,1404,1264,140,47850,38910,8940,55375886.0,44881867.0,10494019.0,1392,1255,137,47586,38626,8960,55087373.0,44569270.0,10518102.0,115.35,117.38,115.39,117.39
2023-10-23 11:45,1378,1290,88,39715,32761,6954,45964684.0,37800246.0,8164438.0,1364,1284,80,39940,33045,6895,46210195.0,38113478.0,8096717.0,115.38,117.41,115.34,117.43
2023-10-23 11:50,1021,887,134,38741,28973,9768,44824913.0,33363874.0,11461039.0,1012,887,125,38669,28971,9698,44747627.0,33364468.0,11383158.0,115.16,117.33,115.17,117.38
2023-10-23 11:55,1232,141,1091,32950,10381,22569,38148842.0,11862550.0,26286291.0,1224,142,1082,34856,12315,22541,40285662.0,14026551.0,26259110.0,114.27,116.47,113.9,116.49
2023-10-23 12:00,241,94,147,12872,6251,6621,14899958.0,7141896.0,7758062.0,240,97,143,12809,6307,6502,14827791.0,7206912.0,7620878.0,114.25,117.17,114.27,117.21
2023-10-23 12:05,873,287,586,29835,11379,18456,34133195.0,12956258.0,21176937.0,769,221,548,28016,10813,17203,32324667.0,12307828.0,20016839.0,113.86,114.74,113.82,116.36
2023-10-23 12:10,294,97,197,15952,6953,8999,18332440.0,7900467.0,10431972.0,262,79,183,15512,6995,8517,17869766.0,7941598.0,9928168.0,113.63,115.92,113.53,116.57
2023-10-23 12:15,437,70,367,13967,4675,9292,16044911.0,5319271.0,10725640.0,405,53,352,13369,4160,9209,15414503.0,4728212.0,10686291.0,113.78,115.43,113.66,116.04
2023-10-23 12:20,726,177,549,23193,9219,13974,26728495.0,10482603.0,16245892.0,690,152,538,23007,9165,13842,26518767.0,10414865.0,16103902.0,113.71,116.26,113.64,116.34
2023-10-23 12:25,166,52,114,8230,3573,4657,9500032.0,4074009.0,5426023.0,157,47,110,8244,3644,4600,9503898.0,4143950.0,5359948.0,114.02,116.51,113.72,116.52
2023-10-23 12:30,518,279,239,17523,10767,6756,20267026.0,12382568.0,7884457.0,501,273,228,17389,10656,6733,20059312.0,12201433.0,7857878.0,115.0,116.7,114.5,116.71
2023-10-23 12:35,537,256,281,33007,17011,15996,38052262.0,19398552.0,18653710.0,511,239,272,32709,17000,15709,37746152.0,19385264.0,18360888.0,114.04,116.61,114.03,116.88
2023-10-23 12:40,281,126,155,15702,7456,8246,18116949.0,8495341.0,9621608.0,259,113,146,15138,7145,7993,17455515.0,8125117.0,9330398.0,113.94,116.68,113.72,116.73
2023-10-23 12:45,437,155,282,25932,12555,13377,29858660.0,14264052.0,15594608.0,384,122,262,25413,12304,13109,29269458.0,13973117.0,15296341.0,113.61,116.58,113.57,116.69
2023-10-23 12:50,388,168,220,21857,10337,11520,25178206.0,11743369.0,13434837.0,348,144,204,21606,10298,11308,24890720.0,11695392.0,13195327.0,113.61,116.62,113.57,116.69
2023-10-23 12:55,358,138,220,19797,9511,10286,22787600.0,10799860.0,11987740.0,330,115,215,19895,9498,10397,22910128.0,10780051.0,12130077.0,113.55,116.54,113.5,116.67
2023-10-23 13:00,602,446,156,22900,11584,11316,26389726.0,13177677.0,13212048.0,575,436,139,22649,11612,11037,26090000.0,13208075.0,12881925.0,113.76,116.76,113.75,116.72
2023-10-23 13:05,216,122,94,14185,6969,7216,16336580.0,7918691.0,8417889.0,195,109,86,13420,6496,6924,15463392.0,7379197.0,8084195.0,113.63,116.66,113.6,116.76
2023-10-23 13:10,114,56,58,5538,3607,1931,6356101.0,4124693.0,2231408.0,98,47,51,5519,1597,3922,6433198.0,1816094.0,4617104.0,114.35,115.56,113.72,117.72
2023-10-23 13:15,189,91,98,3647,1726,1921,4202689.0,1973649.0,2229040.0,161,71,90,5571,3669,1902,6407774.0,4198929.0,2208844.0,114.35,116.04,114.44,116.13
2023-10-23 13:20,91,49,42,5805,2538,3267,6707959.0,2890802.0,3817156.0,71,35,36,5635,2539,3096,6509022.0,2884449.0,3624573.0,113.9,116.84,113.61,117.07
2023-10-23 13:25,63,23,40,2713,1046,1667,3128334.0,1189685.0,1938649.0,58,19,39,3512,1865,1647,4040547.0,2124369.0,1916178.0,113.74,116.3,113.91,116.34
2023-10-23 13:30,143,46,97,6460,3049,3411,7426553.0,3458411.0,3968142.0,120,29,91,6119,2803,3316,7045493.0,3184502.0,3860991.0,113.43,116.33,113.61,116.44
2023-10-23 13:35,2669,1557,1112,184898,117546,67352,208833827.0,133057042.0,75776784.0,1523,961,562,120196,79287,40909,136826797.0,89582086.0,47244711.0,113.2,112.51,112.98,115.49
2023-10-23 13:40,1073,588,485,67894,41772,26122,77427558.0,47345325.0,30082233.0,942,497,445,80970,57046,23924,92171235.0,64625233.0,27546001.0,113.34,115.16,113.29,115.14
2023-10-23 13:45,1543,766,777,82260,38420,43840,93114083.0,43374768.0,49739315.0,1328,621,707,74795,34550,40245,85097925.0,38903664.0,46194261.0,112.9,113.46,112.6,114.78
2023-10-23 13:50,1583,889,694,71294,36454,34840,80914337.0,41058021.0,39856315.0,1185,573,612,57020,25648,31372,64710623.0,28808637.0,35901985.0,112.63,114.4,112.32,114.44
2023-10-23 13:55,1112,474,638,43393,16647,26746,49310135.0,18864514.0,30445621.0,1046,437,609,42893,17036,25857,48751803.0,19218108.0,29533694.0,113.32,113.83,112.81,114.22
2023-10-23 14:00,1380,954,426,55494,34902,20592,62965210.0,39462586.0,23502624.0,1305,897,408,55518,35389,20129,62989601.0,39954421.0,23035179.0,113.07,114.13,112.9,114.44
2023-10-23 14:05,1296,986,310,54723,37463,17260,62216603.0,42425148.0,19791454.0,1225,937,288,52354,35875,16479,59453621.0,40585399.0,18868222.0,113.25,114.67,113.13,114.5
2023-10-23 14:10,1193,1038,155,42067,31973,10094,47804827.0,36243814.0,11561013.0,1148,1005,143,41931,31939,9992,47641046.0,36195249.0,11445796.0,113.36,114.53,113.33,114.55
2023-10-23 14:15,640,424,216,17846,10250,7596,20292658.0,11614955.0,8677703.0,579,373,206,16406,9380,7026,18632300.0,10604866.0,8027434.0,113.32,114.24,113.06,114.25
2023-10-23 14:20,697,529,168,31577,21846,9731,35935098.0,24778301.0,11156797.0,650,486,164,29300,19640,9660,33328906.0,22226666.0,11102239.0,113.42,114.65,113.17,114.93
2023-10-23 14:25,543,307,236,22639,11720,10919,25754235.0,13268967.0,12485268.0,492,265,227,22280,11768,10512,25347499.0,13292455.0,12055044.0,113.22,114.34,112.95,114.68
2023-10-23 14:30,963,835,128,41861,31493,10368,47706332.0,35778832.0,11927500.0,895,790,105,41301,31336,9965,46998148.0,35520799.0,11477348.0,113.61,115.04,113.35,115.18
2023-10-23 14:35,324,195,129,14372,6786,7586,16375647.0,7645761.0,8729885.0,280,167,113,13687,6494,7193,15576934.0,7290015.0,8286919.0,112.67,115.08,112.26,115.21
2023-10-23 14:40,607,357,250,34489,17648,16841,39356175.0,19964542.0,19391633.0,517,310,207,31429,14963,16466,35848837.0,16877678.0,18971159.0,113.13,115.15,112.8,115.21
2023-10-23 14:45,295,187,108,11857,5519,6338,13567290.0,6270401.0,7296889.0,231,152,79,10579,6659,3920,12086448.0,7565446.0,4521002.0,113.61,115.13,113.61,115.33
2023-10-23 14:50,1042,302,740,38305,12195,26110,43663406.0,13800172.0,29863234.0,1004,281,723,36488,11104,25384,41652800.0,12539818.0,29112981.0,113.16,114.37,112.93,114.69
2023-10-23 14:55,1967,883,1084,85513,37279,48234,98084462.0,42612851.0,55471611.0,1836,818,1018,78594,36665,41929,89894885.0,41636147.0,48258738.0,114.31,115.01,113.56,115.1
2023-10-23 15:00,701,447,254,28308,18549,9759,32626754.0,21398054.0,11228699.0,634,410,224,26466,17141,9325,30205313.0,19476587.0,10728726.0,115.36,115.06,113.63,115.05
2023-10-23 15:05,904,722,182,39511,31011,8500,45113955.0,35322138.0,9791817.0,850,716,134,40111,31736,8375,45801753.0,36131541.0,9670211.0,113.9,115.2,113.85,115.47
2023-10-23 15:10,1132,743,389,60659,37909,22750,69306089.0,43226881.0,26079207.0,1113,736,377,60178,37597,22581,68731370.0,42844675.0,25886695.0,114.03,114.63,113.96,114.64
2023-10-23 15:15,590,502,88,30740,25391,5349,35024682.0,28916421.0,6108260.0,572,489,83,30177,25037,5140,34446406.0,28526015.0,5920391.0,113.88,114.19,113.94,115.18
2023-10-23 15:20,743,642,101,44135,34322,9813,50376108.0,39079505.0,11296603.0,702,611,91,43050,33444,9606,49141330.0,38081697.0,11059632.0,113.86,115.12,113.87,115.13
2023-10-23 15:25,1269,1129,140,79804,66441,13363,91125136.0,75745706.0,15379429.0,1253,1122,131,80082,66730,13352,91438305.0,76070538.0,15367767.0,114.0,115.09,114.0,115.1
2023-10-23 15:30,1199,1026,173,74220,60963,13257,84746788.0,69571519.0,15175268.0,1168,1005,163,73406,60561,12845,83808222.0,69099876.0,14708345.0,114.12,114.47,114.1,114.51
2023-10-23 15:35,588,207,381,33979,6907,27072,38778791.0,7830133.0,30948658.0,555,188,367,33564,6820,26744,38296243.0,7723011.0,30573231.0,113.37,114.32,113.24,114.32
2023-10-23 15:40,245,174,71,14592,9097,5495,16644689.0,10318136.0,6326552.0,187,137,50,14396,8935,5461,16412464.0,10119675.0,6292789.0,113.42,115.13,113.26,115.23
2023-10-23 15:45,1296,228,1068,77246,13879,63367,88196266.0,15810967.0,72385299.0,1287,220,1067,77175,13960,63215,88095946.0,15890246.0,72205699.0,113.92,114.23,113.83,114.22
2023-10-23 15:50,1191,626,565,86156,36856,49300,98360347.0,41957082.0,56403265.0,1153,602,551,85325,36223,49102,97411503.0,41236661.0,56174842.0,113.84,114.41,113.84,114.4
2023-10-23 15:55,476,124,352,37948,8380,29568,43309226.0,9478803.0,33830422.0,461,115,346,37779,8176,29603,43122837.0,9247442.0,33875395.0,113.11,114.42,113.1,114.43
2023-10-23 16:00,861,466,395,56946,29908,27038,65004023.0,33984928.0,31019095.0,841,462,379,56902,30052,26850,64950340.0,34141248.0,30809091.0,113.63,114.72,113.61,114.75
2023-10-23 16:05,464,336,128,30991,20035,10956,35388233.0,22799364.0,12588869.0,450,323,127,30712,19774,10938,35055414.0,22486949.0,12568465.0,113.8,114.9,113.72,114.91
2023-10-23 16:10,1043,350,693,64765,19437,45328,73936100.0,22085212.0,51850887.0,1014,335,679,64355,19276,45079,73499951.0,21905272.0,51594679.0,113.62,114.39,113.64,114.45
2023-10-23 16:15,851,105,746,51242,5933,45309,58487161.0,6714532.0,51772629.0,824,92,732,51140,5857,45283,58383432.0,6626890.0,51756542.0,113.17,114.27,113.14,114.3
2023-10-23 16:20,1279,86,1193,65373,4444,60929,74656178.0,5036649.0,69619529.0,1259,66,1193,65016,4104,60912,74249299.0,4649343.0,69599955.0,113.34,114.26,113.29,114.26
2023-10-23 16:25,1987,575,1412,101082,27976,73106,115105630.0,31643128.0,83462502.0,1881,518,1363,106821,27412,79409,121886164.0,31004067.0,90882097.0,113.11,114.17,113.1,114.45
2023-10-23 16:30,1170,961,209,61191,43705,17486,69682954.0,49646694.0,20036260.0,1115,935,180,55078,43710,11368,62725796.0,49652281.0,13073515.0,113.59,114.58,113.59,115.0
2023-10-23 16:35,1241,844,397,53501,35486,18015,60918462.0,40310878.0,20607583.0,1217,823,394,53187,35107,18080,60566300.0,39884187.0,20682112.0,113.6,114.39,113.61,114.39
2023-10-23 16:40,1134,662,472,46689,25226,21463,53127858.0,28653880.0,24473978.0,1091,633,458,46010,25056,20954,52355669.0,28445449.0,23910220.0,113.59,114.03,113.53,114.11
2023-10-23 16:45,1470,672,798,61018,27906,33112,69016043.0,31420271.0,37595772.0,1360,595,765,58983,26564,32419,66912995.0,29924619.0,36988376.0,112.59,113.54,112.65,114.09
2023-10-23 16:50,1070,823,247,49483,34902,14581,56358328.0,39608258.0,16750070.0,995,765,230,46524,32131,14393,52873633.0,36336258.0,16537375.0,113.48,114.88,113.09,114.9
2023-10-23 16:55,927,834,93,35107,27923,7184,39948957.0,31663541.0,8285415.0,895,821,74,34496,27770,6726,39246488.0,31480907.0,7765581.0,113.4,115.33,113.36,115.46
2023-10-23 17:00,1176,1058,118,45729,37667,8062,52021841.0,42728089.0,9293751.0,1136,1039,97,45308,37299,8009,51496259.0,42262462.0,9233797.0,113.44,115.28,113.31,115.29
2023-10-23 17:05,824,597,227,23830,16165,7665,27099165.0,18324345.0,8774820.0,792,586,206,23939,16440,7499,27211468.0,18614452.0,8597015.0,113.36,114.48,113.23,114.64
2023-10-23 17:10,1899,738,1161,69359,24446,44913,79072342.0,27623548.0,51448793.0,1883,722,1161,68940,24044,44896,78560231.0,27159705.0,51400525.0,113.0,114.55,112.96,114.49
2023-10-23 17:15,1200,265,935,41702,10646,31056,47439563.0,11981659.0,35457904.0,1168,241,927,41303,10349,30954,46999380.0,11644257.0,35355122.0,112.55,114.17,112.52,114.22
2023-10-23 17:20,510,228,282,21738,10612,11126,24728005.0,11936116.0,12791889.0,477,210,267,21343,10323,11020,24283525.0,11610709.0,12672816.0,112.48,114.97,112.47,115.0
2023-10-23 17:25,471,373,98,19341,12686,6655,21997890.0,14331229.0,7666661.0,438,337,101,18959,12316,6643,21545366.0,13885159.0,7660206.0,112.97,115.2,112.74,115.31
2023-10-23 17:30,345,294,51,9971,6913,3058,11337932.0,7816170.0,3521761.0,313,274,39,9703,6661,3042,11039123.0,7525703.0,3513419.0,113.06,115.17,112.98,115.5
2023-10-23 17:35,239,58,181,5344,2069,3275,6094648.0,2347047.0,3747601.0,221,43,178,5324,2029,3295,6064953.0,2287779.0,3777173.0,113.44,114.43,112.75,114.63
2023-10-23 17:40,376,324,52,17711,14461,3250,20138338.0,16390079.0,3748259.0,349,306,43,16909,13702,3207,19215565.0,15516065.0,3699500.0,113.34,115.33,113.24,115.36
2023-10-23 17:45,221,159,62,16423,11130,5293,18696137.0,12607301.0,6088835.0,193,143,50,15606,10482,5124,17752205.0,11846880.0,5905325.0,113.27,115.04,113.02,115.25
2023-10-23 17:50,892,734,158,42116,31581,10535,47928957.0,35806848.0,12122109.0,868,723,145,42006,31480,10526,47798884.0,35685398.0,12113485.0,113.38,115.07,113.36,115.08
2023-10-23 17:55,953,837,116,53178,42543,10635,60585355.0,48399639.0,12185715.0,929,823,106,52631,42644,9987,59904560.0,48464566.0,11439994.0,113.77,114.58,113.65,114.55
2023-10-23 18:00,1833,876,957,96959,40443,56516,110373485.0,45947692.0,64425792.0,1820,873,947,97915,41287,56628,111443811.0,46890058.0,64553752.0,113.61,114.0,113.57,114.0
2023-10-23 18:05,1523,623,900,99591,34105,65486,113620066.0,38816264.0,74803802.0,1463,594,869,96251,31158,65093,109719632.0,35303253.0,74416379.0,113.81,114.23,113.3,114.32
2023-10-23 18:10,1674,593,1081,132226,40423,91803,150858735.0,45917456.0,104941279.0,1626,568,1058,128130,38836,89294,146075449.0,44006314.0,102069134.0,113.59,114.31,113.31,114.31
2023-10-23 18:15,1472,1104,368,96840,67057,29783,110378535.0,76227681.0,34150854.0,1434,1079,355,96587,66983,29604,110070433.0,76123429.0,33947004.0,113.68,114.67,113.65,114.67
2023-10-23 18:20,1426,234,1192,93108,13382,79726,106254214.0,15143499.0,91110715.0,1413,224,1189,92756,13409,79347,105834051.0,15158894.0,90675156.0,113.16,114.28,113.05,114.28
2023-10-23 18:25,454,328,126,25768,17366,8402,29388013.0,19761660.0,9626352.0,451,327,124,25757,17711,8046,29365104.0,20143539.0,9221565.0,113.8,114.57,113.73,114.61
2023-10-23 18:30,1254,996,258,57240,39755,17485,65303798.0,45271317.0,20032481.0,1257,991,266,57238,39207,18031,65268984.0,44597989.0,20670994.0,113.88,114.57,113.75,114.64
2023-10-23 18:35,1175,1010,165,60111,51401,8710,68608894.0,58658029.0,9950865.0,1171,1017,154,59911,51840,8071,68330709.0,59112761.0,9217947.0,114.12,114.25,114.03,114.21
2023-10-24 10:00,2528,1650,878,63694,42754,20940,74918001.0,48597409.0,26320591.0,1573,1371,202,44416,39603,4813,50689168.0,45116469.0,5572699.0,113.67,125.7,113.92,115.78
2023-10-24 10:05,2082,1856,226,55302,52988,2314,62748776.0,60013223.0,2735552.0,1882,1768,114,50839,49076,1763,57905283.0,55851076.0,2054206.0,113.26,118.22,113.81,116.52
2023-10-24 10:10,1147,794,353,31266,25171,6095,36042326.0,28674769.0,7367557.0,1066,757,309,26462,23827,2635,30285858.0,27164464.0,3121394.0,113.92,120.88,114.01,118.46
2023-10-24 10:15,2868,1877,991,159158,104566,54592,183567541.0,120001873.0,63565667.0,2339,1612,727,139603,91936,47667,160601898.0,104781479.0,55820418.0,114.76,116.44,113.97,117.1
2023-10-24 10:20,2246,869,1377,106369,43136,63233,123614050.0,49455117.0,74158933.0,1690,597,1093,98902,42449,56453,114613948.0,48535725.0,66078223.0,114.65,117.28,114.34,117.05
2023-10-24 10:25,1579,490,1089,69974,25522,44452,81198416.0,29210382.0,51988034.0,1455,403,1052,65531,23709,41822,75813400.0,27067544.0,48745856.0,114.45,116.95,114.17,116.56
2023-10-24 10:30,631,234,397,21998,8796,13202,25526070.0,10116714.0,15409355.0,553,194,359,20731,8145,12586,23998126.0,9314860.0,14683265.0,115.01,116.72,114.36,116.66
2023-10-24 10:35,1289,542,747,61407,24446,36961,70964741.0,28040810.0,42923930.0,1152,474,678,58556,23288,35268,67861241.0,26658501.0,41202740.0,114.71,116.13,114.47,116.83
2023-10-24 10:40,1535,921,614,63832,35030,28802,74092126.0,40360914.0,33731212.0,1404,840,564,61042,33275,27767,70681136.0,38145063.0,32536073.0,115.22,117.11,114.64,117.18
2023-10-24 10:45,1318,723,595,72865,37707,35158,84944382.0,43491002.0,41453379.0,1179,659,520,69040,35747,33293,80364873.0,41072808.0,39292064.0,115.34,117.91,114.9,118.02
2023-10-24 10:50,954,498,456,44166,24017,20149,51315767.0,27633153.0,23682614.0,867,475,392,42528,23519,19009,49439410.0,27053460.0,22385950.0,115.06,117.54,115.03,117.77
2023-10-24 10:55,1261,596,665,57178,20585,36593,66384849.0,23583572.0,42801276.0,1199,567,632,56417,20313,36104,65498374.0,23266079.0,42232295.0,114.57,116.97,114.54,116.97
2023-10-24 11:00,525,370,155,20510,10122,10388,23774039.0,11606550.0,12167488.0,464,347,117,18551,9230,9321,21492534.0,10567244.0,10925289.0,114.67,117.13,114.49,117.21
2023-10-24 11:05,798,557,241,34385,18636,15749,39768848.0,21337388.0,18431459.0,746,525,221,31061,16803,14258,35957483.0,19229004.0,16728478.0,114.5,117.03,114.44,117.33
2023-10-24 11:10,442,120,322,26630,11078,15552,30814665.0,12635138.0,18179527.0,392,107,285,25374,10314,15060,29365985.0,11759312.0,17606672.0,114.06,116.9,114.01,116.91
2023-10-24 11:15,792,485,307,29090,10750,18340,33656522.0,12264838.0,21391683.0,740,448,292,27822,10905,16917,32289659.0,12435221.0,19854438.0,114.09,116.64,114.03,117.36
2023-10-24 11:20,893,500,393,35128,14671,20457,40492339.0,16720351.0,23771988.0,775,423,352,31450,13646,17804,36290316.0,15522440.0,20767876.0,113.97,116.2,113.75,116.65
2023-10-24 11:25,1017,321,696,42708,18400,24308,49324764.0,21064821.0,28259942.0,902,234,668,39107,15110,23997,45107554.0,17184539.0,27923015.0,114.48,116.26,113.73,116.36
2023-10-24 11:30,1100,370,730,48718,16634,32084,56458696.0,19082310.0,37376386.0,1016,316,700,46410,15020,31390,53701139.0,17159231.0,36541908.0,114.72,116.5,114.24,116.41
2023-10-24 11:35,629,159,470,17938,5897,12041,20885657.0,6792891.0,14092765.0,564,115,449,13633,5217,8416,15842963.0,5971578.0,9871385.0,115.19,117.04,114.46,117.29
2023-10-24 11:40,907,412,495,25296,12113,13183,29424288.0,13950358.0,15473929.0,856,379,477,24343,11380,12963,28273373.0,13071452.0,15201920.0,115.17,117.38,114.86,117.27
2023-10-24 11:45,365,276,89,15762,10251,5511,18249046.0,11783168.0,6465878.0,315,253,62,14049,9330,4719,16297167.0,10744678.0,5552488.0,114.95,117.33,115.16,117.66
2023-10-24 11:50,477,310,167,21241,12809,8432,24701281.0,14758097.0,9943183.0,414,279,135,20341,12417,7924,23618484.0,14291175.0,9327308.0,115.22,117.92,115.09,117.71
2023-10-24 11:55,1089,650,439,46680,23155,23525,54231261.0,26653589.0,27577672.0,1040,631,409,46531,22902,23629,54252481.0,26322203.0,27930278.0,115.11,117.23,114.93,118.2
2023-10-24 12:00,2434,478,1956,145291,36973,108318,168962186.0,42236173.0,126726012.0,2369,450,1919,141699,36900,104799,164921890.0,42143818.0,122778072.0,114.24,116.99,114.21,117.16
2023-10-24 12:05,1020,309,711,45875,14184,31691,53203406.0,16207778.0,36995628.0,969,275,694,44041,13811,30230,50973986.0,15775421.0,35198565.0,114.27,116.74,114.22,116.44
2023-10-24 12:10,631,193,438,36066,11772,24294,41600866.0,13411480.0,28189386.0,570,158,412,33597,11262,22335,38822380.0,12817604.0,26004775.0,113.93,116.03,113.81,116.43
2023-10-24 12:15,295,92,203,15090,4605,10485,17439652.0,5248370.0,12191282.0,259,66,193,15000,4245,10755,17335503.0,4827521.0,12507981.0,113.97,116.27,113.72,116.3
2023-10-24 12:20,430,91,339,13378,4982,8396,15489134.0,5684617.0,9804516.0,408,73,335,12827,4810,8017,14800638.0,5470310.0,9330328.0,114.1,116.78,113.73,116.38
2023-10-24 12:25,352,133,219,16784,4694,12090,19391551.0,5345563.0,14045988.0,340,130,210,16964,4924,12040,19584705.0,5597443.0,13987262.0,113.88,116.18,113.68,116.17
2023-10-24 12:30,411,94,317,14175,6283,7892,16322868.0,7150287.0,9172581.0,362,57,305,11993,4277,7716,13821263.0,4855794.0,8965468.0,113.8,116.23,113.53,116.19
2023-10-24 12:35,425,188,237,25688,11451,14237,29598954.0,13016580.0,16582374.0,382,157,225,25297,11030,14267,29155927.0,12538133.0,16617793.0,113.67,116.47,113.67,116.48
2023-10-24 12:40,247,110,137,17148,8202,8946,19799245.0,9360226.0,10439019.0,226,97,129,16778,7996,8782,19359140.0,9094799.0,10264340.0,114.12,116.69,113.74,116.88
2023-10-24 12:45,848,503,345,39735,16919,22816,45595650.0,19272644.0,26323006.0,781,467,314,37872,16074,21798,43686842.0,18305261.0,25381581.0,113.91,115.37,113.88,116.44
2023-10-24 12:50,755,229,526,37590,13295,24295,43353655.0,15105779.0,28247876.0,730,213,517,37314,13149,24165,43029784.0,14938182.0,28091602.0,113.62,116.27,113.61,116.25
2023-10-24 12:55,465,153,312,33218,13106,20112,38292757.0,14884563.0,23408194.0,445,143,302,33477,13126,20351,38610847.0,14903214.0,23707633.0,113.57,116.39,113.54,116.49
2023-10-24 13:00,436,248,188,17819,6200,11619,20546635.0,7061883.0,13484751.0,381,208,173,16992,5727,11265,19587063.0,6514308.0,13072755.0,113.9,116.06,113.75,116.05
2023-10-24 13:05,200,54,146,9138,2866,6272,10547194.0,3271904.0,7275290.0,177,40,137,8764,2614,6150,10103486.0,2969240.0,7134245.0,114.16,116.0,113.59,116.0
2023-10-24 13:10,187,68,119,11037,5113,5924,12706484.0,5805457.0,6901027.0,167,55,112,10720,4941,5779,12343108.0,5605919.0,6737189.0,113.54,116.49,113.46,116.58
2023-10-24 13:15,296,127,169,7813,3192,4621,9010790.0,3640693.0,5370096.0,286,118,168,7535,2929,4606,8686258.0,3333806.0,5352451.0,114.06,116.21,113.82,116.21
2023-10-24 13:20,253,92,161,18173,8676,9497,20948575.0,9862338.0,11086237.0,237,83,154,19572,10115,9457,22539881.0,11499872.0,11040008.0,113.67,116.73,113.69,116.74
2023-10-24 13:25,149,42,107,7481,2648,4833,8649316.0,3032695.0,5616621.0,136,33,103,7173,2409,4764,8276264.0,2739803.0,5536461.0,114.53,116.21,113.73,116.21
2023-10-24 13:30,150,45,105,7548,2791,4757,8719239.0,3179478.0,5539761.0,132,36,96,7479,2758,4721,8634588.0,3136917.0,5497671.0,113.92,116.45,113.74,116.45
2023-10-24 13:35,141,71,70,10391,4948,5443,11997477.0,5629897.0,6367580.0,126,60,66,10374,4928,5446,11971618.0,5603775.0,6367842.0,113.78,116.99,113.71,116.93
2023-10-24 13:40,919,412,507,24666,5152,19514,28511248.0,5884848.0,22626400.0,906,408,498,24695,5280,19415,28543527.0,6027035.0,22516491.0,114.22,115.95,114.15,115.97
2023-10-24 13:45,165,61,104,7339,2068,5271,8501647.0,2367496.0,6134150.0,140,48,92,7019,1866,5153,8311798.0,2126635.0,6185163.0,114.48,116.38,113.97,120.03
2023-10-24 13:50,95,38,57,6239,2738,3501,7183606.0,3115908.0,4067698.0,96,36,60,6308,2740,3568,7281591.0,3111945.0,4169646.0,113.8,116.19,113.57,116.86
2023-10-24 13:55,438,226,212,12408,5027,7381,14341175.0,5740584.0,8600591.0,424,221,203,12614,5368,7246,14556147.0,6117741.0,8438405.0,114.2,116.52,113.97,116.46
2023-10-24 14:00,173,86,87,10989,5415,5574,12663810.0,6157012.0,6506797.0,166,81,85,10552,4989,5563,12171652.0,5677316.0,6494335.0,113.7,116.73,113.8,116.74
2023-10-24 14:05,113,43,70,7237,3083,4154,8328326.0,3509799.0,4818527.0,99,35,64,6744,2681,4063,7787408.0,3052137.0,4735270.0,113.84,116.0,113.84,116.55
2023-10-24 14:10,88,67,21,3780,1851,1929,4362470.0,2108344.0,2254126.0,86,68,18,4017,2092,1925,4628616.0,2379085.0,2249531.0,113.9,116.85,113.72,116.86
2023-10-24 14:15,274,108,166,5644,1986,3658,6520524.0,2272707.0,4247817.0,261,99,162,5423,1777,3646,6264913.0,2029694.0,4235219.0,114.44,116.12,114.22,116.16
2023-10-24 14:20,165,79,86,7354,2357,4997,8527608.0,2719930.0,5807678.0,151,71,80,7387,2419,4968,8533854.0,2755726.0,5778127.0,115.4,116.22,113.92,116.31
2023-10-24 14:25,790,494,296,44917,25288,19629,51906883.0,28966765.0,22940117.0,771,480,291,44374,24773,19601,51241442.0,28335926.0,22905515.0,114.55,116.87,114.38,116.86
2023-10-24 14:30,470,284,186,25535,15933,9602,29512713.0,18285622.0,11227091.0,445,270,175,25349,15797,9552,29293480.0,18119248.0,11174232.0,114.77,116.92,114.7,116.98
2023-10-24 14:35,1096,808,288,35767,20764,15003,41355072.0,23826448.0,17528623.0,1055,783,272,35564,20645,14919,41154564.0,23679875.0,17474689.0,114.75,116.83,114.7,117.13
2023-10-24 14:40,327,178,149,13106,8536,4570,15158447.0,9804000.0,5354447.0,302,160,142,13253,8427,4826,15327824.0,9677927.0,5649896.0,114.85,117.17,114.84,117.07
2023-10-24 14:45,310,204,106,17465,10816,6649,20202670.0,12426085.0,7776584.0,303,197,106,17022,10794,6228,19683957.0,12396391.0,7287565.0,114.89,116.96,114.85,117.01
2023-10-24 14:50,546,487,59,17288,12558,4730,19994086.0,14448834.0,5545252.0,536,480,56,17183,12470,4713,19873832.0,14346520.0,5527311.0,115.06,117.24,115.05,117.28
2023-10-24 14:55,393,336,57,16212,8653,7559,19281594.0,9959764.0,9321830.0,379,332,47,16113,8633,7480,18800179.0,9936187.0,8863991.0,115.1,123.32,115.1,118.5
2023-10-24 15:00,186,161,25,6404,5369,1035,7396803.0,6187649.0,1209154.0,178,160,18,8222,7373,849,9346444.0,8352486.0,993958.0,115.25,116.83,113.28,117.07
2023-10-24 15:05,204,172,32,6881,5221,1660,7945717.0,6002562.0,1943154.0,197,170,27,6825,5135,1690,7888902.0,5903331.0,1985571.0,114.97,117.06,114.96,117.49
2023-10-24 15:10,137,104,33,7950,5724,2226,9159829.0,6582079.0,2577750.0,125,96,29,7704,5577,2127,8896882.0,6406516.0,2490366.0,114.99,115.8,114.87,117.08
2023-10-24 15:15,534,111,423,9131,5348,3783,10550271.0,6150437.0,4399834.0,525,105,420,9222,5453,3769,10654181.0,6267689.0,4386491.0,115.0,116.31,114.94,116.38
2023-10-24 15:20,94,73,21,5573,4088,1485,6467369.0,4701530.0,1765838.0,90,70,20,5552,4077,1475,6414702.0,4689096.0,1725606.0,115.01,118.91,115.01,116.99
2023-10-24 15:25,413,233,180,20462,12108,8354,23615035.0,13849717.0,9765318.0,401,230,171,20033,11835,8198,23126228.0,13537831.0,9588396.0,114.38,116.89,114.39,116.96
2023-10-24 15:30,146,67,79,7075,3278,3797,8156009.0,3730442.0,4425567.0,122,51,71,7113,3409,3704,8203894.0,3884217.0,4319677.0,113.8,116.55,113.94,116.62
2023-10-24 15:35,117,63,54,7678,3911,3767,8853386.0,4462706.0,4390680.0,109,56,53,7134,3491,3643,8235287.0,3983148.0,4252138.0,114.11,116.56,114.1,116.72
2023-10-24 15:40,433,150,283,21143,9909,11234,24443274.0,11316556.0,13126717.0,403,128,275,20774,9568,11206,23993187.0,10896317.0,13096869.0,114.2,116.85,113.88,116.87
2023-10-24 15:45,61,27,34,2670,1175,1495,3092363.0,1344177.0,1748185.0,53,22,31,4521,1113,3408,5264096.0,1270762.0,3993333.0,114.4,116.94,114.17,117.18
2023-10-24 15:50,308,61,247,9484,3564,5920,11002588.0,4070080.0,6932508.0,286,47,239,9388,3672,5716,10897512.0,4186480.0,6711032.0,114.2,117.1,114.01,117.41
2023-10-24 15:55,111,48,63,5792,2835,2957,6711717.0,3242462.0,3469254.0,104,47,57,6042,3061,2981,6997510.0,3498857.0,3498653.0,114.37,117.32,114.3,117.37
2023-10-24 16:00,124,61,63,6542,3065,3477,7592464.0,3526186.0,4066277.0,108,51,57,6134,2892,3242,7106791.0,3309625.0,3797166.0,115.05,116.95,114.44,117.12
2023-10-24 16:05,400,101,299,11527,5634,5893,13342865.0,6458569.0,6884296.0,380,87,293,11429,5165,6264,13270800.0,5924191.0,7346608.0,114.64,116.82,114.7,117.28
2023-10-24 16:10,830,647,183,30750,19206,11544,35806424.0,22288766.0,13517657.0,774,623,151,29399,18308,11091,34095576.0,21095525.0,13000051.0,116.05,117.1,115.23,117.21
2023-10-24 16:15,1168,594,574,50998,28583,22415,59130076.0,32844211.0,26285864.0,1158,592,566,50467,28143,22324,58515534.0,32335227.0,26180307.0,114.91,117.27,114.9,117.27
2023-10-24 16:20,765,410,355,49567,23828,25739,57419299.0,27312171.0,30107127.0,734,390,344,49128,23687,25441,56944308.0,27148885.0,29795422.0,114.62,116.97,114.62,117.12
2023-10-24 16:25,699,428,271,29390,11919,17471,34067004.0,13666361.0,20400643.0,692,429,263,29299,11920,17379,33963344.0,13669118.0,20294225.0,114.66,116.77,114.67,116.77
2023-10-24 16:30,295,123,172,13456,3508,9948,15601175.0,4019262.0,11581913.0,290,120,170,13358,3435,9923,15489473.0,3928397.0,11561075.0,114.57,116.42,114.36,116.51
2023-10-24 16:35,290,50,240,12647,3973,8674,14651453.0,4545810.0,10105642.0,272,40,232,12287,3914,8373,14241084.0,4477828.0,9763256.0,114.42,116.5,114.41,116.6
2023-10-24 16:40,367,101,266,18480,7291,11189,21438664.0,8383461.0,13055203.0,349,95,254,18283,7269,11014,21172632.0,8318615.0,12854016.0,114.98,116.68,114.44,116.71
2023-10-24 16:45,272,134,138,10660,5916,4744,12297051.0,6768072.0,5528979.0,267,135,132,10807,6073,4734,12481828.0,6964743.0,5517084.0,114.4,116.55,114.68,116.54
2023-10-24 16:50,631,316,315,22047,11965,10082,25630590.0,13830791.0,11799798.0,604,299,305,20736,10647,10089,24054918.0,12246947.0,11807971.0,115.59,117.04,115.03,117.04
2023-10-24 16:55,313,202,111,22390,12900,9490,26088493.0,14922628.0,11165864.0,298,200,98,22496,13440,9056,26129358.0,15454953.0,10674405.0,115.68,117.66,114.99,117.87
2023-10-24 17:00,384,253,131,30363,18114,12249,35269301.0,20834474.0,14434827.0,358,246,112,30062,18076,11986,34908455.0,20784847.0,14123608.0,115.02,117.84,114.99,117.83
2023-10-24 17:05,493,403,90,19796,14788,5008,22984337.0,17093053.0,5891284.0,478,395,83,19519,14667,4852,22661923.0,16952112.0,5709811.0,115.59,117.64,115.58,117.68
2023-10-24 17:10,345,265,80,19422,13948,5474,22587963.0,16117247.0,6470716.0,342,266,76,18811,14109,4702,21843031.0,16300836.0,5542194.0,115.55,118.21,115.54,117.87
2023-10-24 17:15,412,305,107,22351,16402,5949,25963936.0,18953205.0,7010731.0,401,303,98,21634,16402,5232,25112915.0,18953767.0,6159147.0,115.55,117.85,115.56,117.72
2023-10-24 17:20,748,517,231,23024,16150,6874,26710919.0,18636860.0,8074058.0,732,512,220,22893,16108,6785,26559406.0,18588026.0,7971380.0,115.4,117.46,115.4,117.49
2023-10-24 17:25,685,461,224,29196,18973,10223,33863948.0,21849515.0,12014433.0,681,463,218,29629,19521,10108,34359699.0,22475496.0,11884202.0,115.16,117.52,115.13,117.57
2023-10-24 17:30,329,187,142,13770,10550,3220,15957811.0,12184370.0,3773441.0,321,181,140,13918,10656,3262,16129790.0,12305482.0,3824308.0,115.49,117.19,115.48,117.24
2023-10-24 17:35,566,255,311,16901,11855,5046,19590323.0,13688158.0,5902165.0,559,252,307,17656,11858,5798,20480755.0,13689944.0,6790810.0,115.46,116.97,115.45,117.12
2023-10-24 17:40,790,255,535,30508,18135,12373,35377322.0,20872542.0,14504779.0,778,249,529,30112,18033,12079,34913374.0,20751888.0,14161486.0,115.1,117.23,115.08,117.24
2023-10-24 17:45,258,197,61,13835,10035,3800,16050207.0,11583575.0,4466631.0,249,190,59,13891,9987,3904,16106720.0,11518684.0,4588035.0,115.43,117.54,115.34,117.52
2023-10-24 17:50,543,403,140,27610,18096,9514,32020448.0,20834431.0,11186017.0,521,393,128,27415,18064,9351,31795217.0,20797851.0,10997365.0,115.13,117.57,115.13,117.61
2023-10-24 17:55,515,373,142,34828,22584,12244,40462272.0,26035376.0,14426896.0,484,360,124,34894,22588,12306,40491592.0,25983559.0,14508032.0,115.28,117.83,115.03,117.89
2023-10-24 18:00,564,403,161,32889,22187,10702,38215073.0,25607841.0,12607232.0,545,393,152,32729,22168,10561,38028415.0,25585121.0,12443294.0,115.42,117.8,115.41,117.82
2023-10-24 18:05,607,507,100,25026,18615,6411,29064816.0,21521654.0,7543162.0,588,508,80,24847,18581,6266,28857651.0,21474890.0,7382761.0,115.61,117.66,115.57,117.82
2023-10-24 18:10,824,778,46,18326,15307,3019,21275510.0,17724006.0,3551504.0,826,778,48,18151,15186,2965,21057996.0,17566146.0,3491850.0,115.79,117.64,115.67,117.77
2023-10-24 18:15,675,611,64,20088,16497,3591,23299619.0,19095313.0,4204306.0,654,599,55,20251,16486,3765,23479153.0,19046267.0,4432885.0,115.75,117.08,115.53,117.74
2023-10-24 18:20,566,341,225,20202,8495,11707,23396689.0,9783871.0,13612818.0,555,333,222,19817,8367,11450,23016261.0,9608681.0,13407580.0,115.17,116.28,114.84,117.1
2023-10-24 18:25,1175,910,265,51190,35498,15692,59752518.0,41255557.0,18496961.0,1072,850,222,48238,33378,14860,55996802.0,38493721.0,17503081.0,116.22,117.88,115.33,117.79
2023-10-24 18:30,924,481,443,19444,16230,3214,22610732.0,18857859.0,3752873.0,889,454,435,18839,15338,3501,21916944.0,17818401.0,4098543.0,116.19,116.77,116.17,117.07
2023-10-24 18:35,434,313,121,10349,8371,1978,11986873.0,9725205.0,2261667.0,421,315,106,9588,8341,1247,11127389.0,9676310.0,1451079.0,116.18,114.34,116.01,116.37
2023-10-25 10:00,2159,1034,1125,44197,14191,30006,53014133.0,15968173.0,37045959.0,1224,821,403,26871,10969,15902,31203323.0,12660279.0,18543043.0,112.52,123.46,115.42,116.61
2023-10-25 10:05,1102,711,391,31683,13174,18509,36882091.0,15266948.0,21615143.0,974,650,324,27338,11299,16039,31765596.0,13091395.0,18674200.0,115.89,116.78,115.86,116.43
2023-10-25 10:10,979,694,285,23762,8854,14908,27621890.0,10253833.0,17368056.0,883,645,238,20798,8036,12762,24135324.0,9284059.0,14851264.0,115.81,116.5,115.53,116.37
2023-10-25 10:15,1124,408,716,47882,12554,35328,55268491.0,14236296.0,41032194.0,997,326,671,45230,10956,34274,52332397.0,12468482.0,39863914.0,113.4,116.15,113.81,116.31
2023-10-25 10:20,1261,553,708,62003,21314,40689,71885966.0,24354644.0,47531322.0,1184,508,676,60381,20846,39535,69851252.0,23756516.0,46094736.0,114.27,116.82,113.96,116.59
2023-10-25 10:25,976,306,670,39735,11176,28559,46014887.0,12730762.0,33284124.0,729,192,537,38577,10627,27950,44658929.0,12113786.0,32545143.0,113.91,116.55,113.99,116.44
2023-10-25 10:30,782,370,412,24800,5457,19343,28673156.0,6230822.0,22442334.0,733,344,389,23975,5236,18739,27734961.0,5976427.0,21758533.0,114.18,116.02,114.14,116.11
2023-10-25 10:35,693,207,486,37798,9052,28746,43756653.0,10333272.0,33423381.0,623,147,476,36915,8297,28618,42720143.0,9446791.0,33273351.0,114.15,116.27,113.86,116.27
2023-10-25 10:40,572,121,451,34337,6701,27636,39855558.0,7630736.0,32224822.0,523,88,435,31182,6383,24799,36052986.0,7254494.0,28798491.0,113.87,116.6,113.65,116.13
2023-10-25 10:45,857,313,544,53643,24777,28866,61870125.0,28260299.0,33609825.0,748,253,495,51315,23125,28190,59274070.0,26361947.0,32912122.0,114.06,116.43,114.0,116.75
2023-10-25 10:50,182,97,85,10997,5862,5135,12707203.0,6701594.0,6005609.0,139,65,74,9866,4786,5080,11417232.0,5475871.0,5941361.0,114.32,116.95,114.41,116.96
2023-10-25 10:55,164,74,90,11282,5570,5712,13017890.0,6340740.0,6677150.0,127,54,73,10748,5221,5527,12442517.0,5961604.0,6480913.0,113.84,116.9,114.19,117.26
2023-10-25 11:00,236,97,139,18093,7827,10266,20954075.0,8934205.0,12019870.0,229,90,139,18291,7839,10452,21185464.0,8943864.0,12241600.0,114.15,117.08,114.09,117.12
2023-10-25 11:05,541,222,319,26425,11517,14908,30615872.0,13154183.0,17461688.0,502,198,304,25878,11254,14624,29980533.0,12848896.0,17131637.0,114.22,117.13,114.17,117.15
2023-10-25 11:10,163,89,74,14393,6045,8348,16764355.0,6914244.0,9850111.0,145,77,68,12298,6119,6179,14238338.0,6987929.0,7250409.0,114.38,117.99,114.2,117.34
2023-10-25 11:15,180,93,87,12921,6535,6386,14947068.0,7467631.0,7479436.0,168,85,83,12865,6502,6363,14900223.0,7430288.0,7469935.0,114.27,117.12,114.28,117.4
2023-10-25 11:20,537,454,83,13273,6751,6522,15361198.0,7739339.0,7621859.0,532,452,80,12500,6639,5861,14465799.0,7607552.0,6858247.0,114.64,116.86,114.59,117.01
2023-10-25 11:25,570,160,410,21268,10642,10626,24657152.0,12242369.0,12414783.0,522,124,398,19568,9281,10287,22673748.0,10650553.0,12023195.0,115.04,116.83,114.76,116.88
2023-10-25 11:30,1217,590,627,62954,29691,33263,73130131.0,34127746.0,39002384.0,1098,542,556,60563,28926,31637,70251975.0,33186916.0,37065059.0,114.94,117.25,114.73,117.16
2023-10-25 11:35,218,123,95,11401,5128,6273,13215253.0,5877371.0,7337881.0,196,106,90,10992,4823,6169,12742326.0,5525017.0,7217308.0,114.61,116.98,114.56,116.99
2023-10-25 11:40,490,213,277,21540,8711,12829,24971943.0,9977313.0,14994629.0,454,189,265,20516,8044,12472,23783780.0,9200367.0,14583413.0,114.54,116.88,114.38,116.93
2023-10-25 11:45,476,138,338,30831,13502,17329,35730887.0,15409163.0,20321724.0,453,127,326,30410,13323,17087,35222659.0,15201675.0,20020984.0,114.13,117.27,114.1,117.17
2023-10-25 11:50,230,67,163,15136,4328,10808,17549314.0,4942820.0,12606493.0,218,60,158,14801,4162,10639,17171365.0,4752390.0,12418974.0,114.21,116.64,114.19,116.73
2023-10-25 11:55,103,53,50,4558,1558,3000,5309235.0,1785533.0,3523702.0,83,47,36,4008,1570,2438,4639405.0,1791540.0,2847865.0,114.6,117.46,114.11,116.81
2023-10-25 12:00,140,74,66,10389,5035,5354,12029273.0,5749793.0,6279479.0,120,60,60,10241,4915,5326,11857364.0,5610020.0,6247343.0,114.2,117.29,114.14,117.3
2023-10-25 12:05,181,62,119,9290,3084,6206,10780315.0,3534758.0,7245557.0,163,48,115,8798,2805,5993,10204199.0,3209220.0,6994979.0,114.62,116.75,114.41,116.72
2023-10-25 12:10,164,72,92,10563,3619,6944,12267190.0,4136731.0,8130459.0,156,70,86,10789,3551,7238,12512569.0,4056958.0,8455611.0,114.31,117.09,114.25,116.82
2023-10-25 12:15,1256,827,429,65745,42260,23485,76421432.0,48816944.0,27604487.0,1229,816,413,64479,41598,22881,74810928.0,47912909.0,26898018.0,115.52,117.54,115.18,117.56
2023-10-25 12:20,533,333,200,34100,23238,10862,39533706.0,26794880.0,12738826.0,514,320,194,32138,21597,10541,37267622.0,24876663.0,12390958.0,115.31,117.28,115.19,117.55
2023-10-25 12:25,298,164,134,6610,3826,2784,7645752.0,4384790.0,3260961.0,285,161,124,6012,3267,2745,6978324.0,3760662.0,3217662.0,114.61,117.13,115.11,117.22
2023-10-25 12:30,184,96,88,8387,4409,3978,9696059.0,5020582.0,4675477.0,172,92,80,7753,3874,3879,8998054.0,4437399.0,4560654.0,113.87,117.53,114.54,117.57
2023-10-25 12:35,479,242,237,10009,4890,5119,11603510.0,5624343.0,5979167.0,479,247,232,10193,4921,5272,11820364.0,5662860.0,6157504.0,115.02,116.8,115.08,116.8
2023-10-25 12:40,279,52,227,7306,2138,5168,8493998.0,2462303.0,6031694.0,262,37,225,6690,1881,4809,7764297.0,2153862.0,5610434.0,115.17,116.71,114.51,116.67
2023-10-25 12:45,307,270,37,7347,5575,1772,8493493.0,6444557.0,2048936.0,291,262,29,7022,5385,1637,8145914.0,6228169.0,1917745.0,115.6,115.63,115.66,117.15
2023-10-25 12:50,518,398,120,14128,6997,7131,16401996.0,8055922.0,8346073.0,504,390,114,12945,6874,6071,15016099.0,7908942.0,7107157.0,115.13,117.04,115.06,117.07
2023-10-25 12:55,822,157,665,32036,6980,25056,37084975.0,8032015.0,29052959.0,803,150,653,30900,6973,23927,35830570.0,8022869.0,27807701.0,115.07,115.95,115.06,116.22
2023-10-25 13:00,119,55,64,7293,3624,3669,8448329.0,4149435.0,4298894.0,111,48,63,7189,3518,3671,8327579.0,4027103.0,4300476.0,114.5,117.17,114.47,117.15
2023-10-25 13:05,183,98,85,12403,6837,5566,14377425.0,7866827.0,6510597.0,166,94,72,12023,6584,5439,13925962.0,7550438.0,6375524.0,115.06,116.97,114.68,117.22
2023-10-25 13:10,79,37,42,5157,2357,2800,6019562.0,2699394.0,3320168.0,68,31,37,5054,2318,2736,5882412.0,2652265.0,3230146.0,114.53,118.58,114.42,118.06
2023-10-25 13:15,177,74,103,11208,5271,5937,12976921.0,6042703.0,6934218.0,162,62,100,11679,5065,6614,13544714.0,5808023.0,7736691.0,114.64,116.8,114.67,116.97
2023-10-25 13:20,73,22,51,3778,1227,2551,4381974.0,1404897.0,2977076.0,59,18,41,3106,1223,1883,3601405.0,1400150.0,2201254.0,114.5,116.7,114.48,116.9
2023-10-25 13:25,129,56,73,7560,3590,3970,8765672.0,4122634.0,4643038.0,116,49,67,7515,3622,3893,8707862.0,4154037.0,4553824.0,114.84,116.95,114.69,116.97
2023-10-25 13:30,494,127,367,24650,7746,16904,28527069.0,8877492.0,19649576.0,481,114,367,23683,7716,15967,27457541.0,8842632.0,18614909.0,114.61,116.24,114.6,116.58
2023-10-25 13:35,593,97,496,25640,6697,18943,29647264.0,7675228.0,21972036.0,592,94,498,25296,6018,19278,29286390.0,6901795.0,22384595.0,114.61,115.99,114.69,116.11
2023-10-25 13:40,1564,140,1424,62981,12179,50802,72649809.0,13840480.0,58809329.0,1545,130,1415,62753,12715,50038,72521254.0,14456146.0,58065108.0,113.64,115.76,113.69,116.04
2023-10-25 13:45,1532,118,1414,67074,13089,53985,77618069.0,14936155.0,62681913.0,1510,102,1408,67220,12926,54294,77819573.0,14742090.0,63077482.0,114.11,116.11,114.05,116.18
2023-10-25 13:50,1167,97,1070,46978,7960,39018,54372638.0,9083351.0,45289286.0,1158,88,1070,46618,7979,38639,53953812.0,9101732.0,44852080.0,114.11,116.07,114.07,116.08
2023-10-25 13:55,1182,158,1024,51516,14552,36964,59553605.0,16580599.0,42973005.0,1145,129,1016,50581,13835,36746,58478335.0,15752901.0,42725434.0,113.94,116.26,113.86,116.27
2023-10-25 14:00,1106,146,960,51884,14547,37337,60024864.0,16587442.0,43437422.0,1098,140,958,52033,14687,37346,60212461.0,16741491.0,43470970.0,114.03,116.34,113.99,116.4
2023-10-25 14:05,1684,591,1093,62521,21256,41265,72360870.0,24332650.0,48028220.0,1674,588,1086,63147,21665,41482,73054930.0,24776704.0,48278226.0,114.47,116.39,114.36,116.38
2023-10-25 14:10,878,190,688,42093,12740,29353,48750243.0,14562277.0,34187966.0,870,185,685,41680,12685,28995,48235451.0,14499424.0,33736027.0,114.3,116.47,114.3,116.35
2023-10-25 14:15,369,150,219,13272,2429,10843,15375161.0,2800454.0,12574707.0,353,146,207,13388,2402,10986,15503652.0,2763721.0,12739931.0,115.29,115.97,115.06,115.97
2023-10-25 14:20,358,77,281,14346,3609,10737,16603912.0,4135323.0,12468589.0,345,69,276,14235,3569,10666,16475387.0,4088708.0,12386679.0,114.58,116.13,114.56,116.13
2023-10-25 14:25,645,271,374,31158,11273,19885,36094995.0,12910099.0,23184896.0,630,261,369,30543,11133,19410,35363145.0,12739522.0,22623623.0,114.52,116.59,114.43,116.56
2023-10-25 14:30,929,283,646,38548,15535,23013,44649429.0,17777153.0,26872275.0,962,318,644,39198,15756,23442,45429960.0,18024893.0,27405067.0,114.43,116.77,114.4,116.91
2023-10-25 14:35,759,371,388,33237,14390,18847,38498949.0,16484873.0,22014076.0,725,353,372,32268,14056,18212,37373716.0,16097907.0,21275809.0,114.56,116.8,114.53,116.82
2023-10-25 14:40,662,185,477,32254,12928,19326,37341594.0,14807461.0,22534133.0,659,182,477,32478,13148,19330,37592474.0,15054118.0,22538355.0,114.54,116.6,114.5,116.6
2023-10-25 14:45,454,364,90,9299,4906,4393,10770571.0,5673093.0,5097478.0,450,363,87,9343,4997,4346,10818568.0,5774363.0,5044205.0,115.64,116.04,115.56,116.07
2023-10-25 14:50,250,147,103,6147,2412,3735,7119385.0,2789235.0,4330150.0,241,142,99,6326,2613,3713,7319033.0,3014096.0,4304936.0,115.64,115.93,115.35,115.94
2023-10-25 14:55,647,318,329,32810,15105,17705,38002645.0,17330252.0,20672393.0,639,311,328,32730,14988,17742,37912012.0,17183693.0,20728319.0,114.73,116.76,114.65,116.83
2023-10-25 15:00,533,227,306,38309,17810,20499,44369939.0,20399368.0,23970571.0,525,224,301,38251,17851,20400,44318684.0,20446790.0,23871893.0,114.54,116.94,114.54,117.02
2023-10-25 15:05,360,228,132,20142,9285,10857,23321717.0,10643976.0,12677740.0,358,227,131,20042,9186,10856,23206662.0,10529642.0,12677020.0,114.64,116.77,114.63,116.77
2023-10-25 15:10,229,116,113,12725,5627,7098,14727573.0,6448506.0,8279067.0,223,113,110,12626,5547,7079,14616969.0,6356373.0,8260596.0,114.6,116.64,114.59,116.69
2023-10-25 15:15,228,85,143,12305,4271,8034,14247462.0,4880305.0,9367156.0,222,80,142,12282,4258,8024,14220540.0,4865284.0,9355256.0,114.27,116.59,114.26,116.59
2023-10-25 15:20,531,100,431,21706,7115,14591,25134029.0,8128016.0,17006012.0,522,93,429,21775,7097,14678,25213983.0,8106947.0,17107036.0,114.24,116.55,114.23,116.55
2023-10-25 15:25,701,118,583,32736,11828,20908,37909204.0,13520959.0,24388244.0,696,114,582,32614,11570,21044,37769482.0,13219659.0,24549823.0,114.31,116.65,114.26,116.66
2023-10-25 15:30,507,195,312,18131,7832,10299,20997019.0,8980430.0,12016589.0,500,190,310,17689,7627,10062,20484421.0,8745624.0,11738797.0,114.66,116.68,114.67,116.66
2023-10-25 15:35,235,97,138,12661,4779,7882,14658189.0,5471198.0,9186990.0,232,97,135,12646,4775,7871,14642307.0,5466710.0,9175596.0,114.48,116.56,114.49,116.57
2023-10-25 15:40,357,130,227,19406,7460,11946,22467559.0,8532889.0,13934669.0,355,128,227,19252,7306,11946,22288195.0,8354100.0,13934095.0,114.38,116.65,114.35,116.64
2023-10-25 15:45,20,15,5,815,482,333,943665.0,554191.0,389473.0,19,14,5,855,522,333,988586.0,599127.0,389459.0,114.98,116.96,114.78,116.95
2023-10-25 15:50,20,13,7,535,122,413,650630.0,141173.0,509456.0,13,9,4,507,116,391,590345.0,134035.0,456310.0,115.72,123.36,115.55,116.7
2023-10-25 15:55,135,82,53,4422,1928,2494,5114206.0,2215700.0,2898506.0,122,75,47,4523,2012,2511,5236963.0,2310015.0,2926948.0,114.92,116.22,114.81,116.57
2023-10-25 16:00,369,264,105,14478,8157,6321,16725490.0,9336874.0,7388616.0,364,262,102,14774,8460,6314,17041093.0,9658953.0,7382140.0,114.46,116.89,114.17,116.92
2023-10-25 16:05,284,96,188,23667,10345,13322,27386469.0,11805394.0,15581075.0,278,93,185,23182,10204,12978,26829897.0,11646325.0,15183572.0,114.12,116.96,114.13,116.99
2023-10-25 16:10,472,163,309,16299,6672,9627,18877416.0,7672746.0,11204669.0,468,161,307,16277,6661,9616,18853854.0,7659967.0,11193886.0,115.0,116.39,115.0,116.41
2023-10-25 16:15,337,24,313,5052,1329,3723,5851076.0,1520809.0,4330267.0,335,23,312,5071,1367,3704,5872454.0,1564484.0,4307970.0,114.43,116.31,114.45,116.31
2023-10-25 16:20,362,41,321,8271,2220,6051,9564894.0,2554007.0,7010887.0,357,38,319,7984,1998,5986,9247436.0,2296795.0,6950641.0,115.05,115.86,114.95,116.11
2023-10-25 16:25,472,334,138,5226,2426,2800,6050555.0,2802730.0,3247825.0,474,338,136,4744,2941,1803,5475768.0,3382787.0,2092980.0,115.53,115.99,115.02,116.08
2023-10-25 16:30,139,73,66,8873,4531,4342,10290074.0,5209020.0,5081054.0,125,70,55,8697,4409,4288,10057874.0,5037387.0,5020486.0,114.96,117.02,114.25,117.08
2023-10-25 16:35,160,90,70,11047,4329,6718,12760184.0,4943312.0,7816872.0,140,79,61,10694,4116,6578,12364547.0,4697801.0,7666746.0,114.19,116.36,114.14,116.55
2023-10-25 16:40,429,308,121,14669,6853,7816,16911041.0,7837921.0,9073119.0,407,293,114,15512,6754,8758,17922992.0,7723630.0,10199362.0,114.37,116.08,114.36,116.46
2023-10-25 16:45,1125,246,879,47622,11780,35842,55026773.0,13445882.0,41580890.0,1091,219,872,46884,11315,35569,54178940.0,12909520.0,41269419.0,114.14,116.01,114.09,116.03
2023-10-25 16:50,688,134,554,31614,8269,23345,36515075.0,9428804.0,27086271.0,678,135,543,31340,8172,23168,36228444.0,9317758.0,26910686.0,114.03,116.03,114.02,116.15
2023-10-25 16:55,160,29,131,10071,2618,7453,11651092.0,2992228.0,8658863.0,150,24,126,10018,2619,7399,11578900.0,2983017.0,8595882.0,114.29,116.18,113.9,116.18
2023-10-25 17:00,527,275,252,24829,9603,15226,28696125.0,10987740.0,17708385.0,516,268,248,27014,9435,17579,31379173.0,10784838.0,20594334.0,114.42,116.3,114.31,117.15
2023-10-25 17:05,558,68,490,39472,9769,29703,45921302.0,11120655.0,34800646.0,548,62,486,36572,9736,26836,42281079.0,11079394.0,31201684.0,113.84,117.16,113.8,116.27
2023-10-25 17:10,251,105,146,11658,4012,7646,13451297.0,4582481.0,8868816.0,201,63,138,11121,3682,7439,12849259.0,4201325.0,8647933.0,114.22,115.99,114.1,116.25
2023-10-25 17:15,227,58,169,10388,3141,7247,11993432.0,3576930.0,8416501.0,207,41,166,10007,2873,7134,11556533.0,3270197.0,8286335.0,113.88,116.14,113.83,116.15
2023-10-25 17:20,115,30,85,5023,1035,3988,5806188.0,1181037.0,4625150.0,106,24,82,5116,1142,3974,5912021.0,1302273.0,4609748.0,114.11,115.98,114.03,116.0
2023-10-25 17:25,148,33,115,6592,1093,5499,7614118.0,1247588.0,6366529.0,138,27,111,6279,1035,5244,7282072.0,1179809.0,6102263.0,114.14,115.78,113.99,116.37
2023-10-25 17:30,426,60,366,12020,2213,9807,13904730.0,2543548.0,11361182.0,402,42,360,11595,1976,9619,13400504.0,2254188.0,11146316.0,114.94,115.85,114.08,115.88
2023-10-25 17:35,179,77,102,11397,4054,7343,13155339.0,4623656.0,8531683.0,169,67,102,11481,4091,7390,13251757.0,4665006.0,8586750.0,114.05,116.19,114.03,116.19
2023-10-25 17:40,211,74,137,15050,5677,9373,17373690.0,6467778.0,10905912.0,203,70,133,15087,5755,9332,17407267.0,6548011.0,10859255.0,113.93,116.35,113.78,116.37
2023-10-25 17:45,519,62,457,18032,3222,14810,20792176.0,3664845.0,17127331.0,488,40,448,17724,3024,14700,20451226.0,3440835.0,17010391.0,113.74,115.65,113.78,115.72
2023-10-25 17:50,244,64,180,14164,5917,8247,16333101.0,6738853.0,9594247.0,235,57,178,13853,5616,8237,15971410.0,6388959.0,9582451.0,113.89,116.34,113.76,116.33
2023-10-25 17:55,175,154,21,2662,1484,1178,3072613.0,1698946.0,1373667.0,175,155,20,2960,1788,1172,3412332.0,2045331.0,1367001.0,114.48,116.61,114.39,116.64
2023-10-25 18:00,621,433,188,28527,16960,11567,32965983.0,19497057.0,13468926.0,602,419,183,28261,16780,11481,32593462.0,19222576.0,13370886.0,114.96,116.44,114.56,116.46
2023-10-25 18:05,1853,937,916,77710,40595,37115,89937150.0,46743842.0,43193308.0,1830,926,904,76797,39939,36858,88757787.0,45835981.0,42921806.0,115.15,116.38,114.76,116.45
2023-10-25 18:10,2383,857,1526,116191,50694,65497,134314063.0,58019910.0,76294153.0,2366,847,1519,116376,50793,65583,134513675.0,58116383.0,76397292.0,114.45,116.48,114.42,116.49
2023-10-25 18:15,2178,1452,726,65869,38751,27118,76121071.0,44555576.0,31565494.0,2170,1452,718,65351,38796,26555,75513218.0,44604514.0,30908704.0,114.98,116.4,114.97,116.4
2023-10-25 18:20,1039,843,196,29825,22209,7616,34437079.0,25585301.0,8851777.0,1043,844,199,30121,22397,7724,34779635.0,25799117.0,8980517.0,115.2,116.23,115.19,116.27
2023-10-25 18:25,1075,998,77,30335,28376,1959,34953333.0,32721086.0,2232247.0,1058,989,69,30146,28291,1855,34772684.0,32619845.0,2152838.0,115.31,113.95,115.3,116.06
2023-10-25 18:30,633,470,163,12933,8860,4073,14927180.0,10212459.0,4714720.0,628,467,161,12907,8849,4058,14897060.0,10199453.0,4697606.0,115.26,115.76,115.26,115.76
2023-10-25 18:35,218,102,116,6383,2407,3976,7393120.0,2779562.0,4613558.0,205,96,109,6007,2339,3668,6940214.0,2690188.0,4250026.0,115.48,116.04,115.01,115.87
2023-10-26 10:00,2790,638,2152,101694,14832,86862,119578941.0,16596704.0,102982237.0,1965,427,1538,79001,11115,67886,91368103.0,12761241.0,78606861.0,111.9,118.56,114.81,115.79
2023-10-26 10:05,1740,764,976,43930,22962,20968,50937982.0,26512706.0,24425275.0,1639,723,916,41491,22608,18883,47909078.0,26043989.0,21865089.0,115.46,116.49,115.2,115.79
2023-10-26 10:10,1925,264,1661,59917,9420,50497,69249968.0,10832434.0,58417534.0,1873,238,1635,58633,8867,49766,67793291.0,10191582.0,57601709.0,114.99,115.69,114.94,115.75
2023-10-26 10:15,2052,877,1175,93322,44735,48587,106705059.0,50882168.0,55822890.0,1682,665,1017,84025,39678,44347,96558474.0,45074760.0,51483714.0,113.74,114.89,113.6,116.09
2023-10-26 10:20,1368,690,678,56247,26749,29498,64626464.0,30352334.0,34274129.0,983,491,492,54464,25971,28493,62567906.0,29460427.0,33107479.0,113.47,116.19,113.44,116.2
2023-10-26 10:25,1122,643,479,59924,25695,34229,68822616.0,29147544.0,39675071.0,1023,585,438,56669,23801,32868,65133297.0,26968153.0,38165143.0,113.44,115.91,113.31,116.12
2023-10-26 10:30,1395,474,921,74989,26164,48825,85750350.0,29502628.0,56247721.0,1276,388,888,72269,24432,47837,82872111.0,27600009.0,55272101.0,112.76,115.2,112.97,115.54
2023-10-26 10:35,1073,473,600,66018,29989,36029,75661024.0,33941954.0,41719069.0,980,404,576,62324,26914,35410,71427955.0,30446123.0,40981831.0,113.18,115.79,113.12,115.74
2023-10-26 10:40,528,235,293,21023,10055,10968,24175641.0,11449904.0,12725737.0,459,199,260,19428,8884,10544,22311955.0,10082963.0,12228991.0,113.87,116.03,113.5,115.98
2023-10-26 10:45,727,502,225,22486,8594,13892,25849641.0,9775440.0,16074201.0,681,470,211,21340,8156,13184,24539938.0,9279086.0,15260852.0,113.75,115.71,113.77,115.75
2023-10-26 10:50,343,195,148,20954,10427,10527,24066608.0,11828384.0,12238223.0,304,178,126,19969,9669,10300,22932555.0,10966338.0,11966217.0,113.44,116.26,113.42,116.18
2023-10-26 10:55,400,256,144,13791,5523,8268,15848620.0,6283980.0,9564639.0,379,244,135,12978,5245,7733,14909525.0,5967045.0,8942480.0,113.78,115.68,113.77,115.64
2023-10-26 11:00,766,282,484,40494,16363,24131,46379861.0,18543777.0,27836083.0,735,265,470,39537,15713,23824,45382220.0,17821293.0,27560926.0,113.33,115.35,113.42,115.69
2023-10-26 11:05,773,615,158,30640,17802,12838,35178808.0,20265582.0,14913226.0,746,600,146,31710,19163,12547,36339731.0,21775461.0,14564270.0,113.84,116.16,113.63,116.08
2023-10-26 11:10,248,100,148,13642,4920,8722,15691978.0,5587182.0,10104795.0,241,102,139,14290,5578,8712,16404376.0,6315693.0,10088682.0,113.56,115.85,113.23,115.8
2023-10-26 11:15,433,200,233,29767,15120,14647,34240657.0,17200375.0,17040281.0,397,180,217,29063,14694,14369,33358031.0,16655451.0,16702580.0,113.76,116.34,113.35,116.24
2023-10-26 11:20,831,458,373,41169,25673,15496,47361559.0,29344096.0,18017463.0,784,433,351,39378,24529,14849,45225982.0,27951336.0,17274646.0,114.3,116.27,113.95,116.34
2023-10-26 11:25,432,296,136,29147,16339,12808,33508236.0,18570255.0,14937981.0,409,284,125,28831,16172,12659,33131220.0,18380969.0,14750251.0,113.66,116.63,113.66,116.52
2023-10-26 11:30,458,248,210,34983,16724,18259,40113530.0,18949835.0,21163695.0,441,235,206,32721,14902,17819,37569933.0,16876939.0,20692994.0,113.31,115.91,113.25,116.13
2023-10-26 11:35,507,217,290,37797,16954,20843,43242685.0,19218055.0,24024630.0,471,193,278,36673,16391,20282,42014905.0,18538268.0,23476637.0,113.35,115.26,113.1,115.75
2023-10-26 11:40,598,294,304,37438,21739,15699,42772293.0,24528121.0,18244172.0,586,286,300,34615,19076,15539,39698058.0,21636668.0,18061390.0,112.83,116.21,113.42,116.23
2023-10-26 11:45,263,193,70,17856,10838,7018,20448801.0,12284071.0,8164729.0,245,178,67,17408,10454,6954,19968215.0,11874701.0,8093514.0,113.34,116.34,113.59,116.39
2023-10-26 11:50,595,511,84,19493,12909,6584,22354936.0,14697407.0,7657528.0,578,505,73,19436,12896,6540,22296381.0,14682686.0,7613694.0,113.85,116.31,113.85,116.42
2023-10-26 11:55,424,278,146,29568,16341,13227,33840106.0,18516430.0,15323675.0,397,258,139,29346,16267,13079,33603281.0,18410492.0,15192789.0,113.31,115.85,113.18,116.16
2023-10-26 12:00,683,432,251,28980,12887,16093,33219290.0,14607387.0,18611902.0,655,417,238,28556,12749,15807,32759441.0,14447319.0,18312122.0,113.35,115.65,113.32,115.85
2023-10-26 12:05,2754,1639,1115,158337,94916,63421,183323312.0,109463998.0,73859314.0,2428,1479,949,143976,84669,59307,166084725.0,96907615.0,69177109.0,115.33,116.46,114.45,116.64
2023-10-26 12:10,2437,762,1675,127819,48617,79202,147532670.0,55517335.0,92015334.0,2377,732,1645,126091,49524,76567,145496141.0,56551541.0,88944599.0,114.19,116.18,114.19,116.17
2023-10-26 12:15,908,257,651,56636,20074,36562,65169772.0,22748603.0,42421168.0,869,227,642,55269,19376,35893,63649201.0,21971736.0,41677464.0,113.32,116.03,113.4,116.12
2023-10-26 12:20,763,156,607,40887,10894,29993,47145262.0,12361530.0,34783731.0,726,134,592,40838,11108,29730,47061428.0,12577251.0,34484177.0,113.47,115.97,113.23,115.99
2023-10-26 12:25,422,79,343,24301,4946,19355,28053126.0,5611302.0,22441824.0,412,78,334,24261,5219,19042,27996785.0,5924260.0,22072524.0,113.45,115.95,113.51,115.91
2023-10-26 12:30,180,48,132,10719,2647,8072,12357038.0,3003159.0,9353878.0,161,40,121,10712,2749,7963,12356525.0,3118422.0,9238103.0,113.46,115.88,113.44,116.01
2023-10-26 12:35,239,92,147,17245,6350,10895,19859026.0,7206066.0,12652959.0,221,83,138,17215,6339,10876,19820709.0,7190056.0,12630652.0,113.48,116.14,113.43,116.13
2023-10-26 12:40,597,129,468,24711,6564,18147,28472465.0,7447291.0,21025174.0,573,118,455,24607,6302,18305,28358188.0,7152660.0,21205527.0,113.46,115.86,113.5,115.85
2023-10-26 12:45,437,55,382,15541,3042,12499,17911442.0,3462009.0,14449432.0,421,45,376,14781,2696,12085,17039393.0,3064463.0,13974930.0,113.81,115.6,113.67,115.64
2023-10-26 12:50,145,25,120,7531,1493,6038,8684524.0,1695317.0,6989207.0,135,18,117,7542,1517,6025,8698758.0,1722325.0,6976432.0,113.55,115.75,113.53,115.79
2023-10-26 12:55,918,316,602,29376,9693,19683,33879385.0,11064677.0,22814707.0,898,305,593,29330,9992,19338,33815149.0,11402136.0,22413013.0,114.15,115.91,114.11,115.9
2023-10-26 13:00,895,368,527,37877,18699,19178,43719564.0,21366711.0,22352853.0,870,353,517,37360,18407,18953,43107870.0,21022514.0,22085356.0,114.27,116.55,114.21,116.53
2023-10-26 13:05,928,642,286,38869,28407,10462,44986789.0,32745347.0,12241442.0,865,611,254,36674,26718,9956,42468756.0,30780681.0,11688074.0,115.27,117.01,115.21,117.4
2023-10-26 13:10,929,730,199,47317,33010,14307,54832081.0,38036109.0,16795971.0,881,717,164,46483,32887,13596,53844061.0,37876060.0,15968000.0,115.23,117.4,115.17,117.45
2023-10-26 13:15,362,198,164,21877,12024,9853,25261948.0,13808282.0,11453665.0,338,189,149,22480,13170,9310,26003953.0,15106329.0,10897623.0,114.84,116.25,114.7,117.05
2023-10-26 13:20,904,275,629,50874,19335,31539,58777360.0,22108897.0,36668462.0,870,258,612,50049,19173,30876,57935457.0,21916608.0,36018849.0,114.35,116.26,114.31,116.66
2023-10-26 13:25,1134,536,598,39787,12574,27213,45966869.0,14415636.0,31551232.0,1108,527,581,38982,13050,25932,45154875.0,14959402.0,30195473.0,114.65,115.94,114.63,116.44
2023-10-26 13:30,703,349,354,34915,11622,23293,40323379.0,13246751.0,27076628.0,685,336,349,34576,11309,23267,39934133.0,12888489.0,27045644.0,113.98,116.24,113.97,116.24
2023-10-26 13:35,899,184,715,39227,7851,31376,45303996.0,8931692.0,36372304.0,877,180,697,38879,7866,31013,44918127.0,8949558.0,35968568.0,113.77,115.92,113.78,115.98
2023-10-26 13:40,1851,208,1643,74473,14642,59831,86051155.0,16651808.0,69399346.0,1831,193,1638,75229,14830,60399,86928449.0,16863379.0,70065069.0,113.73,115.99,113.71,116.0
2023-10-26 13:45,722,219,503,29378,7864,21514,33891082.0,8949629.0,24941453.0,703,210,493,28735,7732,21003,33184338.0,8799728.0,24384610.0,113.81,115.93,113.81,116.1
2023-10-26 13:50,1020,508,512,50646,17389,33257,58306289.0,19739453.0,38566835.0,981,491,490,49692,17322,32370,57195253.0,19661998.0,37533255.0,113.52,115.97,113.51,115.95
2023-10-26 13:55,278,135,143,13611,4212,9399,15678320.0,4793403.0,10884917.0,256,125,131,13382,4125,9257,15397879.0,4676381.0,10721497.0,113.8,115.81,113.37,115.82
2023-10-26 14:00,444,219,225,24449,6974,17475,27973710.0,7900687.0,20073022.0,406,198,208,23670,6887,16783,27186829.0,7802427.0,19384402.0,113.29,114.87,113.29,115.5
2023-10-26 14:05,833,395,438,31748,10282,21466,36402598.0,11672852.0,24729746.0,801,391,410,31401,10754,20647,36006207.0,12197360.0,23808847.0,113.53,115.2,113.42,115.31
2023-10-26 14:10,899,158,741,37018,6707,30311,42445686.0,7612686.0,34832999.0,867,134,733,35546,5831,29715,40801863.0,6612550.0,34189313.0,113.5,114.92,113.4,115.06
2023-10-26 14:15,1476,233,1243,66652,16698,49954,76346269.0,18866144.0,57480125.0,1398,200,1198,63587,15228,48359,72856075.0,17201259.0,55654816.0,112.98,115.07,112.96,115.09
2023-10-26 14:20,1135,239,896,56447,16736,39711,64708467.0,18935847.0,45772620.0,1093,218,875,55784,16710,39074,63939983.0,18887514.0,45052468.0,113.14,115.26,113.03,115.3
2023-10-26 14:25,638,139,499,26917,6729,20188,30793141.0,7602262.0,23190879.0,625,130,495,26893,6703,20190,30785400.0,7555478.0,23229921.0,112.98,114.87,112.72,115.06
2023-10-26 14:30,1299,244,1055,57889,13703,44186,66280913.0,15483664.0,50797248.0,1272,226,1046,57719,13786,43933,66107513.0,15571146.0,50536367.0,112.99,114.96,112.95,115.03
2023-10-26 14:35,779,235,544,34842,13037,21805,39868882.0,14718202.0,25150679.0,749,216,533,32403,10686,21717,37139762.0,12093412.0,25046350.0,112.9,115.34,113.17,115.33
2023-10-26 14:40,669,156,513,28792,8928,19864,33004742.0,10093336.0,22911406.0,658,148,510,28609,8830,19779,32797458.0,9984953.0,22812504.0,113.05,115.34,113.08,115.34
2023-10-26 14:45,466,170,296,27578,10427,17151,31623303.0,11792424.0,19830878.0,466,169,297,27711,10539,17172,31774361.0,11918092.0,19856268.0,113.1,115.63,113.09,115.63
2023-10-26 14:50,753,176,577,38679,12774,25905,44342263.0,14438993.0,29903270.0,748,176,572,39008,13239,25769,44717101.0,14965118.0,29751983.0,113.03,115.43,113.04,115.46
2023-10-26 14:55,693,429,264,25269,10413,14856,28956432.0,11806116.0,17150316.0,686,425,261,24150,10332,13818,27678594.0,11715644.0,15962950.0,113.38,115.44,113.39,115.52
2023-10-26 15:00,716,398,318,34968,12466,22502,39674378.0,14093598.0,25580779.0,574,311,263,28776,9281,19495,32872703.0,10488993.0,22383710.0,113.06,113.68,113.02,114.82
2023-10-26 15:05,1247,291,956,64728,18547,46181,74035702.0,20990490.0,53045211.0,1204,263,941,62081,17101,44980,70978364.0,19313661.0,51664703.0,113.17,114.86,112.94,114.86
2023-10-26 15:10,645,325,320,31029,13766,17263,35319483.0,15412134.0,19907349.0,638,325,313,29941,13503,16438,34144158.0,15181434.0,18962724.0,111.96,115.32,112.43,115.36
2023-10-26 15:15,1746,525,1221,73800,25950,47850,84332235.0,29414097.0,54918137.0,1715,504,1211,72667,24892,47775,83052170.0,28218521.0,54833649.0,113.35,114.77,113.36,114.77
2023-10-26 15:20,1707,172,1535,70813,13475,57338,80982356.0,15218990.0,65763366.0,1680,151,1529,69688,12887,56801,79698183.0,14545472.0,65152711.0,112.94,114.69,112.87,114.7
2023-10-26 15:25,1687,865,822,69975,30712,39263,80053993.0,34898141.0,45155852.0,1661,845,816,71473,32122,39351,81730333.0,36471872.0,45258461.0,113.63,115.01,113.54,115.01
2023-10-26 15:30,830,491,339,43736,23732,20004,50022124.0,26924087.0,23098036.0,800,473,327,43327,23568,19759,49571071.0,26737445.0,22833626.0,113.45,115.47,113.45,115.56
2023-10-26 15:35,867,182,685,46296,14332,31964,52925984.0,16159306.0,36766677.0,846,177,669,46670,14275,32395,53363129.0,16095377.0,37267751.0,112.75,115.03,112.75,115.04
2023-10-26 15:40,1033,219,814,54794,14214,40580,62459052.0,15940260.0,46518792.0,1003,195,808,53794,13718,40076,61405523.0,15437196.0,45968327.0,112.14,114.63,112.53,114.7
2023-10-26 15:45,1500,266,1234,64554,13894,50660,73351888.0,15600922.0,57750966.0,1375,164,1211,58646,12275,46371,66765814.0,13747085.0,53018729.0,112.29,114.0,111.99,114.34
2023-10-26 15:50,1487,328,1159,58083,20524,37559,66061740.0,23114484.0,42947256.0,1430,277,1153,54775,17550,37225,62329368.0,19731240.0,42598127.0,112.62,114.35,112.43,114.43
2023-10-26 15:55,514,322,192,21109,10606,10503,24047886.0,12009632.0,12038254.0,496,308,188,20612,10099,10513,23426812.0,11346098.0,12080714.0,113.23,114.62,112.35,114.91
2023-10-26 16:00,608,50,558,16054,2614,13440,18321321.0,2934957.0,15386363.0,601,42,559,16087,2633,13454,18362395.0,2961022.0,15401373.0,112.28,114.48,112.46,114.47
2023-10-26 16:05,792,291,501,48412,27132,21280,55276498.0,30780806.0,24495691.0,754,271,483,46564,26506,20058,53152625.0,30058097.0,23094528.0,113.45,115.11,113.4,115.14
2023-10-26 16:10,401,181,220,13994,7159,6835,15997785.0,8131084.0,7866701.0,390,178,212,13837,7145,6692,15814073.0,8108222.0,7705850.0,113.58,115.09,113.48,115.15
2023-10-26 16:15,101,45,56,7250,3599,3651,8292538.0,4065952.0,4226586.0,97,41,56,7012,3559,3453,8019057.0,4018668.0,4000389.0,112.97,115.77,112.92,115.85
2023-10-26 16:20,1066,723,343,56363,39389,16974,64464513.0,44861286.0,19603227.0,1031,701,330,55978,39141,16837,63989330.0,44540788.0,19448542.0,113.89,115.49,113.8,115.51
2023-10-26 16:25,1553,1426,127,71865,64440,7425,82265617.0,73650706.0,8614910.0,1522,1412,110,71964,64728,7236,82368283.0,73970542.0,8397741.0,114.29,116.03,114.28,116.06
2023-10-26 16:30,1358,1184,174,61139,50463,10676,69938305.0,57624715.0,12313590.0,1316,1169,147,60474,50661,9813,69238272.0,57852200.0,11386072.0,114.19,115.34,114.19,116.03
2023-10-26 16:35,498,415,83,25085,18616,6469,28749853.0,21240410.0,7509442.0,483,408,75,26325,18606,7719,30226753.0,21228315.0,8998438.0,114.1,116.08,114.09,116.58
2023-10-26 16:40,2139,873,1266,97251,44821,52430,111400483.0,51036061.0,60364422.0,2116,864,1252,94447,44479,49968,108151893.0,50647156.0,57504736.0,113.87,115.13,113.87,115.08
2023-10-26 16:45,1636,182,1454,62646,15322,47324,71745671.0,17398291.0,54347380.0,1618,171,1447,62295,15047,47248,71350962.0,17093022.0,54257939.0,113.55,114.84,113.6,114.84
2023-10-26 16:50,435,156,279,15079,5387,9692,17270698.0,6127447.0,11143251.0,422,152,270,14856,5333,9523,17015004.0,6064683.0,10950320.0,113.75,114.97,113.72,114.99
2023-10-26 16:55,65,44,21,2201,1316,885,2529224.0,1505665.0,1023558.0,61,45,16,2080,1187,893,2380839.0,1347017.0,1033822.0,114.41,115.66,113.48,115.77
2023-10-26 17:00,846,450,396,37037,19521,17516,42392777.0,22203958.0,20188819.0,838,445,393,34997,19337,15660,40009545.0,21991462.0,18018083.0,113.74,115.26,113.73,115.06
2023-10-26 17:05,312,285,27,10096,7978,2118,11535708.0,9081794.0,2453913.0,306,280,26,10063,7946,2117,11497781.0,9045045.0,2452736.0,113.84,115.86,113.83,115.86
2023-10-26 17:10,286,256,30,10964,8965,1999,12566337.0,10251327.0,2315009.0,272,248,24,10717,8739,1978,12244677.0,9953990.0,2290687.0,114.35,115.81,113.9,115.81
2023-10-26 17:15,177,137,40,9136,6073,3063,10441418.0,6900371.0,3541047.0,172,137,35,8991,6117,2874,10279596.0,6948967.0,3330629.0,113.62,115.61,113.6,115.89
2023-10-26 17:20,940,465,475,46294,21437,24857,52862432.0,24303128.0,28559304.0,908,448,460,44351,21194,23157,50653494.0,24025783.0,26627710.0,113.37,114.89,113.36,114.99
2023-10-26 17:25,1061,387,674,55314,14880,40434,63029017.0,16783766.0,46245251.0,1000,346,654,52172,13780,38392,59487137.0,15560537.0,43926600.0,112.79,114.37,112.92,114.42
2023-10-26 17:30,91,56,35,3067,1009,2058,3506915.0,1149242.0,2357672.0,79,48,31,3502,1522,1980,3967651.0,1698693.0,2268957.0,113.9,114.56,111.61,114.59
2023-10-26 17:35,1351,557,794,58595,20660,37935,66734007.0,23367582.0,43366425.0,1328,539,789,58480,20053,38427,66609970.0,22679037.0,43930932.0,113.11,114.32,113.1,114.32
2023-10-26 17:40,1376,801,575,49877,26972,22905,56718427.0,30578262.0,26140165.0,1344,773,571,47656,24865,22791,54216813.0,28192782.0,26024031.0,113.37,114.12,113.38,114.19
2023-10-26 17:45,1167,798,369,39084,23198,15886,44487687.0,26324097.0,18163589.0,1151,785,366,39136,23288,15848,44490056.0,26364457.0,18125599.0,113.48,114.34,113.21,114.37
2023-10-26 17:50,991,532,459,41054,18138,22916,46825031.0,20578421.0,26246610.0,978,522,456,40061,17147,22914,45698355.0,19453976.0,26244379.0,113.45,114.53,113.45,114.53
2023-10-26 17:55,523,88,435,28318,5479,22839,32349175.0,6174582.0,26174593.0,509,82,427,28647,5912,22735,32715916.0,6658241.0,26057674.0,112.7,114.6,112.62,114.61
2023-10-26 18:00,1291,939,352,63835,39289,24546,72835210.0,44611957.0,28223253.0,1267,925,342,63215,38988,24227,72084753.0,44222694.0,27862059.0,113.55,114.98,113.43,115.0
2023-10-26 18:05,892,812,80,35285,28747,6538,40221219.0,32694134.0,7527085.0,891,810,81,35547,28755,6792,40525539.0,32706677.0,7818862.0,113.73,115.13,113.74,115.12
2023-10-26 18:10,660,340,320,24100,10493,13607,27489460.0,11918598.0,15570862.0,653,342,311,24862,11423,13439,28396160.0,12975429.0,15420731.0,113.59,114.43,113.59,114.75
2023-10-26 18:15,1282,281,1001,42949,7337,35612,49021423.0,8303093.0,40718330.0,1272,279,993,42699,7309,35390,48748375.0,8270427.0,40477947.0,113.17,114.34,113.15,114.38
2023-10-26 18:20,2173,626,1547,75480,21504,53976,86115066.0,24303797.0,61811268.0,2163,619,1544,75406,21426,53980,86018157.0,24195913.0,61822244.0,113.02,114.52,112.93,114.53
2023-10-26 18:25,1630,165,1465,59715,11428,48287,68118947.0,12855369.0,55263577.0,1602,152,1450,58883,10973,47910,67166917.0,12329398.0,54837518.0,112.49,114.45,112.36,114.46
2023-10-26 18:30,2031,66,1965,58115,1195,56920,66302550.0,1357783.0,64944767.0,2018,61,1957,58102,1302,56800,66279522.0,1469212.0,64810310.0,113.62,114.1,112.84,114.1
2023-10-26 18:35,931,73,858,25201,493,24708,28703826.0,560645.0,28143181.0,930,76,854,24996,988,24008,28519960.0,1118218.0,27401741.0,113.72,113.9,113.18,114.14
2023-10-27 10:00,2309,519,1790,65550,7456,58094,77114683.0,7968656.0,69146027.0,1436,308,1128,41160,3234,37926,46915531.0,3654248.0,43261283.0,106.88,119.02,112.99,114.07
2023-10-27 10:05,1662,377,1285,46475,6690,39785,53100926.0,7569568.0,45531358.0,1568,323,1245,42926,4464,38462,48953387.0,5065345.0,43888042.0,113.15,114.44,113.47,114.11
2023-10-27 10:10,798,211,587,23545,7533,16012,26944287.0,8597947.0,18346340.0,743,180,563,23688,9239,14449,26863991.0,10348933.0,16515058.0,114.14,114.58,112.01,114.3
2023-10-27 10:15,1285,579,706,42030,24210,17820,47916577.0,27443975.0,20472601.0,1242,552,690,41193,23892,17301,46888193.0,27015488.0,19872705.0,113.36,114.89,113.07,114.86
2023-10-27 10:20,1168,689,479,52503,25332,27171,59944665.0,28603798.0,31340867.0,1034,590,444,50990,25152,25838,58199187.0,28403620.0,29795567.0,112.92,115.35,112.93,115.32
2023-10-27 10:25,627,258,369,35338,18216,17122,40430959.0,20604041.0,19826918.0,476,239,237,34332,17658,16674,39204856.0,19937268.0,19267588.0,113.11,115.8,112.91,115.55
2023-10-27 10:30,191,119,72,7324,3669,3655,8376651.0,4150702.0,4225949.0,171,110,61,6990,3666,3324,8005010.0,4147115.0,3857894.0,113.13,115.62,113.12,116.06
2023-10-27 10:35,622,525,97,18310,9994,8316,21232401.0,11319425.0,9912975.0,595,513,82,22499,9639,12860,26696798.0,10930151.0,15766646.0,113.26,119.2,113.4,122.6
2023-10-27 10:40,419,335,84,17148,6187,10961,20628510.0,7009689.0,13618821.0,402,331,71,10916,6189,4727,12460026.0,7011516.0,5448509.0,113.3,124.25,113.29,115.26
2023-10-27 10:45,2341,695,1646,123838,36510,87328,140974397.0,41024341.0,99950055.0,2236,614,1622,120543,33690,86853,137357226.0,37873195.0,99484030.0,112.36,114.45,112.42,114.54
2023-10-27 10:50,2531,410,2121,131454,28528,102926,149794000.0,32022501.0,117771498.0,2503,390,2113,131882,29018,102864,150286005.0,32575779.0,117710225.0,112.25,114.42,112.26,114.43
2023-10-27 10:55,2486,473,2013,134140,30607,103533,152687918.0,34305076.0,118382842.0,2460,461,1999,133945,30650,103295,152489941.0,34355905.0,118134035.0,112.08,114.34,112.09,114.37
2023-10-27 11:00,2545,455,2090,141248,30888,110360,160752794.0,34597187.0,126155607.0,2531,448,2083,140983,31060,109923,160440733.0,34792420.0,125648313.0,112.01,114.31,112.02,114.31
2023-10-27 11:05,1330,171,1159,75218,15818,59400,85642380.0,17739445.0,67902935.0,1309,153,1156,73217,13844,59373,83373482.0,15505308.0,67868174.0,112.15,114.31,112.0,114.31
2023-10-27 11:10,1830,583,1247,95098,18123,76975,108262077.0,20316842.0,87945235.0,1801,567,1234,94656,17791,76865,107784417.0,19942453.0,87841963.0,112.11,114.25,112.09,114.28
2023-10-27 11:15,661,160,501,34626,3728,30898,39442544.0,4176773.0,35265771.0,642,148,494,34064,3248,30816,38814405.0,3644220.0,35170185.0,112.04,114.14,112.2,114.13
2023-10-27 11:20,884,302,582,49035,13445,35590,55889884.0,15097133.0,40792751.0,867,286,581,46459,12825,33634,52883404.0,14381038.0,38502366.0,112.29,114.62,112.13,114.47
2023-10-27 11:25,1655,246,1409,107561,23050,84511,122554351.0,25856246.0,96698105.0,1637,236,1401,108141,23681,84460,123204274.0,26565858.0,96638415.0,112.17,114.42,112.18,114.42
2023-10-27 11:30,968,139,829,56409,8281,48128,64428130.0,9286146.0,55141983.0,949,124,825,53033,7851,45182,60470934.0,8807677.0,51663257.0,112.14,114.57,112.19,114.34
2023-10-27 11:35,510,56,454,22731,2354,20377,25929417.0,2640808.0,23288608.0,482,39,443,22568,2245,20323,25748792.0,2520971.0,23227820.0,112.18,114.29,112.29,114.29
2023-10-27 11:40,807,252,555,28242,5401,22841,32225815.0,6076077.0,26149737.0,794,247,547,28084,5490,22594,32033318.0,6176661.0,25856656.0,112.5,114.49,112.51,114.44
2023-10-27 11:45,271,37,234,14542,1949,12593,16587951.0,2189744.0,14398207.0,258,31,227,14463,1885,12578,16500974.0,2117032.0,14383942.0,112.35,114.34,112.31,114.36
2023-10-27 11:50,753,82,671,44913,8653,36260,51174692.0,9697708.0,41476983.0,725,63,662,44635,8440,36195,50879118.0,9467878.0,41411240.0,112.07,114.39,112.18,114.41
2023-10-27 11:55,760,307,453,37243,8823,28420,42438319.0,9900183.0,32538136.0,758,306,452,36103,8716,27387,41145590.0,9780948.0,31364642.0,112.21,114.49,112.22,114.52
2023-10-27 12:00,1207,354,853,64945,17954,46991,73878159.0,20116465.0,53761694.0,1183,344,839,65270,17897,47373,74229561.0,20052379.0,54177182.0,112.04,114.41,112.04,114.36
2023-10-27 12:05,1681,318,1363,95582,28784,66798,108668319.0,32248038.0,76420280.0,1655,305,1350,95254,28599,66655,108311256.0,32042987.0,76268269.0,112.03,114.41,112.04,114.42
2023-10-27 12:10,1559,408,1151,106637,32591,74046,121272129.0,36508085.0,84764043.0,1540,396,1144,106256,32270,73986,120840458.0,36143195.0,84697262.0,112.02,114.47,112.0,114.48
2023-10-27 12:15,1257,251,1006,72258,19734,52524,82226310.0,22123479.0,60102830.0,1234,234,1000,72677,20188,52489,82652892.0,22590364.0,60062527.0,112.11,114.43,111.9,114.43
2023-10-27 12:20,915,420,495,41689,17695,23994,47412475.0,19893369.0,27519106.0,887,399,488,41437,17519,23918,47122796.0,19692565.0,27430231.0,112.42,114.69,112.41,114.68
2023-10-27 12:25,741,251,490,32663,16533,16130,37398907.0,18786000.0,18612906.0,708,233,475,31265,15726,15539,35642634.0,17723059.0,17919575.0,113.63,115.39,112.7,115.32
2023-10-27 12:30,815,408,407,46331,27976,18355,52830427.0,31594703.0,21235724.0,816,404,412,46286,27834,18452,52775059.0,31427914.0,21347145.0,112.94,115.69,112.91,115.69
2023-10-27 12:35,1018,704,314,60579,36270,24309,69226356.0,41092630.0,28133725.0,995,693,302,61966,37753,24213,70742421.0,42720705.0,28021716.0,113.3,115.73,113.16,115.73
2023-10-27 12:40,657,448,209,38103,24795,13308,43525252.0,28111303.0,15413949.0,645,441,204,38138,24795,13343,43563891.0,28109415.0,15454475.0,113.37,115.82,113.37,115.82
2023-10-27 12:45,276,204,72,11754,9476,2278,13436714.0,10776212.0,2660502.0,258,198,60,11216,9400,1816,12792226.0,10687513.0,2104713.0,113.72,116.79,113.7,115.9
2023-10-27 12:50,416,263,153,19287,13256,6031,22069514.0,15055675.0,7013839.0,390,247,143,19293,13438,5855,22053171.0,15235284.0,6817886.0,113.58,116.3,113.37,116.45
2023-10-27 12:55,72,47,25,3990,2585,1405,4571209.0,2940208.0,1631001.0,65,48,17,3886,2563,1323,4450009.0,2909351.0,1540657.0,113.74,116.09,113.51,116.45
2023-10-27 13:00,368,307,61,12402,8834,3568,14172677.0,10026274.0,4146402.0,359,311,48,12212,8854,3358,13945972.0,10047746.0,3898226.0,113.5,116.21,113.48,116.09
2023-10-27 13:05,337,241,96,18044,13851,4193,20590834.0,15729599.0,4861234.0,331,240,91,18197,14085,4112,20764577.0,15993229.0,4771348.0,113.56,115.94,113.55,116.03
2023-10-27 13:10,214,177,37,14161,10672,3489,16176837.0,12114989.0,4061847.0,198,167,31,13749,10487,3262,15695833.0,11908372.0,3787461.0,113.52,116.42,113.55,116.11
2023-10-27 13:15,1391,402,989,89933,29696,60237,102239231.0,33334515.0,68904715.0,1250,310,940,87346,24735,62611,99489756.0,27780028.0,71709728.0,112.25,114.39,112.31,114.53
2023-10-27 13:20,1057,467,590,42732,12039,30693,48542438.0,13525311.0,35017126.0,976,412,564,43446,12600,30846,49332852.0,14116653.0,35216198.0,112.35,114.09,112.04,114.17
2023-10-27 13:25,697,283,414,29170,4224,24946,33191188.0,4739728.0,28451459.0,677,271,406,29649,4500,25149,33732147.0,5047037.0,28685109.0,112.21,114.05,112.16,114.06
2023-10-27 13:30,2029,689,1340,105131,22876,82255,118950301.0,25578085.0,93372216.0,1995,683,1312,104097,23251,80846,118036423.0,25987130.0,92049292.0,111.81,113.52,111.77,113.86
2023-10-27 13:35,1708,586,1122,77345,20845,56500,87652329.0,23354250.0,64298078.0,1622,537,1085,75449,19920,55529,85519383.0,22308992.0,63210391.0,112.04,113.8,111.99,113.83
2023-10-27 13:40,1734,699,1035,86843,32884,53959,98282225.0,36913236.0,61368988.0,1644,639,1005,85317,32071,53246,96693602.0,35996318.0,60697284.0,112.25,113.73,112.24,113.99
2023-10-27 13:45,2393,511,1882,117414,32384,85030,132922606.0,36289940.0,96632665.0,2284,445,1839,114661,30821,83840,129995771.0,34511083.0,95484688.0,112.06,113.65,111.97,113.89
2023-10-27 13:50,584,329,255,29019,11430,17589,32812663.0,12804268.0,20008394.0,542,310,232,27430,11091,16339,31070944.0,12428141.0,18642802.0,112.02,113.76,112.06,114.1
2023-10-27 13:55,2154,514,1640,105455,26709,78746,118682642.0,29750942.0,88931700.0,1966,426,1540,101950,25745,76205,115062332.0,28675924.0,86386408.0,111.39,112.93,111.38,113.36
2023-10-27 14:00,2231,674,1557,108469,33300,75169,121459106.0,36964912.0,84494194.0,2003,533,1470,103610,30993,72617,116603550.0,34401139.0,82202411.0,111.01,112.41,111.0,113.2
2023-10-27 14:05,889,291,598,46933,17750,29183,52687955.0,19685993.0,33001962.0,820,248,572,45009,16307,28702,50556490.0,18059346.0,32497144.0,110.91,113.09,110.75,113.22
2023-10-27 14:10,1808,410,1398,89088,27174,61914,100254810.0,30273057.0,69981753.0,1706,329,1377,83332,23983,59349,93654019.0,26583212.0,67070806.0,111.4,113.03,110.84,113.01
2023-10-27 14:15,1268,791,477,62078,34003,28075,69938907.0,38002847.0,31936060.0,1208,762,446,61289,33958,27331,69066191.0,37932251.0,31133939.0,111.76,113.75,111.7,113.91
2023-10-27 14:20,1104,466,638,47395,18826,28569,53564722.0,21042493.0,32522229.0,1033,414,619,45612,18286,27326,51542106.0,20426455.0,31115651.0,111.77,113.84,111.71,113.87
2023-10-27 14:25,1297,340,957,52136,16137,35999,58774671.0,18015425.0,40759246.0,1259,314,945,52091,15833,36258,58731299.0,17671876.0,41059423.0,111.64,113.22,111.61,113.24
2023-10-27 14:30,1769,1295,474,88801,60267,28534,100311394.0,67811355.0,32500039.0,1653,1232,421,86714,59052,27662,97923591.0,66294609.0,31628982.0,112.52,113.9,112.26,114.34
2023-10-27 14:35,2322,1334,988,102333,56179,46154,115764783.0,63078698.0,52686085.0,2238,1282,956,102129,56513,45616,115500213.0,63396199.0,52104013.0,112.28,114.15,112.18,114.22
2023-10-27 14:40,568,137,431,27012,9676,17336,30585763.0,10817577.0,19768186.0,549,125,424,26613,9496,17117,30148678.0,10614846.0,19533832.0,111.8,114.03,111.78,114.12
2023-10-27 14:45,406,297,109,18105,8899,9206,20466409.0,9929854.0,10536555.0,395,288,107,19940,8787,11153,22574291.0,9802314.0,12771977.0,111.58,114.45,111.55,114.52
2023-10-27 14:50,244,93,151,13797,4710,9087,15615805.0,5265989.0,10349816.0,218,77,141,13501,4469,9032,15296888.0,4987062.0,10309826.0,111.8,113.9,111.59,114.15
2023-10-27 14:55,355,167,188,20136,8160,11976,22834545.0,9164336.0,13670208.0,327,151,176,19798,8068,11730,22391896.0,9001236.0,13390660.0,112.31,114.15,111.57,114.16
2023-10-27 15:00,337,235,102,10492,3276,7216,11906957.0,3689168.0,8217789.0,333,232,101,10419,3227,7192,11812405.0,3621200.0,8191205.0,112.61,113.88,112.22,113.89
2023-10-27 15:05,261,95,166,19819,6753,13066,22451663.0,7539088.0,14912574.0,246,83,163,19689,6660,13029,22304992.0,7434191.0,14870801.0,111.64,114.13,111.62,114.14
2023-10-27 15:10,670,286,384,25018,8653,16365,28316905.0,9643011.0,18673894.0,659,278,381,24797,8477,16320,28103859.0,9472091.0,18631768.0,111.44,114.11,111.74,114.17
2023-10-27 15:15,175,52,123,10408,2739,7669,11796871.0,3061982.0,8734889.0,165,42,123,10110,2487,7623,11446617.0,2762727.0,8683890.0,111.79,113.9,111.09,113.92
2023-10-27 15:20,324,86,238,15019,4399,10620,16968831.0,4869386.0,12099444.0,311,77,234,14410,3810,10600,16333536.0,4256781.0,12076755.0,110.69,113.93,111.73,113.93
2023-10-27 15:25,280,83,197,13306,4634,8672,15061520.0,5187296.0,9874223.0,268,72,196,12988,4389,8599,14714592.0,4905040.0,9809551.0,111.94,113.86,111.76,114.08
2023-10-27 15:30,523,127,396,19496,5940,13556,22118453.0,6649230.0,15469222.0,507,117,390,18984,5640,13344,21526337.0,6311316.0,15215021.0,111.94,114.11,111.9,114.02
2023-10-27 15:35,611,74,537,21497,4566,16931,24395228.0,5104298.0,19290929.0,603,73,530,21340,4530,16810,24216612.0,5063340.0,19153271.0,111.79,113.94,111.77,113.94
2023-10-27 15:40,284,127,157,15390,5923,9467,17458803.0,6628938.0,10829864.0,273,120,153,15145,5814,9331,17169362.0,6503998.0,10665364.0,111.92,114.4,111.87,114.3
2023-10-27 15:45,254,60,194,14051,4572,9479,15951860.0,5114159.0,10837700.0,243,49,194,14029,4495,9534,15926512.0,5026467.0,10900045.0,111.86,114.33,111.82,114.33
2023-10-27 15:50,660,54,606,14746,2417,12329,16760069.0,2718991.0,14041077.0,656,51,605,14661,2358,12303,16656202.0,2644599.0,14011603.0,112.49,113.89,112.15,113.89
2023-10-27 15:55,577,109,468,18364,5048,13316,20889672.0,5660938.0,15228734.0,557,96,461,18329,5022,13307,20838122.0,5630073.0,15208049.0,112.14,114.36,112.11,114.29
2023-10-27 16:00,153,46,107,6039,991,5048,6870165.0,1119522.0,5750643.0,149,43,106,6347,1121,5226,7217618.0,1262410.0,5955207.0,112.97,113.92,112.61,113.95
2023-10-27 16:05,778,195,583,26780,12345,14435,30480560.0,13908331.0,16572229.0,737,167,570,25872,11582,14290,29434862.0,13028232.0,16406630.0,112.66,114.81,112.49,114.81
2023-10-27 16:10,688,128,560,18855,6507,12348,21461002.0,7337828.0,14123173.0,653,113,540,17404,6195,11209,19865719.0,6972477.0,12893241.0,112.77,114.38,112.55,115.03
2023-10-27 16:15,298,87,211,12680,4977,7703,14454751.0,5603226.0,8851525.0,285,81,204,12130,4750,7380,13812751.0,5341739.0,8471011.0,112.58,114.91,112.46,114.78
2023-10-27 16:20,570,89,481,17182,4625,12557,19608161.0,5219139.0,14389022.0,556,80,476,17455,4166,13289,19936252.0,4694529.0,15241723.0,112.85,114.59,112.69,114.69
2023-10-27 16:25,367,240,127,15138,7827,7311,17270398.0,8852078.0,8418320.0,351,228,123,14814,7539,7275,16897955.0,8521558.0,8376397.0,113.1,115.15,113.03,115.14
2023-10-27 16:30,674,424,250,25992,14410,11582,29670224.0,16320425.0,13349798.0,653,413,240,25848,14381,11467,29491402.0,16274127.0,13217275.0,113.26,115.26,113.16,115.26
2023-10-27 16:35,1797,1346,451,68152,42928,25224,77813292.0,48693871.0,29119421.0,1793,1347,446,68566,43008,25558,78294174.0,48784187.0,29509987.0,113.43,115.44,113.43,115.46
2023-10-27 16:40,1377,980,397,53980,30772,23208,61665936.0,34874308.0,26791628.0,1363,976,387,53504,30808,22696,61104273.0,34911198.0,26193074.0,113.33,115.44,113.32,115.41
2023-10-27 16:45,620,240,380,28240,13882,14358,32261303.0,15685833.0,16575469.0,601,228,373,27693,13551,14142,31639083.0,15309085.0,16329998.0,112.99,115.44,112.97,115.47
2023-10-27 16:50,590,313,277,16516,8218,8298,18884751.0,9320339.0,9564412.0,569,313,256,16433,8697,7736,18772930.0,9847515.0,8925415.0,113.41,115.26,113.23,115.38
2023-10-27 16:55,287,237,50,6940,3737,3203,7933621.0,4232314.0,3701306.0,276,234,42,7336,3980,3356,8385189.0,4505519.0,3879670.0,113.25,115.56,113.2,115.6
2023-10-27 17:00,332,138,194,12819,5454,7365,14644409.0,6166914.0,8477494.0,304,120,184,12423,5222,7201,14205588.0,5898119.0,8307469.0,113.07,115.11,112.95,115.37
2023-10-27 17:05,40,19,21,1556,375,1181,1782274.0,428827.0,1353446.0,39,19,20,1550,405,1145,1769833.0,457080.0,1312753.0,114.35,114.6,112.86,114.65
2023-10-27 17:10,662,398,264,17621,7611,10010,20096516.0,8612391.0,11484125.0,647,393,254,17583,7733,9850,20055886.0,8745295.0,11310591.0,113.16,114.73,113.09,114.83
2023-10-27 17:15,1519,909,610,73104,39016,34088,83391148.0,44148873.0,39242274.0,1487,883,604,72822,38824,33998,83006692.0,43873353.0,39133338.0,113.16,115.12,113.01,115.1
2023-10-27 17:20,1107,650,457,61013,36509,24504,69476377.0,41244339.0,28232037.0,1093,645,448,60944,36457,24487,69428959.0,41184586.0,28244372.0,112.97,115.21,112.97,115.34
2023-10-27 17:25,1474,800,674,58901,31413,27488,67113826.0,35499122.0,31614704.0,1460,792,668,59018,31310,27708,67279579.0,35380627.0,31898952.0,113.01,115.01,113.0,115.13
2023-10-27 17:30,518,208,310,27639,12037,15602,31525438.0,13558325.0,17967113.0,512,201,311,27933,12329,15604,31848446.0,13878773.0,17969672.0,112.64,115.16,112.57,115.16
2023-10-27 17:35,439,262,177,14997,6566,8431,17110322.0,7411622.0,9698700.0,434,258,176,14902,6521,8381,17001791.0,7359873.0,9641918.0,112.88,115.04,112.86,115.04
2023-10-27 17:40,306,38,268,4019,1873,2146,4583918.0,2121531.0,2462387.0,295,28,267,4063,1776,2287,4636551.0,2009356.0,2627195.0,113.27,114.74,113.14,114.88
2023-10-27 17:45,757,336,421,39189,23779,15410,44730547.0,26938390.0,17792157.0,736,328,408,39021,23678,15343,44457863.0,26737447.0,17720415.0,113.29,115.46,112.92,115.5
2023-10-27 17:50,677,82,595,8014,4346,3668,9114063.0,4930407.0,4183656.0,670,80,590,7796,4298,3498,8872193.0,4875931.0,3996262.0,113.45,114.06,113.45,114.24
2023-10-27 17:55,652,358,294,20828,12886,7942,23692203.0,14565088.0,9127115.0,638,350,288,20313,12319,7994,23113445.0,13921258.0,9192186.0,113.03,114.92,113.01,114.99
2023-10-27 18:00,280,105,175,18611,10694,7917,21176388.0,12062803.0,9113585.0,269,97,172,18048,10147,7901,20538591.0,11442702.0,9095889.0,112.8,115.11,112.77,115.12
2023-10-27 18:05,125,70,55,6596,5268,1328,7505925.0,5981581.0,1524343.0,118,68,50,6425,5248,1177,7311996.0,5958986.0,1353010.0,113.55,114.78,113.55,114.95
2023-10-27 18:10,115,70,45,6927,5490,1437,7893414.0,6240364.0,1653050.0,106,66,40,6865,5452,1413,7812564.0,6184499.0,1628065.0,113.67,115.03,113.44,115.22
2023-10-27 18:15,149,107,42,9645,7038,2607,10977312.0,7971500.0,3005812.0,141,102,39,9520,7033,2487,10835549.0,7965350.0,2870199.0,113.26,115.3,113.26,115.41
2023-10-27 18:20,98,62,36,5926,4160,1766,6741481.0,4706438.0,2035042.0,94,59,35,5933,4165,1768,6751777.0,4711357.0,2040420.0,113.14,115.23,113.12,115.41
2023-10-27 18:25,272,188,84,10804,6720,4084,12237278.0,7608556.0,4628721.0,256,181,75,10291,6866,3425,11713914.0,7770263.0,3943650.0,113.22,113.34,113.17,115.14
2023-10-27 18:30,266,214,52,3674,2247,1427,4137947.0,2553361.0,1584586.0,250,203,47,3480,2127,1353,3957340.0,2412976.0,1544364.0,113.63,111.04,113.45,114.14
2023-10-27 18:35,406,276,130,6659,2992,3667,7542400.0,3397853.0,4144547.0,390,271,119,6537,3113,3424,7440003.0,3531104.0,3908899.0,113.56,113.02,113.43,114.16
2023-10-30 10:00,3383,2526,857,101093,78161,22932,117774258.0,88678981.0,29095277.0,2540,2315,225,77550,74360,3190,88392995.0,84732303.0,3660691.0,113.46,126.88,113.95,114.76
2023-10-30 10:05,1061,693,368,18362,7746,10616,21053214.0,8817522.0,12235692.0,964,657,307,15735,7215,8520,17979779.0,8224477.0,9755302.0,113.83,115.26,113.99,114.5
2023-10-30 10:10,421,323,98,5241,3444,1797,5989681.0,3919186.0,2070495.0,358,304,54,4203,3093,1110,4793641.0,3520888.0,1272753.0,113.8,115.22,113.83,114.66
2023-10-30 10:15,443,138,305,15688,7460,8228,17878177.0,8411354.0,9466822.0,393,114,279,14497,6654,7843,16528218.0,7497057.0,9031161.0,112.75,115.06,112.67,115.15
2023-10-30 10:20,557,309,248,10007,5845,4162,11397104.0,6591881.0,4805222.0,317,204,113,9048,5568,3480,10317518.0,6299033.0,4018485.0,112.78,115.45,113.13,115.47
2023-10-30 10:25,617,348,269,23914,11234,12680,27316252.0,12700826.0,14615426.0,575,322,253,22634,10277,12357,25842560.0,11613543.0,14229017.0,113.06,115.26,113.01,115.15
2023-10-30 10:30,400,123,277,13904,6731,7173,15879867.0,7587107.0,8292760.0,375,106,269,13602,6611,6991,15524548.0,7450206.0,8074342.0,112.72,115.61,112.69,115.5
2023-10-30 10:35,428,161,267,12676,5467,7209,14508111.0,6175181.0,8332930.0,409,151,258,12651,5875,6776,14433038.0,6624329.0,7808709.0,112.95,115.59,112.75,115.24
2023-10-30 10:40,669,403,266,45710,13309,32401,52180944.0,14997682.0,37183261.0,643,402,241,30325,13415,16910,34606881.0,15120025.0,19486856.0,112.69,114.76,112.71,115.24
2023-10-30 10:45,891,477,414,44127,17665,26462,50221295.0,19841726.0,30379569.0,787,410,377,40006,16275,23731,45572317.0,18281189.0,27291128.0,112.32,114.8,112.33,115.0
2023-10-30 10:50,361,143,218,17413,6778,10635,19610583.0,7580197.0,12030385.0,306,98,208,31152,5918,25234,35480411.0,6627897.0,28852514.0,111.84,113.12,112.0,114.34
2023-10-30 10:55,1191,533,658,65090,25090,40000,74136519.0,28185441.0,45951077.0,1135,500,635,67051,25110,41941,76342230.0,28187357.0,48154873.0,112.34,114.88,112.26,114.82
2023-10-30 11:00,466,259,207,29458,11354,18104,33540722.0,12758092.0,20782629.0,455,254,201,28889,11141,17748,32876472.0,12520750.0,20355721.0,112.37,114.8,112.38,114.69
2023-10-30 11:05,505,282,223,22281,7341,14940,25369292.0,8245042.0,17124249.0,476,273,203,21489,7151,14338,24464873.0,8031488.0,16433384.0,112.31,114.62,112.31,114.61
2023-10-30 11:10,221,95,126,11728,4654,7074,13396350.0,5247514.0,8148835.0,184,79,105,10587,4007,6580,12061750.0,4506123.0,7555627.0,112.75,115.19,112.46,114.83
2023-10-30 11:15,192,84,108,13298,5641,7657,15186292.0,6388178.0,8798113.0,170,68,102,12837,5236,7601,14635886.0,5888215.0,8747671.0,113.25,114.9,112.46,115.09
2023-10-30 11:20,1601,1083,518,129990,46725,83265,147432305.0,52366936.0,95065369.0,1468,1006,462,122821,42440,80381,139591791.0,47804904.0,91786887.0,112.07,114.17,112.64,114.19
2023-10-30 11:25,1517,455,1062,103332,24870,78462,117228794.0,27827077.0,89401717.0,1422,410,1012,84833,23338,61495,96261818.0,26137364.0,70124454.0,111.89,113.94,111.99,114.03
2023-10-30 11:30,999,280,719,39556,11770,27786,44840072.0,13195506.0,31644566.0,933,238,695,39204,12384,26820,44364011.0,13846332.0,30517678.0,112.11,113.89,111.81,113.79
2023-10-30 11:35,679,209,470,34412,12266,22146,38990966.0,13759337.0,25231629.0,644,190,454,32519,10964,21555,36844623.0,12284995.0,24559627.0,112.17,113.93,112.05,113.94
2023-10-30 11:40,672,260,412,23964,9235,14729,27215684.0,10389373.0,16826310.0,631,234,397,38521,9042,29479,43701615.0,10164043.0,33537572.0,112.5,114.24,112.41,113.77
2023-10-30 11:45,1895,588,1307,119867,28567,91300,135093753.0,31332299.0,103761453.0,1800,528,1272,114088,25296,88792,128973051.0,28124027.0,100849023.0,109.68,113.65,111.18,113.58
2023-10-30 11:50,1761,418,1343,100163,30450,69713,113237798.0,33911448.0,79326350.0,1678,361,1317,92326,28672,63654,104322804.0,31840799.0,72482004.0,111.37,113.79,111.05,113.87
2023-10-30 11:55,691,259,432,41520,17866,23654,47162452.0,20174324.0,26988128.0,630,229,401,36186,13041,23145,41024486.0,14601156.0,26423330.0,112.92,114.1,111.96,114.16
2023-10-30 12:00,1163,578,585,47793,17277,30516,54262779.0,19472500.0,34790279.0,1144,570,574,48794,18229,30565,55345817.0,20501873.0,34843943.0,112.71,114.01,112.47,114.0
2023-10-30 12:05,1412,1175,237,46934,35461,11473,53310414.0,40217782.0,13092632.0,1402,1169,233,47216,35605,11611,53587381.0,40335486.0,13251894.0,113.41,114.12,113.29,114.13
2023-10-30 12:10,1176,1005,171,49178,35025,14153,55828031.0,39617428.0,16210603.0,1169,1005,164,49023,34953,14070,55647272.0,39532866.0,16114405.0,113.11,114.54,113.1,114.53
2023-10-30 12:15,1331,1017,314,41553,30318,11235,47163630.0,34356570.0,12807059.0,1329,1019,310,41729,30490,11239,47352106.0,34538907.0,12813199.0,113.32,113.99,113.28,114.01
2023-10-30 12:20,1591,77,1514,53462,8734,44728,60753694.0,9802196.0,50951498.0,1570,66,1504,53306,8788,44518,60557071.0,9832450.0,50724620.0,112.23,113.91,111.88,113.94
2023-10-30 12:25,393,50,343,19058,5331,13727,21644649.0,5960997.0,15683652.0,391,52,339,19052,5451,13601,21635316.0,6094914.0,15540401.0,111.82,114.25,111.81,114.26
2023-10-30 12:30,456,78,378,20322,5160,15162,23084129.0,5782788.0,17301341.0,451,79,372,21758,7177,14581,24384118.0,7748812.0,16635305.0,112.07,114.11,107.97,114.09
2023-10-30 12:35,95,56,39,6262,2907,3355,7108595.0,3255820.0,3852775.0,90,52,38,6320,2901,3419,7176089.0,3248230.0,3927859.0,112.0,114.84,111.97,114.88
2023-10-30 12:40,211,48,163,8873,3223,5650,10053147.0,3605118.0,6448029.0,187,36,151,8659,3115,5544,9825617.0,3484275.0,6341341.0,111.86,114.12,111.85,114.38
2023-10-30 12:45,863,342,521,40776,12833,27943,46127826.0,14328296.0,31799529.0,777,292,485,38023,12066,25957,43044523.0,13478636.0,29565886.0,111.65,113.8,111.71,113.9
2023-10-30 12:50,772,239,533,44650,14998,29652,50150999.0,16417373.0,33733626.0,720,201,519,41175,12346,28829,46571397.0,13775856.0,32795541.0,109.46,113.77,111.58,113.76
2023-10-30 12:55,1027,146,881,44116,10090,34026,49876610.0,11254008.0,38622601.0,995,125,870,43469,9646,33823,49181011.0,10759215.0,38421796.0,111.54,113.51,111.54,113.6
2023-10-30 13:00,318,149,169,16262,4853,11409,18391955.0,5414698.0,12977256.0,266,109,157,16223,4679,11544,18346461.0,5212223.0,13134237.0,111.57,113.75,111.4,113.78
2023-10-30 13:05,240,106,134,13618,4903,8715,15442059.0,5506453.0,9935605.0,198,92,106,12916,5040,7876,14601691.0,5622095.0,8979595.0,112.31,114.01,111.55,114.01
2023-10-30 13:10,446,344,102,20872,10417,10455,23608559.0,11642728.0,11965830.0,433,332,101,20579,9542,11037,23277081.0,10650524.0,12626556.0,111.77,114.45,111.62,114.4
2023-10-30 13:15,156,80,76,10435,4631,5804,11822126.0,5186413.0,6635713.0,139,71,68,10240,4500,5740,11590385.0,5027198.0,6563186.0,111.99,114.33,111.72,114.34
2023-10-30 13:20,136,67,69,10558,4634,5924,11961153.0,5177549.0,6783604.0,130,64,66,10376,4742,5634,11736231.0,5289137.0,6447093.0,111.73,114.51,111.54,114.43
2023-10-30 13:25,383,134,249,27373,8818,18555,30974898.0,9854278.0,21120620.0,349,118,231,25761,8751,17010,29132123.0,9769093.0,19363029.0,111.75,113.83,111.63,113.83
2023-10-30 13:30,451,141,310,28296,8100,20196,32017775.0,9039086.0,22978689.0,433,131,302,28060,7932,20128,31752673.0,8850598.0,22902075.0,111.59,113.78,111.58,113.78
2023-10-30 13:35,1635,287,1348,79265,20343,58922,89497029.0,22670951.0,66826078.0,1542,237,1305,77237,19714,57523,87303544.0,21958910.0,65344634.0,111.44,113.41,111.39,113.6
2023-10-30 13:40,282,145,137,16185,5053,11132,18304305.0,5643822.0,12660483.0,266,138,128,16190,5135,11055,18308512.0,5733050.0,12575462.0,111.69,113.73,111.65,113.75
2023-10-30 13:45,274,120,154,17985,5102,12883,20329998.0,5686364.0,14643634.0,218,79,139,17533,4893,12640,19817366.0,5449364.0,14368002.0,111.45,113.67,111.37,113.67
2023-10-30 13:50,124,75,49,6483,3224,3259,7330018.0,3615381.0,3714637.0,106,57,49,6249,3066,3183,7053988.0,3425168.0,3628820.0,112.14,113.98,111.71,114.01
2023-10-30 13:55,114,79,35,3605,2115,1490,4087249.0,2382588.0,1704660.0,95,69,26,3387,2015,1372,3826211.0,2255175.0,1571036.0,112.65,114.41,111.92,114.51
2023-10-30 14:00,74,40,34,1328,644,684,1501330.0,721088.0,780242.0,56,31,25,1222,582,640,1381126.0,650318.0,730808.0,111.97,114.07,111.74,114.19
2023-10-30 14:05,251,74,177,14088,4802,9286,15916754.0,5354234.0,10562520.0,227,56,171,13848,4680,9168,15638875.0,5208061.0,10430813.0,111.5,113.75,111.28,113.77
2023-10-30 14:10,692,450,242,26687,15598,11089,30116537.0,17511055.0,12605482.0,663,432,231,26477,15440,11037,29891386.0,17332296.0,12559089.0,112.26,113.68,112.26,113.79
2023-10-30 14:15,133,69,64,10432,4776,5656,11781364.0,5317728.0,6463636.0,116,59,57,9952,4739,5213,11236904.0,5273547.0,5963356.0,111.34,114.28,111.28,114.39
2023-10-30 14:20,98,52,46,4783,2264,2519,5464375.0,2592383.0,2871992.0,82,40,42,4186,1821,2365,4728282.0,2030540.0,2697742.0,114.5,114.01,111.51,114.07
2023-10-30 14:25,158,79,79,9398,3709,5689,10677104.0,4138182.0,6538922.0,131,64,67,8142,3557,4585,9197364.0,3964447.0,5232917.0,111.57,114.94,111.45,114.13
2023-10-30 14:30,97,55,42,4874,2225,2649,5505399.0,2481649.0,3023750.0,87,49,38,5616,2180,3436,6403146.0,2430614.0,3972532.0,111.53,114.15,111.5,115.62
2023-10-30 14:35,67,34,33,5476,2976,2500,6176240.0,3331310.0,2844930.0,58,33,25,3236,1184,2052,3664346.0,1321807.0,2342539.0,111.94,113.8,111.64,114.16
2023-10-30 14:40,94,53,41,5795,3430,2365,6534623.0,3830331.0,2704291.0,69,34,35,4667,2342,2325,5268629.0,2609964.0,2658665.0,111.67,114.35,111.44,114.35
2023-10-30 14:45,599,355,244,22164,8526,13638,24959494.0,9507592.0,15451902.0,515,310,205,20329,8504,11825,22909624.0,9483176.0,13426448.0,111.51,113.3,111.51,113.54
2023-10-30 14:50,486,210,276,25852,10116,15736,29129195.0,11253302.0,17875892.0,448,186,262,25839,9813,16026,29112062.0,10908548.0,18203514.0,111.24,113.6,111.16,113.59
2023-10-30 14:55,537,310,227,17826,7113,10713,20092909.0,7923119.0,12169790.0,516,298,218,17798,7086,10712,20057753.0,7888758.0,12168995.0,111.39,113.6,111.33,113.6
2023-10-30 15:00,378,144,234,21715,9486,12229,24426194.0,10543870.0,13882324.0,359,127,232,21694,9370,12324,24440466.0,10442488.0,13997978.0,111.15,113.52,111.45,113.58
2023-10-30 15:05,579,233,346,33630,13335,20295,37844648.0,14843235.0,23001413.0,519,198,321,32647,13105,19542,36755054.0,14572241.0,22182813.0,111.31,113.34,111.2,113.51
2023-10-30 15:10,388,299,89,10950,5573,5377,12329003.0,6218606.0,6110397.0,347,272,75,11308,5514,5794,12739791.0,6153256.0,6586535.0,111.58,113.64,111.59,113.68
2023-10-30 15:15,722,419,303,29221,10803,18418,32922186.0,12034499.0,20887686.0,620,369,251,30378,12545,17833,34183674.0,13950155.0,20233519.0,111.4,113.41,111.2,113.46
2023-10-30 15:20,546,239,307,24871,9764,15107,27894644.0,10827948.0,17066696.0,479,185,294,20944,6210,14734,23561833.0,6898389.0,16663443.0,110.9,112.97,111.09,113.1
2023-10-30 15:25,436,170,266,25738,10115,15623,28970649.0,11260266.0,17710383.0,394,133,261,23825,8225,15600,26829405.0,9135589.0,17693816.0,111.32,113.36,111.07,113.42
2023-10-30 15:30,174,77,97,11271,5453,5818,12722489.0,6087450.0,6635038.0,139,60,79,12750,7017,5733,14342266.0,7802868.0,6539398.0,111.63,114.04,111.2,114.07
2023-10-30 15:35,475,323,152,25257,15947,9310,28527608.0,17888361.0,10639247.0,453,317,136,24490,15278,9212,27642782.0,17113701.0,10529080.0,112.17,114.28,112.02,114.3
2023-10-30 15:40,274,177,97,14611,7178,7433,16642221.0,8033229.0,8608992.0,240,156,84,13136,7633,5503,14836552.0,8515270.0,6321281.0,111.91,115.82,111.56,114.87
2023-10-30 15:45,653,264,389,7359,3194,4165,8324679.0,3582128.0,4742550.0,632,263,369,7219,3154,4065,8166095.0,3536893.0,4629201.0,112.15,113.87,112.14,113.88
2023-10-30 15:50,67,37,30,2205,1229,976,2498565.0,1383332.0,1115232.0,52,31,21,2025,1123,902,2293103.0,1258709.0,1034394.0,112.56,114.27,112.08,114.68
2023-10-30 15:55,65,35,30,2761,1376,1385,3124730.0,1536321.0,1588409.0,67,42,25,3483,2005,1478,3929781.0,2233887.0,1695893.0,111.65,114.69,111.42,114.74
2023-10-30 16:00,169,137,32,5431,3925,1506,6144684.0,4425409.0,1719275.0,178,135,43,5352,3808,1544,6049435.0,4286057.0,1763378.0,112.75,114.16,112.55,114.21
2023-10-30 16:05,156,99,57,9139,5180,3959,10341483.0,5799681.0,4541802.0,134,90,44,8980,5088,3892,10157551.0,5695550.0,4462000.0,111.96,114.72,111.94,114.65
2023-10-30 16:10,86,54,32,5150,2702,2448,5822686.0,3018751.0,2803935.0,81,52,29,5183,2743,2440,5857780.0,3062596.0,2795184.0,111.72,114.54,111.65,114.56
2023-10-30 16:15,43,30,13,1958,1055,903,2214817.0,1181904.0,1032913.0,42,30,12,2118,1225,893,2386878.0,1365338.0,1021539.0,112.03,114.39,111.46,114.39
2023-10-30 16:20,337,112,225,13874,6727,7147,15702917.0,7555288.0,8147629.0,320,103,217,13646,6641,7005,15440875.0,7444449.0,7996426.0,112.31,114.0,112.1,114.15
2023-10-30 16:25,438,232,206,27076,13443,13633,30650825.0,15055786.0,15595038.0,385,203,182,26725,13179,13546,30250045.0,14753779.0,15496265.0,112.0,114.39,111.95,114.4
2023-10-30 16:30,176,78,98,8794,4129,4665,9975025.0,4627239.0,5347786.0,165,75,90,8954,4275,4679,10157176.0,4791018.0,5366157.0,112.07,114.64,112.07,114.69
2023-10-30 16:35,144,90,54,9229,4527,4702,10431624.0,5067855.0,5363769.0,134,87,47,9027,4528,4499,10228605.0,5068953.0,5159652.0,111.95,114.07,111.95,114.68
2023-10-30 16:40,222,126,96,7948,3765,4183,9004669.0,4219960.0,4784709.0,209,118,91,9921,5750,4171,10881963.0,6110762.0,4771201.0,112.08,114.38,106.27,114.39
2023-10-30 16:45,426,130,296,10223,2818,7405,11648030.0,3164896.0,8483133.0,420,129,291,9839,2834,7005,11144588.0,3181684.0,7962904.0,112.31,114.56,112.27,113.67
2023-10-30 16:50,162,72,90,7976,2631,5345,9026114.0,2942705.0,6083408.0,157,70,87,8736,3484,5252,9851978.0,3864869.0,5987108.0,111.85,113.81,110.93,114.0
2023-10-30 16:55,121,49,72,8054,2752,5302,9110142.0,3071866.0,6038275.0,110,37,73,7791,2524,5267,8821149.0,2820532.0,6000617.0,111.62,113.89,111.75,113.93
2023-10-30 17:00,529,251,278,26811,9188,17623,30251146.0,10249863.0,20001283.0,506,238,268,26313,9020,17293,29749729.0,10057536.0,19692192.0,111.56,113.5,111.5,113.87
2023-10-30 17:05,847,681,166,24606,10259,14347,27800693.0,11447443.0,16353250.0,834,671,163,24594,10235,14359,27786315.0,11418878.0,16367437.0,111.58,113.98,111.57,113.99
2023-10-30 17:10,151,63,88,11303,3710,7593,12793972.0,4131506.0,8662466.0,145,62,83,11149,3863,7286,12598508.0,4302650.0,8295858.0,111.36,114.08,111.38,113.86
2023-10-30 17:15,144,42,102,8590,1933,6657,9713744.0,2151654.0,7562090.0,138,39,99,8705,2115,6590,9835326.0,2347659.0,7487667.0,111.31,113.6,111.0,113.62
2023-10-30 17:20,101,45,56,4621,1454,3167,5222799.0,1620736.0,3602062.0,90,39,51,4936,1850,3086,5569173.0,2057897.0,3511276.0,111.47,113.74,111.24,113.78
2023-10-30 17:25,133,73,60,5070,1808,3262,5715016.0,2019317.0,3695699.0,113,57,56,4937,1744,3193,5578560.0,1947298.0,3631262.0,111.69,113.3,111.66,113.73
2023-10-30 17:30,63,30,33,3025,862,2163,3419626.0,962098.0,2457528.0,56,25,31,2972,801,2171,3360102.0,893382.0,2466720.0,111.61,113.62,111.53,113.62
2023-10-30 17:35,2418,1188,1230,178568,95409,83159,202516957.0,107490136.0,95026820.0,2091,1044,1047,159988,85648,74340,181283541.0,96176684.0,85106856.0,112.66,114.27,112.29,114.48
2023-10-30 17:40,1094,347,747,64451,22801,41650,72697092.0,25417388.0,47279704.0,928,247,681,61180,21386,39794,69066239.0,23798938.0,45267300.0,111.47,113.52,111.28,113.75
2023-10-30 17:45,649,247,402,40971,13242,27729,46129294.0,14673166.0,31456128.0,563,183,380,39410,11979,27431,44385001.0,13288340.0,31096660.0,110.81,113.44,110.93,113.36
2023-10-30 17:50,349,89,260,22069,6009,16060,24844852.0,6668256.0,18176596.0,310,68,242,21430,5924,15506,24122848.0,6568818.0,17554029.0,110.97,113.18,110.88,113.21
2023-10-30 17:55,646,347,299,34002,11607,22395,38081566.0,12891391.0,25190175.0,595,312,283,32603,11812,20791,36634020.0,13099892.0,23534127.0,111.07,112.48,110.9,113.19
2023-10-30 18:00,383,252,131,13252,5534,7718,14907391.0,6177631.0,8729760.0,370,242,128,13628,5477,8151,15318126.0,6095538.0,9222587.0,111.63,113.11,111.29,113.15
2023-10-30 18:05,117,72,45,4768,2380,2388,5331821.0,2621306.0,2710515.0,81,40,41,4201,1796,2405,4725738.0,1994761.0,2730976.0,110.14,113.51,111.07,113.55
2023-10-30 18:10,130,72,58,7572,3105,4467,8539406.0,3462604.0,5076802.0,105,52,53,6870,2788,4082,7735817.0,3090376.0,4645441.0,111.52,113.65,110.85,113.8
2023-10-30 18:15,181,57,124,9255,3181,6074,10491926.0,3578947.0,6912978.0,160,39,121,8306,2887,5419,9344247.0,3199973.0,6144273.0,112.51,113.81,110.84,113.38
2023-10-30 18:20,1055,239,816,40987,8130,32857,45441020.0,9046849.0,36394170.0,929,172,757,27662,3443,24219,31027345.0,3837592.0,27189752.0,111.28,110.77,111.46,112.27
2023-10-30 18:25,2517,1097,1420,99159,49519,49640,108024645.0,54212239.0,53812405.0,1670,480,1190,71296,33903,37393,78905706.0,37079795.0,41825911.0,109.48,108.41,109.37,111.85
2023-10-30 18:30,1219,496,723,42545,23027,19518,46950424.0,25254840.0,21695584.0,1115,456,659,49249,25533,23716,54401605.0,27919726.0,26481878.0,109.67,111.16,109.35,111.66
2023-10-30 18:35,1662,334,1328,54867,15313,39554,60633844.0,16906566.0,43727277.0,1565,260,1305,53453,15483,37970,59324915.0,17040908.0,42284007.0,110.41,110.55,110.06,111.36
2023-10-31 10:00,2284,886,1398,45634,17218,28416,54114998.0,18968072.0,35146925.0,1283,644,639,21431,14339,7092,23816666.0,15862217.0,7954448.0,110.16,123.69,110.62,112.16
2023-10-31 10:05,1109,766,343,19756,10332,9424,22457269.0,11590337.0,10866931.0,975,706,269,14424,9530,4894,16129408.0,10594725.0,5534683.0,112.18,115.31,111.17,113.09
2023-10-31 10:10,646,456,190,10078,5778,4300,11321273.0,6420107.0,4901165.0,562,419,143,8508,5481,3027,9492946.0,6087250.0,3405696.0,111.11,113.98,111.06,112.51
2023-10-31 10:15,208,114,94,11448,6079,5369,12899798.0,6754063.0,6145734.0,147,83,64,9409,5438,3971,10531722.0,6023754.0,4507968.0,111.1,114.47,110.77,113.52
2023-10-31 10:20,695,475,220,28536,15977,12559,31893482.0,17688493.0,14204989.0,630,431,199,26571,15735,10836,29672118.0,17425237.0,12246881.0,110.71,113.11,110.74,113.02
2023-10-31 10:25,1831,910,921,69303,39279,30024,77380089.0,43496783.0,33883305.0,1570,794,776,68335,38788,29547,76273560.0,42973862.0,33299698.0,110.74,112.85,110.79,112.7
2023-10-31 10:30,1226,815,411,67353,37606,29747,75259952.0,41641248.0,33618704.0,1184,801,383,66065,37545,28520,73778169.0,41513572.0,32264597.0,110.73,113.02,110.57,113.13
2023-10-31 10:35,672,419,253,26455,11564,14891,29544608.0,12761604.0,16783004.0,640,402,238,26264,11540,14724,29335443.0,12733706.0,16601737.0,110.36,112.71,110.34,112.75
2023-10-31 10:40,388,251,137,20249,13690,6559,22540359.0,15168298.0,7372061.0,350,229,121,18843,12374,6469,21004355.0,13689108.0,7315247.0,110.8,112.4,110.63,113.08
2023-10-31 10:45,1250,881,369,50364,20883,29481,55779035.0,22920491.0,32858544.0,1096,795,301,50158,20305,29853,55693062.0,22268946.0,33424115.0,109.76,111.46,109.67,111.96
2023-10-31 10:50,1348,746,602,75502,29305,46197,83122707.0,31819691.0,51303015.0,1074,567,507,71965,26824,45141,79302727.0,29132892.0,50169834.0,108.58,111.05,108.61,111.14
2023-10-31 10:55,2090,904,1186,111212,47489,63723,121604900.0,51353407.0,70251492.0,1687,603,1084,101662,39761,61901,111288957.0,42959132.0,68329825.0,108.14,110.25,108.04,110.39
2023-10-31 11:00,2211,897,1314,125294,54054,71240,136887314.0,58283483.0,78603831.0,1980,746,1234,117841,47784,70057,129166904.0,51730257.0,77436647.0,107.82,110.34,108.26,110.53
2023-10-31 11:05,1012,573,439,55105,24399,30706,60539711.0,26493115.0,34046595.0,902,507,395,50953,21543,29410,55942448.0,23378638.0,32563809.0,108.58,110.88,108.52,110.72
2023-10-31 11:10,726,487,239,33422,15084,18338,36735565.0,16409807.0,20325757.0,654,447,207,34486,16620,17866,37823063.0,18030187.0,19792875.0,108.79,110.84,108.48,110.79
2023-10-31 11:15,1565,1174,391,64870,34306,30564,71314595.0,37365480.0,33949114.0,1488,1119,369,64936,34634,30302,71315663.0,37653642.0,33662020.0,108.92,111.08,108.72,111.09
2023-10-31 11:20,1348,582,766,53799,14853,38946,59323486.0,16226741.0,43096744.0,1284,545,739,53140,14424,38716,58635077.0,15731981.0,42903096.0,109.25,110.66,109.07,110.81
2023-10-31 11:25,2159,842,1317,111803,32214,79589,124083205.0,35106792.0,88976413.0,2111,818,1293,108053,32028,76025,119213806.0,34902320.0,84311486.0,108.98,111.79,108.97,110.9
2023-10-31 11:30,1333,646,687,44862,12507,32355,49523378.0,13576380.0,35946997.0,1319,643,676,42082,10530,31552,46396805.0,11495137.0,34901668.0,108.55,111.1,109.17,110.62
2023-10-31 11:35,1212,323,889,55394,18698,36696,61023971.0,20366859.0,40657112.0,1167,301,866,54298,17858,36440,59879608.0,19435109.0,40444499.0,108.93,110.79,108.83,110.99
2023-10-31 11:40,976,327,649,40932,12430,28502,45019260.0,13531904.0,31487355.0,939,305,634,40184,12057,28127,44258739.0,13125549.0,31133189.0,108.86,110.47,108.86,110.69
2023-10-31 11:45,2290,286,2004,109561,16859,92702,120810121.0,18368539.0,102441581.0,2258,266,1992,110236,17748,92488,121553682.0,19340331.0,102213350.0,108.95,110.51,108.97,110.52
2023-10-31 11:50,1832,350,1482,88550,13784,74766,97716645.0,15053092.0,82663552.0,1816,342,1474,88438,13819,74619,97600133.0,15088106.0,82512027.0,109.21,110.56,109.18,110.58
2023-10-31 11:55,1704,348,1356,89293,16930,72363,98341946.0,18441662.0,79900283.0,1689,351,1338,86912,17147,69765,95748140.0,18671227.0,77076913.0,108.93,110.42,108.89,110.48
2023-10-31 12:00,3431,367,3064,175716,27543,148173,193255707.0,29834454.0,163421253.0,3392,343,3049,175002,27102,147900,192517792.0,29357418.0,163160374.0,108.32,110.29,108.32,110.32
2023-10-31 12:05,2506,701,1805,131254,45757,85497,142927376.0,48488348.0,94439027.0,2450,668,1782,132946,45385,87561,145463298.0,48002722.0,97460576.0,105.97,110.46,105.77,111.31
2023-10-31 12:10,2052,337,1715,108399,28281,80118,118810918.0,30573925.0,88236992.0,1983,293,1690,97508,27657,69851,106913396.0,29901492.0,77011904.0,108.11,110.13,108.12,110.25
2023-10-31 12:15,1587,391,1196,83935,35326,48609,91991710.0,38320078.0,53671631.0,1485,344,1141,82891,34443,48448,90864290.0,37298762.0,53565528.0,108.48,110.42,108.29,110.56
2023-10-31 12:20,2042,300,1742,66108,18323,47785,72550764.0,19892672.0,52658092.0,2000,280,1720,65152,17792,47360,71519926.0,19280844.0,52239082.0,108.57,110.2,108.37,110.3
2023-10-31 12:25,541,181,360,21372,8708,12664,23454550.0,9446048.0,14008502.0,522,169,353,21056,8647,12409,23084915.0,9375545.0,13709370.0,108.48,110.62,108.43,110.48
2023-10-31 12:30,262,98,164,15649,5806,9843,17138779.0,6280135.0,10858643.0,241,85,156,15162,5644,9518,16632597.0,6100270.0,10532327.0,108.17,110.32,108.08,110.66
2023-10-31 12:35,1124,503,621,76104,28960,47144,83174261.0,31268117.0,51906143.0,1036,430,606,71912,25209,46703,78755302.0,27232450.0,51522852.0,107.97,110.1,108.03,110.32
2023-10-31 12:40,1686,666,1020,102431,39638,62793,111991766.0,42952803.0,69038963.0,1610,607,1003,108020,36779,71241,118120854.0,39829672.0,78291181.0,108.36,109.95,108.29,109.9
2023-10-31 12:45,1630,1063,567,121902,59744,62158,133571412.0,65181789.0,68389623.0,1561,1028,533,114676,61030,53646,125606946.0,66530631.0,59076315.0,109.1,110.03,109.01,110.12
2023-10-31 12:50,1371,343,1028,93302,25917,67385,102072901.0,28090583.0,73982318.0,1342,323,1019,93579,25729,67850,102350642.0,27883095.0,74467546.0,108.39,109.79,108.37,109.75
2023-10-31 12:55,1264,635,629,68558,34873,33685,74883112.0,37964505.0,36918607.0,1235,621,614,68190,34671,33519,74469198.0,37735913.0,36733284.0,108.87,109.6,108.84,109.59
2023-10-31 13:00,2315,761,1554,145570,48769,96801,159280682.0,52605019.0,106675662.0,2055,613,1442,142917,42620,100297,156713145.0,45996236.0,110716908.0,107.87,110.2,107.92,110.39
2023-10-31 13:05,1983,771,1212,111333,41221,70112,121245610.0,44511490.0,76734120.0,1906,731,1175,111414,41693,69721,121317092.0,45013326.0,76303766.0,107.98,109.45,107.96,109.44
2023-10-31 13:10,1925,1361,564,108856,63278,45578,124883042.0,68512338.0,56370704.0,1886,1338,548,108278,62936,45342,117956493.0,68126037.0,49830456.0,108.27,123.68,108.25,109.9
2023-10-31 13:15,474,169,305,23754,7426,16328,25925989.0,8029027.0,17896962.0,423,155,268,24191,7929,16262,26373768.0,8548271.0,17825497.0,108.12,109.61,107.81,109.61
2023-10-31 13:20,227,99,128,8790,3713,5077,9592924.0,4015563.0,5577360.0,209,98,111,10769,5756,5013,11617041.0,6105851.0,5511189.0,108.15,109.86,106.08,109.94
2023-10-31 13:25,1694,757,937,90480,34873,55607,98599779.0,37686184.0,60913594.0,1672,750,922,90447,34963,55484,98638136.0,37779519.0,60858616.0,108.07,109.54,108.06,109.69
2023-10-31 13:30,1102,597,505,40905,16294,24611,44573010.0,17604588.0,26968421.0,1094,581,513,40553,16087,24466,44168504.0,17372349.0,26796155.0,108.04,109.58,107.99,109.52
2023-10-31 13:35,2030,559,1471,82243,19893,62350,89409571.0,21422768.0,67986803.0,1989,529,1460,81604,20123,61481,88729383.0,21666501.0,67062881.0,107.69,109.04,107.67,109.08
2023-10-31 13:40,1147,268,879,66231,19231,47000,71782814.0,20570831.0,51211982.0,1051,227,824,63826,18119,45707,69196543.0,19370753.0,49825790.0,106.97,108.96,106.91,109.01
2023-10-31 13:45,2061,942,1119,114096,38838,75258,123832518.0,41707951.0,82124567.0,1964,883,1081,105694,37969,67725,114674061.0,40705819.0,73968241.0,107.39,109.12,107.21,109.22
2023-10-31 13:50,2404,1243,1161,139880,62341,77539,151011897.0,66950360.0,84061536.0,2103,1056,1047,130962,55107,75855,141368120.0,58929508.0,82438611.0,107.39,108.41,106.94,108.68
2023-10-31 13:55,2124,1079,1045,113100,50263,62837,121768550.0,53610835.0,68157714.0,1963,963,1000,109197,46019,63178,117579337.0,49051249.0,68528088.0,106.66,108.47,106.59,108.47
2023-10-31 14:00,2022,560,1462,91787,26773,65014,98650239.0,28405915.0,70244324.0,1924,495,1429,92682,27120,65562,99584505.0,28753095.0,70831409.0,106.1,108.04,106.02,108.04
2023-10-31 14:05,858,397,461,49399,19062,30337,52825235.0,20255485.0,32569750.0,775,349,426,47069,19289,27780,50501065.0,20436827.0,30064237.0,106.26,107.36,105.95,108.22
2023-10-31 14:10,1904,626,1278,113719,44104,69615,120770172.0,46334925.0,74435247.0,1663,469,1194,109358,42647,66711,116450465.0,44835324.0,71615141.0,105.06,106.92,105.13,107.35
2023-10-31 14:15,1396,463,933,62655,18519,44136,66492176.0,19332500.0,47159676.0,1293,390,903,60523,17409,43114,64352806.0,18207458.0,46145348.0,104.39,106.85,104.59,107.03
2023-10-31 14:20,988,599,389,37401,16287,21114,39623430.0,17112860.0,22510570.0,763,444,319,31581,13387,18194,33502953.0,14040947.0,19462006.0,105.07,106.61,104.88,106.97
2023-10-31 14:25,1555,746,809,73944,38831,35113,78152241.0,40615122.0,37537119.0,1363,620,743,66915,33355,33560,70960895.0,35066678.0,35894217.0,104.59,106.9,105.13,106.96
2023-10-31 14:30,1398,355,1043,65928,23697,42231,70285716.0,25020296.0,45265420.0,1297,301,996,64985,24247,40738,68967233.0,25308268.0,43658965.0,105.58,107.19,104.38,107.17
2023-10-31 14:35,1951,702,1249,82316,32529,49787,87701197.0,34334898.0,53366298.0,1871,650,1221,79761,31175,48586,84948673.0,32848459.0,52100213.0,105.55,107.19,105.37,107.23
2023-10-31 14:40,1576,685,891,77324,37370,39954,82351284.0,39435175.0,42916109.0,1621,625,996,75660,35951,39709,80664923.0,37947597.0,42717326.0,105.53,107.41,105.55,107.58
2023-10-31 14:45,1304,326,978,69701,25206,44495,74152529.0,26503397.0,47649131.0,1226,269,957,63270,19581,43689,67384997.0,20585583.0,46799414.0,105.15,107.09,105.13,107.12
2023-10-31 14:50,662,226,436,25129,9793,15336,26798649.0,10335847.0,16462802.0,588,183,405,23768,9112,14656,25322960.0,9586159.0,15736801.0,105.54,107.35,105.2,107.37
2023-10-31 14:55,565,264,301,29829,15674,14155,31901585.0,16637298.0,15264286.0,464,202,262,27452,13650,13802,29286665.0,14403289.0,14883375.0,106.15,107.84,105.52,107.83
2023-10-31 15:00,539,289,250,25220,15207,10013,27019477.0,16174959.0,10844518.0,471,251,220,22850,13503,9347,24434706.0,14312099.0,10122606.0,106.37,108.3,105.99,108.3
2023-10-31 15:05,620,427,193,27264,15218,12046,29143348.0,16154094.0,12989253.0,571,398,173,27110,15475,11635,28980127.0,16403357.0,12576770.0,106.15,107.83,106.0,108.09
2023-10-31 15:10,273,181,92,14397,7722,6675,15408703.0,8180577.0,7228125.0,233,159,74,13745,7196,6549,14701018.0,7608891.0,7092127.0,105.94,108.29,105.74,108.29
2023-10-31 15:15,276,132,144,11162,5129,6033,11963152.0,5460144.0,6503008.0,235,97,138,10600,4794,5806,11343110.0,5081691.0,6261419.0,106.46,107.79,106.0,107.84
2023-10-31 15:20,522,318,204,17307,9473,7834,18518972.0,10073917.0,8445054.0,482,301,181,17205,9546,7659,18403492.0,10124708.0,8278784.0,106.34,107.8,106.06,108.09
2023-10-31 15:25,290,159,131,15525,8280,7245,16648520.0,8806885.0,7841634.0,241,131,110,14986,8030,6956,16048941.0,8525817.0,7523124.0,106.36,108.24,106.17,108.15
2023-10-31 15:30,530,348,182,21461,15078,6383,22952185.0,16055662.0,6896523.0,507,337,170,21423,15232,6191,22850259.0,16145417.0,6704842.0,106.48,108.05,106.0,108.3
2023-10-31 15:35,432,290,142,26726,16293,10433,28617736.0,17296272.0,11321464.0,415,279,136,26678,16322,10356,28552922.0,17312567.0,11240355.0,106.16,108.52,106.07,108.54
2023-10-31 15:40,549,397,152,27974,16622,11352,29938804.0,17622863.0,12315941.0,532,386,146,28658,17421,11237,30665353.0,18472772.0,12192581.0,106.02,108.49,106.04,108.5
2023-10-31 15:45,1193,626,567,65300,41747,23553,70155742.0,44546466.0,25609275.0,1098,573,525,61394,38422,22972,65913355.0,40932505.0,24980849.0,106.71,108.73,106.53,108.74
2023-10-31 15:50,2338,709,1629,130146,49042,81104,140174553.0,52236780.0,87937773.0,2196,631,1565,128813,49292,79521,138728537.0,52511714.0,86216823.0,106.51,108.43,106.53,108.42
2023-10-31 15:55,1530,249,1281,63389,15474,47915,68191274.0,16397641.0,51793633.0,1509,237,1272,63078,15304,47774,67853411.0,16212015.0,51641396.0,105.97,108.09,105.93,108.1
2023-10-31 16:00,802,504,298,37502,11468,26034,40356636.0,12155104.0,28201532.0,784,497,287,38311,12358,25953,41198564.0,13084018.0,28114546.0,105.99,108.33,105.87,108.33
2023-10-31 16:05,541,301,240,25981,7276,18705,27946121.0,7708614.0,20237506.0,516,287,229,25471,6858,18613,27400340.0,7262106.0,20138233.0,105.95,108.19,105.89,108.19
2023-10-31 16:10,841,405,436,52835,26281,26554,56944441.0,28059013.0,28885427.0,752,354,398,51738,25641,26097,55705153.0,27310660.0,28394492.0,106.77,108.78,106.51,108.8
2023-10-31 16:15,1716,987,729,84852,43522,41330,91841362.0,46734438.0,45106923.0,1599,942,657,82918,42239,40679,89632288.0,45225925.0,44406362.0,107.38,109.14,107.07,109.16
2023-10-31 16:20,1054,662,392,52557,25209,27348,56818242.0,27064349.0,29753893.0,995,647,348,51238,24914,26324,55379945.0,26686398.0,28693547.0,107.36,108.8,107.11,109.0
2023-10-31 16:25,402,213,189,22630,8039,14591,24451598.0,8561841.0,15889757.0,368,193,175,22531,7940,14591,24342244.0,8449631.0,15892613.0,106.5,108.9,106.42,108.92
2023-10-31 16:30,470,229,241,26436,9237,17199,28642306.0,9862116.0,18780190.0,437,210,227,25798,9075,16723,27886085.0,9668865.0,18217220.0,106.77,109.19,106.54,108.94
2023-10-31 16:35,675,285,390,16347,4787,11560,17674097.0,5124532.0,12549564.0,656,277,379,16235,4848,11387,17551133.0,5179765.0,12371367.0,107.05,108.56,106.84,108.64
2023-10-31 16:40,498,271,227,30616,14391,16225,32999724.0,15387037.0,17612687.0,473,260,213,29915,13994,15921,32229897.0,14900401.0,17329496.0,106.92,108.55,106.48,108.85
2023-10-31 16:45,379,327,52,11967,8264,3703,12906356.0,8865725.0,4040630.0,385,331,54,12630,8903,3727,13615357.0,9549425.0,4065931.0,107.28,109.12,107.26,109.09
2023-10-31 16:50,810,580,230,35426,21765,13661,38181614.0,23275557.0,14906057.0,806,588,218,35455,21555,13900,38208265.0,23036563.0,15171701.0,106.94,109.11,106.87,109.15
2023-10-31 16:55,1051,669,382,36769,20775,15994,39641718.0,22209137.0,17432580.0,1033,663,370,36469,20559,15910,39301728.0,21959524.0,17342204.0,106.9,108.99,106.81,109.0
2023-10-31 17:00,929,634,295,48457,26543,21914,52150324.0,28260424.0,23889899.0,910,623,287,47284,25560,21724,51020378.0,27255792.0,23764585.0,106.47,109.02,106.63,109.39
2023-10-31 17:05,529,296,233,35070,18421,16649,37777087.0,19627186.0,18149900.0,510,282,228,36123,18633,17490,38892685.0,19833470.0,19059215.0,106.55,109.01,106.44,108.97
2023-10-31 17:10,517,361,156,31803,17641,14162,34242650.0,18802119.0,15440531.0,509,356,153,31247,17089,14158,33651546.0,18214476.0,15437070.0,106.58,109.03,106.59,109.03
2023-10-31 17:15,552,428,124,20358,12252,8106,21917787.0,13076981.0,8840806.0,540,421,119,20142,12055,8087,21689628.0,12869391.0,8820237.0,106.73,109.06,106.76,109.07
2023-10-31 17:20,755,349,406,29712,15282,14430,32003966.0,16283766.0,15720200.0,742,339,403,29629,15267,14362,31923974.0,16266554.0,15657419.0,106.56,108.94,106.55,109.02
2023-10-31 17:25,914,709,205,37895,22048,15847,40813615.0,23541444.0,17272171.0,894,701,193,37809,21968,15841,40709963.0,23443991.0,17265971.0,106.77,108.99,106.72,109.0
2023-10-31 17:30,952,742,210,32635,18847,13788,35136397.0,20120963.0,15015433.0,949,742,207,32438,18853,13585,34923795.0,20127504.0,14796291.0,106.76,108.9,106.76,108.92
2023-10-31 17:35,267,226,41,19637,12610,7027,21060287.0,13382786.0,7677500.0,263,222,41,18436,11410,7026,19840498.0,12164089.0,7676408.0,106.13,109.26,106.61,109.26
2023-10-31 17:40,226,143,83,15887,9505,6382,17033006.0,10074110.0,6958896.0,217,139,78,17116,10760,6356,18344981.0,11412500.0,6932481.0,105.99,109.04,106.06,109.07
2023-10-31 17:45,50,32,18,5087,2571,2516,5480999.0,2731505.0,2749494.0,58,34,24,5306,2674,2632,5717267.0,2840187.0,2877080.0,106.24,109.28,106.21,109.31
2023-10-31 17:50,165,61,104,8803,4292,4511,9489365.0,4571999.0,4917366.0,151,55,96,8361,3996,4365,9012687.0,4254366.0,4758321.0,106.52,109.01,106.47,109.01
2023-10-31 17:55,217,166,51,11459,6881,4578,12379982.0,7385635.0,4994346.0,223,173,50,11327,6763,4564,12207149.0,7227439.0,4979710.0,107.33,109.09,106.87,109.11
2023-10-31 18:00,1449,855,594,73598,40129,33469,79660774.0,43035199.0,36625575.0,1356,792,564,71255,39268,31987,77036771.0,42072609.0,34964162.0,107.24,109.43,107.14,109.31
2023-10-31 18:05,787,392,395,50375,24851,25524,54496140.0,26595867.0,27900272.0,757,370,387,49689,24225,25464,53749854.0,25918034.0,27831819.0,107.02,109.31,106.99,109.3
2023-10-31 18:10,295,188,107,17741,12584,5157,19211788.0,13555810.0,5655977.0,273,173,100,18393,13150,5243,19798059.0,14041415.0,5756643.0,107.72,109.68,106.78,109.8
2023-10-31 18:15,472,325,147,25862,16330,9532,27960029.0,17501591.0,10458438.0,464,320,144,25588,16327,9261,27663991.0,17497413.0,10166577.0,107.17,109.72,107.17,109.78
2023-10-31 18:20,690,521,169,20715,15236,5479,22399894.0,16401769.0,5998124.0,672,516,156,22377,17060,5317,24050510.0,18226398.0,5824111.0,107.65,109.47,106.84,109.54
2023-10-31 18:25,347,204,143,26604,15598,11006,28767479.0,16723525.0,12043954.0,324,189,135,24504,13901,10603,26483415.0,14874794.0,11608620.0,107.22,109.43,107.01,109.48
2023-10-31 18:30,265,160,105,18367,10466,7901,19807908.0,11204585.0,8603322.0,262,146,116,21492,13781,7711,23038641.0,14603185.0,8435455.0,107.06,108.89,105.97,109.4
2023-10-31 18:35,553,392,161,11184,6193,4991,11987482.0,6620192.0,5367290.0,508,365,143,7450,2928,4522,8050630.0,3132242.0,4918388.0,106.9,107.54,106.98,108.77
2023-11-01 10:00,1881,1003,878,52583,32553,20030,59344952.0,34744652.0,24600300.0,1147,823,324,33242,30687,2555,35596983.0,32843296.0,2753687.0,106.73,122.82,107.03,107.78
2023-11-01 10:05,1362,589,773,27950,9644,18306,29587106.0,10046975.0,19540130.0,1064,387,677,20417,4667,15750,21824292.0,4923118.0,16901174.0,104.18,106.74,105.49,107.31
2023-11-01 10:10,1124,613,511,16404,6845,9559,17727430.0,7344430.0,10383000.0,967,541,426,13433,5932,7501,14372443.0,6296780.0,8075663.0,107.3,108.62,106.15,107.66
2023-11-01 10:15,1363,952,411,36827,22811,14016,39575364.0,24421885.0,15153479.0,1295,929,366,35511,22821,12690,38058966.0,24359164.0,13699801.0,107.06,108.12,106.74,107.96
2023-11-01 10:20,783,496,287,35627,17795,17832,38373542.0,18887559.0,19485982.0,647,382,265,34289,16812,17477,36894323.0,17848330.0,19045992.0,106.14,109.28,106.16,108.98
2023-11-01 10:25,1865,1123,742,89104,46349,42755,96158890.0,49334159.0,46824730.0,1603,1050,553,83849,43112,40737,90542334.0,45974608.0,44567726.0,106.44,109.52,106.64,109.4
2023-11-01 10:30,1287,823,464,52488,26878,25610,56631295.0,28656619.0,27974676.0,1210,776,434,51885,26273,25612,55939145.0,27970270.0,27968875.0,106.62,109.23,106.46,109.2
2023-11-01 10:35,856,616,240,38276,21737,16539,41434481.0,23244399.0,18190081.0,801,588,213,36554,21517,15037,39479950.0,23014193.0,16465757.0,106.93,109.98,106.96,109.5
2023-11-01 10:40,889,510,379,47337,23680,23657,51260152.0,25234276.0,26025876.0,832,476,356,45007,23709,21298,48523466.0,25255733.0,23267733.0,106.56,110.01,106.52,109.25
2023-11-01 10:45,720,421,299,28831,13450,15381,31073672.0,14309629.0,16764043.0,673,387,286,28338,13441,14897,30539039.0,14295950.0,16243088.0,106.39,108.99,106.36,109.04
2023-11-01 10:50,885,409,476,29610,11001,18609,31867470.0,11665719.0,20201750.0,827,379,448,28838,10803,18035,31020114.0,11456526.0,19563587.0,106.04,108.56,106.05,108.48
2023-11-01 10:55,570,314,256,34287,17803,16484,36478099.0,18559743.0,17918355.0,522,277,245,29790,13325,16465,32052200.0,14136791.0,17915408.0,104.25,108.7,106.09,108.81
2023-11-01 11:00,1752,697,1055,80141,30250,49891,85643244.0,31758238.0,53885006.0,1552,572,980,74481,26235,48246,79717160.0,27620808.0,52096351.0,104.99,108.01,105.28,107.98
2023-11-01 11:05,1894,743,1151,107442,51756,55686,114978956.0,54723150.0,60255806.0,1683,619,1064,105773,50437,55336,113210611.0,53317505.0,59893106.0,105.73,108.21,105.71,108.24
2023-11-01 11:10,1025,276,749,41859,16045,25814,44808158.0,16943373.0,27864785.0,971,240,731,42565,16920,25645,45538530.0,17857860.0,27680670.0,105.6,107.94,105.54,107.94
2023-11-01 11:15,1262,409,853,61578,25365,36213,65684280.0,26752197.0,38932083.0,1115,322,793,58677,23426,35251,62710548.0,24700466.0,38010082.0,105.47,107.51,105.44,107.83
2023-11-01 11:20,1170,669,501,62343,32506,29837,66796271.0,34443820.0,32352451.0,1021,588,433,59243,30733,28510,63385375.0,32511070.0,30874304.0,105.96,108.43,105.79,108.29
2023-11-01 11:25,2745,1445,1300,157348,82725,74623,169029062.0,87977939.0,81051123.0,2516,1319,1197,155727,83240,72487,167094728.0,88342431.0,78752297.0,106.35,108.61,106.13,108.64
2023-11-01 11:30,1615,682,933,72336,25897,46439,77513098.0,27344096.0,50169001.0,1542,639,903,70661,24547,46114,75702242.0,25903258.0,49798983.0,105.59,108.03,105.53,107.99
2023-11-01 11:35,943,319,624,43569,14330,29239,48174510.0,15149708.0,33024801.0,924,306,618,37706,14275,23431,40368235.0,15084506.0,25283729.0,105.72,112.95,105.67,107.91
2023-11-01 11:40,620,197,423,25260,10188,15072,27054959.0,10765274.0,16289685.0,606,187,419,24865,9798,15067,26628715.0,10343868.0,16284847.0,105.67,108.08,105.57,108.08
2023-11-01 11:45,436,220,216,22432,9007,13425,23881266.0,9396648.0,14484617.0,409,204,205,20670,7301,13369,22149436.0,7725954.0,14423481.0,104.33,107.89,105.82,107.89
2023-11-01 11:50,832,266,566,31736,9842,21894,34043509.0,10405518.0,23637991.0,812,250,562,32413,10517,21896,34756487.0,11117650.0,23638837.0,105.73,107.97,105.71,107.96
2023-11-01 11:55,589,231,358,33894,13586,20308,36322564.0,14365286.0,21957278.0,578,220,358,33021,12650,20371,35394945.0,13368476.0,22026469.0,105.74,108.12,105.68,108.13
2023-11-01 12:00,692,319,373,30604,10801,19803,32770944.0,11393979.0,21376964.0,677,304,373,30302,10556,19746,32469325.0,11148065.0,21321260.0,105.49,107.95,105.61,107.98
2023-11-01 12:05,747,220,527,46451,16231,30220,49817656.0,17174410.0,32643245.0,726,205,521,46208,16094,30114,49539555.0,17017173.0,32522382.0,105.81,108.02,105.74,108.0
2023-11-01 12:10,1546,502,1044,69576,23098,46478,74742933.0,24471082.0,50271851.0,1521,490,1031,69515,23075,46440,74679599.0,24443665.0,50235934.0,105.94,108.16,105.93,108.17
2023-11-01 12:15,1129,628,501,40992,18927,22065,44010984.0,20110086.0,23900898.0,1107,613,494,40027,18506,21521,42962775.0,19665095.0,23297679.0,106.25,108.32,106.26,108.26
2023-11-01 12:20,1316,471,845,57504,22771,34733,61730484.0,24145024.0,37585460.0,1292,447,845,56525,21663,34862,60697943.0,22974316.0,37723626.0,106.03,108.21,106.05,108.21
2023-11-01 12:25,1777,604,1173,94750,30358,64392,101604141.0,32123749.0,69480392.0,1740,571,1169,93984,30049,63935,100796606.0,31791868.0,69004737.0,105.82,107.9,105.8,107.93
2023-11-01 12:30,1457,613,844,61829,17026,44803,66325305.0,18021896.0,48303408.0,1431,596,835,63015,18285,44730,67580564.0,19352743.0,48227820.0,105.85,107.81,105.84,107.82
2023-11-01 12:35,1893,718,1175,94907,32864,62043,103216489.0,36197494.0,67018995.0,1873,707,1166,94494,32616,61878,101326144.0,34488624.0,66837520.0,110.14,108.02,105.74,108.01
2023-11-01 12:40,1047,244,803,43535,15301,28234,48170874.0,17657401.0,30513473.0,1035,236,799,41949,13934,28015,46456237.0,16185861.0,30270376.0,115.4,108.07,116.16,108.05
2023-11-01 12:45,1245,396,849,49018,19970,29048,52752878.0,21239787.0,31513091.0,1181,352,829,51459,17157,34302,58315922.0,19648166.0,38667756.0,106.36,108.49,114.52,112.73
2023-11-01 12:50,908,472,436,36673,22199,14474,39603612.0,23780437.0,15823174.0,840,438,402,33395,19192,14203,36047725.0,20521413.0,15526311.0,107.12,109.32,106.93,109.32
2023-11-01 12:55,1248,531,717,54014,29209,24805,58453235.0,31288230.0,27165004.0,1197,511,686,53802,29318,24484,58208764.0,31392488.0,26816275.0,107.12,109.51,107.08,109.53
2023-11-01 13:00,679,284,395,36244,15744,20500,40809037.0,16852495.0,23956542.0,657,282,375,29334,15587,13747,31719679.0,16681323.0,15038355.0,107.04,116.86,107.02,109.39
2023-11-01 13:05,561,343,218,15458,8221,7237,16711778.0,8814076.0,7897702.0,560,339,221,17330,9645,7685,18566304.0,10179799.0,8386504.0,107.21,109.13,105.54,109.13
2023-11-01 13:10,463,192,271,22739,10625,12114,24578344.0,11348238.0,13230106.0,455,198,257,27249,15615,11634,29430712.0,16719624.0,12711087.0,106.81,109.21,107.07,109.26
2023-11-01 13:15,750,408,342,27382,12014,15368,30936518.0,14246384.0,16690134.0,735,399,336,26966,11778,15188,29095279.0,12551947.0,16543332.0,118.58,108.6,106.57,108.92
2023-11-01 13:20,440,123,317,24118,9204,14914,26034247.0,9796178.0,16238068.0,429,113,316,24059,9147,14912,25967774.0,9731982.0,16235792.0,106.43,108.88,106.4,108.88
2023-11-01 13:25,641,241,400,29932,12645,17287,32309150.0,13490947.0,18818203.0,606,217,389,28633,11506,17127,30923026.0,12259222.0,18663803.0,106.69,108.86,106.55,108.97
2023-11-01 13:30,389,90,299,9838,4235,5603,10653637.0,4525744.0,6127892.0,365,71,294,9349,3961,5388,10111087.0,4222699.0,5888388.0,106.87,109.37,106.61,109.29
2023-11-01 13:35,674,301,373,25657,11642,14015,27807129.0,12498385.0,15308744.0,651,286,365,29465,9933,19532,34814059.0,12063537.0,22750522.0,107.36,109.23,121.45,116.48
2023-11-01 13:40,380,188,192,17865,9624,8241,19366129.0,10327767.0,9038362.0,332,167,165,17111,9183,7928,18545389.0,9845259.0,8700129.0,107.31,109.68,107.21,109.74
2023-11-01 13:45,772,428,344,47596,27592,20004,51823374.0,29772957.0,22050417.0,711,402,309,46256,26199,20057,50272339.0,28159679.0,22112660.0,107.9,110.23,107.48,110.25
2023-11-01 13:50,552,328,224,31863,18761,13102,34679608.0,20226409.0,14453199.0,483,301,182,30772,18407,12365,33495466.0,19844611.0,13650854.0,107.81,110.31,107.81,110.4
2023-11-01 13:55,253,120,133,15574,8049,7525,16934025.0,8648709.0,8285315.0,244,116,128,15669,8160,7509,17047747.0,8767448.0,8280299.0,107.45,110.1,107.44,110.27
2023-11-01 14:00,489,202,287,22245,12079,10166,24208731.0,13011276.0,11197454.0,486,202,284,22105,12156,9949,24040116.0,13079466.0,10960650.0,107.72,110.15,107.6,110.17
2023-11-01 14:05,199,116,83,12199,6857,5342,13276286.0,7392994.0,5883292.0,183,108,75,11692,6782,4910,12727036.0,7310183.0,5416853.0,107.82,110.13,107.79,110.32
2023-11-01 14:10,363,201,162,11629,7256,4373,12655349.0,7849028.0,4806321.0,340,192,148,13035,8517,4518,14177691.0,9209610.0,4968081.0,108.17,109.91,108.13,109.96
2023-11-01 14:15,663,331,332,33345,17806,15539,36439153.0,19316056.0,17123097.0,554,290,264,31825,18399,13426,34483277.0,19683984.0,14799293.0,108.48,110.19,106.98,110.23
2023-11-01 14:20,276,198,78,14470,10610,3860,15752503.0,11488283.0,4264220.0,232,180,52,13773,10237,3536,14978036.0,11076826.0,3901209.0,108.28,110.47,108.2,110.33
2023-11-01 14:25,106,86,20,1767,1504,263,1951372.0,1662942.0,288430.0,91,79,12,1582,1348,234,1713328.0,1454802.0,258525.0,110.57,109.67,107.92,110.48
2023-11-01 14:30,540,317,223,27885,18840,9045,30426471.0,20433055.0,9993416.0,463,276,187,24891,16008,8883,27131909.0,17316292.0,9815617.0,108.46,110.49,108.17,110.5
2023-11-01 14:35,1236,692,544,68397,42706,25691,74994804.0,46473736.0,28521067.0,1143,653,490,67634,42355,25279,74055474.0,45982522.0,28072952.0,108.82,111.02,108.56,111.05
2023-11-01 14:40,971,614,357,29139,19797,9342,31868347.0,21559447.0,10308900.0,924,588,336,26793,17701,9092,29346694.0,19269269.0,10077425.0,108.9,110.35,108.86,110.84
2023-11-01 14:45,492,364,128,18738,11964,6774,20535976.0,13012137.0,7523838.0,462,346,116,17499,10799,6700,19186607.0,11733313.0,7453293.0,108.76,111.07,108.65,111.24
2023-11-01 14:50,1043,465,578,61429,36144,25285,66784270.0,38580270.0,28204000.0,951,414,537,56089,31506,24583,61736808.0,34312053.0,27424755.0,106.74,111.54,108.91,111.56
2023-11-01 14:55,975,672,303,45891,26396,19495,55777538.0,27679286.0,28098252.0,887,635,252,42081,23707,18374,46376417.0,25861272.0,20515145.0,104.86,144.13,109.09,111.65
2023-11-01 15:00,680,399,281,31028,15158,15870,34197840.0,16524723.0,17673117.0,638,377,261,31718,15936,15782,34970698.0,17369329.0,17601369.0,109.02,111.36,108.99,111.53
2023-11-01 15:05,475,166,309,20627,9903,10724,22280352.0,10364504.0,11915847.0,443,145,298,17945,7712,10233,19767257.0,8391790.0,11375467.0,104.66,111.11,108.81,111.16
2023-11-01 15:10,727,174,553,14204,4816,9388,15768349.0,5266056.0,10502293.0,696,159,537,13904,4757,9147,15361112.0,5187184.0,10173928.0,109.35,111.87,109.04,111.23
2023-11-01 15:15,692,46,646,10644,1870,8774,11672963.0,2035893.0,9637069.0,670,38,632,9931,1998,7933,10932831.0,2158035.0,8774796.0,108.87,109.84,108.01,110.61
2023-11-01 15:20,571,451,120,13129,8290,4839,14461555.0,9094059.0,5367496.0,546,436,110,12358,7705,4653,13606341.0,8426950.0,5179391.0,109.7,110.92,109.37,111.31
2023-11-01 15:25,491,101,390,15234,4248,10986,16746826.0,4621434.0,12125392.0,519,141,378,15025,4163,10862,16531293.0,4517435.0,12013858.0,108.79,110.37,108.51,110.6
2023-11-01 15:30,199,78,121,6701,3074,3627,7383182.0,3350921.0,4032261.0,183,65,118,6604,2905,3699,7270442.0,3160315.0,4110127.0,109.01,111.17,108.79,111.11
2023-11-01 15:35,481,44,437,9781,3091,6690,10781582.0,3393396.0,7388185.0,469,33,436,8388,1703,6685,9228150.0,1845959.0,7382191.0,109.78,110.44,108.39,110.43
2023-11-01 15:40,1607,1298,309,52935,38583,14352,58414530.0,42416665.0,15997865.0,1577,1283,294,52255,38037,14218,57611954.0,41763986.0,15847968.0,109.94,111.47,109.8,111.46
2023-11-01 15:45,350,245,105,13066,7805,5261,14443862.0,8555421.0,5888441.0,313,228,85,12628,7591,5037,13940508.0,8308355.0,5632152.0,109.61,111.93,109.45,111.82
2023-11-01 15:50,596,366,230,26554,15752,10802,29357941.0,17280392.0,12077549.0,572,351,221,24791,14217,10574,27386397.0,15561755.0,11824641.0,109.7,111.81,109.46,111.83
2023-11-01 15:55,386,171,215,23181,9421,13760,25428067.0,10274302.0,15153765.0,348,155,193,21204,9032,12172,23404200.0,9841591.0,13562609.0,109.06,110.13,108.96,111.42
2023-11-01 16:00,859,303,556,44635,17124,27511,49221815.0,18669065.0,30552749.0,828,285,543,48343,21085,27258,52802297.0,22494726.0,30307570.0,109.02,111.06,106.69,111.19
2023-11-01 16:05,910,481,429,41577,20425,21152,45869177.0,22270385.0,23598791.0,899,472,427,42380,20539,21841,46758089.0,22393285.0,24364803.0,109.03,111.57,109.03,111.56
2023-11-01 16:10,753,423,330,29897,14886,15011,32985209.0,16222800.0,16762409.0,737,419,318,31940,17295,14645,35019830.0,18670534.0,16349296.0,108.98,111.67,107.95,111.64
2023-11-01 16:15,1127,736,391,46612,25015,21597,51499396.0,27427910.0,24071485.0,1096,719,377,46236,24739,21497,51047094.0,27085968.0,23961126.0,109.65,111.46,109.49,111.46
2023-11-01 16:20,391,264,127,14124,7607,6517,15590199.0,8314521.0,7275678.0,378,260,118,14038,7614,6424,15495159.0,8321956.0,7173203.0,109.3,111.64,109.3,111.66
2023-11-01 16:25,198,104,94,12883,6104,6779,14270890.0,6655674.0,7615216.0,188,98,90,12174,6031,6143,13432906.0,6567601.0,6865304.0,109.04,112.34,108.9,111.76
2023-11-01 16:30,133,72,61,7818,3665,4153,8637757.0,3993391.0,4644365.0,125,69,56,7681,3654,4027,8477767.0,3980822.0,4496945.0,108.96,111.83,108.94,111.67
2023-11-01 16:35,351,181,170,18113,8145,9968,19985007.0,8874339.0,11110668.0,336,170,166,17670,8092,9578,19497506.0,8816432.0,10681074.0,108.95,111.46,108.95,111.52
2023-11-01 16:40,96,48,48,5231,2300,2931,5768998.0,2503674.0,3265323.0,86,44,42,5208,2262,2946,5742357.0,2459822.0,3282535.0,108.86,111.41,108.75,111.42
2023-11-01 16:45,112,55,57,4987,2132,2855,5483657.0,2322027.0,3161629.0,92,47,45,5320,2685,2635,5860942.0,2929949.0,2930993.0,108.91,110.74,109.12,111.23
2023-11-01 16:50,113,55,58,4563,1571,2992,5025892.0,1710333.0,3315559.0,89,49,40,3698,1660,2038,4072841.0,1805846.0,2266995.0,108.87,110.81,108.79,111.24
2023-11-01 16:55,70,34,36,5020,2971,2049,5530235.0,3248009.0,2282226.0,59,30,29,3800,1817,1983,4185744.0,1974513.0,2211230.0,109.32,111.38,108.67,111.51
2023-11-01 17:00,164,67,97,9756,4104,5652,10756894.0,4470007.0,6286886.0,167,70,97,21032,15801,5231,20638488.0,14816390.0,5822097.0,108.92,111.23,93.77,111.3
2023-11-01 17:05,683,627,56,10166,7199,2967,11189057.0,7890872.0,3298185.0,673,622,51,9853,7108,2745,10847749.0,7790032.0,3057717.0,109.61,111.16,109.6,111.39
2023-11-01 17:10,269,136,133,5852,2820,3032,6443090.0,3076525.0,3366564.0,254,125,129,5854,2815,3039,6445954.0,3071639.0,3374315.0,109.1,111.03,109.12,111.03
2023-11-01 17:15,327,249,78,8821,4869,3952,9678195.0,5309306.0,4368888.0,305,241,64,8953,4974,3979,9857697.0,5419815.0,4437882.0,109.04,110.55,108.96,111.53
2023-11-01 17:20,1114,678,436,46878,22240,24638,51566983.0,24219479.0,27347504.0,1072,653,419,44640,22244,22396,49116096.0,24224460.0,24891635.0,108.9,111.0,108.9,111.14
2023-11-01 17:25,1018,542,476,37714,14677,23037,41433885.0,15963410.0,25470475.0,986,528,458,38365,15296,23069,42161031.0,16614691.0,25546339.0,108.76,110.56,108.62,110.74
2023-11-01 17:30,582,222,360,33623,13371,20252,36977819.0,14516760.0,22461058.0,566,210,356,32915,12898,20017,36218916.0,14001573.0,22217342.0,108.57,110.91,108.56,110.99
2023-11-01 17:35,506,145,361,21218,8594,12624,23342315.0,9323123.0,14019192.0,487,137,350,17983,6434,11549,19777478.0,6982742.0,12794736.0,108.48,111.05,108.53,110.79
2023-11-01 17:40,470,202,268,17782,8530,9252,19556490.0,9316065.0,10240425.0,456,195,261,17539,8255,9284,19266530.0,8985647.0,10280883.0,109.22,110.68,108.85,110.74
2023-11-01 17:45,446,236,210,26855,13805,13050,29545657.0,15018526.0,14527131.0,440,230,210,26681,13639,13042,29354227.0,14835767.0,14518460.0,108.79,111.32,108.77,111.32
2023-11-01 17:50,494,302,192,17448,11255,6193,19169951.0,12299890.0,6870060.0,488,299,189,19413,13224,6189,21295557.0,14430117.0,6865440.0,109.28,110.93,109.12,110.93
2023-11-01 17:55,218,103,115,7152,3303,3849,7868286.0,3602199.0,4266086.0,208,100,108,6999,3291,3708,7702244.0,3589575.0,4112669.0,109.06,110.84,109.07,110.91
2023-11-01 18:00,64,35,29,3372,1743,1629,3701351.0,1895799.0,1805552.0,55,33,22,3252,1680,1572,3577263.0,1823529.0,1753734.0,108.77,110.84,108.54,111.56
2023-11-01 18:05,41,15,26,1855,839,1016,2036482.0,909305.0,1127176.0,33,14,19,1893,926,967,2080192.0,1003213.0,1076979.0,108.38,110.94,108.34,111.37
2023-11-01 18:10,150,98,52,6104,3652,2452,6733954.0,3991550.0,2742403.0,142,95,47,4747,2531,2216,5222249.0,2757162.0,2465086.0,109.3,111.84,108.94,111.24
2023-11-01 18:15,1168,656,512,44364,23939,20425,48884725.0,26130943.0,22753781.0,1159,646,513,44181,23705,20476,48684817.0,25875089.0,22809727.0,109.16,111.4,109.15,111.4
2023-11-01 18:20,1189,507,682,78020,37916,40104,85808685.0,41246505.0,44562180.0,1181,503,678,77244,37790,39454,85060486.0,41107504.0,43952981.0,108.78,111.12,108.78,111.4
2023-11-01 18:25,1152,709,443,33218,19360,13858,36556680.0,21361016.0,15195664.0,1117,689,428,29483,15983,13500,32527916.0,17572151.0,14955764.0,110.34,109.65,109.94,110.78
2023-11-01 18:30,950,293,657,22178,5380,16798,24490581.0,5929067.0,18561514.0,943,290,653,22195,5435,16760,24510065.0,5983698.0,18526367.0,110.21,110.5,110.1,110.54
2023-11-01 18:35,592,254,338,13204,5444,7760,14435682.0,5986517.0,8449165.0,570,248,322,12673,5352,7321,13979849.0,5880253.0,8099595.0,109.97,108.88,109.87,110.64
2023-11-02 10:00,2261,1240,1021,68764,40205,28559,86003128.0,44092012.0,41911115.0,1440,1085,355,43080,37104,5976,47528076.0,40880821.0,6647255.0,109.67,146.75,110.18,111.23
2023-11-02 10:05,437,312,125,5201,2408,2793,5807967.0,2653188.0,3154779.0,383,287,96,4272,2127,2145,4765676.0,2347235.0,2418440.0,110.18,112.95,110.35,112.75
2023-11-02 10:10,483,146,337,7213,1733,5480,8239206.0,1920402.0,6318804.0,439,128,311,4234,1315,2919,4690400.0,1443473.0,3246927.0,110.81,115.31,109.77,111.23
2023-11-02 10:15,525,263,262,17941,8004,9937,19995303.0,8739757.0,11255545.0,295,152,143,15981,7677,8304,17726184.0,8391855.0,9334328.0,109.19,113.27,109.31,112.41
2023-11-02 10:20,431,331,100,15043,8066,6977,16712608.0,8846164.0,7866444.0,399,320,79,14403,8161,6242,15963872.0,8953806.0,7010066.0,109.67,112.75,109.71,112.3
2023-11-02 10:25,1965,1470,495,80557,53804,26753,88938239.0,59031968.0,29906271.0,1934,1452,482,79850,53535,26315,88161533.0,58738638.0,29422895.0,109.72,111.79,109.72,111.81
2023-11-02 10:30,2190,1361,829,105803,59050,46753,117029855.0,64762723.0,52267131.0,2144,1337,807,104326,58656,45670,115265606.0,64321384.0,50944222.0,109.67,111.79,109.66,111.55
2023-11-02 10:35,2359,656,1703,125466,47899,77567,138865517.0,52315833.0,86549683.0,2341,646,1695,125128,47663,77465,138455645.0,52028416.0,86427229.0,109.22,111.58,109.16,111.57
2023-11-02 10:40,1643,531,1112,84709,34038,50671,93661517.0,37163072.0,56498444.0,1617,527,1090,84010,34081,49929,92914546.0,37209447.0,55705098.0,109.18,111.5,109.18,111.57
2023-11-02 10:45,1689,656,1033,75768,23717,52051,83809678.0,25896745.0,57912933.0,1659,642,1017,75326,23408,51918,83325675.0,25550318.0,57775357.0,109.19,111.26,109.15,111.28
2023-11-02 10:50,1092,684,408,40006,17556,22450,44198690.0,19174525.0,25024165.0,1076,676,400,39895,17422,22473,44100232.0,19029351.0,25070880.0,109.22,111.47,109.23,111.56
2023-11-02 10:55,875,524,351,32931,13542,19389,36397740.0,14791660.0,21606079.0,863,518,345,32758,13536,19222,36193498.0,14784360.0,21409138.0,109.23,111.43,109.22,111.38
2023-11-02 11:00,548,227,321,30745,13034,17711,33884834.0,14188045.0,19696788.0,512,204,308,29321,11737,17584,32361503.0,12778298.0,19583205.0,108.85,111.21,108.87,111.37
2023-11-02 11:05,574,354,220,21750,8824,12926,23990665.0,9615705.0,14374960.0,548,342,206,22169,9462,12707,24436160.0,10303161.0,14132999.0,108.97,111.21,108.89,111.22
2023-11-02 11:10,189,114,75,5860,2436,3424,6468503.0,2661224.0,3807278.0,177,107,70,5385,2045,3340,5940762.0,2231402.0,3709359.0,109.25,111.19,109.12,111.06
2023-11-02 11:15,510,135,375,29938,9102,20836,33067569.0,9896528.0,23171041.0,494,124,370,29699,9175,20524,32794767.0,9976274.0,22818492.0,108.73,111.21,108.73,111.18
2023-11-02 11:20,443,217,226,13900,3324,10576,15352420.0,3624558.0,11727861.0,439,219,220,13758,3335,10423,15196223.0,3636859.0,11559364.0,109.04,110.89,109.05,110.9
2023-11-02 11:25,735,411,324,23603,11041,12562,25581047.0,11630217.0,13950830.0,701,385,316,20824,8380,12444,22953800.0,9118162.0,13835637.0,105.34,111.06,108.81,111.18
2023-11-02 11:30,782,321,461,43988,17610,26378,48381276.0,18938640.0,29442635.0,758,307,451,42589,16735,25854,46953584.0,18181404.0,28772179.0,107.54,111.62,108.64,111.29
2023-11-02 11:35,391,121,270,27230,11339,15891,29605330.0,11935259.0,17670070.0,389,121,268,24658,8845,15813,27190225.0,9607380.0,17582845.0,105.26,111.2,108.62,111.19
2023-11-02 11:40,423,206,217,24610,10225,14385,26869570.0,10863839.0,16005731.0,394,194,200,22969,8900,14069,25325908.0,9668957.0,15656950.0,106.25,111.27,108.64,111.29
2023-11-02 11:45,212,86,126,14371,8122,6249,15846651.0,8915897.0,6930754.0,201,81,120,13136,7034,6102,14508536.0,7694868.0,6813668.0,109.77,110.91,109.4,111.66
2023-11-02 11:50,161,47,114,6914,3017,3897,7622968.0,3294337.0,4328630.0,155,41,114,8111,3869,4242,8941079.0,4232470.0,4708609.0,109.19,111.08,109.39,111.0
2023-11-02 11:55,210,51,159,6241,1895,4346,6885882.0,2060806.0,4825075.0,199,43,156,7226,2883,4343,7967514.0,3145898.0,4821615.0,108.75,111.02,109.12,111.02
2023-11-02 12:00,223,77,146,12803,6240,6563,14120509.0,6811838.0,7308671.0,217,69,148,11861,5198,6663,13080697.0,5659356.0,7421340.0,109.16,111.36,108.88,111.38
2023-11-02 12:05,430,170,260,30709,15038,15671,33850329.0,16388674.0,17461655.0,420,166,254,29520,14009,15511,32543766.0,15256507.0,17287259.0,108.98,111.43,108.91,111.45
2023-11-02 12:10,375,110,265,28511,9740,18771,32946460.0,10598357.0,22348103.0,361,109,252,22597,9376,13221,31403605.0,10198958.0,21204646.0,108.81,119.06,108.78,160.39
2023-11-02 12:15,509,184,325,28184,11918,16266,31067490.0,12961630.0,18105860.0,495,174,321,28156,11903,16253,31047460.0,12952903.0,18094557.0,108.76,111.31,108.82,111.33
2023-11-02 12:20,796,259,537,49834,23110,26724,54943281.0,25165321.0,29777960.0,779,249,530,50001,23245,26756,55111793.0,25298340.0,29813452.0,108.89,111.43,108.83,111.43
2023-11-02 12:25,709,114,595,27763,6614,21149,30671718.0,7196609.0,23475109.0,702,109,593,27684,6653,21031,30582478.0,7238440.0,23344037.0,108.81,111.0,108.8,111.0
2023-11-02 12:30,492,219,273,23180,10445,12735,25580814.0,11389026.0,14191788.0,493,225,268,25242,12524,12718,27860676.0,13675306.0,14185369.0,109.04,111.44,109.19,111.54
2023-11-02 12:35,328,176,152,22410,12380,10030,24716465.0,13513572.0,11202893.0,323,176,147,27073,11593,15480,31369132.0,12639704.0,18729428.0,109.16,111.69,109.03,120.99
2023-11-02 12:40,5351,2786,2565,370239,184321,185918,418935621.0,209778457.0,209157164.0,3640,1647,1993,270967,134497,136470,293029453.0,143328410.0,149701043.0,113.81,112.5,106.57,109.7
2023-11-02 12:45,3924,2132,1792,301154,127468,173686,405971173.0,218329345.0,187641828.0,3043,1608,1435,265310,108551,156759,374177970.0,197326069.0,176851900.0,171.28,108.04,181.78,112.82
2023-11-02 12:50,2827,1662,1165,153093,72887,80206,164421061.0,77569810.0,86851251.0,2220,1220,1000,156990,67574,89416,168877291.0,71779418.0,97097872.0,106.42,108.29,106.22,108.59
2023-11-02 12:55,2078,838,1240,134077,46742,87335,146770384.0,53502595.0,93267788.0,1778,703,1075,106797,43215,63582,127223202.0,58287940.0,68935261.0,114.46,106.79,134.88,108.42
2023-11-02 13:00,2557,1079,1478,178788,59509,119279,193178742.0,65186003.0,127992739.0,2109,781,1328,171902,53440,118462,189360672.0,61396857.0,127963814.0,109.54,107.31,114.89,108.02
2023-11-02 13:05,3143,1268,1875,207830,90280,117550,219240297.0,94534718.0,124705578.0,2446,825,1621,176114,74782,101332,186921726.0,78134889.0,108786837.0,104.71,106.09,104.48,107.36
2023-11-02 13:10,2747,1100,1647,165526,74631,90895,174489760.0,78079851.0,96409908.0,2316,835,1481,152282,69065,83217,161224079.0,72255865.0,88968214.0,104.62,106.07,104.62,106.91
2023-11-02 13:15,2886,1257,1629,172138,83153,88985,180287413.0,86628251.0,93659162.0,2249,775,1474,155379,75476,79903,163477650.0,78372219.0,85105431.0,104.18,105.25,103.84,106.51
2023-11-02 13:20,1951,1115,836,82805,44289,38516,87154444.0,46304832.0,40849611.0,1632,947,685,73179,38949,34230,76995284.0,40505374.0,36489909.0,104.55,106.06,104.0,106.6
2023-11-02 13:25,2016,853,1163,114759,60988,53771,121262781.0,63915973.0,57346808.0,1660,646,1014,99649,51268,48381,104959827.0,53362754.0,51597073.0,104.8,106.65,104.09,106.65
2023-11-02 13:30,2097,853,1244,118695,59209,59486,125889819.0,62431556.0,63458263.0,1799,741,1058,110991,57342,53649,117576130.0,60120057.0,57456073.0,105.44,106.68,104.84,107.1
2023-11-02 13:35,1517,527,990,79963,35242,44721,84371457.0,36753041.0,47618416.0,1336,422,914,72270,31038,41232,76545280.0,32431697.0,44113582.0,104.29,106.48,104.49,106.99
2023-11-02 13:40,2420,950,1470,125364,50681,74683,131919884.0,53023775.0,78896108.0,2118,743,1375,115860,47428,68432,122659344.0,49540951.0,73118393.0,104.62,105.64,104.46,106.85
2023-11-02 13:45,3427,1917,1510,113610,51366,62244,120003540.0,53899929.0,66103610.0,3252,1807,1445,108625,47478,61147,114711487.0,49734243.0,64977244.0,104.93,106.2,104.75,106.26
2023-11-02 13:50,1938,863,1075,105297,45254,60043,111046653.0,47250579.0,63796073.0,1792,792,1000,97696,40582,57114,103255344.0,42335980.0,60919363.0,104.41,106.25,104.32,106.66
2023-11-02 13:55,2460,614,1846,114264,32722,81542,120583309.0,34082890.0,86500418.0,2227,477,1750,110617,30284,80333,116944604.0,31547539.0,85397064.0,104.16,106.08,104.17,106.3
2023-11-02 14:00,1680,405,1275,72243,19142,53101,76441683.0,20090225.0,56351458.0,1549,319,1230,73212,19485,53727,77359174.0,20282553.0,57076621.0,104.95,106.12,104.09,106.23
2023-11-02 14:05,1680,706,974,72596,30112,42484,76692519.0,31536831.0,45155688.0,1537,621,916,66504,28859,37645,70237968.0,30128629.0,40109338.0,104.73,106.29,104.4,106.55
2023-11-02 14:10,1595,789,806,84080,39412,44668,88763712.0,41154307.0,47609405.0,1481,725,756,80766,37151,43615,85350734.0,38772386.0,46578348.0,104.42,106.59,104.36,106.79
2023-11-02 14:15,1151,673,478,53313,23477,29836,56167069.0,24552660.0,31614408.0,1049,610,439,54502,23712,30790,57595063.0,24729558.0,32865504.0,104.58,105.96,104.29,106.74
2023-11-02 14:20,1109,593,516,52310,23993,28317,55099589.0,25036224.0,30063365.0,1006,537,469,52149,23556,28593,55106757.0,24564039.0,30542718.0,104.35,106.17,104.28,106.82
2023-11-02 14:25,934,333,601,49702,22068,27634,52334469.0,22942984.0,29391485.0,848,275,573,50493,23655,26838,53210535.0,24603258.0,28607277.0,103.96,106.36,104.01,106.59
2023-11-02 14:30,669,272,397,40714,15905,24809,42935438.0,16557647.0,26377790.0,565,201,364,38041,15193,22848,40146705.0,15802286.0,24344418.0,104.1,106.32,104.01,106.55
2023-11-02 14:35,1661,717,944,88504,39938,48566,92399288.0,41439740.0,50959548.0,1198,397,801,72956,30826,42130,76653410.0,31938033.0,44715377.0,103.76,104.93,103.61,106.14
2023-11-02 14:40,1763,776,987,78873,39919,38954,82454096.0,41223450.0,41230646.0,1474,589,885,70079,35633,34446,73415323.0,36878602.0,36536720.0,103.27,105.84,103.5,106.07
2023-11-02 14:45,1380,692,688,67937,35136,32801,70809899.0,36349113.0,34460786.0,1127,543,584,57553,29869,27684,60171104.0,30897336.0,29273768.0,103.45,105.06,103.44,105.74
2023-11-02 14:50,1479,590,889,64230,28608,35622,67245821.0,29708393.0,37537428.0,1250,412,838,59433,24998,34435,62156120.0,25759780.0,36396340.0,103.85,105.38,103.05,105.7
2023-11-02 14:55,1161,725,436,52430,29142,23288,55476350.0,30725114.0,24751236.0,1003,665,338,48925,28353,20572,51337325.0,29461364.0,21875961.0,105.43,106.28,103.91,106.34
2023-11-02 15:00,940,592,348,50781,26455,24326,52989528.0,27254761.0,25734766.0,859,541,318,49135,26093,23042,51432422.0,26931058.0,24501364.0,103.02,105.79,103.21,106.33
2023-11-02 15:05,1545,1153,392,67355,42551,24804,70656745.0,44342889.0,26313855.0,1439,1098,341,64127,40433,23694,67222921.0,42063632.0,25159288.0,104.21,106.09,104.03,106.18
2023-11-02 15:10,1273,791,482,63349,36780,26569,66403045.0,38264749.0,28138295.0,1153,712,441,60464,34748,25716,63419888.0,36112457.0,27307431.0,104.04,105.91,103.93,106.19
2023-11-02 15:15,1458,1115,343,75618,50362,25256,80581975.0,53620598.0,26961376.0,1357,1084,273,72515,48916,23599,76209909.0,50992372.0,25217536.0,106.47,106.75,104.24,106.86
2023-11-02 15:20,643,269,374,29849,16452,13397,31402155.0,17156755.0,14245400.0,585,238,347,29671,16806,12865,31217990.0,17517297.0,13700693.0,104.28,106.33,104.23,106.5
2023-11-02 15:25,1354,672,682,79799,44673,35126,84634378.0,47087443.0,37546934.0,1195,579,616,68347,35255,33092,73201835.0,37782555.0,35419279.0,105.4,106.89,107.17,107.03
2023-11-02 15:30,1808,1044,764,100736,53099,47637,106730121.0,55787867.0,50942254.0,1656,981,675,97468,52860,44608,103035511.0,55192446.0,47843064.0,105.06,106.94,104.41,107.25
2023-11-02 15:35,636,231,405,29075,12944,16131,30664700.0,13505495.0,17159205.0,560,175,385,27071,12224,14847,28557371.0,12715380.0,15841991.0,104.34,106.37,104.02,106.7
2023-11-02 15:40,968,247,721,40138,16988,23150,42313421.0,17679968.0,24633452.0,896,199,697,39172,16471,22701,41367293.0,17186529.0,24180763.0,104.07,106.41,104.34,106.52
2023-11-02 15:45,1785,944,841,83463,40335,43128,87661187.0,41979675.0,45681512.0,1683,896,787,74758,36584,38174,78923334.0,38206425.0,40716909.0,104.08,105.92,104.43,106.66
2023-11-02 15:50,1089,534,555,53287,24090,29197,56085964.0,25053511.0,31032453.0,991,469,522,50449,22622,27827,53086101.0,23492101.0,29593999.0,104.0,106.29,103.85,106.35
2023-11-02 15:55,1073,585,488,51085,21928,29157,53594370.0,22745058.0,30849312.0,980,532,448,51357,22801,28556,53977404.0,23644300.0,30333104.0,103.73,105.8,103.7,106.22
2023-11-02 16:00,352,190,162,19218,8583,10635,20214883.0,8929604.0,11285279.0,259,116,143,17380,7462,9918,18274544.0,7735380.0,10539163.0,104.04,106.11,103.66,106.26
2023-11-02 16:05,278,139,139,32854,7221,25633,39700949.0,7468159.0,32232790.0,241,104,137,14259,5178,9081,15009971.0,5354799.0,9655172.0,103.42,125.75,103.41,106.32
2023-11-02 16:10,362,181,181,16175,7041,9134,16984051.0,7303706.0,9680344.0,321,144,177,32968,8103,24865,39792905.0,8368940.0,31423965.0,103.73,105.98,103.28,126.38
2023-11-02 16:15,360,164,196,25201,10257,14944,26482227.0,10669754.0,15812472.0,307,123,184,24477,9581,14896,25752073.0,9925316.0,15826757.0,104.02,105.81,103.59,106.25
2023-11-02 16:20,1597,1071,526,68291,39132,29159,71893578.0,40889222.0,31004356.0,1531,1037,494,69678,37747,31931,73206627.0,39222778.0,33983848.0,104.49,106.33,103.91,106.43
2023-11-02 16:25,3194,1157,2037,173303,71423,101880,183711365.0,74965115.0,108746250.0,2997,1049,1948,164562,67547,97015,175203006.0,70618446.0,104584560.0,104.96,106.74,104.55,107.8
2023-11-02 16:30,2165,1823,342,105451,80257,25194,111519154.0,84501344.0,27017809.0,2072,1781,291,104004,79602,24402,109955955.0,83748793.0,26207162.0,105.29,107.24,105.21,107.4
2023-11-02 16:35,2049,1422,627,114158,84394,29764,118579349.0,86604613.0,31974735.0,1921,1364,557,101717,72668,29049,107735457.0,76520328.0,31215129.0,102.62,107.43,105.3,107.46
2023-11-02 16:40,1754,1244,510,89432,62406,27026,94804670.0,65794017.0,29010653.0,1665,1220,445,89376,63758,25618,94571403.0,67013049.0,27558353.0,105.43,107.34,105.11,107.57
2023-11-02 16:45,1656,450,1206,90835,31931,58904,96392988.0,33511738.0,62881249.0,1603,415,1188,90224,31504,58720,95642331.0,32949599.0,62692732.0,104.95,106.75,104.59,106.77
2023-11-02 16:50,668,267,401,43301,18531,24770,69269348.0,19420137.0,49849211.0,628,242,386,42393,18414,23979,44928883.0,19258156.0,25670727.0,104.8,201.25,104.58,107.06
2023-11-02 16:55,1144,597,547,48625,24598,24027,51471644.0,25736947.0,25734697.0,1130,589,541,48230,24348,23882,51053092.0,25472948.0,25580144.0,104.63,107.11,104.62,107.11
2023-11-02 17:00,272,149,123,16441,8180,8261,17353092.0,8537212.0,8815880.0,263,149,114,17442,9236,8206,18418396.0,9635581.0,8782815.0,104.37,106.72,104.33,107.03
2023-11-02 17:05,373,234,139,17192,10105,7087,18163199.0,10570389.0,7592810.0,352,215,137,17267,10137,7130,18236857.0,10596243.0,7640614.0,104.61,107.14,104.53,107.16
2023-11-02 17:10,1355,1034,321,84812,54406,30406,89819531.0,57175207.0,32644323.0,1290,1020,270,82294,52533,29761,87123667.0,55130233.0,31993434.0,105.09,107.36,104.94,107.5
2023-11-02 17:15,2058,957,1101,123882,62470,61412,131199620.0,65613394.0,65586226.0,1892,892,1000,118534,61025,57509,125677251.0,63990897.0,61686354.0,105.03,106.8,104.86,107.26
2023-11-02 17:20,1129,421,708,64301,26103,38198,67829507.0,27129324.0,40700182.0,1034,359,675,63671,26143,37528,67008760.0,26983847.0,40024912.0,103.93,106.55,103.22,106.65
2023-11-02 17:25,263,110,153,13142,4741,8401,13893136.0,4934336.0,8958800.0,234,93,141,13020,4825,8195,13752651.0,5017439.0,8735211.0,104.08,106.64,103.99,106.59
2023-11-02 17:30,1021,226,795,44466,16705,27761,46649398.0,17321826.0,29327572.0,930,175,755,41172,14929,26243,43381552.0,15486531.0,27895020.0,103.69,105.64,103.73,106.3
2023-11-02 17:35,391,132,259,21209,6648,14561,22395557.0,6906960.0,15488597.0,337,94,243,21494,6532,14962,22796143.0,6775449.0,16020693.0,103.9,106.37,103.73,107.08
2023-11-02 17:40,517,275,242,25627,10253,15374,26968970.0,10641006.0,16327963.0,490,250,240,25857,10285,15572,27250577.0,10664223.0,16586353.0,103.78,106.21,103.69,106.51
2023-11-02 17:45,1001,407,594,43895,17709,26186,46007904.0,18373021.0,27634883.0,938,370,568,42950,17530,25420,45179220.0,18165005.0,27014215.0,103.75,105.53,103.62,106.27
2023-11-02 17:50,587,193,394,38194,15670,22524,40165962.0,16250581.0,23915381.0,529,162,367,37215,15352,21863,39118109.0,15881170.0,23236939.0,103.71,106.18,103.45,106.28
2023-11-02 17:55,973,465,508,53495,20803,32692,56190156.0,21566202.0,34623954.0,920,426,494,57026,25126,31900,59718478.0,25873584.0,33844893.0,103.67,105.91,102.98,106.1
2023-11-02 18:00,1183,586,597,60408,23852,36556,63459340.0,24722430.0,38736909.0,1115,543,572,59560,23293,36267,62580523.0,24118171.0,38462352.0,103.65,105.97,103.54,106.05
2023-11-02 18:05,632,198,434,31851,10626,21225,33352886.0,11014125.0,22338760.0,591,179,412,31796,11040,20756,33392152.0,11430273.0,21961878.0,103.65,105.25,103.54,105.81
2023-11-02 18:10,701,225,476,41106,16960,24146,42767621.0,17502626.0,25264995.0,613,157,456,37817,15431,22386,39574423.0,15908823.0,23665599.0,103.2,104.63,103.1,105.72
2023-11-02 18:15,1727,343,1384,95900,35874,60026,100378956.0,37007550.0,63371406.0,1627,272,1355,94211,35156,59055,98622395.0,36251301.0,62371094.0,103.16,105.57,103.12,105.62
2023-11-02 18:20,1898,1192,706,77241,44955,32286,81191024.0,47135884.0,34055139.0,1841,1159,682,75784,43624,32160,79352330.0,45389060.0,33963269.0,104.85,105.48,104.05,105.61
2023-11-02 18:25,2491,2066,425,81809,76832,4977,86108697.0,80856146.0,5252551.0,2426,2047,379,81517,77640,3877,85301061.0,81212059.0,4089002.0,105.24,105.54,104.6,105.47
2023-11-02 18:30,2055,1569,486,63727,57471,6256,67102165.0,60480887.0,6621278.0,1956,1533,423,61298,56541,4757,64538924.0,59461734.0,5077190.0,105.24,105.84,105.17,106.73
2023-11-02 18:35,1090,770,320,35837,26103,9734,37983915.0,27671234.0,10312680.0,927,720,207,25503,20276,5227,26956756.0,21347169.0,5609587.0,106.01,105.94,105.28,107.32
2023-11-03 10:00,2595,1181,1414,78644,28432,50212,106352534.0,30447045.0,75905489.0,1806,975,831,50003,24522,25481,53682845.0,26251107.0,27431738.0,107.09,151.17,107.05,107.66
2023-11-03 10:05,1912,1162,750,41275,22280,18995,43507261.0,23323843.0,20183418.0,1623,1004,619,36603,18311,18292,38860128.0,19326502.0,19533626.0,104.69,106.26,105.55,106.79
2023-11-03 10:10,1193,682,511,20635,9381,11254,22030471.0,9874049.0,12156422.0,1058,590,468,16637,8188,8449,17585773.0,8606287.0,8979485.0,105.26,108.02,105.11,106.28
2023-11-03 10:15,1070,388,682,28236,11940,16296,30103864.0,12496118.0,17607745.0,769,229,540,27072,12750,14322,28468829.0,13168411.0,15300418.0,104.66,108.05,103.28,106.83
2023-11-03 10:20,509,219,290,26316,9959,16357,28187644.0,10408361.0,17779282.0,421,176,245,21914,9429,12485,23237244.0,9852890.0,13384353.0,104.51,108.7,104.5,107.2
2023-11-03 10:25,659,306,353,26157,10027,16130,27967309.0,10551748.0,17415561.0,594,267,327,22298,8629,13669,23684193.0,9040490.0,14643703.0,105.23,107.97,104.77,107.13
2023-11-03 10:30,941,427,514,46309,19604,26705,49377598.0,20616319.0,28761278.0,865,384,481,45175,19092,26083,48142025.0,20061080.0,28080945.0,105.16,107.7,105.08,107.66
2023-11-03 10:35,663,367,296,28041,11532,16509,29862569.0,12121206.0,17741363.0,615,336,279,27537,11171,16366,29345385.0,11735713.0,17609671.0,105.11,107.46,105.06,107.6
2023-11-03 10:40,955,398,557,38764,16408,22356,41340382.0,17286348.0,24054033.0,920,380,540,38557,16320,22237,41096494.0,17163292.0,23933202.0,105.35,107.6,105.17,107.63
2023-11-03 10:45,1117,551,566,46384,21621,24763,49577443.0,22952206.0,26625237.0,1067,525,542,45137,20590,24547,48123421.0,21718518.0,26404903.0,106.16,107.52,105.48,107.57
2023-11-03 10:50,1738,1344,394,84183,58731,25452,89987824.0,62430124.0,27557699.0,1698,1331,367,83601,58686,24915,89231998.0,62266270.0,26965728.0,106.3,108.27,106.1,108.23
2023-11-03 10:55,651,269,382,32453,15872,16581,34552919.0,16767940.0,17784979.0,602,254,348,29156,14554,14602,31138666.0,15369746.0,15768920.0,105.64,107.26,105.6,107.99
2023-11-03 11:00,656,305,351,31163,12468,18695,33161820.0,13108988.0,20052832.0,622,298,324,28938,12353,16585,30815507.0,12984417.0,17831090.0,105.14,107.26,105.11,107.51
2023-11-03 11:05,1324,935,389,43110,20258,22852,45659332.0,21314169.0,24345162.0,1252,899,353,40567,19573,20994,42971009.0,20569240.0,22401768.0,105.21,106.53,105.09,106.71
2023-11-03 11:10,1581,648,933,70464,26848,43616,74101948.0,28043686.0,46058262.0,1488,580,908,67197,25140,42057,71070793.0,26269552.0,44801241.0,104.45,105.6,104.49,106.53
2023-11-03 11:15,605,262,343,14677,5413,9264,15505573.0,5673418.0,9832155.0,568,236,332,14019,4969,9050,14810441.0,5206495.0,9603945.0,104.81,106.13,104.78,106.12
2023-11-03 11:20,970,546,424,30874,12141,18733,32496720.0,12588127.0,19908593.0,936,527,409,29617,11441,18176,31300888.0,11971352.0,19329535.0,103.68,106.28,104.64,106.35
2023-11-03 11:25,1523,954,569,61857,35781,26076,65299516.0,37485344.0,27814172.0,1496,935,561,61172,35366,25806,64568139.0,37040231.0,27527907.0,104.76,106.67,104.73,106.67
2023-11-03 11:30,1670,977,693,63606,29238,34368,66684033.0,30483894.0,36200138.0,1551,906,645,60715,28367,32348,64018054.0,29580567.0,34437486.0,104.26,105.33,104.28,106.46
2023-11-03 11:35,1588,982,606,67485,28502,38983,70856308.0,29527096.0,41329211.0,1498,926,572,65879,27571,38308,69217881.0,28558635.0,40659246.0,103.6,106.02,103.58,106.14
2023-11-03 11:40,956,411,545,40785,13748,27037,42904491.0,14253268.0,28651223.0,877,354,523,39475,12914,26561,41535470.0,13385662.0,28149807.0,103.68,105.97,103.65,105.98
2023-11-03 11:45,1313,703,610,74239,20627,53612,83197477.0,21368137.0,61829340.0,1272,683,589,56043,20548,35495,77822948.0,21283104.0,56539843.0,103.59,115.33,103.58,159.29
2023-11-03 11:50,804,355,449,44462,17324,27138,46678868.0,17937752.0,28741115.0,705,280,425,42905,16304,26601,45049897.0,16862272.0,28187625.0,103.54,105.91,103.42,105.96
2023-11-03 11:55,532,346,186,24639,13186,11453,25885016.0,13711545.0,12173471.0,494,328,166,23836,12974,10862,25043204.0,13486628.0,11556576.0,103.99,106.29,103.95,106.39
2023-11-03 12:00,674,408,266,23942,13109,10833,25152126.0,13621620.0,11530505.0,637,387,250,23603,12557,11046,24835113.0,13055160.0,11779952.0,103.91,106.44,103.97,106.64
2023-11-03 12:05,1082,754,328,59921,30790,29131,62856492.0,31891462.0,30965030.0,1021,714,307,58970,30469,28501,61871665.0,31561881.0,30309783.0,103.58,106.3,103.59,106.35
2023-11-03 12:10,996,609,387,37557,20678,16879,39427857.0,21500267.0,17927589.0,946,576,370,37256,20526,16730,39070653.0,21299905.0,17770747.0,103.98,106.21,103.77,106.22
2023-11-03 12:15,452,308,144,21025,11493,9532,22057015.0,11926861.0,10130153.0,403,280,123,20692,11381,9311,21704883.0,11808831.0,9896052.0,103.78,106.28,103.76,106.28
2023-11-03 12:20,218,148,70,10729,5896,4833,11252530.0,6113757.0,5138773.0,184,127,57,10375,5663,4712,10877422.0,5865686.0,5011736.0,103.69,106.33,103.58,106.36
2023-11-03 12:25,504,351,153,19389,10428,8961,20363021.0,10854155.0,9508866.0,465,330,135,18520,9735,8785,19433545.0,10098512.0,9335033.0,104.09,106.11,103.73,106.26
2023-11-03 12:30,948,600,348,50038,30157,19881,52550593.0,31387654.0,21162938.0,904,575,329,49334,29631,19703,51814657.0,30836387.0,20978270.0,104.08,106.45,104.07,106.47
2023-11-03 12:35,721,164,557,27161,13573,13588,28532623.0,14091249.0,14441374.0,720,159,561,27088,13508,13580,28459549.0,14023428.0,14436121.0,103.82,106.28,103.82,106.3
2023-11-03 12:40,506,226,280,14586,8803,5783,15321274.0,9177476.0,6143798.0,490,220,270,14370,8770,5600,15089082.0,9139037.0,5950044.0,104.25,106.24,104.21,106.25
2023-11-03 12:45,363,211,152,18014,10919,7095,18917230.0,11361031.0,7556199.0,343,196,147,17955,10854,7101,18856650.0,11291307.0,7565343.0,104.05,106.5,104.03,106.54
2023-11-03 12:50,588,398,190,27094,15460,11634,28476462.0,16073421.0,12403041.0,582,399,183,27063,15454,11609,28441334.0,16064746.0,12376588.0,103.97,106.61,103.95,106.61
2023-11-03 12:55,375,158,217,13606,7364,6242,14305322.0,7651777.0,6653545.0,356,147,209,13467,7286,6181,14155165.0,7569725.0,6585440.0,103.91,106.59,103.89,106.54
2023-11-03 13:00,457,203,254,16673,9440,7233,17523950.0,9820597.0,7703352.0,449,198,251,18328,11187,7141,19172500.0,11561715.0,7610784.0,104.03,106.5,103.35,106.58
2023-11-03 13:05,80,48,32,6870,4924,1946,7145191.0,5068440.0,2076751.0,64,36,28,4872,2941,1931,5116624.0,3055771.0,2060853.0,102.93,106.72,103.9,106.72
2023-11-03 13:10,283,134,149,2411,1373,1038,2534583.0,1440308.0,1094275.0,270,126,144,2754,1340,1414,2944847.0,1404451.0,1540396.0,104.9,105.42,104.81,108.94
2023-11-03 13:15,285,196,89,15277,8967,6310,16074803.0,9338958.0,6735845.0,292,195,97,15245,8930,6315,16042735.0,9300219.0,6742515.0,104.15,106.75,104.15,106.77
2023-11-03 13:20,643,232,411,32283,17311,14972,33980342.0,18019238.0,15961104.0,631,226,405,32189,17281,14908,33883840.0,17988602.0,15895237.0,104.09,106.61,104.09,106.62
2023-11-03 13:25,620,499,121,18738,12912,5826,19718297.0,13503670.0,6214627.0,596,483,113,18625,12832,5793,19598210.0,13414083.0,6184126.0,104.58,106.67,104.54,106.75
2023-11-03 13:30,1421,720,701,75230,39893,35337,79187464.0,41532103.0,37655360.0,1404,709,695,74934,39906,35028,78884256.0,41540573.0,37343682.0,104.11,106.56,104.1,106.61
2023-11-03 13:35,1180,447,733,62709,32429,30280,66043010.0,33774220.0,32268789.0,1169,439,730,62596,32434,30162,65916297.0,33778463.0,32137833.0,104.15,106.57,104.15,106.55
2023-11-03 13:40,502,293,209,34861,20681,14180,36708312.0,21565197.0,15143115.0,479,279,200,34552,20393,14159,36387597.0,21264915.0,15122682.0,104.28,106.79,104.28,106.81
2023-11-03 13:45,954,418,536,48909,28153,20756,51490295.0,29349103.0,22141192.0,936,406,530,48813,28140,20673,51401334.0,29334730.0,22066603.0,104.25,106.67,104.25,106.74
2023-11-03 13:50,743,547,196,37784,22243,15541,39767544.0,23186465.0,16581079.0,734,544,190,37643,22133,15510,39630397.0,23080630.0,16549766.0,104.24,106.69,104.28,106.7
2023-11-03 13:55,409,119,290,16632,8822,7810,17508888.0,9176842.0,8332045.0,402,115,287,16535,8805,7730,17407047.0,9160000.0,8247047.0,104.02,106.68,104.03,106.69
2023-11-03 14:00,510,130,380,20062,10818,9244,21091060.0,11251893.0,9839166.0,480,115,365,19898,10762,9136,20931826.0,11191439.0,9740387.0,104.01,106.44,103.99,106.62
2023-11-03 14:05,258,96,162,12106,5821,6285,12683385.0,6026247.0,6657138.0,203,63,140,10963,5506,5457,11499394.0,5696557.0,5802836.0,103.53,105.92,103.46,106.34
2023-11-03 14:10,161,78,83,6691,3895,2796,7000099.0,4027141.0,2972957.0,126,57,69,5408,2800,2608,5673929.0,2901180.0,2772749.0,103.39,106.33,103.61,106.32
2023-11-03 14:15,225,124,101,6391,3298,3093,6726356.0,3440860.0,3285496.0,200,105,95,7097,4054,3043,7405013.0,4168788.0,3236224.0,104.33,106.22,102.83,106.35
2023-11-03 14:20,152,58,94,7794,3473,4321,8210872.0,3621608.0,4589264.0,129,39,90,7698,3359,4339,8083953.0,3475649.0,4608303.0,104.28,106.21,103.47,106.21
2023-11-03 14:25,311,146,165,15424,8344,7080,16155534.0,8659266.0,7496268.0,279,121,158,15140,8165,6975,15885495.0,8471742.0,7413753.0,103.78,105.88,103.76,106.29
2023-11-03 14:30,480,291,189,18547,9843,8704,19421799.0,10208002.0,9213797.0,446,264,182,17984,9567,8417,18863190.0,9923295.0,8939894.0,103.71,105.86,103.72,106.21
2023-11-03 14:35,150,77,73,1595,670,925,1673307.0,695342.0,977965.0,160,77,83,1567,590,977,1646886.0,611978.0,1034908.0,103.78,105.73,103.73,105.93
2023-11-03 14:40,807,298,509,45163,22936,22227,47320192.0,23778522.0,23541669.0,767,264,503,38868,16847,22021,40758013.0,17433658.0,23324355.0,103.67,105.91,103.48,105.92
2023-11-03 14:45,869,341,528,49904,21638,28266,52280603.0,22377706.0,29902897.0,838,321,517,49599,21623,27976,52014089.0,22360404.0,29653684.0,103.42,105.79,103.41,106.0
2023-11-03 14:50,528,199,329,22153,8381,13772,23285299.0,8709903.0,14575396.0,496,181,315,20829,7126,13703,21893105.0,7392273.0,14500832.0,103.92,105.83,103.74,105.82
2023-11-03 14:55,1274,508,766,60851,24955,35896,64127805.0,26001355.0,38126449.0,1214,483,731,60690,24927,35763,63884263.0,25899432.0,37984831.0,104.19,106.21,103.9,106.21
2023-11-03 15:00,867,565,302,30899,12473,18426,32535224.0,12996470.0,19538753.0,842,549,293,30532,12412,18120,32204132.0,12930101.0,19274030.0,104.2,106.04,104.17,106.37
2023-11-03 15:05,1731,323,1408,80891,20736,60155,85356553.0,21558258.0,63798294.0,1701,308,1393,80773,20674,60099,85227900.0,21489119.0,63738780.0,103.97,106.06,103.94,106.06
2023-11-03 15:10,1611,509,1102,70950,25558,45392,74964071.0,26738975.0,48225095.0,1597,494,1103,68309,23069,45240,72150714.0,24087093.0,48063621.0,104.62,106.24,104.41,106.24
2023-11-03 15:15,957,574,383,37493,20988,16505,39498024.0,22046160.0,17451864.0,900,552,348,35908,20744,15164,38005571.0,21780673.0,16224898.0,105.04,105.74,105.0,107.0
2023-11-03 15:20,1306,564,742,54206,20860,33346,57248453.0,21784766.0,35463686.0,1276,546,730,54080,20965,33115,57176644.0,21890495.0,35286149.0,104.43,106.35,104.41,106.56
2023-11-03 15:25,951,462,489,40309,16421,23888,42602902.0,17163650.0,25439252.0,928,448,480,39899,16276,23623,42154210.0,16997523.0,25156686.0,104.52,106.49,104.43,106.49
2023-11-03 15:30,980,482,498,42367,23215,19152,44726895.0,24296394.0,20430501.0,967,474,493,42316,23211,19105,44659806.0,24265126.0,20394679.0,104.66,106.68,104.54,106.75
2023-11-03 15:35,1897,1428,469,82345,54219,28126,87062632.0,56946293.0,30116339.0,1874,1415,459,81086,53292,27794,85667051.0,55904322.0,29762729.0,105.03,107.08,104.9,107.08
2023-11-03 15:40,2232,1481,751,110174,69982,40192,116469237.0,73384589.0,43084648.0,2222,1484,738,109493,69994,39499,115746845.0,73396421.0,42350424.0,104.86,107.2,104.86,107.22
2023-11-03 15:45,2341,1266,1075,116891,77001,39890,123341564.0,80657388.0,42684175.0,2329,1260,1069,116282,76906,39376,122666634.0,80558359.0,42108275.0,104.75,107.0,104.75,106.94
2023-11-03 15:50,1476,853,623,76001,46005,29996,80296302.0,48157739.0,32138562.0,1446,835,611,75852,45254,30598,80164293.0,47352603.0,32811689.0,104.68,107.14,104.64,107.23
2023-11-03 15:55,437,296,141,7004,5650,1354,7455164.0,5974592.0,1480571.0,397,279,118,6784,5738,1046,7160594.0,6043106.0,1117488.0,105.75,109.35,105.32,106.83
2023-11-03 16:00,1160,780,380,31011,21092,9919,32827463.0,22199673.0,10627789.0,1144,770,374,30849,20972,9877,32656025.0,22064706.0,10591319.0,105.25,107.15,105.21,107.23
2023-11-03 16:05,683,421,262,23688,18713,4975,25106478.0,19729804.0,5376674.0,673,418,255,23199,18661,4538,24538150.0,19672966.0,4865183.0,105.43,108.07,105.42,107.21
2023-11-03 16:10,1031,686,345,30565,20518,10047,32371749.0,21584048.0,10787701.0,1021,683,338,30171,20567,9604,31942851.0,21634253.0,10308598.0,105.2,107.37,105.19,107.34
2023-11-03 16:15,1104,671,433,52764,33102,19662,55835423.0,34763170.0,21072252.0,1096,666,430,52805,33164,19641,55901596.0,34826318.0,21075277.0,105.02,107.17,105.01,107.3
2023-11-03 16:20,543,260,283,32458,16850,15608,34356823.0,17636468.0,16720354.0,530,256,274,32081,16690,15391,33960794.0,17467355.0,16493438.0,104.67,107.13,104.66,107.16
2023-11-03 16:25,877,430,447,55324,29227,26097,58566069.0,30607840.0,27958229.0,868,428,440,55235,29226,26009,58467379.0,30602485.0,27864894.0,104.72,107.13,104.71,107.14
2023-11-03 16:30,1352,696,656,37048,22504,14544,39161212.0,23628805.0,15532406.0,1337,687,650,36548,22413,14135,38632179.0,23532346.0,15099833.0,105.0,106.8,104.99,106.83
2023-11-03 16:35,651,321,330,23870,17941,5929,25150158.0,18831925.0,6318233.0,640,311,329,23757,17810,5947,25035241.0,18696649.0,6338591.0,104.97,106.56,104.98,106.58
2023-11-03 16:40,483,302,181,25199,16550,8649,26583776.0,17339739.0,9244036.0,475,293,182,25061,16479,8582,26434745.0,17264257.0,9170488.0,104.77,106.88,104.77,106.86
2023-11-03 16:45,1026,365,661,55345,25840,29505,58741262.0,27237514.0,31503748.0,1004,349,655,54348,24941,29407,57512204.0,26111293.0,31400911.0,105.41,106.77,104.69,106.78
2023-11-03 16:50,1165,845,320,60564,38391,22173,64140893.0,40321658.0,23819235.0,1148,837,311,60054,38265,21789,63597831.0,40186678.0,23411153.0,105.03,107.42,105.02,107.44
2023-11-03 16:55,1289,944,345,80854,49641,31213,85665031.0,52098366.0,33566664.0,1283,940,343,80803,49591,31212,85608880.0,52043714.0,33565166.0,104.95,107.54,104.95,107.54
2023-11-03 17:00,1401,898,503,81456,46502,34954,86115108.0,48763929.0,37351178.0,1380,888,492,80372,46170,34202,85100869.0,48415230.0,36685638.0,104.86,106.86,104.86,107.26
2023-11-03 17:05,1313,520,793,80152,34130,46022,84744490.0,35604956.0,49139534.0,1303,516,787,79756,33843,45913,84336982.0,35311030.0,49025952.0,104.32,106.77,104.34,106.78
2023-11-03 17:10,275,105,170,10878,3191,7687,11511585.0,3335046.0,8176539.0,265,100,165,10831,3188,7643,11454764.0,3324211.0,8130552.0,104.51,106.37,104.27,106.38
2023-11-03 17:15,462,276,186,10660,2119,8541,11269785.0,2219008.0,9050777.0,452,272,180,10635,2170,8465,11253108.0,2270229.0,8982878.0,104.72,105.97,104.62,106.12
2023-11-03 17:20,657,365,292,15147,3246,11901,16023041.0,3398619.0,12624422.0,648,358,290,14941,3148,11793,15805664.0,3295303.0,12510361.0,104.7,106.08,104.68,106.08
2023-11-03 17:25,646,23,623,18228,987,17241,19302688.0,1028439.0,18274249.0,639,22,617,18278,951,17327,19359867.0,990309.0,18369558.0,104.2,105.99,104.13,106.02
2023-11-03 17:30,471,44,427,17373,2291,15082,18390976.0,2384809.0,16006166.0,466,39,427,35531,2474,33057,42663631.0,2567724.0,40095907.0,104.09,106.13,103.79,121.29
2023-11-03 17:35,1336,801,535,61550,32745,28805,65167792.0,34326650.0,30841142.0,1323,792,531,61204,32431,28773,64744461.0,33937904.0,30806557.0,104.83,107.07,104.65,107.07
2023-11-03 17:40,904,714,190,34386,22945,11441,36339902.0,24077049.0,12262852.0,896,711,185,34352,22928,11424,36231272.0,23986794.0,12244478.0,104.93,107.18,104.62,107.18
2023-11-03 17:45,858,486,372,21198,16121,5077,22416982.0,16982145.0,5434837.0,841,474,367,21134,16003,5131,22346718.0,16852988.0,5493730.0,105.34,107.05,105.31,107.07
2023-11-03 17:50,1025,252,773,39779,15310,24469,42025857.0,16087779.0,25938077.0,1002,240,762,38513,14701,23812,40745716.0,15393735.0,25351981.0,105.08,106.0,104.71,106.47
2023-11-03 17:55,2476,584,1892,137191,34438,102753,145103738.0,35887426.0,109216311.0,2454,566,1888,136731,34121,102610,144618962.0,35553786.0,109065175.0,104.21,106.29,104.2,106.29
2023-11-03 18:00,2791,596,2195,154086,41137,112949,163026253.0,42885198.0,120141055.0,2778,587,2191,154232,41151,113081,163179191.0,42891349.0,120287842.0,104.25,106.37,104.23,106.37
2023-11-03 18:05,1476,471,1005,81148,30256,50892,85789659.0,31532239.0,54257420.0,1466,465,1001,80663,29998,50665,85278343.0,31262615.0,54015727.0,104.22,106.61,104.22,106.61
2023-11-03 18:10,1047,476,571,58382,28366,30016,61916097.0,29807551.0,32108546.0,1008,457,551,56495,26575,29920,59835783.0,27830869.0,32004914.0,105.08,106.97,104.73,106.97
2023-11-03 18:15,1082,774,308,53129,33461,19668,56513756.0,35298871.0,21214885.0,1019,747,272,54133,34914,19219,57530565.0,36788945.0,20741619.0,105.49,107.86,105.37,107.92
2023-11-03 18:20,663,382,281,48509,28701,19808,51608803.0,30242874.0,21365929.0,645,381,264,48600,29084,19516,51717263.0,30640611.0,21076652.0,105.37,107.87,105.35,108.0
2023-11-03 18:25,1879,572,1307,99589,32594,66995,104832791.0,34031685.0,70801106.0,1771,504,1267,91847,27053,64794,97195833.0,28257858.0,68937975.0,104.41,105.68,104.45,106.4
2023-11-03 18:30,1013,595,418,30161,21132,9029,31822291.0,22312397.0,9509894.0,924,553,371,25853,18920,6933,27295517.0,19899745.0,7395772.0,105.59,105.33,105.18,106.67
2023-11-03 18:35,1430,358,1072,27213,7726,19487,28926643.0,8189859.0,20736784.0,1451,390,1061,28290,8560,19730,30066956.0,9031637.0,21035319.0,106.0,106.41,105.51,106.62
2023-11-06 10:00,2690,1617,1073,71115,38974,32141,100233177.0,41687271.0,58545906.0,2017,1418,599,49053,35708,13345,52529114.0,38180066.0,14349048.0,106.96,182.15,106.92,107.52
2023-11-06 10:05,429,148,281,4840,2629,2211,5252869.0,2852360.0,2400508.0,347,123,224,4255,2515,1740,4539602.0,2660377.0,1879224.0,108.5,108.57,105.78,108.0
2023-11-06 10:10,646,142,504,8952,4767,4185,9628765.0,5104682.0,4524083.0,613,132,481,8436,4883,3553,9051829.0,5217652.0,3834176.0,107.08,108.1,106.85,107.91
2023-11-06 10:15,675,447,228,31996,19242,12754,34480655.0,20502737.0,13977918.0,628,431,197,30334,18868,11466,32602289.0,20104352.0,12497937.0,106.55,109.6,106.55,109.0
2023-11-06 10:20,1038,541,497,43004,24908,18096,45979364.0,26139251.0,19840113.0,794,426,368,39600,22888,16712,42541060.0,24347339.0,18193720.0,104.94,109.64,106.38,108.87
2023-11-06 10:25,927,517,410,50333,30329,20004,53547916.0,31686213.0,21861702.0,874,496,378,47139,27631,19508,50691620.0,29423792.0,21267828.0,104.47,109.29,106.49,109.02
2023-11-06 10:30,706,431,275,48286,29411,18875,50762383.0,30162001.0,20600382.0,687,432,255,43956,25321,18635,47277466.0,26950645.0,20326821.0,102.55,109.14,106.44,109.08
2023-11-06 10:35,361,214,147,27473,14438,13035,29791660.0,15350955.0,14440705.0,338,204,134,25791,14227,11564,27743699.0,15127349.0,12616350.0,106.32,110.78,106.33,109.1
2023-11-06 10:40,928,358,570,40532,19742,20790,43771213.0,21065667.0,22705546.0,839,307,532,36806,17451,19355,39725288.0,18596578.0,21128710.0,106.7,109.21,106.56,109.16
2023-11-06 10:45,1572,582,990,74669,35453,39216,80622194.0,37793048.0,42829146.0,1534,564,970,73127,33758,39369,79005527.0,35987982.0,43017545.0,106.6,109.21,106.61,109.27
2023-11-06 10:50,1061,326,735,52648,20184,32464,56808373.0,21465129.0,35343243.0,1018,303,715,51136,20001,31135,55086735.0,21247170.0,33839564.0,106.35,108.87,106.23,108.69
2023-11-06 10:55,886,329,557,37892,18285,19607,40693178.0,19400757.0,21292421.0,827,296,531,36491,17286,19205,39204215.0,18329742.0,20874472.0,106.1,108.6,106.04,108.69
2023-11-06 11:00,1110,536,574,43557,19788,23769,68208188.0,21023596.0,47184591.0,1094,523,571,43036,19602,23434,67594994.0,20810717.0,46784276.0,106.24,198.51,106.17,199.64
2023-11-06 11:05,727,194,533,41982,17591,24391,45122225.0,18624186.0,26498039.0,706,183,523,41513,17348,24165,44619131.0,18366822.0,26252308.0,105.87,108.64,105.87,108.64
2023-11-06 11:10,1564,658,906,74821,29469,45352,79456324.0,31025078.0,48431246.0,1410,580,830,69981,27188,42793,74709633.0,28627643.0,46081990.0,105.28,106.79,105.3,107.69
2023-11-06 11:15,503,250,253,27773,13582,14191,29596365.0,14312064.0,15284300.0,471,222,249,27660,13647,14013,29473795.0,14376630.0,15097164.0,105.38,107.7,105.35,107.74
2023-11-06 11:20,425,152,273,28485,12363,16122,30405877.0,13023265.0,17382611.0,395,136,259,27031,11027,16004,28855812.0,11599800.0,17256011.0,105.34,107.82,105.19,107.82
2023-11-06 11:25,741,349,392,22817,8327,14490,24382150.0,8784344.0,15597806.0,717,337,380,23178,8815,14363,24769564.0,9294621.0,15474943.0,105.49,107.65,105.44,107.74
2023-11-06 11:30,1148,477,671,58339,20820,37519,62129987.0,21879322.0,40250665.0,1101,450,651,58449,21532,36917,62318629.0,22623778.0,39694851.0,105.09,107.28,105.07,107.52
2023-11-06 11:35,702,247,455,45822,16369,29453,48801871.0,17134832.0,31667038.0,662,218,444,44581,15456,29125,47494901.0,16171244.0,31323656.0,104.68,107.52,104.63,107.55
2023-11-06 11:40,1304,440,864,89970,36981,52989,95842247.0,38864860.0,56977387.0,1244,398,846,89881,37336,52545,95837854.0,39240801.0,56597053.0,105.09,107.53,105.1,107.71
2023-11-06 11:45,710,240,470,49543,18975,30568,52859792.0,19956403.0,32903389.0,671,212,459,49261,18828,30433,52538407.0,19790669.0,32747738.0,105.17,107.64,105.11,107.61
2023-11-06 11:50,524,319,205,16234,4788,11446,17354942.0,5051433.0,12303509.0,493,302,191,15919,4640,11279,17014709.0,4892750.0,12121959.0,105.5,107.49,105.45,107.47
2023-11-06 11:55,780,133,647,29548,6726,22822,31674055.0,7139456.0,24534599.0,744,110,634,28861,6062,22799,30897424.0,6387359.0,24510065.0,106.15,107.5,105.37,107.51
2023-11-06 12:00,909,322,587,49025,15082,33943,52453234.0,15920002.0,36533231.0,875,302,573,49757,16073,33684,53201182.0,16949887.0,36251295.0,105.56,107.63,105.46,107.62
2023-11-06 12:05,848,196,652,20389,8767,11622,21805889.0,9266582.0,12539307.0,827,183,644,20241,8709,11532,21646023.0,9204730.0,12441292.0,105.7,107.89,105.69,107.88
2023-11-06 12:10,757,573,184,29098,15766,13332,31134550.0,16696830.0,14437720.0,740,563,177,28769,15497,13272,30776739.0,16408492.0,14368246.0,105.9,108.29,105.88,108.26
2023-11-06 12:15,1219,661,558,69088,29552,39536,73590195.0,31071694.0,42518501.0,1172,630,542,66673,28183,38490,71042219.0,29624704.0,41417515.0,105.14,107.54,105.12,107.61
2023-11-06 12:20,1717,688,1029,103243,40726,62517,109695689.0,42679466.0,67016222.0,1612,618,994,101371,40211,61160,107733931.0,42125392.0,65608538.0,104.8,107.2,104.76,107.27
2023-11-06 12:25,654,134,520,29578,11218,18360,31494664.0,11785553.0,19709111.0,628,115,513,29028,10522,18506,30901019.0,11035889.0,19865130.0,105.06,107.35,104.88,107.34
2023-11-06 12:30,463,75,388,17149,6006,11143,18302684.0,6319528.0,11983155.0,439,63,376,16067,5351,10716,17124986.0,5624387.0,11500598.0,105.22,107.54,105.11,107.32
2023-11-06 12:35,764,444,320,41647,20382,21265,44166884.0,21289671.0,22877212.0,747,429,318,40281,18797,21484,42907773.0,19737700.0,23170072.0,104.45,107.58,105.0,107.85
2023-11-06 12:40,662,126,536,16355,6337,10018,17427086.0,6665621.0,10761464.0,616,90,526,17104,7787,9317,18065246.0,8065052.0,10000193.0,105.19,107.42,103.57,107.33
2023-11-06 12:45,359,88,271,19307,6851,12456,20569026.0,7188097.0,13380929.0,353,89,264,19075,7119,11956,20302931.0,7464800.0,12838131.0,104.92,107.43,104.86,107.38
2023-11-06 12:50,176,42,134,9361,3134,6227,9967340.0,3289340.0,6678000.0,169,35,134,9143,2987,6156,9739804.0,3134212.0,6605591.0,104.96,107.24,104.93,107.3
2023-11-06 12:55,347,119,228,22647,8317,14330,24061942.0,8725084.0,15336858.0,329,108,221,22271,8225,14046,23695722.0,8627864.0,15067858.0,104.91,107.03,104.9,107.28
2023-11-06 13:00,445,236,209,16099,9630,6469,17135824.0,10172262.0,6963562.0,426,223,203,15653,9281,6372,16659251.0,9800166.0,6859084.0,105.63,107.65,105.59,107.64
2023-11-06 13:05,643,468,175,26095,14644,11451,27814481.0,15471041.0,12343440.0,626,458,168,23933,14689,9244,25475900.0,15510931.0,9964968.0,105.65,107.79,105.6,107.8
2023-11-06 13:10,335,242,93,13270,8775,4495,14132219.0,9285387.0,4846831.0,333,240,93,13269,8757,4512,14130352.0,9265500.0,4864852.0,105.82,107.83,105.81,107.82
2023-11-06 13:15,268,159,109,17806,9686,8120,18970865.0,10204486.0,8766379.0,261,157,104,16979,8946,8033,18094621.0,9422560.0,8672061.0,105.35,107.96,105.33,107.96
2023-11-06 13:20,147,72,75,8405,4349,4056,8961331.0,4579793.0,4381537.0,136,66,70,8567,4325,4242,9151781.0,4552926.0,4598855.0,105.31,108.03,105.27,108.41
2023-11-06 13:25,407,315,92,16054,9349,6705,17095927.0,9856256.0,7239671.0,396,310,86,16325,9765,6560,17385340.0,10305407.0,7079933.0,105.43,107.97,105.53,107.93
2023-11-06 13:30,136,62,74,8642,4182,4460,9205001.0,4400970.0,4804030.0,123,55,68,8532,4164,4368,9094177.0,4381515.0,4712662.0,105.24,107.71,105.22,107.89
2023-11-06 13:35,344,315,29,6058,4822,1236,6415709.0,5106288.0,1309421.0,336,312,24,5932,4785,1147,6306368.0,5067628.0,1238740.0,105.9,105.94,105.91,108.0
2023-11-06 13:40,57,35,22,2036,1380,656,2170233.0,1457492.0,712741.0,52,31,21,1930,1304,626,2055139.0,1380082.0,675057.0,105.62,108.65,105.83,107.84
2023-11-06 13:45,180,103,77,12418,6983,5435,13223174.0,7358276.0,5864898.0,184,105,79,12658,7057,5601,13477605.0,7435446.0,6042159.0,105.37,107.91,105.36,107.88
2023-11-06 13:50,531,293,238,10386,6202,4184,11056475.0,6554542.0,4501933.0,524,288,236,10280,6186,4094,10945574.0,6539655.0,4405919.0,105.68,107.6,105.72,107.62
2023-11-06 13:55,521,464,57,9287,6067,3220,9893335.0,6420465.0,3472869.0,509,455,54,9251,6050,3201,9848997.0,6401800.0,3447197.0,105.83,107.85,105.81,107.69
2023-11-06 14:00,161,74,87,7252,3562,3690,7728746.0,3746976.0,3981769.0,143,65,78,7197,3386,3811,7671606.0,3558062.0,4113544.0,105.19,107.91,105.08,107.94
2023-11-06 14:05,32,16,16,157,58,99,167896.0,61909.0,105986.0,30,15,15,143,54,89,152936.0,57325.0,95611.0,106.74,107.06,106.16,107.43
2023-11-06 14:10,274,237,37,2680,1615,1065,2855288.0,1706866.0,1148422.0,264,236,28,2546,1548,998,2712438.0,1635476.0,1076962.0,105.69,107.83,105.65,107.91
2023-11-06 14:15,438,350,88,17061,11205,5856,17940256.0,11636635.0,6303621.0,405,329,76,14454,8747,5707,15379521.0,9226200.0,6153321.0,103.85,107.64,105.48,107.82
2023-11-06 14:20,352,193,159,21582,11891,9691,22963276.0,12521980.0,10441295.0,342,188,154,21405,11762,9643,22779695.0,12388706.0,10390989.0,105.31,107.74,105.33,107.76
2023-11-06 14:25,181,100,81,10681,6287,4394,11364464.0,6626152.0,4738311.0,178,97,81,10662,6268,4394,11345082.0,6605509.0,4739572.0,105.39,107.84,105.38,107.86
2023-11-06 14:30,226,141,85,7860,4850,3010,8363523.0,5123227.0,3240295.0,212,132,80,7742,4746,2996,8239780.0,5012100.0,3227679.0,105.63,107.65,105.61,107.73
2023-11-06 14:35,428,347,81,14386,8845,5541,15305311.0,9329209.0,5976102.0,407,333,74,14080,8772,5308,14980543.0,9251676.0,5728867.0,105.47,107.85,105.47,107.93
2023-11-06 14:40,193,127,66,9097,5510,3587,9675345.0,5813439.0,3861906.0,173,115,58,8792,5477,3315,9348133.0,5775250.0,3572883.0,105.51,107.66,105.45,107.78
2023-11-06 14:45,199,137,62,7704,4207,3497,8187002.0,4420006.0,3766996.0,179,125,54,7630,4187,3443,8107136.0,4396748.0,3710387.0,105.06,107.72,105.01,107.77
2023-11-06 14:50,227,132,95,11553,5648,5905,12268721.0,5911762.0,6356958.0,185,94,91,10895,5035,5860,11573992.0,5269908.0,6304084.0,104.67,107.65,104.67,107.58
2023-11-06 14:55,177,86,91,10238,4896,5342,10857178.0,5122646.0,5734531.0,191,104,87,9882,4639,5243,10487570.0,4857025.0,5630545.0,104.63,107.35,104.7,107.39
2023-11-06 15:00,507,378,129,16938,9718,7220,18023843.0,10256131.0,7767711.0,485,360,125,16292,9091,7201,17308979.0,9561793.0,7747186.0,105.54,107.59,105.18,107.58
2023-11-06 15:05,638,383,255,13194,8563,4631,14030335.0,9053481.0,4976853.0,627,379,248,13157,8572,4585,13985618.0,9056118.0,4929499.0,105.73,107.47,105.65,107.51
2023-11-06 15:10,466,317,149,20657,12646,8011,21940326.0,13314190.0,8626135.0,455,308,147,19622,11613,8009,20853540.0,12226674.0,8626865.0,105.28,107.68,105.28,107.71
2023-11-06 15:15,212,129,83,12261,7158,5103,13034212.0,7534950.0,5499262.0,202,122,80,11954,7069,4885,12695809.0,7433840.0,5261969.0,105.27,107.77,105.16,107.72
2023-11-06 15:20,325,250,75,9163,4384,4779,9717334.0,4603539.0,5113794.0,316,246,70,10840,6551,4289,11315428.0,6704277.0,4611150.0,105.01,107.01,102.34,107.51
2023-11-06 15:25,240,94,146,14391,6140,8251,15282339.0,6438703.0,8843635.0,220,81,139,14255,6121,8134,15144454.0,6412066.0,8732388.0,104.86,107.18,104.76,107.36
2023-11-06 15:30,157,50,107,8179,3370,4809,8681387.0,3526675.0,5154711.0,147,41,106,8139,3324,4815,8649358.0,3482996.0,5166362.0,104.65,107.19,104.78,107.3
2023-11-06 15:35,431,308,123,12207,5720,6487,12993155.0,6030991.0,6962163.0,406,297,109,11861,5530,6331,12613251.0,5818240.0,6795011.0,105.44,107.32,105.21,107.33
2023-11-06 15:40,415,318,97,7857,3672,4185,8359018.0,3875181.0,4483836.0,406,311,95,7741,3561,4180,8235534.0,3756115.0,4479419.0,105.53,107.14,105.48,107.16
2023-11-06 15:45,90,38,52,2756,1054,1702,2932221.0,1110302.0,1821918.0,84,37,47,2665,1054,1611,2836147.0,1110258.0,1725889.0,105.34,107.05,105.34,107.13
2023-11-06 15:50,324,159,165,22253,10028,12225,23642010.0,10502436.0,13139573.0,306,143,163,22110,9928,12182,23494658.0,10399006.0,13095651.0,104.73,107.48,104.74,107.5
2023-11-06 15:55,266,149,117,10375,4268,6107,11044503.0,4493792.0,6550711.0,241,131,110,10345,4255,6090,11004597.0,4470689.0,6533907.0,105.29,107.27,105.07,107.29
2023-11-06 16:00,237,193,44,5289,2828,2461,5692539.0,2978555.0,2713983.0,227,187,40,4824,2817,2007,5131784.0,2965755.0,2166029.0,105.32,110.28,105.28,107.92
2023-11-06 16:05,112,64,48,4413,2517,1896,4697338.0,2658320.0,2039017.0,97,57,40,4336,2463,1873,4672382.0,2597419.0,2074962.0,105.61,107.54,105.46,110.78
2023-11-06 16:10,236,158,78,11804,7079,4725,12544121.0,7455936.0,5088185.0,210,140,70,11347,6701,4646,12059912.0,7053926.0,5005985.0,105.32,107.69,105.27,107.75
2023-11-06 16:15,81,45,36,1717,889,828,1827330.0,941462.0,885868.0,68,33,35,1659,863,796,1769322.0,913304.0,856017.0,105.9,106.99,105.83,107.54
2023-11-06 16:20,98,38,60,3269,1224,2045,3483334.0,1289648.0,2193686.0,91,36,55,3143,1193,1950,3345784.0,1254663.0,2091121.0,105.36,107.27,105.17,107.24
2023-11-06 16:25,302,58,244,7147,3093,4054,7583513.0,3258427.0,4325086.0,287,45,242,6863,2912,3951,7296229.0,3056357.0,4239871.0,105.35,106.69,104.96,107.31
2023-11-06 16:30,292,228,64,6489,3404,3085,6920126.0,3603872.0,3316253.0,284,223,61,6589,3515,3074,6997570.0,3692694.0,3304875.0,105.87,107.5,105.06,107.51
2023-11-06 16:35,59,29,30,4367,2172,2195,4642733.0,2278682.0,2364051.0,51,25,26,4320,2146,2174,4595918.0,2250173.0,2345745.0,104.91,107.7,104.85,107.9
2023-11-06 16:40,263,29,234,5185,2081,3104,5513173.0,2180689.0,3332483.0,257,24,233,5163,2056,3107,5490353.0,2154412.0,3335941.0,104.79,107.36,104.79,107.37
2023-11-06 16:45,57,24,33,2963,1376,1587,3153147.0,1448832.0,1704315.0,48,19,29,2651,1268,1383,2818461.0,1330908.0,1487552.0,105.29,107.39,104.96,107.56
2023-11-06 16:50,138,76,62,9663,5014,4649,10275202.0,5266215.0,5008986.0,128,68,60,9414,4769,4645,10012566.0,5008001.0,5004565.0,105.03,107.74,105.01,107.74
2023-11-06 16:55,31,15,16,1331,697,634,1415668.0,731886.0,683781.0,27,11,16,1363,696,667,1449917.0,730552.0,719365.0,105.01,107.85,104.96,107.85
2023-11-06 17:00,93,43,50,5872,2699,3173,6245433.0,2830072.0,3415361.0,84,39,45,6004,2844,3160,6383040.0,2980792.0,3402248.0,104.86,107.64,104.81,107.67
2023-11-06 17:05,80,32,48,3599,1516,2083,3841001.0,1597806.0,2243194.0,66,24,42,3239,1463,1776,3441142.0,1532201.0,1908941.0,105.4,107.69,104.73,107.49
2023-11-06 17:10,200,92,108,12996,6877,6119,13620951.0,7046323.0,6574628.0,188,82,106,10586,4477,6109,11262061.0,4698096.0,6563965.0,102.46,107.45,104.94,107.45
2023-11-06 17:15,100,53,47,8332,4210,4122,8861427.0,4421929.0,4439497.0,88,44,44,7941,3854,4087,8444764.0,4041083.0,4403681.0,105.03,107.7,104.85,107.75
2023-11-06 17:20,75,14,61,1762,52,1710,1879060.0,55627.0,1823433.0,68,7,61,1735,25,1710,1850070.0,26527.0,1823543.0,106.98,106.63,106.11,106.64
2023-11-06 17:25,128,48,80,7535,2709,4826,8033550.0,2842126.0,5191424.0,119,41,78,7488,2857,4631,7969467.0,2998438.0,4971029.0,104.91,107.57,104.95,107.34
2023-11-06 17:30,128,61,67,7321,3481,3840,7798892.0,3663529.0,4135363.0,120,54,66,7135,3313,3822,7596944.0,3481039.0,4115905.0,105.24,107.69,105.07,107.69
2023-11-06 17:35,422,285,137,11434,6352,5082,12183726.0,6704369.0,5479357.0,411,279,132,11649,6595,5054,12404121.0,6955401.0,5448719.0,105.55,107.82,105.46,107.81
2023-11-06 17:40,1344,236,1108,44187,12548,31639,47121781.0,13226299.0,33895482.0,1329,226,1103,44106,12530,31576,47037785.0,13205682.0,33832102.0,105.41,107.13,105.39,107.14
2023-11-06 17:45,1689,787,902,105431,59006,46425,112951262.0,62692409.0,50258853.0,1584,739,845,96180,51148,45032,103007027.0,54252675.0,48754352.0,106.25,108.26,106.07,108.27
2023-11-06 17:50,1245,730,515,77452,45324,32128,83306578.0,48255751.0,35050827.0,1200,713,487,77162,45470,31692,82977834.0,48406816.0,34571018.0,106.47,109.1,106.46,109.08
2023-11-06 17:55,1893,980,913,103890,59770,44120,111894266.0,63722951.0,48171315.0,1848,958,890,102793,58872,43921,110712334.0,62734758.0,47977576.0,106.61,109.18,106.56,109.24
2023-11-06 18:00,871,226,645,39228,21967,17261,42146522.0,23371063.0,18775459.0,850,220,630,39195,22001,17194,42106306.0,23398540.0,18707766.0,106.39,108.77,106.35,108.8
2023-11-06 18:05,1137,407,730,49970,30373,19597,53734125.0,32397860.0,21336264.0,1114,400,714,49918,30677,19241,53656097.0,32700520.0,20955576.0,106.67,108.88,106.6,108.91
2023-11-06 18:10,707,310,397,37983,22510,15473,40898926.0,23999638.0,16899288.0,684,306,378,38784,23628,15156,41760172.0,25207528.0,16552644.0,106.62,109.22,106.68,109.22
2023-11-06 18:15,1119,648,471,52483,30867,21616,56502845.0,32924633.0,23578212.0,1100,644,456,54862,33188,21674,58849850.0,35185336.0,23664514.0,106.67,109.08,106.02,109.18
2023-11-06 18:20,948,519,429,54859,31714,23145,59093237.0,33827970.0,25265266.0,929,512,417,53660,31609,22051,57771619.0,33690423.0,24081196.0,106.67,109.16,106.58,109.21
2023-11-06 18:25,719,265,454,34855,18336,16519,37485099.0,19595304.0,17889795.0,703,253,450,33275,16879,16396,35872016.0,18019018.0,17852997.0,106.87,108.3,106.75,108.89
2023-11-06 18:30,1436,489,947,32540,9420,23120,35064751.0,10069482.0,24995269.0,1405,475,930,31712,9426,22286,34174789.0,10074727.0,24100061.0,106.89,108.11,106.88,108.14
2023-11-06 18:35,337,178,159,8620,5533,3087,9264694.0,5933594.0,3331100.0,333,181,152,8820,5697,3123,9467810.0,6097739.0,3370071.0,107.24,107.91,107.03,107.91
2023-11-07 10:00,2116,862,1254,55901,21409,34492,62309573.0,22712875.0,39596698.0,1363,635,728,30614,16123,14491,32839399.0,17186441.0,15652958.0,106.09,114.8,106.6,108.02
2023-11-07 10:05,1026,561,465,20481,7883,12598,22004359.0,8321135.0,13683224.0,938,511,427,16050,5277,10773,17262307.0,5645883.0,11616423.0,105.56,108.61,106.99,107.83
2023-11-07 10:10,1044,595,449,22680,5106,17574,24454230.0,5428138.0,19026092.0,989,568,421,19875,3504,16371,21393525.0,3743516.0,17650009.0,106.31,108.26,106.84,107.81
2023-11-07 10:15,1161,610,551,30040,10236,19804,32404472.0,10849378.0,21555094.0,901,479,422,26685,9071,17614,28684861.0,9624565.0,19060296.0,105.99,108.84,106.1,108.21
2023-11-07 10:20,340,148,192,14060,4335,9725,15303471.0,4591842.0,10711629.0,310,134,176,12555,4285,8270,13490190.0,4535206.0,8954984.0,105.92,110.15,105.84,108.28
2023-11-07 10:25,798,424,374,34044,14706,19338,36746501.0,15773959.0,20972541.0,745,388,357,33869,14658,19211,36380992.0,15548811.0,20832181.0,107.26,108.45,106.08,108.44
2023-11-07 10:30,1375,925,450,55318,30832,24486,59708379.0,33015186.0,26693192.0,1330,901,429,53893,30674,23219,58017729.0,32710389.0,25307340.0,107.08,109.01,106.64,108.99
2023-11-07 10:35,1460,1048,412,75398,47707,27691,81307783.0,51037228.0,30270555.0,1384,1023,361,74363,47121,27242,80153468.0,50375316.0,29778151.0,106.98,109.32,106.91,109.31
2023-11-07 10:40,1079,801,278,74014,49586,24428,80061588.0,53244018.0,26817569.0,1025,786,239,71653,49062,22591,77264721.0,52517343.0,24747378.0,107.38,109.78,107.04,109.55
2023-11-07 10:45,2009,1405,604,105852,76333,29519,114162181.0,81849836.0,32312345.0,1971,1395,576,105003,76449,28554,113230349.0,81975175.0,31255174.0,107.23,109.46,107.23,109.46
2023-11-07 10:50,1815,1029,786,84045,58038,26007,90664587.0,62258989.0,28405598.0,1790,1020,770,82750,57416,25334,89139420.0,61464789.0,27674630.0,107.27,109.22,107.05,109.24
2023-11-07 10:55,825,705,120,37815,28148,9667,40690164.0,30134158.0,10556006.0,800,699,101,37566,28306,9260,40416091.0,30299005.0,10117085.0,107.06,109.2,107.04,109.26
2023-11-07 11:00,833,472,361,29064,17013,12051,31267193.0,18136093.0,13131100.0,820,465,355,29052,17041,12011,31254090.0,18165333.0,13088757.0,106.6,108.96,106.6,108.97
2023-11-07 11:05,595,538,57,19330,12726,6604,41579967.0,13583302.0,27996664.0,582,533,49,18437,12668,5769,19816155.0,13521165.0,6294989.0,106.74,423.93,106.73,109.12
2023-11-07 11:10,47,30,17,1416,728,688,1520529.0,770823.0,749705.0,35,23,12,1402,741,661,1506148.0,784313.0,721834.0,105.88,108.97,105.85,109.2
2023-11-07 11:15,194,107,87,6211,3708,2503,6678818.0,3951937.0,2726881.0,187,102,85,6339,3841,2498,6813540.0,4091206.0,2722333.0,106.58,108.94,106.51,108.98
2023-11-07 11:20,507,174,333,16371,9500,6871,17638732.0,10156271.0,7482461.0,482,157,325,15772,8976,6796,16993381.0,9580827.0,7412553.0,106.91,108.9,106.74,109.07
2023-11-07 11:25,1379,690,689,42950,28311,14639,46360960.0,30415403.0,15945557.0,1348,668,680,42252,27688,14564,45546557.0,29690261.0,15856295.0,107.43,108.93,107.23,108.87
2023-11-07 11:30,2061,1326,735,99974,75210,24764,107900539.0,80852571.0,27047968.0,2038,1312,726,99906,75095,24811,107830933.0,80726189.0,27104744.0,107.5,109.22,107.5,109.24
2023-11-07 11:35,881,565,316,41105,31085,10020,44371391.0,33425456.0,10945934.0,870,562,308,41074,31306,9768,44324328.0,33650122.0,10674206.0,107.53,109.24,107.49,109.28
2023-11-07 11:40,324,184,140,7713,4830,2883,8316175.0,5188114.0,3128061.0,317,182,135,7588,4795,2793,8185861.0,5141888.0,3043972.0,107.41,108.5,107.23,108.99
2023-11-07 11:45,87,52,35,6598,3778,2820,7155813.0,4033010.0,3122802.0,74,44,30,6086,3700,2386,6560709.0,3945695.0,2615014.0,106.75,110.74,106.64,109.6
2023-11-07 11:50,313,178,135,8620,4798,3822,9308734.0,5133763.0,4174970.0,315,178,137,8732,4864,3868,9427368.0,5200999.0,4226368.0,107.0,109.24,106.93,109.26
2023-11-07 11:55,100,73,27,5187,3989,1198,5576532.0,4268704.0,1307827.0,85,66,19,3878,2922,956,4175656.0,3128015.0,1047641.0,107.01,109.17,107.05,109.59
2023-11-07 12:00,1370,418,952,60045,24188,35857,64516803.0,25675351.0,38841452.0,1274,368,906,57556,23417,34139,61858638.0,24853780.0,37004857.0,106.15,108.32,106.14,108.39
2023-11-07 12:05,897,566,331,41864,18831,23033,44954514.0,19957635.0,24996879.0,860,546,314,41676,18744,22932,44744789.0,19856158.0,24888631.0,105.98,108.53,105.93,108.53
2023-11-07 12:10,1015,513,502,47035,21363,25672,50479833.0,22612840.0,27866993.0,1002,508,494,46869,21184,25685,50308794.0,22425612.0,27883182.0,105.85,108.55,105.86,108.56
2023-11-07 12:15,518,219,299,25951,10788,15163,27895449.0,11439194.0,16456255.0,495,195,300,25119,9934,15185,27000087.0,10520482.0,16479604.0,106.04,108.53,105.9,108.53
2023-11-07 12:20,369,151,218,22832,9489,13343,24540759.0,10045738.0,14495021.0,359,150,209,22864,9497,13367,24573809.0,10054923.0,14518886.0,105.87,108.63,105.87,108.62
2023-11-07 12:25,516,136,380,16893,4659,12234,18189445.0,4938241.0,13251204.0,505,135,370,16592,4551,12041,17852835.0,4819611.0,13033223.0,105.99,108.31,105.9,108.24
2023-11-07 12:30,418,83,335,18271,5449,12822,19660320.0,5774441.0,13885879.0,401,72,329,18222,5460,12762,19603704.0,5783393.0,13820310.0,105.97,108.3,105.92,108.29
2023-11-07 12:35,631,150,481,25890,7841,18049,27847626.0,8309323.0,19538303.0,601,131,470,25719,7745,17974,27678050.0,8205575.0,19472475.0,105.97,108.25,105.95,108.34
2023-11-07 12:40,83,26,57,5377,2112,3265,5786811.0,2239492.0,3547318.0,77,24,53,5219,2111,3108,5615835.0,2237725.0,3378109.0,106.04,108.65,106.0,108.69
2023-11-07 12:45,151,67,84,7318,3107,4211,7846585.0,3288839.0,4557746.0,141,61,80,7276,3075,4201,7824146.0,3257408.0,4566738.0,105.85,108.23,105.93,108.71
2023-11-07 12:50,649,469,180,17739,7883,9856,19066820.0,8374758.0,10692061.0,635,460,175,18345,8600,9745,19714457.0,9136654.0,10577802.0,106.24,108.48,106.24,108.55
2023-11-07 12:55,858,393,465,34194,13507,20687,37098424.0,14260979.0,22837444.0,809,367,442,33369,13129,20240,36067110.0,13868020.0,22199090.0,105.58,110.4,105.63,109.68
2023-11-07 13:00,704,405,299,31405,13148,18257,33629857.0,13887102.0,19742754.0,688,390,298,31007,12655,18352,33390723.0,13348518.0,20042205.0,105.62,108.14,105.48,109.21
2023-11-07 13:05,1137,484,653,55211,20086,35125,59124201.0,21186261.0,37937940.0,1107,471,636,55088,19984,35104,58994023.0,21075066.0,37918956.0,105.48,108.01,105.46,108.02
2023-11-07 13:10,954,566,388,57139,29218,27921,61521021.0,31152332.0,30368689.0,915,540,375,56263,28382,27881,60457129.0,30144908.0,30312221.0,106.62,108.77,106.21,108.72
2023-11-07 13:15,990,479,511,46223,24252,21971,49702876.0,25787057.0,23915819.0,990,482,508,46521,24666,21855,50010490.0,26225932.0,23784558.0,106.33,108.85,106.32,108.83
2023-11-07 13:20,1221,769,452,42418,24219,18199,45500267.0,25742638.0,19757628.0,1226,778,448,42634,24525,18109,45731668.0,26068236.0,19663432.0,106.29,108.56,106.29,108.58
2023-11-07 13:25,436,204,232,16262,9545,6717,17427812.0,10133889.0,7293923.0,439,209,230,15302,8621,6681,16405078.0,9149973.0,7255104.0,106.17,108.59,106.14,108.59
2023-11-07 13:30,40,26,14,495,352,143,536627.0,374728.0,161899.0,38,26,12,838,769,69,870910.0,796121.0,74789.0,106.46,113.22,103.53,108.39
2023-11-07 13:35,1391,821,570,68827,42371,26456,74487035.0,45650832.0,28836202.0,1349,798,551,66163,40054,26109,71208205.0,42746906.0,28461298.0,107.74,109.0,106.72,109.01
2023-11-07 13:40,896,323,573,55267,24235,31032,59528073.0,25759425.0,33768648.0,873,310,563,53835,23826,30009,57999057.0,25332862.0,32666195.0,106.29,108.82,106.32,108.85
2023-11-07 13:45,161,91,70,9726,5331,4395,10455591.0,5667828.0,4787763.0,156,89,67,10217,5850,4367,10971141.0,6212174.0,4758967.0,106.32,108.94,106.19,108.98
2023-11-07 13:50,203,111,92,17131,8367,8764,18428692.0,8869987.0,9558704.0,203,112,91,17151,8465,8686,18446616.0,8971651.0,9474965.0,106.01,109.07,105.99,109.08
2023-11-07 13:55,860,358,502,50066,21825,28241,53959254.0,23214606.0,30744648.0,844,340,504,50183,20969,29214,54095170.0,22304072.0,31791098.0,106.37,108.87,106.37,108.82
2023-11-07 14:00,409,129,280,22797,9110,13687,24570092.0,9684862.0,14885229.0,389,125,264,22115,9059,13056,23837029.0,9629625.0,14207403.0,106.31,108.75,106.3,108.82
2023-11-07 14:05,947,604,343,52124,26227,25897,55929422.0,27788471.0,28140951.0,920,586,334,51612,26111,25501,55381789.0,27664837.0,27716952.0,105.95,108.66,105.95,108.69
2023-11-07 14:10,1159,584,575,62247,31097,31150,66819611.0,32982980.0,33836630.0,1156,581,575,62506,31263,31243,67076306.0,33139886.0,33936419.0,106.06,108.62,106.0,108.62
2023-11-07 14:15,520,341,179,34388,19834,14554,36881710.0,21048879.0,15832831.0,509,336,173,33274,18814,14460,35706494.0,19974402.0,15732092.0,106.13,108.79,106.17,108.8
2023-11-07 14:20,371,292,79,8460,5766,2694,9084135.0,6146483.0,2937652.0,363,289,74,8479,5800,2679,9093958.0,6178566.0,2915392.0,106.6,109.04,106.53,108.82
2023-11-07 14:25,284,178,106,11329,7482,3847,12147243.0,7965108.0,4182135.0,275,171,104,11265,7435,3830,12080211.0,7915262.0,4164949.0,106.46,108.71,106.46,108.75
2023-11-07 14:30,161,82,79,7769,4554,3215,8315791.0,4829864.0,3485927.0,156,79,77,7645,4397,3248,8187624.0,4660385.0,3527239.0,106.06,108.43,105.99,108.6
2023-11-07 14:35,151,105,46,8324,4570,3754,8935529.0,4850126.0,4085403.0,142,103,39,8245,4567,3678,8849261.0,4844997.0,4004264.0,106.13,108.83,106.09,108.87
2023-11-07 14:40,96,63,33,4670,2685,1985,5016056.0,2855219.0,2160837.0,80,53,27,4581,2624,1957,4916060.0,2785284.0,2130776.0,106.34,108.86,106.15,108.88
2023-11-07 14:45,437,26,411,4149,1320,2829,4458439.0,1401304.0,3057135.0,437,26,411,4444,1577,2867,4768806.0,1669564.0,3099242.0,106.16,108.06,105.87,108.1
2023-11-07 14:50,24,12,12,558,521,37,577166.0,537086.0,40080.0,19,7,12,51,14,37,54696.0,14605.0,40091.0,103.09,108.32,104.32,108.35
2023-11-07 14:55,381,32,349,4894,1616,3278,5257505.0,1714024.0,3543481.0,375,29,346,4663,1552,3111,5010683.0,1645266.0,3365417.0,106.07,108.1,106.01,108.18
2023-11-07 15:00,470,43,427,4798,1899,2899,5155778.0,2024604.0,3131173.0,460,37,423,4878,2018,2860,5237653.0,2148100.0,3089553.0,106.61,108.01,106.45,108.03
2023-11-07 15:05,72,26,46,3744,1653,2091,4021036.0,1748819.0,2272217.0,70,25,45,3595,1655,1940,3861159.0,1750723.0,2110436.0,105.8,108.67,105.78,108.79
2023-11-07 15:10,478,405,73,9658,5320,4338,10315293.0,5655864.0,4659428.0,470,402,68,9316,5216,4100,9998783.0,5544860.0,4453922.0,106.31,107.41,106.3,108.63
2023-11-07 15:15,372,311,61,8923,5076,3847,9570050.0,5391558.0,4178492.0,370,312,58,9549,5782,3767,10236078.0,6144008.0,4092070.0,106.22,108.62,106.26,108.63
2023-11-07 15:20,545,200,345,28473,11341,17132,30504540.0,11982160.0,18522380.0,528,191,337,29714,12603,17111,31838605.0,13320991.0,18517614.0,105.65,108.12,105.7,108.22
2023-11-07 15:25,387,102,285,15650,5564,10086,16789839.0,5881296.0,10908543.0,385,101,284,14967,5344,9623,16054106.0,5648830.0,10405275.0,105.7,108.16,105.7,108.13
2023-11-07 15:30,684,251,433,24458,9713,14745,26234127.0,10282993.0,15951133.0,675,244,431,23783,8704,15079,25513368.0,9203219.0,16310148.0,105.87,108.18,105.74,108.16
2023-11-07 15:35,256,157,99,15675,8983,6692,16802158.0,9529622.0,7272536.0,257,159,98,15582,8937,6645,16704278.0,9481841.0,7222437.0,106.09,108.68,106.1,108.69
2023-11-07 15:40,187,102,85,10885,5939,4946,11675481.0,6308831.0,5366650.0,178,98,80,11180,6337,4843,11984657.0,6733124.0,5251533.0,106.23,108.5,106.25,108.44
2023-11-07 15:45,227,124,103,12838,6754,6084,13762183.0,7158183.0,6603999.0,219,121,98,12995,6928,6067,13923446.0,7334040.0,6589405.0,105.98,108.55,105.86,108.61
2023-11-07 15:50,124,69,55,7274,4013,3261,7796575.0,4251737.0,3544838.0,120,65,55,7303,4042,3261,7821938.0,4277225.0,3544713.0,105.95,108.7,105.82,108.7
2023-11-07 15:55,117,50,67,6416,3595,2821,6873719.0,3815367.0,3058352.0,112,48,64,5473,2660,2813,5865653.0,2814460.0,3051192.0,106.13,108.41,105.81,108.47
2023-11-07 16:00,448,187,261,21582,10852,10730,23132458.0,11490211.0,11642247.0,447,188,259,22094,11052,11042,23683806.0,11701797.0,11982008.0,105.88,108.5,105.88,108.51
2023-11-07 16:05,228,59,169,11763,3433,8330,12560076.0,3624731.0,8935345.0,209,46,163,13437,3371,10066,14459885.0,3558006.0,10901878.0,105.58,107.27,105.55,108.3
2023-11-07 16:10,443,138,305,16435,5801,10634,17616366.0,6123544.0,11492822.0,439,133,306,16442,5780,10662,17623890.0,6101423.0,11522467.0,105.56,108.08,105.56,108.07
2023-11-07 16:15,433,136,297,24359,10217,14142,26109430.0,10797093.0,15312337.0,423,129,294,24230,10079,14151,25966886.0,10645028.0,15321858.0,105.68,108.28,105.62,108.27
2023-11-07 16:20,645,232,413,44740,20153,24587,48027757.0,21296546.0,26731211.0,634,227,407,43160,18945,24215,46269505.0,20012456.0,26257048.0,105.67,108.72,105.63,108.43
2023-11-07 16:25,52,21,31,1640,233,1407,1769098.0,253436.0,1515662.0,36,13,23,336,75,261,360874.0,79006.0,281867.0,108.77,107.72,105.34,108.0
2023-11-07 16:30,59,27,32,2488,1019,1469,2546151.0,1082151.0,1464000.0,57,26,31,2060,1089,971,2200638.0,1144368.0,1056270.0,106.2,99.66,105.08,108.78
2023-11-07 16:35,178,22,156,2358,810,1548,2528418.0,862089.0,1666328.0,172,19,153,1946,582,1364,2088254.0,617144.0,1471110.0,106.43,107.64,106.04,107.85
2023-11-07 16:40,323,170,153,8103,3786,4317,8631326.0,4019245.0,4612081.0,305,163,142,7915,4339,3576,8476731.0,4607322.0,3869409.0,106.16,106.84,106.18,108.2
2023-11-07 16:45,84,46,38,5858,2988,2870,6274200.0,3157363.0,3116836.0,73,39,34,5721,2876,2845,6127075.0,3037138.0,3089937.0,105.67,108.6,105.6,108.61
2023-11-07 16:50,316,85,231,11230,5219,6011,12028724.0,5523423.0,6505301.0,317,87,230,11243,5252,5991,12047641.0,5558597.0,6489044.0,105.83,108.22,105.84,108.31
2023-11-07 16:55,457,392,65,8485,4540,3945,9076638.0,4799074.0,4277564.0,442,382,60,7710,3864,3846,8262053.0,4085235.0,4176817.0,105.71,108.43,105.73,108.6
2023-11-07 17:00,178,67,111,12732,5725,7007,13646583.0,6050736.0,7595847.0,168,60,108,12283,5572,6711,13160814.0,5885011.0,7275803.0,105.69,108.4,105.62,108.42
2023-11-07 17:05,318,59,259,8137,3040,5097,8728526.0,3218785.0,5509740.0,304,52,252,8044,2955,5089,8628952.0,3124248.0,5504704.0,105.88,108.1,105.73,108.17
2023-11-07 17:10,76,38,38,3922,1977,1945,4180421.0,2085233.0,2095188.0,68,35,33,4059,2230,1829,4345680.0,2360679.0,1985001.0,105.47,107.72,105.86,108.53
2023-11-07 17:15,171,82,89,8346,4008,4338,8950781.0,4239767.0,4711013.0,160,73,87,8239,3907,4332,8834042.0,4130523.0,4703519.0,105.78,108.6,105.72,108.58
2023-11-07 17:20,336,159,177,12363,5621,6742,13258442.0,5955296.0,7303146.0,324,151,173,12589,6126,6463,13489774.0,6476225.0,7013549.0,105.95,108.32,105.72,108.52
2023-11-07 17:25,95,46,49,2498,985,1513,2692026.0,1051778.0,1640248.0,88,40,48,2487,950,1537,2675761.0,1011436.0,1664325.0,106.78,108.41,106.47,108.28
2023-11-07 17:30,147,74,73,4782,2151,2631,5146078.0,2280234.0,2865843.0,112,55,57,4973,2125,2848,5355550.0,2252200.0,3103350.0,106.01,108.93,105.99,108.97
2023-11-07 17:35,167,104,63,4728,2343,2385,5091924.0,2505765.0,2586159.0,154,96,58,5365,3288,2077,5753245.0,3501393.0,2251852.0,106.95,108.43,106.49,108.42
2023-11-07 17:40,337,81,256,8791,3293,5498,9428076.0,3494698.0,5933377.0,320,70,250,8715,3244,5471,9346960.0,3442079.0,5904881.0,106.13,107.92,106.11,107.93
2023-11-07 17:45,140,71,69,7990,3621,4369,8569970.0,3830359.0,4739611.0,125,61,64,7884,3642,4242,8456363.0,3852317.0,4604045.0,105.78,108.48,105.77,108.53
2023-11-07 17:50,283,43,240,7603,2360,5243,8159335.0,2497109.0,5662225.0,267,30,237,7692,2331,5361,8250312.0,2455513.0,5794799.0,105.81,108.0,105.34,108.09
2023-11-07 17:55,107,54,53,7250,3470,3780,7780823.0,3669651.0,4111171.0,103,52,51,7079,3469,3610,7586582.0,3666651.0,3919931.0,105.75,108.76,105.7,108.59
2023-11-07 18:00,275,127,148,16324,7962,8362,17531480.0,8457427.0,9074052.0,258,115,143,16052,7776,8276,17212328.0,8230214.0,8982114.0,106.22,108.52,105.84,108.53
2023-11-07 18:05,165,74,91,11918,5647,6271,12752707.0,5986004.0,6766703.0,148,59,89,11819,5429,6390,12680091.0,5741416.0,6938675.0,106.0,107.9,105.75,108.59
2023-11-07 18:10,494,62,432,20634,4870,15764,22116133.0,5155237.0,16960896.0,489,56,433,20060,4072,15988,21508548.0,4302117.0,17206430.0,105.86,107.59,105.65,107.62
2023-11-07 18:15,43,23,20,3232,1689,1543,3448315.0,1787798.0,1660516.0,34,20,14,3211,1690,1521,3441909.0,1788705.0,1653203.0,105.85,107.62,105.84,108.69
2023-11-07 18:20,64,29,35,3881,1400,2481,4158414.0,1481107.0,2677307.0,56,24,32,3910,1374,2536,4244256.0,1452828.0,2791428.0,105.79,107.91,105.74,110.07
2023-11-07 18:25,340,268,72,10377,5827,4550,11115206.0,6204437.0,4910768.0,313,253,60,9716,5502,4214,10421224.0,5850646.0,4570578.0,106.48,107.93,106.34,108.46
2023-11-07 18:30,308,271,37,5881,4985,896,6304745.0,5339268.0,965476.0,296,264,32,6175,5139,1036,6616644.0,5499600.0,1117044.0,107.11,107.75,107.02,107.82
2023-11-07 18:35,1024,161,863,31521,5271,26250,33647518.0,5637798.0,28009720.0,986,138,848,26617,3429,23188,28502453.0,3659055.0,24843398.0,106.96,106.7,106.71,107.14
2023-11-08 10:00,1845,926,919,41870,11928,29942,47631588.0,12643381.0,34988207.0,1260,802,458,22060,10625,11435,23663970.0,11347064.0,12316905.0,106.0,116.85,106.8,107.71
2023-11-08 10:05,1076,479,597,19118,6766,12352,20416948.0,7171437.0,13245511.0,971,421,550,15576,5112,10464,16652690.0,5436335.0,11216355.0,105.99,107.23,106.34,107.19
2023-11-08 10:10,1191,887,304,27231,21077,6154,29308943.0,22463147.0,6845796.0,1123,848,275,24100,20197,3903,25717096.0,21527156.0,4189939.0,106.58,111.24,106.59,107.35
2023-11-08 10:15,855,503,352,17662,9223,8439,18927321.0,9777861.0,9149459.0,642,343,299,16601,8376,8225,17767872.0,8893125.0,8874747.0,106.02,108.42,106.17,107.9
2023-11-08 10:20,728,318,410,29491,13654,15837,31580792.0,14403713.0,17177079.0,595,293,302,26771,13498,13273,28578821.0,14248876.0,14329945.0,105.49,108.46,105.56,107.96
2023-11-08 10:25,1091,456,635,58464,23953,34511,83834955.0,25222428.0,58612527.0,1000,402,598,56664,23334,33330,60448910.0,24543235.0,35905675.0,105.3,169.84,105.18,107.73
2023-11-08 10:30,1362,571,791,69121,27501,41620,73733028.0,28852375.0,44880653.0,1274,513,761,67307,27169,40138,71640246.0,28502939.0,43137306.0,104.91,107.83,104.91,107.47
2023-11-08 10:35,428,215,213,20097,7652,12445,21385727.0,8008210.0,13377516.0,380,174,206,19672,7348,12324,20947517.0,7710454.0,13237063.0,104.66,107.49,104.93,107.41
2023-11-08 10:40,178,82,96,6973,2154,4819,7405152.0,2266669.0,5138483.0,133,48,85,6110,1706,4404,6511685.0,1791348.0,4720336.0,105.23,106.63,105.0,107.18
2023-11-08 10:45,520,228,292,23488,11743,11745,24970424.0,12344366.0,12626058.0,476,201,275,22967,11362,11605,24412985.0,11937859.0,12475125.0,105.12,107.5,105.07,107.5
2023-11-08 10:50,1106,547,559,56203,25683,30520,59433492.0,26932051.0,32501440.0,1008,485,523,53427,24146,29281,56727859.0,25309109.0,31418750.0,104.86,106.49,104.82,107.3
2023-11-08 10:55,825,354,471,47960,22309,25651,50943191.0,23392686.0,27550504.0,761,323,438,47228,21884,25344,50163336.0,22940577.0,27222758.0,104.86,107.41,104.83,107.41
2023-11-08 11:00,123,94,29,4756,3491,1265,5072015.0,3697102.0,1374913.0,90,66,24,3906,3126,780,4146966.0,3308002.0,838964.0,105.9,108.69,105.82,107.56
2023-11-08 11:05,138,83,55,5740,4397,1343,6106389.0,4667712.0,1438677.0,124,75,49,5625,4328,1297,5976436.0,4580203.0,1396233.0,106.16,107.12,105.83,107.65
2023-11-08 11:10,262,162,100,15544,9725,5819,16537786.0,10256525.0,6281260.0,243,144,99,15695,9603,6092,16698899.0,10124071.0,6574828.0,105.47,107.94,105.43,107.93
2023-11-08 11:15,430,357,73,16893,11807,5086,17981292.0,12491334.0,5489958.0,401,337,64,16729,11753,4976,17802263.0,12426942.0,5375320.0,105.8,107.94,105.73,108.02
2023-11-08 11:20,278,203,75,18425,9929,8496,19779939.0,10480642.0,9299296.0,264,197,67,15939,9937,6002,16968723.0,10482577.0,6486145.0,105.56,109.45,105.49,108.07
2023-11-08 11:25,1271,949,322,81421,52821,28600,87084548.0,56113440.0,30971107.0,1223,917,306,80923,52134,28789,86361144.0,55187420.0,31173724.0,106.23,108.29,105.86,108.28
2023-11-08 11:30,2048,1215,833,119963,72974,46989,128758078.0,77683940.0,51074138.0,1947,1178,769,115400,69419,45981,123654851.0,73673818.0,49981033.0,106.45,108.69,106.13,108.7
2023-11-08 11:35,1865,1392,473,104026,68458,35568,111553407.0,72838511.0,38714895.0,1774,1365,409,103898,68556,35342,111495076.0,72934215.0,38560860.0,106.4,108.85,106.39,109.11
2023-11-08 11:40,1375,892,483,69846,44722,25124,74830529.0,47532809.0,27297719.0,1337,873,464,69310,44612,24698,74255606.0,47408284.0,26847321.0,106.29,108.65,106.27,108.7
2023-11-08 11:45,1945,1726,219,98998,75100,23898,105962455.0,79951713.0,26010741.0,1917,1707,210,98995,74992,24003,105969724.0,79836011.0,26133713.0,106.46,108.84,106.46,108.88
2023-11-08 11:50,1541,1047,494,75877,53696,22181,81296955.0,57155897.0,24141058.0,1521,1039,482,74337,52663,21674,79625470.0,56038502.0,23586968.0,106.44,108.84,106.41,108.83
2023-11-08 11:55,1593,1348,245,83418,50342,33076,89310770.0,53407646.0,35903124.0,1563,1330,233,83253,50337,32916,89188904.0,53398797.0,35790107.0,106.09,108.55,106.08,108.73
2023-11-08 12:00,2388,1467,921,137142,68197,68945,146831492.0,72209824.0,74621667.0,2346,1445,901,136307,67971,68336,145943444.0,71967321.0,73976122.0,105.88,108.23,105.88,108.25
2023-11-08 12:05,958,559,399,52448,26286,26162,56310745.0,28023225.0,28287520.0,897,524,373,51963,26178,25785,55599219.0,27715904.0,27883314.0,106.61,108.12,105.87,108.14
2023-11-08 12:10,1436,1332,104,89363,77512,11851,95571008.0,82682641.0,12888367.0,1424,1327,97,88031,76264,11767,94164808.0,81353738.0,12811069.0,106.67,108.75,106.67,108.87
2023-11-08 12:15,1662,1560,102,82994,71725,11269,88766500.0,76499077.0,12267423.0,1653,1557,96,83198,71947,11251,88989726.0,76738577.0,12251148.0,106.66,108.86,106.66,108.89
2023-11-08 12:20,2069,1341,728,123281,72927,50354,131719042.0,77201517.0,54517525.0,1952,1283,669,122345,73051,49294,131042980.0,77539514.0,53503465.0,105.86,108.27,106.14,108.54
2023-11-08 12:25,1754,1212,542,89931,47660,42271,96115909.0,50370288.0,45745620.0,1726,1199,527,89165,46757,42408,95306167.0,49413057.0,45893110.0,105.69,108.22,105.68,108.22
2023-11-08 12:30,878,645,233,43469,24281,19188,46481996.0,25679240.0,20802756.0,854,629,225,43317,24137,19180,46304425.0,25510628.0,20793797.0,105.76,108.42,105.69,108.41
2023-11-08 12:35,880,568,312,49847,27528,22319,53029858.0,28854677.0,24175180.0,844,549,295,49344,27266,22078,52755754.0,28839717.0,23916037.0,104.82,108.32,105.77,108.33
2023-11-08 12:40,1036,684,352,70473,37931,32542,75333334.0,40061697.0,35271636.0,1028,684,344,71037,38332,32705,75927316.0,40476783.0,35450533.0,105.62,108.39,105.6,108.39
2023-11-08 12:45,1236,499,737,47644,16002,31642,51044277.0,16914650.0,34129627.0,1231,496,735,47215,15774,31441,50579668.0,16668390.0,33911278.0,105.7,107.86,105.67,107.86
2023-11-08 12:50,1401,487,914,62486,23177,39309,66928342.0,24481999.0,42446343.0,1386,480,906,62363,23118,39245,66796225.0,24419050.0,42377175.0,105.63,107.98,105.63,107.98
2023-11-08 12:55,973,188,785,44413,11688,32725,47655509.0,12356522.0,35298986.0,968,184,784,44968,12050,32918,48246526.0,12738925.0,35507601.0,105.72,107.87,105.72,107.87
2023-11-08 13:00,1536,987,549,61303,31856,29447,65615936.0,33712433.0,31903502.0,1523,978,545,61238,31810,29428,65543789.0,33660340.0,31883449.0,105.83,108.34,105.82,108.34
2023-11-08 13:05,1401,708,693,70545,37397,33148,76009118.0,40084737.0,35924380.0,1406,718,688,70766,37579,33187,75714099.0,39740448.0,35973651.0,107.19,108.38,105.75,108.4
2023-11-08 13:10,676,209,467,23123,10649,12474,24737356.0,11242737.0,13494618.0,674,212,462,23215,10851,12364,24835939.0,11458334.0,13377605.0,105.58,108.18,105.6,108.2
2023-11-08 13:15,101,34,67,2668,1554,1114,2840344.0,1637327.0,1203017.0,95,29,66,2311,1297,1014,2463409.0,1366914.0,1096495.0,105.36,107.99,105.39,108.14
2023-11-08 13:20,256,77,179,8206,3262,4944,8779240.0,3450320.0,5328920.0,244,70,174,8177,3187,4990,8748797.0,3368097.0,5380700.0,105.77,107.79,105.68,107.83
2023-11-08 13:25,458,243,215,25414,12459,12955,27154963.0,13159217.0,13995745.0,443,234,209,25200,12419,12781,26947431.0,13116358.0,13831072.0,105.62,108.03,105.62,108.22
2023-11-08 13:30,530,236,294,29779,14663,15116,31849965.0,15477544.0,16372420.0,526,235,291,29769,14663,15106,31839122.0,15477532.0,16361589.0,105.56,108.31,105.56,108.31
2023-11-08 13:35,1070,575,495,57354,23352,34002,61100122.0,24606041.0,36494081.0,1035,551,484,56260,23136,33124,60112318.0,24371418.0,35740899.0,105.37,107.33,105.34,107.9
2023-11-08 13:40,376,167,209,26309,10997,15312,28095866.0,11577413.0,16518453.0,356,161,195,26587,11245,15342,28376054.0,11828695.0,16547359.0,105.28,107.88,105.19,107.86
2023-11-08 13:45,206,69,137,13413,4956,8457,14321069.0,5215056.0,9106012.0,197,63,134,13340,4807,8533,14247611.0,5059839.0,9187771.0,105.23,107.67,105.26,107.67
2023-11-08 13:50,314,255,59,3612,881,2731,3861593.0,935358.0,2926234.0,317,259,58,3637,914,2723,3888077.0,970476.0,2917601.0,106.17,107.15,106.18,107.15
2023-11-08 13:55,522,163,359,34265,12479,21786,36555925.0,13110365.0,23445559.0,502,148,354,34022,12367,21655,36300278.0,12992874.0,23307403.0,105.06,107.62,105.06,107.63
2023-11-08 14:00,628,341,287,28642,9842,18800,30516495.0,10335536.0,20180959.0,611,333,278,26099,9830,16269,27806425.0,10321454.0,17484970.0,105.01,107.35,105.0,107.47
2023-11-08 14:05,286,53,233,4685,2226,2459,4982623.0,2347476.0,2635147.0,271,44,227,3589,1198,2391,3820696.0,1257987.0,2562709.0,105.46,107.16,105.01,107.18
2023-11-08 14:10,507,242,265,7965,3326,4639,8495878.0,3518593.0,4977284.0,495,233,262,7891,3206,4685,8411371.0,3377366.0,5034005.0,105.79,107.29,105.35,107.45
2023-11-08 14:15,482,246,236,7674,3320,4354,8131538.0,3492722.0,4638815.0,467,236,231,7447,3292,4155,7924910.0,3465026.0,4459884.0,105.2,106.54,105.26,107.34
2023-11-08 14:20,506,253,253,19564,8309,11255,20816670.0,8726613.0,12090056.0,490,245,245,20128,8947,11181,21385033.0,9370407.0,12014626.0,105.03,107.42,104.73,107.46
2023-11-08 14:25,848,492,356,36944,16405,20539,39073045.0,17197733.0,21875311.0,771,451,320,36691,16768,19923,38808354.0,17345121.0,21463233.0,104.83,106.51,103.44,107.73
2023-11-08 14:30,287,96,191,15249,5797,9452,16201859.0,6070609.0,10131249.0,230,60,170,14896,5597,9299,15569330.0,5612200.0,9957129.0,104.72,107.19,100.27,107.08
2023-11-08 14:35,374,260,114,11081,4674,6407,11759095.0,4900477.0,6858617.0,357,249,108,10786,4597,6189,11447562.0,4816552.0,6631009.0,104.85,107.05,104.78,107.14
2023-11-08 14:40,243,99,144,14613,6146,8467,15517013.0,6438406.0,9078607.0,220,85,135,14463,5980,8483,15358429.0,6260166.0,9098263.0,104.76,107.22,104.69,107.25
2023-11-08 14:45,374,182,192,18308,7757,10551,19411576.0,8123900.0,11287676.0,348,162,186,18554,7821,10733,19700046.0,8186013.0,11514033.0,104.73,106.98,104.67,107.28
2023-11-08 14:50,91,51,40,5978,2975,3003,6331962.0,3117494.0,3214467.0,82,47,35,6346,3608,2738,6733896.0,3787742.0,2946154.0,104.79,107.04,104.98,107.6
2023-11-08 14:55,376,127,249,23129,8926,14203,24540934.0,9339321.0,15201612.0,355,114,241,22953,8831,14122,24368462.0,9239339.0,15129123.0,104.63,107.03,104.62,107.13
2023-11-08 15:00,115,30,85,5493,1100,4393,5836424.0,1151001.0,4685422.0,109,26,83,5359,1092,4267,5693749.0,1141992.0,4551757.0,104.64,106.66,104.58,106.67
2023-11-08 15:05,150,51,99,6598,1011,5587,7016087.0,1063281.0,5952805.0,123,30,93,6733,1314,5419,7141570.0,1367725.0,5773845.0,105.17,106.55,104.09,106.55
2023-11-08 15:10,204,66,138,11661,3040,8621,12384900.0,3198308.0,9186592.0,178,48,130,11261,2784,8477,11963330.0,2911071.0,9052258.0,105.21,106.56,104.56,106.79
2023-11-08 15:15,247,94,153,14564,4219,10345,15493638.0,4439548.0,11054090.0,239,89,150,14431,4097,10334,15326694.0,4284776.0,11041918.0,105.23,106.85,104.58,106.85
2023-11-08 15:20,636,303,333,18080,6733,11347,19169398.0,7028744.0,12140653.0,617,286,331,16981,5656,11325,18036015.0,5918647.0,12117367.0,104.39,106.99,104.64,107.0
2023-11-08 15:25,337,136,201,23100,9187,13913,24528604.0,9612829.0,14915774.0,311,119,192,22680,8963,13717,24080389.0,9373407.0,14706982.0,104.64,107.21,104.58,107.22
2023-11-08 15:30,798,400,398,47226,21798,25428,50218521.0,22890963.0,27327557.0,727,348,379,46651,21284,25367,49568228.0,22304187.0,27264041.0,105.01,107.47,104.79,107.48
2023-11-08 15:35,500,353,147,26840,15085,11755,28588195.0,15900984.0,12687210.0,466,334,132,26521,14891,11630,28196305.0,15658414.0,12537891.0,105.41,107.93,105.15,107.81
2023-11-08 15:40,671,467,204,33221,21081,12140,35363454.0,22266337.0,13097117.0,642,451,191,32959,20960,11999,35056094.0,22109606.0,12946487.0,105.62,107.88,105.48,107.9
2023-11-08 15:45,950,436,514,47842,26279,21563,50831849.0,27673862.0,23157986.0,920,418,502,47391,26110,21281,50399589.0,27488563.0,22911026.0,105.31,107.4,105.28,107.66
2023-11-08 15:50,866,287,579,31425,12143,19282,33377927.0,12736621.0,20641305.0,840,271,569,30977,12010,18967,32933589.0,12596804.0,20336784.0,104.89,107.05,104.89,107.22
2023-11-08 15:55,287,105,182,15842,5512,10330,16850319.0,5794146.0,11056173.0,267,93,174,15680,5640,10040,16661467.0,5906531.0,10754935.0,105.12,107.03,104.73,107.12
2023-11-08 16:00,101,55,46,4187,1984,2203,4362392.0,2078682.0,2283709.0,71,31,40,3499,1571,1928,3712970.0,1642413.0,2070557.0,104.77,103.66,104.55,107.39
2023-11-08 16:05,169,46,123,8160,3081,5079,8655525.0,3220671.0,5434854.0,165,40,125,8168,3077,5091,8663802.0,3216184.0,5447617.0,104.53,107.01,104.52,107.0
2023-11-08 16:10,213,56,157,9199,4098,5101,9755873.0,4302269.0,5453604.0,196,48,148,8543,3995,4548,9053782.0,4187290.0,4866492.0,104.98,106.91,104.81,107.0
2023-11-08 16:15,160,86,74,3450,1608,1842,3659231.0,1689242.0,1969988.0,143,72,71,3489,1557,1932,3702575.0,1634297.0,2068278.0,105.05,106.95,104.96,107.05
2023-11-08 16:20,314,262,52,5516,3377,2139,5868578.0,3566986.0,2301591.0,287,243,44,5171,3216,1955,5480250.0,3382120.0,2098129.0,105.63,107.6,105.17,107.32
2023-11-08 16:25,76,47,29,3545,2031,1514,3754543.0,2128866.0,1625677.0,71,43,28,3816,2313,1503,4027214.0,2413055.0,1614159.0,104.82,107.38,104.33,107.4
2023-11-08 16:30,224,136,88,9071,4606,4465,9640635.0,4836707.0,4803928.0,193,120,73,8772,4488,4284,9305709.0,4707201.0,4598508.0,105.01,107.59,104.88,107.34
2023-11-08 16:35,99,61,38,3039,1462,1577,3224513.0,1534781.0,1689732.0,79,45,34,3013,1511,1502,3193229.0,1582947.0,1610281.0,104.98,107.15,104.76,107.21
2023-11-08 16:40,80,48,32,3532,1894,1638,3741853.0,1986209.0,1755644.0,67,40,27,3270,1671,1599,3468639.0,1749266.0,1719372.0,104.87,107.18,104.68,107.53
2023-11-08 16:45,34,20,14,238,164,74,248516.0,169585.0,78931.0,17,9,8,90,75,15,93655.0,77344.0,16311.0,103.41,106.66,103.13,108.74
2023-11-08 16:50,511,389,122,23459,13471,9988,24971413.0,14220159.0,10751254.0,493,375,118,22652,12976,9676,24056681.0,13642100.0,10414581.0,105.56,107.64,105.13,107.63
2023-11-08 16:55,560,169,391,24984,10725,14259,26510188.0,11240498.0,15269690.0,549,166,383,25218,11107,14111,26774481.0,11642529.0,15131951.0,104.81,107.09,104.82,107.24
2023-11-08 17:00,633,178,455,25998,7354,18644,27513298.0,7692696.0,19820602.0,549,126,423,22531,7327,15204,23846701.0,7640252.0,16206449.0,104.61,106.31,104.28,106.59
2023-11-08 17:05,1268,729,539,57988,31448,26540,61223798.0,32883054.0,28340743.0,1163,641,522,57673,28993,28680,60984094.0,30364639.0,30619454.0,104.56,106.79,104.73,106.76
2023-11-08 17:10,952,450,502,45534,21619,23915,47746875.0,22612560.0,25134314.0,901,419,482,44192,20952,23240,46738058.0,21896981.0,24841077.0,104.6,105.1,104.51,106.89
2023-11-08 17:15,636,352,284,22080,8507,13573,23356397.0,8897403.0,14458993.0,590,319,271,21473,7874,13599,22721168.0,8238220.0,14482948.0,104.59,106.53,104.63,106.5
2023-11-08 17:20,328,113,215,14471,4873,9598,15304475.0,5084120.0,10220355.0,310,98,212,14182,4603,9579,14996744.0,4797870.0,10198873.0,104.33,106.48,104.23,106.47
2023-11-08 17:25,217,95,122,11409,4415,6994,12073139.0,4610965.0,7462174.0,197,79,118,10851,4066,6785,11481562.0,4242721.0,7238840.0,104.44,106.69,104.35,106.69
2023-11-08 17:30,170,52,118,9184,2856,6328,9722579.0,2981691.0,6740888.0,162,46,116,9202,2907,6295,9740600.0,3033752.0,6706848.0,104.4,106.52,104.36,106.54
2023-11-08 17:35,432,66,366,7545,1504,6041,7970796.0,1571227.0,6399569.0,400,43,357,7405,1413,5992,7831586.0,1478178.0,6353408.0,104.47,105.94,104.61,106.03
2023-11-08 17:40,474,151,323,20677,8321,12356,21840768.0,8674403.0,13166364.0,450,131,319,20160,7831,12329,21299961.0,8160448.0,13139512.0,104.25,106.56,104.21,106.57
2023-11-08 17:45,378,88,290,15215,4836,10379,16084148.0,5041315.0,11042832.0,363,76,287,15108,4801,10307,15979742.0,5002268.0,10977473.0,104.25,106.4,104.19,106.51
2023-11-08 17:50,195,56,139,11340,3167,8173,11998463.0,3302498.0,8695964.0,191,54,137,11223,3125,8098,11873016.0,3256099.0,8616916.0,104.28,106.4,104.2,106.41
2023-11-08 17:55,434,152,282,21949,7175,14774,23211609.0,7481927.0,15729681.0,408,134,274,21378,7109,14269,22614372.0,7407647.0,15206724.0,104.28,106.47,104.2,106.57
2023-11-08 18:00,91,46,45,3293,995,2298,3502281.0,1059489.0,2442792.0,69,26,43,3005,718,2287,3181530.0,747532.0,2433998.0,106.48,106.3,104.11,106.43
2023-11-08 18:05,263,82,181,12810,3364,9446,13565509.0,3515925.0,10049583.0,244,68,176,12638,3218,9420,13379517.0,3354546.0,10024970.0,104.52,106.39,104.24,106.42
2023-11-08 18:10,170,78,92,7070,2596,4474,7479693.0,2711651.0,4768042.0,163,73,90,7215,2783,4432,7628834.0,2905622.0,4723212.0,104.45,106.57,104.41,106.57
2023-11-08 18:15,476,195,281,18021,5103,12918,19074321.0,5328615.0,13745705.0,454,176,278,18067,4864,13203,40542924.0,5073250.0,35469673.0,104.42,106.41,104.3,268.65
2023-11-08 18:20,495,140,355,33850,12194,21656,35773977.0,12692299.0,23081677.0,493,137,356,33539,12250,21289,35446838.0,12751060.0,22695777.0,104.09,106.58,104.09,106.61
2023-11-08 18:25,716,219,497,33192,10405,22787,35073638.0,10832924.0,24240714.0,687,200,487,32836,10407,22429,34710465.0,10833464.0,23877001.0,104.11,106.38,104.1,106.46
2023-11-08 18:30,979,141,838,39479,8890,30589,41725933.0,9276449.0,32449483.0,950,116,834,40088,9699,30389,42267081.0,9999338.0,32267742.0,104.35,106.08,103.1,106.18
2023-11-08 18:35,770,408,362,40311,20627,19684,42732348.0,21671362.0,21060985.0,720,394,326,39665,20250,19415,42075962.0,21245901.0,20830061.0,105.06,107.0,104.92,107.29
2023-11-09 10:00,2693,1368,1325,67786,42946,24840,74950574.0,45492753.0,29457821.0,2090,1235,855,47612,41542,6070,50640434.0,44133196.0,6507237.0,105.93,118.59,106.24,107.2
2023-11-09 10:05,1476,1023,453,35992,29523,6469,38390854.0,31318074.0,7072780.0,1417,1005,412,32760,29097,3663,34799020.0,30879190.0,3919830.0,106.08,109.33,106.12,107.01
2023-11-09 10:10,1136,631,505,27756,18437,9319,29305353.0,19445546.0,9859806.0,1068,588,480,25290,17095,8195,26819520.0,18101108.0,8718412.0,105.47,105.8,105.89,106.39
2023-11-09 10:15,778,589,189,29380,17621,11759,31033420.0,18463696.0,12569723.0,657,505,152,28311,16712,11599,30156807.0,17522418.0,12634388.0,104.78,106.89,104.85,108.93
2023-11-09 10:20,1627,616,1011,62208,23686,38522,65003245.0,24600226.0,40403019.0,1241,387,854,57543,21627,35916,60547618.0,22464009.0,38083609.0,103.86,104.88,103.87,106.04
2023-11-09 10:25,1378,583,795,42646,15171,27475,44912967.0,15791275.0,29121691.0,1282,532,750,40840,14044,26796,43009198.0,14612057.0,28397141.0,104.09,105.99,104.04,105.98
2023-11-09 10:30,1153,712,441,39330,19742,19588,41402034.0,20614815.0,20787219.0,1080,667,413,38369,19260,19109,40421402.0,20093279.0,20328123.0,104.42,106.12,104.33,106.38
2023-11-09 10:35,1478,567,911,60803,22286,38517,63994601.0,23146585.0,40848015.0,1410,513,897,59859,21866,37993,63033224.0,22699627.0,40333597.0,103.86,106.05,103.81,106.16
2023-11-09 10:40,1038,370,668,50545,18415,32130,53205371.0,19121751.0,34083620.0,993,335,658,48973,16869,32104,51555196.0,17502187.0,34053008.0,103.84,106.08,103.75,106.07
2023-11-09 10:45,994,396,598,61233,25817,35416,64247943.0,26617634.0,37630309.0,953,367,586,56233,21065,35168,59242929.0,21873282.0,37369647.0,103.1,106.25,103.84,106.26
2023-11-09 10:50,651,195,456,23873,6555,17318,25156940.0,6813179.0,18343760.0,611,167,444,22883,5957,16926,24115200.0,6187657.0,17927543.0,103.94,105.92,103.87,105.92
2023-11-09 10:55,414,150,264,19809,6142,13667,20750369.0,6270790.0,14479579.0,397,141,256,17856,4016,13840,18850151.0,4169806.0,14680344.0,102.1,105.95,103.83,106.07
2023-11-09 11:00,736,346,390,39290,14771,24519,41421078.0,15358360.0,26062717.0,707,327,380,39433,14998,24435,41547373.0,15575231.0,25972142.0,103.98,106.3,103.85,106.29
2023-11-09 11:05,2664,1638,1026,163443,95123,68320,174611429.0,101220897.0,73390532.0,2248,1425,823,149057,85669,63388,158431394.0,90285023.0,68146370.0,106.41,107.42,105.39,107.51
2023-11-09 11:10,1023,723,300,62030,30239,31791,66546769.0,32114054.0,34432715.0,887,679,208,54753,26632,28121,58630462.0,28181438.0,30449024.0,106.2,108.31,105.82,108.28
2023-11-09 11:15,653,511,142,29613,20920,8693,31672937.0,22270375.0,9402561.0,568,478,90,29378,20810,8568,31421123.0,22113346.0,9307777.0,106.45,108.16,106.26,108.63
2023-11-09 11:20,580,437,143,26171,17846,8325,27948700.0,18972069.0,8976630.0,522,416,106,24303,17510,6793,25981192.0,18599130.0,7382062.0,106.31,107.83,106.22,108.67
2023-11-09 11:25,1284,934,350,62320,43123,19197,66645270.0,45853972.0,20791298.0,1205,905,300,61153,43115,18038,65331802.0,45773435.0,19558366.0,106.33,108.3,106.17,108.43
2023-11-09 11:30,3380,959,2421,187547,72570,114977,200242175.0,76640679.0,123601495.0,3324,924,2400,186723,71640,115083,199470822.0,75623537.0,123847284.0,105.61,107.5,105.56,107.62
2023-11-09 11:35,1352,437,915,47130,21355,25775,50479128.0,22655065.0,27824063.0,1300,421,879,47229,21755,25474,50536396.0,23033558.0,27502838.0,106.09,107.95,105.88,107.96
2023-11-09 11:40,620,262,358,27163,14571,12592,50375966.0,15464163.0,34911803.0,563,241,322,25861,13914,11947,27646921.0,14730799.0,12916122.0,106.13,277.25,105.87,108.11
2023-11-09 11:45,327,150,177,14735,7661,7074,15839237.0,8213105.0,7626131.0,290,138,152,13102,7173,5929,14001433.0,7598482.0,6402951.0,107.21,107.81,105.93,107.99
2023-11-09 11:50,1044,667,377,31088,18317,12771,33141471.0,19406794.0,13734677.0,1014,659,355,30777,18410,12367,32846776.0,19504531.0,13342244.0,105.95,107.55,105.95,107.89
2023-11-09 11:55,1242,601,641,54208,25231,28977,57872253.0,26606026.0,31266227.0,1227,594,633,54059,25189,28870,57698358.0,26562343.0,31136015.0,105.45,107.9,105.45,107.85
2023-11-09 12:00,1210,721,489,55164,32482,22682,59118055.0,34600008.0,24518046.0,1172,704,468,53508,31204,22304,57191118.0,33072623.0,24118495.0,106.52,108.09,105.99,108.14
2023-11-09 12:05,1594,826,768,69246,34749,34497,74069471.0,36810890.0,37258581.0,1548,797,751,68611,34581,34030,73348749.0,36573331.0,36775417.0,105.93,108.01,105.76,108.07
2023-11-09 12:10,1185,618,567,45207,26116,19091,48359466.0,27669196.0,20690270.0,1160,607,553,44931,26013,18918,48063932.0,27559248.0,20504683.0,105.95,108.38,105.94,108.39
2023-11-09 12:15,1075,856,219,50178,30141,20037,53752338.0,31995487.0,21756851.0,1041,842,199,47978,29389,18589,51319826.0,31139412.0,20180414.0,106.15,108.58,105.96,108.56
2023-11-09 12:20,958,680,278,49072,30193,18879,52514337.0,32018442.0,20495894.0,928,665,263,48547,29832,18715,51956774.0,31637636.0,20319137.0,106.05,108.56,106.05,108.57
2023-11-09 12:25,863,469,394,40492,24064,16428,43349139.0,25515268.0,17833870.0,851,462,389,40408,24141,16267,43251803.0,25593127.0,17658676.0,106.03,108.56,106.02,108.56
2023-11-09 12:30,979,612,367,32501,19289,13212,34827043.0,20493888.0,14333155.0,960,608,352,32145,19313,12832,34404683.0,20480194.0,13924488.0,106.25,108.49,106.04,108.51
2023-11-09 12:35,831,714,117,28668,19936,8732,30665207.0,21190006.0,9475201.0,810,705,105,27993,19841,8152,29942514.0,21087703.0,8854811.0,106.29,108.51,106.28,108.62
2023-11-09 12:40,514,468,46,25376,24390,986,27066341.0,25997997.0,1068344.0,510,462,48,25382,24447,935,27067347.0,26053711.0,1013636.0,106.59,108.35,106.57,108.41
2023-11-09 12:45,614,97,517,9255,5062,4193,9889880.0,5366632.0,4523248.0,609,96,513,9277,5077,4200,9908597.0,5378318.0,4530278.0,106.02,107.88,105.93,107.86
2023-11-09 12:50,300,182,118,17070,10026,7044,18267049.0,10618376.0,7648672.0,289,177,112,17094,10075,7019,18289517.0,10669277.0,7620240.0,105.91,108.58,105.9,108.57
2023-11-09 12:55,273,185,88,17228,9506,7722,18486819.0,10065792.0,8421027.0,278,192,86,16132,9545,6587,17264740.0,10107484.0,7157256.0,105.89,109.05,105.89,108.66
2023-11-09 13:00,1750,596,1154,67420,23458,43962,72066182.0,24839563.0,47226618.0,1728,586,1142,66530,23441,43089,71165003.0,24821855.0,46343148.0,105.89,107.43,105.89,107.55
2023-11-09 13:05,1465,590,875,60467,28687,31780,64569952.0,30311085.0,34258866.0,1453,582,871,59944,28222,31722,64016843.0,29818469.0,34198374.0,105.66,107.8,105.66,107.81
2023-11-09 13:10,1380,467,913,58898,24879,34019,62955088.0,26266622.0,36688466.0,1371,464,907,58276,24840,33436,62234433.0,26224941.0,36009492.0,105.58,107.85,105.58,107.7
2023-11-09 13:15,1315,630,685,55422,29844,25578,59220502.0,31608603.0,27611898.0,1307,626,681,55190,29791,25399,58942109.0,31524124.0,27417985.0,105.91,107.95,105.82,107.95
2023-11-09 13:20,1962,1386,576,103832,67778,36054,110879395.0,71858049.0,39021345.0,1958,1383,575,103800,67737,36063,110844691.0,71813375.0,39031315.0,106.02,108.23,106.02,108.23
2023-11-09 13:25,1889,1514,375,97487,66879,30608,104111181.0,70955623.0,33155558.0,1874,1507,367,97109,66731,30378,103705584.0,70795282.0,32910301.0,106.1,108.32,106.09,108.34
2023-11-09 13:30,982,480,502,55754,32018,23736,59515043.0,33907999.0,25607043.0,951,468,483,55396,31924,23472,59135744.0,33808645.0,25327099.0,105.9,107.88,105.9,107.9
2023-11-09 13:35,511,144,367,22339,6206,16133,23831099.0,6523259.0,17307839.0,490,135,355,22235,6197,16038,23730354.0,6509549.0,17220805.0,105.11,107.28,105.04,107.38
2023-11-09 13:40,191,26,165,9225,2422,6803,9843923.0,2542854.0,7301069.0,186,24,162,9294,2425,6869,9918428.0,2546026.0,7372402.0,104.99,107.32,104.99,107.33
2023-11-09 13:45,252,36,216,14191,2505,11686,15154044.0,2631676.0,12522367.0,255,36,219,14301,2517,11784,15270836.0,2642619.0,12628216.0,105.06,107.16,104.99,107.16
2023-11-09 13:50,538,155,383,12841,2357,10484,13715486.0,2483087.0,11232398.0,525,146,379,12504,2221,10283,13355324.0,2337739.0,11017585.0,105.35,107.14,105.26,107.14
2023-11-09 13:55,407,96,311,24277,7198,17079,25915303.0,7565313.0,18349989.0,379,83,296,24214,7188,17026,25845888.0,7552135.0,18293753.0,105.1,107.44,105.07,107.45
2023-11-09 14:00,648,120,528,27016,8748,18268,28855878.0,9211259.0,19644619.0,634,113,521,27140,8748,18392,28975100.0,9194818.0,19780282.0,105.3,107.54,105.11,107.55
2023-11-09 14:05,1285,243,1042,58479,19906,38573,62402894.0,20921262.0,41481631.0,1273,237,1036,57887,19586,38301,61771069.0,20582727.0,41188341.0,105.1,107.54,105.09,107.54
2023-11-09 14:10,1131,345,786,43610,14847,28763,46565551.0,15644279.0,30921272.0,1116,333,783,43403,14703,28700,46327606.0,15473793.0,30853813.0,105.37,107.5,105.24,107.5
2023-11-09 14:15,1771,1170,601,110973,65185,45788,118604653.0,69073909.0,49530744.0,1732,1153,579,109115,64787,44328,116602766.0,68641060.0,47961706.0,105.97,108.17,105.95,108.2
2023-11-09 14:20,2088,1567,521,112475,76043,36432,120256803.0,80697310.0,39559492.0,2074,1558,516,111356,74881,36475,119071953.0,79462795.0,39609157.0,106.12,108.58,106.12,108.59
2023-11-09 14:25,1561,1407,154,74562,49130,25432,79743717.0,52120535.0,27623182.0,1553,1405,148,74459,49214,25245,79630724.0,52209749.0,27420974.0,106.09,108.62,106.09,108.62
2023-11-09 14:30,878,724,154,38804,25445,13359,41501987.0,26996584.0,14505403.0,872,723,149,39821,26541,13280,42580005.0,28159198.0,14420807.0,106.1,108.58,106.1,108.59
2023-11-09 14:35,320,254,66,18370,12608,5762,19627238.0,13383472.0,6243765.0,307,248,59,18031,12294,5737,19295453.0,13056116.0,6239336.0,106.15,108.36,106.2,108.76
2023-11-09 14:40,2112,805,1307,95425,34905,60520,101881506.0,36845684.0,65035822.0,2103,802,1301,95090,34939,60151,101584686.0,36882695.0,64701991.0,105.56,107.46,105.56,107.57
2023-11-09 14:45,1935,651,1284,99637,33090,66547,106479827.0,34902020.0,71577806.0,1913,633,1280,99350,32827,66523,106173969.0,34620983.0,71552986.0,105.48,107.56,105.46,107.56
2023-11-09 14:50,676,185,491,32421,7238,25183,34672116.0,7636830.0,27035286.0,667,179,488,31998,6830,25168,34222072.0,7202126.0,27019946.0,105.51,107.36,105.45,107.36
2023-11-09 14:55,1507,359,1148,86244,28574,57670,92084834.0,30065696.0,62019138.0,1501,350,1151,86516,28489,58027,92391999.0,29972201.0,62419798.0,105.22,107.54,105.21,107.57
2023-11-09 15:00,2420,712,1708,119448,37808,81640,127532094.0,39799227.0,87732867.0,2395,703,1692,121244,39882,81362,129279431.0,41835573.0,87443858.0,105.27,107.46,104.9,107.48
2023-11-09 15:05,1696,344,1352,86783,25006,61777,92685096.0,26311278.0,66373818.0,1682,336,1346,86487,24778,61709,92384174.0,26066989.0,66317185.0,105.22,107.44,105.2,107.47
2023-11-09 15:10,880,31,849,32806,4231,28575,35058557.0,4447593.0,30610964.0,880,32,848,32804,4257,28547,35055971.0,4474736.0,30581235.0,105.12,107.12,105.11,107.13
2023-11-09 15:15,1082,215,867,29603,2059,27544,31638483.0,2175845.0,29462638.0,1075,209,866,29569,2030,27539,31602250.0,2145197.0,29457053.0,105.67,106.97,105.67,106.96
2023-11-09 15:20,517,18,499,23819,960,22859,25454681.0,1005646.0,24449034.0,511,14,497,23446,634,22812,25065210.0,666007.0,24399202.0,104.75,106.96,105.05,106.96
2023-11-09 15:25,681,23,658,25680,2052,23628,27444805.0,2157121.0,25287684.0,688,29,659,29909,6250,23659,31610088.0,6289223.0,25320864.0,105.12,107.02,100.63,107.02
2023-11-09 15:30,580,132,448,40384,14493,25891,43052533.0,15214996.0,27837537.0,577,130,447,38703,12775,25928,41311187.0,13430724.0,27880462.0,104.98,107.52,105.13,107.53
2023-11-09 15:35,2113,479,1634,97631,26651,70980,103710469.0,27940555.0,75769914.0,2077,453,1624,96591,26631,69960,102858290.0,27920817.0,74937473.0,104.84,106.75,104.84,107.11
2023-11-09 15:40,1498,655,843,77225,26910,50315,82134070.0,28201514.0,53932555.0,1472,640,832,76661,26661,50000,81555364.0,27940801.0,53614563.0,104.8,107.19,104.8,107.23
2023-11-09 15:45,1121,138,983,41304,9854,31450,43937252.0,10302128.0,33635123.0,1098,124,974,39177,7786,31391,41724453.0,8151904.0,33572548.0,104.55,106.95,104.7,106.95
2023-11-09 15:50,788,24,764,17415,708,16707,18577664.0,741808.0,17835855.0,790,26,764,17833,1043,16790,19017862.0,1093300.0,17924562.0,104.78,106.76,104.82,106.76
2023-11-09 15:55,1031,73,958,23052,1806,21246,24561371.0,1889803.0,22671568.0,1026,72,954,23299,2006,21293,24827779.0,2098940.0,22728838.0,104.64,106.71,104.63,106.74
2023-11-09 16:00,848,160,688,24111,3878,20233,25697482.0,4067871.0,21629611.0,836,150,686,24042,3822,20220,25620824.0,4005204.0,21615619.0,104.9,106.9,104.79,106.9
2023-11-09 16:05,177,46,131,7103,1170,5933,7569723.0,1230871.0,6338852.0,162,39,123,5310,1089,4221,5661223.0,1140234.0,4520989.0,105.2,106.84,104.7,107.11
2023-11-09 16:10,271,33,238,4340,1525,2815,4613032.0,1598382.0,3014649.0,260,22,238,3905,1249,2656,4150952.0,1306653.0,2844298.0,104.81,107.09,104.62,107.09
2023-11-09 16:15,1541,434,1107,53406,13955,39451,56784514.0,14640641.0,42143872.0,1480,398,1082,52727,13411,39316,56059147.0,14056843.0,42002303.0,104.91,106.83,104.82,106.83
2023-11-09 16:20,949,204,745,36641,13907,22734,38909063.0,14547104.0,24361959.0,935,197,738,36491,13858,22633,38747629.0,14494826.0,24252803.0,104.6,107.16,104.6,107.16
2023-11-09 16:25,482,96,386,24140,7868,16272,25688983.0,8237963.0,17451019.0,473,95,378,23532,7892,15640,25022542.0,8260689.0,16761852.0,104.7,107.25,104.67,107.17
2023-11-09 16:30,266,150,116,15812,7045,8767,16792975.0,7375888.0,9417087.0,266,150,116,15813,7048,8765,16792376.0,7377625.0,9414750.0,104.7,107.42,104.68,107.41
2023-11-09 16:35,399,269,130,17209,8147,9062,18326958.0,8597002.0,9729956.0,384,262,122,16892,7905,8987,17940659.0,8290068.0,9650590.0,105.52,107.37,104.87,107.38
2023-11-09 16:40,1319,993,326,72385,41946,30439,77023543.0,44261949.0,32761593.0,1290,978,312,71889,41566,30323,76438837.0,43798658.0,32640179.0,105.52,107.63,105.37,107.64
2023-11-09 16:45,848,589,259,19566,11221,8345,20794884.0,11809874.0,8985010.0,827,578,249,19402,11245,8157,20605390.0,11834185.0,8771205.0,105.25,107.67,105.24,107.53
2023-11-09 16:50,278,126,152,18071,8642,9429,19187997.0,9045567.0,10142429.0,265,119,146,18414,8826,9588,19566330.0,9237872.0,10328457.0,104.67,107.57,104.67,107.72
2023-11-09 16:55,193,76,117,12351,5147,7204,13121353.0,5386321.0,7735032.0,177,70,107,11798,4887,6911,12535437.0,5113422.0,7422015.0,104.65,107.37,104.63,107.39
2023-11-09 17:00,41,21,20,2559,1300,1259,2715477.0,1359954.0,1355522.0,39,20,19,2572,1314,1258,2728870.0,1374402.0,1354468.0,104.61,107.67,104.6,107.67
2023-11-09 17:05,139,70,69,7554,2847,4707,8019693.0,2984578.0,5035115.0,118,56,62,7047,2826,4221,7480582.0,2957431.0,4523151.0,104.83,106.97,104.65,107.16
2023-11-09 17:10,100,50,50,5947,2305,3642,6315173.0,2413373.0,3901800.0,96,47,49,6024,2384,3640,6394125.0,2494387.0,3899737.0,104.7,107.13,104.63,107.14
2023-11-09 17:15,248,151,97,16495,8556,7939,17495995.0,8964801.0,8531193.0,233,139,94,16297,8354,7943,17286404.0,8751201.0,8535202.0,104.78,107.46,104.75,107.46
2023-11-09 17:20,106,57,49,4169,1697,2472,4431234.0,1780541.0,2650693.0,103,55,48,3816,1392,2424,4055051.0,1457153.0,2597897.0,104.92,107.23,104.68,107.17
2023-11-09 17:25,107,54,53,7922,3874,4048,8409970.0,4061644.0,4348326.0,103,52,51,7225,3204,4021,7670699.0,3351104.0,4319594.0,104.84,107.42,104.59,107.43
2023-11-09 17:30,196,58,138,15651,5454,10197,16636944.0,5703556.0,10933388.0,198,60,138,16235,6038,10197,17255909.0,6322470.0,10933438.0,104.58,107.22,104.71,107.22
2023-11-09 17:35,109,43,66,6776,1898,4878,7210540.0,1987769.0,5222771.0,98,35,63,6504,1718,4786,6921353.0,1796925.0,5124427.0,104.73,107.07,104.59,107.07
2023-11-09 17:40,410,177,233,30371,12075,18296,32268607.0,12670424.0,19598183.0,402,175,227,30183,12058,18125,32066619.0,12625373.0,19441246.0,104.93,107.12,104.71,107.26
2023-11-09 17:45,970,713,257,32076,14430,17646,34086493.0,15159666.0,18926827.0,961,706,255,31891,14246,17645,33879810.0,14954063.0,18925747.0,105.06,107.26,104.97,107.26
2023-11-09 17:50,592,390,202,18674,8620,10054,19842119.0,9058450.0,10783668.0,584,384,200,18589,8522,10067,19748764.0,8950977.0,10797787.0,105.09,107.26,105.03,107.26
2023-11-09 17:55,627,337,290,33766,17854,15912,35873009.0,18762545.0,17110463.0,603,328,275,33577,17718,15859,35680641.0,18618701.0,17061940.0,105.09,107.53,105.08,107.59
2023-11-09 18:00,406,236,170,18732,10043,8689,19880594.0,10547042.0,9333552.0,400,234,166,18634,10034,8600,19788568.0,10537239.0,9251329.0,105.02,107.42,105.02,107.57
2023-11-09 18:05,1066,268,798,49999,18811,31188,53075660.0,19689791.0,33385869.0,1039,259,780,49363,18786,30577,52420706.0,19665013.0,32755693.0,104.67,107.05,104.68,107.13
2023-11-09 18:10,350,54,296,14399,4305,10094,15283279.0,4500154.0,10783125.0,340,49,291,14081,4277,9804,14947729.0,4470568.0,10477161.0,104.53,106.83,104.53,106.87
2023-11-09 18:15,721,230,491,22440,7597,14843,23813408.0,7950844.0,15862564.0,722,231,491,22832,7945,14887,24232981.0,8308701.0,15924280.0,104.66,106.87,104.58,106.97
2023-11-09 18:20,690,140,550,25401,9274,16127,26977042.0,9740564.0,17236478.0,682,136,546,24277,8241,16036,25783107.0,8643893.0,17139214.0,105.03,106.88,104.89,106.88
2023-11-09 18:25,510,105,405,13222,3361,9861,14045364.0,3530817.0,10514546.0,503,100,403,13444,3369,10075,14294997.0,3537581.0,10757415.0,105.05,106.63,105.0,106.77
2023-11-09 18:30,350,73,277,11906,2920,8986,12624429.0,3060545.0,9563884.0,337,68,269,12108,3214,8894,12867508.0,3369633.0,9497875.0,104.81,106.43,104.84,106.79
2023-11-09 18:35,186,26,160,5821,129,5692,6196748.0,136758.0,6059990.0,213,43,170,6080,387,5693,6472525.0,407000.0,6065525.0,106.01,106.47,105.17,106.54
2023-11-10 10:00,2168,447,1721,65741,5021,60720,72111301.0,5176380.0,66934921.0,1491,238,1253,44745,2013,42732,47400994.0,2109917.0,45291076.0,103.09,110.24,104.81,105.99
2023-11-10 10:05,1597,252,1345,56294,2225,54069,59666218.0,2318799.0,57347419.0,1468,192,1276,53527,1219,52308,56645983.0,1279001.0,55366982.0,104.22,106.06,104.92,105.85
2023-11-10 10:10,1073,249,824,32099,3973,28126,34073103.0,4147767.0,29925335.0,909,154,755,26833,2245,24588,28368942.0,2341810.0,26027131.0,104.4,106.4,104.31,105.85
2023-11-10 10:15,1264,472,792,46378,24295,22083,48678740.0,25251417.0,23427323.0,1134,379,755,43578,22047,21531,45775682.0,22878578.0,22897103.0,103.94,106.09,103.77,106.34
2023-11-10 10:20,1332,548,784,44170,17384,26786,46482721.0,18017147.0,28465574.0,1080,414,666,42763,16476,26287,44954291.0,17078876.0,27875414.0,103.64,106.27,103.66,106.04
2023-11-10 10:25,457,83,374,16964,3867,13097,17870806.0,4011782.0,13859023.0,424,64,360,16897,3791,13106,17841564.0,3927107.0,13914456.0,103.74,105.82,103.59,106.17
2023-11-10 10:30,1091,499,592,52434,19766,32668,54976311.0,20471205.0,34505105.0,1016,442,574,51961,20078,31883,54544194.0,20771295.0,33772898.0,103.57,105.62,103.45,105.93
2023-11-10 10:35,756,222,534,29419,12669,16750,30784780.0,13092393.0,17692386.0,682,170,512,28041,11519,16522,29402509.0,11909195.0,17493313.0,103.34,105.63,103.39,105.88
2023-11-10 10:40,725,318,407,39968,16005,23963,41868133.0,16546398.0,25321734.0,659,274,385,39818,16338,23480,41726452.0,16868413.0,24858039.0,103.38,105.67,103.25,105.87
2023-11-10 10:45,1045,521,524,35711,12418,23293,37304805.0,12830569.0,24474235.0,988,488,500,34547,11844,22703,36183938.0,12228448.0,23955489.0,103.32,105.07,103.25,105.52
2023-11-10 10:50,1860,1055,805,76939,43394,33545,78783983.0,44585218.0,34198765.0,1279,659,620,54419,30164,24255,56479585.0,30971864.0,25507721.0,102.75,101.95,102.68,105.16
2023-11-10 10:55,715,326,389,17033,9584,7449,17574622.0,9844251.0,7730370.0,542,221,321,16663,10118,6545,17210483.0,10367798.0,6842684.0,102.72,103.78,102.47,104.55
2023-11-10 11:00,683,291,392,13174,9856,3318,13671466.0,10197335.0,3474131.0,610,235,375,11933,8790,3143,12363613.0,9075750.0,3287863.0,103.46,104.71,103.25,104.61
2023-11-10 11:05,785,325,460,18310,9636,8674,18841473.0,9996029.0,8845443.0,729,293,436,17731,10877,6854,18367449.0,11200343.0,7167106.0,103.74,101.98,102.97,104.57
2023-11-10 11:10,675,474,201,21166,11110,10056,21953983.0,11426651.0,10527331.0,611,416,195,20108,10072,10036,20873224.0,10344668.0,10528555.0,102.85,104.69,102.71,104.91
2023-11-10 11:15,480,229,251,23616,9978,13638,24531541.0,10233275.0,14298266.0,388,175,213,22007,9533,12474,22850115.0,9760274.0,13089841.0,102.56,104.84,102.38,104.94
2023-11-10 11:20,1142,543,599,60603,29176,31427,62547820.0,29793013.0,32754807.0,984,434,550,54846,25817,29029,56703457.0,26353578.0,30349878.0,102.11,104.23,102.08,104.55
2023-11-10 11:25,1009,393,616,52241,19217,33024,53814534.0,19479212.0,34335321.0,890,303,587,51761,18527,33234,53360891.0,18785851.0,34575040.0,101.36,103.97,101.4,104.04
2023-11-10 11:30,818,324,494,39401,15502,23899,40657841.0,15774358.0,24883483.0,749,271,478,38898,14989,23909,40153654.0,15237328.0,24916325.0,101.76,104.12,101.66,104.21
2023-11-10 11:35,1164,833,331,43956,23761,20195,45297497.0,24236266.0,21061230.0,1115,796,319,42726,22790,19936,44061130.0,23266558.0,20794571.0,102.0,104.29,102.09,104.31
2023-11-10 11:40,1707,793,914,74818,29538,45280,76378913.0,29810589.0,46568324.0,1557,701,856,70232,27405,42827,72286570.0,27814325.0,44472245.0,100.92,102.85,101.49,103.84
2023-11-10 11:45,1346,726,620,67151,32622,34529,69022355.0,33163392.0,35858962.0,1242,666,576,66135,32261,33874,68003394.0,32772452.0,35230942.0,101.66,103.85,101.59,104.01
2023-11-10 11:50,1137,506,631,43787,17994,25793,44921905.0,18224486.0,26697418.0,1056,445,611,42486,17394,25092,43622197.0,17608613.0,26013584.0,101.28,103.51,101.23,103.67
2023-11-10 11:55,1210,476,734,59877,23585,36292,61345237.0,23836874.0,37508363.0,1117,409,708,58686,22778,35908,60188127.0,23011475.0,37176652.0,101.07,103.35,101.03,103.53
2023-11-10 12:00,582,213,369,38102,15693,22409,39092352.0,15897150.0,23195201.0,517,173,344,35919,14688,21231,36856755.0,14844602.0,22012153.0,101.3,103.51,101.07,103.68
2023-11-10 12:05,328,128,200,18942,8566,10376,19433554.0,8682750.0,10750804.0,289,101,188,20482,10232,10250,20959707.0,10342648.0,10617059.0,101.36,103.61,101.08,103.58
2023-11-10 12:10,182,96,86,10777,5446,5331,11101585.0,5534594.0,5566991.0,138,60,78,9944,5029,4915,10207961.0,5088572.0,5119389.0,101.63,104.43,101.18,104.16
2023-11-10 12:15,412,152,260,22604,11594,11010,23160981.0,11740302.0,11420679.0,397,113,284,21459,11032,10427,22016095.0,11179848.0,10836247.0,101.26,103.73,101.34,103.92
2023-11-10 12:20,246,93,153,14962,7230,7732,15315086.0,7322799.0,7992287.0,208,68,140,14708,7411,7297,15072748.0,7502039.0,7570708.0,101.28,103.37,101.23,103.75
2023-11-10 12:25,198,83,115,12845,6342,6503,13124066.0,6424746.0,6699319.0,155,54,101,11965,5678,6287,12300916.0,5741039.0,6559877.0,101.3,103.02,101.11,104.34
2023-11-10 12:30,406,253,153,19437,12452,6985,19896412.0,12669058.0,7227353.0,372,226,146,19267,12250,7017,19706968.0,12435082.0,7271886.0,101.74,103.47,101.51,103.63
2023-11-10 12:35,283,208,75,12809,9092,3717,13113190.0,9265268.0,3847922.0,265,194,71,13115,9063,4052,13420686.0,9227328.0,4193358.0,101.91,103.52,101.81,103.49
2023-11-10 12:40,1208,682,526,58507,24209,34298,59603898.0,24532916.0,35070982.0,1103,625,478,54287,23324,30963,55537378.0,23630482.0,31906896.0,101.34,102.25,101.31,103.05
2023-11-10 12:45,1123,556,567,50791,15935,34856,51795029.0,16012113.0,35782915.0,1041,499,542,49492,15342,34150,50528924.0,15418395.0,35110529.0,100.48,102.66,100.5,102.81
2023-11-10 12:50,1017,514,503,75271,24519,50752,81813055.0,24730159.0,57082896.0,819,386,433,51182,20695,30487,52109891.0,20767697.0,31342193.0,100.86,112.47,100.35,102.81
2023-11-10 12:55,1757,956,801,95902,36464,59438,97250748.0,36563438.0,60687309.0,1573,829,744,93351,34647,58704,94693513.0,34678723.0,60014790.0,100.27,102.1,100.09,102.23
2023-11-10 13:00,1304,657,647,51417,15451,35966,52238324.0,15506765.0,36731558.0,1231,604,627,50504,14766,35738,51346543.0,14812491.0,36534052.0,100.36,102.13,100.31,102.23
2023-11-10 13:05,2037,506,1531,138328,32259,106069,140788546.0,32341735.0,108446811.0,1982,467,1515,138264,31878,106386,140702766.0,31929123.0,108773642.0,100.26,102.24,100.16,102.24
2023-11-10 13:10,619,288,331,38542,15714,22828,39260210.0,15786577.0,23473633.0,581,262,319,38448,15704,22744,39154524.0,15763445.0,23391078.0,100.46,102.83,100.38,102.85
2023-11-10 13:15,1163,646,517,56047,25727,30320,57177250.0,25985476.0,31191774.0,1144,620,524,55621,25223,30398,56649872.0,25369392.0,31280479.0,101.0,102.88,100.58,102.9
2023-11-10 13:20,1294,312,982,99405,16884,82521,101453652.0,16963978.0,84489674.0,1245,278,967,98695,16474,82221,100744164.0,16537883.0,84206280.0,100.47,102.39,100.39,102.41
2023-11-10 13:25,2502,473,2029,167623,25797,141826,171161026.0,25911704.0,145249322.0,2428,426,2002,166071,24673,141398,169614646.0,24770755.0,144843891.0,100.44,102.41,100.4,102.44
2023-11-10 13:30,2788,707,2081,169248,31396,137852,172975761.0,31577246.0,141398515.0,2723,660,2063,168993,31052,137941,172720096.0,31214451.0,141505645.0,100.58,102.57,100.52,102.58
2023-11-10 13:35,2586,670,1916,174766,31838,142928,178396266.0,31973090.0,146423176.0,2513,634,1879,173311,31046,142265,176932246.0,31163900.0,145768346.0,100.42,102.45,100.38,102.46
2023-11-10 13:40,1241,775,466,64065,15174,48891,65497349.0,15300803.0,50196545.0,1211,757,454,64082,15261,48821,65493728.0,15372403.0,50121325.0,100.84,102.67,100.73,102.66
2023-11-10 13:45,967,495,472,47779,12207,35572,48789452.0,12274894.0,36514558.0,935,478,457,47605,12156,35449,48616565.0,12215369.0,36401196.0,100.56,102.65,100.49,102.69
2023-11-10 13:50,961,267,694,81153,16668,64485,82845357.0,16725730.0,66119627.0,944,259,685,80518,16351,64167,82214204.0,16404501.0,65809703.0,100.35,102.53,100.33,102.56
2023-11-10 13:55,1668,641,1027,94094,17027,77067,96275757.0,17149338.0,79126419.0,1627,615,1012,92668,15972,76696,94752000.0,16053731.0,78698268.0,100.72,102.67,100.51,102.61
2023-11-10 14:00,907,129,778,49665,12956,36709,50769737.0,13096633.0,37673104.0,883,111,772,44586,7940,36646,45611138.0,7990920.0,37620218.0,101.09,102.63,100.64,102.66
2023-11-10 14:05,1732,1357,375,101956,81753,20203,104040817.0,83123292.0,20917525.0,1667,1326,341,100801,81062,19739,102868407.0,82428868.0,20439538.0,101.68,103.54,101.69,103.55
2023-11-10 14:10,2276,677,1599,120950,38110,82840,123476176.0,38524486.0,84951690.0,2181,626,1555,117612,36635,80977,120302546.0,37011472.0,83291073.0,101.09,102.55,101.03,102.86
2023-11-10 14:15,2703,616,2087,144047,42348,101699,147252330.0,42761570.0,104490759.0,2661,587,2074,143872,42122,101750,147080193.0,42529617.0,104550576.0,100.98,102.75,100.97,102.75
2023-11-10 14:20,1891,507,1384,96934,36051,60883,99068263.0,36493644.0,62574619.0,1867,494,1373,97086,36309,60777,99222057.0,36752985.0,62469071.0,101.23,102.78,101.22,102.78
2023-11-10 14:25,3233,963,2270,202881,80536,122345,207375364.0,81355727.0,126019637.0,3206,942,2264,203121,80581,122540,207609488.0,81387429.0,126222059.0,101.02,103.0,101.0,103.0
2023-11-10 14:30,2429,611,1818,160228,58196,102032,163939621.0,58762591.0,105177029.0,2416,606,1810,159201,57377,101824,162883345.0,57922123.0,104961222.0,100.97,103.08,100.95,103.08
2023-11-10 14:35,1799,823,976,95139,44787,50352,97455986.0,45497193.0,51958792.0,1771,809,962,112492,44313,68179,120695168.0,45002532.0,75692636.0,101.59,103.19,101.56,111.02
2023-11-10 14:40,579,395,184,38074,25478,12596,38977258.0,25899770.0,13077487.0,558,383,175,36997,24812,12185,37873235.0,25214303.0,12658932.0,101.66,103.82,101.62,103.89
2023-11-10 14:45,65,37,28,2427,926,1501,2525686.0,937796.0,1587890.0,47,25,22,1813,919,894,1859527.0,929856.0,929671.0,101.27,105.79,101.18,103.99
2023-11-10 14:50,805,274,531,55617,24465,31152,57066383.0,24743237.0,32323146.0,791,261,530,55502,24189,31313,56984664.0,24456601.0,32528063.0,101.14,103.76,101.11,103.88
2023-11-10 14:55,723,386,337,41747,18545,23202,42860042.0,18787298.0,24072744.0,704,377,327,41992,18835,23157,43095720.0,19066792.0,24028927.0,101.31,103.75,101.23,103.77
2023-11-10 15:00,179,99,80,11986,5859,6127,12308216.0,5946082.0,6362133.0,162,91,71,11585,5554,6031,11887179.0,5624069.0,6263110.0,101.49,103.84,101.26,103.85
2023-11-10 15:05,303,195,108,22751,11618,11133,23367127.0,11782384.0,11584743.0,276,182,94,22090,11240,10850,22684972.0,11390787.0,11294185.0,101.41,104.06,101.34,104.09
2023-11-10 15:10,1104,690,414,68012,38168,29844,69763701.0,38801544.0,30962157.0,1063,672,391,67532,38056,29476,69316647.0,38685499.0,30631148.0,101.66,103.75,101.65,103.92
2023-11-10 15:15,570,211,359,39036,16026,23010,40069473.0,16202810.0,23866663.0,536,201,335,38811,15890,22921,39852518.0,16069398.0,23783120.0,101.1,103.72,101.13,103.76
2023-11-10 15:20,356,186,170,27851,12434,15417,28594655.0,12576429.0,16018225.0,343,179,164,28106,12750,15356,28850523.0,12893405.0,15957118.0,101.15,103.9,101.12,103.91
2023-11-10 15:25,561,346,215,31849,15327,16522,32682244.0,15515121.0,17167122.0,543,340,203,31592,15442,16150,32418353.0,15632566.0,16785786.0,101.23,103.9,101.23,103.94
2023-11-10 15:30,130,75,55,6013,2812,3201,6159777.0,2843294.0,3316483.0,117,67,50,13246,3143,10103,14926501.0,3180325.0,11746176.0,101.11,103.61,101.19,116.26
2023-11-10 15:35,722,610,112,26446,16483,9963,27230655.0,16879256.0,10351399.0,670,572,98,25544,15647,9897,26205580.0,15921844.0,10283736.0,102.4,103.9,101.76,103.91
2023-11-10 15:40,1077,895,182,59242,41585,17657,60775299.0,42394427.0,18380871.0,1033,865,168,58909,41383,17526,60413123.0,42167569.0,18245554.0,101.95,104.1,101.9,104.11
2023-11-10 15:45,264,217,47,14957,11075,3882,15338679.0,11294746.0,4043933.0,251,205,46,14954,11076,3878,15333424.0,11293773.0,4039651.0,101.98,104.17,101.97,104.17
2023-11-10 15:50,242,199,43,10486,7522,2964,10754925.0,7678727.0,3076198.0,229,196,33,11833,9212,2621,12087508.0,9357054.0,2730453.0,102.08,103.79,101.57,104.18
2023-11-10 15:55,478,404,74,22499,15637,6862,23097637.0,15963707.0,7133929.0,467,400,67,23085,15972,7113,23675926.0,16267675.0,7408250.0,102.09,103.96,101.85,104.15
2023-11-10 16:00,1345,1123,222,80506,53812,26694,82582737.0,54782478.0,27800259.0,1329,1114,215,80166,53702,26464,82228577.0,54667424.0,27561152.0,101.8,104.14,101.8,104.15
2023-11-10 16:05,974,650,324,48606,27484,21122,49887798.0,27969129.0,21918669.0,943,631,312,48676,27767,20909,49972644.0,28249336.0,21723308.0,101.77,103.77,101.74,103.89
2023-11-10 16:10,927,692,235,36259,21864,14395,37278068.0,22327105.0,14950963.0,916,688,228,35910,21458,14452,36887497.0,21877141.0,15010355.0,102.12,103.86,101.95,103.86
2023-11-10 16:15,104,63,41,6785,3277,3508,6979343.0,3321967.0,3657376.0,95,58,37,6569,3214,3355,6752071.0,3252829.0,3499241.0,101.37,104.26,101.21,104.3
2023-11-10 16:20,527,400,127,23791,15000,8791,24426567.0,15271464.0,9155103.0,502,385,117,23183,14512,8671,23805046.0,14771191.0,9033855.0,101.81,104.14,101.79,104.18
2023-11-10 16:25,158,76,82,13076,6537,6539,13458898.0,6631616.0,6827281.0,156,77,79,13745,7136,6609,14154964.0,7236406.0,6918557.0,101.45,104.41,101.41,104.68
2023-11-10 16:30,290,121,169,16030,8221,7809,16485461.0,8360638.0,8124823.0,276,113,163,20218,12723,7495,20707868.0,12909333.0,7798535.0,101.7,104.04,101.46,104.05
2023-11-10 16:35,554,431,123,35335,21214,14121,36355333.0,21618023.0,14737310.0,537,424,113,35000,21008,13992,36004769.0,21402530.0,14602239.0,101.9,104.36,101.88,104.36
2023-11-10 16:40,893,710,183,48319,36455,11864,49689859.0,37326464.0,12363394.0,874,702,172,48001,36239,11762,49365116.0,37104011.0,12261105.0,102.39,104.21,102.39,104.24
2023-11-10 16:45,988,479,509,41445,27578,13867,42732945.0,28250260.0,14482684.0,928,457,471,40091,26575,13516,41327513.0,27203451.0,14124062.0,102.44,104.44,102.36,104.5
2023-11-10 16:50,720,346,374,29885,22720,7165,30779255.0,23303722.0,7475533.0,686,326,360,29641,22530,7111,30548761.0,23107481.0,7441279.0,102.57,104.33,102.56,104.64
2023-11-10 16:55,1859,1480,379,109093,88737,20356,112287876.0,91044244.0,21243632.0,1838,1474,364,108895,88691,20204,112086634.0,90997466.0,21089168.0,102.6,104.36,102.6,104.38
2023-11-10 17:00,1638,1322,316,100250,75041,25209,103176389.0,76856446.0,26319942.0,1609,1301,308,99894,74814,25080,102814030.0,76621121.0,26192909.0,102.42,104.41,102.42,104.44
2023-11-10 17:05,490,125,365,19470,9767,9703,20103581.0,9971037.0,10132544.0,475,116,359,19330,9693,9637,19938470.0,9875174.0,10063296.0,102.09,104.43,101.88,104.42
2023-11-10 17:10,643,337,306,41689,21339,20350,43049585.0,21772583.0,21277001.0,618,318,300,41095,20767,20328,42454051.0,21184344.0,21269707.0,102.03,104.56,102.01,104.63
2023-11-10 17:15,510,275,235,19441,9477,9964,20090036.0,9672240.0,10417795.0,479,263,216,18879,9216,9663,19506426.0,9401992.0,10104434.0,102.06,104.55,102.02,104.57
2023-11-10 17:20,180,82,98,14507,6963,7544,15003835.0,7094223.0,7909611.0,165,71,94,14552,7004,7548,15048228.0,7134611.0,7913617.0,101.88,104.85,101.86,104.84
2023-11-10 17:25,1191,924,267,58346,43274,15072,60367923.0,44561461.0,15806462.0,1137,911,226,55992,41386,14606,57907111.0,42585660.0,15321450.0,102.98,104.87,102.9,104.9
2023-11-10 17:30,1686,1402,284,93601,75898,17703,96944953.0,78326428.0,18618524.0,1625,1381,244,92781,75678,17103,96079578.0,78082554.0,17997024.0,103.2,105.17,103.18,105.23
2023-11-10 17:35,1329,1050,279,91065,70006,21059,94301440.0,72145583.0,22155857.0,1285,1035,250,90628,69453,21175,93855382.0,71575056.0,22280326.0,103.06,105.21,103.06,105.22
2023-11-10 17:40,1709,687,1022,97066,54828,42238,100514905.0,56393336.0,44121569.0,1685,677,1008,96525,54750,41775,99987438.0,56310241.0,43677196.0,102.85,104.46,102.85,104.55
2023-11-10 17:45,1569,371,1198,80513,25044,55469,83487769.0,25592875.0,57894893.0,1542,353,1189,80098,24562,55536,83064812.0,25097168.0,57967643.0,102.19,104.37,102.18,104.38
2023-11-10 17:50,915,269,646,49943,19310,30633,51788827.0,19748207.0,32040619.0,886,251,635,47850,17262,30588,49645323.0,17650882.0,31994440.0,102.27,104.6,102.25,104.6
2023-11-10 17:55,1576,511,1065,82428,33201,49227,85501023.0,33968013.0,51533010.0,1556,500,1056,82295,33142,49153,85363457.0,33900256.0,51463200.0,102.31,104.68,102.29,104.7
2023-11-10 18:00,1042,342,700,57418,17015,40403,59599011.0,17408282.0,42190729.0,1022,335,687,57203,17045,40158,59383965.0,17438381.0,41945584.0,102.31,104.42,102.31,104.45
2023-11-10 18:05,678,104,574,39352,8305,31047,40860403.0,8490842.0,32369561.0,665,97,568,39006,8137,30869,40498612.0,8316416.0,32182196.0,102.24,104.26,102.2,104.25
2023-11-10 18:10,934,343,591,42804,12588,30216,44424660.0,12893632.0,31531028.0,906,333,573,42606,12577,30029,44245555.0,12880773.0,31364781.0,102.43,104.35,102.42,104.45
2023-11-10 18:15,391,131,260,25821,8237,17584,26801633.0,8426852.0,18374781.0,364,121,243,25411,8102,17309,26376995.0,8286832.0,18090162.0,102.3,104.5,102.28,104.51
2023-11-10 18:20,330,242,88,11917,5067,6850,12382992.0,5188017.0,7194975.0,317,238,79,11227,4961,6266,11648683.0,5077611.0,6571072.0,102.39,105.04,102.35,104.87
2023-11-10 18:25,959,599,360,50875,32856,18019,52873260.0,33945023.0,18928237.0,928,586,342,49085,32119,16966,50919464.0,33095469.0,17823995.0,103.31,105.05,103.04,105.06
2023-11-10 18:30,1148,189,959,19614,9044,10570,20349540.0,9320336.0,11029203.0,1124,180,944,19510,9373,10137,20245629.0,9652436.0,10593193.0,103.06,104.34,102.98,104.5
2023-11-10 18:35,428,203,225,5530,1483,4047,5701012.0,1532070.0,4168942.0,423,209,214,5140,1611,3529,5341316.0,1659480.0,3681835.0,103.31,103.01,103.01,104.33
2023-11-13 10:00,2381,857,1524,82086,36281,45805,86450764.0,37239720.0,49211044.0,1807,722,1085,68954,34307,34647,71335050.0,35283551.0,36051498.0,102.64,107.44,102.85,104.05
2023-11-13 10:05,1347,303,1044,32366,7766,24600,33410549.0,7905641.0,25504908.0,1250,234,1016,30773,6638,24135,31810112.0,6772262.0,25037849.0,101.8,103.68,102.02,103.74
2023-11-13 10:10,1334,535,799,44933,13219,31714,46374095.0,13506581.0,32867514.0,1259,485,774,42203,12097,30106,43570596.0,12378960.0,31191636.0,102.18,103.64,102.33,103.61
2023-11-13 10:15,1074,319,755,61000,21448,39552,63124676.0,21863578.0,41261097.0,1025,291,734,59605,21320,38285,61498444.0,21716490.0,39781953.0,101.94,104.32,101.86,103.91
2023-11-13 10:20,531,222,309,21179,10890,10289,21688689.0,10972498.0,10716190.0,481,190,291,19337,9223,10114,19932287.0,9405619.0,10526667.0,100.76,104.15,101.98,104.08
2023-11-13 10:25,886,444,442,40127,14475,25652,41679025.0,14807779.0,26871246.0,646,336,310,38137,14001,24136,39370254.0,14269276.0,25100978.0,102.3,104.75,101.92,104.0
2023-11-13 10:30,745,342,403,26253,9902,16351,27261266.0,10197795.0,17063471.0,703,321,382,25824,9692,16132,26711369.0,9892732.0,16818636.0,102.99,104.36,102.07,104.26
2023-11-13 10:35,713,265,448,28233,13459,14774,29285293.0,13816457.0,15468836.0,678,253,425,27749,13271,14478,28825681.0,13616950.0,15208730.0,102.66,104.7,102.61,105.05
2023-11-13 10:40,1330,993,337,74010,54055,19955,76580866.0,55659456.0,20921410.0,1271,977,294,72327,52777,19550,74863964.0,54328006.0,20535957.0,102.97,104.84,102.94,105.04
2023-11-13 10:45,274,121,153,19145,10412,8733,19809859.0,10651027.0,9158831.0,243,105,138,18863,10336,8527,19521085.0,10575471.0,8945614.0,102.3,104.88,102.32,104.91
2023-11-13 10:50,473,212,261,27090,15513,11577,28002254.0,15886067.0,12116187.0,466,207,259,27693,15765,11928,28622357.0,16135585.0,12486771.0,102.4,104.66,102.35,104.68
2023-11-13 10:55,310,122,188,23747,11645,12102,24550530.0,11899691.0,12650838.0,288,115,173,23591,11721,11870,24401225.0,11979215.0,12422009.0,102.19,104.54,102.2,104.65
2023-11-13 11:00,1032,587,445,45701,21163,24538,47248913.0,21625720.0,25623193.0,1017,576,441,44852,20367,24485,46400011.0,20817593.0,25582417.0,102.19,104.42,102.21,104.48
2023-11-13 11:05,775,319,456,47114,21652,25462,48745130.0,22146836.0,26598294.0,742,300,442,46142,21066,25076,47747164.0,21548155.0,26199009.0,102.29,104.46,102.29,104.48
2023-11-13 11:10,302,139,163,22137,11284,10853,22868389.0,11518721.0,11349668.0,264,118,146,21793,11071,10722,22506610.0,11284059.0,11222551.0,102.08,104.58,101.92,104.67
2023-11-13 11:15,577,126,451,31114,11151,19963,32189972.0,11360576.0,20829396.0,564,116,448,31079,11087,19992,32154572.0,11294659.0,20859913.0,101.88,104.34,101.87,104.34
2023-11-13 11:20,975,186,789,54311,16487,37824,55878712.0,16796226.0,39082486.0,928,160,768,52871,16233,36638,54623397.0,16536232.0,38087165.0,101.88,103.33,101.87,103.96
2023-11-13 11:25,1860,647,1213,86794,18085,68709,89683544.0,18391943.0,71291601.0,1818,621,1197,86533,18085,68448,89442353.0,18390400.0,71051953.0,101.7,103.76,101.69,103.8
2023-11-13 11:30,1301,275,1026,67152,11375,55777,69289679.0,11487678.0,57802000.0,1242,242,1000,67148,11489,55659,69322788.0,11637429.0,57685358.0,100.99,103.63,101.29,103.64
2023-11-13 11:35,1528,277,1251,66366,17010,49356,68221759.0,17182921.0,51038838.0,1497,260,1237,65738,16838,48900,67581353.0,17006965.0,50574388.0,101.02,103.41,101.0,103.42
2023-11-13 11:40,2198,442,1756,101965,23420,78545,104044098.0,23448046.0,80596052.0,1992,291,1701,95665,18789,76876,98039344.0,18873178.0,79166166.0,100.12,102.61,100.45,102.98
2023-11-13 11:45,1636,440,1196,91419,28218,63201,92856677.0,28175161.0,64681515.0,1537,378,1159,89235,26651,62584,90724851.0,26599503.0,64125347.0,99.85,102.34,99.81,102.46
2023-11-13 11:50,2231,400,1831,120120,27046,93074,121930836.0,26999178.0,94931658.0,2170,349,1821,119889,26788,93101,121729805.0,26723268.0,95006537.0,99.83,102.0,99.76,102.05
2023-11-13 11:55,1157,246,911,66099,18015,48084,67109438.0,17967970.0,49141468.0,1130,197,933,64247,16654,47593,65261923.0,16609577.0,48652346.0,99.74,102.2,99.73,102.23
2023-11-13 12:00,1348,401,947,85084,26771,58313,86674665.0,26858270.0,59816394.0,1282,370,912,85798,27385,58413,87357264.0,27412837.0,59944427.0,100.33,102.58,100.1,102.62
2023-11-13 12:05,856,439,417,53587,22258,31329,54896527.0,22481330.0,32415197.0,827,425,402,53759,22515,31244,55052858.0,22717508.0,32335349.0,101.0,103.47,100.9,103.49
2023-11-13 12:10,1248,440,808,56744,13153,43591,58166341.0,13281453.0,44884887.0,1234,433,801,57118,13689,43429,58549679.0,13808776.0,44740903.0,100.98,102.97,100.87,103.02
2023-11-13 12:15,1119,765,354,40326,10130,30196,41307141.0,10256522.0,31050619.0,1086,751,335,40434,10405,30029,41401083.0,10516963.0,30884119.0,101.25,102.83,101.08,102.85
2023-11-13 12:20,774,513,261,27305,6124,21181,27952979.0,6199293.0,21753686.0,762,510,252,27492,6352,21140,28136013.0,6410473.0,21725539.0,101.23,102.7,100.92,102.77
2023-11-13 12:25,669,397,272,35620,9554,26066,36443153.0,9645996.0,26797157.0,648,387,261,34636,8987,25649,35465286.0,9075687.0,26389599.0,100.96,102.81,100.99,102.89
2023-11-13 12:30,500,142,358,27228,4732,22496,27885290.0,4776076.0,23109214.0,483,130,353,26502,4098,22404,27137998.0,4129944.0,23008054.0,100.93,102.73,100.78,102.7
2023-11-13 12:35,204,95,109,12851,4884,7967,13155232.0,4927020.0,8228212.0,165,74,91,12350,4636,7714,12641023.0,4674671.0,7966351.0,100.88,103.28,100.83,103.27
2023-11-13 12:40,821,357,464,29673,8467,21206,30379122.0,8549018.0,21830103.0,797,351,446,28847,8364,20483,29514073.0,8446429.0,21067643.0,100.97,102.94,100.99,102.85
2023-11-13 12:45,1705,833,872,99707,35825,63882,101838685.0,36158907.0,65679777.0,1665,812,853,100426,36624,63802,102482403.0,36880688.0,65601714.0,100.93,102.81,100.7,102.82
2023-11-13 12:50,860,143,717,59654,13025,46629,60919391.0,13098442.0,47820949.0,829,125,704,59296,12888,46408,60558702.0,12957469.0,47601233.0,100.56,102.56,100.54,102.57
2023-11-13 12:55,504,107,397,31986,4596,27390,32650610.0,4620386.0,28030224.0,492,99,393,32037,4574,27463,32702129.0,4597133.0,28104996.0,100.53,102.34,100.51,102.34
2023-11-13 13:00,927,180,747,52160,13305,38855,52934804.0,13279141.0,39655662.0,831,116,715,50317,12220,38097,51152312.0,12198251.0,38954061.0,99.81,102.06,99.82,102.25
2023-11-13 13:05,740,107,633,44794,8857,35937,45558305.0,8843370.0,36714934.0,701,74,627,44133,8213,35920,44902406.0,8197677.0,36704728.0,99.85,102.16,99.81,102.18
2023-11-13 13:10,783,152,631,57441,10689,46752,58524638.0,10725126.0,47799512.0,751,138,613,57240,10731,46509,58286260.0,10737037.0,47549223.0,100.34,102.24,100.06,102.24
2023-11-13 13:15,1039,149,890,73925,14910,59015,75244879.0,14916308.0,60328571.0,1017,135,882,73342,14508,58834,74654291.0,14509216.0,60145075.0,100.04,102.23,100.01,102.23
2023-11-13 13:20,1002,146,856,66443,10080,56363,67698561.0,10112082.0,57586478.0,974,127,847,66109,9880,56229,67341419.0,9883898.0,57457520.0,100.32,102.17,100.04,102.18
2023-11-13 13:25,284,28,256,21400,2281,19119,21835896.0,2286967.0,19548929.0,272,20,252,21137,2067,19070,21567979.0,2069044.0,19498935.0,100.26,102.25,100.1,102.25
2023-11-13 13:30,767,134,633,62151,10308,51843,63392408.0,10329365.0,53063042.0,732,114,618,61946,10216,51730,63181270.0,10233801.0,52947469.0,100.21,102.35,100.17,102.35
2023-11-13 13:35,481,73,408,40318,5156,35162,41156209.0,5171069.0,35985139.0,466,62,404,40138,4986,35152,40974134.0,4998782.0,35975352.0,100.29,102.34,100.26,102.34
2023-11-13 13:40,971,175,796,63917,13614,50303,65160283.0,13696426.0,51463857.0,942,156,786,63324,13327,49997,64574421.0,13367117.0,51207303.0,100.61,102.31,100.3,102.42
2023-11-13 13:45,1031,123,908,54572,8704,45868,55687445.0,8743218.0,46944227.0,1003,104,899,53683,7799,45884,54791319.0,7827047.0,46964271.0,100.45,102.35,100.36,102.35
2023-11-13 13:50,1391,113,1278,62059,11527,50532,63414503.0,11600451.0,51814052.0,1398,112,1286,61877,11303,50574,63226841.0,11370131.0,51856710.0,100.64,102.54,100.59,102.54
2023-11-13 13:55,51,10,41,4233,1009,3224,4327290.0,1015686.0,3311604.0,52,15,37,4568,1538,3030,4666154.0,1552317.0,3113836.0,100.66,102.72,100.93,102.77
2023-11-13 14:00,755,521,234,52683,36119,16564,53844239.0,36710461.0,17133777.0,712,502,210,51445,35139,16306,52564724.0,35694553.0,16870170.0,101.64,103.44,101.58,103.46
2023-11-13 14:05,441,372,69,28051,22183,5868,28658266.0,22582440.0,6075826.0,429,364,65,27743,21947,5796,28345187.0,22343161.0,6002026.0,101.8,103.54,101.81,103.55
2023-11-13 14:10,740,407,333,45093,32370,12723,46156991.0,32969360.0,13187630.0,725,397,328,44892,32182,12710,45918747.0,32745599.0,13173148.0,101.85,103.65,101.75,103.64
2023-11-13 14:15,681,575,106,43946,41300,2646,44940627.0,42212207.0,2728419.0,671,572,99,43248,40830,2418,44231000.0,41737942.0,2493058.0,102.21,103.11,102.22,103.1
2023-11-13 14:20,132,24,108,7751,1980,5771,7957574.0,2001435.0,5956138.0,128,21,107,7786,2002,5784,7992526.0,2020635.0,5971890.0,101.08,103.21,100.93,103.25
2023-11-13 14:25,109,34,75,8246,4427,3819,8446573.0,4499891.0,3946682.0,101,32,69,7338,3576,3762,7517944.0,3624095.0,3893848.0,101.65,103.34,101.34,103.5
2023-11-13 14:30,207,134,73,13694,9285,4409,14007270.0,9452282.0,4554988.0,192,127,65,13788,9553,4235,14110431.0,9724478.0,4385953.0,101.8,103.31,101.8,103.56
2023-11-13 14:35,678,533,145,39942,29407,10535,40890173.0,29968678.0,10921494.0,646,522,124,39292,29010,10282,40225960.0,29560576.0,10665383.0,101.91,103.67,101.9,103.73
2023-11-13 14:40,762,513,249,51183,36348,14835,52381502.0,37061027.0,15320475.0,748,507,241,51589,37011,14578,52784318.0,37727237.0,15057081.0,101.96,103.27,101.94,103.29
2023-11-13 14:45,1693,759,934,105787,55856,49931,108318402.0,56839894.0,51478507.0,1681,752,929,105512,55644,49868,108037163.0,56623713.0,51413449.0,101.76,103.1,101.76,103.1
2023-11-13 14:50,1755,1131,624,133856,83280,50576,137050532.0,84673523.0,52377008.0,1743,1124,619,133499,82996,50503,136686858.0,84384921.0,52301937.0,101.67,103.56,101.67,103.56
2023-11-13 14:55,1171,1134,37,77981,72363,5618,79727501.0,73891065.0,5836435.0,1164,1131,33,77803,72218,5585,79545797.0,73744180.0,5801616.0,102.11,103.89,102.11,103.88
2023-11-13 15:00,1290,742,548,74767,51388,23379,76473920.0,52366067.0,24107852.0,1267,734,533,74484,51456,23028,76188423.0,52434052.0,23754370.0,101.9,103.12,101.9,103.15
2023-11-13 15:05,416,33,383,15015,2056,12959,15381957.0,2073393.0,13308563.0,407,26,381,14829,2038,12791,15194251.0,2055614.0,13138636.0,100.85,102.7,100.86,102.72
2023-11-13 15:10,325,223,102,16680,10232,6448,16978880.0,10366479.0,6612401.0,315,218,97,15391,8892,6499,15685322.0,9018687.0,6666634.0,101.31,102.55,101.42,102.58
2023-11-13 15:15,267,86,181,16640,3542,13098,16994954.0,3588615.0,13406339.0,257,80,177,16437,3488,12949,16824660.0,3533459.0,13291200.0,101.32,102.35,101.3,102.64
2023-11-13 15:20,137,14,123,7129,346,6783,7307438.0,352496.0,6954942.0,126,7,119,6967,302,6665,7139502.0,304818.0,6834683.0,101.88,102.53,100.93,102.55
2023-11-13 15:25,504,18,486,19193,804,18389,19668751.0,808944.0,18859807.0,484,10,474,18948,741,18207,19423206.0,745970.0,18677236.0,100.61,102.56,100.67,102.58
2023-11-13 15:30,61,19,42,3557,609,2948,3644061.0,617208.0,3026853.0,53,11,42,3750,809,2941,3828569.0,808893.0,3019675.0,101.35,102.67,99.99,102.68
2023-11-13 15:35,1010,26,984,64372,2754,61618,65977326.0,2778119.0,63199206.0,997,17,980,63815,2217,61598,65409161.0,2229986.0,63179175.0,100.88,102.57,100.59,102.57
2023-11-13 15:40,196,33,163,11710,1153,10557,11999702.0,1164126.0,10835576.0,192,30,162,11706,1151,10555,11992803.0,1159549.0,10833253.0,100.96,102.64,100.74,102.64
2023-11-13 15:45,441,17,424,23497,894,22603,24070045.0,900595.0,23169450.0,429,10,419,23788,1286,22502,24377924.0,1291164.0,23086760.0,100.74,102.51,100.4,102.6
2023-11-13 15:50,525,89,436,34479,5255,29224,35295009.0,5313343.0,29981666.0,512,85,427,34401,5180,29221,35220928.0,5236554.0,29984373.0,101.11,102.59,101.09,102.61
2023-11-13 15:55,326,21,305,15181,248,14933,15551950.0,253189.0,15298761.0,309,8,301,15635,573,15062,16008601.0,574233.0,15434367.0,102.09,102.45,100.22,102.47
2023-11-13 16:00,1784,117,1667,80171,8023,72148,81744593.0,8067863.0,73676730.0,1738,88,1650,78395,7491,70904,80034467.0,7520794.0,72513673.0,100.56,102.12,100.4,102.27
2023-11-13 16:05,1014,53,961,37433,3612,33821,38226005.0,3618739.0,34607266.0,994,37,957,36971,3182,33789,37753383.0,3183161.0,34570222.0,100.19,102.32,100.04,102.31
2023-11-13 16:10,617,27,590,25080,2034,23046,25651556.0,2047486.0,23604070.0,606,18,588,24941,1905,23036,25509682.0,1915720.0,23593962.0,100.66,102.42,100.56,102.42
2023-11-13 16:15,1758,101,1657,109279,9079,100200,111917934.0,9151301.0,102766632.0,1744,88,1656,109161,8986,100175,111805461.0,9053297.0,102752164.0,100.8,102.56,100.75,102.57
2023-11-13 16:20,1774,125,1649,120794,19087,101707,123839059.0,19262849.0,104576209.0,1751,114,1637,120477,18871,101606,123505447.0,19033064.0,104472383.0,100.92,102.82,100.86,102.82
2023-11-13 16:25,2329,260,2069,171834,37231,134603,176114803.0,37544167.0,138570635.0,2321,255,2066,171782,37185,134597,176061004.0,37494780.0,138566224.0,100.84,102.95,100.83,102.95
2023-11-13 16:30,1769,337,1432,151063,37319,113744,154793083.0,37652583.0,117140500.0,1743,320,1423,150638,37272,113366,154343749.0,37599313.0,116744436.0,100.89,102.99,100.88,102.98
2023-11-13 16:35,591,183,408,51252,16711,34541,52477851.0,16862016.0,35615834.0,578,173,405,51007,16514,34493,52226535.0,16660130.0,35566405.0,100.9,103.11,100.88,103.11
2023-11-13 16:40,57,32,25,2549,1186,1363,2631995.0,1225705.0,1406289.0,50,28,22,2455,1103,1352,2507542.0,1112301.0,1395241.0,103.35,103.18,100.84,103.2
2023-11-13 16:45,85,55,30,2974,1801,1173,3037679.0,1831174.0,1206505.0,75,50,25,4830,3820,1010,4893149.0,3848664.0,1044484.0,101.68,102.86,100.75,103.41
2023-11-13 16:50,37,28,9,1095,614,481,1127699.0,626803.0,500895.0,26,19,7,1010,546,464,1033435.0,554047.0,479388.0,102.09,104.14,101.47,103.32
2023-11-13 16:55,48,35,13,4798,4112,686,4881469.0,4172162.0,709306.0,32,25,7,1617,957,660,1654359.0,971188.0,683171.0,101.46,103.4,101.48,103.51
2023-11-13 17:00,39,21,18,3995,2755,1240,4049564.0,2770004.0,1279560.0,27,16,11,1750,631,1119,1795150.0,636609.0,1158541.0,100.54,103.19,100.89,103.53
2023-11-13 17:05,1152,1074,78,44272,39800,4472,45155466.0,40551498.0,4603967.0,1142,1073,69,44129,39726,4403,45013423.0,40478683.0,4534740.0,101.89,102.95,101.89,102.99
2023-11-13 17:10,1282,1240,42,49298,45765,3533,50249029.0,46615500.0,3633528.0,1274,1238,36,49251,45801,3450,50200122.0,46649514.0,3550608.0,101.86,102.85,101.85,102.92
2023-11-13 17:15,1070,1049,21,38897,37656,1241,39633588.0,38362824.0,1270764.0,1061,1042,19,38863,37634,1229,39598601.0,38337309.0,1261292.0,101.88,102.4,101.87,102.63
2023-11-13 17:20,6493,1490,5003,329998,103810,226188,333304649.0,103458426.0,229846223.0,5693,1021,4672,295576,88125,207451,299329164.0,87865327.0,211463837.0,99.66,101.62,99.71,101.93
2023-11-13 17:25,2250,798,1452,177689,63536,114153,178880145.0,63301405.0,115578739.0,1907,617,1290,166788,61806,104982,168179286.0,61537334.0,106641952.0,99.63,101.25,99.57,101.58
2023-11-13 17:30,1145,387,758,88110,33370,54740,88495983.0,33110419.0,55385564.0,974,279,695,86531,31478,55053,86997860.0,31192855.0,55805005.0,99.22,101.18,99.09,101.37
2023-11-13 17:35,771,207,564,58043,20265,37778,58330583.0,20172702.0,38157881.0,682,172,510,54707,18698,36009,55012642.0,18533784.0,36478857.0,99.54,101.01,99.12,101.3
2023-11-13 17:40,1649,572,1077,127946,56459,71487,126800348.0,55315560.0,71484788.0,1292,357,935,124186,54240,69946,123553273.0,53161089.0,70392183.0,97.97,100.0,98.01,100.64
2023-11-13 17:45,956,441,515,106226,37720,68506,110230143.0,36802354.0,73427789.0,640,250,390,74154,35712,38442,73007815.0,34638884.0,38368931.0,97.57,107.18,97.0,99.81
2023-11-13 17:50,1272,543,729,111425,48508,62917,111705816.0,46788129.0,64917686.0,902,316,586,105547,42218,63329,108865779.0,40671065.0,68194714.0,96.45,103.18,96.34,107.68
2023-11-13 17:55,1024,527,497,88934,40504,48430,86158334.0,38938615.0,47219719.0,700,307,393,74284,32310,41974,72470327.0,31056574.0,41413752.0,96.14,97.5,96.12,98.67
2023-11-13 18:00,2466,1564,902,187355,112210,75145,185320740.0,110643528.0,74677212.0,1883,1268,615,178386,97071,81315,176429237.0,94303924.0,82125313.0,98.6,99.38,97.15,101.0
2023-11-13 18:05,1223,579,644,103487,53294,50193,103213572.0,52719542.0,50494030.0,1006,472,534,100925,48633,52292,102646963.0,47865592.0,54781371.0,98.92,100.6,98.42,104.76
2023-11-13 18:10,1567,464,1103,90356,32886,57470,89829750.0,32235152.0,57594597.0,1399,382,1017,87401,32136,55265,87014639.0,31500611.0,55514028.0,98.02,100.22,98.02,100.45
2023-11-13 18:15,1441,993,448,78829,52482,26347,79047028.0,52367320.0,26679708.0,1250,904,346,76080,53204,22876,75740196.0,52629458.0,23110738.0,99.78,101.26,98.92,101.03
2023-11-13 18:20,2293,1779,514,107381,87794,19587,108823397.0,88802168.0,20021229.0,2021,1697,324,99821,84155,15666,100323867.0,84270071.0,16053796.0,101.15,102.22,100.14,102.48
2023-11-13 18:25,908,678,230,34085,30223,3862,34391319.0,30495430.0,3895889.0,775,618,157,31844,28503,3341,31998735.0,28590928.0,3407806.0,100.9,100.88,100.31,102.0
2023-11-13 18:30,874,652,222,33147,30134,3013,33279041.0,30249890.0,3029150.0,853,636,217,33666,30622,3044,33823225.0,30732200.0,3091025.0,100.38,100.54,100.36,101.54
2023-11-13 18:35,1033,295,738,35430,9957,25473,35523210.0,9907416.0,25615794.0,962,247,715,36287,8870,27417,36541502.0,8790491.0,27751011.0,99.5,100.56,99.1,101.22
2023-11-14 10:00,3073,1101,1972,128289,51196,77093,121770519.0,47696419.0,74074099.0,1486,479,1007,71317,25964,45353,66839118.0,24008876.0,42830242.0,93.16,96.08,92.47,94.44
2023-11-14 10:05,1891,324,1567,81261,20763,60498,74870370.0,19012961.0,55857408.0,1485,151,1334,59062,9630,49432,55022756.0,8785012.0,46237744.0,91.57,92.33,91.23,93.54
2023-11-14 10:10,2361,740,1621,103804,39583,64221,95373908.0,36827254.0,58546654.0,1930,514,1416,80023,25090,54933,74073949.0,23136179.0,50937769.0,93.04,91.16,92.21,92.73
2023-11-14 10:15,2745,1979,766,166664,111001,55663,157361023.0,104346502.0,53014520.0,2305,1771,534,145859,100474,45385,137130718.0,93804427.0,43326290.0,94.01,95.24,93.36,95.46
2023-11-14 10:20,1555,1228,327,82297,68660,13637,78839720.0,65695186.0,13144534.0,1312,1100,212,75998,63272,12726,72708527.0,60408875.0,12299652.0,95.68,96.39,95.47,96.65
2023-11-14 10:25,1205,668,537,58776,32317,26459,56756431.0,31004982.0,25751448.0,997,565,432,47630,25557,22073,46122118.0,24601572.0,21520546.0,95.94,97.33,96.26,97.5
2023-11-14 10:30,1722,820,902,74307,29252,45055,71370362.0,27959489.0,43410873.0,1394,663,731,70979,27614,43365,68050782.0,26298782.0,41752000.0,95.58,96.35,95.24,96.28
2023-11-14 10:35,1458,481,977,93001,22730,70271,89261980.0,21585186.0,67676793.0,1307,380,927,89770,20904,68866,86147261.0,19827301.0,66319960.0,94.96,96.31,94.85,96.3
2023-11-14 10:40,2125,798,1327,147412,50947,96465,141316836.0,48205736.0,93111100.0,2045,756,1289,146706,50825,95881,140661905.0,48076198.0,92585707.0,94.62,96.52,94.59,96.56
2023-11-14 10:45,2007,1367,640,112613,82667,29946,113179352.0,83390740.0,29788611.0,1530,1139,391,99198,74873,24325,99541014.0,75372711.0,24168303.0,100.88,99.47,100.67,99.36
2023-11-14 10:50,642,284,358,22816,10221,12595,22700350.0,10135545.0,12564805.0,416,198,218,14965,7703,7262,14919487.0,7542671.0,7376816.0,99.16,99.76,97.92,101.58
2023-11-14 10:55,412,211,201,15123,6171,8952,15160477.0,6126120.0,9034357.0,333,170,163,12348,5836,6512,12304250.0,5743158.0,6561092.0,99.27,100.92,98.41,100.75
2023-11-14 11:00,1754,329,1425,106639,22049,84590,105859411.0,21559500.0,84299911.0,1610,255,1355,103479,20510,82969,102846786.0,20110525.0,82736261.0,97.78,99.66,98.05,99.72
2023-11-14 11:05,1871,691,1180,136602,50621,85981,135065199.0,49492197.0,85573002.0,1770,630,1140,133837,48698,85139,132409479.0,47650175.0,84759304.0,97.77,99.53,97.85,99.55
2023-11-14 11:10,2134,1258,876,163772,96241,67531,161876452.0,94444380.0,67432072.0,2064,1216,848,162877,95995,66882,161061199.0,94185528.0,66875671.0,98.13,99.85,98.12,99.99
2023-11-14 11:15,2620,1205,1415,177430,75106,102324,175641388.0,73710483.0,101930905.0,2564,1174,1390,176885,74879,102006,175108237.0,73436549.0,101671687.0,98.14,99.62,98.07,99.67
2023-11-14 11:20,2082,956,1126,146126,56255,89871,143718161.0,54966347.0,88751814.0,1981,902,1079,143100,55465,87635,141256300.0,54211308.0,87044992.0,97.71,98.75,97.74,99.33
2023-11-14 11:25,3762,551,3211,246282,33153,213129,240711127.0,31765860.0,208945267.0,3607,459,3148,242745,32294,210451,237278244.0,30927427.0,206350817.0,95.82,98.04,95.77,98.05
2023-11-14 11:30,2112,404,1708,171201,41575,129626,165755362.0,39657612.0,126097750.0,1994,329,1665,166552,39781,126771,161392486.0,37869276.0,123523210.0,95.39,97.28,95.19,97.44
2023-11-14 11:35,1172,675,497,81648,39887,41761,79249585.0,38350062.0,40899523.0,1075,611,464,79760,38536,41224,77400640.0,37027142.0,40373498.0,96.15,97.94,96.08,97.94
2023-11-14 11:40,3081,905,2176,206000,57066,148934,201356771.0,55112428.0,146244343.0,3000,858,2142,207143,59316,147827,202599411.0,57250196.0,145349214.0,96.58,98.19,96.52,98.32
2023-11-14 11:45,1368,622,746,109554,39727,69827,106990753.0,38357745.0,68633008.0,1262,556,706,103888,36325,67563,101462837.0,35049144.0,66413693.0,96.55,98.29,96.49,98.3
2023-11-14 11:50,1729,1429,300,113623,85742,27881,110842558.0,83246827.0,27595730.0,1660,1385,275,112314,84859,27455,109575000.0,82392013.0,27182986.0,97.09,98.98,97.09,99.01
2023-11-14 11:55,2332,2000,332,152556,114954,37602,148893357.0,111690651.0,37202705.0,2286,1975,311,152342,115057,37285,148712035.0,111791414.0,36920621.0,97.16,98.94,97.16,99.02
2023-11-14 12:00,1224,922,302,74704,37133,37571,73138497.0,35916299.0,37222198.0,1200,908,292,74242,37243,36999,72650944.0,35994859.0,36656085.0,96.72,99.07,96.65,99.07
2023-11-14 12:05,1613,1251,362,132943,98109,34834,131341083.0,96424599.0,34916484.0,1498,1210,288,127233,95230,32003,125635129.0,93521114.0,32114015.0,98.28,100.24,98.21,100.35
2023-11-14 12:10,253,129,124,17625,9844,7781,17325140.0,9532480.0,7792659.0,215,101,114,14481,7184,7297,14321778.0,7007458.0,7314319.0,96.84,100.15,97.54,100.24
2023-11-14 12:15,230,121,109,16353,9749,6604,16115483.0,9512795.0,6602688.0,187,100,87,15644,9516,6128,15431656.0,9295895.0,6135760.0,97.58,99.98,97.69,100.13
2023-11-14 12:20,193,85,108,10822,5250,5572,10688863.0,5147126.0,5541736.0,175,78,97,10888,5648,5240,10706449.0,5468101.0,5238347.0,98.04,99.46,96.81,99.97
2023-11-14 12:25,942,385,557,63429,29607,33822,62381232.0,28852765.0,33528466.0,899,371,528,63123,29661,33462,62116423.0,28911499.0,33204923.0,97.45,99.13,97.47,99.23
2023-11-14 12:30,394,88,306,29731,10525,19206,29057031.0,10092577.0,18964454.0,377,82,295,28070,9385,18685,27550685.0,9077584.0,18473100.0,95.89,98.74,96.72,98.87
2023-11-14 12:35,1054,171,883,72127,18314,53813,70516821.0,17650426.0,52866395.0,1027,160,867,70565,17389,53176,69083037.0,16793420.0,52289616.0,96.38,98.24,96.57,98.33
2023-11-14 12:40,1871,341,1530,140107,32484,107623,136930420.0,31368349.0,105562070.0,1841,321,1520,139423,31991,107432,136287558.0,30892205.0,105395352.0,96.57,98.09,96.57,98.1
2023-11-14 12:45,1824,126,1698,127638,16754,110884,124896183.0,16157525.0,108738658.0,1818,124,1694,127781,17040,110741,125027967.0,16433207.0,108594760.0,96.44,98.07,96.44,98.06
2023-11-14 12:50,1495,205,1290,126388,26675,99713,123775206.0,25712736.0,98062470.0,1479,194,1285,126280,26674,99606,123666859.0,25708228.0,97958630.0,96.39,98.34,96.38,98.35
2023-11-14 12:55,832,132,700,55658,10559,45099,54454659.0,10206353.0,44248305.0,809,122,687,54926,10464,44462,53737472.0,10107745.0,43629726.0,96.66,98.11,96.6,98.13
2023-11-14 13:00,180,51,129,12465,4650,7815,12157748.0,4464530.0,7693218.0,144,38,106,12180,4558,7622,11908116.0,4376436.0,7531679.0,96.01,98.44,96.02,98.82
2023-11-14 13:05,255,116,139,20877,10594,10283,20198366.0,10138907.0,10059458.0,209,99,110,20235,10565,9670,19571262.0,10095130.0,9476132.0,95.7,97.83,95.55,98.0
2023-11-14 13:10,497,179,318,44336,20524,23812,42691278.0,19482257.0,23209021.0,440,139,301,42895,19556,23339,41353487.0,18596460.0,22757027.0,94.92,97.47,95.09,97.51
2023-11-14 13:15,426,83,343,28489,8035,20454,27543376.0,7667998.0,19875378.0,412,71,341,28153,7614,20539,27230817.0,7262276.0,19968541.0,95.43,97.17,95.38,97.22
2023-11-14 13:20,1233,113,1120,93579,8633,84946,90584456.0,8223143.0,82361312.0,1195,87,1108,92724,7968,84756,89777897.0,7590793.0,82187104.0,95.25,96.96,95.27,96.97
2023-11-14 13:25,843,39,804,63085,3362,59723,61081061.0,3192690.0,57888371.0,830,36,794,64045,4383,59662,62007943.0,4164118.0,57843825.0,94.96,96.93,95.01,96.95
2023-11-14 13:30,207,46,161,15660,3891,11769,15150244.0,3729044.0,11421199.0,190,37,153,14555,3037,11518,14078351.0,2903463.0,11174887.0,95.84,97.04,95.6,97.02
2023-11-14 13:35,180,133,47,12882,9870,3012,12466488.0,9507022.0,2959466.0,164,121,43,12905,10321,2584,12430197.0,9899638.0,2530559.0,96.32,98.26,95.92,97.93
2023-11-14 13:40,928,269,659,72626,27543,45083,70154239.0,26328147.0,43826091.0,879,248,631,72114,27474,44640,69698063.0,26255591.0,43442472.0,95.59,97.21,95.57,97.32
2023-11-14 13:45,754,86,668,52548,9309,43239,50771109.0,8836255.0,41934853.0,709,67,642,52098,9155,42943,50377919.0,8696850.0,41681069.0,94.92,96.98,95.0,97.06
2023-11-14 13:50,252,27,225,16798,2126,14672,16222811.0,2015324.0,14207487.0,237,18,219,17179,1974,15205,16669457.0,1875198.0,14794259.0,94.79,96.83,94.99,97.3
2023-11-14 13:55,991,124,867,78980,17264,61716,76191119.0,16368136.0,59822983.0,961,111,850,77490,17313,60177,74762481.0,16409418.0,58353063.0,94.81,96.93,94.78,96.97
2023-11-14 14:00,332,101,231,27392,7258,20134,26069464.0,6831717.0,19237747.0,269,68,201,26336,6781,19555,25242858.0,6372731.0,18870127.0,94.13,95.55,93.98,96.5
2023-11-14 14:05,437,99,338,42690,10230,32460,40776794.0,9599638.0,31177156.0,373,65,308,41408,9846,31562,39636992.0,9233493.0,30403499.0,93.84,96.05,93.78,96.33
2023-11-14 14:10,489,70,419,44125,4588,39537,42300970.0,4307901.0,37993068.0,443,41,402,42898,4400,38498,41118251.0,4120259.0,36997991.0,93.89,96.09,93.64,96.1
2023-11-14 14:15,191,34,157,12996,1088,11908,12447705.0,1021116.0,11426589.0,159,18,141,12754,1018,11736,12227616.0,953296.0,11274319.0,93.85,95.96,93.64,96.07
2023-11-14 14:20,356,33,323,29846,1208,28638,28652444.0,1139924.0,27512520.0,334,19,315,29886,1469,28417,28672688.0,1373294.0,27299393.0,94.36,96.07,93.49,96.07
2023-11-14 14:25,721,85,636,69767,7600,62167,66714051.0,7118291.0,59595759.0,676,59,617,68890,6855,62035,65903522.0,6406451.0,59497071.0,93.66,95.86,93.46,95.91
2023-11-14 14:30,765,78,687,72081,6664,65417,68789742.0,6229021.0,62560720.0,721,57,664,69574,6404,63170,66442378.0,5981922.0,60460455.0,93.47,95.63,93.41,95.71
2023-11-14 14:35,986,159,827,91421,14316,77105,86466170.0,13288030.0,73178139.0,908,120,788,89313,13987,75326,84512718.0,12978573.0,71534144.0,92.82,94.91,92.79,94.97
2023-11-14 14:40,914,145,769,74940,13183,61757,70233963.0,12137694.0,58096269.0,852,105,747,73576,12406,61170,69089655.0,11450098.0,57639557.0,92.07,94.07,92.29,94.23
2023-11-14 14:45,434,114,320,39048,9221,29827,36689928.0,8521964.0,28167963.0,394,85,309,38755,8716,30039,36424535.0,8057375.0,28367160.0,92.42,94.44,92.44,94.43
2023-11-14 14:50,256,119,137,23295,9195,14100,21964705.0,8583192.0,13381512.0,208,88,120,22551,8781,13770,21233663.0,8131368.0,13102295.0,93.35,94.9,92.6,95.15
2023-11-14 14:55,111,67,44,6202,2630,3572,5880974.0,2469191.0,3411783.0,75,42,33,5675,2373,3302,5342804.0,2198489.0,3144315.0,93.89,95.51,92.65,95.22
2023-11-14 15:00,395,71,324,34448,1947,32501,32798588.0,1822606.0,30975982.0,354,37,317,33371,1535,31836,31647477.0,1427190.0,30220287.0,93.61,95.31,92.98,94.92
2023-11-14 15:05,510,104,406,47968,7030,40938,45454329.0,6620119.0,38834210.0,472,78,394,47433,6623,40810,44863650.0,6147757.0,38715893.0,94.17,94.86,92.82,94.87
2023-11-14 15:10,34012,33133,879,1585071,1508870,76201,1492080410.0,1419429953.0,72650457.0,33973,33115,858,1584481,1508697,75784,1491518081.0,1419262812.0,72255268.0,94.07,95.34,94.07,95.34
2023-11-14 15:15,961,560,401,77182,38009,39173,72905998.0,35522368.0,37383630.0,934,545,389,77201,38038,39163,72922651.0,35545076.0,37377574.0,93.46,95.43,93.45,95.44
2023-11-14 15:20,777,488,289,56328,28808,27520,53230671.0,26991320.0,26239351.0,754,476,278,56142,28934,27208,53050833.0,27108844.0,25941989.0,93.69,95.35,93.69,95.35
2023-11-14 15:25,1027,154,873,85182,14734,70448,80404562.0,13696744.0,66707817.0,989,141,848,85069,14708,70361,80356794.0,13671432.0,66685362.0,92.96,94.69,92.95,94.78
2023-11-14 15:30,1244,195,1049,104342,14148,90194,98640017.0,13141117.0,85498899.0,1213,177,1036,103721,13845,89876,98046097.0,12853200.0,85192897.0,92.88,94.79,92.84,94.79
2023-11-14 15:35,767,67,700,63087,4000,59087,59714171.0,3717788.0,55996382.0,750,53,697,63073,3974,59099,59704920.0,3688114.0,56016806.0,92.94,94.77,92.81,94.78
2023-11-14 15:40,690,48,642,58355,3395,54960,55336834.0,3161250.0,52175584.0,673,35,638,58031,3177,54854,54999134.0,2954530.0,52044603.0,93.11,94.93,93.0,94.88
2023-11-14 15:45,491,43,448,44862,3580,41282,42642952.0,3335158.0,39307794.0,474,28,446,44372,3448,40924,42182766.0,3209607.0,38973159.0,93.16,95.22,93.09,95.23
2023-11-14 15:50,527,145,382,46078,11216,34862,43363232.0,10403459.0,32959773.0,500,125,375,45057,11111,33946,42492488.0,10301271.0,32191216.0,92.76,94.54,92.71,94.83
2023-11-14 15:55,422,109,313,37985,8233,29752,35736020.0,7623249.0,28112771.0,377,84,293,37183,7737,29446,35009571.0,7158153.0,27851417.0,92.59,94.49,92.52,94.58
2023-11-14 16:00,1612,238,1374,164478,27375,137103,154594360.0,25305823.0,129288536.0,1543,202,1341,163070,26605,136465,153279253.0,24562940.0,128716312.0,92.44,94.3,92.32,94.32
2023-11-14 16:05,1478,244,1234,138702,26497,112205,130405916.0,24535387.0,105870529.0,1453,230,1223,138841,26463,112378,130511436.0,24468074.0,106043362.0,92.6,94.35,92.46,94.36
2023-11-14 16:10,894,174,720,84480,20210,64270,79504663.0,18751778.0,60752884.0,851,151,700,83816,19796,64020,78847820.0,18325126.0,60522693.0,92.78,94.53,92.57,94.54
2023-11-14 16:15,290,83,207,28061,5901,22160,26427046.0,5463719.0,20963327.0,261,65,196,27895,6029,21866,26271715.0,5580882.0,20690832.0,92.59,94.6,92.57,94.63
2023-11-14 16:20,159,53,106,11538,2328,9210,10857540.0,2155000.0,8702540.0,121,25,96,11007,2046,8961,10357517.0,1892672.0,8464845.0,92.57,94.49,92.51,94.46
2023-11-14 16:25,121,63,58,10264,4726,5538,9641017.0,4391850.0,5249166.0,90,44,46,9688,4201,5487,9113236.0,3894801.0,5218435.0,92.93,94.78,92.71,95.11
2023-11-14 16:30,311,120,191,33603,13499,20104,31585169.0,12492083.0,19093085.0,290,109,181,33861,13345,20516,31903642.0,12350245.0,19553397.0,92.54,94.97,92.55,95.31
2023-11-14 16:35,426,200,226,40801,16202,24599,38434164.0,15110412.0,23323752.0,394,184,210,39891,15829,24062,37501791.0,14662123.0,22839667.0,93.26,94.82,92.63,94.92
2023-11-14 16:40,144,121,23,6278,5168,1110,5878600.0,4831964.0,1046635.0,111,96,15,5839,4834,1005,5480539.0,4518520.0,962018.0,93.5,94.29,93.47,95.72
2023-11-14 16:45,130,112,18,6031,5527,504,5685530.0,5208289.0,477241.0,118,104,14,5724,5261,463,5369594.0,4927788.0,441805.0,94.23,94.69,93.67,95.42
2023-11-14 16:50,77,48,29,3982,2389,1593,3753192.0,2230436.0,1522755.0,46,27,19,3918,2432,1486,3688981.0,2266337.0,1422644.0,93.36,95.59,93.19,95.74
2023-11-14 16:55,260,185,75,19684,12360,7324,18514126.0,11553966.0,6960160.0,231,164,67,19208,12037,7171,18081734.0,11250883.0,6830851.0,93.48,95.03,93.47,95.26
2023-11-14 17:00,91,59,32,5827,3781,2046,5509544.0,3541454.0,1968089.0,68,45,23,5060,3014,2046,4780379.0,2813900.0,1966479.0,93.66,96.19,93.36,96.11
2023-11-14 17:05,160,89,71,14536,6147,8389,13814399.0,5764084.0,8050314.0,136,72,64,13972,5953,8019,13264105.0,5570395.0,7693710.0,93.77,95.96,93.57,95.94
2023-11-14 17:10,202,42,160,16716,3965,12751,15943537.0,3717549.0,12225988.0,181,32,149,16917,4212,12705,16117377.0,3929764.0,12187613.0,93.76,95.88,93.3,95.93
2023-11-14 17:15,154,77,77,9224,3846,5378,8786555.0,3623155.0,5163400.0,125,56,69,8768,3533,5235,8337784.0,3309023.0,5028760.0,94.21,96.01,93.66,96.06
2023-11-14 17:20,222,62,160,18750,4568,14182,17907105.0,4272808.0,13634296.0,196,50,146,18441,4557,13884,17594574.0,4262197.0,13332377.0,93.54,96.14,93.53,96.03
2023-11-14 17:25,407,85,322,38318,6553,31765,36586789.0,6124249.0,30462539.0,383,64,319,38163,6376,31787,36441951.0,5957849.0,30484101.0,93.46,95.9,93.44,95.9
2023-11-14 17:30,2014,210,1804,182336,18981,163355,173739222.0,17741197.0,155998025.0,1943,154,1789,181356,18827,162529,172933476.0,17594222.0,155339253.0,93.47,95.5,93.45,95.58
2023-11-14 17:35,815,67,748,74514,6306,68208,70873770.0,5870744.0,65003026.0,795,51,744,74355,6247,68108,70725524.0,5815706.0,64909817.0,93.1,95.3,93.1,95.3
2023-11-14 17:40,8857,7328,1529,223743,84644,139099,212381185.0,79698226.0,132682958.0,8820,7301,1519,223207,84439,138768,211855399.0,79500348.0,132355051.0,94.16,95.39,94.15,95.38
2023-11-14 17:45,478,40,438,43731,3999,39732,41644127.0,3718328.0,37925799.0,465,31,434,43707,3957,39750,41620704.0,3670018.0,37950685.0,92.98,95.45,92.75,95.47
2023-11-14 17:50,840,113,727,77759,7699,70060,74037068.0,7211799.0,66825268.0,809,93,716,77692,7880,69812,73922485.0,7327830.0,66594655.0,93.67,95.38,92.99,95.39
2023-11-14 17:55,1372,123,1249,122616,7943,114673,116789279.0,7411877.0,109377401.0,1354,114,1240,122557,8014,114543,116731086.0,7475302.0,109255783.0,93.31,95.38,93.28,95.38
2023-11-14 18:00,1222,164,1058,110861,11077,99784,105680701.0,10347997.0,95332703.0,1200,151,1049,109961,10226,99735,104767606.0,9481938.0,95285667.0,93.42,95.54,92.72,95.54
2023-11-14 18:05,1653,363,1290,145525,26639,118886,138689376.0,24991447.0,113697928.0,1631,358,1273,145231,26399,118832,138361514.0,24709383.0,113652131.0,93.82,95.64,93.6,95.64
2023-11-14 18:10,162,98,64,16370,7851,8519,15551273.0,7343139.0,8208133.0,150,91,59,15578,7299,8279,14750250.0,6775576.0,7974673.0,93.53,96.35,92.83,96.32
2023-11-14 18:15,551,318,233,54917,17864,37053,52361821.0,16723051.0,35638770.0,529,307,222,54257,17813,36444,51748174.0,16667147.0,35081027.0,93.61,96.18,93.57,96.26
2023-11-14 18:20,170,46,124,12088,1432,10656,11502779.0,1340331.0,10162448.0,146,32,114,12203,1459,10744,11657559.0,1362215.0,10295343.0,93.6,95.37,93.37,95.82
2023-11-14 18:25,70,27,43,2490,148,2342,2344733.0,139477.0,2205255.0,46,15,31,2136,129,2007,2042934.0,118850.0,1924083.0,94.24,94.16,92.13,95.87
2023-11-14 18:30,453,247,206,26028,15388,10640,24791872.0,14643901.0,10147971.0,395,212,183,25575,15618,9957,24313679.0,14792060.0,9521618.0,95.16,95.38,94.71,95.63
2023-11-14 18:35,421,243,178,20442,14880,5562,19637079.0,14220187.0,5416892.0,288,198,90,13245,10890,2355,12656849.0,10337057.0,2319792.0,95.57,97.39,94.92,98.5
2023-11-29 10:00,472,157,315,15821,2510,13311,1641087.0,223476.0,223476.0,161,61,100,5514,1257,4257,531624.0,117887.0,117887.0,8.9,10.65,9.38,9.72
2023-11-29 10:05,92,40,52,1858,791,1067,178014.0,73266.0,73266.0,48,23,25,1259,426,833,121010.0,40551.0,40551.0,9.26,9.82,9.52,9.66
2023-11-29 10:10,308,124,184,21205,10232,10973,2038678.0,971449.0,971449.0,273,107,166,20032,9589,10443,1929804.0,910913.0,910913.0,9.49,9.73,9.5,9.76
2023-11-29 10:15,395,170,225,15737,6044,9693,1520576.0,572275.0,572275.0,182,63,119,14988,5845,9143,1444868.0,554496.0,554496.0,9.47,9.78,9.49,9.74
2023-11-29 10:20,121,54,67,9422,3665,5757,909259.0,347184.0,347184.0,90,43,47,8663,3180,5483,837539.0,302631.0,302631.0,9.47,9.76,9.52,9.76
2023-11-29 10:25,146,71,75,12312,5039,7273,1187119.0,478197.0,478197.0,112,49,63,12467,5333,7134,1200485.0,505064.0,505064.0,9.49,9.75,9.47,9.75
2023-11-29 10:30,101,55,46,10440,4957,5483,1005120.0,470769.0,470769.0,88,46,42,10563,4940,5623,1017676.0,469117.0,469117.0,9.5,9.75,9.5,9.76
2023-11-29 10:35,42,26,16,3010,1693,1317,285818.0,158434.0,158434.0,27,17,10,2593,1515,1078,247140.0,141979.0,141979.0,9.36,9.67,9.37,9.76
2023-11-29 10:40,367,137,230,34012,13066,20946,3269067.0,1236361.0,1236361.0,355,130,225,33879,13035,20844,3257123.0,1234457.0,1234457.0,9.46,9.7,9.47,9.7
2023-11-29 10:45,320,134,186,32398,12170,20228,3112108.0,1152883.0,1152883.0,307,125,182,32269,12045,20224,3101607.0,1140900.0,1140900.0,9.47,9.69,9.47,9.69
2023-11-29 10:50,32,13,19,1198,681,517,113146.0,64153.0,64153.0,22,12,10,1056,580,476,101098.0,54971.0,54971.0,9.42,9.48,9.48,9.69
2023-11-29 10:55,27,15,12,1724,1323,401,165096.0,126184.0,126184.0,23,11,12,885,504,381,84539.0,47490.0,47490.0,9.54,9.7,9.42,9.72
2023-11-29 11:00,108,69,39,10506,5334,5172,1011231.0,506013.0,506013.0,84,53,31,10287,5227,5060,990294.0,495938.0,495938.0,9.49,9.77,9.49,9.77
2023-11-29 11:05,167,82,85,17200,8713,8487,1655228.0,826780.0,826780.0,133,62,71,16700,8399,8301,1608713.0,797414.0,797414.0,9.49,9.76,9.49,9.77
2023-11-29 11:10,90,43,47,10098,6122,3976,970335.0,582166.0,582166.0,78,35,43,9837,5819,4018,945446.0,553174.0,553174.0,9.51,9.76,9.51,9.76
2023-11-29 11:15,552,426,126,47130,32690,14440,4545525.0,3132021.0,3132021.0,524,405,119,46185,31896,14289,4447504.0,3048947.0,3048947.0,9.58,9.79,9.56,9.79
2023-11-29 11:20,730,596,134,50513,38193,12320,4878971.0,3670519.0,3670519.0,679,551,128,50311,38117,12194,4859287.0,3663213.0,3663213.0,9.61,9.81,9.61,9.81
2023-11-29 11:25,1503,1239,264,115613,86472,29141,11168569.0,8309306.0,8309306.0,1491,1233,258,115452,86352,29100,11155845.0,8299568.0,8299568.0,9.61,9.81,9.61,9.82
2023-11-29 11:30,587,434,153,46610,34365,12245,4498397.0,3298689.0,3298689.0,576,433,143,46501,34438,12063,4487379.0,3306122.0,3306122.0,9.6,9.8,9.6,9.79
2023-11-29 11:35,77,52,25,8100,5077,3023,781035.0,485482.0,485482.0,73,48,25,7572,4960,2612,729925.0,474053.0,474053.0,9.56,9.78,9.56,9.8
2023-11-29 11:40,38,19,19,2056,1235,821,197672.0,117324.0,117324.0,36,18,18,2095,1280,815,201738.0,122172.0,122172.0,9.5,9.79,9.54,9.76
2023-11-29 11:45,28,12,16,892,589,303,86022.0,56696.0,56696.0,24,11,13,803,526,277,77690.0,50661.0,50661.0,9.63,9.68,9.63,9.76
2023-11-29 11:50,106,33,73,5344,2487,2857,514727.0,236546.0,236546.0,86,24,62,5329,2623,2706,513486.0,249813.0,249813.0,9.51,9.74,9.52,9.74
2023-11-29 11:55,9,4,5,112,18,94,10179.0,1706.0,1706.0,8,4,4,118,14,104,11371.0,1327.0,1327.0,9.48,9.01,9.48,9.66
2023-11-29 12:00,13,8,5,397,304,93,33490.0,28280.0,28280.0,7,3,4,208,146,62,20311.0,14041.0,14041.0,9.3,5.6,9.62,10.11
2023-11-29 12:05,27,10,17,1472,645,827,142000.0,61354.0,61354.0,20,8,12,1432,617,815,138190.0,58633.0,58633.0,9.51,9.75,9.5,9.76
2023-11-29 12:10,95,33,62,6385,3822,2563,613770.0,365638.0,365638.0,83,28,55,6386,3889,2497,615068.0,371368.0,371368.0,9.57,9.68,9.55,9.76
2023-11-29 12:15,46,21,25,3101,1697,1404,299152.0,161881.0,161881.0,39,16,23,3088,1744,1344,297894.0,166456.0,166456.0,9.54,9.78,9.54,9.78
2023-11-29 12:20,86,49,37,7251,4607,2644,698202.0,440155.0,440155.0,72,39,33,7191,4569,2622,693605.0,436990.0,436990.0,9.55,9.76,9.56,9.79
2023-11-29 12:25,39,21,18,4667,2251,2416,450199.0,213986.0,213986.0,45,27,18,4676,2256,2420,451076.0,214468.0,214468.0,9.51,9.78,9.51,9.78
2023-11-29 12:30,44,22,22,4151,2037,2114,400411.0,193579.0,193579.0,34,17,17,4132,2032,2100,398698.0,193218.0,193218.0,9.5,9.78,9.51,9.78
2023-11-29 12:35,559,450,109,62374,46995,15379,6022390.0,4514166.0,4514166.0,538,438,100,61797,46568,15229,5965259.0,4472909.0,4472909.0,9.61,9.81,9.61,9.8
2023-11-29 12:40,417,366,51,36027,31537,4490,3476869.0,3037182.0,3037182.0,408,362,46,35774,31580,4194,3452440.0,3041483.0,3041483.0,9.63,9.79,9.63,9.8
2023-11-29 12:45,622,371,251,64286,43379,20907,6209521.0,4161963.0,4161963.0,612,364,248,64173,43310,20863,6198712.0,4155383.0,4155383.0,9.59,9.79,9.59,9.79
2023-11-29 12:50,342,128,214,24746,13252,11494,2390568.0,1268260.0,1268260.0,337,125,212,24799,13327,11472,2395792.0,1275561.0,1275561.0,9.57,9.76,9.57,9.76
2023-11-29 12:55,92,55,37,9929,6908,3021,960308.0,662271.0,662271.0,87,51,36,10114,6811,3303,976088.0,653061.0,653061.0,9.59,9.87,9.59,9.78
2023-11-29 13:00,315,184,131,31561,20823,10738,3046106.0,1995691.0,1995691.0,307,180,127,31427,20863,10564,3033113.0,1999533.0,1999533.0,9.58,9.78,9.58,9.78
2023-11-29 13:05,106,56,50,11132,6288,4844,1074552.0,600060.0,600060.0,105,55,50,11436,6268,5168,1104808.0,598137.0,598137.0,9.54,9.8,9.54,9.8
2023-11-29 13:10,58,24,34,4478,3079,1399,432250.0,295598.0,295598.0,58,25,33,4338,2989,1349,418691.0,286900.0,286900.0,9.6,9.77,9.6,9.77
2023-11-29 13:15,97,56,41,8942,5609,3333,861613.0,535522.0,535522.0,90,54,36,8935,5724,3211,862434.0,547937.0,547937.0,9.55,9.78,9.57,9.79
2023-11-29 13:20,115,73,42,13551,8420,5131,1296735.0,805135.0,805135.0,101,65,36,13274,8305,4969,1281998.0,794887.0,794887.0,9.56,9.58,9.57,9.8
2023-11-29 13:25,74,40,34,6279,3509,2770,606879.0,335297.0,335297.0,65,35,30,6293,3544,2749,608020.0,338542.0,338542.0,9.56,9.8,9.55,9.8
2023-11-29 13:30,94,45,49,7669,3615,4054,738412.0,344713.0,344713.0,73,37,36,7617,3632,3985,737221.0,346342.0,346342.0,9.54,9.71,9.54,9.81
2023-11-29 13:35,98,53,45,8180,4148,4032,785421.0,393152.0,393152.0,83,44,39,8428,4221,4207,814899.0,402643.0,402643.0,9.48,9.73,9.54,9.8
2023-11-29 13:40,80,47,33,7932,3972,3960,767010.0,378486.0,378486.0,74,43,31,7849,3784,4065,761226.0,360444.0,360444.0,9.53,9.81,9.53,9.86
2023-11-29 13:45,56,35,21,5604,2932,2672,541525.0,279573.0,279573.0,49,30,19,5468,2800,2668,528941.0,267061.0,267061.0,9.54,9.8,9.54,9.82
2023-11-29 13:50,168,133,35,11966,9510,2456,1156237.0,915676.0,915676.0,169,135,34,12130,9683,2447,1171922.0,932355.0,932355.0,9.63,9.79,9.63,9.79
2023-11-29 13:55,48,39,9,3722,2898,824,359638.0,278784.0,278784.0,46,38,8,3585,2773,812,346434.0,266724.0,266724.0,9.62,9.81,9.62,9.82
2023-11-29 14:00,73,53,20,6696,4253,2443,647279.0,408040.0,408040.0,72,51,21,6652,4207,2445,643080.0,403676.0,403676.0,9.59,9.79,9.6,9.79
2023-11-29 14:05,75,63,12,5582,4786,796,543961.0,461782.0,461782.0,68,59,9,5115,4875,240,493991.0,470449.0,470449.0,9.65,10.32,9.65,9.81
2023-11-29 14:10,167,138,29,12942,10555,2387,1250695.0,1016521.0,1016521.0,148,130,18,12732,10413,2319,1230534.0,1002931.0,1002931.0,9.63,9.81,9.63,9.81
2023-11-29 14:15,62,46,16,4384,3029,1355,423727.0,290944.0,290944.0,61,43,18,4551,3136,1415,439917.0,301295.0,301295.0,9.61,9.8,9.61,9.8
2023-11-29 14:20,60,43,17,4900,3219,1681,473584.0,308672.0,308672.0,63,44,19,4952,3281,1671,478709.0,314648.0,314648.0,9.59,9.81,9.59,9.82
2023-11-29 14:25,63,42,21,3546,2386,1160,341651.0,228378.0,228378.0,51,39,12,3302,2277,1025,319140.0,218842.0,218842.0,9.57,9.76,9.61,9.79
2023-11-29 14:30,5,2,3,9,2,7,875.0,185.0,185.0,7,4,3,14,8,6,1346.0,753.0,753.0,9.27,9.85,9.42,9.89
2023-11-29 14:35,10,5,5,65,6,59,5722.0,570.0,570.0,6,2,4,11,2,9,1068.0,185.0,185.0,9.5,8.73,9.27,9.81
2023-11-29 14:40,19,11,8,850,720,130,72380.0,59775.0,59775.0,16,10,6,693,628,65,66872.0,60550.0,60550.0,8.3,9.7,9.64,9.73
2023-11-29 14:45,44,35,9,3335,2686,649,321878.0,258513.0,258513.0,41,34,7,3231,2594,637,312158.0,249684.0,249684.0,9.62,9.76,9.63,9.81
2023-11-29 14:50,71,48,23,5246,3284,1962,504501.0,314335.0,314335.0,60,43,17,5179,3291,1888,500548.0,315482.0,315482.0,9.57,9.69,9.59,9.8
2023-11-29 14:55,49,23,26,4433,2383,2050,428211.0,227543.0,227543.0,50,25,25,4396,2358,2038,424818.0,225168.0,225168.0,9.55,9.79,9.55,9.8
2023-11-29 15:00,133,54,79,10930,5841,5089,1055902.0,558759.0,558759.0,133,55,78,10716,5912,4804,1034903.0,565186.0,565186.0,9.57,9.77,9.56,9.78
2023-11-29 15:05,20,8,12,1635,812,823,157981.0,77357.0,77357.0,21,12,9,1818,1012,806,175162.0,96089.0,96089.0,9.53,9.8,9.49,9.81
2023-11-29 15:10,55,36,19,4475,2987,1488,423326.0,277196.0,277196.0,47,31,16,4075,2702,1373,393860.0,259283.0,259283.0,9.28,9.82,9.6,9.8
2023-11-29 15:15,165,143,22,13796,11662,2134,1332559.0,1123228.0,1123228.0,156,139,17,13848,11728,2120,1337545.0,1129594.0,1129594.0,9.63,9.81,9.63,9.81
2023-11-29 15:20,103,92,11,8214,7341,873,793412.0,708124.0,708124.0,98,91,7,8273,7369,904,799238.0,710851.0,710851.0,9.65,9.77,9.65,9.78
2023-11-29 15:25,263,216,47,23995,18931,5064,2317134.0,1821621.0,1821621.0,259,215,44,23840,18831,5009,2302245.0,1812032.0,1812032.0,9.62,9.78,9.62,9.79
2023-11-29 15:30,34,15,19,2054,964,1090,188236.0,91997.0,91997.0,32,14,18,2093,1104,989,202207.0,105513.0,105513.0,9.54,8.83,9.56,9.78
2023-11-29 15:35,22,16,6,1749,1146,603,168610.0,109575.0,109575.0,18,12,6,1761,1070,691,170761.0,102333.0,102333.0,9.56,9.79,9.56,9.9
2023-11-29 15:40,47,32,15,4642,2817,1825,445254.0,266609.0,266609.0,42,29,13,4427,2613,1814,426925.0,249341.0,249341.0,9.46,9.79,9.54,9.79
2023-11-29 15:45,169,59,110,15061,6384,8677,1449399.0,607354.0,607354.0,155,53,102,15162,6492,8670,1462971.0,617946.0,617946.0,9.51,9.7,9.52,9.75
2023-11-29 15:50,75,14,61,4648,1393,3255,447481.0,131656.0,131656.0,74,16,58,4593,1386,3207,441573.0,130298.0,130298.0,9.45,9.7,9.4,9.71
2023-11-29 15:55,145,47,98,13036,5874,7162,1257634.0,560317.0,560317.0,144,45,99,13362,5990,7372,1289107.0,571254.0,571254.0,9.54,9.74,9.54,9.74
2023-11-29 16:00,25,10,15,1694,767,927,162550.0,72965.0,72965.0,20,8,12,1682,764,918,162263.0,72761.0,72761.0,9.51,9.66,9.52,9.75
2023-11-29 16:05,37,18,19,2527,1376,1151,241470.0,131428.0,131428.0,31,14,17,2494,1358,1136,240528.0,129705.0,129705.0,9.55,9.56,9.55,9.76
2023-11-29 16:10,54,25,29,4847,2441,2406,467397.0,232829.0,232829.0,50,22,28,4927,2513,2414,475125.0,239769.0,239769.0,9.54,9.75,9.54,9.75
2023-11-29 16:15,10,7,3,585,354,231,56503.0,33808.0,33808.0,8,4,4,511,272,239,49380.0,25916.0,25916.0,9.55,9.82,9.53,9.82
2023-11-29 16:20,58,25,33,4638,2176,2462,447247.0,207852.0,207852.0,53,22,31,4606,2248,2358,444125.0,214791.0,214791.0,9.55,9.72,9.55,9.73
2023-11-29 16:25,49,12,37,3830,1504,2326,369806.0,142916.0,142916.0,39,9,30,3564,1402,2162,343884.0,133213.0,133213.0,9.5,9.75,9.5,9.74
2023-11-29 16:30,15,8,7,683,275,408,65637.0,26019.0,26019.0,9,4,5,707,302,405,68221.0,28789.0,28789.0,9.46,9.71,9.53,9.74
2023-11-29 16:35,14,9,5,398,333,65,38118.0,31675.0,31675.0,9,5,4,277,205,72,26884.0,19690.0,19690.0,9.51,9.91,9.6,9.99
2023-11-29 16:40,129,42,87,9127,3639,5488,874022.0,341005.0,341005.0,117,34,83,9076,3592,5484,875882.0,343250.0,343250.0,9.37,9.71,9.56,9.71
2023-11-29 16:45,239,69,170,15261,6118,9143,1472505.0,585095.0,585095.0,234,67,167,15182,6049,9133,1464904.0,578458.0,578458.0,9.56,9.71,9.56,9.71
2023-11-29 16:50,140,39,101,8904,3385,5519,857470.0,323361.0,323361.0,130,32,98,8853,3387,5466,854815.0,323527.0,323527.0,9.55,9.68,9.55,9.72
2023-11-29 16:55,139,34,105,12652,3205,9447,1095227.0,304172.0,304172.0,117,22,95,10895,3123,7772,1048553.0,294792.0,294792.0,9.49,8.37,9.44,9.7
2023-11-29 17:00,844,135,709,70732,16716,54016,6808131.0,1583980.0,1583980.0,817,118,699,70158,16287,53871,6755163.0,1544073.0,1544073.0,9.48,9.67,9.48,9.67
2023-11-29 17:05,717,86,631,60293,13056,47237,5807293.0,1235971.0,1235971.0,699,81,618,60273,13201,47072,5804841.0,1249494.0,1249494.0,9.47,9.68,9.47,9.68
2023-11-29 17:10,286,63,223,23834,7631,16203,2290806.0,725861.0,725861.0,276,54,222,23551,7321,16230,2264707.0,697101.0,697101.0,9.51,9.66,9.52,9.66
2023-11-29 17:15,214,48,166,18375,4845,13530,1766746.0,459378.0,459378.0,199,39,160,18258,4789,13469,1757308.0,454274.0,454274.0,9.48,9.66,9.49,9.67
2023-11-29 17:20,277,39,238,23343,4710,18633,2248080.0,446531.0,446531.0,266,34,232,23327,4700,18627,2246917.0,445570.0,445570.0,9.48,9.67,9.48,9.67
2023-11-29 17:25,303,27,276,24521,3816,20705,2361935.0,361620.0,361620.0,304,29,275,24614,3858,20756,2371531.0,365625.0,365625.0,9.48,9.66,9.48,9.66
2023-11-29 17:30,181,19,162,13812,1727,12085,1330288.0,163594.0,163594.0,174,14,160,13703,1673,12030,1320259.0,158499.0,158499.0,9.47,9.65,9.47,9.66
2023-11-29 17:35,418,115,303,41597,14874,26723,4004574.0,1413297.0,1413297.0,400,107,293,41223,14657,26566,3969211.0,1392362.0,1392362.0,9.5,9.7,9.5,9.7
2023-11-29 17:40,373,110,263,33345,13577,19768,3208643.0,1288807.0,1288807.0,369,108,261,33122,13448,19674,3187089.0,1276384.0,1276384.0,9.49,9.71,9.49,9.71
2023-11-29 17:45,535,152,383,45633,17018,28615,4390145.0,1616167.0,1616167.0,515,139,376,45839,17196,28643,4409644.0,1632758.0,1632758.0,9.5,9.69,9.49,9.69
2023-11-29 17:50,2222,366,1856,188232,53666,134566,18142607.0,5092349.0,5092349.0,2216,364,1852,187740,53589,134151,18092946.0,5084950.0,5084950.0,9.49,9.7,9.49,9.7
2023-11-29 17:55,1353,277,1076,120854,40104,80750,11649918.0,3813441.0,3813441.0,1337,271,1066,120548,39774,80774,11620517.0,3781808.0,3781808.0,9.51,9.7,9.51,9.7
2023-11-29 18:00,2437,2147,290,199484,160760,38724,19189857.0,15411445.0,15411445.0,2431,2143,288,199515,160914,38601,19192787.0,15426215.0,15426215.0,9.59,9.76,9.59,9.76
2023-11-29 18:05,1658,1517,141,133522,109963,23559,12844928.0,10542390.0,10542390.0,1649,1512,137,133500,109882,23618,12842837.0,10534620.0,10534620.0,9.59,9.77,9.59,9.77
2023-11-29 18:10,535,505,30,41202,36387,4815,3962671.0,3491731.0,3491731.0,530,504,26,41200,36398,4802,3962507.0,3492750.0,3492750.0,9.6,9.78,9.6,9.78
2023-11-29 18:15,2386,1840,546,193423,150937,42486,18622512.0,14479958.0,14479958.0,2375,1837,538,193309,150846,42463,18611402.0,14471085.0,14471085.0,9.59,9.75,9.59,9.75
2023-11-29 18:20,1572,1324,248,121470,107195,14275,11689423.0,10292800.0,10292800.0,1577,1325,252,121456,107193,14263,11688046.0,10292562.0,10292562.0,9.6,9.78,9.6,9.78
2023-11-29 18:25,594,497,97,46813,40427,6386,4505581.0,3880701.0,3880701.0,582,494,88,46574,40432,6142,4482434.0,3881261.0,3881261.0,9.6,9.79,9.6,9.79
2023-11-29 18:30,2226,1729,497,176222,145782,30440,16956373.0,13991314.0,13991314.0,2220,1723,497,176744,146075,30669,17006954.0,14019308.0,14019308.0,9.6,9.74,9.6,9.74
2023-11-29 18:35,791,580,211,44940,41730,3210,4318822.0,4008134.0,4008134.0,799,590,209,45178,41994,3184,4340874.0,4032715.0,4032715.0,9.6,9.68,9.6,9.68
2023-11-30 10:00,437,218,219,12119,4575,7544,1269605.0,428075.0,428075.0,138,121,17,3764,3122,642,361816.0,299652.0,299652.0,9.36,11.15,9.6,9.68
2023-11-30 10:05,92,35,57,733,405,328,72205.0,38644.0,38644.0,61,35,26,568,392,176,54590.0,37552.0,37552.0,9.54,10.23,9.58,9.68
2023-11-30 10:10,65,38,27,1408,984,424,135040.0,93847.0,93847.0,48,32,16,917,820,97,87578.0,78228.0,78228.0,9.54,9.72,9.54,9.64
2023-11-30 10:15,377,175,202,18063,8735,9328,1741879.0,826950.0,826950.0,146,75,71,16629,8594,8035,1598651.0,814429.0,814429.0,9.47,9.81,9.48,9.76
2023-11-30 10:20,352,219,133,40850,21350,19500,3927078.0,2024351.0,2024351.0,331,207,124,39965,20560,19405,3843575.0,1949711.0,1949711.0,9.48,9.76,9.48,9.76
2023-11-30 10:25,312,157,155,28644,14515,14129,2743201.0,1373180.0,1373180.0,288,144,144,28238,14394,13844,2710458.0,1362035.0,1362035.0,9.46,9.7,9.46,9.74
2023-11-30 10:30,56,21,35,1956,942,1014,184801.0,88855.0,88855.0,29,8,21,1851,855,996,177683.0,80876.0,80876.0,9.43,9.46,9.46,9.72
2023-11-30 10:35,355,282,73,26039,17612,8427,2498678.0,1676840.0,1676840.0,335,258,77,25849,17417,8432,2480383.0,1658153.0,1658153.0,9.52,9.75,9.52,9.75
2023-11-30 10:40,8789,8756,33,334262,331843,2419,32053904.0,31817863.0,31817863.0,8781,8749,32,334171,331749,2422,32045516.0,31809181.0,31809181.0,9.59,9.76,9.59,9.76
2023-11-30 10:45,575,462,113,39541,27465,12076,3807196.0,2628961.0,2628961.0,531,442,89,38814,26947,11867,3741700.0,2578789.0,2578789.0,9.57,9.76,9.57,9.8
2023-11-30 10:50,1137,1107,30,49899,45772,4127,4815545.0,4410720.0,4410720.0,1130,1099,31,49770,45669,4101,4803743.0,4401567.0,4401567.0,9.64,9.81,9.64,9.81
2023-11-30 10:55,768,671,97,56694,41456,15238,5469306.0,3976023.0,3976023.0,763,672,91,56658,41450,15208,5466642.0,3975566.0,3975566.0,9.59,9.8,9.59,9.8
2023-11-30 11:00,1316,1139,177,100342,72115,28227,9677093.0,6912368.0,6912368.0,1311,1142,169,99931,72095,27836,9637912.0,6909955.0,6909955.0,9.59,9.79,9.58,9.8
2023-11-30 11:05,599,504,95,45356,34665,10691,4364862.0,3318783.0,3318783.0,591,502,89,44805,34470,10335,4312704.0,3301554.0,3301554.0,9.57,9.78,9.58,9.78
2023-11-30 11:10,212,176,36,14871,11638,3233,1425746.0,1115248.0,1115248.0,205,171,34,14894,11800,3094,1433208.0,1130828.0,1130828.0,9.58,9.6,9.58,9.77
2023-11-30 11:15,417,307,110,29903,22721,7182,2873095.0,2172895.0,2172895.0,400,300,100,29457,22531,6926,2830226.0,2155541.0,2155541.0,9.56,9.75,9.57,9.74
2023-11-30 11:20,460,267,193,42317,27665,14652,4062380.0,2641823.0,2641823.0,450,260,190,42027,27378,14649,4040385.0,2614954.0,2614954.0,9.55,9.7,9.55,9.73
2023-11-30 11:25,567,241,326,52580,27630,24950,5041733.0,2630121.0,2630121.0,554,236,318,51921,27711,24210,4992554.0,2637610.0,2637610.0,9.52,9.67,9.52,9.73
2023-11-30 11:30,22,12,10,959,466,493,91866.0,43746.0,43746.0,13,5,8,777,391,386,74608.0,37195.0,37195.0,9.39,9.76,9.51,9.69
2023-11-30 11:35,405,96,309,41592,11106,30486,3906911.0,1047561.0,1047561.0,371,84,287,40288,10641,29647,3865128.0,1004299.0,1004299.0,9.43,9.38,9.44,9.65
2023-11-30 11:40,444,100,344,48854,9640,39214,4688155.0,908174.0,908174.0,435,90,345,48661,9463,39198,4669758.0,891474.0,891474.0,9.42,9.64,9.42,9.64
2023-11-30 11:45,224,39,185,23570,2149,21421,2265289.0,202450.0,202450.0,206,27,179,23378,2028,21350,2247339.0,191267.0,191267.0,9.42,9.63,9.43,9.63
2023-11-30 11:50,254,30,224,23582,493,23089,2264730.0,44416.0,44416.0,250,27,223,23575,476,23099,2266591.0,45175.0,45175.0,9.01,9.62,9.49,9.62
2023-11-30 11:55,246,32,214,23667,1560,22107,2274100.0,147033.0,147033.0,239,26,213,23657,1517,22140,2273509.0,143242.0,143242.0,9.43,9.62,9.44,9.62
2023-11-30 12:00,260,48,212,25884,2166,23718,2484730.0,204198.0,204198.0,245,35,210,25789,2106,23683,2476186.0,198518.0,198518.0,9.43,9.62,9.43,9.62
2023-11-30 12:05,155,15,140,14876,304,14572,1428940.0,28721.0,28721.0,158,20,138,14518,478,14040,1394231.0,45148.0,45148.0,9.45,9.61,9.45,9.61
2023-11-30 12:10,155,9,146,12899,303,12596,1235571.0,27803.0,27803.0,154,8,146,12880,247,12633,1234635.0,23300.0,23300.0,9.18,9.59,9.43,9.59
2023-11-30 12:15,137,15,122,10859,478,10381,1038364.0,42782.0,42782.0,135,15,120,11101,518,10583,1063059.0,48171.0,48171.0,8.95,9.59,9.3,9.59
2023-11-30 12:20,132,9,123,11175,809,10366,1066395.0,74492.0,74492.0,130,9,121,10837,809,10028,1038177.0,75718.0,75718.0,9.21,9.57,9.36,9.6
2023-11-30 12:25,232,22,210,19393,1513,17880,1858782.0,142579.0,142579.0,222,16,206,19305,1479,17826,1850532.0,139357.0,139357.0,9.42,9.6,9.42,9.6
2023-11-30 12:30,207,27,180,21042,2888,18154,2014633.0,271964.0,271964.0,208,32,176,21261,3133,18128,2035721.0,294560.0,294560.0,9.42,9.6,9.4,9.6
2023-11-30 12:35,126,14,112,12264,1735,10529,1171800.0,163200.0,163200.0,122,13,109,12241,1635,10606,1172798.0,154136.0,154136.0,9.41,9.58,9.43,9.6
2023-11-30 12:40,175,14,161,16805,1073,15732,1610639.0,101151.0,101151.0,171,13,158,16774,1068,15706,1607794.0,100687.0,100687.0,9.43,9.6,9.43,9.6
2023-11-30 12:45,153,12,141,14340,427,13913,1373474.0,40195.0,40195.0,151,10,141,14227,358,13869,1363517.0,33751.0,33751.0,9.41,9.58,9.43,9.59
2023-11-30 12:50,127,9,118,11794,245,11549,1130621.0,22997.0,22997.0,123,7,116,11704,253,11451,1122018.0,23846.0,23846.0,9.39,9.59,9.43,9.59
2023-11-30 12:55,223,28,195,23029,4065,18964,2205533.0,383305.0,383305.0,218,26,192,22895,4039,18856,2193096.0,380857.0,380857.0,9.43,9.61,9.43,9.61
2023-11-30 13:00,211,30,181,23022,4022,19000,2204924.0,379132.0,379132.0,202,27,175,23131,4071,19060,2215537.0,383854.0,383854.0,9.43,9.61,9.43,9.61
2023-11-30 13:05,302,44,258,31946,4222,27724,3060047.0,398490.0,398490.0,292,37,255,31699,4173,27526,3036537.0,393863.0,393863.0,9.44,9.6,9.44,9.6
2023-11-30 13:10,208,31,177,22555,3267,19288,2159968.0,307902.0,307902.0,207,31,176,22551,3252,19299,2159745.0,306453.0,306453.0,9.42,9.6,9.42,9.6
2023-11-30 13:15,132,21,111,13846,2352,11494,1326046.0,221821.0,221821.0,129,21,108,13849,2359,11490,1326323.0,222485.0,222485.0,9.43,9.61,9.43,9.61
2023-11-30 13:20,167,42,125,16696,2778,13918,1599513.0,262994.0,262994.0,156,32,124,16561,2644,13917,1586466.0,250126.0,250126.0,9.47,9.6,9.46,9.6
2023-11-30 13:25,71,18,53,6913,948,5965,662030.0,90028.0,90028.0,65,15,50,7010,941,6069,671903.0,89646.0,89646.0,9.5,9.59,9.53,9.59
2023-11-30 13:30,132,35,97,13324,2630,10694,1275355.0,248760.0,248760.0,121,30,91,13078,2568,10510,1252531.0,242988.0,242988.0,9.46,9.6,9.46,9.61
2023-11-30 13:35,208,37,171,22282,4238,18044,2132684.0,399151.0,399151.0,201,32,169,22074,4103,17971,2112965.0,386410.0,386410.0,9.42,9.61,9.42,9.61
2023-11-30 13:40,230,40,190,23374,3418,19956,2237181.0,321667.0,321667.0,224,35,189,23361,3405,19956,2236068.0,320593.0,320593.0,9.41,9.6,9.42,9.6
2023-11-30 13:45,115,15,100,11177,697,10480,1070919.0,66093.0,66093.0,111,13,98,11190,712,10478,1072151.0,67520.0,67520.0,9.48,9.59,9.48,9.59
2023-11-30 13:50,122,16,106,12684,780,11904,1215102.0,73764.0,73764.0,115,11,104,12280,578,11702,1176872.0,54776.0,54776.0,9.46,9.59,9.48,9.59
2023-11-30 13:55,106,18,88,10175,664,9511,973814.0,63151.0,63151.0,98,13,85,10165,614,9551,973719.0,58395.0,58395.0,9.51,9.57,9.51,9.58
2023-11-30 14:00,64,9,55,6799,41,6758,651588.0,3781.0,3781.0,62,8,54,6771,42,6729,649024.0,3949.0,3949.0,9.22,9.59,9.4,9.59
2023-11-30 14:05,145,21,124,16498,1876,14622,1579140.0,177029.0,177029.0,139,19,120,16458,1863,14595,1575429.0,175845.0,175845.0,9.44,9.59,9.44,9.59
2023-11-30 14:10,224,27,197,25341,2808,22533,2426312.0,264556.0,264556.0,218,21,197,25369,2767,22602,2430253.0,260657.0,260657.0,9.42,9.59,9.42,9.6
2023-11-30 14:15,359,66,293,42700,8142,34558,4081564.0,764666.0,764666.0,342,56,286,42074,7652,34422,4023179.0,719074.0,719074.0,9.39,9.6,9.4,9.6
2023-11-30 14:20,179,30,149,19830,2873,16957,1896051.0,269183.0,269183.0,170,24,146,19793,2854,16939,1892696.0,267543.0,267543.0,9.37,9.59,9.37,9.59
2023-11-30 14:25,132,15,117,13776,1045,12731,1318935.0,98284.0,98284.0,127,10,117,13759,1028,12731,1317331.0,96662.0,96662.0,9.41,9.59,9.4,9.59
2023-11-30 14:30,105,7,98,10503,47,10456,1005835.0,4461.0,4461.0,106,8,98,10506,50,10456,1006101.0,4745.0,4745.0,9.49,9.58,9.49,9.58
2023-11-30 14:35,207,37,170,23598,4863,18735,2255921.0,456631.0,456631.0,202,33,169,23578,4853,18725,2254665.0,456337.0,456337.0,9.39,9.6,9.4,9.6
2023-11-30 14:40,71,8,63,7424,322,7102,710088.0,28851.0,28851.0,67,5,62,7338,285,7053,702839.0,26720.0,26720.0,8.96,9.59,9.38,9.59
2023-11-30 14:45,268,180,88,27569,16888,10681,2633624.0,1605655.0,1605655.0,248,169,79,23973,13935,10038,2291453.0,1325258.0,1325258.0,9.51,9.62,9.51,9.63
2023-11-30 14:50,200,189,11,19197,19068,129,1831909.0,1820374.0,1820374.0,193,184,9,19076,19043,33,1821271.0,1818034.0,1818034.0,9.55,8.94,9.55,9.81
2023-11-30 14:55,309,190,119,34796,24379,10417,3334646.0,2326197.0,2326197.0,295,182,113,34803,24464,10339,3335427.0,2333946.0,2333946.0,9.54,9.68,9.54,9.69
2023-11-30 15:00,347,162,185,35152,22401,12751,3370351.0,2138163.0,2138163.0,333,153,180,34795,22405,12390,3336073.0,2138560.0,2138560.0,9.54,9.66,9.55,9.67
2023-11-30 15:05,379,144,235,31917,15422,16495,3067940.0,1471190.0,1471190.0,362,130,232,31536,15012,16524,3031150.0,1431736.0,1431736.0,9.54,9.68,9.54,9.68
2023-11-30 15:10,44,21,23,3410,1581,1829,329020.0,150698.0,150698.0,37,15,22,3251,1401,1850,313586.0,133327.0,133327.0,9.53,9.75,9.52,9.74
2023-11-30 15:15,812,18,794,38106,385,37721,3683225.0,36953.0,36953.0,806,22,784,38145,477,37668,3687118.0,45774.0,45774.0,9.6,9.67,9.6,9.67
2023-11-30 15:20,382,25,357,18615,915,17700,1798571.0,87066.0,87066.0,375,19,356,18553,844,17709,1793143.0,80425.0,80425.0,9.52,9.67,9.53,9.67
2023-11-30 15:25,44,18,26,1878,572,1306,181061.0,54377.0,54377.0,40,16,24,1874,570,1304,180756.0,54274.0,54274.0,9.51,9.7,9.52,9.7
2023-11-30 15:30,47,16,31,1843,173,1670,178025.0,16602.0,16602.0,40,11,29,1818,158,1660,175646.0,15173.0,15173.0,9.6,9.67,9.6,9.67
2023-11-30 15:35,129,22,107,7852,1401,6451,757953.0,133100.0,133100.0,124,19,105,7629,1359,6270,736598.0,129189.0,129189.0,9.5,9.69,9.51,9.69
2023-11-30 15:40,830,251,579,50019,14040,35979,4812742.0,1332618.0,1332618.0,823,246,577,50111,14053,36058,4824496.0,1333861.0,1333861.0,9.49,9.67,9.49,9.68
2023-11-30 15:45,1257,389,868,67585,17222,50363,6510855.0,1637142.0,1637142.0,1255,387,868,67572,17198,50374,6509708.0,1634935.0,1634935.0,9.51,9.68,9.51,9.68
2023-11-30 15:50,2279,1286,993,134822,59162,75660,12977377.0,5628784.0,5628784.0,2267,1276,991,134569,59113,75456,12953029.0,5624090.0,5624090.0,9.51,9.71,9.51,9.71
2023-11-30 15:55,876,866,10,14455,13481,974,1389107.0,1294223.0,1294223.0,875,865,10,14903,13730,1173,1432074.0,1317755.0,1317755.0,9.6,9.74,9.6,9.75
2023-11-30 16:00,745,716,29,20047,15074,4973,1927528.0,1442001.0,1442001.0,745,715,30,20053,15071,4982,1928494.0,1442099.0,1442099.0,9.57,9.76,9.57,9.76
2023-11-30 16:05,753,662,91,40922,25339,15583,3934108.0,2413982.0,2413982.0,751,664,87,40730,25145,15585,3915856.0,2395508.0,2395508.0,9.53,9.76,9.53,9.76
2023-11-30 16:10,191,151,40,17210,12866,4344,1652883.0,1229773.0,1229773.0,185,147,38,16642,12513,4129,1598142.0,1195856.0,1195856.0,9.56,9.74,9.56,9.74
2023-11-30 16:15,94,85,9,6039,5227,812,581045.0,501627.0,501627.0,89,83,6,6025,5223,802,579799.0,501342.0,501342.0,9.6,9.78,9.6,9.78
2023-11-30 16:20,401,346,55,33099,24454,8645,3183245.0,2340967.0,2340967.0,394,343,51,33150,24562,8588,3189837.0,2351276.0,2351276.0,9.57,9.74,9.57,9.76
2023-11-30 16:25,414,334,80,25346,18316,7030,2438909.0,1755071.0,1755071.0,406,331,75,25232,18217,7015,2428187.0,1745711.0,1745711.0,9.58,9.73,9.58,9.73
2023-11-30 16:30,249,183,66,17661,11470,6191,1699859.0,1097445.0,1097445.0,247,182,65,17657,11469,6188,1699771.0,1097351.0,1097351.0,9.57,9.73,9.57,9.74
2023-11-30 16:35,312,240,72,21580,14348,7232,2076406.0,1372248.0,1372248.0,310,242,68,21536,14350,7186,2072266.0,1372511.0,1372511.0,9.56,9.74,9.56,9.74
2023-11-30 16:40,1351,608,743,90932,43052,47880,8757361.0,4102200.0,4102200.0,1343,609,734,90837,43085,47752,8748575.0,4105290.0,4105290.0,9.53,9.72,9.53,9.72
2023-11-30 16:45,871,342,529,77989,38718,39271,7496665.0,3688686.0,3688686.0,852,337,515,77743,38739,39004,7479561.0,3690697.0,3690697.0,9.53,9.7,9.53,9.71
2023-11-30 16:50,203,48,155,15397,5214,10183,1481647.0,498042.0,498042.0,193,43,150,14888,5237,9651,1432169.0,500287.0,500287.0,9.55,9.66,9.55,9.66
2023-11-30 16:55,374,131,243,35186,15473,19713,3380880.0,1476558.0,1476558.0,357,128,229,34337,15129,19208,3299546.0,1443719.0,1443719.0,9.54,9.66,9.54,9.66
2023-11-30 17:00,122,49,73,11246,5702,5544,1074347.0,543028.0,543028.0,114,45,69,11321,5736,5585,1086458.0,546331.0,546331.0,9.52,9.58,9.52,9.67
2023-11-30 17:05,169,80,89,12134,7483,4651,1161575.0,712308.0,712308.0,155,67,88,12018,7403,4615,1151587.0,705749.0,705749.0,9.52,9.66,9.53,9.66
2023-11-30 17:10,87,27,60,5425,2466,2959,520459.0,235120.0,235120.0,83,24,59,5343,2422,2921,512875.0,231211.0,231211.0,9.53,9.64,9.55,9.64
2023-11-30 17:15,358,127,231,31326,14906,16420,3007334.0,1414341.0,1414341.0,340,118,222,31302,15053,16249,3005487.0,1428313.0,1428313.0,9.49,9.7,9.49,9.71
2023-11-30 17:20,996,360,636,75743,39441,36302,7271170.0,3745748.0,3745748.0,995,359,636,75749,39438,36311,7271711.0,3745439.0,3745439.0,9.5,9.71,9.5,9.71
2023-11-30 17:25,187,46,141,11698,5072,6626,1123226.0,482811.0,482811.0,187,47,140,11368,4886,6482,1091696.0,465054.0,465054.0,9.52,9.67,9.52,9.67
2023-11-30 17:30,13,5,8,94,5,89,8941.0,370.0,370.0,11,3,8,92,3,89,8846.0,275.0,275.0,7.42,9.63,9.18,9.63
2023-11-30 17:35,19,7,12,885,442,443,84359.0,41789.0,41789.0,14,6,8,838,404,434,80331.0,38145.0,38145.0,9.45,9.61,9.44,9.72
2023-11-30 17:40,56,27,29,3724,2395,1329,347507.0,228590.0,228590.0,52,26,26,3588,2394,1194,343701.0,228519.0,228519.0,9.54,8.95,9.55,9.65
2023-11-30 17:45,85,5,80,3265,90,3175,314172.0,8609.0,8609.0,79,3,76,3139,13,3126,302180.0,1226.0,1226.0,9.57,9.62,9.44,9.63
2023-11-30 17:50,104,23,81,5526,1777,3749,530050.0,168795.0,168795.0,97,19,78,5523,1743,3780,530300.0,165977.0,165977.0,9.5,9.64,9.52,9.64
2023-11-30 17:55,44,15,29,2333,1147,1186,223309.0,109344.0,109344.0,43,15,28,2268,1145,1123,217415.0,109197.0,109197.0,9.53,9.61,9.54,9.64
2023-11-30 18:00,308,76,232,24624,10032,14592,2356823.0,950816.0,950816.0,298,70,228,24541,10008,14533,2353507.0,949110.0,949110.0,9.48,9.64,9.48,9.66
2023-11-30 18:05,1073,262,811,99980,38434,61546,9588732.0,3632566.0,3632566.0,1058,252,806,100096,38592,61504,9600010.0,3647635.0,3647635.0,9.45,9.68,9.45,9.68
2023-11-30 18:10,709,163,546,55969,19590,36379,5371295.0,1853509.0,1853509.0,697,158,539,55919,19450,36469,5366794.0,1839925.0,1839925.0,9.46,9.67,9.46,9.67
2023-11-30 18:15,296,56,240,21952,7541,14411,2107704.0,715987.0,715987.0,293,54,239,21651,7359,14292,2078931.0,698715.0,698715.0,9.49,9.66,9.49,9.66
2023-11-30 18:20,342,76,266,27176,9863,17313,2608750.0,935249.0,935249.0,339,75,264,27569,10026,17543,2646714.0,950623.0,950623.0,9.48,9.67,9.48,9.67
2023-11-30 18:25,151,64,87,8751,4540,4211,835284.0,429816.0,429816.0,144,57,87,8412,4193,4219,807581.0,401319.0,401319.0,9.47,9.63,9.57,9.63
2023-11-30 18:30,150,56,94,9334,5125,4209,896043.0,490811.0,490811.0,144,56,88,9069,5234,3835,870566.0,501262.0,501262.0,9.58,9.63,9.58,9.63
2023-11-30 18:35,120,41,79,6625,2686,3939,617327.0,251306.0,251306.0,127,53,74,6406,2690,3716,613246.0,256187.0,256187.0,9.36,9.29,9.52,9.61
2023-12-01 10:00,1152,472,680,47832,33212,14620,4599346.0,3145341.0,3145341.0,880,374,506,41289,31554,9735,3933942.0,3000923.0,3000923.0,9.47,9.95,9.51,9.58
2023-12-01 10:05,413,198,215,12448,8961,3487,1191614.0,850122.0,850122.0,200,95,105,11893,8900,2993,1132808.0,845359.0,845359.0,9.49,9.79,9.5,9.6
2023-12-01 10:10,251,39,212,12579,2645,9934,1201165.0,245310.0,245310.0,180,22,158,11012,1897,9115,1053953.0,179785.0,179785.0,9.27,9.62,9.48,9.59
2023-12-01 10:15,261,109,152,20422,8856,11566,1953013.0,839551.0,839551.0,251,101,150,19531,8235,11296,1869067.0,781679.0,781679.0,9.48,9.63,9.49,9.63
2023-12-01 10:20,279,106,173,31059,13086,17973,2971100.0,1233566.0,1233566.0,262,103,159,31081,13325,17756,2972643.0,1256231.0,1256231.0,9.43,9.67,9.43,9.67
2023-12-01 10:25,210,86,124,18204,7971,10233,1734552.0,748253.0,748253.0,179,73,106,17316,7870,9446,1650195.0,739311.0,739311.0,9.39,9.64,9.39,9.64
2023-12-01 10:30,283,86,197,28480,8747,19733,2719561.0,820336.0,820336.0,306,94,212,29023,8619,20404,2774497.0,809398.0,809398.0,9.38,9.62,9.39,9.63
2023-12-01 10:35,425,126,299,42209,11965,30244,4035612.0,1124489.0,1124489.0,409,114,295,41859,11887,29972,4002659.0,1117624.0,1117624.0,9.4,9.63,9.4,9.63
2023-12-01 10:40,493,153,340,55664,16948,38716,5317675.0,1592944.0,1592944.0,471,140,331,55249,16920,38329,5278515.0,1590520.0,1590520.0,9.4,9.62,9.4,9.62
2023-12-01 10:45,347,119,228,38662,13281,25381,3684022.0,1248358.0,1248358.0,330,107,223,38379,13135,25244,3663661.0,1234460.0,1234460.0,9.4,9.6,9.4,9.62
2023-12-01 10:50,143,40,103,10862,2088,8774,1036386.0,194020.0,194020.0,132,34,98,10703,2018,8685,1023657.0,189732.0,189732.0,9.29,9.6,9.4,9.6
2023-12-01 10:55,101,33,68,8711,1904,6807,833347.0,179606.0,179606.0,84,27,57,8361,1741,6620,799611.0,164139.0,164139.0,9.43,9.6,9.43,9.6
2023-12-01 11:00,184,28,156,19077,2389,16688,1822782.0,224384.0,224384.0,161,24,137,18425,2469,15956,1763187.0,232134.0,232134.0,9.39,9.58,9.4,9.6
2023-12-01 11:05,205,28,177,21405,2295,19110,2046325.0,214670.0,214670.0,198,24,174,21371,2266,19105,2045528.0,212973.0,212973.0,9.35,9.58,9.4,9.59
2023-12-01 11:10,1658,1332,326,136486,106517,29969,12854614.0,9956611.0,9956611.0,1625,1315,310,133795,104234,29561,12795766.0,9931731.0,9931731.0,9.35,9.67,9.53,9.69
2023-12-01 11:15,1533,1038,495,121586,88526,33060,11644911.0,8436862.0,8436862.0,1516,1029,487,120983,88227,32756,11587683.0,8409135.0,8409135.0,9.53,9.7,9.53,9.7
2023-12-01 11:20,1146,636,510,139917,96190,43727,13391504.0,9141449.0,9141449.0,1119,626,493,139354,96102,43252,13338510.0,9133377.0,9133377.0,9.5,9.72,9.5,9.72
2023-12-01 11:25,569,274,295,62498,41444,21054,5981298.0,3938702.0,3938702.0,564,275,289,62085,41491,20594,5941703.0,3943235.0,3943235.0,9.5,9.7,9.5,9.7
2023-12-01 11:30,331,97,234,26281,11939,14342,2514585.0,1132975.0,1132975.0,303,77,226,25796,11543,14253,2470106.0,1095690.0,1095690.0,9.49,9.63,9.49,9.64
2023-12-01 11:35,309,75,234,25205,8591,16614,2414296.0,810496.0,810496.0,308,72,236,24662,8146,16516,2361745.0,768653.0,768653.0,9.43,9.65,9.44,9.65
2023-12-01 11:40,392,113,279,35830,14556,21274,3426680.0,1377039.0,1377039.0,376,102,274,35492,14296,21196,3399970.0,1352469.0,1352469.0,9.46,9.63,9.46,9.66
2023-12-01 11:45,186,12,174,9048,75,8973,869433.0,7146.0,7146.0,185,19,166,9286,311,8975,891635.0,29045.0,29045.0,9.53,9.61,9.34,9.61
2023-12-01 11:50,379,60,319,28700,7873,20827,2751963.0,742544.0,742544.0,366,51,315,28517,7863,20654,2734658.0,741798.0,741798.0,9.43,9.65,9.43,9.65
2023-12-01 11:55,565,77,488,48386,11259,37127,4614729.0,1060701.0,1060701.0,546,69,477,47952,11239,36713,4595381.0,1059203.0,1059203.0,9.42,9.57,9.42,9.63
2023-12-01 12:00,525,33,492,43893,5609,38284,4209319.0,528727.0,528727.0,521,31,490,43882,5603,38279,4208480.0,528154.0,528154.0,9.43,9.61,9.43,9.61
2023-12-01 12:05,452,40,412,36495,3851,32644,3499100.0,362903.0,362903.0,446,37,409,36927,4240,32687,3540577.0,400143.0,400143.0,9.42,9.61,9.44,9.61
2023-12-01 12:10,433,17,416,32365,1499,30866,3103310.0,141376.0,141376.0,423,13,410,32026,1243,30783,3071972.0,117161.0,117161.0,9.43,9.6,9.43,9.6
2023-12-01 12:15,320,15,305,25976,1819,24157,2490994.0,171400.0,171400.0,315,12,303,25945,1803,24142,2488229.0,169886.0,169886.0,9.42,9.6,9.42,9.6
2023-12-01 12:20,101,5,96,8647,34,8613,829408.0,3063.0,3063.0,103,7,96,8632,19,8613,828159.0,1799.0,1799.0,9.01,9.59,9.47,9.59
2023-12-01 12:25,82,6,76,6731,215,6516,646002.0,20254.0,20254.0,83,6,77,6800,234,6566,652596.0,22066.0,22066.0,9.42,9.6,9.43,9.6
2023-12-01 12:30,93,8,85,8468,421,8047,812808.0,39651.0,39651.0,83,8,75,8320,455,7865,798528.0,42894.0,42894.0,9.42,9.61,9.43,9.61
2023-12-01 12:35,169,9,160,15203,548,14655,1458025.0,51797.0,51797.0,162,4,158,15085,402,14683,1446820.0,37855.0,37855.0,9.45,9.6,9.42,9.6
2023-12-01 12:40,196,29,167,18504,3044,15460,1772894.0,287445.0,287445.0,181,21,160,18290,2932,15358,1752459.0,276817.0,276817.0,9.44,9.61,9.44,9.61
2023-12-01 12:45,176,32,144,13464,1607,11857,1290966.0,150720.0,150720.0,136,13,123,13354,1640,11714,1279946.0,154814.0,154814.0,9.38,9.62,9.44,9.61
2023-12-01 12:50,94,18,76,8437,1633,6804,808063.0,154665.0,154665.0,91,17,74,8394,1593,6801,804292.0,151017.0,151017.0,9.47,9.6,9.48,9.61
2023-12-01 12:55,92,24,68,8929,2774,6155,855430.0,263388.0,263388.0,81,22,59,8414,2546,5868,805609.0,241702.0,241702.0,9.49,9.62,9.49,9.61
2023-12-01 13:00,102,30,72,8991,2013,6978,857271.0,190252.0,190252.0,81,12,69,8779,1899,6880,841092.0,179468.0,179468.0,9.45,9.56,9.45,9.62
2023-12-01 13:05,44,6,38,4449,651,3798,426424.0,61573.0,61573.0,41,6,35,4423,652,3771,423925.0,61677.0,61677.0,9.46,9.61,9.46,9.61
2023-12-01 13:10,37,7,30,3496,748,2748,329952.0,71183.0,71183.0,42,15,27,3729,1032,2697,356395.0,97528.0,97528.0,9.52,9.42,9.45,9.6
2023-12-01 13:15,15,3,12,1207,3,1204,115840.0,269.0,269.0,13,3,10,1194,3,1191,114611.0,269.0,269.0,8.97,9.6,8.97,9.6
2023-12-01 13:20,25,7,18,2107,231,1876,202054.0,21748.0,21748.0,19,3,16,2075,202,1873,199015.0,19019.0,19019.0,9.41,9.61,9.42,9.61
2023-12-01 13:25,47,20,27,5274,2199,3075,503092.0,206600.0,206600.0,41,15,26,5209,2138,3071,498411.0,201909.0,201909.0,9.4,9.64,9.44,9.65
2023-12-01 13:30,161,18,143,14938,1845,13093,1423420.0,174574.0,174574.0,166,27,139,14757,1888,12869,1414164.0,178752.0,178752.0,9.46,9.54,9.47,9.6
2023-12-01 13:35,69,13,56,6997,828,6169,670029.0,77757.0,77757.0,63,7,56,7027,812,6215,673263.0,76435.0,76435.0,9.39,9.6,9.41,9.6
2023-12-01 13:40,49,6,43,4702,452,4250,450395.0,42622.0,42622.0,43,4,39,4546,426,4120,435669.0,40355.0,40355.0,9.43,9.59,9.47,9.6
2023-12-01 13:45,42,11,31,4634,1145,3489,422772.0,87465.0,87465.0,44,10,34,4387,865,3522,420164.0,81703.0,81703.0,7.64,9.61,9.45,9.61
2023-12-01 13:50,18,7,11,1300,406,894,124144.0,38036.0,38036.0,12,5,7,1284,403,881,122875.0,37931.0,37931.0,9.37,9.63,9.41,9.64
2023-12-01 13:55,27,10,17,2718,1068,1650,247152.0,100746.0,100746.0,22,7,15,2517,1050,1467,240702.0,99170.0,99170.0,9.43,8.87,9.44,9.65
2023-12-01 14:00,18,8,10,2059,1003,1056,196760.0,94475.0,94475.0,18,9,9,2073,1019,1054,198150.0,95980.0,95980.0,9.42,9.69,9.42,9.69
2023-12-01 14:05,6,3,3,6,3,3,569.0,269.0,269.0,6,3,3,6,3,3,569.0,269.0,269.0,8.97,10.0,8.97,10.0
2023-12-01 14:10,39,7,32,3335,426,2909,319738.0,40138.0,40138.0,34,5,29,3285,412,2873,314806.0,38807.0,38807.0,9.42,9.61,9.42,9.61
2023-12-01 14:15,47,11,36,4791,1228,3563,458696.0,115669.0,115669.0,47,12,35,4864,1238,3626,465717.0,116628.0,116628.0,9.42,9.63,9.42,9.63
2023-12-01 14:20,28,9,19,2581,618,1963,247233.0,58220.0,58220.0,21,7,14,2415,605,1810,231278.0,56976.0,56976.0,9.42,9.63,9.42,9.63
2023-12-01 14:25,37,13,24,3774,1167,2607,359215.0,109527.0,109527.0,31,12,19,3664,1165,2499,350789.0,110181.0,110181.0,9.39,9.58,9.46,9.63
2023-12-01 14:30,10,4,6,31,4,27,2482.0,370.0,370.0,7,3,4,41,18,23,3928.0,1704.0,1704.0,9.25,7.82,9.47,9.67
2023-12-01 14:35,33,8,25,2667,902,1765,254995.0,85478.0,85478.0,28,7,21,2654,899,1755,253935.0,85186.0,85186.0,9.48,9.6,9.48,9.62
2023-12-01 14:40,301,145,156,30531,17256,13275,2908277.0,1628461.0,1628461.0,281,137,144,30331,17286,13045,2896472.0,1638158.0,1638158.0,9.44,9.64,9.48,9.65
2023-12-01 14:45,166,90,76,15676,9497,6179,1495218.0,900243.0,900243.0,155,85,70,15621,9418,6203,1490944.0,892758.0,892758.0,9.48,9.63,9.48,9.64
2023-12-01 14:50,315,53,262,30065,5977,24088,2853233.0,562153.0,562153.0,296,39,257,29536,5799,23737,2823841.0,545287.0,545287.0,9.41,9.51,9.4,9.6
2023-12-01 14:55,174,44,130,19008,4551,14457,1818733.0,428424.0,428424.0,162,33,129,18982,4515,14467,1816198.0,424982.0,424982.0,9.41,9.62,9.41,9.62
2023-12-01 15:00,78,20,58,7625,1168,6457,730392.0,110961.0,110961.0,73,16,57,7578,1171,6407,725862.0,111244.0,111244.0,9.5,9.59,9.5,9.59
2023-12-01 15:05,69,18,51,6583,1406,5177,629474.0,133445.0,133445.0,63,17,46,6563,1403,5160,628311.0,133539.0,133539.0,9.49,9.58,9.52,9.59
2023-12-01 15:10,59,16,43,6284,1586,4698,601370.0,150847.0,150847.0,55,13,42,6279,1583,4696,601023.0,150648.0,150648.0,9.51,9.59,9.52,9.59
2023-12-01 15:15,77,37,40,7744,3740,4004,737693.0,354569.0,354569.0,65,33,32,7579,3606,3973,724084.0,342075.0,342075.0,9.48,9.57,9.49,9.62
2023-12-01 15:20,207,139,68,14301,7205,7096,1365515.0,684175.0,684175.0,169,109,60,13685,6618,7067,1307435.0,627775.0,627775.0,9.5,9.6,9.49,9.62
2023-12-01 15:25,652,561,91,43034,32298,10736,4116685.0,3079257.0,3079257.0,631,556,75,42294,32272,10022,4043110.0,3076672.0,3076672.0,9.53,9.66,9.53,9.64
2023-12-01 15:30,1117,995,122,82583,61879,20704,7889690.0,5893127.0,5893127.0,1107,990,117,82551,61880,20671,7888043.0,5893223.0,5893223.0,9.52,9.64,9.52,9.65
2023-12-01 15:35,669,556,113,55039,40421,14618,5265923.0,3849440.0,3849440.0,665,553,112,54806,40369,14437,5239217.0,3844462.0,3844462.0,9.52,9.69,9.52,9.66
2023-12-01 15:40,798,706,92,73589,64094,9495,7030542.0,6118854.0,6118854.0,761,688,73,70636,61854,8782,6756279.0,5903023.0,5903023.0,9.55,9.6,9.54,9.72
2023-12-01 15:45,251,236,15,30439,28754,1685,2918482.0,2754277.0,2754277.0,245,233,12,29500,27832,1668,2828398.0,2665278.0,2665278.0,9.58,9.75,9.58,9.78
2023-12-01 15:50,208,182,26,26880,22453,4427,2588665.0,2156437.0,2156437.0,195,176,19,24887,21485,3402,2395929.0,2062581.0,2062581.0,9.6,9.76,9.6,9.8
2023-12-01 15:55,71,59,12,9741,8409,1332,938267.0,807708.0,807708.0,66,57,9,9669,8267,1402,931350.0,793947.0,793947.0,9.61,9.8,9.6,9.8
2023-12-01 16:00,152,113,39,17938,15633,2305,1720718.0,1496331.0,1496331.0,139,110,29,17710,15572,2138,1700317.0,1491629.0,1491629.0,9.57,9.73,9.58,9.76
2023-12-01 16:05,382,288,94,39755,32582,7173,3801706.0,3113851.0,3113851.0,358,281,77,39167,32558,6609,3754576.0,3112239.0,3112239.0,9.56,9.59,9.56,9.72
2023-12-01 16:10,187,112,75,28778,20659,8119,2759302.0,1970307.0,1970307.0,182,107,75,28817,20698,8119,2762959.0,1974093.0,1974093.0,9.54,9.72,9.54,9.72
2023-12-01 16:15,872,140,732,67716,27056,40660,6506087.0,2578850.0,2578850.0,857,129,728,67295,26734,40561,6466877.0,2548648.0,2548648.0,9.53,9.66,9.53,9.66
2023-12-01 16:20,336,65,271,26147,10327,15820,2503816.0,979399.0,979399.0,316,57,259,26225,10666,15559,2515699.0,1012036.0,1012036.0,9.48,9.64,9.49,9.66
2023-12-01 16:25,183,90,93,21627,13437,8190,2069569.0,1275822.0,1275822.0,174,81,93,20937,12727,8210,2003527.0,1207899.0,1207899.0,9.49,9.69,9.49,9.69
2023-12-01 16:30,18,9,9,1371,616,755,131548.0,58203.0,58203.0,17,9,8,1370,616,754,131414.0,58183.0,58183.0,9.45,9.71,9.45,9.71
2023-12-01 16:35,29,14,15,1865,1178,687,177865.0,112150.0,112150.0,27,13,14,1840,1171,669,176324.0,111481.0,111481.0,9.52,9.57,9.52,9.69
2023-12-01 16:40,36,13,23,2084,1090,994,194419.0,103927.0,103927.0,29,11,18,1987,1087,900,190626.0,103655.0,103655.0,9.53,9.1,9.54,9.66
2023-12-01 16:45,23,11,12,1374,631,743,131461.0,59483.0,59483.0,16,7,9,1305,604,701,124932.0,56957.0,56957.0,9.43,9.69,9.43,9.7
2023-12-01 16:50,473,218,255,41778,27249,14529,4008436.0,2606633.0,2606633.0,467,212,255,41528,26984,14544,3984414.0,2581233.0,2581233.0,9.57,9.65,9.57,9.65
2023-12-01 16:55,1064,936,128,96921,81672,15249,9302605.0,7813807.0,7813807.0,1037,925,112,96308,81200,15108,9242670.0,7767342.0,7767342.0,9.57,9.76,9.57,9.77
2023-12-01 17:00,848,705,143,78144,66811,11333,7504333.0,6396458.0,6396458.0,828,705,123,77188,66757,10431,7411716.0,6392131.0,6392131.0,9.57,9.78,9.58,9.77
2023-12-01 17:05,848,710,138,76112,67369,8743,7309172.0,6454363.0,6454363.0,831,705,126,75985,67451,8534,7296516.0,6462163.0,6462163.0,9.58,9.78,9.58,9.78
2023-12-01 17:10,817,732,85,61436,58766,2670,5896080.0,5635535.0,5635535.0,806,728,78,61280,58666,2614,5880992.0,5625907.0,5625907.0,9.59,9.76,9.59,9.76
2023-12-01 17:15,421,345,76,32701,30227,2474,3143453.0,2901828.0,2901828.0,415,342,73,32652,30208,2444,3139350.0,2900617.0,2900617.0,9.6,9.77,9.6,9.77
2023-12-01 17:20,529,434,95,44886,39817,5069,4311981.0,3819140.0,3819140.0,511,427,84,44653,39781,4872,4292433.0,3816100.0,3816100.0,9.59,9.72,9.59,9.78
2023-12-01 17:25,807,763,44,57761,56127,1634,5539922.0,5378389.0,5378389.0,802,763,39,56659,56049,610,5430190.0,5370960.0,5370960.0,9.58,9.89,9.58,9.71
2023-12-01 17:30,1039,1013,26,72301,71480,821,6931446.0,6851534.0,6851534.0,1039,1012,27,73310,71489,1821,7032487.0,6852477.0,6852477.0,9.59,9.73,9.59,9.89
2023-12-01 17:35,694,638,56,46611,44828,1783,4470736.0,4297311.0,4297311.0,691,637,54,46578,44817,1761,4467870.0,4296348.0,4296348.0,9.59,9.73,9.59,9.74
2023-12-01 17:40,1089,787,302,85237,72853,12384,8179522.0,6976928.0,6976928.0,1085,787,298,85111,72840,12271,8167474.0,6975714.0,6975714.0,9.58,9.71,9.58,9.71
2023-12-01 17:45,996,641,355,89075,71966,17109,8548211.0,6888666.0,6888666.0,992,639,353,89157,72059,17098,8555818.0,6897343.0,6897343.0,9.57,9.7,9.57,9.7
2023-12-01 17:50,570,266,304,57800,42517,15283,5536263.0,4063144.0,4063144.0,551,256,295,57080,42222,14858,5476672.0,4036204.0,4036204.0,9.56,9.64,9.56,9.69
2023-12-01 17:55,197,53,144,15630,8383,7247,1499372.0,798183.0,798183.0,186,48,138,15458,8237,7221,1483057.0,784296.0,784296.0,9.52,9.68,9.52,9.68
2023-12-01 18:00,65,19,46,4813,1978,2835,461645.0,186901.0,186901.0,56,13,43,4611,1969,2642,442334.0,186108.0,186108.0,9.45,9.69,9.45,9.7
2023-12-01 18:05,217,44,173,16309,6031,10278,1560751.0,569380.0,569380.0,201,34,167,16206,6004,10202,1553718.0,566761.0,566761.0,9.44,9.65,9.44,9.67
2023-12-01 18:10,138,12,126,5861,1219,4642,554544.0,115119.0,115119.0,137,13,124,5819,1239,4580,558140.0,117037.0,117037.0,9.44,9.47,9.45,9.63
2023-12-01 18:15,75,21,54,6060,3147,2913,570763.0,298376.0,298376.0,72,21,51,6300,3382,2918,603110.0,320925.0,320925.0,9.48,9.35,9.49,9.67
2023-12-01 18:20,39,13,26,3883,2019,1864,363756.0,191057.0,191057.0,34,12,22,3229,1870,1359,308583.0,177005.0,177005.0,9.46,9.26,9.47,9.68
2023-12-01 18:25,21,8,13,1540,611,929,147480.0,57582.0,57582.0,18,8,10,1687,610,1077,161615.0,57485.0,57485.0,9.42,9.68,9.42,9.67
2023-12-01 18:30,61,15,46,5292,1815,3477,482182.0,171359.0,171359.0,55,11,44,5175,1725,3450,495800.0,163238.0,163238.0,9.44,8.94,9.46,9.64
2023-12-01 18:35,224,102,122,18422,10644,7778,1759629.0,1013928.0,1013928.0,205,100,105,15349,8357,6992,1472101.0,801480.0,801480.0,9.53,9.59,9.59,9.59
2023-12-04 10:00,710,475,235,26295,18128,8167,2551092.0,1721782.0,1721782.0,435,371,64,19401,16979,2422,1861539.0,1627769.0,1627769.0,9.5,10.15,9.59,9.65
2023-12-04 10:05,3659,1325,2334,43450,5404,38046,4168455.0,505526.0,505526.0,3598,1295,2303,42415,4577,37838,4079818.0,435409.0,435409.0,9.35,9.63,9.51,9.63
2023-12-04 10:10,1285,583,702,39927,18656,21271,3759042.0,1741954.0,1741954.0,930,421,509,35800,16880,18920,3394472.0,1580261.0,1580261.0,9.34,9.48,9.36,9.59
2023-12-04 10:15,2747,1736,1011,88300,44279,44021,7920013.0,4033468.0,4033468.0,2211,1358,853,71219,33017,38202,6406788.0,3019858.0,3019858.0,9.11,8.83,9.15,8.87
2023-12-04 10:20,421,145,276,43501,9465,34036,4045277.0,863914.0,863914.0,338,93,245,41325,8246,33079,3845899.0,755282.0,755282.0,9.13,9.35,9.16,9.34
2023-12-04 10:25,672,220,452,74542,25922,48620,6913332.0,2369804.0,2369804.0,580,159,421,72370,24324,48046,6711808.0,2224849.0,2224849.0,9.14,9.34,9.15,9.34
2023-12-04 10:30,866,511,355,75987,42090,33897,7040165.0,3867789.0,3867789.0,700,457,243,72148,39750,32398,6687256.0,3651085.0,3651085.0,9.19,9.36,9.19,9.37
2023-12-04 10:35,5874,1874,4000,127659,55435,72224,11763875.0,5066061.0,5066061.0,5489,1731,3758,115648,47229,68419,10683021.0,4318271.0,4318271.0,9.14,9.27,9.14,9.3
2023-12-04 10:40,441,370,71,47928,41194,6734,4419904.0,3788774.0,3788774.0,425,366,59,48313,41853,6460,4452781.0,3845755.0,3845755.0,9.2,9.37,9.19,9.4
2023-12-04 10:45,587,365,222,62781,41594,21187,5804333.0,3819148.0,3819148.0,539,340,199,62814,42100,20714,5808035.0,3866958.0,3866958.0,9.18,9.37,9.19,9.37
2023-12-04 10:50,426,293,133,48493,33472,15021,4485644.0,3077506.0,3077506.0,390,273,117,47461,33088,14373,4392381.0,3042260.0,3042260.0,9.19,9.37,9.19,9.39
2023-12-04 10:55,315,115,200,28291,8521,19770,2617849.0,779194.0,779194.0,299,108,191,28209,8521,19688,2612003.0,780170.0,780170.0,9.14,9.3,9.16,9.3
2023-12-04 11:00,421,206,215,38755,15026,23729,3581540.0,1376734.0,1376734.0,383,183,200,38346,14789,23557,3546255.0,1357707.0,1357707.0,9.16,9.29,9.18,9.29
2023-12-04 11:05,503,275,228,46697,19396,27301,4312708.0,1777459.0,1777459.0,463,244,219,46020,18974,27046,4267006.0,1745183.0,1745183.0,9.16,9.29,9.2,9.32
2023-12-04 11:10,642,376,266,64875,34958,29917,6013468.0,3209498.0,3209498.0,587,345,242,63320,34033,29287,5869932.0,3127865.0,3127865.0,9.18,9.37,9.19,9.36
2023-12-04 11:15,405,205,200,39834,22734,17100,3673095.0,2090999.0,2090999.0,381,200,181,39040,22845,16195,3611933.0,2101107.0,2101107.0,9.2,9.25,9.2,9.33
2023-12-04 11:20,272,166,106,28240,17933,10307,2592330.0,1630057.0,1630057.0,245,147,98,27629,17418,10211,2554748.0,1601034.0,1601034.0,9.09,9.34,9.19,9.34
2023-12-04 11:25,194,153,41,22091,18381,3710,2033856.0,1687645.0,1687645.0,172,139,33,22573,19336,3237,2077711.0,1774593.0,1774593.0,9.18,9.33,9.18,9.36
2023-12-04 11:30,144,78,66,13814,7066,6748,1225779.0,634643.0,634643.0,103,53,50,13035,6848,6187,1202088.0,625743.0,625743.0,8.98,8.76,9.14,9.32
2023-12-04 11:35,164,119,45,18255,13416,4839,1678730.0,1228560.0,1228560.0,149,106,43,17595,12896,4699,1619540.0,1181566.0,1181566.0,9.16,9.3,9.16,9.32
2023-12-04 11:40,186,151,35,17457,14729,2728,1606167.0,1351919.0,1351919.0,177,145,32,17496,14694,2802,1610565.0,1349332.0,1349332.0,9.18,9.32,9.18,9.32
2023-12-04 11:45,323,233,90,33925,25956,7969,3118499.0,2373675.0,2373675.0,303,221,82,33775,25869,7906,3106952.0,2367883.0,2367883.0,9.14,9.35,9.15,9.35
2023-12-04 11:50,207,153,54,20342,17546,2796,1865972.0,1604434.0,1604434.0,196,151,45,20270,17629,2641,1863082.0,1616124.0,1616124.0,9.14,9.35,9.17,9.35
2023-12-04 11:55,177,147,30,16310,14241,2069,1501968.0,1306271.0,1306271.0,174,145,29,16451,14523,1928,1511984.0,1331838.0,1331838.0,9.17,9.46,9.17,9.34
2023-12-04 12:00,126,109,17,10420,8873,1547,958622.0,813635.0,813635.0,117,107,10,11469,10024,1445,1054429.0,919354.0,919354.0,9.17,9.37,9.17,9.35
2023-12-04 12:05,164,115,49,14670,11359,3311,1349154.0,1040972.0,1040972.0,149,110,39,14144,11054,3090,1301842.0,1013275.0,1013275.0,9.16,9.31,9.17,9.34
2023-12-04 12:10,275,185,90,24284,16771,7513,2232377.0,1534029.0,1534029.0,260,175,85,24203,16740,7463,2227564.0,1531418.0,1531418.0,9.15,9.3,9.15,9.33
2023-12-04 12:15,245,170,75,26654,17303,9351,2451547.0,1579532.0,1579532.0,235,166,69,26795,17244,9551,2467253.0,1576580.0,1576580.0,9.13,9.33,9.14,9.33
2023-12-04 12:20,267,214,53,26322,20147,6175,2419395.0,1842433.0,1842433.0,237,192,45,25723,19909,5814,2365699.0,1822297.0,1822297.0,9.14,9.34,9.15,9.35
2023-12-04 12:25,117,84,33,12711,8461,4250,1141551.0,773199.0,773199.0,108,78,30,12123,8447,3676,1115043.0,772023.0,772023.0,9.14,8.67,9.14,9.33
2023-12-04 12:30,137,88,49,13348,8442,4906,1226790.0,768750.0,768750.0,112,75,37,13762,8881,4881,1265907.0,810078.0,810078.0,9.11,9.34,9.12,9.34
2023-12-04 12:35,244,98,146,25174,9720,15454,2295201.0,862654.0,862654.0,233,93,140,24752,9493,15259,2279649.0,864738.0,864738.0,8.88,9.27,9.11,9.27
2023-12-04 12:40,144,45,99,13500,2812,10688,1243059.0,255493.0,255493.0,132,37,95,13374,2635,10739,1232006.0,239454.0,239454.0,9.09,9.24,9.09,9.24
2023-12-04 12:45,145,41,104,14201,3994,10207,1308032.0,365211.0,365211.0,140,35,105,13857,3769,10088,1277167.0,344403.0,344403.0,9.14,9.24,9.14,9.25
2023-12-04 12:50,193,68,125,15812,5448,10364,1451369.0,496554.0,496554.0,167,50,117,15781,5479,10302,1453762.0,499623.0,499623.0,9.11,9.21,9.12,9.26
2023-12-04 12:55,79,47,32,7013,3662,3351,646276.0,334019.0,334019.0,71,40,31,7191,4016,3175,661252.0,365357.0,365357.0,9.12,9.32,9.1,9.32
2023-12-04 13:00,267,78,189,25118,7896,17222,2312588.0,715436.0,715436.0,227,58,169,24688,7660,17028,2275889.0,695727.0,695727.0,9.06,9.27,9.08,9.28
2023-12-04 13:05,218,69,149,22062,5069,16993,2030464.0,460245.0,460245.0,193,53,140,21996,5016,16980,2028033.0,457299.0,457299.0,9.08,9.24,9.12,9.25
2023-12-04 13:10,129,34,95,10891,2087,8804,1002708.0,190135.0,190135.0,105,20,85,10216,1765,8451,941364.0,161103.0,161103.0,9.11,9.23,9.13,9.23
2023-12-04 13:15,141,51,90,19136,9472,9664,1761551.0,866771.0,866771.0,120,39,81,18895,9360,9535,1740341.0,857338.0,857338.0,9.15,9.26,9.16,9.26
2023-12-04 13:20,423,244,179,42341,22785,19556,3900233.0,2074205.0,2074205.0,305,172,133,37892,18387,19505,3494967.0,1673872.0,1673872.0,9.1,9.34,9.1,9.34
2023-12-04 13:25,175,84,91,21245,7420,13825,1954370.0,668399.0,668399.0,151,72,79,20298,6898,13400,1877336.0,629445.0,629445.0,9.01,9.3,9.13,9.31
2023-12-04 13:30,334,185,149,38994,15928,23066,3597740.0,1451111.0,1451111.0,309,171,138,38432,15981,22451,3549463.0,1459075.0,1459075.0,9.11,9.31,9.13,9.31
2023-12-04 13:35,281,242,39,18834,13612,5222,1731735.0,1250067.0,1250067.0,264,230,34,18788,13508,5280,1733230.0,1240647.0,1240647.0,9.18,9.22,9.18,9.33
2023-12-04 13:40,270,143,127,31687,16259,15428,2929657.0,1492422.0,1492422.0,224,115,109,28453,13802,14651,2630591.0,1264580.0,1264580.0,9.18,9.32,9.16,9.32
2023-12-04 13:45,298,202,96,26804,17742,9062,2477554.0,1635326.0,1635326.0,263,182,81,24849,16839,8010,2301437.0,1552064.0,1552064.0,9.22,9.29,9.22,9.36
2023-12-04 13:50,116,41,75,11772,4198,7574,1091504.0,382923.0,382923.0,114,41,73,11550,4152,7398,1071833.0,379627.0,379627.0,9.12,9.36,9.14,9.36
2023-12-04 13:55,45,23,22,1931,541,1390,178818.0,49201.0,49201.0,30,17,13,1732,523,1209,161294.0,47924.0,47924.0,9.09,9.32,9.16,9.38
2023-12-04 14:00,90,37,53,8499,3482,5017,788520.0,318498.0,318498.0,80,38,42,8885,3827,5058,823237.0,349155.0,349155.0,9.15,9.37,9.12,9.37
2023-12-04 14:05,134,53,81,13183,5871,7312,1220584.0,536669.0,536669.0,122,48,74,13042,5749,7293,1209264.0,525624.0,525624.0,9.14,9.35,9.14,9.37
2023-12-04 14:10,294,63,231,25576,6463,19113,2371395.0,589808.0,589808.0,263,46,217,25143,6351,18792,2331320.0,579335.0,579335.0,9.13,9.32,9.12,9.32
2023-12-04 14:15,382,38,344,31489,3414,28075,2922951.0,311952.0,311952.0,376,31,345,31617,3359,28258,2934661.0,306878.0,306878.0,9.14,9.3,9.14,9.3
2023-12-04 14:20,502,153,349,56905,18637,38268,5267112.0,1706111.0,1706111.0,477,137,340,56875,18512,38363,5269681.0,1694708.0,1694708.0,9.15,9.31,9.15,9.32
2023-12-04 14:25,269,18,251,19728,761,18967,1829814.0,69602.0,69602.0,259,11,248,19533,680,18853,1811742.0,62122.0,62122.0,9.15,9.28,9.14,9.28
2023-12-04 14:30,337,27,310,26563,1873,24690,2463491.0,170631.0,170631.0,334,25,309,27418,2410,25008,2541804.0,219439.0,219439.0,9.11,9.29,9.11,9.29
2023-12-04 14:35,189,34,155,23296,4630,18666,2160457.0,421792.0,421792.0,192,39,153,23162,4649,18513,2148359.0,423998.0,423998.0,9.11,9.31,9.12,9.31
2023-12-04 14:40,111,22,89,13804,1157,12647,1281089.0,105763.0,105763.0,105,16,89,13460,1045,12415,1249206.0,95448.0,95448.0,9.14,9.29,9.13,9.29
2023-12-04 14:45,88,13,75,12492,244,12248,1158740.0,21639.0,21639.0,80,11,69,12532,262,12270,1163344.0,23902.0,23902.0,8.87,9.28,9.12,9.29
2023-12-04 14:50,252,102,150,27304,7391,19913,2524753.0,674446.0,674446.0,221,79,142,27377,7345,20032,2535399.0,670521.0,670521.0,9.13,9.29,9.13,9.31
2023-12-04 14:55,102,18,84,11920,1658,10262,1104946.0,150989.0,150989.0,105,21,84,11727,1654,10073,1087070.0,150643.0,150643.0,9.11,9.3,9.11,9.3
2023-12-04 15:00,98,14,84,10908,727,10181,1012194.0,66073.0,66073.0,91,10,81,10957,787,10170,1016709.0,71698.0,71698.0,9.09,9.29,9.11,9.29
2023-12-04 15:05,78,7,71,9256,200,9056,859240.0,18266.0,18266.0,73,5,68,9208,184,9024,855230.0,16752.0,16752.0,9.13,9.29,9.1,9.29
2023-12-04 15:10,406,197,209,37689,23630,14059,3489870.0,2176940.0,2176940.0,399,201,198,37031,22699,14332,3428731.0,2090300.0,2090300.0,9.21,9.34,9.21,9.34
2023-12-04 15:15,228,177,51,24100,20934,3166,2222993.0,1928713.0,1928713.0,212,168,44,23445,20577,2868,2167842.0,1899571.0,1899571.0,9.21,9.3,9.23,9.35
2023-12-04 15:20,86,71,15,9554,8365,1189,883514.0,772353.0,772353.0,86,70,16,9693,8502,1191,896371.0,785016.0,785016.0,9.23,9.35,9.23,9.35
2023-12-04 15:25,177,145,32,20903,18196,2707,1931893.0,1678292.0,1678292.0,178,147,31,20789,18083,2706,1921324.0,1667834.0,1667834.0,9.22,9.37,9.22,9.37
2023-12-04 15:30,323,236,87,37713,29315,8398,3478400.0,2690276.0,2690276.0,313,228,85,37565,29151,8414,3474103.0,2684513.0,2684513.0,9.18,9.38,9.21,9.38
2023-12-04 15:35,197,134,63,24952,18974,5978,2308069.0,1747290.0,1747290.0,185,129,56,24777,18943,5834,2291926.0,1744385.0,1744385.0,9.21,9.38,9.21,9.39
2023-12-04 15:40,418,313,105,49882,38366,11516,4613987.0,3533145.0,3533145.0,411,312,99,50195,38585,11610,4642957.0,3553418.0,3553418.0,9.21,9.39,9.21,9.38
2023-12-04 15:45,611,279,332,54416,42516,11900,5026942.0,3917388.0,3917388.0,602,276,326,54033,42198,11835,4994639.0,3888279.0,3888279.0,9.21,9.32,9.21,9.35
2023-12-04 15:50,492,162,330,44345,24931,19414,4096288.0,2288218.0,2288218.0,475,152,323,43304,24928,18376,4004962.0,2287979.0,2287979.0,9.18,9.31,9.18,9.34
2023-12-04 15:55,65,26,39,5004,2363,2641,456639.0,215346.0,215346.0,49,22,27,5219,2535,2684,482284.0,231141.0,231141.0,9.11,9.14,9.12,9.36
2023-12-04 16:00,95,48,47,9933,4642,5291,917256.0,423016.0,423016.0,80,38,42,10058,4840,5218,928835.0,441178.0,441178.0,9.11,9.34,9.12,9.35
2023-12-04 16:05,27,11,16,2709,1201,1508,250052.0,109391.0,109391.0,20,7,13,2538,1052,1486,234547.0,95813.0,95813.0,9.11,9.33,9.11,9.34
2023-12-04 16:10,81,37,44,8539,3774,4765,780058.0,343639.0,343639.0,72,34,38,8374,3872,4502,772891.0,352799.0,352799.0,9.11,9.16,9.11,9.33
2023-12-04 16:15,34,19,15,879,99,780,74167.0,6781.0,6781.0,13,3,10,766,4,762,71224.0,357.0,357.0,6.85,8.64,8.93,9.3
2023-12-04 16:20,44,16,28,3573,1629,1944,329491.0,148758.0,148758.0,32,9,23,2793,888,1905,258500.0,81168.0,81168.0,9.13,9.3,9.14,9.31
2023-12-04 16:25,40,19,21,2844,913,1931,262936.0,83016.0,83016.0,29,11,18,2710,844,1866,250447.0,76634.0,76634.0,9.09,9.32,9.08,9.31
2023-12-04 16:30,48,18,30,3974,1364,2610,367215.0,124073.0,124073.0,38,12,26,4249,1756,2493,392327.0,159912.0,159912.0,9.1,9.32,9.11,9.32
2023-12-04 16:35,69,22,47,4449,1239,3210,404907.0,112416.0,112416.0,54,16,38,4417,1228,3189,408147.0,111433.0,111433.0,9.07,9.11,9.07,9.3
2023-12-04 16:40,44,15,29,3155,659,2496,287733.0,55793.0,55793.0,38,8,30,3146,610,2536,291038.0,55336.0,55336.0,8.47,9.29,9.07,9.29
2023-12-04 16:45,51,15,36,3866,1084,2782,339381.0,97952.0,97952.0,38,10,28,3605,1013,2592,332908.0,91875.0,91875.0,9.04,8.68,9.07,9.3
2023-12-04 16:50,71,27,44,4768,2009,2759,433769.0,180076.0,180076.0,54,15,39,4289,1613,2676,394603.0,145829.0,145829.0,8.96,9.2,9.04,9.3
2023-12-04 16:55,33,15,18,2240,921,1319,205991.0,83024.0,83024.0,30,14,16,2104,825,1279,194108.0,74840.0,74840.0,9.01,9.32,9.07,9.33
2023-12-04 17:00,29,14,15,1798,626,1172,165987.0,56809.0,56809.0,28,11,17,2197,906,1291,202457.0,82212.0,82212.0,9.08,9.32,9.07,9.31
2023-12-04 17:05,73,20,53,6449,2017,4432,594495.0,183007.0,183007.0,57,14,43,5961,2005,3956,550585.0,181908.0,181908.0,9.07,9.28,9.07,9.32
2023-12-04 17:10,477,172,305,58178,27877,30301,5291161.0,2523565.0,2523565.0,396,134,262,49063,26038,23025,4489636.0,2358881.0,2358881.0,9.05,9.13,9.06,9.25
2023-12-04 17:15,414,87,327,31965,14823,17142,2920710.0,1341134.0,1341134.0,396,79,317,32321,15279,17042,2956096.0,1385603.0,1385603.0,9.05,9.21,9.07,9.22
2023-12-04 17:20,346,78,268,27764,12060,15704,2539358.0,1091257.0,1091257.0,322,61,261,27431,11956,15475,2509033.0,1081986.0,1081986.0,9.05,9.22,9.05,9.22
2023-12-04 17:25,262,54,208,19432,7349,12083,1777374.0,666521.0,666521.0,249,48,201,19505,7313,12192,1787852.0,663274.0,663274.0,9.07,9.19,9.07,9.22
2023-12-04 17:30,176,41,135,14109,6756,7353,1289461.0,614105.0,614105.0,169,37,132,14144,6835,7309,1292653.0,619449.0,619449.0,9.09,9.18,9.06,9.21
2023-12-04 17:35,128,31,97,10312,4192,6120,943462.0,379450.0,379450.0,123,27,96,10220,4121,6099,935144.0,373052.0,373052.0,9.05,9.22,9.05,9.22
2023-12-04 17:40,175,39,136,14482,5982,8500,1323460.0,541128.0,541128.0,168,40,128,14458,5959,8499,1323260.0,539137.0,539137.0,9.05,9.2,9.05,9.23
2023-12-04 17:45,44,14,30,5227,2325,2902,477819.0,209906.0,209906.0,38,12,26,4750,2255,2495,434309.0,203779.0,203779.0,9.03,9.23,9.04,9.24
2023-12-04 17:50,80,20,60,6894,2822,4072,627829.0,254477.0,254477.0,77,20,57,7152,3124,4028,653535.0,282305.0,282305.0,9.02,9.17,9.04,9.22
2023-12-04 17:55,192,56,136,17648,7537,10111,1565373.0,680360.0,680360.0,157,32,125,16148,7039,9109,1475148.0,635586.0,635586.0,9.03,8.75,9.03,9.22
2023-12-04 18:00,510,128,382,52699,20951,31748,4792810.0,1885927.0,1885927.0,464,106,358,51422,20242,31180,4693670.0,1822047.0,1822047.0,9.0,9.16,9.0,9.21
2023-12-04 18:05,834,468,366,90611,57365,33246,8244065.0,5188195.0,5188195.0,766,427,339,86399,53927,32472,7869943.0,4881334.0,4881334.0,9.04,9.19,9.05,9.2
2023-12-04 18:10,497,250,247,52341,34474,17867,4769672.0,3123989.0,3123989.0,512,241,271,52595,34365,18230,4795810.0,3114346.0,3114346.0,9.06,9.21,9.06,9.22
2023-12-04 18:15,363,116,247,34090,17823,16267,3100958.0,1609931.0,1609931.0,338,105,233,33852,17810,16042,3083581.0,1609737.0,1609737.0,9.03,9.17,9.04,9.19
2023-12-04 18:20,63,30,33,5403,2807,2596,490759.0,252534.0,252534.0,50,23,27,5212,2732,2480,474498.0,245908.0,245908.0,9.0,9.18,9.0,9.22
2023-12-04 18:25,1425,55,1370,54719,6800,47919,4966015.0,609353.0,609353.0,1400,42,1358,53740,6482,47258,4895881.0,581279.0,581279.0,8.96,9.09,8.97,9.13
2023-12-04 18:30,153,56,97,10636,4266,6370,963321.0,383270.0,383270.0,114,31,83,8879,3411,5468,810241.0,307825.0,307825.0,8.98,9.11,9.02,9.19
2023-12-04 18:35,191,112,79,16742,11452,5290,1522269.0,1038131.0,1038131.0,180,110,70,14965,10773,4192,1361555.0,975728.0,975728.0,9.07,9.15,9.06,9.2
2023-12-05 10:00,862,344,518,36788,24995,11793,3180771.0,2169891.0,2169891.0,331,119,212,24240,19370,4870,2141560.0,1702871.0,1702871.0,8.68,8.57,8.79,9.01
2023-12-05 10:05,468,305,163,39223,33870,5353,3429496.0,2979574.0,2979574.0,351,242,109,36791,32907,3884,3264740.0,2915442.0,2915442.0,8.8,8.41,8.86,8.99
2023-12-05 10:10,1245,993,252,83573,76410,7163,7466988.0,6799876.0,6799876.0,874,780,94,77419,73332,4087,6955402.0,6579386.0,6579386.0,8.9,9.31,8.97,9.2
2023-12-05 10:15,540,462,78,61933,58055,3878,5597938.0,5240356.0,5240356.0,460,420,40,60053,56995,3058,5432785.0,5151303.0,5151303.0,9.03,9.22,9.04,9.2
2023-12-05 10:20,532,305,227,67962,44341,23621,6132001.0,3980315.0,3980315.0,480,283,197,66199,44067,22132,5979924.0,3957049.0,3957049.0,8.98,9.11,8.98,9.14
2023-12-05 10:25,450,379,71,46863,36704,10159,4205029.0,3279328.0,3279328.0,426,365,61,46320,36348,9972,4163079.0,3254054.0,3254054.0,8.93,9.11,8.95,9.12
2023-12-05 10:30,760,688,72,68377,61633,6744,6132052.0,5521205.0,5521205.0,727,669,58,68792,61459,7333,6172168.0,5506048.0,5506048.0,8.96,9.06,8.96,9.08
2023-12-05 10:35,490,183,307,43675,22725,20950,3918656.0,2025190.0,2025190.0,456,161,295,42463,22222,20241,3819946.0,1989173.0,1989173.0,8.91,9.04,8.95,9.04
2023-12-05 10:40,7867,3518,4349,252250,216965,35285,22677047.0,19470829.0,19470829.0,7830,3498,4332,252264,216849,35415,22683958.0,19465246.0,19465246.0,8.97,9.09,8.98,9.09
2023-12-05 10:45,1747,1398,349,144336,107831,36505,12984657.0,9651578.0,9651578.0,1658,1350,308,143424,107219,36205,12907727.0,9598262.0,9598262.0,8.95,9.13,8.95,9.14
2023-12-05 10:50,2169,1411,758,168350,113603,54747,15152792.0,10156192.0,10156192.0,2150,1402,748,168286,113674,54612,15147217.0,10162556.0,10162556.0,8.94,9.13,8.94,9.13
2023-12-05 10:55,1413,1255,158,98408,81180,17228,8842007.0,7269664.0,7269664.0,1380,1238,142,98022,81093,16929,8807778.0,7262220.0,7262220.0,8.95,9.13,8.96,9.13
2023-12-05 11:00,1666,1496,170,140436,111437,28999,12612502.0,9963533.0,9963533.0,1650,1489,161,139874,111073,28801,12571423.0,9940148.0,9940148.0,8.94,9.13,8.95,9.14
2023-12-05 11:05,2237,2012,225,73392,46922,26470,6572407.0,4186105.0,4186105.0,2184,1987,197,72555,46614,25941,6525743.0,4160669.0,4160669.0,8.92,9.02,8.93,9.12
2023-12-05 11:10,286,138,148,29824,15611,14213,2675243.0,1385599.0,1385599.0,234,121,113,29154,15462,13692,2615994.0,1372364.0,1372364.0,8.88,9.07,8.88,9.08
2023-12-05 11:15,329,225,104,39309,26657,12652,3516676.0,2372761.0,2372761.0,290,200,90,38423,26143,12280,3441373.0,2327416.0,2327416.0,8.9,9.04,8.9,9.07
2023-12-05 11:20,348,154,194,40017,17874,22143,3563321.0,1575114.0,1575114.0,269,122,147,38003,17693,20310,3393449.0,1560380.0,1560380.0,8.81,8.98,8.82,9.03
2023-12-05 11:25,520,168,352,62688,19094,43594,5548980.0,1670933.0,1670933.0,449,130,319,62184,18745,43439,5530537.0,1640986.0,1640986.0,8.75,8.9,8.75,8.95
2023-12-05 11:30,2225,475,1750,106580,43351,63229,9483984.0,3815699.0,3815699.0,2162,429,1733,105374,42186,63188,9386136.0,3712402.0,3712402.0,8.8,8.96,8.8,8.98
2023-12-05 11:35,30767,444,30323,160324,55877,104447,14294585.0,4924353.0,4924353.0,30708,417,30291,159171,55329,103842,14201435.0,4875807.0,4875807.0,8.81,8.97,8.81,8.98
2023-12-05 11:40,2866,381,2485,89453,44830,44623,7937563.0,3927066.0,3927066.0,2814,357,2457,88734,44333,44401,7896833.0,3905063.0,3905063.0,8.76,8.99,8.81,8.99
2023-12-05 11:45,1065,518,547,102898,55562,47336,9053042.0,4881592.0,4881592.0,951,462,489,99172,53343,45829,8795988.0,4689878.0,4689878.0,8.79,8.81,8.79,8.96
2023-12-05 11:50,475,373,102,48458,32975,15483,4288533.0,2900165.0,2900165.0,459,359,100,47842,32740,15102,4234957.0,2879937.0,2879937.0,8.8,8.97,8.8,8.97
2023-12-05 11:55,485,294,191,55032,27106,27926,4871851.0,2377582.0,2377582.0,456,281,175,56156,28511,27645,4972382.0,2500158.0,2500158.0,8.77,8.93,8.77,8.94
2023-12-05 12:00,324,185,139,35278,16513,18765,3114466.0,1436526.0,1436526.0,304,172,132,34888,16289,18599,3088836.0,1425782.0,1425782.0,8.7,8.94,8.75,8.94
2023-12-05 12:05,221,182,39,21474,12413,9061,1902151.0,1091438.0,1091438.0,212,176,36,21525,12462,9063,1907403.0,1096200.0,1096200.0,8.79,8.95,8.8,8.95
2023-12-05 12:10,261,222,39,22614,12744,9870,2004292.0,1120837.0,1120837.0,238,202,36,22374,12556,9818,1983108.0,1104272.0,1104272.0,8.8,8.95,8.79,8.95
2023-12-05 12:15,561,432,129,52600,31244,21356,4663268.0,2747493.0,2747493.0,518,408,110,52433,31081,21352,4648699.0,2732940.0,2732940.0,8.79,8.97,8.79,8.97
2023-12-05 12:20,533,356,177,61567,31177,30390,5463203.0,2737040.0,2737040.0,516,345,171,60609,30530,30079,5379360.0,2680750.0,2680750.0,8.78,8.97,8.78,8.97
2023-12-05 12:25,259,195,64,24512,14730,9782,2174818.0,1297492.0,1297492.0,247,186,61,24277,14694,9583,2154195.0,1294964.0,1294964.0,8.81,8.97,8.81,8.97
2023-12-05 12:30,311,225,86,28033,17209,10824,2481225.0,1514454.0,1514454.0,303,226,77,28262,17664,10598,2505750.0,1555294.0,1555294.0,8.8,8.93,8.8,8.97
2023-12-05 12:35,92,48,44,11251,4386,6865,995863.0,382062.0,382062.0,73,37,36,11130,4340,6790,986237.0,378465.0,378465.0,8.71,8.94,8.72,8.95
2023-12-05 12:40,67,30,37,4812,1492,3320,426692.0,130210.0,130210.0,48,20,28,4695,1518,3177,416575.0,132732.0,132732.0,8.73,8.93,8.74,8.93
2023-12-05 12:45,114,37,77,14264,3201,11063,1256694.0,277760.0,277760.0,96,28,68,14021,3146,10875,1244026.0,273794.0,273794.0,8.68,8.85,8.7,8.92
2023-12-05 12:50,755,406,349,75900,39489,36411,6682326.0,3443170.0,3443170.0,643,351,292,74631,38725,35906,6572373.0,3375656.0,3375656.0,8.72,8.9,8.72,8.9
2023-12-05 12:55,427,262,165,42615,25247,17368,3739343.0,2204177.0,2204177.0,397,245,152,41853,24988,16865,3679049.0,2179527.0,2179527.0,8.73,8.84,8.72,8.89
2023-12-05 13:00,712,493,219,79127,51848,27279,6955741.0,4521761.0,4521761.0,679,473,206,78412,51455,26957,6894527.0,4488426.0,4488426.0,8.72,8.92,8.72,8.93
2023-12-05 13:05,1614,279,1335,118856,32185,86671,10459124.0,2796288.0,2796288.0,1585,262,1323,118347,32151,86196,10431857.0,2793467.0,2793467.0,8.69,8.84,8.69,8.86
2023-12-05 13:10,461,163,298,54794,19070,35724,4818488.0,1652564.0,1652564.0,436,150,286,54396,18525,35871,4795667.0,1607495.0,1607495.0,8.67,8.86,8.68,8.89
2023-12-05 13:15,825,289,536,83903,30831,53072,7261473.0,2632156.0,2632156.0,714,225,489,78931,28050,50881,6900614.0,2415502.0,2415502.0,8.54,8.72,8.61,8.81
2023-12-05 13:20,300,198,102,34863,21271,13592,3036081.0,1839148.0,1839148.0,270,176,94,35451,22066,13385,3083760.0,1901453.0,1901453.0,8.65,8.81,8.62,8.83
2023-12-05 13:25,932,539,393,106245,54184,52061,9270942.0,4676279.0,4676279.0,852,486,366,105102,53442,51660,9176140.0,4615767.0,4615767.0,8.63,8.83,8.64,8.83
2023-12-05 13:30,659,346,313,71550,35924,35626,6239169.0,3100691.0,3100691.0,617,326,291,71094,35849,35245,6207368.0,3097819.0,3097819.0,8.63,8.81,8.64,8.82
2023-12-05 13:35,385,188,197,38627,16387,22240,3357672.0,1405879.0,1405879.0,329,162,167,37621,16348,21273,3276217.0,1405504.0,1405504.0,8.58,8.78,8.6,8.79
2023-12-05 13:40,467,197,270,53241,16615,36626,4640047.0,1430214.0,1430214.0,426,158,268,52710,15844,36866,4595728.0,1364665.0,1364665.0,8.61,8.76,8.61,8.76
2023-12-05 13:45,212,88,124,22790,6896,15894,1987481.0,592502.0,592502.0,179,67,112,22387,6731,15656,1951216.0,578377.0,578377.0,8.59,8.78,8.59,8.77
2023-12-05 13:50,149,92,57,14072,5666,8406,1225501.0,486938.0,486938.0,122,70,52,13838,5482,8356,1205381.0,471132.0,471132.0,8.59,8.79,8.59,8.79
2023-12-05 13:55,205,62,143,24545,4286,20259,2144599.0,368193.0,368193.0,195,60,135,24639,4265,20374,2153275.0,366293.0,366293.0,8.59,8.77,8.59,8.77
2023-12-05 14:00,350,109,241,42195,8953,33242,3680797.0,762194.0,762194.0,333,96,237,41577,8772,32805,3636249.0,755106.0,755106.0,8.51,8.78,8.61,8.78
2023-12-05 14:05,227,119,108,28759,12221,16538,2504381.0,1050341.0,1050341.0,209,106,103,29083,12622,16461,2531485.0,1083698.0,1083698.0,8.59,8.79,8.59,8.8
2023-12-05 14:10,452,172,280,46684,10261,36423,4083566.0,883736.0,883736.0,406,139,267,45886,9647,36239,4014104.0,830831.0,830831.0,8.61,8.79,8.61,8.78
2023-12-05 14:15,150,58,92,16303,3684,12619,1428433.0,316536.0,316536.0,130,44,86,16028,3575,12453,1404623.0,307531.0,307531.0,8.59,8.81,8.6,8.81
2023-12-05 14:20,423,334,89,43892,31482,12410,3831250.0,2733409.0,2733409.0,388,315,73,42728,30609,12119,3732509.0,2656899.0,2656899.0,8.68,8.85,8.68,8.88
2023-12-05 14:25,135,99,36,13492,10271,3221,1177703.0,891590.0,891590.0,113,89,24,13190,10145,3045,1151286.0,880518.0,880518.0,8.68,8.88,8.68,8.89
2023-12-05 14:30,309,241,68,31527,26141,5386,2737722.0,2261136.0,2261136.0,275,224,51,30803,25547,5256,2680623.0,2215127.0,2215127.0,8.65,8.85,8.67,8.86
2023-12-05 14:35,506,344,162,63696,36877,26819,5562984.0,3188099.0,3188099.0,466,318,148,60749,35922,24827,5313878.0,3113520.0,3113520.0,8.65,8.86,8.67,8.86
2023-12-05 14:40,1116,498,618,113779,62800,50979,9956514.0,5434560.0,5434560.0,1116,502,614,113853,62814,51039,9964076.0,5436089.0,5436089.0,8.65,8.87,8.65,8.87
2023-12-05 14:45,1409,719,690,136129,81417,54712,11904349.0,7050533.0,7050533.0,1390,707,683,135954,81318,54636,11890556.0,7043498.0,7043498.0,8.66,8.87,8.66,8.87
2023-12-05 14:50,393,324,69,34846,25738,9108,3043724.0,2237450.0,2237450.0,387,319,68,34709,25818,8891,3031707.0,2244432.0,2244432.0,8.69,8.85,8.69,8.85
2023-12-05 14:55,452,373,79,54516,33974,20542,4767958.0,2947179.0,2947179.0,434,360,74,51230,30976,20254,4487004.0,2691912.0,2691912.0,8.67,8.86,8.69,8.86
2023-12-05 15:00,265,239,26,20939,15848,5091,1830391.0,1379141.0,1379141.0,249,228,21,20743,15613,5130,1812722.0,1359107.0,1359107.0,8.7,8.86,8.7,8.84
2023-12-05 15:05,189,137,52,19279,8068,11211,1694185.0,701299.0,701299.0,176,125,51,19209,7878,11331,1687882.0,684492.0,684492.0,8.69,8.86,8.69,8.86
2023-12-05 15:10,291,161,130,29936,15403,14533,2614429.0,1324919.0,1324919.0,255,140,115,29502,15173,14329,2585476.0,1313873.0,1313873.0,8.6,8.87,8.66,8.87
2023-12-05 15:15,860,376,484,99679,45885,53794,8753842.0,3972732.0,3972732.0,821,355,466,99609,45830,53779,8750517.0,3967837.0,3967837.0,8.66,8.89,8.66,8.89
2023-12-05 15:20,503,167,336,60026,25538,34488,5272509.0,2208482.0,2208482.0,489,160,329,59550,25302,34248,5230791.0,2188106.0,2188106.0,8.65,8.88,8.65,8.88
2023-12-05 15:25,137,84,53,13822,7041,6781,1211084.0,609604.0,609604.0,125,74,51,13576,6829,6747,1190838.0,591694.0,591694.0,8.66,8.87,8.66,8.88
2023-12-05 15:30,156,93,63,18516,9034,9482,1625181.0,783081.0,783081.0,146,86,60,18581,9015,9566,1631280.0,781513.0,781513.0,8.67,8.88,8.67,8.88
2023-12-05 15:35,74,36,38,9045,2487,6558,794648.0,215225.0,215225.0,69,34,35,11986,5543,6443,1045721.0,476399.0,476399.0,8.65,8.84,8.59,8.84
2023-12-05 15:40,45,30,15,4254,2176,2078,372375.0,188540.0,188540.0,36,26,10,4274,2271,2003,373895.0,196915.0,196915.0,8.66,8.85,8.67,8.84
2023-12-05 15:45,82,48,34,8885,3662,5223,777998.0,316739.0,316739.0,64,36,28,8719,3555,5164,765067.0,307898.0,307898.0,8.65,8.83,8.66,8.85
2023-12-05 15:50,161,93,68,19460,10836,8624,1693915.0,939263.0,939263.0,135,78,57,18795,10342,8453,1644722.0,896246.0,896246.0,8.67,8.75,8.67,8.85
2023-12-05 15:55,553,273,280,62372,30389,31983,5456196.0,2630171.0,2630171.0,532,259,273,62244,30444,31800,5445654.0,2634751.0,2634751.0,8.66,8.84,8.65,8.84
2023-12-05 16:00,107,84,23,8269,6961,1308,719652.0,604236.0,604236.0,97,76,21,8185,6938,1247,712751.0,602458.0,602458.0,8.68,8.82,8.68,8.84
2023-12-05 16:05,164,144,20,12800,11103,1697,1114377.0,964233.0,964233.0,154,137,17,12730,11071,1659,1108595.0,961757.0,961757.0,8.68,8.85,8.69,8.85
2023-12-05 16:10,150,131,19,11729,10075,1654,1020675.0,874258.0,874258.0,135,119,16,11695,10046,1649,1017871.0,871900.0,871900.0,8.68,8.85,8.68,8.85
2023-12-05 16:15,64,53,11,5596,4344,1252,491314.0,376566.0,376566.0,54,45,9,5192,4252,940,452104.0,369167.0,369167.0,8.67,9.17,8.68,8.82
2023-12-05 16:20,86,62,24,7945,5125,2820,694277.0,444499.0,444499.0,78,56,22,7843,5072,2771,685340.0,439937.0,439937.0,8.67,8.86,8.67,8.86
2023-12-05 16:25,137,96,41,14114,8329,5785,1233207.0,722377.0,722377.0,127,90,37,14208,8500,5708,1242455.0,737916.0,737916.0,8.67,8.83,8.68,8.84
2023-12-05 16:30,69,58,11,5699,4773,926,495683.0,414555.0,414555.0,61,54,7,5680,4771,909,494843.0,414331.0,414331.0,8.69,8.76,8.68,8.86
2023-12-05 16:35,263,164,99,28491,16416,12075,2476990.0,1417236.0,1417236.0,250,158,92,28382,16440,11942,2475683.0,1419885.0,1419885.0,8.63,8.78,8.64,8.84
2023-12-05 16:40,222,159,63,23850,16980,6870,2071303.0,1464131.0,1464131.0,208,149,59,21065,14160,6905,1835325.0,1224125.0,1224125.0,8.62,8.84,8.64,8.85
2023-12-05 16:45,128,79,49,11529,6389,5140,1004685.0,551529.0,551529.0,113,71,42,11513,6358,5155,1004471.0,549018.0,549018.0,8.63,8.82,8.64,8.84
2023-12-05 16:50,145,67,78,13035,4733,8302,1135629.0,408229.0,408229.0,115,49,66,12813,4700,8113,1119916.0,405582.0,405582.0,8.63,8.76,8.63,8.8
2023-12-05 16:55,200,63,137,23222,5545,17677,2032332.0,479157.0,479157.0,197,57,140,23306,5446,17860,2039781.0,470514.0,470514.0,8.64,8.79,8.64,8.79
2023-12-05 17:00,509,210,299,53857,19702,34155,4711600.0,1711471.0,1711471.0,496,202,294,53791,19710,34081,4706176.0,1712424.0,1712424.0,8.69,8.78,8.69,8.78
2023-12-05 17:05,157,64,93,17500,5918,11582,1531837.0,514283.0,514283.0,151,59,92,17541,5959,11582,1535404.0,517851.0,517851.0,8.69,8.79,8.69,8.79
2023-12-05 17:10,317,118,199,32359,10794,21565,2832778.0,939599.0,939599.0,312,116,196,32533,10987,21546,2847770.0,956128.0,956128.0,8.7,8.78,8.7,8.78
2023-12-05 17:15,405,139,266,40072,13174,26898,3507918.0,1145743.0,1145743.0,395,132,263,40055,13165,26890,3506853.0,1145379.0,1145379.0,8.7,8.78,8.7,8.78
2023-12-05 17:20,567,217,350,61891,23305,38586,5413508.0,2021750.0,2021750.0,551,206,345,62032,23263,38769,5427252.0,2018354.0,2018354.0,8.68,8.79,8.68,8.79
2023-12-05 17:25,764,181,583,96572,29829,66743,8444002.0,2567264.0,2567264.0,743,163,580,98988,32355,66633,8654739.0,2782964.0,2782964.0,8.61,8.81,8.6,8.81
2023-12-05 17:30,396,66,330,38693,3503,35190,3392002.0,303691.0,303691.0,373,54,319,38275,3342,34933,3355360.0,289753.0,289753.0,8.67,8.78,8.67,8.78
2023-12-05 17:35,718,269,449,77981,28539,49442,6816823.0,2462003.0,2462003.0,703,260,443,77740,28398,49342,6807234.0,2456842.0,2456842.0,8.63,8.81,8.65,8.82
2023-12-05 17:40,388,205,183,34935,12289,22646,3060887.0,1068170.0,1068170.0,372,194,178,34780,12266,22514,3047516.0,1066361.0,1066361.0,8.69,8.8,8.69,8.8
2023-12-05 17:45,270,109,161,27890,8361,19529,2434145.0,724548.0,724548.0,244,89,155,27685,8312,19373,2426171.0,720422.0,720422.0,8.67,8.75,8.67,8.8
2023-12-05 17:50,404,243,161,42795,20688,22107,3730074.0,1781254.0,1781254.0,385,233,152,42415,20357,22058,3711111.0,1765815.0,1765815.0,8.61,8.82,8.67,8.82
2023-12-05 17:55,199,154,45,17843,11249,6594,1561611.0,980132.0,980132.0,187,148,39,17092,10747,6345,1495794.0,936592.0,936592.0,8.71,8.82,8.71,8.81
2023-12-05 18:00,475,328,147,54491,27682,26809,4774969.0,2403415.0,2403415.0,456,315,141,53702,27121,26581,4706316.0,2354912.0,2354912.0,8.68,8.85,8.68,8.85
2023-12-05 18:05,474,265,209,65676,30909,34767,5776697.0,2675363.0,2675363.0,407,227,180,62976,29531,33445,5546856.0,2563574.0,2563574.0,8.66,8.92,8.68,8.92
2023-12-05 18:10,99,51,48,9089,3315,5774,797951.0,282171.0,282171.0,71,40,31,8616,3105,5511,762596.0,269928.0,269928.0,8.51,8.93,8.69,8.94
2023-12-05 18:15,224,133,91,22998,12698,10300,2019806.0,1105697.0,1105697.0,192,112,80,21929,12172,9757,1925984.0,1059675.0,1059675.0,8.71,8.87,8.71,8.88
2023-12-05 18:20,216,173,43,19999,13984,6015,1753187.0,1219398.0,1219398.0,196,159,37,19051,13278,5773,1670800.0,1158151.0,1158151.0,8.72,8.87,8.72,8.88
2023-12-05 18:25,225,152,73,29118,19229,9889,2558313.0,1673599.0,1673599.0,201,138,63,28231,18753,9478,2483560.0,1634767.0,1634767.0,8.7,8.95,8.72,8.96
2023-12-05 18:30,90,66,24,7079,4131,2948,619002.0,355328.0,355328.0,73,53,20,6221,3369,2852,549402.0,294275.0,294275.0,8.6,8.94,8.73,8.95
2023-12-05 18:35,583,172,411,48914,21002,27912,4267033.0,1835097.0,1835097.0,569,172,397,47346,20170,27176,4166095.0,1760686.0,1760686.0,8.74,8.71,8.73,8.85
2023-12-06 10:00,560,332,228,36399,29166,7233,32375210.0,25486913.0,6888296.0,265,230,35,30124,27059,3065,26429728.0,23655686.0,2774041.0,87.39,95.23,87.42,90.51
2023-12-06 10:05,396,297,99,32159,25464,6695,28411149.0,22403505.0,6007643.0,256,182,74,31090,25025,6065,27468651.0,22030695.0,5437956.0,87.98,89.73,88.03,89.66
2023-12-06 10:10,390,196,194,27560,20712,6848,24405943.0,18281015.0,6124928.0,242,165,77,25896,19609,6287,22882869.0,17283248.0,5599621.0,88.26,89.44,88.14,89.07
2023-12-06 10:15,266,191,75,32708,25112,7596,29064892.0,22210784.0,6854108.0,224,172,52,31425,24436,6989,27925805.0,21604746.0,6321059.0,88.45,90.23,88.41,90.44
2023-12-06 10:20,210,160,50,25071,20046,5025,22275065.0,17729875.0,4545189.0,181,143,38,25015,20181,4834,22200712.0,17838644.0,4362068.0,88.45,90.45,88.39,90.24
2023-12-06 10:25,214,132,82,24297,17361,6936,21602240.0,15345815.0,6256425.0,187,121,66,23369,16614,6755,20782134.0,14687371.0,6094762.0,88.39,90.2,88.4,90.23
2023-12-06 10:30,153,98,55,24722,14520,10202,22836895.0,12805223.0,10031672.0,145,96,49,20563,14590,5973,18250059.0,12866260.0,5383798.0,88.19,98.33,88.19,90.14
2023-12-06 10:35,363,196,167,43004,20943,22061,38130849.0,18470454.0,19660394.0,316,167,149,40479,20192,20287,35933021.0,17781456.0,18151564.0,88.19,89.12,88.06,89.47
2023-12-06 10:40,395,169,226,48426,20646,27780,42098525.0,17288309.0,24810215.0,371,153,218,44261,16612,27649,39257799.0,14570105.0,24687694.0,83.74,89.31,87.71,89.29
2023-12-06 10:45,386,281,105,42989,24900,18089,38217428.0,21940149.0,16277278.0,358,269,89,42569,24800,17769,37826303.0,21853151.0,15973152.0,88.11,89.98,88.12,89.89
2023-12-06 10:50,93,78,15,7882,6134,1748,6989202.0,5419288.0,1569913.0,82,73,9,7684,6105,1579,6814369.0,5395196.0,1419173.0,88.35,89.81,88.37,89.88
2023-12-06 10:55,100,85,15,9747,7167,2580,8642388.0,6321388.0,2320999.0,100,86,14,9759,7180,2579,8653314.0,6332728.0,2320586.0,88.2,89.96,88.2,89.98
2023-12-06 11:00,391,276,115,49537,26138,23399,44832942.0,23003556.0,21829386.0,358,264,94,44278,25390,18888,39320354.0,22326815.0,16993539.0,88.01,93.29,87.94,89.97
2023-12-06 11:05,2319,2283,36,106042,99599,6443,93941907.0,88162204.0,5779703.0,2305,2277,28,105619,99478,6141,93569449.0,88057220.0,5512229.0,88.52,89.71,88.52,89.76
2023-12-06 11:10,80,37,43,7316,3423,3893,6492469.0,3004750.0,3487718.0,64,36,28,7365,3611,3754,6529782.0,3165071.0,3364710.0,87.78,89.59,87.65,89.63
2023-12-06 11:15,66,26,40,7249,2195,5054,6429013.0,1909798.0,4519215.0,49,12,37,6816,1953,4863,6054245.0,1701261.0,4352984.0,87.01,89.42,87.11,89.51
2023-12-06 11:20,101,37,64,13141,3817,9324,11680308.0,3329824.0,8350484.0,84,29,55,13080,3805,9275,11616502.0,3319238.0,8297264.0,87.24,89.56,87.23,89.46
2023-12-06 11:25,1219,319,900,93810,30636,63174,83022185.0,26809732.0,56212453.0,1203,311,892,93878,30616,63262,83085731.0,26791789.0,56293941.0,87.51,88.98,87.51,88.99
2023-12-06 11:30,553,169,384,45645,16048,29597,40409689.0,14051903.0,26357785.0,526,149,377,45190,16029,29161,39998123.0,14030875.0,25967248.0,87.56,89.06,87.53,89.05
2023-12-06 11:35,104,75,29,11151,6569,4582,9868992.0,5759061.0,4109930.0,95,69,26,11139,6562,4577,9858824.0,5752416.0,4106407.0,87.67,89.7,87.66,89.72
2023-12-06 11:40,343,314,29,26338,21838,4500,23278561.0,19244804.0,4033757.0,330,307,23,26491,21817,4674,23417014.0,19226123.0,4190890.0,88.13,89.64,88.12,89.66
2023-12-06 11:45,687,627,60,47454,38718,8736,41946209.0,34133775.0,7812434.0,678,622,56,47235,38744,8491,41756612.0,34156188.0,7600423.0,88.16,89.43,88.16,89.51
2023-12-06 11:50,310,267,43,22637,17548,5089,20029422.0,15473903.0,4555519.0,298,262,36,22600,17579,5021,19989395.0,15498729.0,4490666.0,88.18,89.52,88.17,89.44
2023-12-06 11:55,619,501,118,55489,35864,19625,49082898.0,31501216.0,17581681.0,598,486,112,55392,35688,19704,49003285.0,31343073.0,17660212.0,87.84,89.59,87.83,89.63
2023-12-06 12:00,587,164,423,61879,15485,46394,54881388.0,13536304.0,41345084.0,571,156,415,61886,15365,46521,54898231.0,13434991.0,41463239.0,87.42,89.12,87.44,89.13
2023-12-06 12:05,580,209,371,74664,32617,42047,66011558.0,28390325.0,37621233.0,576,205,371,74547,32613,41934,65908101.0,28386730.0,37521371.0,87.04,89.47,87.04,89.48
2023-12-06 12:10,154,46,108,20846,6466,14380,18480659.0,5631869.0,12848790.0,138,38,100,20402,6236,14166,18088368.0,5430481.0,12657887.0,87.1,89.35,87.08,89.35
2023-12-06 12:15,76,40,36,9948,3314,6634,8793232.0,2860828.0,5932403.0,57,27,30,9358,2835,6523,8299842.0,2465415.0,5834427.0,86.33,89.42,86.96,89.44
2023-12-06 12:20,152,42,110,16170,3978,12192,14330724.0,3477179.0,10853544.0,152,40,112,16542,4003,12539,14662799.0,3499873.0,11162925.0,87.41,89.02,87.43,89.03
2023-12-06 12:25,55,17,38,5245,1924,3321,4632835.0,1669125.0,2963710.0,44,15,29,5201,1918,3283,4594021.0,1663961.0,2930060.0,86.75,89.24,86.76,89.25
2023-12-06 12:30,48,27,21,4980,2710,2270,4368355.0,2355880.0,2012474.0,45,18,27,4909,2670,2239,4340295.0,2323921.0,2016374.0,86.93,88.66,87.04,90.06
2023-12-06 12:35,182,62,120,21367,7387,13980,18860639.0,6418088.0,12442550.0,167,54,113,21138,7389,13749,18660632.0,6419919.0,12240712.0,86.88,89.0,86.88,89.03
2023-12-06 12:40,80,12,68,9823,1638,8185,8697475.0,1422614.0,7274861.0,78,11,67,10136,1694,8442,8974109.0,1471859.0,7502250.0,86.85,88.88,86.89,88.87
2023-12-06 12:45,483,179,304,48356,21262,27094,42573230.0,18513927.0,24059302.0,472,176,296,47769,21240,26529,42056629.0,18494237.0,23562392.0,87.08,88.8,87.07,88.82
2023-12-06 12:50,213,59,154,21133,6736,14397,18626220.0,5858021.0,12768198.0,202,53,149,21268,7154,14114,18730381.0,6212549.0,12517832.0,86.97,88.69,86.84,88.69
2023-12-06 12:55,83,14,69,6764,1063,5701,5974425.0,925683.0,5048742.0,78,10,68,6996,1033,5963,6177212.0,896083.0,5281129.0,87.08,88.56,86.75,88.56
2023-12-06 13:00,94,17,77,7521,1305,6216,6636110.0,1135003.0,5501106.0,88,12,76,7479,1267,6212,6598543.0,1100085.0,5498457.0,86.97,88.5,86.83,88.51
2023-12-06 13:05,91,16,75,8153,1854,6299,7184027.0,1605070.0,5578957.0,80,15,65,8103,1852,6251,7141395.0,1604002.0,5537393.0,86.57,88.57,86.61,88.58
2023-12-06 13:10,363,100,263,34020,10498,23522,29937150.0,9091042.0,20846107.0,350,97,253,33989,10521,23468,29909820.0,9112644.0,20797176.0,86.6,88.62,86.61,88.62
2023-12-06 13:15,222,68,154,21030,7407,13623,18484620.0,6423553.0,12061066.0,206,61,145,20906,7407,13499,18378635.0,6424568.0,11954067.0,86.72,88.53,86.74,88.56
2023-12-06 13:20,117,22,95,9787,2039,7748,8605457.0,1760565.0,6844891.0,102,18,84,9573,1857,7716,8425418.0,1604419.0,6820998.0,86.34,88.34,86.4,88.4
2023-12-06 13:25,98,28,70,10932,2648,8284,9601176.0,2281959.0,7319216.0,87,22,65,10686,2626,8060,9393926.0,2267958.0,7125968.0,86.18,88.35,86.37,88.41
2023-12-06 13:30,90,29,61,9060,2086,6974,7963305.0,1797697.0,6165607.0,81,27,54,9251,2212,7039,8127846.0,1903983.0,6223862.0,86.18,88.41,86.08,88.42
2023-12-06 13:35,48,17,31,4747,1772,2975,4160413.0,1534865.0,2625548.0,39,12,27,3980,1438,2542,3492065.0,1244454.0,2247611.0,86.62,88.25,86.54,88.42
2023-12-06 13:40,158,51,107,18543,5606,12937,16242077.0,4835659.0,11406418.0,142,45,97,17837,5609,12228,15637087.0,4841367.0,10795720.0,86.26,88.17,86.31,88.29
2023-12-06 13:45,157,101,56,16228,8481,7747,14145452.0,7321740.0,6823711.0,139,87,52,15847,8474,7373,13818530.0,7316224.0,6502305.0,86.33,88.08,86.34,88.19
2023-12-06 13:50,135,69,66,14298,6703,7595,12464928.0,5776907.0,6688021.0,113,58,55,13662,6273,7389,11915475.0,5405156.0,6510319.0,86.18,88.06,86.17,88.11
2023-12-06 13:55,171,74,97,16664,5690,10974,14526035.0,4889195.0,9636840.0,139,52,87,16040,5310,10730,13991885.0,4560505.0,9431380.0,85.93,87.82,85.89,87.9
2023-12-06 14:00,236,172,64,24121,14106,10015,20970320.0,12190556.0,8779763.0,205,155,50,23412,13693,9719,20310410.0,11769801.0,8540609.0,86.42,87.67,85.95,87.88
2023-12-06 14:05,271,179,92,26598,15824,10774,23016973.0,13600457.0,9416516.0,239,159,80,26389,15819,10570,22888449.0,13600493.0,9287956.0,85.95,87.4,85.98,87.87
2023-12-06 14:10,432,151,281,45184,13450,31734,39167300.0,11486268.0,27681032.0,404,130,274,45047,13377,31670,39055321.0,11425528.0,27629793.0,85.4,87.23,85.41,87.24
2023-12-06 14:15,187,60,127,22143,4817,17326,19243253.0,4119895.0,15123357.0,170,49,121,21869,4730,17139,19004431.0,4044186.0,14960244.0,85.53,87.29,85.5,87.29
2023-12-06 14:20,98,38,60,10814,3097,7717,9383997.0,2649354.0,6734643.0,91,36,55,10419,2961,7458,9040844.0,2531254.0,6509589.0,85.55,87.27,85.49,87.28
2023-12-06 14:25,138,49,89,15835,2812,13023,13806690.0,2415166.0,11391523.0,98,22,76,15283,2576,12707,13321812.0,2200080.0,11121732.0,85.89,87.47,85.41,87.52
2023-12-06 14:30,73,21,52,11717,2193,9524,10215507.0,1875426.0,8340081.0,63,19,44,11301,1930,9371,9857526.0,1648450.0,8209076.0,85.52,87.57,85.41,87.6
2023-12-06 14:35,112,74,38,14683,4464,10219,12822816.0,3843578.0,8979237.0,103,68,35,13943,4149,9794,12174165.0,3567445.0,8606719.0,86.1,87.87,85.98,87.88
2023-12-06 14:40,147,117,30,14386,7675,6711,12495460.0,6588948.0,5906511.0,141,112,29,14375,7669,6706,12485635.0,6583868.0,5901767.0,85.85,88.01,85.85,88.01
2023-12-06 14:45,42,36,6,2593,1948,645,2242616.0,1678024.0,564592.0,37,31,6,2360,1715,645,2044841.0,1480369.0,564472.0,86.14,87.53,86.32,87.52
2023-12-06 14:50,156,116,40,17944,10690,7254,15574772.0,9202376.0,6372395.0,131,100,31,15275,8690,6585,13256706.0,7464627.0,5792079.0,86.08,87.85,85.9,87.96
2023-12-06 14:55,567,325,242,64948,32474,32474,56532016.0,28017976.0,28514039.0,522,298,224,62341,31226,31115,54281465.0,26928311.0,27353154.0,86.28,87.81,86.24,87.91
2023-12-06 15:00,639,277,362,74321,31715,42606,64665171.0,27334022.0,37331148.0,611,269,342,73952,31510,42442,64349831.0,27159864.0,37189966.0,86.19,87.62,86.19,87.63
2023-12-06 15:05,363,176,187,42535,18832,23703,36955506.0,16209506.0,20746000.0,355,169,186,42468,18700,23768,36918372.0,16112183.0,20806188.0,86.07,87.52,86.16,87.54
2023-12-06 15:10,453,202,251,54240,22653,31587,47146115.0,19508887.0,27637227.0,440,194,246,54109,22561,31548,47031704.0,19428125.0,27603579.0,86.12,87.5,86.11,87.5
2023-12-06 15:15,367,174,193,42810,18159,24651,37298152.0,15695531.0,21602620.0,348,159,189,42734,18031,24703,37221631.0,15576493.0,21645138.0,86.43,87.63,86.39,87.62
2023-12-06 15:20,313,107,206,38043,10623,27420,33206525.0,9151664.0,24054861.0,287,94,193,37931,10742,27189,33124622.0,9244547.0,23880075.0,86.15,87.73,86.06,87.83
2023-12-06 15:25,218,73,145,26980,6126,20854,23607050.0,5290424.0,18316625.0,201,60,141,26717,5904,20813,23370132.0,5090390.0,18279742.0,86.36,87.83,86.22,87.83
2023-12-06 15:30,130,43,87,16831,4083,12748,14721566.0,3532288.0,11189277.0,129,43,86,16815,4082,12733,14705444.0,3531431.0,11174013.0,86.51,87.77,86.51,87.76
2023-12-06 15:35,224,66,158,28741,7199,21542,25092136.0,6187358.0,18904778.0,205,53,152,28677,7171,21506,25044804.0,6163202.0,18881601.0,85.95,87.76,85.95,87.8
2023-12-06 15:40,252,80,172,33082,9322,23760,28876934.0,8035832.0,20841102.0,229,68,161,33306,9481,23825,29071402.0,8171661.0,20899740.0,86.2,87.72,86.19,87.72
2023-12-06 15:45,267,80,187,35784,9522,26262,31238516.0,8209706.0,23028809.0,238,66,172,35309,9297,26012,30822618.0,8015259.0,22807358.0,86.22,87.69,86.21,87.68
2023-12-06 15:50,235,64,171,32317,9101,23216,28160396.0,7820377.0,20340018.0,230,64,166,32214,9102,23112,28073909.0,7822845.0,20251064.0,85.93,87.61,85.95,87.62
2023-12-06 15:55,116,22,94,15241,2461,12780,13273881.0,2113747.0,11160133.0,107,16,91,15596,2623,12973,13582365.0,2250416.0,11331948.0,85.89,87.32,85.8,87.35
2023-12-06 16:00,279,70,209,35437,6852,28585,30854162.0,5888263.0,24965898.0,252,56,196,33396,5642,27754,29099196.0,4828187.0,24271009.0,85.93,87.34,85.58,87.45
2023-12-06 16:05,223,57,166,27478,4697,22781,23881644.0,3980832.0,19900812.0,209,47,162,26861,4265,22596,23374385.0,3632784.0,19741601.0,84.75,87.36,85.18,87.37
2023-12-06 16:10,334,100,234,43705,9136,34569,37984874.0,7824540.0,30160334.0,293,76,217,43550,9032,34518,37854677.0,7737607.0,30117069.0,85.65,87.25,85.67,87.25
2023-12-06 16:15,144,37,107,20189,3363,16826,17552495.0,2887722.0,14664772.0,141,35,106,20197,3366,16831,17561523.0,2889898.0,14671625.0,85.87,87.16,85.86,87.17
2023-12-06 16:20,383,108,275,52806,13044,39762,45921262.0,11163274.0,34757987.0,366,103,263,52986,13257,39729,46064199.0,11335724.0,34728475.0,85.58,87.42,85.51,87.41
2023-12-06 16:25,735,220,515,85018,22130,62888,73826210.0,18904927.0,54921283.0,691,197,494,84743,22056,62687,73577062.0,18826003.0,54751058.0,85.43,87.33,85.36,87.34
2023-12-06 16:30,88,9,79,10099,419,9680,8790544.0,357910.0,8432634.0,83,6,77,10088,416,9672,8781319.0,355419.0,8425900.0,85.42,87.11,85.44,87.12
2023-12-06 16:35,196,47,149,24837,4752,20085,21603227.0,4066960.0,17536267.0,189,40,149,24481,4705,19776,21288401.0,4021139.0,17267262.0,85.58,87.31,85.47,87.31
2023-12-06 16:40,305,106,199,38898,10504,28394,33807293.0,8981896.0,24825397.0,291,98,193,38993,10345,28648,33895626.0,8849463.0,25046162.0,85.51,87.43,85.54,87.43
2023-12-06 16:45,157,35,122,21961,3692,18269,19166482.0,3161038.0,16005444.0,136,27,109,21498,3644,17854,18762739.0,3119128.0,15643610.0,85.62,87.61,85.6,87.62
2023-12-06 16:50,190,43,147,30016,5446,24570,26222240.0,4665666.0,21556574.0,181,39,142,30015,5463,24552,26214169.0,4674501.0,21539668.0,85.67,87.74,85.57,87.73
2023-12-06 16:55,281,104,177,38339,10828,27511,33407429.0,9270652.0,24136777.0,258,90,168,38055,10806,27249,33164612.0,9251633.0,23912978.0,85.62,87.74,85.62,87.76
2023-12-06 17:00,285,87,198,30236,9566,20670,26249263.0,8191260.0,18058002.0,261,73,188,30223,9557,20666,26237787.0,8182831.0,18054956.0,85.63,87.36,85.62,87.37
2023-12-06 17:05,225,81,144,28133,6525,21608,24535029.0,5582215.0,18952814.0,214,77,137,28092,6514,21578,24498206.0,5571352.0,18926854.0,85.55,87.71,85.53,87.71
2023-12-06 17:10,90,17,73,7712,724,6988,6673624.0,619241.0,6054382.0,87,15,72,7531,737,6794,6541704.0,630513.0,5911191.0,85.53,86.64,85.55,87.01
2023-12-06 17:15,231,56,175,25662,5730,19932,22258057.0,4900149.0,17357908.0,215,46,169,25411,5525,19886,22026095.0,4707478.0,17318617.0,85.52,87.09,85.2,87.09
2023-12-06 17:20,118,69,49,11677,5555,6122,10150923.0,4797213.0,5353710.0,108,61,47,11735,5595,6140,10165010.0,4795788.0,5369222.0,86.36,87.45,85.72,87.45
2023-12-06 17:25,286,214,72,30842,19114,11728,26736471.0,16427595.0,10308876.0,276,212,64,30799,19096,11703,26696556.0,16409383.0,10287173.0,85.95,87.9,85.93,87.9
2023-12-06 17:30,345,271,74,36527,22953,13574,31684369.0,19741695.0,11942674.0,334,262,72,36268,22939,13329,31454069.0,19728933.0,11725135.0,86.01,87.98,86.01,87.97
2023-12-06 17:35,174,149,25,15142,10948,4194,13133744.0,9443985.0,3689759.0,172,147,25,15057,10863,4194,13060426.0,9369277.0,3691148.0,86.26,87.98,86.25,88.01
2023-12-06 17:40,170,136,34,16033,10163,5870,13925962.0,8763267.0,5162694.0,161,131,30,16029,10158,5871,13922614.0,8758280.0,5164334.0,86.23,87.95,86.22,87.96
2023-12-06 17:45,133,102,31,14482,7266,7216,12613115.0,6270206.0,6342909.0,125,96,29,14461,7235,7226,12595801.0,6243245.0,6352556.0,86.3,87.9,86.29,87.91
2023-12-06 17:50,122,88,34,14749,6677,8072,12852259.0,5760912.0,7091347.0,121,87,34,14748,6676,8072,12851360.0,5760178.0,7091182.0,86.28,87.85,86.28,87.85
2023-12-06 17:55,405,287,118,49787,23175,26612,43411992.0,19960969.0,23451023.0,386,273,113,48995,22341,26654,42715719.0,19235042.0,23480676.0,86.13,88.12,86.1,88.09
2023-12-06 18:00,226,152,74,24950,9132,15818,21866675.0,7900802.0,13965873.0,218,146,72,24941,9057,15884,21857691.0,7832653.0,14025038.0,86.52,88.29,86.48,88.3
2023-12-06 18:05,1063,757,306,72906,41622,31284,64051415.0,36293744.0,27757671.0,981,720,261,71287,40803,30484,62589411.0,35530642.0,27058768.0,87.2,88.73,87.08,88.76
2023-12-06 18:10,643,469,174,55669,34963,20706,48905164.0,30508775.0,18396388.0,609,456,153,54191,33874,20317,47609970.0,29558521.0,18051449.0,87.26,88.85,87.26,88.85
2023-12-06 18:15,1146,542,604,102574,45217,57357,90127174.0,39331138.0,50796036.0,1130,528,602,102767,45633,57134,90299417.0,39697680.0,50601736.0,86.98,88.56,86.99,88.57
2023-12-06 18:20,642,287,355,76774,35486,41288,67202419.0,30713399.0,36489020.0,616,280,336,75564,35319,40245,66223845.0,30575153.0,35648692.0,86.55,88.38,86.57,88.58
2023-12-06 18:25,407,162,245,48766,18439,30327,42577045.0,15835787.0,26741258.0,393,153,240,47627,18027,29600,41594610.0,15486870.0,26107739.0,85.88,88.18,85.91,88.2
2023-12-06 18:30,232,72,160,20841,6511,14330,18169682.0,5574843.0,12594839.0,225,70,155,20728,6495,14233,18077105.0,5561087.0,12516017.0,85.62,87.89,85.62,87.94
2023-12-06 18:35,131,44,87,11350,2946,8404,9868531.0,2518040.0,7350491.0,133,48,85,11884,3395,8489,10338342.0,2893915.0,7444427.0,85.47,87.46,85.24,87.69
2023-12-07 10:00,18346,415,17931,646193,19359,626834,56908131.0,1673070.0,1673070.0,18120,342,17778,641187,18045,623142,56463931.0,1568023.0,1568023.0,8.64,8.81,8.69,8.81
2023-12-07 10:05,439,112,327,44136,6297,37839,3865239.0,539569.0,539569.0,398,86,312,42903,5743,37160,3764746.0,491680.0,491680.0,8.57,8.79,8.56,8.81
2023-12-07 10:10,318,141,177,14500,3205,11295,1265585.0,270417.0,270417.0,115,43,72,12755,2417,10338,1113880.0,207342.0,207342.0,8.44,8.81,8.58,8.77
2023-12-07 10:15,241,90,151,42790,12077,30713,3647265.0,954173.0,954173.0,220,81,139,38701,8165,30536,3376759.0,698035.0,698035.0,7.9,8.77,8.55,8.77
2023-12-07 10:20,472,202,270,45124,13454,31670,3861904.0,1139141.0,1139141.0,361,129,232,43084,12529,30555,3728526.0,1064266.0,1064266.0,8.47,8.6,8.49,8.72
2023-12-07 10:25,883,464,419,93659,33633,60026,8027709.0,2800023.0,2800023.0,753,366,387,91330,31548,59782,7889736.0,2684488.0,2684488.0,8.33,8.71,8.51,8.71
2023-12-07 10:30,1255,944,311,87500,38174,49326,7603650.0,3281014.0,3281014.0,1218,934,284,86879,38143,48736,7562934.0,3278741.0,3278741.0,8.59,8.76,8.6,8.79
2023-12-07 10:35,855,342,513,84816,18982,65834,7359039.0,1619929.0,1619929.0,821,321,500,84450,18764,65686,7326926.0,1601262.0,1601262.0,8.53,8.72,8.53,8.72
2023-12-07 10:40,660,433,227,70747,31562,39185,6128829.0,2695474.0,2695474.0,637,423,214,70229,31335,38894,6090600.0,2683304.0,2683304.0,8.54,8.76,8.56,8.76
2023-12-07 10:45,806,692,114,66921,49821,17100,5784980.0,4284346.0,4284346.0,756,665,91,64900,48507,16393,5612571.0,4172612.0,4172612.0,8.6,8.78,8.6,8.78
2023-12-07 10:50,221,185,36,26403,21012,5391,2284142.0,1807530.0,1807530.0,202,174,28,25769,20756,5013,2230247.0,1789752.0,1789752.0,8.6,8.84,8.62,8.79
2023-12-07 10:55,308,263,45,36650,29195,7455,3162122.0,2506102.0,2506102.0,292,252,40,36545,29245,7300,3159944.0,2517467.0,2517467.0,8.58,8.8,8.61,8.8
2023-12-07 11:00,522,467,55,51146,43049,8097,4428480.0,3715725.0,3715725.0,506,457,49,51067,43045,8022,4423615.0,3717294.0,3717294.0,8.63,8.8,8.64,8.8
2023-12-07 11:05,573,325,248,53170,35621,17549,4605826.0,3071647.0,3071647.0,553,317,236,53019,35521,17498,4596452.0,3063225.0,3063225.0,8.62,8.74,8.62,8.76
2023-12-07 11:10,927,450,477,96468,56067,40401,8338927.0,4809781.0,4809781.0,891,433,458,96359,56055,40304,8342471.0,4811327.0,4811327.0,8.58,8.74,8.58,8.76
2023-12-07 11:15,241,158,83,29912,19252,10660,2569983.0,1645174.0,1645174.0,226,150,76,29519,19159,10360,2542752.0,1637512.0,1637512.0,8.55,8.68,8.55,8.74
2023-12-07 11:20,267,137,130,31222,14713,16509,2690801.0,1253391.0,1253391.0,244,122,122,30746,14373,16373,2649846.0,1224133.0,1224133.0,8.52,8.71,8.52,8.71
2023-12-07 11:25,244,144,100,29428,16379,13049,2538329.0,1399678.0,1399678.0,234,141,93,29225,16394,12831,2520169.0,1400827.0,1400827.0,8.55,8.73,8.54,8.72
2023-12-07 11:30,266,139,127,32126,16995,15131,2767089.0,1450093.0,1450093.0,237,128,109,31034,16296,14738,2674296.0,1390130.0,1390130.0,8.53,8.7,8.53,8.71
2023-12-07 11:35,249,97,152,34807,14341,20466,2997239.0,1214171.0,1214171.0,232,86,146,34788,14393,20395,2999010.0,1221026.0,1221026.0,8.47,8.71,8.48,8.72
2023-12-07 11:40,249,73,176,35613,8945,26668,3079291.0,760116.0,760116.0,232,67,165,34011,8396,25615,2942086.0,713074.0,713074.0,8.5,8.7,8.49,8.7
2023-12-07 11:45,255,60,195,35177,6150,29027,3023310.0,515772.0,515772.0,219,39,180,33510,4785,28725,2888583.0,404971.0,404971.0,8.39,8.64,8.46,8.65
2023-12-07 11:50,232,59,173,32780,4349,28431,2824302.0,367030.0,367030.0,205,42,163,32255,4255,28000,2779594.0,359006.0,359006.0,8.44,8.64,8.44,8.64
2023-12-07 11:55,390,205,185,53368,28201,25167,4597551.0,2412284.0,2412284.0,348,177,171,50287,25936,24351,4331667.0,2216841.0,2216841.0,8.55,8.68,8.55,8.68
2023-12-07 12:00,16581,1708,14873,289449,111872,177577,25204714.0,9610590.0,9610590.0,16471,1644,14827,286439,109800,176639,25032650.0,9521401.0,9521401.0,8.59,8.78,8.67,8.78
2023-12-07 12:05,1208,886,322,87110,81352,5758,7572482.0,7064373.0,7064373.0,1167,862,305,86295,80876,5419,7502876.0,7024124.0,7024124.0,8.68,8.82,8.69,8.83
2023-12-07 12:10,121,44,77,9702,8458,1244,838189.0,729498.0,729498.0,121,50,71,9550,8520,1030,825433.0,735023.0,735023.0,8.62,8.74,8.63,8.78
2023-12-07 12:15,179,154,25,21710,21500,210,1873970.0,1856075.0,1856075.0,169,152,17,21488,21433,55,1856484.0,1851630.0,1851630.0,8.63,8.52,8.64,8.83
2023-12-07 12:20,933,865,68,81739,77417,4322,7112779.0,6728807.0,6728807.0,848,788,60,80370,76380,3990,6991801.0,6637412.0,6637412.0,8.69,8.88,8.69,8.88
2023-12-07 12:25,666,272,394,71254,48291,22963,6220895.0,4196429.0,4196429.0,645,264,381,70986,48266,22720,6208946.0,4194299.0,4194299.0,8.69,8.82,8.69,8.87
2023-12-07 12:30,573,239,334,65269,46040,19229,5699479.0,3996390.0,3996390.0,565,237,328,65739,46237,19502,5740948.0,4013524.0,4013524.0,8.68,8.86,8.68,8.86
2023-12-07 12:35,728,276,452,79096,52652,26444,6902764.0,4563793.0,4563793.0,706,265,441,77346,51299,26047,6752098.0,4448050.0,4448050.0,8.67,8.84,8.67,8.85
2023-12-07 12:40,625,160,465,55165,38863,16302,4799664.0,3370216.0,3370216.0,615,155,460,55889,39620,16269,4862477.0,3435473.0,3435473.0,8.67,8.77,8.67,8.77
2023-12-07 12:45,649,142,507,52433,35312,17121,4565168.0,3066035.0,3066035.0,658,153,505,52366,35250,17116,4559221.0,3060503.0,3060503.0,8.68,8.76,8.68,8.76
2023-12-07 12:50,402,102,300,35334,19232,16102,3076681.0,1666283.0,1666283.0,381,92,289,34063,18914,15149,2966256.0,1638820.0,1638820.0,8.66,8.76,8.66,8.76
2023-12-07 12:55,137,17,120,11899,927,10972,1039168.0,79717.0,79717.0,130,11,119,11892,912,10980,1038605.0,78501.0,78501.0,8.6,8.74,8.61,8.74
2023-12-07 13:00,83,24,59,10488,2096,8392,915989.0,180071.0,180071.0,76,21,55,10554,2175,8379,921452.0,186533.0,186533.0,8.59,8.77,8.58,8.77
2023-12-07 13:05,58,16,42,6702,835,5867,585993.0,71681.0,71681.0,52,12,40,6713,848,5865,586994.0,72850.0,72850.0,8.58,8.77,8.59,8.77
2023-12-07 13:10,95,33,62,11723,2769,8954,1024881.0,237679.0,237679.0,89,26,63,11667,2710,8957,1019882.0,232835.0,232835.0,8.58,8.79,8.59,8.79
2023-12-07 13:15,165,22,143,17937,1263,16674,1580802.0,108651.0,108651.0,157,18,139,17918,1282,16636,1579356.0,110207.0,110207.0,8.6,8.83,8.6,8.83
2023-12-07 13:20,175,18,157,16096,1479,14617,1409375.0,127017.0,127017.0,170,17,153,16216,1474,14742,1424351.0,126686.0,126686.0,8.59,8.77,8.59,8.8
2023-12-07 13:25,42,3,39,3343,202,3141,293650.0,17340.0,17340.0,39,3,36,3102,202,2900,272397.0,17340.0,17340.0,8.58,8.8,8.58,8.8
2023-12-07 13:30,391,89,302,37595,13452,24143,3268648.0,1154790.0,1154790.0,371,80,291,37687,13511,24176,3285415.0,1159984.0,1159984.0,8.58,8.76,8.59,8.79
2023-12-07 13:35,991,159,832,80665,24523,56142,7009566.0,2096130.0,2096130.0,965,145,820,80288,24299,55989,6978736.0,2077975.0,2077975.0,8.55,8.75,8.55,8.75
2023-12-07 13:40,473,92,381,42356,11481,30875,3684687.0,981355.0,981355.0,468,88,380,42851,11867,30984,3726018.0,1013032.0,1013032.0,8.55,8.76,8.54,8.76
2023-12-07 13:45,1068,249,819,95895,37650,58245,8305939.0,3221072.0,3221072.0,1043,241,802,95103,37415,57688,8241373.0,3201109.0,3201109.0,8.56,8.73,8.56,8.74
2023-12-07 13:50,851,144,707,68069,19099,48970,5905410.0,1634659.0,1634659.0,837,133,704,68101,18992,49109,5909118.0,1625489.0,1625489.0,8.56,8.72,8.56,8.72
2023-12-07 13:55,663,424,239,79371,45263,34108,6866041.0,3873454.0,3873454.0,641,411,230,79524,45206,34318,6879607.0,3868579.0,3868579.0,8.56,8.77,8.56,8.77
2023-12-07 14:00,350,140,210,33743,12790,20953,2928967.0,1099074.0,1099074.0,335,133,202,33488,12721,20767,2906368.0,1092982.0,1092982.0,8.59,8.73,8.59,8.73
2023-12-07 14:05,378,111,267,43519,13546,29973,3783838.0,1159334.0,1159334.0,361,99,262,43440,13514,29926,3776968.0,1156652.0,1156652.0,8.56,8.76,8.56,8.76
2023-12-07 14:10,379,124,255,45679,15699,29980,3969749.0,1345397.0,1345397.0,376,124,252,45662,15695,29967,3968450.0,1345029.0,1345029.0,8.57,8.75,8.57,8.75
2023-12-07 14:15,417,152,265,50165,19929,30236,4348393.0,1704075.0,1704075.0,403,145,258,48230,18213,30017,4188644.0,1563770.0,1563770.0,8.55,8.75,8.59,8.74
2023-12-07 14:20,640,390,250,67765,32867,34898,5867924.0,2816540.0,2816540.0,621,375,246,67540,32697,34843,5854664.0,2808235.0,2808235.0,8.57,8.74,8.59,8.74
2023-12-07 14:25,571,439,132,51028,30013,21015,4427485.0,2592480.0,2592480.0,569,437,132,51037,30022,21015,4428208.0,2593230.0,2593230.0,8.64,8.73,8.64,8.73
2023-12-07 14:30,675,554,121,53300,33769,19531,4623149.0,2911993.0,2911993.0,665,547,118,53184,33682,19502,4613033.0,2904434.0,2904434.0,8.62,8.76,8.62,8.76
2023-12-07 14:35,416,260,156,51433,26734,24699,4464964.0,2304157.0,2304157.0,406,256,150,51393,26738,24655,4461917.0,2304812.0,2304812.0,8.62,8.75,8.62,8.75
2023-12-07 14:40,605,292,313,77431,36654,40777,6711373.0,3153679.0,3153679.0,575,274,301,77001,36450,40551,6684716.0,3136142.0,3136142.0,8.6,8.72,8.6,8.75
2023-12-07 14:45,489,164,325,57422,20413,37009,4985951.0,1752330.0,1752330.0,476,155,321,57484,20479,37005,4992934.0,1758048.0,1758048.0,8.58,8.74,8.58,8.74
2023-12-07 14:50,287,67,220,36098,9033,27065,3136948.0,772516.0,772516.0,283,67,216,36012,8973,27039,3129760.0,767327.0,767327.0,8.55,8.74,8.55,8.74
2023-12-07 14:55,235,46,189,27057,6234,20823,2348762.0,532809.0,532809.0,220,40,180,27246,6163,21083,2367277.0,527535.0,527535.0,8.55,8.72,8.56,8.73
2023-12-07 15:00,165,24,141,16373,2888,13485,1420406.0,246773.0,246773.0,154,16,138,15985,2523,13462,1388423.0,216040.0,216040.0,8.54,8.7,8.56,8.71
2023-12-07 15:05,85,9,76,8124,1476,6648,705311.0,126749.0,126749.0,79,7,72,7882,1321,6561,684530.0,113414.0,113414.0,8.59,8.7,8.59,8.7
2023-12-07 15:10,76,8,68,6152,233,5919,534999.0,19877.0,19877.0,70,4,66,6108,219,5889,531167.0,18655.0,18655.0,8.53,8.7,8.52,8.7
2023-12-07 15:15,73,14,59,6133,947,5186,532662.0,81048.0,81048.0,67,9,58,5803,937,4866,503865.0,80143.0,80143.0,8.56,8.71,8.55,8.71
2023-12-07 15:20,87,22,65,7991,1961,6030,692842.0,167516.0,167516.0,79,16,63,8522,1850,6672,743082.0,158170.0,158170.0,8.54,8.71,8.55,8.77
2023-12-07 15:25,294,90,204,32684,9536,23148,2835038.0,814423.0,814423.0,282,84,198,32834,9670,23164,2850306.0,827526.0,827526.0,8.54,8.73,8.56,8.73
2023-12-07 15:30,311,79,232,37420,9791,27629,3251688.0,836721.0,836721.0,306,75,231,37205,9606,27599,3233140.0,820790.0,820790.0,8.55,8.74,8.54,8.74
2023-12-07 15:35,146,18,128,14937,2231,12706,1299010.0,190930.0,190930.0,144,17,127,14918,2214,12704,1297398.0,189468.0,189468.0,8.56,8.72,8.56,8.72
2023-12-07 15:40,199,41,158,22921,4044,18877,1968919.0,344924.0,344924.0,185,35,150,22707,4141,18566,1973571.0,354407.0,354407.0,8.53,8.6,8.56,8.72
2023-12-07 15:45,190,35,155,23938,3926,20012,2081231.0,335786.0,335786.0,187,31,156,23879,3939,19940,2076105.0,337192.0,337192.0,8.55,8.72,8.56,8.72
2023-12-07 15:50,110,15,95,13600,1517,12083,1184515.0,130746.0,130746.0,102,10,92,13706,1507,12199,1193890.0,129807.0,129807.0,8.62,8.72,8.61,8.72
2023-12-07 15:55,216,74,142,29521,7882,21639,2555773.0,673644.0,673644.0,206,66,140,29626,8042,21584,2574095.0,687650.0,687650.0,8.55,8.7,8.55,8.74
2023-12-07 16:00,148,44,104,20341,5027,15314,1767188.0,429643.0,429643.0,140,40,100,20322,5018,15304,1765462.0,428920.0,428920.0,8.55,8.73,8.55,8.73
2023-12-07 16:05,163,29,134,21339,3086,18253,1859627.0,264528.0,264528.0,161,26,135,21328,3069,18259,1858379.0,262756.0,262756.0,8.57,8.74,8.56,8.74
2023-12-07 16:10,332,138,194,37297,10193,27104,3249589.0,877761.0,877761.0,324,132,192,37127,10053,27074,3234861.0,865732.0,865732.0,8.61,8.75,8.61,8.75
2023-12-07 16:15,716,307,409,70838,24365,46473,6165311.0,2090278.0,2090278.0,699,294,405,70802,24265,46537,6170848.0,2090373.0,2090373.0,8.58,8.77,8.61,8.77
2023-12-07 16:20,944,48,896,72891,3195,69696,6371571.0,274056.0,274056.0,941,47,894,73026,3426,69600,6383826.0,294591.0,294591.0,8.58,8.75,8.6,8.75
2023-12-07 16:25,1256,278,978,104358,27908,76450,9111469.0,2399623.0,2399623.0,1239,267,972,104305,27790,76515,9108340.0,2390512.0,2390512.0,8.6,8.78,8.6,8.78
2023-12-07 16:30,1726,360,1366,161177,48957,112220,14097092.0,4209919.0,4209919.0,1719,352,1367,161672,48971,112701,14140702.0,4211105.0,4211105.0,8.6,8.81,8.6,8.81
2023-12-07 16:35,1059,192,867,90778,24083,66695,7945856.0,2068671.0,2068671.0,1045,188,857,89948,23845,66103,7875185.0,2050399.0,2050399.0,8.59,8.81,8.6,8.81
2023-12-07 16:40,1108,200,908,106878,29293,77585,9363083.0,2518322.0,2518322.0,1096,193,903,106608,29076,77532,9341309.0,2500523.0,2500523.0,8.6,8.82,8.6,8.82
2023-12-07 16:45,771,66,705,52680,5127,47553,4617902.0,441664.0,441664.0,768,66,702,52982,5530,47452,4643626.0,476039.0,476039.0,8.61,8.78,8.61,8.78
2023-12-07 16:50,593,156,437,59494,15066,44428,5158322.0,1292817.0,1292817.0,570,146,424,58746,14772,43974,5116225.0,1268280.0,1268280.0,8.58,8.7,8.59,8.75
2023-12-07 16:55,201,60,141,26304,6874,19430,2286166.0,589934.0,589934.0,198,59,139,26152,6882,19270,2272915.0,590650.0,590650.0,8.58,8.73,8.58,8.73
2023-12-07 17:00,402,135,267,54220,15751,38469,4712932.0,1352255.0,1352255.0,395,132,263,54141,15696,38445,4706160.0,1347559.0,1347559.0,8.59,8.74,8.59,8.74
2023-12-07 17:05,435,111,324,60878,13402,47476,5289149.0,1146148.0,1146148.0,426,106,320,60844,13392,47452,5286464.0,1145370.0,1145370.0,8.55,8.73,8.55,8.73
2023-12-07 17:10,530,156,374,72515,16598,55917,6304276.0,1418575.0,1418575.0,520,149,371,72367,16392,55975,6291645.0,1400852.0,1400852.0,8.55,8.74,8.55,8.74
2023-12-07 17:15,164,42,122,22896,4208,18688,1993460.0,361452.0,361452.0,156,37,119,22978,4328,18650,2000432.0,371759.0,371759.0,8.59,8.73,8.59,8.73
2023-12-07 17:20,138,21,117,19890,1829,18061,1733256.0,157358.0,157358.0,133,16,117,20035,1969,18066,1746528.0,169705.0,169705.0,8.6,8.73,8.62,8.73
2023-12-07 17:25,126,18,108,17123,1238,15885,1492520.0,105999.0,105999.0,119,13,106,16987,1145,15842,1480664.0,98021.0,98021.0,8.56,8.73,8.56,8.73
2023-12-07 17:30,113,12,101,15297,1000,14297,1333996.0,86145.0,86145.0,110,9,101,15276,961,14315,1332740.0,82774.0,82774.0,8.61,8.73,8.61,8.73
2023-12-07 17:35,191,35,156,24583,2431,22152,2142246.0,208065.0,208065.0,179,24,155,24555,2406,22149,2140237.0,206334.0,206334.0,8.56,8.73,8.58,8.73
2023-12-07 17:40,260,49,211,33479,4863,28616,2915216.0,416824.0,416824.0,237,33,204,33151,4567,28584,2889180.0,391806.0,391806.0,8.57,8.73,8.58,8.74
2023-12-07 17:45,267,47,220,35528,5176,30352,3092608.0,444404.0,444404.0,257,44,213,35315,5280,30035,3074176.0,453361.0,453361.0,8.59,8.72,8.59,8.73
2023-12-07 17:50,331,75,256,45078,9187,35891,3920318.0,784884.0,784884.0,327,72,255,45068,9185,35883,3919441.0,784762.0,784762.0,8.54,8.74,8.54,8.74
2023-12-07 17:55,379,160,219,49066,13026,36040,4254185.0,1104701.0,1104701.0,368,151,217,48681,12626,36055,4236953.0,1086297.0,1086297.0,8.48,8.74,8.6,8.74
2023-12-07 18:00,273,164,109,35374,13123,22251,3079687.0,1133136.0,1133136.0,266,161,105,35335,13128,22207,3076302.0,1133549.0,1133549.0,8.63,8.75,8.63,8.75
2023-12-07 18:05,570,306,264,73867,30037,43830,6421128.0,2584721.0,2584721.0,559,304,255,73782,30075,43707,6420198.0,2588129.0,2588129.0,8.61,8.75,8.61,8.77
2023-12-07 18:10,562,342,220,66075,38575,27500,5739981.0,3328410.0,3328410.0,535,329,206,63834,36736,27098,5543899.0,3167853.0,3167853.0,8.63,8.77,8.62,8.77
2023-12-07 18:15,296,264,32,31526,28568,2958,2737653.0,2475923.0,2475923.0,283,255,28,31428,28480,2948,2730329.0,2469375.0,2469375.0,8.67,8.85,8.67,8.85
2023-12-07 18:20,682,519,163,75310,56446,18864,6604540.0,4922089.0,4922089.0,647,504,143,73706,55248,18458,6462084.0,4815077.0,4815077.0,8.72,8.92,8.72,8.92
2023-12-07 18:25,649,265,384,63080,43308,19772,5540924.0,3776559.0,3776559.0,595,250,345,62657,43316,19341,5504068.0,3777048.0,3777048.0,8.72,8.92,8.72,8.93
2023-12-07 18:30,208,147,61,27399,23944,3455,2398514.0,2090543.0,2090543.0,188,142,46,26895,23611,3284,2355209.0,2061775.0,2061775.0,8.73,8.91,8.73,8.94
2023-12-07 18:35,207,137,70,23849,21407,2442,2087175.0,1870922.0,1870922.0,210,146,64,24867,22290,2577,2175007.0,1946520.0,1946520.0,8.74,8.86,8.73,8.87
2023-12-08 10:00,404,215,189,21256,16933,4323,1875178.0,1454882.0,1454882.0,158,128,30,16382,15434,948,1435383.0,1350575.0,1350575.0,8.59,9.72,8.75,8.95
2023-12-08 10:05,137,106,31,15363,10649,4714,1421188.0,933397.0,933397.0,96,84,12,10550,10078,472,928060.0,885763.0,885763.0,8.77,10.35,8.79,8.96
2023-12-08 10:10,243,109,134,2506,603,1903,225281.0,51056.0,51056.0,49,14,35,1934,522,1412,170611.0,44358.0,44358.0,8.47,9.16,8.5,8.94
2023-12-08 10:15,108,61,47,10285,7868,2417,897293.0,686011.0,686011.0,85,50,35,9568,7460,2108,839230.0,651028.0,651028.0,8.72,8.74,8.73,8.93
2023-12-08 10:20,854,525,329,84027,58843,25184,7349985.0,5115693.0,5115693.0,800,502,298,82642,58410,24232,7236550.0,5086572.0,5086572.0,8.69,8.87,8.71,8.87
2023-12-08 10:25,80,47,33,6491,3161,3330,565234.0,270762.0,270762.0,53,26,27,5202,1991,3211,455826.0,171790.0,171790.0,8.57,8.84,8.63,8.85
2023-12-08 10:30,48,29,19,4466,2853,1613,384992.0,242536.0,242536.0,32,17,15,4212,2759,1453,367635.0,238913.0,238913.0,8.5,8.83,8.66,8.86
2023-12-08 10:35,235,133,102,24197,16875,7322,2102531.0,1454354.0,1454354.0,201,103,98,23886,16598,7288,2086385.0,1441274.0,1441274.0,8.62,8.85,8.68,8.85
2023-12-08 10:40,19164,374,18790,629772,46366,583406,55406923.0,4038420.0,4038420.0,19147,371,18776,629645,46365,583280,55395486.0,4038204.0,4038204.0,8.71,8.8,8.71,8.8
2023-12-08 10:45,278,176,102,26990,20214,6776,2362539.0,1763198.0,1763198.0,270,173,97,26587,20017,6570,2327118.0,1746193.0,1746193.0,8.72,8.85,8.72,8.84
2023-12-08 10:50,341,269,72,41293,35202,6091,3610696.0,3068742.0,3068742.0,317,261,56,41101,35097,6004,3595030.0,3059935.0,3059935.0,8.72,8.9,8.72,8.91
2023-12-08 10:55,224,190,34,22904,18664,4240,1998780.0,1620949.0,1620949.0,210,181,29,22363,18139,4224,1955234.0,1578816.0,1578816.0,8.68,8.91,8.7,8.91
2023-12-08 11:00,841,464,377,109016,71686,37330,9533891.0,6221112.0,6221112.0,820,455,365,108832,71587,37245,9521273.0,6212827.0,6212827.0,8.68,8.87,8.68,8.88
2023-12-08 11:05,453,267,186,56596,38957,17639,4942512.0,3376972.0,3376972.0,437,263,174,56002,38662,17340,4896501.0,3355265.0,3355265.0,8.67,8.88,8.68,8.89
2023-12-08 11:10,307,215,92,43181,33482,9699,3782599.0,2918836.0,2918836.0,283,205,78,42701,33122,9579,3740975.0,2887623.0,2887623.0,8.72,8.91,8.72,8.91
2023-12-08 11:15,398,318,80,54316,43667,10649,4759233.0,3810901.0,3810901.0,396,316,80,54652,44065,10587,4781357.0,3838144.0,3838144.0,8.73,8.91,8.71,8.91
2023-12-08 11:20,250,200,50,38163,31932,6231,3344265.0,2788904.0,2788904.0,244,196,48,38156,31914,6242,3344105.0,2787491.0,2787491.0,8.73,8.91,8.73,8.92
2023-12-08 11:25,392,357,35,43834,40111,3723,3838494.0,3507147.0,3507147.0,374,342,32,43447,39742,3705,3808032.0,3478093.0,3478093.0,8.74,8.9,8.75,8.91
2023-12-08 11:30,1146,1122,24,97635,95574,2061,8552716.0,8369349.0,8369349.0,1132,1114,18,97756,95684,2072,8567263.0,8382500.0,8382500.0,8.76,8.9,8.76,8.92
2023-12-08 11:35,1289,1211,78,117479,106129,11350,10300349.0,9287844.0,9287844.0,1278,1207,71,117424,106103,11321,10295443.0,9285617.0,9285617.0,8.75,8.92,8.75,8.92
2023-12-08 11:40,567,497,70,62356,52435,9921,5467934.0,4583872.0,4583872.0,557,492,65,62126,52407,9719,5448161.0,4581529.0,4581529.0,8.74,8.91,8.74,8.92
2023-12-08 11:45,351,217,134,45313,34448,10865,3956281.0,2995795.0,2995795.0,318,200,118,44878,34364,10514,3921182.0,2989564.0,2989564.0,8.7,8.84,8.7,8.86
2023-12-08 11:50,203,122,81,26620,20554,6066,2321400.0,1785618.0,1785618.0,168,95,73,26111,20026,6085,2277009.0,1739788.0,1739788.0,8.69,8.83,8.69,8.83
2023-12-08 11:55,417,209,208,51897,33828,18069,4534559.0,2938985.0,2938985.0,390,195,195,52852,35122,17730,4609555.0,3041690.0,3041690.0,8.69,8.83,8.66,8.84
2023-12-08 12:00,125,60,65,17093,11014,6079,1491712.0,953276.0,953276.0,117,55,62,17118,11077,6041,1494249.0,958985.0,958985.0,8.66,8.86,8.66,8.86
2023-12-08 12:05,163,90,73,15569,8933,6636,1353836.0,770142.0,770142.0,149,83,66,16297,9424,6873,1421469.0,812768.0,812768.0,8.62,8.8,8.62,8.86
2023-12-08 12:10,147,72,75,18681,11796,6885,1629536.0,1020136.0,1020136.0,131,63,68,17945,11325,6620,1565401.0,979282.0,979282.0,8.65,8.85,8.65,8.85
2023-12-08 12:15,191,102,89,19094,11542,7552,1668259.0,999487.0,999487.0,172,87,85,19427,11847,7580,1696223.0,1025001.0,1025001.0,8.66,8.86,8.65,8.86
2023-12-08 12:20,136,87,49,16946,10055,6891,1480384.0,868991.0,868991.0,119,75,44,16741,9932,6809,1463424.0,859335.0,859335.0,8.64,8.87,8.65,8.87
2023-12-08 12:25,66,38,28,7892,4642,3250,690223.0,401504.0,401504.0,61,34,27,7868,4619,3249,688590.0,399965.0,399965.0,8.65,8.88,8.66,8.88
2023-12-08 12:30,232,148,84,25519,15723,9796,2219670.0,1360673.0,1360673.0,197,122,75,25531,15771,9760,2230798.0,1365048.0,1365048.0,8.65,8.77,8.66,8.87
2023-12-08 12:35,263,199,64,35812,28235,7577,3118319.0,2445905.0,2445905.0,246,189,57,35594,28031,7563,3108848.0,2437697.0,2437697.0,8.66,8.87,8.7,8.87
2023-12-08 12:40,208,155,53,32515,24477,8038,2841849.0,2127233.0,2127233.0,199,152,47,32502,24477,8025,2841523.0,2128078.0,2128078.0,8.69,8.89,8.69,8.89
2023-12-08 12:45,169,130,39,28141,23119,5022,2458069.0,2011839.0,2011839.0,165,127,38,28114,23101,5013,2455843.0,2010387.0,2010387.0,8.7,8.89,8.7,8.89
2023-12-08 12:50,146,116,30,20258,17433,2825,1767385.0,1517482.0,1517482.0,134,109,25,20191,17358,2833,1762645.0,1511270.0,1511270.0,8.7,8.85,8.71,8.87
2023-12-08 12:55,155,115,40,19854,16687,3167,1730937.0,1451311.0,1451311.0,130,96,34,18684,15565,3119,1629914.0,1353282.0,1353282.0,8.7,8.83,8.69,8.87
2023-12-08 13:00,92,42,50,8473,5392,3081,733592.0,460257.0,460257.0,76,31,45,7141,4239,2902,624878.0,367503.0,367503.0,8.54,8.87,8.67,8.87
2023-12-08 13:05,191,124,67,15051,9833,5218,1321991.0,859514.0,859514.0,181,121,60,14652,9474,5178,1287559.0,827895.0,827895.0,8.74,8.86,8.74,8.88
2023-12-08 13:10,503,446,57,33415,29483,3932,2931930.0,2583870.0,2583870.0,501,444,57,32758,28826,3932,2875925.0,2527866.0,2527866.0,8.76,8.85,8.77,8.85
2023-12-08 13:15,942,825,117,68714,59292,9422,6031143.0,5196428.0,5196428.0,934,821,113,69241,59858,9383,6076737.0,5244719.0,5244719.0,8.76,8.86,8.76,8.87
2023-12-08 13:20,553,534,19,37820,36482,1338,3313637.0,3194917.0,3194917.0,540,522,18,37442,36115,1327,3282359.0,3164526.0,3164526.0,8.76,8.87,8.76,8.88
2023-12-08 13:25,448,441,7,32207,31810,397,2818865.0,2784186.0,2784186.0,447,441,6,32111,31721,390,2811270.0,2776603.0,2776603.0,8.75,8.74,8.75,8.89
2023-12-08 13:30,359,339,20,22599,20297,2302,1980786.0,1776658.0,1776658.0,350,333,17,22449,20162,2287,1967676.0,1764774.0,1764774.0,8.75,8.87,8.75,8.87
2023-12-08 13:35,657,632,25,34075,31130,2945,2987121.0,2725250.0,2725250.0,651,628,23,33905,31043,2862,2976615.0,2722176.0,2722176.0,8.75,8.89,8.77,8.89
2023-12-08 13:40,236,207,29,21578,17662,3916,1895628.0,1547647.0,1547647.0,231,204,27,21576,17651,3925,1895484.0,1546726.0,1546726.0,8.76,8.89,8.76,8.89
2023-12-08 13:45,207,149,58,24067,17470,6597,2114273.0,1528139.0,1528139.0,198,143,55,24042,17452,6590,2113053.0,1526612.0,1526612.0,8.75,8.88,8.75,8.9
2023-12-08 13:50,924,917,7,73251,72859,392,6415609.0,6380831.0,6380831.0,920,915,5,73233,72847,386,6414224.0,6379895.0,6379895.0,8.76,8.87,8.76,8.89
2023-12-08 13:55,798,780,18,71935,70822,1113,6297967.0,6199072.0,6199072.0,787,774,13,72265,70963,1302,6326669.0,6210646.0,6210646.0,8.75,8.89,8.75,8.91
2023-12-08 14:00,136,117,19,7826,6280,1546,686918.0,549822.0,549822.0,131,118,13,7582,6319,1263,664445.0,552327.0,552327.0,8.76,8.87,8.74,8.88
2023-12-08 14:05,253,120,133,27162,12824,14338,2397843.0,1118724.0,1118724.0,235,111,124,26372,12137,14235,2328347.0,1058161.0,1058161.0,8.72,8.92,8.72,8.92
2023-12-08 14:10,201,78,123,19291,7655,11636,1704857.0,666812.0,666812.0,188,71,117,18602,7412,11190,1643402.0,645474.0,645474.0,8.71,8.92,8.71,8.92
2023-12-08 14:15,116,29,87,10545,3511,7034,932354.0,305695.0,305695.0,122,31,91,10654,3612,7042,941624.0,314276.0,314276.0,8.71,8.91,8.7,8.91
2023-12-08 14:20,117,34,83,10607,3786,6821,937499.0,329493.0,329493.0,113,30,83,10543,3722,6821,931994.0,323947.0,323947.0,8.7,8.91,8.7,8.91
2023-12-08 14:25,243,133,110,27066,16803,10263,2383816.0,1466966.0,1466966.0,230,127,103,26814,16560,10254,2366273.0,1450347.0,1450347.0,8.73,8.93,8.76,8.93
2023-12-08 14:30,238,169,69,27483,17502,9981,2425982.0,1530111.0,1530111.0,221,158,63,27327,17479,9848,2413989.0,1530091.0,1530091.0,8.74,8.98,8.75,8.98
2023-12-08 14:35,201,136,65,23958,15335,8623,2117201.0,1342968.0,1342968.0,193,131,62,24424,15749,8675,2159067.0,1380085.0,1380085.0,8.76,8.98,8.76,8.98
2023-12-08 14:40,93,72,21,9291,6777,2514,820865.0,594983.0,594983.0,93,72,21,9087,6564,2523,803071.0,576406.0,576406.0,8.78,8.98,8.78,8.98
2023-12-08 14:45,186,122,64,17676,11848,5828,1563894.0,1041241.0,1041241.0,180,123,57,18040,12281,5759,1596037.0,1079335.0,1079335.0,8.79,8.97,8.79,8.97
2023-12-08 14:50,110,74,36,10094,6747,3347,892987.0,592793.0,592793.0,106,71,35,9845,6500,3345,871090.0,571078.0,571078.0,8.79,8.97,8.79,8.97
2023-12-08 14:55,132,92,40,12638,8905,3733,1118471.0,783215.0,783215.0,121,88,33,12716,9065,3651,1125242.0,797350.0,797350.0,8.8,8.98,8.8,8.98
2023-12-08 15:00,63,51,12,2419,1975,444,213567.0,173852.0,173852.0,60,51,9,2437,1963,474,215246.0,172645.0,172645.0,8.8,8.94,8.79,8.99
2023-12-08 15:05,74,52,22,6432,4479,1953,565240.0,393221.0,393221.0,62,48,14,5383,3696,1687,475805.0,324709.0,324709.0,8.78,8.81,8.79,8.96
2023-12-08 15:10,92,47,45,9678,5790,3888,840888.0,506697.0,506697.0,80,42,38,9201,5573,3628,812001.0,488064.0,488064.0,8.75,8.6,8.76,8.93
2023-12-08 15:15,359,169,190,40164,21064,19100,3533908.0,1836959.0,1836959.0,336,156,180,40037,21027,19010,3529610.0,1834226.0,1834226.0,8.72,8.88,8.72,8.92
2023-12-08 15:20,143,66,77,12636,5804,6832,1114484.0,505899.0,505899.0,137,63,74,12803,5969,6834,1129158.0,520469.0,520469.0,8.72,8.91,8.72,8.91
2023-12-08 15:25,332,113,219,36769,16141,20628,3238243.0,1403958.0,1403958.0,319,108,211,36773,16186,20587,3242919.0,1408135.0,1408135.0,8.7,8.89,8.7,8.91
2023-12-08 15:30,595,212,383,75878,32084,43794,6667161.0,2789646.0,2789646.0,574,205,369,71154,30760,40394,6255085.0,2674749.0,2674749.0,8.69,8.85,8.7,8.86
2023-12-08 15:35,568,195,373,74008,23172,50836,6502785.0,2011276.0,2011276.0,562,190,372,74286,22140,52146,6531912.0,1920804.0,1920804.0,8.68,8.84,8.68,8.84
2023-12-08 15:40,472,144,328,61450,16198,45252,5395019.0,1399970.0,1399970.0,445,139,306,62216,18166,44050,5463745.0,1572435.0,1572435.0,8.64,8.83,8.66,8.83
2023-12-08 15:45,307,147,160,37864,12375,25489,3286498.0,1055438.0,1055438.0,251,108,143,35364,10066,25298,3076639.0,860434.0,860434.0,8.53,8.75,8.55,8.76
2023-12-08 15:50,484,166,318,70047,13987,56060,6104848.0,1193714.0,1193714.0,443,132,311,68979,12966,56013,6014996.0,1107426.0,1107426.0,8.53,8.76,8.54,8.76
2023-12-08 15:55,474,256,218,55814,17538,38276,4784906.0,1497973.0,1497973.0,438,233,205,54818,17253,37565,4761590.0,1475608.0,1475608.0,8.54,8.59,8.55,8.75
2023-12-08 16:00,669,197,472,88334,18683,69651,7571357.0,1586869.0,1586869.0,602,158,444,86262,17957,68305,7487863.0,1526450.0,1526450.0,8.49,8.59,8.5,8.73
2023-12-08 16:05,1033,568,465,92561,24337,68224,7777451.0,2051401.0,2051401.0,898,469,429,87903,22659,65244,7571833.0,1911908.0,1911908.0,8.43,8.39,8.44,8.68
2023-12-08 16:10,558,181,377,87253,18436,68817,7456479.0,1546232.0,1546232.0,483,123,360,86798,18160,68638,7420025.0,1524080.0,1524080.0,8.39,8.59,8.39,8.59
2023-12-08 16:15,655,222,433,84283,16339,67944,7281062.0,1375208.0,1375208.0,599,179,420,84949,16583,68366,7341302.0,1399591.0,1399591.0,8.42,8.69,8.44,8.69
2023-12-08 16:20,1080,361,719,126543,31222,95321,10989405.0,2664426.0,2664426.0,1009,303,706,126300,31355,94945,10967393.0,2675015.0,2675015.0,8.53,8.73,8.53,8.73
2023-12-08 16:25,1391,414,977,141457,35206,106251,12266539.0,3006788.0,3006788.0,1367,400,967,141342,35395,105947,12266968.0,3026813.0,3026813.0,8.54,8.71,8.55,8.72
2023-12-08 16:30,399,91,308,56381,11325,45056,4884994.0,963929.0,963929.0,390,90,300,56094,11253,44841,4860637.0,958020.0,958020.0,8.51,8.7,8.51,8.7
2023-12-08 16:35,179,28,151,27544,1900,25644,2389709.0,161959.0,161959.0,166,15,151,27374,1635,25739,2374792.0,138741.0,138741.0,8.52,8.69,8.49,8.69
2023-12-08 16:40,184,41,143,29673,4380,25293,2574857.0,373641.0,373641.0,178,36,142,29960,4559,25401,2601088.0,389263.0,389263.0,8.53,8.7,8.54,8.71
2023-12-08 16:45,338,57,281,44023,5048,38975,3825087.0,431115.0,431115.0,328,49,279,44121,5071,39050,3833480.0,432854.0,432854.0,8.54,8.71,8.54,8.71
2023-12-08 16:50,525,103,422,71808,12356,59452,6231418.0,1053377.0,1053377.0,509,96,413,71524,12339,59185,6209256.0,1052376.0,1052376.0,8.53,8.71,8.53,8.71
2023-12-08 16:55,294,56,238,40887,7055,33832,3547023.0,602367.0,602367.0,286,49,237,40796,6876,33920,3540447.0,587013.0,587013.0,8.54,8.7,8.54,8.71
2023-12-08 17:00,1125,251,874,163709,44435,119274,14191072.0,3788399.0,3788399.0,1128,252,876,163809,44500,119309,14199855.0,3793974.0,3793974.0,8.53,8.72,8.53,8.72
2023-12-08 17:05,59,9,50,9482,208,9274,821932.0,17706.0,17706.0,59,11,48,9454,210,9244,821152.0,17880.0,17880.0,8.51,8.67,8.51,8.69
2023-12-08 17:10,707,144,563,91442,15435,76007,7937210.0,1318078.0,1318078.0,691,133,558,90660,14764,75896,7869147.0,1259922.0,1259922.0,8.54,8.71,8.53,8.71
2023-12-08 17:15,384,184,200,37316,12893,24423,3205864.0,1066612.0,1066612.0,345,166,179,35752,11704,24048,3114316.0,1007498.0,1007498.0,8.27,8.76,8.61,8.76
2023-12-08 17:20,297,101,196,35835,11335,24500,3116160.0,971728.0,971728.0,295,96,199,35746,11324,24422,3108228.0,970948.0,970948.0,8.57,8.75,8.57,8.75
2023-12-08 17:25,304,164,140,35994,16819,19175,3128463.0,1445693.0,1445693.0,308,168,140,36332,17170,19162,3156801.0,1475088.0,1475088.0,8.6,8.78,8.59,8.78
2023-12-08 17:30,463,210,253,49058,20005,29053,4270598.0,1720760.0,1720760.0,456,206,250,49039,20001,29038,4268771.0,1720413.0,1720413.0,8.6,8.78,8.6,8.78
2023-12-08 17:35,160,71,89,18719,6459,12260,1630884.0,554589.0,554589.0,152,63,89,18370,6099,12271,1601764.0,524537.0,524537.0,8.59,8.78,8.6,8.78
2023-12-08 17:40,145,55,90,16898,6575,10323,1469561.0,566455.0,566455.0,132,52,80,16102,5965,10137,1405027.0,513269.0,513269.0,8.62,8.75,8.6,8.8
2023-12-08 17:45,99,36,63,8826,2855,5971,767560.0,241656.0,241656.0,83,30,53,8921,3014,5907,779651.0,259255.0,259255.0,8.46,8.81,8.6,8.81
2023-12-08 17:50,211,60,151,24454,6928,17526,2134352.0,595331.0,595331.0,200,55,145,24775,7438,17337,2162542.0,639793.0,639793.0,8.59,8.78,8.6,8.78
2023-12-08 17:55,245,55,190,29084,6800,22284,2540377.0,585012.0,585012.0,244,54,190,29024,6839,22185,2535195.0,588199.0,588199.0,8.6,8.77,8.6,8.78
2023-12-08 18:00,259,85,174,31444,8387,23057,2735325.0,717443.0,717443.0,252,83,169,31538,8419,23119,2752735.0,724768.0,724768.0,8.55,8.75,8.61,8.77
2023-12-08 18:05,665,379,286,73697,32597,41100,6418342.0,2806465.0,2806465.0,642,369,273,73006,32198,40808,6367347.0,2781340.0,2781340.0,8.61,8.79,8.64,8.79
2023-12-08 18:10,396,228,168,48750,20799,27951,4255568.0,1800586.0,1800586.0,400,229,171,48782,20802,27980,4258808.0,1800980.0,1800980.0,8.66,8.78,8.66,8.78
2023-12-08 18:15,132,88,44,15750,9419,6331,1353116.0,797283.0,797283.0,128,85,43,15328,9132,6196,1335999.0,792086.0,792086.0,8.46,8.78,8.67,8.78
2023-12-08 18:20,69,51,18,9154,7132,2022,794386.0,616314.0,616314.0,70,53,17,8760,7117,1643,762813.0,617928.0,617928.0,8.64,8.81,8.68,8.82
2023-12-08 18:25,89,60,29,9642,6869,2773,834982.0,595668.0,595668.0,76,53,23,10006,7071,2935,872340.0,613664.0,613664.0,8.67,8.63,8.68,8.81
2023-12-08 18:30,349,137,212,38868,17282,21586,3370141.0,1487632.0,1487632.0,325,126,199,38404,17246,21158,3337024.0,1485985.0,1485985.0,8.61,8.72,8.62,8.75
2023-12-08 18:35,388,112,276,30110,12531,17579,2608796.0,1077414.0,1077414.0,374,111,263,30427,12823,17604,2635875.0,1101993.0,1101993.0,8.6,8.71,8.59,8.71
