datetime,put_orders,put_orders_b,put_orders_s,put_vol,put_vol_b,put_vol_s,put_val,put_val_b,put_val_s,cancel_orders,cancel_orders_b,cancel_orders_s,cancel_vol,cancel_vol_b,cancel_vol_s,cancel_val,cancel_val_b,cancel_val_s,put_vwap_b,put_vwap_s,cancel_vwap_b,cancel_vwap_s
2023-03-29 10:00,210,148,62,25732,18205,7527,15698026.0,11217972.0,4480053.0,41,27,14,9556,7940,1616,5426589.0,4473816.0,952772.0,0.6162,0.5952,0.5635,0.5896
2023-03-29 10:05,203,125,78,30888,20539,10349,17775569.0,11838961.0,5936607.0,62,34,28,22708,17319,5389,13123750.0,9960786.0,3162963.0,0.5764,0.5736,0.5751,0.5869
2023-03-29 10:10,140,96,44,14903,5304,9599,8788282.0,3013025.0,5775256.0,56,33,23,14856,2406,12450,8789098.0,1377439.0,7411658.0,0.5681,0.6017,0.5725,0.5953
2023-03-29 10:15,108,59,49,7147,2135,5012,4430720.0,1227017.0,3203703.0,42,23,19,4877,1389,3488,2841996.0,798296.0,2043700.0,0.5747,0.6392,0.5747,0.5859
2023-03-29 10:20,78,46,32,10260,1906,8354,5931966.0,1102241.0,4829725.0,26,13,13,5655,2198,3457,3301519.0,1262968.0,2038550.0,0.5783,0.5781,0.5746,0.5897
2023-03-29 10:25,52,39,13,4594,2761,1833,2663673.0,1602857.0,1060816.0,16,12,4,8997,8261,736,5180445.0,4750448.0,429996.0,0.5805,0.5787,0.575,0.5842
2023-03-29 10:30,76,48,28,10370,974,9396,5997674.0,564199.0,5433475.0,27,8,19,6208,247,5961,3669062.0,140981.0,3528081.0,0.5793,0.5783,0.5708,0.5919
2023-03-29 10:35,96,62,34,11532,8265,3267,6995544.0,5099996.0,1895548.0,27,15,12,2970,483,2487,1726806.0,277630.0,1449176.0,0.6171,0.5802,0.5748,0.5827
2023-03-29 10:40,124,76,48,8310,1263,7047,4769350.0,730584.0,4038766.0,43,19,24,3864,507,3357,2248177.0,289910.0,1958266.0,0.5785,0.5731,0.5718,0.5833
2023-03-29 10:45,108,81,27,8824,6489,2335,4948333.0,3682073.0,1266260.0,46,37,9,4051,2905,1146,2311336.0,1639879.0,671456.0,0.5674,0.5423,0.5645,0.5859
2023-03-29 10:50,102,63,39,8235,5345,2890,4724926.0,3041723.0,1683202.0,48,18,30,7981,4471,3510,4586820.0,2540013.0,2046807.0,0.5691,0.5824,0.5681,0.5831
2023-03-29 10:55,53,41,12,1565,1501,64,934581.0,897871.0,36710.0,16,14,2,67,65,2,37788.0,36595.0,1193.0,0.5982,0.5736,0.563,0.5969
2023-03-29 11:00,64,44,20,1876,791,1085,1138579.0,500615.0,637964.0,27,20,7,644,228,416,375667.0,130693.0,244974.0,0.6329,0.588,0.5732,0.5889
2023-03-29 11:05,62,43,19,2565,820,1745,1434672.0,467739.0,966932.0,18,11,7,948,188,760,551470.0,108064.0,443406.0,0.5704,0.5541,0.5748,0.5834
2023-03-29 11:10,67,45,22,4403,1319,3084,2545699.0,756958.0,1788740.0,40,23,17,4383,854,3529,2542612.0,488191.0,2054421.0,0.5739,0.58,0.5717,0.5822
2023-03-29 11:15,71,48,23,7619,6065,1554,4326552.0,3469399.0,857153.0,34,22,12,2493,1471,1022,1440298.0,845502.0,594796.0,0.572,0.5516,0.5748,0.582
2023-03-29 11:20,85,64,21,3681,3172,509,2136655.0,1842708.0,293947.0,32,26,6,2640,2422,218,1515739.0,1389298.0,126440.0,0.5809,0.5775,0.5736,0.58
2023-03-29 11:25,48,37,11,4793,1433,3360,2781924.0,819102.0,1962822.0,11,8,3,1924,1022,902,1092286.0,571434.0,520851.0,0.5716,0.5842,0.5591,0.5774
2023-03-29 11:30,37,26,11,632,554,78,371343.0,326351.0,44992.0,15,4,11,25,12,13,14576.0,6893.0,7683.0,0.5891,0.5768,0.5744,0.591
2023-03-29 11:35,42,33,9,641,459,182,517491.0,270875.0,246616.0,11,4,7,632,4,628,511270.0,2291.0,508979.0,0.5901,1.355,0.5728,0.8105
2023-03-29 11:40,42,32,10,947,407,540,550817.0,240581.0,310235.0,14,5,9,2691,5,2686,1604548.0,2867.0,1601680.0,0.5911,0.5745,0.5735,0.5963
2023-03-29 11:45,59,44,15,1876,1145,731,1070494.0,647992.0,422501.0,18,12,6,1048,735,313,596426.0,412843.0,183583.0,0.5659,0.578,0.5617,0.5865
2023-03-29 11:50,89,51,38,7601,1983,5618,4372383.0,1137660.0,3234723.0,40,19,21,3088,1222,1866,1783982.0,696912.0,1087070.0,0.5737,0.5758,0.5703,0.5826
2023-03-29 11:55,32,19,13,3505,532,2973,2071790.0,304779.0,1767011.0,16,12,4,699,591,108,399226.0,336277.0,62949.0,0.5729,0.5944,0.569,0.5829
2023-03-29 12:00,49,36,13,1370,1223,147,805941.0,720986.0,84955.0,16,10,6,395,370,25,226158.0,211602.0,14556.0,0.5895,0.5779,0.5719,0.5822
2023-03-29 12:05,65,44,21,2994,1185,1809,1748306.0,702222.0,1046084.0,16,8,8,1685,830,855,975030.0,476574.0,498456.0,0.5926,0.5783,0.5742,0.583
2023-03-29 12:10,32,23,9,4632,3590,1042,2660822.0,2058078.0,602744.0,12,7,5,3403,2479,924,1930616.0,1396736.0,533879.0,0.5733,0.5784,0.5634,0.5778
2023-03-29 12:15,24,14,10,1186,850,336,730286.0,551755.0,178531.0,11,7,4,539,504,35,308416.0,287707.0,20708.0,0.6491,0.5313,0.5708,0.5917
2023-03-29 12:20,23,16,7,191,81,110,107385.0,48270.0,59115.0,9,6,3,189,186,3,107900.0,106086.0,1814.0,0.5959,0.5374,0.5704,0.6047
2023-03-29 12:25,30,24,6,912,484,428,533591.0,286103.0,247488.0,11,7,4,602,179,423,347825.0,102453.0,245371.0,0.5911,0.5782,0.5724,0.5801
2023-03-29 12:30,25,16,9,387,307,80,228685.0,182230.0,46455.0,12,6,6,266,201,65,153581.0,115576.0,38005.0,0.5936,0.5807,0.575,0.5847
2023-03-29 12:35,19,13,6,4204,4050,154,2417054.0,2328165.0,88888.0,20,13,7,4122,4060,62,2361260.0,2324992.0,36268.0,0.5749,0.5772,0.5727,0.585
2023-03-29 12:40,42,27,15,393,164,229,222934.0,107913.0,115021.0,12,6,6,64,55,9,36838.0,31571.0,5267.0,0.658,0.5023,0.574,0.5852
2023-03-29 12:45,34,24,10,1677,1355,322,977050.0,790704.0,186346.0,10,7,3,367,165,202,211777.0,94783.0,116994.0,0.5835,0.5787,0.5744,0.5792
2023-03-29 12:50,31,24,7,1079,717,362,643158.0,436461.0,206697.0,9,6,3,202,148,54,116055.0,84711.0,31343.0,0.6087,0.571,0.5724,0.5804
2023-03-29 12:55,35,28,7,1608,1232,376,936214.0,719502.0,216712.0,13,10,3,538,315,223,312309.0,180767.0,131541.0,0.584,0.5764,0.5739,0.5899
2023-03-29 13:00,27,15,12,1207,799,408,705114.0,469427.0,235687.0,11,7,4,450,276,174,259406.0,158467.0,100939.0,0.5875,0.5777,0.5742,0.5801
2023-03-29 13:05,22,17,5,162,132,30,93770.0,77259.0,16510.0,8,6,2,254,252,2,1069365.0,1068169.0,1196.0,0.5853,0.5504,4.2388,0.5982
2023-03-29 13:10,49,34,15,2134,1894,240,1228084.0,1105064.0,123020.0,20,16,4,1814,1677,137,1043890.0,963570.0,80320.0,0.5835,0.5126,0.5746,0.5863
2023-03-29 13:15,82,43,39,7089,2387,4702,4128246.0,1384741.0,2743505.0,48,28,20,7957,2328,5629,4670990.0,1338078.0,3332912.0,0.5801,0.5835,0.5748,0.5921
2023-03-29 13:20,57,30,27,2558,1392,1166,1483231.0,802734.0,680497.0,31,20,11,2040,1028,1012,1180719.0,591207.0,589511.0,0.5767,0.5836,0.5751,0.5825
2023-03-29 13:25,71,37,34,7614,1741,5873,4441909.0,999167.0,3442741.0,50,26,24,6866,1667,5199,3995653.0,955896.0,3039756.0,0.5739,0.5862,0.5734,0.5847
2023-03-29 13:30,50,25,25,3761,1101,2660,2199300.0,639028.0,1560271.0,30,12,18,3157,811,2346,1838360.0,465521.0,1372839.0,0.5804,0.5866,0.574,0.5852
2023-03-29 13:35,15,8,7,130,38,92,83184.0,21950.0,61234.0,13,10,3,180,177,3,103474.0,101693.0,1780.0,0.5776,0.6656,0.5745,0.5936
2023-03-29 13:40,19,13,6,359,332,27,207592.0,192115.0,15476.0,11,9,2,201,199,2,116086.0,114887.0,1198.0,0.5787,0.5732,0.5773,0.5994
2023-03-29 13:45,31,21,10,1727,1294,433,977619.0,748577.0,229042.0,14,10,4,590,347,243,341480.0,200212.0,141268.0,0.5785,0.529,0.577,0.5814
2023-03-29 13:50,51,24,27,8084,531,7553,4949590.0,308035.0,4641555.0,30,14,16,5758,452,5306,3402283.0,259362.0,3142921.0,0.5801,0.6145,0.5738,0.5923
2023-03-29 13:55,46,32,14,1338,689,649,778497.0,398477.0,380019.0,18,11,7,812,318,494,473725.0,183647.0,290078.0,0.5783,0.5855,0.5775,0.5872
2023-03-29 14:00,42,27,15,6575,1191,5384,3811139.0,686254.0,3124885.0,25,16,9,3825,1076,2749,2238618.0,617784.0,1620834.0,0.5762,0.5804,0.5741,0.5896
2023-03-29 14:05,39,23,16,4457,416,4041,2586154.0,238532.0,2347622.0,21,12,9,3177,488,2689,1837861.0,278615.0,1559246.0,0.5734,0.581,0.5709,0.5799
2023-03-29 14:10,57,35,22,4443,882,3561,2558282.0,506828.0,2051454.0,22,13,9,4579,822,3757,2655651.0,469223.0,2186428.0,0.5746,0.5761,0.5708,0.582
2023-03-29 14:15,45,31,14,3027,724,2303,1729154.0,425756.0,1303398.0,14,7,7,1972,258,1714,1144282.0,147028.0,997253.0,0.5881,0.566,0.5699,0.5818
2023-03-29 14:20,68,46,22,6041,2495,3546,3521093.0,1444770.0,2076323.0,28,19,9,4542,1568,2974,2632202.0,895672.0,1736529.0,0.5791,0.5855,0.5712,0.5839
2023-03-29 14:25,39,26,13,2137,830,1307,1242536.0,478175.0,764361.0,14,6,8,1649,391,1258,960322.0,224247.0,736075.0,0.5761,0.5848,0.5735,0.5851
2023-03-29 14:30,23,12,11,593,42,551,347922.0,24311.0,323610.0,7,2,5,95,2,93,55301.0,1147.0,54153.0,0.5789,0.5873,0.5738,0.5823
2023-03-29 14:35,45,39,6,806,361,445,471321.0,213482.0,257839.0,26,19,7,1002,230,772,584088.0,132632.0,451455.0,0.5914,0.5794,0.5767,0.5848
2023-03-29 14:40,19,8,11,1600,42,1558,936308.0,24274.0,912034.0,8,3,5,1393,3,1390,816007.0,1721.0,814286.0,0.578,0.5854,0.5737,0.5858
2023-03-29 14:45,25,15,10,331,229,102,192992.0,132601.0,60390.0,7,4,3,414,91,323,242228.0,51703.0,190525.0,0.579,0.5921,0.5682,0.5899
2023-03-29 14:50,15,10,5,704,42,662,406185.0,24183.0,382001.0,7,3,4,394,3,391,228240.0,1718.0,226521.0,0.5758,0.577,0.5728,0.5793
2023-03-29 14:55,20,13,7,888,241,647,520177.0,145122.0,375055.0,8,3,5,648,3,645,375619.0,1717.0,373901.0,0.6022,0.5797,0.5726,0.5797
2023-03-29 15:00,25,16,9,1155,421,734,673480.0,244892.0,428587.0,7,3,4,821,109,712,477824.0,61703.0,416121.0,0.5817,0.5839,0.5661,0.5844
2023-03-29 15:05,29,19,10,404,255,149,236884.0,150532.0,86352.0,6,4,2,284,282,2,163631.0,162432.0,1199.0,0.5903,0.5795,0.576,0.5996
2023-03-29 15:10,29,16,13,1689,856,833,983972.0,497368.0,486603.0,12,8,4,1159,515,644,671795.0,295218.0,376577.0,0.581,0.5842,0.5732,0.5847
2023-03-29 15:15,33,22,11,3367,3216,151,1943281.0,1856253.0,87027.0,18,13,5,3151,2804,347,1815199.0,1614027.0,201172.0,0.5772,0.5763,0.5756,0.5797
2023-03-29 15:20,25,16,9,3950,3582,368,2265358.0,2068170.0,197187.0,17,10,7,4708,2996,1712,2732103.0,1722644.0,1009458.0,0.5774,0.5358,0.575,0.5896
2023-03-29 15:25,32,22,10,2320,2170,150,1330825.0,1246899.0,83925.0,12,7,5,2219,2118,101,1271221.0,1212406.0,58814.0,0.5746,0.5595,0.5724,0.5823
2023-03-29 15:30,34,26,8,3160,3112,48,1830389.0,1802546.0,27842.0,16,12,4,2745,2674,71,1586551.0,1545348.0,41203.0,0.5792,0.5801,0.5779,0.5803
2023-03-29 15:35,35,23,12,2352,654,1698,1367622.0,381862.0,985759.0,16,8,8,1735,586,1149,1017071.0,336430.0,680641.0,0.5839,0.5805,0.5741,0.5924
2023-03-29 15:40,46,34,12,5202,4049,1153,3016791.0,2339340.0,677450.0,27,21,6,5071,3933,1138,2935969.0,2271655.0,664314.0,0.5778,0.5876,0.5776,0.5838
2023-03-29 15:45,31,21,10,2483,2462,21,1435564.0,1424513.0,11051.0,14,10,4,2144,2139,5,1238573.0,1235632.0,2940.0,0.5786,0.5263,0.5777,0.5882
2023-03-29 15:50,24,12,12,1431,487,944,785058.0,282479.0,502578.0,11,5,6,423,386,37,244752.0,223253.0,21499.0,0.58,0.5324,0.5784,0.5811
2023-03-29 15:55,29,18,11,1436,284,1152,836471.0,165813.0,670658.0,15,9,6,1357,263,1094,790374.0,152041.0,638333.0,0.5839,0.5822,0.5781,0.5835
2023-03-29 16:00,36,22,14,3380,2966,414,1950335.0,1712833.0,237502.0,11,7,4,370,248,122,212722.0,141865.0,70857.0,0.5775,0.5737,0.572,0.5808
2023-03-29 16:05,26,14,12,396,351,45,227982.0,202700.0,25282.0,8,6,2,412,410,2,237574.0,236373.0,1200.0,0.5775,0.5618,0.5765,0.6004
2023-03-29 16:10,20,10,10,150,43,107,88006.0,26651.0,61354.0,9,5,4,2316,2303,13,1332163.0,1324543.0,7619.0,0.6198,0.5734,0.5751,0.5861
2023-03-29 16:15,36,16,20,6172,6074,98,3508502.0,3451953.0,56549.0,23,10,13,4104,4035,69,2324201.0,2284192.0,40009.0,0.5683,0.577,0.5661,0.5798
2023-03-29 16:20,44,37,7,649,592,57,378406.0,345402.0,33004.0,17,12,5,655,297,358,378269.0,170734.0,207535.0,0.5834,0.579,0.5749,0.5797
2023-03-29 16:25,25,10,15,2518,45,2473,1505869.0,26011.0,1479857.0,19,11,8,1601,124,1477,951984.0,71682.0,880301.0,0.578,0.5984,0.5781,0.596
2023-03-29 16:30,33,19,14,1642,1316,326,948731.0,761865.0,186865.0,25,19,6,4604,4562,42,2627798.0,2603347.0,24451.0,0.5789,0.5732,0.5707,0.5822
2023-03-29 16:35,19,6,13,3663,3091,572,2091441.0,1761959.0,329482.0,9,4,5,735,7,728,426023.0,4034.0,421989.0,0.57,0.576,0.5763,0.5797
2023-03-29 16:40,37,19,18,2335,1511,824,1354527.0,876125.0,478401.0,14,4,10,653,189,464,380460.0,108880.0,271580.0,0.5798,0.5806,0.5761,0.5853
2023-03-29 16:45,31,18,13,292,121,171,171262.0,73198.0,98063.0,12,7,5,84,31,53,48644.0,17884.0,30760.0,0.6049,0.5735,0.5769,0.5804
2023-03-29 16:50,34,16,18,887,68,819,537832.0,40997.0,496834.0,12,3,9,178,3,175,103124.0,1725.0,101399.0,0.6029,0.6066,0.575,0.5794
2023-03-29 16:55,23,9,14,505,47,458,288095.0,27165.0,260930.0,10,5,5,455,113,342,261351.0,62606.0,198744.0,0.578,0.5697,0.554,0.5811
2023-03-29 17:00,43,8,35,1904,39,1865,1102633.0,22598.0,1080035.0,43,8,35,1830,132,1698,1060410.0,76052.0,984358.0,0.5794,0.5791,0.5762,0.5797
2023-03-29 17:05,32,9,23,909,104,805,527321.0,60965.0,466356.0,19,3,16,495,3,492,286876.0,1729.0,285146.0,0.5862,0.5793,0.5766,0.5796
2023-03-29 17:10,17,12,5,330,18,312,191495.0,10647.0,180848.0,10,7,3,308,7,301,178595.0,4037.0,174557.0,0.5915,0.5796,0.5768,0.5799
2023-03-29 17:15,39,8,31,4162,1109,3053,2395159.0,625935.0,1769223.0,36,4,32,1691,100,1591,978462.0,56882.0,921580.0,0.5644,0.5795,0.5688,0.5792
2023-03-29 17:20,54,7,47,2967,27,2940,1716023.0,15837.0,1700186.0,46,2,44,2627,2,2625,1522768.0,1147.0,1521621.0,0.5866,0.5783,0.5737,0.5797
2023-03-29 17:25,24,15,9,399,37,362,226396.0,21370.0,205025.0,15,10,5,327,19,308,189508.0,10961.0,178547.0,0.5776,0.5664,0.5769,0.5797
2023-03-29 17:30,34,10,24,2649,384,2265,1389552.0,221919.0,1167633.0,30,5,25,2961,260,2701,1744609.0,150124.0,1594484.0,0.5779,0.5155,0.5774,0.5903
2023-03-29 17:35,29,17,12,1013,661,352,584093.0,381208.0,202885.0,18,13,5,2279,1698,581,1314280.0,976319.0,337960.0,0.5767,0.5764,0.575,0.5817
2023-03-29 17:40,29,18,11,5658,1495,4163,3276242.0,863412.0,2412830.0,19,10,9,3505,259,3246,2030846.0,149393.0,1881453.0,0.5775,0.5796,0.5768,0.5796
2023-03-29 17:45,25,16,9,1330,770,560,755889.0,446476.0,309412.0,16,10,6,1105,726,379,639522.0,417333.0,222189.0,0.5798,0.5525,0.5748,0.5863
2023-03-29 17:50,17,8,9,323,94,229,186902.0,54154.0,132747.0,6,3,3,108,6,102,62556.0,3356.0,59200.0,0.5761,0.5797,0.5593,0.5804
2023-03-29 17:55,17,7,10,427,203,224,243152.0,115751.0,127400.0,12,8,4,793,675,118,457691.0,389122.0,68569.0,0.5702,0.5688,0.5765,0.5811
2023-03-29 18:00,21,13,8,1357,726,631,796627.0,430968.0,365659.0,10,6,4,917,600,317,529520.0,345799.0,183720.0,0.5936,0.5795,0.5763,0.5796
2023-03-29 18:05,23,19,4,1762,1659,103,994864.0,933189.0,61675.0,8,4,4,390,91,299,224951.0,51639.0,173312.0,0.5625,0.5988,0.5675,0.5796
2023-03-29 18:10,31,23,8,312,266,46,176787.0,150199.0,26588.0,9,4,5,4449,96,4353,2835523.0,55468.0,2780055.0,0.5647,0.578,0.5778,0.6387
2023-03-29 18:15,27,18,9,1195,647,548,686257.0,368787.0,317469.0,12,8,4,372,350,22,213090.0,200293.0,12796.0,0.57,0.5793,0.5723,0.5817
2023-03-29 18:20,20,8,12,1274,415,859,730385.0,239695.0,490690.0,7,4,3,296,285,11,171105.0,164697.0,6408.0,0.5776,0.5712,0.5779,0.5826
2023-03-29 18:25,18,9,9,748,112,636,432471.0,64373.0,368097.0,8,2,6,590,2,588,342458.0,1149.0,341309.0,0.5748,0.5788,0.5746,0.5805
2023-03-29 18:30,19,11,8,270,189,81,152480.0,109210.0,43270.0,8,5,3,94,91,3,54337.0,52551.0,1786.0,0.5778,0.5342,0.5775,0.5953
2023-03-29 18:35,22,12,10,505,179,326,289378.0,101817.0,187561.0,5,2,3,470,89,381,275192.0,50488.0,224704.0,0.5688,0.5753,0.5673,0.5898
2023-03-30 10:00,806,715,91,62267,54956,7311,37704630.0,33266982.0,4437648.0,622,606,16,42145,40494,1651,24468543.0,23482566.0,985976.0,0.6053,0.607,0.5799,0.5972
2023-03-30 10:05,221,122,99,19408,10184,9224,184452317.0,179111591.0,5340726.0,153,92,61,17875,9537,8338,173872289.0,169003428.0,4868861.0,17.5875,0.579,17.7208,0.5839
2023-03-30 10:10,1167,519,648,106955,22713,84242,326660850.0,278843729.0,47817121.0,696,219,477,78709,10256,68453,311312891.0,271799100.0,39513791.0,12.2768,0.5676,26.5015,0.5772
2023-03-30 10:15,1027,665,362,76001,34879,41122,79859120.0,56182729.0,23676390.0,804,522,282,70879,32355,38524,76879486.0,54714670.0,22164815.0,1.6108,0.5758,1.6911,0.5754
2023-03-30 10:20,573,141,432,48477,13649,34828,52156299.0,32021487.0,20134812.0,457,83,374,41072,7668,33404,47865236.0,28552420.0,19312815.0,2.3461,0.5781,3.7236,0.5782
2023-03-30 10:25,871,490,381,90028,56812,33216,87949907.0,68769808.0,19180099.0,775,432,343,86066,55332,30734,85670639.0,67916410.0,17754229.0,1.2105,0.5774,1.2274,0.5777
2023-03-30 10:30,118,63,55,6376,2858,3518,15756226.0,13738101.0,2018124.0,59,22,37,4215,1328,2887,14508295.0,12847398.0,1660897.0,4.8069,0.5737,9.6742,0.5753
2023-03-30 10:35,134,41,93,6951,1911,5040,16080841.0,13184196.0,2896644.0,88,15,73,6349,1499,4850,15732376.0,12944833.0,2787542.0,6.8991,0.5747,8.6356,0.5748
2023-03-30 10:40,304,51,253,22719,2873,19846,13183337.0,1716660.0,11466676.0,254,18,236,21549,1906,19643,12440553.0,1088568.0,11351985.0,0.5975,0.5778,0.5711,0.5779
2023-03-30 10:45,116,56,60,14939,9723,5216,20699510.0,17677699.0,3021810.0,71,29,42,6466,3458,3008,15809457.0,14070331.0,1739126.0,1.8181,0.5793,4.0689,0.5782
2023-03-30 10:50,155,52,103,5997,533,5464,3462529.0,307157.0,3155372.0,88,20,68,5939,550,5389,3434961.0,314775.0,3120185.0,0.5763,0.5775,0.5723,0.579
2023-03-30 10:55,105,40,65,11891,6239,5652,6886259.0,3602878.0,3283381.0,66,17,49,11709,6387,5322,6752472.0,3662027.0,3090444.0,0.5775,0.5809,0.5734,0.5807
2023-03-30 11:00,155,58,97,12782,8593,4189,31529747.0,29117253.0,2412494.0,91,27,64,11686,7827,3859,30877956.0,28643839.0,2234117.0,3.3885,0.5759,3.6596,0.5789
2023-03-30 11:05,85,40,45,7157,3655,3502,16234196.0,14201136.0,2033059.0,47,9,38,3813,442,3371,14300828.0,12344074.0,1956754.0,3.8854,0.5805,27.9278,0.5805
2023-03-30 11:10,170,97,73,11323,5461,5862,30798626.0,27378218.0,3420407.0,127,80,47,13430,8174,5256,31967773.0,28879616.0,3088157.0,5.0134,0.5835,3.5331,0.5875
2023-03-30 11:15,112,54,58,7787,4836,2951,28659284.0,26950908.0,1708376.0,68,35,33,6799,4532,2267,28084674.0,26770081.0,1314593.0,5.573,0.5789,5.9069,0.5799
2023-03-30 11:20,83,28,55,3186,843,2343,1824955.0,485828.0,1339127.0,58,25,33,2879,1045,1834,1663752.0,601367.0,1062385.0,0.5763,0.5715,0.5755,0.5793
2023-03-30 11:25,262,14,248,16241,436,15805,9379279.0,250195.0,9129083.0,255,14,241,15696,182,15514,9062921.0,103548.0,8959373.0,0.5738,0.5776,0.5689,0.5775
2023-03-30 11:30,864,412,452,99763,72098,27665,57599039.0,41568336.0,16030703.0,840,401,439,99354,71866,27488,57353171.0,41424591.0,15928580.0,0.5766,0.5795,0.5764,0.5795
2023-03-30 11:35,859,246,613,79008,39287,39721,45700943.0,22646300.0,23054642.0,837,230,607,77848,39024,38824,45039985.0,22494220.0,22545765.0,0.5764,0.5804,0.5764,0.5807
2023-03-30 11:40,761,195,566,68303,29679,38624,63657120.0,41298174.0,22358946.0,738,182,556,68279,29867,38412,63652234.0,41406833.0,22245401.0,1.3915,0.5789,1.3864,0.5791
2023-03-30 11:45,43,12,31,1649,274,1375,956402.0,159338.0,797064.0,34,10,24,1629,230,1399,942652.0,132009.0,810643.0,0.5815,0.5797,0.574,0.5794
2023-03-30 11:50,310,137,173,29134,15541,13593,16756552.0,8958242.0,7798309.0,279,122,157,25839,15076,10763,14911531.0,8688108.0,6223422.0,0.5764,0.5737,0.5763,0.5782
2023-03-30 11:55,63,32,31,11400,9803,1597,6531858.0,5608591.0,923266.0,38,13,25,5825,4265,1560,3335434.0,2432361.0,903073.0,0.5721,0.5781,0.5703,0.5789
2023-03-30 12:00,35,15,20,1028,295,733,593545.0,169964.0,423581.0,9,2,7,441,88,353,254731.0,50081.0,204650.0,0.5761,0.5779,0.5691,0.5797
2023-03-30 12:05,451,23,428,91744,747,90997,53208178.0,442232.0,52765945.0,427,12,415,90148,595,89553,52252473.0,338363.0,51914110.0,0.592,0.5799,0.5687,0.5797
2023-03-30 12:10,1254,44,1210,265414,1645,263769,153865136.0,958140.0,152906995.0,1235,36,1199,264981,1335,263646,153605877.0,770506.0,152835371.0,0.5825,0.5797,0.5772,0.5797
2023-03-30 12:15,1621,28,1593,316178,948,315230,183287820.0,554220.0,182733600.0,1609,23,1586,316033,769,315264,183196983.0,443962.0,182753020.0,0.5846,0.5797,0.5773,0.5797
2023-03-30 12:20,33,12,21,2491,1133,1358,1429517.0,647284.0,782232.0,23,9,14,2194,1043,1151,1267153.0,599078.0,668075.0,0.5713,0.576,0.5744,0.5804
2023-03-30 12:25,39,20,19,2362,439,1923,13501491.0,12342920.0,1158571.0,25,12,13,1246,358,888,12813290.0,12295909.0,517380.0,28.116,0.6025,34.3461,0.5826
2023-03-30 12:30,520,211,309,51513,9942,41571,29817546.0,5750127.0,24067419.0,510,205,305,51128,9739,41389,29591809.0,5631863.0,23959945.0,0.5784,0.5789,0.5783,0.5789
2023-03-30 12:35,98,30,68,2496,793,1703,13529884.0,12542651.0,987233.0,82,21,61,2121,709,1412,13317179.0,12495604.0,821575.0,15.8167,0.5797,17.6243,0.5819
2023-03-30 12:40,52,14,38,2028,357,1671,1190906.0,223153.0,967753.0,59,5,54,1963,156,1807,1139925.0,90000.0,1049924.0,0.6251,0.5791,0.5769,0.581
2023-03-30 12:45,1406,728,678,142471,55153,87318,106429256.0,55944028.0,50485227.0,1388,716,672,141946,55048,86898,106126368.0,55883236.0,50243131.0,1.0143,0.5782,1.0152,0.5782
2023-03-30 12:50,564,437,127,51491,33274,18217,29710156.0,19169106.0,10541050.0,549,429,120,51240,33106,18134,29562789.0,19070552.0,10492237.0,0.5761,0.5786,0.576,0.5786
2023-03-30 12:55,26,18,8,924,891,33,532539.0,513671.0,18868.0,18,14,4,850,828,22,489908.0,477117.0,12790.0,0.5765,0.5718,0.5762,0.5814
2023-03-30 13:00,52,30,22,4082,2214,1868,50722537.0,49636905.0,1085632.0,34,19,15,3862,1799,2063,50596730.0,49396586.0,1200144.0,22.4196,0.5812,27.4578,0.5817
2023-03-30 13:05,47,18,29,2715,764,1951,1573977.0,440509.0,1133468.0,34,12,22,2235,593,1642,1296444.0,342014.0,954430.0,0.5766,0.581,0.5768,0.5813
2023-03-30 13:10,43,19,24,1838,461,1377,1067002.0,266205.0,800797.0,32,14,18,1532,400,1132,888792.0,230821.0,657970.0,0.5775,0.5816,0.5771,0.5812
2023-03-30 13:15,82,42,40,4353,1597,2756,14612528.0,13014452.0,1598076.0,65,31,34,8739,6539,2200,17129162.0,15852571.0,1276591.0,8.1493,0.5799,2.4243,0.5803
2023-03-30 13:20,1022,654,368,57490,34217,23273,57384480.0,43936785.0,13447695.0,1000,642,358,56696,33522,23174,56950466.0,43544045.0,13406421.0,1.2841,0.5778,1.299,0.5785
2023-03-30 13:25,1187,133,1054,96767,6174,90593,80115922.0,27732207.0,52383714.0,1157,112,1045,96209,5842,90367,79820246.0,27537783.0,52282462.0,4.4918,0.5782,4.7138,0.5786
2023-03-30 13:30,329,23,306,18322,160,18162,10585761.0,93967.0,10491794.0,318,18,300,18093,324,17769,10446282.0,185772.0,10260509.0,0.5873,0.5777,0.5734,0.5774
2023-03-30 13:35,466,85,381,44563,2625,41938,37851000.0,13601975.0,24249025.0,453,73,380,44128,2153,41975,37596953.0,13327016.0,24269936.0,5.1817,0.5782,6.19,0.5782
2023-03-30 13:40,864,106,758,144223,2113,142110,107673103.0,25375949.0,82297154.0,847,96,751,144352,2271,142081,107746003.0,25466654.0,82279348.0,12.0094,0.5791,11.2139,0.5791
2023-03-30 13:45,1080,485,595,121394,16748,104646,70250546.0,9649709.0,60600837.0,1066,478,588,121344,16639,104705,70221070.0,9586395.0,60634675.0,0.5762,0.5791,0.5761,0.5791
2023-03-30 13:50,339,171,168,21458,6052,15406,36576624.0,27667779.0,8908844.0,334,170,164,21360,6118,15242,36519383.0,27704554.0,8814828.0,4.5717,0.5783,4.5284,0.5783
2023-03-30 13:55,1251,206,1045,203495,5972,197523,117658260.0,3449451.0,114208809.0,1226,190,1036,202979,5677,197302,117363506.0,3267974.0,114095532.0,0.5776,0.5782,0.5757,0.5783
2023-03-30 14:00,240,61,179,9875,483,9392,5709817.0,284764.0,5425053.0,218,48,170,9469,240,9229,5471013.0,138054.0,5332959.0,0.5896,0.5776,0.5752,0.5778
2023-03-30 14:05,877,94,783,156522,4305,152217,90603811.0,2500771.0,88103040.0,867,86,781,156322,4035,152287,90469468.0,2326165.0,88143302.0,0.5809,0.5788,0.5765,0.5788
2023-03-30 14:10,334,69,265,24225,4580,19645,14009728.0,2648513.0,11361215.0,312,56,256,23955,4399,19556,13845084.0,2534948.0,11310136.0,0.5783,0.5783,0.5763,0.5783
2023-03-30 14:15,42,13,29,2366,403,1963,1373437.0,237063.0,1136374.0,35,8,27,2077,457,1620,1202027.0,263127.0,938900.0,0.5882,0.5789,0.5758,0.5796
2023-03-30 14:20,435,21,414,53318,932,52386,30818579.0,537557.0,30281022.0,421,13,408,53326,1021,52305,30819570.0,585359.0,30234210.0,0.5768,0.578,0.5733,0.578
2023-03-30 14:25,84,18,66,6936,2409,4527,4024134.0,1386975.0,2637158.0,81,19,62,8187,3483,4704,4727601.0,1987755.0,2739846.0,0.5757,0.5825,0.5707,0.5825
2023-03-30 14:30,44,16,28,2284,588,1696,1318233.0,336954.0,981279.0,36,15,21,2046,706,1340,1184584.0,406728.0,777855.0,0.5731,0.5786,0.5761,0.5805
2023-03-30 14:35,258,30,228,16399,1798,14601,9453657.0,1023622.0,8430035.0,241,17,224,15095,549,14546,8713969.0,315507.0,8398462.0,0.5693,0.5774,0.5747,0.5774
2023-03-30 14:40,386,136,250,32601,2348,30253,18844338.0,1355701.0,17488637.0,362,123,239,31914,1725,30189,18448021.0,993766.0,17454255.0,0.5774,0.5781,0.5761,0.5782
2023-03-30 14:45,27,15,12,1302,377,925,750824.0,214233.0,536590.0,21,12,9,826,156,670,478801.0,89846.0,388955.0,0.5683,0.5801,0.5759,0.5805
2023-03-30 14:50,431,31,400,25574,3249,22325,14708626.0,1862897.0,12845728.0,407,17,390,24021,2447,21574,13867888.0,1407311.0,12460577.0,0.5734,0.5754,0.5751,0.5776
2023-03-30 14:55,246,58,188,18287,2114,16173,10563711.0,1216954.0,9346757.0,233,47,186,17495,1850,15645,10111210.0,1064024.0,9047185.0,0.5757,0.5779,0.5751,0.5783
2023-03-30 15:00,415,44,371,20771,1053,19718,11993363.0,610558.0,11382804.0,393,32,361,20233,723,19510,11676319.0,416216.0,11260103.0,0.5798,0.5773,0.5757,0.5771
2023-03-30 15:05,54,27,27,2530,928,1602,1458665.0,534339.0,924326.0,40,22,18,2015,1051,964,1166310.0,605144.0,561166.0,0.5758,0.577,0.5758,0.5821
2023-03-30 15:10,58,31,27,3102,1109,1993,1795972.0,639139.0,1156833.0,44,22,22,2865,746,2119,1659215.0,429822.0,1229392.0,0.5763,0.5804,0.5762,0.5802
2023-03-30 15:15,385,35,350,54138,646,53492,31267750.0,371931.0,30895819.0,364,22,342,53693,437,53256,31018784.0,251726.0,30767057.0,0.5757,0.5776,0.576,0.5777
2023-03-30 15:20,266,32,234,15863,783,15080,9154783.0,450832.0,8703951.0,249,19,230,15586,514,15072,8995425.0,295904.0,8699521.0,0.5758,0.5772,0.5757,0.5772
2023-03-30 15:25,203,155,48,8280,2382,5898,4782608.0,1371381.0,3411226.0,189,146,43,6226,2467,3759,3605826.0,1421228.0,2184597.0,0.5757,0.5784,0.5761,0.5812
2023-03-30 15:30,68,35,33,7215,4260,2955,4166002.0,2453409.0,1712593.0,44,20,24,5905,2585,3320,3404758.0,1481105.0,1923652.0,0.5759,0.5796,0.573,0.5794
2023-03-30 15:35,50,18,32,3767,875,2892,2157200.0,499297.0,1657902.0,39,8,31,2879,210,2669,1670846.0,120975.0,1549871.0,0.5706,0.5733,0.5761,0.5807
2023-03-30 15:40,27,18,9,1174,391,783,686539.0,225882.0,460657.0,23,16,7,757,408,349,436164.0,233839.0,202325.0,0.5777,0.5883,0.5731,0.5797
2023-03-30 15:45,65,31,34,11472,3884,7588,6828264.0,2239220.0,4589044.0,59,31,28,11969,5040,6929,7104214.0,2898803.0,4205411.0,0.5765,0.6048,0.5752,0.6069
2023-03-30 15:50,21,12,9,393,298,95,224007.0,171915.0,52092.0,13,6,7,413,231,182,239026.0,133212.0,105814.0,0.5769,0.5483,0.5767,0.5814
2023-03-30 15:55,60,21,39,5424,791,4633,15298837.0,12548069.0,2750767.0,42,11,31,5055,730,4325,15066165.0,12511083.0,2555082.0,15.8636,0.5937,17.1385,0.5908
2023-03-30 16:00,17,7,10,658,94,564,381852.0,54201.0,327651.0,16,8,8,756,162,594,437144.0,92847.0,344297.0,0.5766,0.5809,0.5731,0.5796
2023-03-30 16:05,862,8,854,321771,25,321746,186369633.0,14402.0,186355231.0,856,3,853,322130,7,322123,186577616.0,3624.0,186573992.0,0.5761,0.5792,0.5178,0.5792
2023-03-30 16:10,235,211,24,16216,13532,2684,9366906.0,7811781.0,1555125.0,225,204,21,15717,13415,2302,9079524.0,7744435.0,1335089.0,0.5773,0.5794,0.5773,0.58
2023-03-30 16:15,53,26,27,3391,956,2435,1946930.0,551219.0,1395710.0,36,16,20,3105,496,2609,1798619.0,285978.0,1512641.0,0.5766,0.5732,0.5766,0.5798
2023-03-30 16:20,53,14,39,4257,475,3782,2473557.0,274300.0,2199257.0,42,9,33,3947,233,3714,2294205.0,134438.0,2159767.0,0.5775,0.5815,0.577,0.5815
2023-03-30 16:25,17,9,8,3580,3282,298,2064834.0,1892368.0,172466.0,14,8,6,3479,3209,270,2005691.0,1849534.0,156157.0,0.5766,0.5787,0.5764,0.5784
2023-03-30 16:30,47,22,25,2341,813,1528,1351941.0,467979.0,883961.0,32,17,15,1438,571,867,833375.0,329621.0,503754.0,0.5756,0.5785,0.5773,0.581
2023-03-30 16:35,55,27,28,5324,3858,1466,3072240.0,2221330.0,850910.0,43,24,19,5373,3963,1410,3106177.0,2285403.0,820773.0,0.5758,0.5804,0.5767,0.5821
2023-03-30 16:40,113,75,38,6402,3255,3147,3711751.0,1879165.0,1832586.0,106,70,36,6353,3268,3085,3682240.0,1886482.0,1795757.0,0.5773,0.5823,0.5773,0.5821
2023-03-30 16:45,49,16,33,4034,1106,2928,2353727.0,653420.0,1700307.0,39,12,27,2943,351,2592,1712005.0,202440.0,1509565.0,0.5908,0.5807,0.5768,0.5824
2023-03-30 16:50,59,20,39,3689,484,3205,2139613.0,279366.0,1860247.0,51,17,34,3493,530,2963,2026232.0,305644.0,1720588.0,0.5772,0.5804,0.5767,0.5807
2023-03-30 16:55,47,19,28,2059,529,1530,1196353.0,312368.0,883985.0,39,10,29,2175,351,1824,1258054.0,202645.0,1055409.0,0.5905,0.5778,0.5773,0.5786
2023-03-30 17:00,31,6,25,1473,100,1373,852590.0,58013.0,794577.0,28,5,23,1737,374,1363,1004306.0,215513.0,788793.0,0.5801,0.5787,0.5762,0.5787
2023-03-30 17:05,47,13,34,2513,469,2044,1454944.0,271827.0,1183116.0,37,5,32,2476,420,2056,1433068.0,242648.0,1190420.0,0.5796,0.5788,0.5777,0.579
2023-03-30 17:10,41,12,29,2755,352,2403,1609986.0,207753.0,1402232.0,34,7,27,2712,132,2580,1574425.0,75443.0,1498982.0,0.5902,0.5835,0.5715,0.581
2023-03-30 17:15,40,13,27,2046,136,1910,1187306.0,77663.0,1109642.0,24,6,18,1454,277,1177,843700.0,158826.0,684874.0,0.5711,0.581,0.5734,0.5819
2023-03-30 17:20,22,12,10,784,267,517,469797.0,169149.0,300648.0,14,5,9,1015,7,1008,589864.0,4009.0,585855.0,0.6335,0.5815,0.5727,0.5812
2023-03-30 17:25,27,8,19,1940,174,1766,1141234.0,109957.0,1031277.0,19,3,16,1700,3,1697,991329.0,1694.0,989634.0,0.6319,0.584,0.5648,0.5832
2023-03-30 17:30,51,26,25,2705,979,1726,13679306.0,12672323.0,1006982.0,28,8,20,2126,580,1546,13324700.0,12421681.0,903018.0,12.9442,0.5834,21.4167,0.5841
2023-03-30 17:35,41,19,22,2049,400,1649,1209833.0,248079.0,961754.0,21,9,12,1303,204,1099,755125.0,116943.0,638182.0,0.6202,0.5832,0.5733,0.5807
2023-03-30 17:40,27,16,11,720,673,47,415725.0,389729.0,25996.0,14,8,6,972,561,411,559382.0,314958.0,244424.0,0.5791,0.5531,0.5614,0.5947
2023-03-30 17:45,22,12,10,687,396,291,398321.0,229586.0,168734.0,13,9,4,438,269,169,253661.0,155660.0,98000.0,0.5798,0.5798,0.5787,0.5799
2023-03-30 17:50,471,43,428,30682,2055,28627,17803342.0,1199279.0,16604062.0,445,28,417,29482,1174,28308,17113593.0,675906.0,16437687.0,0.5836,0.58,0.5757,0.5807
2023-03-30 17:55,87,30,57,7146,1812,5334,4158790.0,1045310.0,3113480.0,71,18,53,6023,837,5186,3512757.0,484493.0,3028264.0,0.5769,0.5837,0.5788,0.5839
2023-03-30 18:00,146,30,116,10771,860,9911,6270074.0,498932.0,5771142.0,140,25,115,11823,2056,9767,6877090.0,1185531.0,5691558.0,0.5802,0.5823,0.5766,0.5827
2023-03-30 18:05,59,34,25,3311,1541,1770,1909159.0,890058.0,1019101.0,40,22,18,2964,1368,1596,1722747.0,789730.0,933017.0,0.5776,0.5758,0.5773,0.5846
2023-03-30 18:10,64,37,27,3600,1671,1929,2095290.0,966710.0,1128580.0,56,33,23,3169,1417,1752,1844587.0,818589.0,1025998.0,0.5785,0.5851,0.5777,0.5856
2023-03-30 18:15,46,25,21,2147,1227,920,1241510.0,707324.0,534185.0,35,19,16,1571,909,662,907939.0,522452.0,385487.0,0.5765,0.5806,0.5748,0.5823
2023-03-30 18:20,44,20,24,2794,882,1912,1627622.0,504460.0,1123161.0,35,14,21,2198,604,1594,1280312.0,346855.0,933456.0,0.572,0.5874,0.5743,0.5856
2023-03-30 18:25,35,21,14,1767,1339,428,1063277.0,815989.0,247287.0,27,18,9,1209,518,691,705912.0,298845.0,407067.0,0.6094,0.5778,0.5769,0.5891
2023-03-30 18:30,30,18,12,2502,878,1624,1359057.0,519153.0,839904.0,22,12,10,1594,686,908,927831.0,394899.0,532932.0,0.5913,0.5172,0.5757,0.5869
2023-03-30 18:35,33,16,17,2234,350,1884,1301911.0,202470.0,1099440.0,27,14,13,2613,625,1988,1529026.0,358696.0,1170330.0,0.5785,0.5836,0.5739,0.5887
2023-03-31 10:00,3649,498,3151,385215,49373,335842,224587195.0,29864985.0,194722210.0,3430,356,3074,367462,34755,332707,212863282.0,20010762.0,192852520.0,0.6049,0.5798,0.5758,0.5796
2023-03-31 10:05,3330,336,2994,361223,41697,319526,221539271.0,36119529.0,185419742.0,3273,300,2973,354497,40592,313905,207846927.0,25747150.0,182099777.0,0.8662,0.5803,0.6343,0.5801
2023-03-31 10:10,2029,83,1946,208023,5915,202108,120598174.0,3360848.0,117237326.0,1984,53,1931,205085,5173,199912,118842190.0,2954904.0,115887286.0,0.5682,0.5801,0.5712,0.5797
2023-03-31 10:15,3066,99,2967,322509,7203,315306,199019220.0,16211593.0,182807627.0,2998,55,2943,317782,3572,314210,196332746.0,14128981.0,182203765.0,2.2507,0.5798,3.9555,0.5799
2023-03-31 10:20,4414,121,4293,509041,12199,496842,294741022.0,7009382.0,287731639.0,4354,80,4274,507202,10867,496335,293668366.0,6229248.0,287439118.0,0.5746,0.5791,0.5732,0.5791
2023-03-31 10:25,2341,736,1605,268775,82575,186200,288761840.0,180812774.0,107949066.0,2275,696,1579,263788,79848,183940,285695366.0,179059851.0,106635514.0,2.1897,0.5797,2.2425,0.5797
2023-03-31 10:30,2912,1990,922,358088,267982,90106,218973298.0,166549244.0,52424054.0,2860,1977,883,359842,268733,91109,219839187.0,166980586.0,52858601.0,0.6215,0.5818,0.6214,0.5802
2023-03-31 10:35,2031,1158,873,246579,169826,76753,142464734.0,97954078.0,44510655.0,1992,1142,850,244577,168431,76146,141316931.0,97146337.0,44170594.0,0.5768,0.5799,0.5768,0.5801
2023-03-31 10:40,2469,476,1993,257892,76379,181513,161221957.0,56111416.0,105110541.0,2431,467,1964,259022,76061,182961,162093790.0,55933452.0,106160338.0,0.7346,0.5791,0.7354,0.5802
2023-03-31 10:45,1538,192,1346,137327,6717,130610,91602346.0,15950027.0,75652319.0,1486,158,1328,136243,6079,130164,91067499.0,15584560.0,75482938.0,2.3746,0.5792,2.5637,0.5799
2023-03-31 10:50,745,165,580,65777,12735,53042,38001751.0,7333935.0,30667816.0,703,140,563,67899,15579,52320,39199429.0,8935529.0,30263900.0,0.5759,0.5782,0.5736,0.5784
2023-03-31 10:55,685,190,495,68158,7416,60742,39473519.0,4286434.0,35187085.0,661,180,481,68382,7126,61256,39585904.0,4098306.0,35487598.0,0.578,0.5793,0.5751,0.5793
2023-03-31 11:00,1219,567,652,133562,79159,54403,88670491.0,57358997.0,31311494.0,1166,539,627,129508,77293,52215,86440025.0,56306590.0,30133435.0,0.7246,0.5755,0.7285,0.5771
2023-03-31 11:05,2482,1259,1223,291593,169914,121679,167249949.0,97136134.0,70113814.0,2431,1229,1202,288854,170157,118697,165652550.0,97263695.0,68388855.0,0.5717,0.5762,0.5716,0.5762
2023-03-31 11:10,1813,432,1381,206635,30085,176550,166403775.0,65479231.0,100924543.0,1620,286,1334,197208,25168,172040,161192718.0,62690184.0,98502534.0,2.1765,0.5716,2.4909,0.5726
2023-03-31 11:15,600,133,467,62095,6097,55998,59717714.0,27646328.0,32071386.0,500,54,446,59595,4187,55408,58281318.0,26556765.0,31724553.0,4.5344,0.5727,6.3427,0.5726
2023-03-31 11:20,138,67,71,7432,2045,5387,4282039.0,1176014.0,3106025.0,62,29,33,6794,1824,4970,3903133.0,1036998.0,2866135.0,0.5751,0.5766,0.5685,0.5767
2023-03-31 11:25,80,47,33,6549,4412,2137,3742238.0,2523855.0,1218382.0,52,26,26,3848,1777,2071,2185121.0,995278.0,1189843.0,0.572,0.5701,0.5601,0.5745
2023-03-31 11:30,69,34,35,7469,568,6901,4224181.0,324690.0,3899491.0,37,10,27,4199,561,3638,2406476.0,319219.0,2087256.0,0.5716,0.5651,0.569,0.5737
2023-03-31 11:35,1863,524,1339,299096,46897,252199,171789998.0,26903977.0,144886021.0,1820,497,1323,296904,45152,251752,170430251.0,25799786.0,144630464.0,0.5737,0.5745,0.5714,0.5745
2023-03-31 11:40,2188,1198,990,223948,100396,123552,140543076.0,69522918.0,71020158.0,2158,1179,979,223416,99913,123503,140234862.0,69239518.0,70995343.0,0.6925,0.5748,0.693,0.5748
2023-03-31 11:45,467,309,158,37105,20119,16986,21284435.0,11518774.0,9765661.0,437,297,140,37156,20136,17020,21306404.0,11520881.0,9785523.0,0.5725,0.5749,0.5722,0.5749
2023-03-31 11:50,1131,321,810,127257,23084,104173,73086280.0,13211077.0,59875203.0,1093,298,795,126833,22853,103980,72850938.0,13077510.0,59773428.0,0.5723,0.5748,0.5722,0.5749
2023-03-31 11:55,1706,334,1372,198766,21217,177549,114232808.0,12140877.0,102091930.0,1675,317,1358,198526,21166,177360,114098799.0,12111594.0,101987204.0,0.5722,0.575,0.5722,0.575
2023-03-31 12:00,2018,1017,1001,204042,58659,145383,117238138.0,33580630.0,83657508.0,1989,996,993,201807,56894,144913,115951595.0,32557763.0,83393831.0,0.5725,0.5754,0.5723,0.5755
2023-03-31 12:05,101,74,27,5755,3334,2421,3304710.0,1908702.0,1396008.0,89,65,24,5279,3109,2170,3033122.0,1779053.0,1254069.0,0.5725,0.5766,0.5722,0.5779
2023-03-31 12:10,377,101,276,65739,10186,55553,37769631.0,5824279.0,31945352.0,357,85,272,64503,9515,54988,37085594.0,5441354.0,31644240.0,0.5718,0.575,0.5719,0.5755
2023-03-31 12:15,340,42,298,42865,4469,38396,24622101.0,2555840.0,22066260.0,330,35,295,43063,4647,38416,24733435.0,2655341.0,22078094.0,0.5719,0.5747,0.5714,0.5747
2023-03-31 12:20,38,17,21,2793,512,2281,1603119.0,290972.0,1312147.0,26,9,17,2644,372,2272,1520123.0,212762.0,1307361.0,0.5683,0.5753,0.5719,0.5754
2023-03-31 12:25,87,29,58,9780,1332,8448,5624964.0,763030.0,4861933.0,68,19,49,9543,1151,8392,5499248.0,659202.0,4840046.0,0.5728,0.5755,0.5727,0.5767
2023-03-31 12:30,39,20,19,2652,922,1730,1525407.0,529195.0,996212.0,28,12,16,2102,705,1397,1206995.0,403653.0,803341.0,0.574,0.5758,0.5726,0.575
2023-03-31 12:35,113,31,82,11362,1809,9553,6542083.0,1037325.0,5504757.0,103,22,81,11097,1604,9493,6388116.0,918570.0,5469545.0,0.5734,0.5762,0.5727,0.5762
2023-03-31 12:40,67,26,41,8822,1416,7406,5080653.0,811040.0,4269613.0,56,20,36,8142,1720,6422,4686267.0,984859.0,3701407.0,0.5728,0.5765,0.5726,0.5764
2023-03-31 12:45,467,53,414,53492,2114,51378,30733661.0,1211697.0,29521964.0,448,41,407,53401,2240,51161,30684337.0,1282549.0,29401787.0,0.5732,0.5746,0.5726,0.5747
2023-03-31 12:50,659,170,489,63943,10764,53179,36689949.0,6160601.0,30529348.0,651,166,485,64719,11851,52868,37115079.0,6763735.0,30351343.0,0.5723,0.5741,0.5707,0.5741
2023-03-31 12:55,701,196,505,85979,2641,83338,49373034.0,1506884.0,47866149.0,675,179,496,85453,2443,83010,49077485.0,1394890.0,47682595.0,0.5706,0.5744,0.571,0.5744
2023-03-31 13:00,1369,330,1039,220126,34529,185597,126342984.0,19729659.0,106613325.0,1351,327,1024,220413,34673,185740,126516219.0,19811370.0,106704849.0,0.5714,0.5744,0.5714,0.5745
2023-03-31 13:05,1212,324,888,155264,24085,131179,101128840.0,25855320.0,75273519.0,1176,301,875,153672,23395,130277,100237409.0,25460029.0,74777380.0,1.0735,0.5738,1.0883,0.574
2023-03-31 13:10,239,72,167,23853,3588,20265,25763669.0,14142301.0,11621368.0,191,41,150,22972,3410,19562,25267508.0,14033062.0,11234446.0,3.9416,0.5735,4.1153,0.5743
2023-03-31 13:15,695,50,645,100899,3692,97207,57926755.0,2104693.0,55822062.0,671,37,634,100715,3688,97027,57827289.0,2101235.0,55726053.0,0.5701,0.5743,0.5697,0.5743
2023-03-31 13:20,66,34,32,4300,1517,2783,2459972.0,863001.0,1596970.0,41,16,25,3907,1219,2688,2237291.0,693513.0,1543778.0,0.5689,0.5738,0.5689,0.5743
2023-03-31 13:25,246,42,204,27276,3277,23999,15625376.0,1856627.0,13768748.0,228,28,200,25968,2177,23791,14889748.0,1240789.0,13648959.0,0.5666,0.5737,0.57,0.5737
2023-03-31 13:30,403,31,372,79604,1491,78113,45646429.0,848963.0,44797466.0,381,20,361,79281,1330,77951,45474799.0,757437.0,44717362.0,0.5694,0.5735,0.5695,0.5737
2023-03-31 13:35,1075,254,821,169198,32233,136965,108758767.0,30413471.0,78345295.0,1026,222,804,167959,31875,136084,108073338.0,30211538.0,77861799.0,0.9436,0.572,0.9478,0.5722
2023-03-31 13:40,1284,191,1093,254623,15601,239022,145516122.0,8862597.0,136653525.0,1232,152,1080,253201,14590,238611,144753374.0,8292454.0,136460920.0,0.5681,0.5717,0.5684,0.5719
2023-03-31 13:45,1444,59,1385,289556,3779,285777,165545385.0,2148014.0,163397371.0,1414,41,1373,288891,3488,285403,165187448.0,1982723.0,163204724.0,0.5684,0.5718,0.5684,0.5718
2023-03-31 13:50,1492,55,1437,332123,3055,329068,189989938.0,1736302.0,188253636.0,1461,32,1429,331485,2733,328752,189637668.0,1552702.0,188084966.0,0.5683,0.5721,0.5681,0.5721
2023-03-31 13:55,1376,30,1346,321028,1178,319850,183491020.0,669483.0,182821536.0,1359,16,1343,321365,1175,320190,183688494.0,667543.0,183020951.0,0.5683,0.5716,0.5681,0.5716
2023-03-31 14:00,1930,83,1847,385839,5748,380091,220656832.0,3264953.0,217391878.0,1899,66,1833,384604,4588,380016,219962956.0,2604962.0,217357994.0,0.568,0.5719,0.5678,0.572
2023-03-31 14:05,1299,102,1197,324238,5828,318410,185452800.0,3335526.0,182117274.0,1276,89,1187,323893,5474,318419,185242613.0,3112126.0,182130486.0,0.5723,0.572,0.5685,0.572
2023-03-31 14:10,2327,758,1569,397672,47622,350050,227157117.0,27087799.0,200069317.0,2302,743,1559,397208,47433,349775,226894141.0,26976971.0,199917170.0,0.5688,0.5715,0.5687,0.5716
2023-03-31 14:15,1502,244,1258,206854,13622,193232,130296967.0,19844559.0,110452408.0,1472,221,1251,206696,13469,193227,130199820.0,19749383.0,110450437.0,1.4568,0.5716,1.4663,0.5716
2023-03-31 14:20,1572,268,1304,202574,9321,193253,116013589.0,5315595.0,110697994.0,1556,264,1292,202777,9291,193486,116128427.0,5294976.0,110833451.0,0.5703,0.5728,0.5699,0.5728
2023-03-31 14:25,2385,824,1561,294767,46273,248494,168858474.0,26452270.0,142406203.0,2354,808,1546,293345,45278,248067,168003554.0,25843255.0,142160298.0,0.5717,0.5731,0.5708,0.5731
2023-03-31 14:30,451,253,198,29020,13292,15728,28688517.0,19681599.0,9006918.0,435,241,194,28602,13259,15343,28445744.0,19661465.0,8784279.0,1.4807,0.5727,1.4829,0.5725
2023-03-31 14:35,2236,857,1379,287186,46862,240324,164756004.0,26775993.0,137980010.0,2224,850,1374,287398,46718,240680,164866593.0,26679465.0,138187127.0,0.5714,0.5741,0.5711,0.5742
2023-03-31 14:40,1560,660,900,168425,32265,136160,96572625.0,18476105.0,78096520.0,1536,649,887,167018,31647,135371,95718941.0,18076634.0,77642306.0,0.5726,0.5736,0.5712,0.5736
2023-03-31 14:45,450,129,321,49775,4932,44843,28563034.0,2818420.0,25744614.0,439,124,315,49991,4804,45187,28688754.0,2745266.0,25943488.0,0.5715,0.5741,0.5715,0.5741
2023-03-31 14:50,817,162,655,95194,8718,86476,54604320.0,4979988.0,49624331.0,802,152,650,94688,8615,86073,54316637.0,4921313.0,49395323.0,0.5712,0.5739,0.5712,0.5739
2023-03-31 14:55,1095,257,838,109546,14023,95523,62747034.0,8011102.0,54735931.0,1081,246,835,109198,13748,95450,62544761.0,7850793.0,54693967.0,0.5713,0.573,0.571,0.573
2023-03-31 15:00,1048,441,607,79919,17843,62076,45779552.0,10194637.0,35584915.0,1037,436,601,79308,17859,61449,45428001.0,10204179.0,35223821.0,0.5714,0.5732,0.5714,0.5732
2023-03-31 15:05,2216,686,1530,307914,20429,287485,176405586.0,11695584.0,164710001.0,2206,674,1532,308989,21242,287747,176974975.0,12114458.0,164860516.0,0.5725,0.5729,0.5703,0.5729
2023-03-31 15:10,2370,375,1995,347642,22224,325418,199248688.0,12684325.0,186564363.0,2356,367,1989,347012,21231,325781,198893846.0,12123020.0,186770826.0,0.5707,0.5733,0.571,0.5733
2023-03-31 15:15,934,99,835,199783,6283,193500,114734351.0,3592848.0,111141503.0,920,89,831,199005,5740,193265,114285471.0,3278188.0,111007282.0,0.5718,0.5744,0.5711,0.5744
2023-03-31 15:20,405,25,380,67254,3170,64084,38601441.0,1808736.0,36792704.0,399,25,374,67337,3170,64167,38649966.0,1808752.0,36841214.0,0.5706,0.5741,0.5706,0.5741
2023-03-31 15:25,880,72,808,139700,4167,135533,80101536.0,2378294.0,77723242.0,872,70,802,139151,4176,134975,79789401.0,2383521.0,77405880.0,0.5707,0.5735,0.5708,0.5735
2023-03-31 15:30,704,64,640,98257,3233,95024,56350790.0,1858480.0,54492309.0,684,51,633,97734,2863,94871,56037888.0,1634123.0,54403765.0,0.5748,0.5735,0.5708,0.5734
2023-03-31 15:35,642,112,530,56287,4488,51799,32271553.0,2562816.0,29708736.0,636,110,526,56437,4768,51669,32356861.0,2722511.0,29634349.0,0.571,0.5735,0.571,0.5735
2023-03-31 15:40,111,62,49,9533,2182,7351,5486514.0,1259063.0,4227451.0,97,47,50,9293,1952,7341,5336805.0,1114860.0,4221944.0,0.577,0.5751,0.5711,0.5751
2023-03-31 15:45,51,9,42,3163,407,2756,1811594.0,230234.0,1581360.0,42,6,36,2990,180,2810,1715027.0,102694.0,1612332.0,0.5657,0.5738,0.5705,0.5738
2023-03-31 15:50,63,46,17,4053,2025,2028,2322024.0,1158201.0,1163823.0,61,44,17,4157,1986,2171,2383389.0,1134889.0,1248499.0,0.572,0.5739,0.5714,0.5751
2023-03-31 15:55,581,517,64,36814,29549,7265,21052155.0,16887567.0,4164587.0,569,509,60,36943,29410,7533,21134629.0,16806914.0,4327715.0,0.5715,0.5732,0.5715,0.5745
2023-03-31 16:00,1059,722,337,103421,41585,61836,59310712.0,23784740.0,35525971.0,1052,716,336,103145,41330,61815,59142883.0,23629218.0,35513665.0,0.572,0.5745,0.5717,0.5745
2023-03-31 16:05,797,497,300,86269,24914,61355,49489269.0,14252790.0,35236478.0,796,495,301,87010,24829,62181,49926732.0,14203550.0,35723182.0,0.5721,0.5743,0.5721,0.5745
2023-03-31 16:10,428,216,212,47445,11406,36039,27200350.0,6521816.0,20678534.0,416,211,205,47628,11645,35983,27309790.0,6658490.0,20651300.0,0.5718,0.5738,0.5718,0.5739
2023-03-31 16:15,860,139,721,108827,8603,100224,62281990.0,4910082.0,57371907.0,840,130,710,106769,7962,98807,61156880.0,4544398.0,56612482.0,0.5707,0.5724,0.5708,0.573
2023-03-31 16:20,684,62,622,95030,3555,91475,66454919.0,14115557.0,52339362.0,677,57,620,94607,3705,90902,66256976.0,14201106.0,52055870.0,3.9706,0.5722,3.833,0.5727
2023-03-31 16:25,1189,216,973,169163,8008,161155,96849162.0,4564896.0,92284266.0,1172,202,970,169091,7770,161321,96820618.0,4428960.0,92391658.0,0.57,0.5726,0.57,0.5727
2023-03-31 16:30,1186,51,1135,277674,2032,275642,158945630.0,1154024.0,157791606.0,1170,37,1133,276476,1322,275154,158297483.0,750508.0,157546975.0,0.5679,0.5725,0.5677,0.5726
2023-03-31 16:35,1188,69,1119,250759,1844,248915,143514933.0,1050398.0,142464535.0,1166,55,1111,250017,1629,248388,143096496.0,927444.0,142169052.0,0.5696,0.5723,0.5693,0.5724
2023-03-31 16:40,1517,230,1287,193649,9788,183861,110812024.0,5605737.0,105206286.0,1477,199,1278,192704,9615,183089,110240906.0,5476382.0,104764524.0,0.5727,0.5722,0.5696,0.5722
2023-03-31 16:45,1642,368,1274,207090,18714,188376,118391168.0,10668213.0,107722955.0,1634,364,1270,207364,18667,188697,118550276.0,10640594.0,107909682.0,0.5701,0.5719,0.57,0.5719
2023-03-31 16:50,871,31,840,148108,1010,147098,84704226.0,574991.0,84129235.0,865,26,839,147853,916,146937,84556332.0,520650.0,84035682.0,0.5693,0.5719,0.5684,0.5719
2023-03-31 16:55,916,179,737,179360,10639,168721,102586350.0,6064224.0,96522125.0,907,175,732,179637,10790,168847,102728688.0,6147544.0,96581144.0,0.57,0.5721,0.5697,0.572
2023-03-31 17:00,2057,65,1992,306019,3381,302638,175100790.0,1932063.0,173168727.0,2043,55,1988,305722,3256,302466,174924496.0,1855360.0,173069136.0,0.5714,0.5722,0.5698,0.5722
2023-03-31 17:05,2050,54,1996,350439,4237,346202,200543129.0,2412317.0,198130812.0,2033,45,1988,349003,4190,344813,199730305.0,2382450.0,197347854.0,0.5693,0.5723,0.5686,0.5723
2023-03-31 17:10,2316,42,2274,401132,2288,398844,229551354.0,1304831.0,228246523.0,2313,40,2273,400826,2282,398544,229376250.0,1300850.0,228075400.0,0.5703,0.5723,0.57,0.5723
2023-03-31 17:15,2940,265,2675,431290,15255,416035,246773278.0,8699572.0,238073706.0,2927,253,2674,431009,14744,416265,246613614.0,8404702.0,238208912.0,0.5703,0.5722,0.57,0.5723
2023-03-31 17:20,1543,125,1418,228658,7671,220987,130862211.0,4372942.0,126489269.0,1532,120,1412,228509,7623,220886,130773979.0,4344815.0,126429164.0,0.5701,0.5724,0.57,0.5724
2023-03-31 17:25,690,21,669,76541,1397,75144,43847788.0,798530.0,43049258.0,680,12,668,77125,1363,75762,44180746.0,776444.0,43404301.0,0.5716,0.5729,0.5697,0.5729
2023-03-31 17:30,1288,72,1216,153735,7773,145962,100166094.0,16525195.0,83640898.0,1280,71,1209,153450,7802,145648,99998378.0,16538011.0,83460367.0,2.126,0.573,2.1197,0.573
2023-03-31 17:35,787,93,694,114541,9485,105056,65595389.0,5409312.0,60186076.0,778,87,691,114115,9429,104686,65355849.0,5376366.0,59979483.0,0.5703,0.5729,0.5702,0.5729
2023-03-31 17:40,2715,728,1987,283196,14746,268450,174111255.0,20492823.0,153618432.0,2698,714,1984,282245,13614,268631,173573374.0,19849762.0,153723612.0,1.3897,0.5722,1.458,0.5722
2023-03-31 17:45,2043,305,1738,255347,15023,240324,158265312.0,20672110.0,137593201.0,2026,295,1731,256002,15860,240142,158638819.0,21134786.0,137504033.0,1.376,0.5725,1.3326,0.5726
2023-03-31 17:50,2647,402,2245,325096,19500,305596,186073851.0,11126290.0,174947561.0,2637,396,2241,325121,19626,305495,186089060.0,11197909.0,174891150.0,0.5706,0.5725,0.5706,0.5725
2023-03-31 17:55,1086,259,827,139066,20021,119045,79574631.0,11419192.0,68155438.0,1070,249,821,138430,20001,118429,79209584.0,11406507.0,67803076.0,0.5704,0.5725,0.5703,0.5725
2023-03-31 18:00,980,315,665,106909,22159,84750,61191248.0,12657818.0,48533429.0,960,304,656,105630,21529,84101,60449830.0,12276586.0,48173244.0,0.5712,0.5727,0.5702,0.5728
2023-03-31 18:05,3473,574,2899,456377,32925,423452,261251965.0,18777356.0,242474609.0,3468,571,2897,456752,32945,423807,261465161.0,18788084.0,242677077.0,0.5703,0.5726,0.5703,0.5726
2023-03-31 18:10,2062,393,1669,318150,15617,302533,182187651.0,8910527.0,173277124.0,2046,382,1664,317789,15421,302368,181977300.0,8794086.0,173183213.0,0.5706,0.5728,0.5703,0.5728
2023-03-31 18:15,61,5,56,7040,208,6832,4034027.0,118893.0,3915133.0,58,5,53,7209,355,6854,4128898.0,201266.0,3927631.0,0.5716,0.5731,0.5669,0.573
2023-03-31 18:20,1148,1060,88,148383,132440,15943,84711395.0,75555615.0,9155779.0,1133,1049,84,146571,130990,15581,83673126.0,74725063.0,8948063.0,0.5705,0.5743,0.5705,0.5743
2023-03-31 18:25,567,557,10,69302,68551,751,39540904.0,39111404.0,429499.0,551,548,3,69217,68511,706,39492049.0,39084606.0,407443.0,0.5705,0.5719,0.5705,0.5771
2023-03-31 18:30,186,48,138,31064,3963,27101,29909754.0,14355611.0,15554142.0,156,28,128,31450,4059,27391,30142537.0,14409792.0,15732745.0,3.6224,0.5739,3.5501,0.5744
2023-03-31 18:35,93,26,67,10455,980,9475,6021578.0,560665.0,5460913.0,85,15,70,10696,1107,9589,6158031.0,630621.0,5527409.0,0.5721,0.5763,0.5697,0.5764
2023-04-03 10:00,2471,1768,703,288564,197982,90582,177793454.0,125391259.0,52402194.0,2299,1659,640,269707,184744,84963,162107186.0,113082540.0,49024646.0,0.6333,0.5785,0.6121,0.577
2023-04-03 10:05,1770,1364,406,245265,186792,58473,140112292.0,106325603.0,33786689.0,1694,1315,379,243455,185549,57906,139047017.0,105609270.0,33437746.0,0.5692,0.5778,0.5692,0.5774
2023-04-03 10:10,2320,1484,836,345014,217891,127123,197233219.0,123958524.0,73274694.0,2274,1460,814,343780,217325,126455,196538338.0,123632666.0,72905672.0,0.5689,0.5764,0.5689,0.5765
2023-04-03 10:15,980,232,748,121985,30329,91656,70188410.0,17308444.0,52879966.0,900,201,699,118366,30017,88349,68052948.0,17071100.0,50981848.0,0.5707,0.5769,0.5687,0.5771
2023-04-03 10:20,2240,684,1556,266590,84044,182546,164899516.0,59929127.0,104970389.0,2159,644,1515,262960,82765,180195,156386335.0,52746771.0,103639564.0,0.7131,0.575,0.6373,0.5752
2023-04-03 10:25,6677,3424,3253,800213,415901,384312,480913808.0,260580352.0,220333456.0,6628,3392,3236,799201,415445,383756,480340147.0,260326131.0,220014015.0,0.6265,0.5733,0.6266,0.5733
2023-04-03 10:30,2574,776,1798,296329,92986,203343,193682444.0,77071735.0,116610708.0,2530,746,1784,295988,92626,203362,193486257.0,76864914.0,116621342.0,0.8289,0.5735,0.8298,0.5735
2023-04-03 10:35,3419,1020,2399,410672,109928,300744,235130669.0,62565782.0,172564887.0,3388,1006,2382,410220,109702,300518,234871243.0,62438159.0,172433084.0,0.5692,0.5738,0.5692,0.5738
2023-04-03 10:40,1478,351,1127,209350,32423,176927,132131202.0,30569723.0,101561479.0,1442,337,1105,208673,32243,176430,131760142.0,30466077.0,101294064.0,0.9428,0.574,0.9449,0.5741
2023-04-03 10:45,121,67,54,9114,3436,5678,5229040.0,1965266.0,3263774.0,95,47,48,8136,2557,5579,4666870.0,1460642.0,3206228.0,0.572,0.5748,0.5712,0.5747
2023-04-03 10:50,632,217,415,49881,11228,38653,40637449.0,18507805.0,22129644.0,593,200,393,48549,10972,37577,39932524.0,18361126.0,21571397.0,1.6484,0.5725,1.6735,0.5741
2023-04-03 10:55,1336,684,652,115354,61661,53693,65900928.0,35107655.0,30793273.0,1303,661,642,114409,61174,53235,65342853.0,34820541.0,30522311.0,0.5694,0.5735,0.5692,0.5734
2023-04-03 11:00,1577,918,659,158436,94284,64152,90448625.0,53681686.0,36766939.0,1529,878,651,157115,93514,63601,89691893.0,53239342.0,36452551.0,0.5694,0.5731,0.5693,0.5731
2023-04-03 11:05,1420,876,544,119463,69019,50444,68256038.0,39346010.0,28910027.0,1397,861,536,119509,69101,50408,68278229.0,39389208.0,28889021.0,0.5701,0.5731,0.57,0.5731
2023-04-03 11:10,1926,1297,629,148383,92939,55444,84758711.0,52992402.0,31766308.0,1880,1270,610,146383,92379,54004,83616959.0,52672949.0,30944010.0,0.5702,0.5729,0.5702,0.573
2023-04-03 11:15,561,139,422,38422,7923,30499,34058425.0,16609053.0,17449371.0,528,116,412,37798,7453,30345,33709127.0,16338797.0,17370329.0,2.0963,0.5721,2.1922,0.5724
2023-04-03 11:20,318,31,287,27200,785,26415,15564512.0,455984.0,15108528.0,298,15,283,26776,534,26242,15313578.0,303417.0,15010160.0,0.5809,0.572,0.5682,0.572
2023-04-03 11:25,397,22,375,47195,172,47023,26994559.0,98703.0,26895856.0,369,2,367,46901,2,46899,26826749.0,1131.0,26825618.0,0.5739,0.572,0.5656,0.572
2023-04-03 11:30,579,231,348,60481,25503,34978,34572127.0,14545751.0,20026376.0,551,211,340,59701,24732,34969,34126959.0,14102462.0,20024497.0,0.5704,0.5725,0.5702,0.5726
2023-04-03 11:35,446,118,328,53812,17516,36296,30695353.0,9930435.0,20764917.0,427,105,322,54066,17095,36971,30851781.0,9691996.0,21159785.0,0.5669,0.5721,0.5669,0.5723
2023-04-03 11:40,876,124,752,120712,21408,99304,69069974.0,12211789.0,56858184.0,849,112,737,119272,20821,98451,68244796.0,11876845.0,56367950.0,0.5704,0.5726,0.5704,0.5725
2023-04-03 11:45,770,122,648,92592,17771,74821,65110018.0,22232877.0,42877141.0,746,107,639,91271,17792,73479,64345010.0,22240863.0,42104146.0,1.2511,0.5731,1.25,0.573
2023-04-03 11:50,49,13,36,4023,165,3858,2304211.0,93885.0,2210326.0,33,3,30,3903,92,3811,2235839.0,52507.0,2183332.0,0.569,0.5729,0.5707,0.5729
2023-04-03 11:55,728,174,554,90806,17365,73441,51900711.0,9874039.0,42026672.0,710,163,547,90832,17203,73629,51956698.0,9778609.0,42178088.0,0.5686,0.5723,0.5684,0.5728
2023-04-03 12:00,957,252,705,114341,20428,93913,65440597.0,11667245.0,53773352.0,919,222,697,113929,20261,93668,65202587.0,11569298.0,53633289.0,0.5711,0.5726,0.571,0.5726
2023-04-03 12:05,306,233,73,20544,11661,8883,11744305.0,6650590.0,5093714.0,285,219,66,19719,10938,8781,11290717.0,6246360.0,5044356.0,0.5703,0.5734,0.5711,0.5745
2023-04-03 12:10,274,145,129,22118,8326,13792,12657824.0,4741828.0,7915995.0,253,132,121,21894,8401,13493,12520882.0,4777438.0,7743444.0,0.5695,0.574,0.5687,0.5739
2023-04-03 12:15,112,61,51,8442,3142,5300,4827595.0,1786619.0,3040975.0,96,49,47,7732,2479,5253,4423048.0,1409480.0,3013568.0,0.5686,0.5738,0.5686,0.5737
2023-04-03 12:20,58,17,41,3999,661,3338,2291637.0,377262.0,1914375.0,46,12,34,3871,625,3246,2217866.0,356413.0,1861453.0,0.5707,0.5735,0.5703,0.5735
2023-04-03 12:25,103,52,51,6485,1789,4696,3722938.0,1030543.0,2692395.0,89,43,46,6415,1828,4587,3667855.0,1038223.0,2629632.0,0.576,0.5733,0.568,0.5733
2023-04-03 12:30,465,383,82,25321,14860,10461,14485528.0,8478739.0,6006788.0,446,375,71,24951,14600,10351,14266145.0,8319117.0,5947028.0,0.5706,0.5742,0.5698,0.5745
2023-04-03 12:35,422,402,20,19567,17755,1812,11133638.0,10093509.0,1040128.0,406,391,15,19460,17830,1630,11067620.0,10132696.0,934924.0,0.5685,0.574,0.5683,0.5736
2023-04-03 12:40,601,289,312,40322,12232,28090,23066846.0,6981221.0,16085625.0,586,282,304,40249,12378,27871,23045084.0,7065923.0,15979160.0,0.5707,0.5726,0.5708,0.5733
2023-04-03 12:45,221,105,116,18822,5809,13013,10781571.0,3317895.0,7463676.0,197,89,108,18039,5058,12981,10331746.0,2884522.0,7447223.0,0.5712,0.5736,0.5703,0.5737
2023-04-03 12:50,189,64,125,16705,3015,13690,9584149.0,1721844.0,7862305.0,178,54,124,16645,2806,13839,9551174.0,1602394.0,7948780.0,0.5711,0.5743,0.5711,0.5744
2023-04-03 12:55,205,39,166,18508,2767,15741,10574878.0,1561295.0,9013582.0,188,28,160,18013,2669,15344,10297585.0,1502230.0,8795355.0,0.5643,0.5726,0.5628,0.5732
2023-04-03 13:00,516,175,341,42604,12867,29737,24356426.0,7302877.0,17053549.0,497,162,335,42449,12829,29620,24265162.0,7278927.0,16986235.0,0.5676,0.5735,0.5674,0.5735
2023-04-03 13:05,415,254,161,26114,14086,12028,14904397.0,8013570.0,6890827.0,394,236,158,25798,13709,12089,14725359.0,7797811.0,6927548.0,0.5689,0.5729,0.5688,0.573
2023-04-03 13:10,835,602,233,50783,33146,17637,29051116.0,18936542.0,10114573.0,803,579,224,50347,32709,17638,28800927.0,18685053.0,10115873.0,0.5713,0.5735,0.5713,0.5735
2023-04-03 13:15,992,709,283,84458,66623,17835,48099562.0,37899372.0,10200189.0,972,696,276,84131,66558,17573,47929584.0,37860698.0,10068886.0,0.5689,0.5719,0.5688,0.573
2023-04-03 13:20,66,36,30,6696,1359,5337,3843515.0,777396.0,3066118.0,46,19,27,6130,1170,4960,3524260.0,668535.0,2855725.0,0.572,0.5745,0.5714,0.5758
2023-04-03 13:25,385,231,154,27386,13823,13563,15666318.0,7887638.0,7778680.0,366,217,149,27478,13731,13747,15721917.0,7835699.0,7886217.0,0.5706,0.5735,0.5707,0.5737
2023-04-03 13:30,76,27,49,6664,1287,5377,3817259.0,731728.0,3085531.0,66,21,45,6573,1177,5396,3771706.0,669313.0,3102393.0,0.5686,0.5738,0.5687,0.5749
2023-04-03 13:35,116,35,81,11761,1743,10018,6750087.0,995234.0,5754852.0,105,29,76,11340,1597,9743,6503296.0,910794.0,5592501.0,0.571,0.5745,0.5703,0.574
2023-04-03 13:40,236,41,195,24310,1406,22904,13926874.0,803049.0,13123825.0,226,35,191,24355,1428,22927,13954662.0,815562.0,13139099.0,0.5712,0.573,0.5711,0.5731
2023-04-03 13:45,70,32,38,5857,1322,4535,3363783.0,757754.0,2606029.0,52,18,34,5418,1012,4406,3112586.0,578144.0,2534442.0,0.5732,0.5746,0.5713,0.5752
2023-04-03 13:50,266,39,227,18681,2780,15901,10701888.0,1589036.0,9112852.0,252,32,220,18437,2634,15803,10561779.0,1505303.0,9056476.0,0.5716,0.5731,0.5715,0.5731
2023-04-03 13:55,63,27,36,6316,1601,4715,3623336.0,914305.0,2709030.0,55,21,34,6632,1650,4982,3803791.0,940466.0,2863324.0,0.5711,0.5746,0.57,0.5747
2023-04-03 14:00,282,35,247,24739,2998,21741,14188949.0,1713831.0,12475118.0,268,26,242,24068,2906,21162,13803714.0,1660696.0,12143018.0,0.5717,0.5738,0.5715,0.5738
2023-04-03 14:05,567,520,47,34313,27239,7074,19677691.0,15604425.0,4073266.0,548,509,39,33969,26852,7117,19456538.0,15358504.0,4098034.0,0.5729,0.5758,0.572,0.5758
2023-04-03 14:10,390,214,176,26113,12428,13685,27558132.0,19701297.0,7856835.0,374,206,168,25559,12282,13277,26733457.0,19111354.0,7622102.0,1.5852,0.5741,1.556,0.5741
2023-04-03 14:15,246,233,13,9830,9245,585,5622499.0,5287286.0,335212.0,240,229,11,9980,9397,583,5708281.0,5374106.0,334175.0,0.5719,0.573,0.5719,0.5732
2023-04-03 14:20,1062,638,424,103647,38716,64931,71987434.0,34731148.0,37256286.0,1048,631,417,103715,38675,65040,72027525.0,34707348.0,37320177.0,0.8971,0.5738,0.8974,0.5738
2023-04-03 14:25,1359,305,1054,164338,26187,138151,94220450.0,14974764.0,79245686.0,1348,301,1047,163690,25967,137723,93845220.0,14845306.0,78999913.0,0.5718,0.5736,0.5717,0.5736
2023-04-03 14:30,1316,197,1119,124740,17879,106861,71497779.0,10216644.0,61281135.0,1298,186,1112,124143,17495,106648,71161144.0,9999852.0,61161291.0,0.5714,0.5735,0.5716,0.5735
2023-04-03 14:35,1254,137,1117,178495,9976,168519,102326464.0,5697918.0,96628546.0,1244,130,1114,178605,10073,168532,102388930.0,5751468.0,96637462.0,0.5712,0.5734,0.571,0.5734
2023-04-03 14:40,836,16,820,130377,1545,128832,74792971.0,882664.0,73910307.0,829,11,818,130017,1385,128632,74585115.0,790938.0,73794176.0,0.5713,0.5737,0.5711,0.5737
2023-04-03 14:45,1382,160,1222,194171,10711,183460,111387716.0,6140846.0,105246870.0,1363,144,1219,193601,10521,183080,111040891.0,6012987.0,105027904.0,0.5733,0.5737,0.5715,0.5737
2023-04-03 14:50,1304,19,1285,248741,1221,247520,142653234.0,695035.0,141958199.0,1298,15,1283,248756,1057,247699,142667516.0,602338.0,142065178.0,0.5692,0.5735,0.5699,0.5735
2023-04-03 14:55,817,182,635,129077,17038,112039,73977006.0,9731024.0,64245981.0,801,175,626,128328,16910,111418,73575608.0,9657883.0,63917725.0,0.5711,0.5734,0.5711,0.5737
2023-04-03 15:00,1472,303,1169,227336,25431,201905,130363590.0,14545508.0,115818081.0,1456,293,1163,227213,25292,201921,130280765.0,14453492.0,115827273.0,0.572,0.5736,0.5715,0.5736
2023-04-03 15:05,566,290,276,41511,10990,30521,23805310.0,6284896.0,17520413.0,544,273,271,41132,10625,30507,23593382.0,6076747.0,17516635.0,0.5719,0.574,0.5719,0.5742
2023-04-03 15:10,714,609,105,61875,47637,14238,48033775.0,39847101.0,8186674.0,695,596,99,61253,47181,14072,47676180.0,39584300.0,8091880.0,0.8365,0.575,0.839,0.575
2023-04-03 15:15,226,177,49,21376,13249,8127,12249078.0,7573869.0,4675208.0,214,170,44,18973,11382,7591,10877006.0,6512902.0,4364104.0,0.5717,0.5753,0.5722,0.5749
2023-04-03 15:20,44,12,32,3595,311,3284,2066158.0,178082.0,1888076.0,41,11,30,3855,310,3545,2216709.0,177539.0,2039170.0,0.5726,0.5749,0.5727,0.5752
2023-04-03 15:25,42,3,39,6403,3,6400,3691941.0,1711.0,3690230.0,40,2,38,6401,2,6399,3690695.0,1138.0,3689556.0,0.5705,0.5766,0.5692,0.5766
2023-04-03 15:30,199,51,148,16440,1557,14883,9415285.0,888218.0,8527067.0,193,51,142,16229,1676,14553,9330208.0,956374.0,8373833.0,0.5705,0.5729,0.5706,0.5754
2023-04-03 15:35,2811,1458,1353,239521,125189,114332,149696539.0,84142674.0,65553865.0,2800,1452,1348,238653,124998,113655,149208639.0,84033824.0,65174814.0,0.6721,0.5734,0.6723,0.5734
2023-04-03 15:40,1952,1308,644,174641,115369,59272,99960360.0,65942761.0,34017598.0,1939,1301,638,174267,115049,59218,99745473.0,65758659.0,33986814.0,0.5716,0.5739,0.5716,0.5739
2023-04-03 15:45,32,16,16,2006,704,1302,1150651.0,401680.0,748971.0,22,9,13,1622,167,1455,933326.0,95478.0,837847.0,0.5706,0.5752,0.5717,0.5758
2023-04-03 15:50,104,35,69,12908,3483,9425,7410666.0,1993362.0,5417304.0,103,34,69,12543,2549,9994,7202296.0,1457701.0,5744595.0,0.5723,0.5748,0.5719,0.5748
2023-04-03 15:55,259,26,233,18990,1270,17720,10901869.0,725153.0,10176715.0,249,19,230,17813,481,17332,10227156.0,274510.0,9952645.0,0.571,0.5743,0.5707,0.5742
2023-04-03 16:00,66,20,46,7516,1945,5571,16914483.0,13705827.0,3208655.0,52,13,39,6213,1061,5152,16170871.0,13199586.0,2971284.0,7.0467,0.576,12.4407,0.5767
2023-04-03 16:05,134,40,94,11998,2982,9016,6897175.0,1708834.0,5188341.0,116,28,88,11045,3079,7966,6344477.0,1759386.0,4585090.0,0.573,0.5755,0.5714,0.5756
2023-04-03 16:10,120,50,70,10703,2787,7916,6147336.0,1595514.0,4551822.0,105,40,65,11149,2739,8410,6398451.0,1567256.0,4831195.0,0.5725,0.575,0.5722,0.5745
2023-04-03 16:15,79,36,43,7602,1120,6482,4492242.0,642545.0,3849696.0,69,29,40,7033,1556,5477,4063272.0,858867.0,3204405.0,0.5737,0.5939,0.552,0.5851
2023-04-03 16:20,388,213,175,22933,10749,12184,13192887.0,6200486.0,6992401.0,374,209,165,22347,10549,11798,12811943.0,6038566.0,6773377.0,0.5768,0.5739,0.5724,0.5741
2023-04-03 16:25,433,309,124,30140,21861,8279,17279556.0,12527707.0,4751849.0,422,302,120,30206,21764,8442,17318266.0,12470881.0,4847384.0,0.5731,0.574,0.573,0.5742
2023-04-03 16:30,59,34,25,3415,471,2944,1960615.0,270029.0,1690585.0,52,31,21,3306,601,2705,1896534.0,343062.0,1553472.0,0.5733,0.5742,0.5708,0.5743
2023-04-03 16:35,70,41,29,5120,2360,2760,2950384.0,1350797.0,1599587.0,55,30,25,3585,1207,2378,2062022.0,691647.0,1370375.0,0.5724,0.5796,0.573,0.5763
2023-04-03 16:40,115,50,65,7713,2719,4994,4433213.0,1555899.0,2877314.0,98,39,59,6439,1412,5027,3703496.0,807406.0,2896090.0,0.5722,0.5762,0.5718,0.5761
2023-04-03 16:45,439,400,39,18389,14799,3590,10559196.0,8493027.0,2066169.0,437,399,38,18437,14864,3573,10588139.0,8530028.0,2058111.0,0.5739,0.5755,0.5739,0.576
2023-04-03 16:50,443,281,162,33254,15712,17542,31722934.0,21628596.0,10094338.0,422,272,150,31474,15092,16382,30670379.0,21242408.0,9427971.0,1.3766,0.5754,1.4075,0.5755
2023-04-03 16:55,97,71,26,7391,3788,3603,4246098.0,2172865.0,2073232.0,89,65,24,7573,3998,3575,4349794.0,2293084.0,2056710.0,0.5736,0.5754,0.5736,0.5753
2023-04-03 17:00,445,71,374,54134,3785,50349,43686634.0,14763067.0,28923567.0,433,67,366,54584,3860,50724,43965100.0,14806817.0,29158283.0,3.9004,0.5745,3.836,0.5748
2023-04-03 17:05,51,13,38,3488,452,3036,2012696.0,259104.0,1753592.0,41,9,32,3228,321,2907,1862787.0,184000.0,1678787.0,0.5732,0.5776,0.5732,0.5775
2023-04-03 17:10,1266,123,1143,105825,2679,103146,60813143.0,1536549.0,59276594.0,1256,118,1138,106126,2757,103369,60994881.0,1579278.0,59415603.0,0.5736,0.5747,0.5728,0.5748
2023-04-03 17:15,798,113,685,66434,9610,56824,38160867.0,5512069.0,32648798.0,784,107,677,65931,9520,56411,37879709.0,5451840.0,32427869.0,0.5736,0.5746,0.5727,0.5749
2023-04-03 17:20,227,10,217,15289,467,14822,8790060.0,269057.0,8521003.0,217,4,213,14755,9,14746,8482530.0,5153.0,8477377.0,0.5761,0.5749,0.5726,0.5749
2023-04-03 17:25,27,15,12,1251,275,976,726938.0,163281.0,563657.0,16,7,9,1133,321,812,652200.0,182681.0,469518.0,0.5938,0.5775,0.5691,0.5782
2023-04-03 17:30,131,24,107,22398,1183,21215,12912514.0,692944.0,12219570.0,122,21,101,20843,750,20093,12002234.0,429354.0,11572880.0,0.5858,0.576,0.5725,0.576
2023-04-03 17:35,73,20,53,10705,751,9954,6159692.0,430853.0,5728839.0,69,17,52,10421,680,9741,5996274.0,390003.0,5606271.0,0.5737,0.5755,0.5735,0.5755
2023-04-03 17:40,230,110,120,16612,7106,9506,9542705.0,4077672.0,5465033.0,228,108,120,16644,7070,9574,9561166.0,4057080.0,5504086.0,0.5738,0.5749,0.5738,0.5749
2023-04-03 17:45,227,57,170,21343,1814,19529,12269456.0,1039826.0,11229630.0,220,55,165,21253,2045,19208,12220304.0,1172303.0,11048001.0,0.5732,0.575,0.5733,0.5752
2023-04-03 17:50,296,149,147,22249,9965,12284,12778292.0,5716681.0,7061611.0,291,145,146,22012,9703,12309,12641460.0,5565510.0,7075949.0,0.5737,0.5749,0.5736,0.5749
2023-04-03 17:55,267,127,140,21039,7625,13414,12091775.0,4375314.0,7716461.0,258,122,136,20952,7692,13260,12044255.0,4413963.0,7630291.0,0.5738,0.5753,0.5738,0.5754
2023-04-03 18:00,63,22,41,7505,654,6851,4318964.0,374601.0,3944362.0,58,20,38,6727,612,6115,3873575.0,350494.0,3523081.0,0.5728,0.5757,0.5727,0.5761
2023-04-03 18:05,40,28,12,2660,1235,1425,1527279.0,707173.0,820105.0,36,25,11,2546,1150,1396,1462655.0,659136.0,803518.0,0.5726,0.5755,0.5732,0.5756
2023-04-03 18:10,567,548,19,46249,43311,2938,26522319.0,24832684.0,1689635.0,567,549,18,46078,43217,2861,26423041.0,24777428.0,1645613.0,0.5734,0.5751,0.5733,0.5752
2023-04-03 18:15,1277,924,353,100724,80408,20316,57778648.0,46108923.0,11669725.0,1262,916,346,100471,80257,20214,57632869.0,46016982.0,11615887.0,0.5734,0.5744,0.5734,0.5746
2023-04-03 18:20,449,277,172,35333,24677,10656,20287815.0,14149432.0,6138382.0,441,273,168,35174,24810,10364,20183988.0,14225077.0,5958911.0,0.5734,0.576,0.5734,0.575
2023-04-03 18:25,86,49,37,5264,2711,2553,3023761.0,1553638.0,1470122.0,80,47,33,5224,2675,2549,3000607.0,1532785.0,1467822.0,0.5731,0.5758,0.573,0.5758
2023-04-03 18:30,438,24,414,29040,732,28308,16684616.0,420442.0,16264174.0,427,15,412,28944,668,28276,16629040.0,383088.0,16245951.0,0.5744,0.5745,0.5735,0.5745
2023-04-03 18:35,437,351,86,29370,22880,6490,16858392.0,13134791.0,3723601.0,415,343,72,29650,23274,6376,17007316.0,13337264.0,3670052.0,0.5741,0.5737,0.5731,0.5756
2023-04-04 10:00,4083,2154,1929,590401,359923,230478,346322854.0,213239610.0,133083243.0,3854,2017,1837,573054,347347,225707,331394008.0,201200143.0,130193864.0,0.5925,0.5774,0.5792,0.5768
2023-04-04 10:05,1577,811,766,194840,113844,80996,148896468.0,101930926.0,46965542.0,1471,754,717,181849,106845,75004,134707620.0,91262048.0,43445571.0,0.8954,0.5799,0.8542,0.5792
2023-04-04 10:10,910,609,301,103200,83471,19729,59568148.0,48096121.0,11472027.0,809,565,244,99499,81880,17619,57409892.0,47171999.0,10237893.0,0.5762,0.5815,0.5761,0.5811
2023-04-04 10:15,654,372,282,43534,25906,17628,25219367.0,14985249.0,10234118.0,581,338,243,41911,25268,16643,24280001.0,14609413.0,9670588.0,0.5784,0.5806,0.5782,0.5811
2023-04-04 10:20,888,556,332,108703,81414,27289,62783485.0,46857278.0,15926207.0,823,542,281,101515,80282,21233,58551781.0,46211733.0,12340047.0,0.5755,0.5836,0.5756,0.5812
2023-04-04 10:25,1935,1320,615,243585,203823,39762,140460391.0,117383307.0,23077083.0,1876,1301,575,239933,202796,37137,138286872.0,116739546.0,21547326.0,0.5759,0.5804,0.5757,0.5802
2023-04-04 10:30,963,420,543,71094,33432,37662,65503731.0,43566289.0,21937442.0,895,386,509,67958,30782,37176,63651643.0,41998466.0,21653177.0,1.3031,0.5825,1.3644,0.5825
2023-04-04 10:35,961,296,665,70064,23967,46097,40755747.0,13902084.0,26853663.0,890,266,624,67097,22573,44524,39033783.0,13096331.0,25937452.0,0.5801,0.5825,0.5802,0.5825
2023-04-04 10:40,1395,689,706,178599,126994,51605,115557311.0,85494682.0,30062629.0,1335,662,673,175958,126116,49842,114008322.0,84984678.0,29023643.0,0.6732,0.5826,0.6739,0.5823
2023-04-04 10:45,1504,945,559,200953,159104,41849,116355730.0,91985931.0,24369799.0,1463,931,532,200731,159278,41453,116224776.0,92084990.0,24139786.0,0.5781,0.5823,0.5781,0.5823
2023-04-04 10:50,895,515,380,140372,112672,27700,81313218.0,65192726.0,16120492.0,868,503,365,138470,110729,27741,80206406.0,64060542.0,16145864.0,0.5786,0.582,0.5785,0.582
2023-04-04 10:55,6150,5294,856,1461191,1396036,65155,909616407.0,871504305.0,38112102.0,6081,5263,818,1457656,1395020,62636,906965823.0,870375773.0,36590049.0,0.6243,0.5849,0.6239,0.5842
2023-04-04 11:00,3653,2880,773,718358,664601,53757,429875540.0,398415645.0,31459895.0,3580,2847,733,716551,663727,52824,428760404.0,397862762.0,30897642.0,0.5995,0.5852,0.5994,0.5849
2023-04-04 11:05,3380,1977,1403,651385,403275,248110,416630104.0,271828223.0,144801881.0,3293,1948,1345,648470,403450,245020,414984646.0,271927541.0,143057105.0,0.6741,0.5836,0.674,0.5839
2023-04-04 11:10,2423,568,1855,339261,79096,260165,197648030.0,45814633.0,151833396.0,2369,544,1825,336759,78358,258401,196189841.0,45385740.0,150804101.0,0.5792,0.5836,0.5792,0.5836
2023-04-04 11:15,518,148,370,55139,17119,38020,44668808.0,22478377.0,22190430.0,484,134,350,52844,17089,35755,43302938.0,22458958.0,20843980.0,1.3131,0.5837,1.3142,0.583
2023-04-04 11:20,2568,696,1872,272247,67428,204819,158395144.0,39042371.0,119352773.0,2531,674,1857,271626,67130,204496,158029570.0,38867334.0,119162235.0,0.579,0.5827,0.579,0.5827
2023-04-04 11:25,3612,1202,2410,480288,161948,318340,304345292.0,118812875.0,185532417.0,3573,1182,2391,479547,161735,317812,303922355.0,118695183.0,185227172.0,0.7336,0.5828,0.7339,0.5828
2023-04-04 11:30,1605,79,1526,187091,6263,180828,108938703.0,3620490.0,105318213.0,1584,68,1516,187084,6209,180875,108932637.0,3586912.0,105345725.0,0.5781,0.5824,0.5777,0.5824
2023-04-04 11:35,2554,1286,1268,515947,371206,144741,311832188.0,227530584.0,84301603.0,2513,1261,1252,513688,369495,144193,310431859.0,226445982.0,83985877.0,0.6129,0.5824,0.6129,0.5825
2023-04-04 11:40,3546,2538,1008,653449,599988,53461,378731473.0,347539797.0,31191675.0,3512,2525,987,652376,599598,52778,378110452.0,347311573.0,30798878.0,0.5792,0.5834,0.5792,0.5836
2023-04-04 11:45,3447,2055,1392,561909,452021,109888,326057972.0,261951198.0,64106773.0,3407,2037,1370,561452,452262,109190,325792032.0,262090071.0,63701961.0,0.5795,0.5834,0.5795,0.5834
2023-04-04 11:50,3013,2356,657,700535,648542,51993,405678001.0,375378732.0,30299269.0,2987,2348,639,699939,648317,51622,405331546.0,375247834.0,30083712.0,0.5788,0.5828,0.5788,0.5828
2023-04-04 11:55,3758,2683,1075,856493,767529,88964,508751512.0,457019155.0,51732356.0,3730,2669,1061,855071,766897,88174,507936182.0,456646037.0,51290145.0,0.5954,0.5815,0.5954,0.5817
2023-04-04 12:00,2520,903,1617,313780,171137,142643,182001316.0,99034340.0,82966976.0,2501,893,1608,313337,171423,141914,181766753.0,99201002.0,82565751.0,0.5787,0.5816,0.5787,0.5818
2023-04-04 12:05,1439,426,1013,185972,88172,97800,107869703.0,51029570.0,56840133.0,1413,410,1003,185449,87922,97527,107583041.0,50875239.0,56707802.0,0.5788,0.5812,0.5786,0.5815
2023-04-04 12:10,1030,359,671,149211,81700,67511,86479707.0,47233393.0,39246314.0,1018,353,665,150589,82526,68063,87283361.0,47713166.0,39570195.0,0.5781,0.5813,0.5782,0.5814
2023-04-04 12:15,258,65,193,29508,5829,23679,17122110.0,3355457.0,13766652.0,235,52,183,28983,5476,23507,16826609.0,3152925.0,13673683.0,0.5756,0.5814,0.5758,0.5817
2023-04-04 12:20,763,357,406,69653,30803,38850,40398236.0,17808612.0,22589624.0,748,351,397,69430,30924,38506,40262135.0,17873518.0,22388617.0,0.5781,0.5815,0.578,0.5814
2023-04-04 12:25,1700,1117,583,205875,140723,65152,119275483.0,81403664.0,37871819.0,1684,1110,574,205353,140293,65060,118970796.0,81152838.0,37817957.0,0.5785,0.5813,0.5785,0.5813
2023-04-04 12:30,1591,1052,539,158663,112050,46613,91975129.0,64887159.0,27087969.0,1581,1047,534,158804,112354,46450,92055618.0,65062398.0,26993220.0,0.5791,0.5811,0.5791,0.5811
2023-04-04 12:35,2190,1224,966,267206,167021,100185,167478731.0,109293491.0,58185240.0,2165,1213,952,266220,166666,99554,166963482.0,109087376.0,57876106.0,0.6544,0.5808,0.6545,0.5814
2023-04-04 12:40,1326,80,1246,130467,8068,122399,75659105.0,4615887.0,71043218.0,1299,65,1234,129989,8172,121817,75402515.0,4670368.0,70732147.0,0.5721,0.5804,0.5715,0.5806
2023-04-04 12:45,1489,28,1461,176677,1580,175097,102620990.0,913756.0,101707233.0,1473,20,1453,175889,1306,174583,102163983.0,754655.0,101409327.0,0.5783,0.5809,0.5778,0.5809
2023-04-04 12:50,1633,83,1550,200564,4234,196330,116466124.0,2436740.0,114029383.0,1614,72,1542,199925,4166,195759,116101943.0,2394818.0,113707124.0,0.5755,0.5808,0.5748,0.5809
2023-04-04 12:55,645,490,155,64866,46039,18827,37551212.0,26607306.0,10943906.0,640,485,155,63968,45076,18892,36989201.0,26007138.0,10982062.0,0.5779,0.5813,0.577,0.5813
2023-04-04 13:00,646,125,521,73143,8935,64208,42483205.0,5161935.0,37321270.0,632,122,510,73245,9256,63989,42539234.0,5343276.0,37195958.0,0.5777,0.5813,0.5773,0.5813
2023-04-04 13:05,496,15,481,64385,700,63685,37444023.0,415369.0,37028654.0,485,8,477,63989,413,63576,37206278.0,236041.0,36970236.0,0.5934,0.5814,0.5715,0.5815
2023-04-04 13:10,1500,36,1464,178241,4219,174022,103614065.0,2425454.0,101188610.0,1486,29,1457,177912,3857,174055,103425406.0,2217617.0,101207789.0,0.5749,0.5815,0.575,0.5815
2023-04-04 13:15,1507,293,1214,163866,30218,133648,107772263.0,30063541.0,77708721.0,1493,284,1209,163568,30208,133360,107624847.0,30054287.0,77570559.0,0.9949,0.5814,0.9949,0.5817
2023-04-04 13:20,1243,429,814,158456,60012,98444,91933144.0,34676448.0,57256696.0,1236,427,809,157804,59607,98197,91554183.0,34442633.0,57111549.0,0.5778,0.5816,0.5778,0.5816
2023-04-04 13:25,2185,433,1752,265522,70632,194890,166611435.0,53417307.0,113194128.0,2168,425,1743,263681,70197,193484,165543203.0,53155863.0,112387340.0,0.7563,0.5808,0.7572,0.5809
2023-04-04 13:30,2135,224,1911,238261,20355,217906,138212481.0,11711177.0,126501303.0,2117,214,1903,238173,20272,217901,138165043.0,11662836.0,126502206.0,0.5753,0.5805,0.5753,0.5805
2023-04-04 13:35,512,130,382,43439,8031,35408,25196129.0,4634505.0,20561624.0,497,119,378,42890,7475,35415,24873758.0,4309169.0,20564589.0,0.5771,0.5807,0.5765,0.5807
2023-04-04 13:40,1363,878,485,144962,94036,50926,83966593.0,54383066.0,29583526.0,1348,870,478,143742,93506,50236,83249188.0,54066342.0,29182845.0,0.5783,0.5809,0.5782,0.5809
2023-04-04 13:45,2040,779,1261,215530,67773,147757,125017939.0,39180692.0,85837246.0,2028,775,1253,215465,67654,147811,124969344.0,39100830.0,85868513.0,0.5781,0.5809,0.578,0.5809
2023-04-04 13:50,699,369,330,74327,39302,35025,55639217.0,35291818.0,20347399.0,691,363,328,73583,38983,34600,55209901.0,35108867.0,20101034.0,0.898,0.5809,0.9006,0.581
2023-04-04 13:55,340,95,245,27272,6098,21174,15816431.0,3524182.0,12292249.0,330,92,238,27588,6263,21325,16000253.0,3619386.0,12380867.0,0.5779,0.5805,0.5779,0.5806
2023-04-04 14:00,711,314,397,68668,26372,42296,39763902.0,15209943.0,24553959.0,690,301,389,68208,26295,41913,39489373.0,15160389.0,24328984.0,0.5767,0.5805,0.5766,0.5805
2023-04-04 14:05,783,336,447,79241,31605,47636,45843143.0,18177979.0,27665164.0,767,326,441,78794,31367,47427,45590396.0,18038241.0,27552155.0,0.5752,0.5808,0.5751,0.5809
2023-04-04 14:10,613,99,514,60249,3988,56261,34971403.0,2300921.0,32670482.0,595,86,509,59670,3708,55962,34633777.0,2136712.0,32497064.0,0.577,0.5807,0.5762,0.5807
2023-04-04 14:15,132,32,100,13062,2090,10972,7579548.0,1200350.0,6379198.0,121,26,95,13068,2147,10921,7583347.0,1232353.0,6350994.0,0.5743,0.5814,0.574,0.5815
2023-04-04 14:20,409,175,234,38569,13354,25215,22394218.0,7733613.0,14660605.0,400,170,230,39210,13311,25899,22769838.0,7701283.0,15068555.0,0.5791,0.5814,0.5786,0.5818
2023-04-04 14:25,387,150,237,33513,9633,23880,19459080.0,5572120.0,13886960.0,379,142,237,33209,9537,23672,19280963.0,5515768.0,13765195.0,0.5784,0.5815,0.5784,0.5815
2023-04-04 14:30,789,212,577,68922,11449,57473,40023970.0,6627611.0,33396359.0,778,204,574,69199,11533,57666,40186476.0,6676038.0,33510438.0,0.5789,0.5811,0.5789,0.5811
2023-04-04 14:35,527,71,456,48122,3999,44123,27950045.0,2311857.0,25638187.0,519,67,452,47764,3713,44051,27742701.0,2146489.0,25596211.0,0.5781,0.5811,0.5781,0.5811
2023-04-04 14:40,106,36,70,9893,2279,7614,5745732.0,1314746.0,4430986.0,95,29,66,9822,2188,7634,5705643.0,1262648.0,4442995.0,0.5769,0.582,0.5771,0.582
2023-04-04 14:45,2443,916,1527,322733,166393,156340,187459915.0,96521348.0,90938566.0,2418,900,1518,321651,165586,156065,186777657.0,95997840.0,90779817.0,0.5801,0.5817,0.5797,0.5817
2023-04-04 14:50,2384,399,1985,250127,36797,213330,145244834.0,21202064.0,124042769.0,2369,389,1980,249154,36342,212812,144679881.0,20936759.0,123743121.0,0.5762,0.5815,0.5761,0.5815
2023-04-04 14:55,2247,528,1719,215520,47078,168442,125088392.0,27227331.0,97861061.0,2232,524,1708,214704,47288,167416,124675444.0,27347136.0,97328308.0,0.5783,0.581,0.5783,0.5814
2023-04-04 15:00,541,156,385,49451,16420,33031,28636600.0,9436018.0,19200581.0,530,151,379,48099,14891,33208,27864118.0,8560589.0,19303529.0,0.5747,0.5813,0.5749,0.5813
2023-04-04 15:05,1054,55,999,93898,4260,89638,67606978.0,15550423.0,52056555.0,1045,46,999,93090,4114,88976,66669206.0,14962419.0,51706786.0,3.6503,0.5807,3.637,0.5811
2023-04-04 15:10,1177,39,1138,99974,2010,97964,58029159.0,1154785.0,56874374.0,1164,31,1133,100019,2042,97977,58054803.0,1173639.0,56881163.0,0.5745,0.5806,0.5747,0.5806
2023-04-04 15:15,378,58,320,32427,2444,29983,18827180.0,1402945.0,17424234.0,369,57,312,32646,2377,30269,18996791.0,1364003.0,17632787.0,0.574,0.5811,0.5738,0.5825
2023-04-04 15:20,462,18,444,38834,412,38422,22576101.0,238191.0,22337909.0,456,15,441,38720,392,38328,22508737.0,226546.0,22282191.0,0.5781,0.5814,0.5779,0.5814
2023-04-04 15:25,1135,483,652,92466,36715,55751,53550625.0,21177787.0,32372838.0,1124,475,649,92272,36415,55857,53418184.0,20984630.0,32433554.0,0.5768,0.5807,0.5763,0.5807
2023-04-04 15:30,597,156,441,52737,11115,41622,30521845.0,6414098.0,24107747.0,578,145,433,51652,10766,40886,29943155.0,6211486.0,23731668.0,0.5771,0.5792,0.577,0.5804
2023-04-04 15:35,340,37,303,29203,3630,25573,16941733.0,2091837.0,14849895.0,333,34,299,28418,3127,25291,16486211.0,1800661.0,14685550.0,0.5763,0.5807,0.5758,0.5807
2023-04-04 15:40,202,41,161,24591,3374,21217,14235396.0,1943544.0,12291852.0,187,29,158,21687,2615,19072,12572338.0,1505360.0,11066977.0,0.576,0.5793,0.5757,0.5803
2023-04-04 15:45,953,198,755,97119,20626,76493,82133755.0,38046897.0,44086857.0,888,151,737,95807,19624,76183,81380978.0,37463954.0,43917023.0,1.8446,0.5764,1.9091,0.5765
2023-04-04 15:50,1901,85,1816,179348,4990,174358,103133577.0,2852785.0,100280791.0,1863,52,1811,180632,5334,175298,103868237.0,3047251.0,100820985.0,0.5717,0.5751,0.5713,0.5751
2023-04-04 15:55,1297,80,1217,142060,3651,138409,81719427.0,2073092.0,79646335.0,1220,13,1207,139489,1448,138041,80274766.0,824604.0,79450161.0,0.5678,0.5754,0.5695,0.5756
2023-04-04 16:00,1338,40,1298,156839,2349,154490,90237285.0,1342988.0,88894296.0,1312,19,1293,156108,1788,154320,89819412.0,1021887.0,88797524.0,0.5717,0.5754,0.5715,0.5754
2023-04-04 16:05,593,16,577,76087,693,75394,43783140.0,396280.0,43386859.0,580,11,569,76318,1118,75200,43913204.0,637916.0,43275288.0,0.5718,0.5755,0.5706,0.5755
2023-04-04 16:10,781,16,765,86578,2506,84072,49826683.0,1431555.0,48395128.0,771,13,758,87529,3353,84176,50364021.0,1905125.0,48458896.0,0.5713,0.5756,0.5682,0.5757
2023-04-04 16:15,1498,122,1376,125416,828,124588,72155388.0,474047.0,71681341.0,1476,105,1371,124833,555,124278,71804521.0,317462.0,71487059.0,0.5725,0.5753,0.572,0.5752
2023-04-04 16:20,1513,11,1502,160434,41,160393,92442129.0,23479.0,92418650.0,1504,4,1500,160263,27,160236,92342941.0,15431.0,92327510.0,0.5727,0.5762,0.5715,0.5762
2023-04-04 16:25,1313,15,1298,120949,452,120497,69623063.0,260503.0,69362559.0,1299,5,1294,120701,229,120472,69480533.0,131217.0,69349316.0,0.5763,0.5756,0.573,0.5756
2023-04-04 16:30,91,27,64,7147,551,6596,4129533.0,320644.0,3808888.0,74,13,61,6928,377,6551,3997458.0,214160.0,3783298.0,0.5819,0.5775,0.5681,0.5775
2023-04-04 16:35,55,17,38,4125,216,3909,2390414.0,125020.0,2265394.0,43,7,36,3673,62,3611,2126848.0,35514.0,2091334.0,0.5788,0.5795,0.5728,0.5792
2023-04-04 16:40,56,23,33,4154,659,3495,2400851.0,379099.0,2021752.0,54,22,32,4382,993,3389,2528496.0,569212.0,1959283.0,0.5753,0.5785,0.5732,0.5781
2023-04-04 16:45,101,30,71,6153,585,5568,3546292.0,342073.0,3204218.0,88,18,70,6102,490,5612,3513856.0,280905.0,3232951.0,0.5847,0.5755,0.5733,0.5761
2023-04-04 16:50,399,18,381,41309,798,40511,23858672.0,455953.0,23402719.0,389,12,377,40944,525,40419,23644891.0,297863.0,23347028.0,0.5714,0.5777,0.5674,0.5776
2023-04-04 16:55,659,120,539,80663,9793,70870,59174733.0,18216609.0,40958123.0,633,102,531,81471,9642,71829,60190435.0,18630190.0,41560244.0,1.8602,0.5779,1.9322,0.5786
2023-04-04 17:00,771,171,600,74343,20754,53589,55408707.0,24491253.0,30917453.0,764,167,597,74505,21065,53440,55504660.0,24671946.0,30832714.0,1.1801,0.5769,1.1712,0.577
2023-04-04 17:05,909,113,796,72544,9839,62705,41708983.0,5630245.0,36078738.0,901,106,795,72305,9723,62582,41572078.0,5563053.0,36009025.0,0.5722,0.5754,0.5722,0.5754
2023-04-04 17:10,1437,140,1297,131549,14331,117218,75680750.0,8211717.0,67469032.0,1431,134,1297,131383,14303,117080,75582595.0,8193493.0,67389101.0,0.573,0.5756,0.5729,0.5756
2023-04-04 17:15,1135,283,852,86354,11930,74424,49681992.0,6838517.0,42843475.0,1125,277,848,86322,11906,74416,49664870.0,6824738.0,42840132.0,0.5732,0.5757,0.5732,0.5757
2023-04-04 17:20,1594,124,1470,130383,4840,125543,74995850.0,2774067.0,72221783.0,1586,119,1467,130074,4832,125242,74831703.0,2769029.0,72062674.0,0.5732,0.5753,0.5731,0.5754
2023-04-04 17:25,566,62,504,39594,2385,37209,22771666.0,1368518.0,21403148.0,555,53,502,39625,2343,37282,22787808.0,1342799.0,21445008.0,0.5738,0.5752,0.5731,0.5752
2023-04-04 17:30,43,17,26,3561,1155,2406,2051279.0,663876.0,1387403.0,38,12,26,3277,833,2444,1885985.0,477113.0,1408871.0,0.5748,0.5766,0.5728,0.5765
2023-04-04 17:35,1218,191,1027,129808,6090,123718,74790849.0,3487957.0,71302892.0,1211,188,1023,129435,6101,123334,74584620.0,3494211.0,71090408.0,0.5727,0.5763,0.5727,0.5764
2023-04-04 17:40,795,124,671,76911,3587,73324,44351031.0,2055382.0,42295649.0,790,119,671,77022,3579,73443,44415190.0,2050654.0,42364535.0,0.573,0.5768,0.573,0.5768
2023-04-04 17:45,873,43,830,81087,1436,79651,46801257.0,822535.0,45978722.0,865,38,827,81132,1431,79701,46826915.0,818689.0,46008225.0,0.5728,0.5773,0.5721,0.5773
2023-04-04 17:50,752,122,630,68177,9455,58722,52439573.0,18596806.0,33842767.0,739,113,626,66597,8323,58274,50947019.0,17366942.0,33580077.0,1.9669,0.5763,2.0866,0.5762
2023-04-04 17:55,974,691,283,137200,100341,36859,78769512.0,57534692.0,21234820.0,963,685,278,137745,100750,36995,79083877.0,57768887.0,21314990.0,0.5734,0.5761,0.5734,0.5762
2023-04-04 18:00,1298,626,672,167473,93134,74339,96222727.0,53401107.0,42821619.0,1289,622,667,167658,93245,74413,96330670.0,53464723.0,42865947.0,0.5734,0.576,0.5734,0.5761
2023-04-04 18:05,1190,710,480,130469,79252,51217,74950240.0,45446527.0,29503713.0,1180,707,473,129678,78816,50862,74499033.0,45197129.0,29301904.0,0.5734,0.5761,0.5735,0.5761
2023-04-04 18:10,575,264,311,40620,17160,23460,36420737.0,22928844.0,13491892.0,561,255,306,40659,17439,23220,36441162.0,23087213.0,13353949.0,1.3362,0.5751,1.3239,0.5751
2023-04-04 18:15,107,85,22,9744,7177,2567,5592676.0,4111449.0,1481226.0,105,84,21,9721,7150,2571,5579050.0,4095298.0,1483752.0,0.5729,0.577,0.5728,0.5771
2023-04-04 18:20,185,74,111,19277,5833,13444,24094697.0,16434216.0,7660481.0,165,66,99,17823,5399,12424,23344492.0,16186142.0,7158349.0,2.8175,0.5698,2.998,0.5762
2023-04-04 18:25,760,206,554,80404,21289,59115,46100679.0,12166766.0,33933913.0,743,195,548,80175,21460,58715,45988207.0,12268275.0,33719931.0,0.5715,0.574,0.5717,0.5743
2023-04-04 18:30,1641,1207,434,224978,158287,66691,141658700.0,103257868.0,38400832.0,1634,1204,430,224809,157876,66933,141556889.0,103020356.0,38536532.0,0.6523,0.5758,0.6525,0.5757
2023-04-04 18:35,2212,931,1281,292173,100459,191714,180476098.0,70463450.0,110012648.0,2199,924,1275,292695,100873,191822,180787262.0,70696367.0,110090895.0,0.7014,0.5738,0.7008,0.5739
2023-04-05 10:00,2918,638,2280,346400,68159,278241,228522672.0,68046974.0,160475698.0,2679,495,2184,329889,55444,274445,208376687.0,50167734.0,158208952.0,0.9984,0.5768,0.9048,0.5765
2023-04-05 10:05,1863,242,1621,182203,31676,150527,104524006.0,18001013.0,86522992.0,1818,215,1603,179771,29837,149934,103169359.0,16974821.0,86194538.0,0.5683,0.5748,0.5689,0.5749
2023-04-05 10:10,2329,369,1960,239397,42167,197230,149720653.0,36551631.0,113169022.0,2276,340,1936,237946,41783,196163,147597470.0,35034343.0,112563126.0,0.8668,0.5738,0.8385,0.5738
2023-04-05 10:15,1252,250,1002,106834,15461,91373,73645753.0,21386139.0,52259614.0,1159,196,963,104367,14358,90009,72284811.0,20760586.0,51524224.0,1.3832,0.5719,1.4459,0.5724
2023-04-05 10:20,2185,488,1697,220967,76419,144548,126035809.0,43386827.0,82648981.0,2151,465,1686,219224,74284,144940,125125250.0,42252435.0,82872814.0,0.5677,0.5718,0.5688,0.5718
2023-04-05 10:25,3069,817,2252,318016,95519,222497,207073210.0,79608397.0,127464813.0,3018,778,2240,316478,94811,221667,206185102.0,79197051.0,126988051.0,0.8334,0.5729,0.8353,0.5729
2023-04-05 10:30,4729,2029,2700,602272,353756,248516,394502905.0,251993448.0,142509457.0,4702,2016,2686,602667,353165,249502,394753857.0,251658743.0,143095114.0,0.7123,0.5734,0.7126,0.5735
2023-04-05 10:35,1827,1061,766,289256,203573,85683,165364354.0,116164690.0,49199664.0,1795,1038,757,288095,202714,85381,164666333.0,115640392.0,49025941.0,0.5706,0.5742,0.5705,0.5742
2023-04-05 10:40,1640,689,951,200269,107752,92517,127229339.0,74094951.0,53134388.0,1602,669,933,198730,107020,91710,126367957.0,73678714.0,52689243.0,0.6876,0.5743,0.6885,0.5745
2023-04-05 10:45,856,169,687,85186,21665,63521,48860891.0,12364489.0,36496402.0,833,158,675,85116,21440,63676,48824807.0,12235418.0,36589389.0,0.5707,0.5746,0.5707,0.5746
2023-04-05 10:50,442,175,267,34395,12983,21412,19733207.0,7428793.0,12304414.0,419,161,258,34280,13319,20961,19667809.0,7620106.0,12047703.0,0.5722,0.5747,0.5721,0.5748
2023-04-05 10:55,899,190,709,73604,9254,64350,42389241.0,5297288.0,37091953.0,865,170,695,72684,8938,63746,41866597.0,5111601.0,36754996.0,0.5724,0.5764,0.5719,0.5766
2023-04-05 11:00,1022,169,853,70040,5301,64739,52940083.0,15634217.0,37305866.0,1004,164,840,70115,5292,64823,52982454.0,15628287.0,37354167.0,2.9493,0.5763,2.9532,0.5762
2023-04-05 11:05,2549,369,2180,217601,35237,182364,125329604.0,20168176.0,105161428.0,2511,344,2167,216497,34576,181921,124696442.0,19777518.0,104918924.0,0.5724,0.5767,0.572,0.5767
2023-04-05 11:10,5089,2154,2935,643574,371508,272066,368801517.0,211997214.0,156804303.0,5073,2147,2926,642051,370436,271615,367910477.0,211392122.0,156518354.0,0.5706,0.5763,0.5707,0.5763
2023-04-05 11:15,3868,1123,2745,392896,161773,231123,225597420.0,92451396.0,133146024.0,3849,1113,2736,392284,161437,230847,225249186.0,92259905.0,132989281.0,0.5715,0.5761,0.5715,0.5761
2023-04-05 11:20,2497,200,2297,192403,18901,173502,123751372.0,23906821.0,99844551.0,2478,193,2285,191645,18330,173315,122816489.0,23077655.0,99738834.0,1.2648,0.5755,1.259,0.5755
2023-04-05 11:25,551,118,433,45926,6959,38967,39549311.0,17090669.0,22458642.0,527,107,420,44901,6674,38227,38959896.0,16926896.0,22033000.0,2.4559,0.5764,2.5362,0.5764
2023-04-05 11:30,884,329,555,65878,20382,45496,50977481.0,24788637.0,26188844.0,867,322,545,65749,21464,44285,50874177.0,25394921.0,25479255.0,1.2162,0.5756,1.1831,0.5753
2023-04-05 11:35,2006,1009,997,220521,135783,84738,139320929.0,90680426.0,48640502.0,1985,994,991,220234,135634,84600,139159973.0,90595812.0,48564160.0,0.6678,0.574,0.6679,0.574
2023-04-05 11:40,1320,619,701,136064,71327,64737,77932012.0,40745455.0,37186557.0,1301,605,696,135063,70553,64510,77357031.0,40303836.0,37053195.0,0.5712,0.5744,0.5713,0.5744
2023-04-05 11:45,1036,68,968,88591,6965,81626,64000934.0,17074548.0,46926385.0,1027,64,963,88405,7051,81354,63890031.0,17120239.0,46769792.0,2.4515,0.5749,2.4281,0.5749
2023-04-05 11:50,448,44,404,45110,6397,38713,25913079.0,3639503.0,22273576.0,433,35,398,43966,5371,38595,25265541.0,3056901.0,22208640.0,0.5689,0.5754,0.5691,0.5754
2023-04-05 11:55,1904,721,1183,248158,132229,115929,168894857.0,102140290.0,66754567.0,1876,704,1172,246334,130741,115593,167782753.0,101224453.0,66558300.0,0.7724,0.5758,0.7742,0.5758
2023-04-05 12:00,3266,1774,1492,452160,313712,138448,273330896.0,193370069.0,79960827.0,3239,1766,1473,450342,313471,136871,272293629.0,193234140.0,79059488.0,0.6164,0.5776,0.6164,0.5776
2023-04-05 12:05,1384,70,1314,140242,12502,127740,80820456.0,7169666.0,73650789.0,1375,66,1309,139821,12421,127400,80565712.0,7111538.0,73454173.0,0.5735,0.5766,0.5725,0.5766
2023-04-05 12:10,2728,299,2429,385943,45673,340270,222564662.0,26214380.0,196350282.0,2708,290,2418,385166,45400,339766,222117003.0,26058096.0,196058907.0,0.574,0.577,0.574,0.577
2023-04-05 12:15,3109,71,3038,460203,4341,455862,265297993.0,2490012.0,262807981.0,3101,69,3032,459327,4336,454991,264728046.0,2486404.0,262241642.0,0.5736,0.5765,0.5734,0.5764
2023-04-05 12:20,3265,384,2881,427818,28820,398998,246735243.0,16553951.0,230181291.0,3250,376,2874,426828,28712,398116,246136074.0,16485380.0,229650693.0,0.5744,0.5769,0.5742,0.5768
2023-04-05 12:25,2498,472,2026,304593,20883,283710,175781641.0,11994585.0,163787056.0,2489,468,2021,304263,20673,283590,175590557.0,11875609.0,163714948.0,0.5744,0.5773,0.5745,0.5773
2023-04-05 12:30,1972,88,1884,288097,11926,276171,166064177.0,6825737.0,159238439.0,1967,88,1879,288117,11985,276132,166086009.0,6859554.0,159226455.0,0.5723,0.5766,0.5723,0.5766
2023-04-05 12:35,3560,769,2791,449494,67109,382385,272281922.0,51690068.0,220591854.0,3543,753,2790,447415,65139,382276,271021938.0,50495248.0,220526689.0,0.7702,0.5769,0.7752,0.5769
2023-04-05 12:40,3692,3107,585,366736,277117,89619,237608901.0,185588037.0,52020864.0,3668,3092,576,366223,276022,90201,237319471.0,184947999.0,52371472.0,0.6697,0.5805,0.67,0.5806
2023-04-05 12:45,1886,1232,654,243693,197099,46594,153959508.0,126957513.0,27001994.0,1835,1206,629,240924,194952,45972,152270201.0,125628844.0,26641357.0,0.6441,0.5795,0.6444,0.5795
2023-04-05 12:50,995,712,283,87139,72800,14339,63336361.0,55058110.0,8278251.0,957,689,268,85512,72153,13359,62428755.0,54683065.0,7745690.0,0.7563,0.5773,0.7579,0.5798
2023-04-05 12:55,478,288,190,29780,19789,9991,17193366.0,11408498.0,5784867.0,453,274,179,29758,19699,10059,17182565.0,11355396.0,5827168.0,0.5765,0.579,0.5764,0.5793
2023-04-05 13:00,371,57,314,26405,7953,18452,15280966.0,4580115.0,10700850.0,346,49,297,25651,7908,17743,14838479.0,4555253.0,10283225.0,0.5759,0.5799,0.576,0.5796
2023-04-05 13:05,744,666,78,103086,98595,4491,72637361.0,70011120.0,2626241.0,706,652,54,100609,96770,3839,71147323.0,68906488.0,2240835.0,0.7101,0.5848,0.7121,0.5837
2023-04-05 13:10,705,525,180,49208,36127,13081,28473668.0,20854431.0,7619237.0,687,515,172,47893,35618,12275,27735275.0,20545984.0,7189291.0,0.5773,0.5825,0.5768,0.5857
2023-04-05 13:15,1771,1486,285,262983,244587,18396,258066502.0,247298023.0,10768479.0,1539,1374,165,248767,236994,11773,249411525.0,242524145.0,6887380.0,1.0111,0.5854,1.0233,0.585
2023-04-05 13:20,1102,655,447,85034,61874,23160,89055083.0,75483776.0,13571307.0,962,597,365,76440,55906,20534,83879187.0,71856293.0,12022894.0,1.22,0.586,1.2853,0.5855
2023-04-05 13:25,925,567,358,75653,57269,18384,57328162.0,46554207.0,10773954.0,807,529,278,68005,54731,13274,52815042.0,45021009.0,7794033.0,0.8129,0.5861,0.8226,0.5872
2023-04-05 13:30,2446,1628,818,296911,240298,56613,212954412.0,179776533.0,33177879.0,2331,1584,747,292117,239315,52802,210223026.0,179173325.0,31049701.0,0.7481,0.586,0.7487,0.588
2023-04-05 13:35,1086,910,176,137373,128383,8990,106456250.0,101221231.0,5235019.0,1017,878,139,133101,126561,6540,103992331.0,100150160.0,3842171.0,0.7884,0.5823,0.7913,0.5875
2023-04-05 13:40,457,190,267,27846,14131,13715,16285783.0,8254992.0,8030790.0,421,174,247,27452,13603,13849,16044361.0,7933042.0,8111319.0,0.5842,0.5855,0.5832,0.5857
2023-04-05 13:45,449,365,84,47300,44094,3206,27590932.0,25751798.0,1839133.0,416,350,66,45973,43444,2529,26856394.0,25370949.0,1485445.0,0.584,0.5737,0.584,0.5874
2023-04-05 13:50,381,123,258,23126,8836,14290,13519884.0,5165001.0,8354883.0,339,104,235,22070,8351,13719,12914986.0,4873867.0,8041119.0,0.5845,0.5847,0.5836,0.5861
2023-04-05 13:55,827,283,544,55995,25254,30741,32636217.0,14663065.0,17973152.0,769,255,514,54398,24336,30062,31729688.0,14115251.0,17614436.0,0.5806,0.5847,0.58,0.5859
2023-04-05 14:00,149,89,60,8219,5816,2403,17884790.0,16490860.0,1393930.0,108,74,34,7210,5556,1654,17310113.0,16336725.0,973388.0,2.8354,0.5801,2.9404,0.5885
2023-04-05 14:05,423,217,206,26670,14755,11915,15488733.0,8595013.0,6893720.0,379,200,179,24914,14172,10742,14539266.0,8255495.0,6283770.0,0.5825,0.5786,0.5825,0.585
2023-04-05 14:10,133,54,79,16740,5606,11134,9850487.0,3272826.0,6577661.0,100,41,59,14955,4848,10107,8795033.0,2811819.0,5983213.0,0.5838,0.5908,0.58,0.592
2023-04-05 14:15,563,258,305,42939,25031,17908,25038802.0,14567966.0,10470835.0,542,249,293,42856,25450,17406,24971256.0,14791571.0,10179684.0,0.582,0.5847,0.5812,0.5848
2023-04-05 14:20,188,34,154,9971,2168,7803,5823052.0,1256307.0,4566744.0,170,26,144,10594,1550,9044,6193073.0,898401.0,5294672.0,0.5795,0.5853,0.5796,0.5854
2023-04-05 14:25,403,280,123,28788,21666,7122,16821823.0,12671831.0,4149992.0,380,271,109,27492,20663,6829,16033994.0,12035276.0,3998718.0,0.5849,0.5827,0.5825,0.5855
2023-04-05 14:30,494,363,131,67657,60537,7120,65709833.0,61535766.0,4174067.0,458,349,109,66532,59786,6746,65029706.0,61073936.0,3955769.0,1.0165,0.5862,1.0215,0.5864
2023-04-05 14:35,1479,1299,180,164399,156993,7406,135440926.0,131099314.0,4341611.0,1417,1274,143,158651,153483,5168,132016621.0,128968632.0,3047988.0,0.8351,0.5862,0.8403,0.5898
2023-04-05 14:40,2127,1903,224,312535,295650,16885,209140677.0,199293896.0,9846781.0,2069,1878,191,309062,294460,14602,207099029.0,198510357.0,8588671.0,0.6741,0.5832,0.6742,0.5882
2023-04-05 14:45,1359,1127,232,154787,123762,31025,116850299.0,98593953.0,18256345.0,1318,1114,204,153402,123882,29520,116022777.0,98648166.0,17374611.0,0.7966,0.5884,0.7963,0.5886
2023-04-05 14:50,1550,961,589,158575,64679,93896,158561929.0,103342557.0,55219372.0,1502,942,560,155868,63726,92142,156985359.0,102781241.0,54204117.0,1.5978,0.5881,1.6129,0.5883
2023-04-05 14:55,3973,1166,2807,479119,93651,385468,281288878.0,54757467.0,226531411.0,3943,1155,2788,478630,93653,384977,280998055.0,54758261.0,226239794.0,0.5847,0.5877,0.5847,0.5877
2023-04-05 15:00,4296,1096,3200,499315,85035,414280,293235558.0,49718532.0,243517026.0,4271,1085,3186,498921,84894,414027,292990402.0,49617190.0,243373212.0,0.5847,0.5878,0.5845,0.5878
2023-04-05 15:05,3392,1033,2359,389732,71891,317841,228838182.0,42022233.0,186815948.0,3376,1027,2349,388802,71309,317493,228320499.0,41683452.0,186637047.0,0.5845,0.5878,0.5845,0.5878
2023-04-05 15:10,2580,614,1966,375087,53365,321722,271898834.0,83460013.0,188438820.0,2532,586,1946,370391,52088,318303,269407860.0,82721914.0,186685945.0,1.5639,0.5857,1.5881,0.5865
2023-04-05 15:15,3428,1812,1616,436521,245569,190952,267713332.0,156101181.0,111612150.0,3393,1791,1602,435717,244286,191431,267188931.0,155298321.0,111890610.0,0.6357,0.5845,0.6357,0.5845
2023-04-05 15:20,3087,1913,1174,316435,231545,84890,184388155.0,134768955.0,49619199.0,3070,1908,1162,316731,232177,84554,184537358.0,135114093.0,49423265.0,0.582,0.5845,0.5819,0.5845
2023-04-05 15:25,4379,3037,1342,685089,560267,124822,918797746.0,844051225.0,74746521.0,3507,2670,837,627016,526149,100867,883175164.0,822841109.0,60334054.0,1.5065,0.5988,1.5639,0.5982
2023-04-05 15:30,5298,2642,2656,727166,346390,380776,912321685.0,681524719.0,230796966.0,4217,2171,2046,655171,311844,343327,869015383.0,660014638.0,209000744.0,1.9675,0.6061,2.1165,0.6088
2023-04-05 15:35,2057,599,1458,219091,31335,187756,197306018.0,84209773.0,113096245.0,1686,376,1310,196553,20176,176377,184181291.0,77532475.0,106648816.0,2.6874,0.6024,3.8428,0.6047
2023-04-05 15:40,2146,1204,942,230673,113164,117509,164685689.0,93812184.0,70873505.0,1921,1073,848,224243,109718,114525,160757273.0,91641518.0,69115755.0,0.829,0.6031,0.8352,0.6035
2023-04-05 15:45,1870,775,1095,192663,92473,100190,155106688.0,94554328.0,60552360.0,1671,679,992,187834,90232,97602,152349697.0,93126013.0,59223683.0,1.0225,0.6044,1.0321,0.6068
2023-04-05 15:50,2524,895,1629,238204,46468,191736,350969409.0,237153623.0,113815786.0,2225,713,1512,224307,41730,182577,343145745.0,234264162.0,108881582.0,5.1036,0.5936,5.6138,0.5964
2023-04-05 15:55,1717,198,1519,231309,5842,225467,150479201.0,16551203.0,133927998.0,1578,107,1471,226713,4192,222521,147892886.0,15565255.0,132327630.0,2.8331,0.594,3.7131,0.5947
2023-04-05 16:00,1662,617,1045,197318,30983,166335,130326191.0,31479765.0,98846426.0,1549,546,1003,194413,27876,166537,128572159.0,29574029.0,98998130.0,1.016,0.5943,1.0609,0.5945
2023-04-05 16:05,1963,1380,583,179843,116328,63515,172510331.0,134595643.0,37914688.0,1848,1331,517,177276,115950,61326,170861629.0,134280808.0,36580820.0,1.157,0.5969,1.1581,0.5965
2023-04-05 16:10,1155,720,435,107127,55551,51576,89893363.0,59212789.0,30680573.0,1028,646,382,99213,51170,48043,85192434.0,56536724.0,28655709.0,1.0659,0.5949,1.1049,0.5965
2023-04-05 16:15,891,437,454,78845,33983,44862,47066592.0,20228028.0,26838563.0,811,411,400,77482,33576,43906,46249721.0,19968230.0,26281490.0,0.5952,0.5982,0.5947,0.5986
2023-04-05 16:20,386,120,266,29324,9135,20189,30409662.0,18507940.0,11901722.0,323,78,245,27600,8317,19283,29528526.0,18023456.0,11505070.0,2.026,0.5895,2.1671,0.5966
2023-04-05 16:25,667,132,535,47594,11569,36025,41411933.0,19958809.0,21453123.0,613,107,506,46930,10882,36048,41032006.0,19539319.0,21492686.0,1.7252,0.5955,1.7956,0.5962
2023-04-05 16:30,2044,1366,678,232536,180252,52284,177947788.0,146749184.0,31198604.0,1967,1332,635,229414,179319,50095,176096745.0,146140143.0,29956602.0,0.8141,0.5967,0.815,0.598
2023-04-05 16:35,1123,912,211,90633,79537,11096,53926179.0,47317748.0,6608431.0,1069,891,178,88641,78778,9863,52755583.0,46865346.0,5890236.0,0.5949,0.5956,0.5949,0.5972
2023-04-05 16:40,318,196,122,25352,17248,8104,15045379.0,10251420.0,4793958.0,268,169,99,23295,16278,7017,13864282.0,9673630.0,4190652.0,0.5944,0.5916,0.5943,0.5972
2023-04-05 16:45,2553,772,1781,373410,51380,322030,273897436.0,82821010.0,191076425.0,2477,733,1744,365803,49715,316088,269716298.0,81820359.0,187895939.0,1.6119,0.5933,1.6458,0.5944
2023-04-05 16:50,2447,1738,709,208216,110894,97322,149687768.0,91844197.0,57843571.0,2389,1714,675,206854,110071,96783,148856789.0,91326379.0,57530410.0,0.8282,0.5944,0.8297,0.5944
2023-04-05 16:55,815,93,722,105633,3838,101795,88895459.0,28468932.0,60426527.0,761,62,699,103445,2851,100594,87677796.0,27878599.0,59799196.0,7.4176,0.5936,9.7785,0.5945
2023-04-05 17:00,2148,1361,787,186872,73449,113423,110884181.0,43454758.0,67429422.0,2109,1343,766,183948,73278,110670,109009450.0,43311927.0,65697522.0,0.5916,0.5945,0.5911,0.5936
2023-04-05 17:05,1005,165,840,149840,11928,137912,88864074.0,7077890.0,81786184.0,974,149,825,149267,11827,137440,88503178.0,6976726.0,81526452.0,0.5934,0.593,0.5899,0.5932
2023-04-05 17:10,1501,226,1275,292382,15171,277211,186703267.0,22061763.0,164641504.0,1477,204,1273,291702,14259,277443,186295186.0,21520927.0,164774258.0,1.4542,0.5939,1.5093,0.5939
2023-04-05 17:15,1498,205,1293,266788,15015,251773,171915710.0,21972315.0,149943394.0,1468,194,1274,266023,14696,251327,171479576.0,21783568.0,149696008.0,1.4634,0.5955,1.4823,0.5956
2023-04-05 17:20,1273,126,1147,211839,55926,155913,122453635.0,29813062.0,92640572.0,1220,94,1126,197307,43225,154082,114735657.0,23175707.0,91559950.0,0.5331,0.5942,0.5362,0.5942
2023-04-05 17:25,1282,788,494,117651,61169,56482,69659757.0,36133309.0,33526448.0,1252,770,482,116436,60887,55549,68923560.0,35962073.0,32961487.0,0.5907,0.5936,0.5906,0.5934
2023-04-05 17:30,1109,602,507,107974,51803,56171,77110257.0,43713999.0,33396257.0,1091,593,498,107227,50957,56270,76684843.0,43211806.0,33473037.0,0.8439,0.5945,0.848,0.5949
2023-04-05 17:35,1775,573,1202,284808,47117,237691,182206662.0,41034234.0,141172428.0,1739,559,1180,281839,44997,236842,180374513.0,39696132.0,140678381.0,0.8709,0.5939,0.8822,0.594
2023-04-05 17:40,2118,555,1563,296216,52680,243536,201972536.0,57380382.0,144592154.0,2067,528,1539,294478,50633,243845,200894297.0,56118949.0,144775347.0,1.0892,0.5937,1.1083,0.5937
2023-04-05 17:45,960,695,265,82391,62077,20314,48886789.0,36773456.0,12113333.0,930,684,246,80973,62183,18790,48018253.0,36827816.0,11190437.0,0.5924,0.5963,0.5922,0.5956
2023-04-05 17:50,2112,1703,409,212558,192285,20273,138875247.0,126874478.0,12000768.0,2074,1690,384,212281,191503,20778,138800083.0,126405859.0,12394224.0,0.6598,0.592,0.6601,0.5965
2023-04-05 17:55,609,397,212,49435,37940,11495,42435929.0,35578034.0,6857895.0,577,383,194,46407,35669,10738,40619993.0,34221147.0,6398845.0,0.9377,0.5966,0.9594,0.5959
2023-04-05 18:00,305,28,277,17225,834,16391,10215054.0,516775.0,9698279.0,277,22,255,15577,440,15137,9283922.0,259966.0,9023956.0,0.6196,0.5917,0.5908,0.5962
2023-04-05 18:05,860,516,344,63617,41911,21706,37775204.0,24852967.0,12922237.0,856,516,340,62359,42302,20057,37024226.0,25079706.0,11944519.0,0.593,0.5953,0.5929,0.5955
2023-04-05 18:10,2439,2053,386,214812,186489,28323,140423414.0,123580938.0,16842476.0,2411,2042,369,213875,186031,27844,139886994.0,123310126.0,16576867.0,0.6627,0.5947,0.6628,0.5953
2023-04-05 18:15,928,450,478,89352,45804,43548,53006339.0,27118753.0,25887586.0,916,449,467,89948,46188,43760,53362601.0,27342290.0,26020311.0,0.5921,0.5945,0.592,0.5946
2023-04-05 18:20,2665,1792,873,278915,236336,42579,165382736.0,140063178.0,25319558.0,2645,1787,858,278819,235988,42831,165278953.0,139797519.0,25481433.0,0.5926,0.5946,0.5924,0.5949
2023-04-05 18:25,3605,2554,1051,474144,379974,94170,360496594.0,304161092.0,56335502.0,3530,2521,1009,470256,377055,93201,358121515.0,302369581.0,55751934.0,0.8005,0.5982,0.8019,0.5982
2023-04-05 18:30,4115,3522,593,641147,609987,31160,420182563.0,401596562.0,18586000.0,4064,3506,558,639631,609805,29826,419310151.0,401465977.0,17844174.0,0.6584,0.5965,0.6584,0.5983
2023-04-05 18:35,2993,1898,1095,403740,277242,126498,344803883.0,269357260.0,75446622.0,2939,1880,1059,402063,276468,125595,343879239.0,268875862.0,75003376.0,0.9716,0.5964,0.9725,0.5972
2023-04-06 10:00,5407,2458,2949,656354,377181,279173,416919115.0,249649057.0,167270057.0,5129,2297,2832,652735,379551,273184,408292434.0,244720768.0,163571666.0,0.6619,0.5992,0.6448,0.5988
2023-04-06 10:05,3903,2406,1497,510077,374784,135293,542005752.0,460226137.0,81779615.0,3350,2168,1182,480233,359843,120390,516746364.0,443986009.0,72760355.0,1.228,0.6045,1.2338,0.6044
2023-04-06 10:10,5537,4234,1303,704310,588737,115573,688390210.0,618097171.0,70293039.0,4978,4010,968,676937,575831,101106,671418773.0,609786815.0,61631958.0,1.0499,0.6082,1.059,0.6096
2023-04-06 10:15,2517,1189,1328,206415,132405,74010,217168777.0,172163141.0,45005636.0,2216,1052,1164,201005,130592,70413,213872633.0,170856224.0,43016409.0,1.3003,0.6081,1.3083,0.6109
2023-04-06 10:20,2111,1267,844,204323,150057,54266,150398991.0,117353469.0,33045521.0,1921,1207,714,194275,143993,50282,144255324.0,113576805.0,30678518.0,0.7821,0.609,0.7888,0.6101
2023-04-06 10:25,1562,1227,335,162975,141018,21957,99031545.0,85626649.0,13404896.0,1343,1164,179,156091,139179,16912,94806566.0,84457300.0,10349266.0,0.6072,0.6105,0.6068,0.6119
2023-04-06 10:30,2428,1524,904,257194,206016,51178,182504727.0,151438087.0,31066640.0,2124,1405,719,240853,198627,42226,172694780.0,146887689.0,25807091.0,0.7351,0.607,0.7395,0.6112
2023-04-06 10:35,3232,2463,769,411201,351427,59774,341117467.0,304864228.0,36253239.0,3116,2415,701,399490,348037,51453,334125012.0,302763427.0,31361584.0,0.8675,0.6065,0.8699,0.6095
2023-04-06 10:40,3104,2572,532,415047,383588,31459,304586471.0,285418864.0,19167606.0,2988,2527,461,409862,378899,30963,301161586.0,282275189.0,18886396.0,0.7441,0.6093,0.745,0.61
2023-04-06 10:45,2272,862,1410,135001,68113,66888,94753498.0,54397412.0,40356086.0,2157,807,1350,129750,67519,62231,91948540.0,54020986.0,37927554.0,0.7986,0.6033,0.8001,0.6095
2023-04-06 10:50,1770,1228,542,197952,152093,45859,120137277.0,92193900.0,27943376.0,1707,1198,509,196081,151290,44791,118973504.0,91692774.0,27280730.0,0.6062,0.6093,0.6061,0.6091
2023-04-06 10:55,2747,2361,386,361003,302773,58230,245886406.0,210356212.0,35530194.0,2671,2332,339,359034,302391,56643,244123076.0,209585861.0,34537215.0,0.6948,0.6102,0.6931,0.6097
2023-04-06 11:00,896,771,125,82710,65823,16887,50274371.0,39957712.0,10316659.0,819,738,81,78496,63725,14771,47692524.0,38684492.0,9008032.0,0.607,0.6109,0.6071,0.6098
2023-04-06 11:05,364,288,76,15347,11222,4125,9319740.0,6808112.0,2511628.0,320,271,49,14419,11171,3248,8745938.0,6762685.0,1983253.0,0.6067,0.6089,0.6054,0.6106
2023-04-06 11:10,1088,925,163,110475,92964,17511,66987428.0,56325319.0,10662108.0,1050,908,142,110378,93434,16944,66936330.0,56608448.0,10327882.0,0.6059,0.6089,0.6059,0.6095
2023-04-06 11:15,439,360,79,36348,29868,6480,22031598.0,18105713.0,3925884.0,387,337,50,34692,28946,5746,21051301.0,17546074.0,3505226.0,0.6062,0.6058,0.6062,0.61
2023-04-06 11:20,4815,4536,279,874303,849614,24689,541433710.0,526498649.0,14935061.0,4753,4509,244,870676,848624,22052,539322394.0,525901730.0,13420663.0,0.6197,0.6049,0.6197,0.6086
2023-04-06 11:25,3592,2650,942,547779,485384,62395,356849282.0,319055266.0,37794016.0,3504,2595,909,545195,484110,61085,355350827.0,318278347.0,37072480.0,0.6573,0.6057,0.6575,0.6069
2023-04-06 11:30,1041,494,547,85163,47401,37762,51510546.0,28654857.0,22855688.0,994,473,521,83109,46532,36577,50317586.0,28129311.0,22188275.0,0.6045,0.6053,0.6045,0.6066
2023-04-06 11:35,5504,5119,385,1000318,974779,25539,615602051.0,600145408.0,15456643.0,5440,5080,360,998288,973633,24655,614372678.0,599438418.0,14934259.0,0.6157,0.6052,0.6157,0.6057
2023-04-06 11:40,2287,2068,219,341034,324847,16187,218709533.0,208894150.0,9815383.0,2237,2038,199,340209,324009,16200,218188751.0,208364454.0,9824297.0,0.6431,0.6064,0.6431,0.6064
2023-04-06 11:45,461,122,339,34109,9144,24965,20687319.0,5540049.0,15147270.0,415,92,323,31424,6800,24624,19041805.0,4099584.0,14942220.0,0.6059,0.6067,0.6029,0.6068
2023-04-06 11:50,137,72,65,11353,5176,6177,6859246.0,3124024.0,3735222.0,109,61,48,9330,3635,5695,5651653.0,2187966.0,3463686.0,0.6036,0.6047,0.6019,0.6082
2023-04-06 11:55,525,308,217,38210,22307,15903,23136911.0,13474747.0,9662163.0,489,293,196,35785,20688,15097,21677680.0,12505272.0,9172407.0,0.6041,0.6076,0.6045,0.6076
2023-04-06 12:00,425,199,226,29433,11932,17501,17856200.0,7222031.0,10634168.0,395,188,207,28425,11489,16936,17243157.0,6949209.0,10293948.0,0.6053,0.6076,0.6049,0.6078
2023-04-06 12:05,381,262,119,24259,15765,8494,14746798.0,9590465.0,5156333.0,354,251,103,23822,15715,8107,14457393.0,9526363.0,4931029.0,0.6083,0.6071,0.6062,0.6082
2023-04-06 12:10,865,480,385,103693,73857,29836,76021301.0,57826335.0,18194965.0,824,465,359,103162,75291,27871,75647756.0,58693511.0,16954245.0,0.7829,0.6098,0.7796,0.6083
2023-04-06 12:15,246,192,54,19516,16265,3251,24889159.0,22912052.0,1977107.0,225,185,40,18000,15736,2264,23973208.0,22594392.0,1378816.0,1.4087,0.6082,1.4358,0.609
2023-04-06 12:20,404,241,163,30995,21027,9968,18641393.0,12627042.0,6014351.0,372,230,142,28913,19979,8934,17476633.0,12057545.0,5419087.0,0.6005,0.6034,0.6035,0.6066
2023-04-06 12:25,332,183,149,20144,12922,7222,12187654.0,7806541.0,4381113.0,315,174,141,19558,12431,7127,11834512.0,7510786.0,4323726.0,0.6041,0.6066,0.6042,0.6067
2023-04-06 12:30,109,74,35,5639,3288,2351,3491279.0,1994343.0,1496936.0,79,57,22,5517,3342,2175,3402666.0,2019097.0,1383569.0,0.6066,0.6367,0.6042,0.6361
2023-04-06 12:35,162,122,40,12482,10340,2142,7554577.0,6252175.0,1302401.0,143,116,27,12256,10261,1995,7415713.0,6203629.0,1212084.0,0.6047,0.608,0.6046,0.6076
2023-04-06 12:40,410,277,133,33558,24523,9035,20300373.0,14806936.0,5493437.0,396,270,126,32657,23900,8757,19748555.0,14431744.0,5316810.0,0.6038,0.608,0.6038,0.6071
2023-04-06 12:45,479,223,256,30382,13241,17141,18365739.0,8020120.0,10345619.0,449,207,242,29725,12933,16792,18012500.0,7818044.0,10194456.0,0.6057,0.6036,0.6045,0.6071
2023-04-06 12:50,304,266,38,18717,15519,3198,11338961.0,9396934.0,1942026.0,275,251,24,16830,14781,2049,10194373.0,8949088.0,1245284.0,0.6055,0.6073,0.6054,0.6078
2023-04-06 12:55,102,62,40,7840,5799,2041,17829864.0,16590841.0,1239022.0,77,51,26,7618,6063,1555,17702451.0,16755797.0,946654.0,2.861,0.6071,2.7636,0.6088
2023-04-06 13:00,141,112,29,16379,15342,1037,9882100.0,9253931.0,628168.0,120,104,16,16519,15289,1230,9963457.0,9216186.0,747271.0,0.6032,0.6058,0.6028,0.6075
2023-04-06 13:05,211,67,144,19770,9537,10233,11896810.0,5722670.0,6174140.0,194,59,135,17363,7859,9504,10506182.0,4745741.0,5760441.0,0.6,0.6034,0.6039,0.6061
2023-04-06 13:10,250,215,35,37075,35614,1461,22357695.0,21468271.0,889424.0,233,207,26,37496,36054,1442,22610893.0,21727602.0,883291.0,0.6028,0.6088,0.6026,0.6125
2023-04-06 13:15,465,274,191,31458,18924,12534,19040095.0,11439525.0,7600569.0,454,270,184,31366,19175,12191,18970736.0,11583829.0,7386907.0,0.6045,0.6064,0.6041,0.6059
2023-04-06 13:20,252,168,84,18280,11990,6290,11056708.0,7243256.0,3813452.0,235,156,79,17773,11593,6180,10753553.0,7005759.0,3747793.0,0.6041,0.6063,0.6043,0.6064
2023-04-06 13:25,685,118,567,56007,13069,42938,33883117.0,7887503.0,25995613.0,657,103,554,53847,12006,41841,32575142.0,7242744.0,25332398.0,0.6035,0.6054,0.6033,0.6054
2023-04-06 13:30,509,171,338,35948,13030,22918,21733684.0,7864993.0,13868691.0,486,159,327,34490,12725,21765,20856837.0,7681626.0,13175211.0,0.6036,0.6051,0.6037,0.6053
2023-04-06 13:35,377,115,262,29563,8700,20863,30939995.0,18337160.0,12602835.0,339,95,244,24731,7489,17242,28026992.0,17603816.0,10423175.0,2.1077,0.6041,2.3506,0.6045
2023-04-06 13:40,122,84,38,6728,4815,1913,4055161.0,2899906.0,1155254.0,95,67,28,7662,4139,3523,4610165.0,2480294.0,2129870.0,0.6023,0.6039,0.5992,0.6046
2023-04-06 13:45,174,93,81,12917,6147,6770,20771813.0,16783410.0,3988403.0,142,80,62,10780,4889,5891,19639998.0,16035990.0,3604008.0,2.7303,0.5891,3.28,0.6118
2023-04-06 13:50,200,84,116,16459,6056,10403,22901459.0,16722179.0,6179280.0,178,69,109,16830,5733,11097,23241419.0,16527593.0,6713826.0,2.7613,0.594,2.8829,0.605
2023-04-06 13:55,928,639,289,100499,74674,25825,99849334.0,84250413.0,15598921.0,895,618,277,98437,73380,25057,98518563.0,83381522.0,15137041.0,1.1282,0.604,1.1363,0.6041
2023-04-06 14:00,1755,1498,257,253243,225656,27587,152323655.0,135649207.0,16674447.0,1738,1493,245,252425,224962,27463,151838419.0,135238972.0,16599447.0,0.6011,0.6044,0.6012,0.6044
2023-04-06 14:05,443,179,264,24976,5219,19757,15049823.0,3131300.0,11918522.0,390,142,248,23527,5215,18312,14176276.0,3119103.0,11057173.0,0.6,0.6033,0.5981,0.6038
2023-04-06 14:10,360,321,39,9450,6345,3105,5697463.0,3821023.0,1876439.0,351,312,39,9316,6074,3242,5620248.0,3658145.0,1962102.0,0.6022,0.6043,0.6023,0.6052
2023-04-06 14:15,160,142,18,9737,8306,1431,5851145.0,4985342.0,865803.0,139,128,11,7822,6309,1513,4710719.0,3794884.0,915835.0,0.6002,0.605,0.6015,0.6053
2023-04-06 14:20,117,89,28,10335,7433,2902,5866434.0,4111589.0,1754845.0,107,82,25,6003,3390,2613,3620139.0,2040890.0,1579249.0,0.5532,0.6047,0.602,0.6044
2023-04-06 14:25,533,166,367,42669,10041,32628,25762421.0,6047660.0,19714761.0,517,162,355,42488,9079,33409,25645664.0,5457384.0,20188280.0,0.6023,0.6042,0.6011,0.6043
2023-04-06 14:30,904,275,629,102312,33256,69056,61792644.0,20054575.0,41738069.0,885,272,613,101967,33158,68809,61581104.0,19982279.0,41598824.0,0.603,0.6044,0.6026,0.6046
2023-04-06 14:35,806,151,655,48740,9930,38810,29418693.0,5979865.0,23438827.0,791,145,646,48366,9444,38922,29194579.0,5687399.0,23507180.0,0.6022,0.6039,0.6022,0.604
2023-04-06 14:40,673,212,461,44910,11373,33537,27126488.0,6851939.0,20274549.0,659,206,453,44617,11366,33251,26948880.0,6847354.0,20101525.0,0.6025,0.6045,0.6024,0.6045
2023-04-06 14:45,898,340,558,70920,25764,45156,42722327.0,15479367.0,27242959.0,877,332,545,71217,25678,45539,42936316.0,15425099.0,27511217.0,0.6008,0.6033,0.6007,0.6041
2023-04-06 14:50,923,263,660,62674,13400,49274,50800053.0,21129993.0,29670060.0,901,251,650,61026,13209,47817,49846142.0,21024317.0,28821825.0,1.5769,0.6021,1.5917,0.6028
2023-04-06 14:55,1183,700,483,123013,85108,37905,87097258.0,64251437.0,22845820.0,1148,677,471,121536,83834,37702,86151692.0,63423464.0,22728228.0,0.7549,0.6027,0.7565,0.6028
2023-04-06 15:00,575,295,280,34921,17664,17257,34090110.0,23697994.0,10392116.0,554,284,270,32936,17285,15651,32900560.0,23473311.0,9427249.0,1.3416,0.6022,1.358,0.6023
2023-04-06 15:05,436,114,322,29793,5776,24017,17885324.0,3457679.0,14427645.0,404,98,306,27971,5731,22240,16801525.0,3423829.0,13377696.0,0.5986,0.6007,0.5974,0.6015
2023-04-06 15:10,86,44,42,4851,2652,2199,2889985.0,1580009.0,1309976.0,69,40,29,4712,2181,2531,2826216.0,1298907.0,1527309.0,0.5958,0.5957,0.5956,0.6034
2023-04-06 15:15,306,32,274,20491,2289,18202,12312335.0,1373578.0,10938756.0,295,27,268,19175,1185,17990,11525140.0,707390.0,10817750.0,0.6001,0.601,0.597,0.6013
2023-04-06 15:20,686,374,312,69313,44426,24887,41678184.0,26711929.0,14966254.0,655,360,295,68061,43573,24488,40886736.0,26149034.0,14737701.0,0.6013,0.6014,0.6001,0.6018
2023-04-06 15:25,333,65,268,20015,2570,17445,12012773.0,1532450.0,10480322.0,316,58,258,19030,1733,17297,11441729.0,1035681.0,10406047.0,0.5963,0.6008,0.5976,0.6016
2023-04-06 15:30,154,78,76,7408,2629,4779,4457054.0,1578871.0,2878182.0,156,77,79,7751,1907,5844,4661213.0,1141566.0,3519647.0,0.6006,0.6023,0.5986,0.6023
2023-04-06 15:35,434,94,340,29295,6490,22805,17588805.0,3866140.0,13722664.0,423,89,334,29188,6456,22732,17526649.0,3845584.0,13681065.0,0.5957,0.6017,0.5957,0.6018
2023-04-06 15:40,279,94,185,19235,4346,14889,11554191.0,2595553.0,8958638.0,265,89,176,18877,4238,14639,11337539.0,2521360.0,8816179.0,0.5972,0.6017,0.5949,0.6022
2023-04-06 15:45,694,206,488,47594,9974,37620,28649083.0,5989771.0,22659312.0,684,203,481,47277,10173,37104,28449854.0,6104761.0,22345093.0,0.6005,0.6023,0.6001,0.6022
2023-04-06 15:50,263,54,209,18151,1685,16466,10938447.0,1010203.0,9928244.0,246,50,196,17213,1445,15768,10359227.0,865921.0,9493305.0,0.5995,0.603,0.5993,0.6021
2023-04-06 15:55,58,23,35,6227,3257,2970,3737476.0,1946199.0,1791276.0,50,23,27,6664,3762,2902,4000599.0,2242875.0,1757724.0,0.5975,0.6031,0.5962,0.6057
2023-04-06 16:00,412,194,218,35370,16435,18935,21171964.0,9809617.0,11362347.0,400,195,205,34444,17450,16994,20630879.0,10404004.0,10226875.0,0.5969,0.6001,0.5962,0.6018
2023-04-06 16:05,807,347,460,78485,24382,54103,47113351.0,14592081.0,32521270.0,780,332,448,77156,23829,53327,46347448.0,14262225.0,32085223.0,0.5985,0.6011,0.5985,0.6017
2023-04-06 16:10,754,303,451,69468,22492,46976,54640655.0,26517613.0,28123041.0,714,287,427,67617,22226,45391,53599241.0,26357123.0,27242118.0,1.179,0.5987,1.1859,0.6002
2023-04-06 16:15,805,442,363,56036,25277,30759,33568213.0,15079687.0,18488525.0,771,421,350,56278,25371,30907,33684601.0,15127339.0,18557262.0,0.5966,0.6011,0.5962,0.6004
2023-04-06 16:20,511,163,348,39317,10842,28475,36575390.0,19529333.0,17046056.0,464,131,333,35811,9682,26129,34499229.0,18837880.0,15661349.0,1.8013,0.5986,1.9457,0.5994
2023-04-06 16:25,994,769,225,110548,87448,23100,92194080.0,78348532.0,13845547.0,921,727,194,105991,84487,21504,89472501.0,76584041.0,12888460.0,0.8959,0.5994,0.9065,0.5994
2023-04-06 16:30,705,643,62,135365,128625,6740,80726910.0,76713876.0,4013034.0,689,635,54,134352,128234,6118,80140505.0,76466436.0,3674068.0,0.5964,0.5954,0.5963,0.6005
2023-04-06 16:35,678,246,432,79423,50036,29387,47310496.0,29690824.0,17619671.0,668,238,430,80751,50784,29967,48088482.0,30119600.0,17968881.0,0.5934,0.5996,0.5931,0.5996
2023-04-06 16:40,920,714,206,195862,180815,15047,116545635.0,107513208.0,9032427.0,908,707,201,195600,180697,14903,116385529.0,107442114.0,8943415.0,0.5946,0.6003,0.5946,0.6001
2023-04-06 16:45,1378,1343,35,278479,276838,1641,165585487.0,164608770.0,976717.0,1371,1339,32,278289,276733,1556,165483297.0,164550145.0,933152.0,0.5946,0.5952,0.5946,0.5997
2023-04-06 16:50,1555,926,629,186747,144932,41815,126144775.0,99864226.0,26280548.0,1533,912,621,186247,144475,41772,125305518.0,99079520.0,26225998.0,0.689,0.6285,0.6858,0.6278
2023-04-06 16:55,977,349,628,102017,54184,47833,60953867.0,32331793.0,28622074.0,964,340,624,102242,54427,47815,61088613.0,32476300.0,28612312.0,0.5967,0.5984,0.5967,0.5984
2023-04-06 17:00,2890,1198,1692,319014,210105,108909,190506805.0,125306028.0,65200777.0,2888,1201,1687,318745,210034,108711,190340162.0,125256570.0,65083591.0,0.5964,0.5987,0.5964,0.5987
2023-04-06 17:05,1289,482,807,132322,79569,52753,79039578.0,47463486.0,31576092.0,1270,473,797,131653,79400,52253,78640919.0,47356052.0,31284867.0,0.5965,0.5986,0.5964,0.5987
2023-04-06 17:10,420,138,282,36537,17605,18932,21793771.0,10474326.0,11319445.0,407,133,274,36147,17266,18881,21560634.0,10269457.0,11291176.0,0.595,0.5979,0.5948,0.598
2023-04-06 17:15,634,409,225,97789,80192,17597,58339849.0,47813417.0,10526432.0,634,411,223,98299,81092,17207,58633461.0,48338157.0,10295303.0,0.5962,0.5982,0.5961,0.5983
2023-04-06 17:20,434,246,188,35351,21514,13837,21004546.0,12790644.0,8213902.0,408,230,178,33790,20416,13374,20101876.0,12102844.0,7999031.0,0.5945,0.5936,0.5928,0.5981
2023-04-06 17:25,233,133,100,18901,11693,7208,11249082.0,6939708.0,4309374.0,223,125,98,19430,12000,7430,11562275.0,7118859.0,4443415.0,0.5935,0.5979,0.5932,0.598
2023-04-06 17:30,386,95,291,30432,10553,19879,18131748.0,6258141.0,11873607.0,372,85,287,30245,10156,20089,18025100.0,6025014.0,12000086.0,0.593,0.5973,0.5932,0.5973
2023-04-06 17:35,417,82,335,32791,4132,28659,33093408.0,16045789.0,17047619.0,371,51,320,30216,2341,27875,31674045.0,14994283.0,16679762.0,3.8833,0.5948,6.4051,0.5984
2023-04-06 17:40,708,76,632,51323,3503,47820,30602990.0,2075799.0,28527190.0,677,58,619,50459,3249,47210,30092117.0,1923661.0,28168456.0,0.5926,0.5966,0.5921,0.5967
2023-04-06 17:45,294,69,225,22348,2044,20304,13342126.0,1219800.0,12122326.0,266,61,205,23025,3271,19754,13722389.0,1926985.0,11795403.0,0.5968,0.597,0.5891,0.5971
2023-04-06 17:50,1558,1202,356,209516,176581,32935,124745318.0,105071247.0,19674071.0,1533,1187,346,208868,175781,33087,124363029.0,104587641.0,19775388.0,0.595,0.5974,0.595,0.5977
2023-04-06 17:55,1698,435,1263,219423,23973,195450,144575356.0,27857066.0,116718289.0,1667,421,1246,217326,23386,193940,143428459.0,27508485.0,115919974.0,1.162,0.5972,1.1763,0.5977
2023-04-06 18:00,1556,301,1255,193779,34272,159507,129288447.0,34035130.0,95253317.0,1526,287,1239,191604,32566,159038,127928591.0,32949394.0,94979197.0,0.9931,0.5972,1.0118,0.5972
2023-04-06 18:05,1952,1309,643,271024,209555,61469,175199157.0,138412466.0,36786691.0,1940,1302,638,270508,209301,61207,174897093.0,138261040.0,36636052.0,0.6605,0.5985,0.6606,0.5986
2023-04-06 18:10,2011,963,1048,216855,123775,93080,129314878.0,73595154.0,55719724.0,2000,954,1046,216785,123612,93173,129281228.0,73498779.0,55782448.0,0.5946,0.5986,0.5946,0.5987
2023-04-06 18:15,2057,1214,843,278570,195643,82927,179646717.0,130020313.0,49626404.0,2040,1207,833,278176,195664,82512,179416704.0,130030415.0,49386288.0,0.6646,0.5984,0.6646,0.5985
2023-04-06 18:20,1589,843,746,201755,124750,77005,297597616.0,251492706.0,46104910.0,1534,821,713,196142,120103,76039,293884945.0,248355261.0,45529683.0,2.016,0.5987,2.0679,0.5988
2023-04-06 18:25,2952,2467,485,307184,272684,34500,350431616.0,329534540.0,20897076.0,2058,1806,252,267916,245782,22134,325802520.0,312346010.0,13456510.0,1.2085,0.6057,1.2708,0.608
2023-04-06 18:30,2362,1697,665,256270,211110,45160,265213015.0,237873127.0,27339888.0,1923,1456,467,239017,202779,36238,254885333.0,232663640.0,22221692.0,1.1268,0.6054,1.1474,0.6132
2023-04-06 18:35,2526,1605,921,259845,174212,85633,226951708.0,174496800.0,52454908.0,2250,1451,799,248371,165795,82576,219904313.0,169234783.0,50669529.0,1.0016,0.6126,1.0207,0.6136
2023-04-07 10:00,5049,3883,1166,571267,497705,73562,429617707.0,384060747.0,45556959.0,3908,3341,567,512385,469563,42822,385082452.0,358270140.0,26812312.0,0.7717,0.6193,0.763,0.6261
2023-04-07 10:05,2649,1278,1371,202989,87806,115183,127581745.0,55350542.0,72231202.0,2028,985,1043,174629,72149,102480,109599775.0,45070848.0,64528927.0,0.6304,0.6271,0.6247,0.6297
2023-04-07 10:10,1129,546,583,79078,39333,39745,62047824.0,37297918.0,24749906.0,862,458,404,60974,29000,31974,45335479.0,25260695.0,20074784.0,0.9483,0.6227,0.8711,0.6278
2023-04-07 10:15,1414,881,533,95678,48740,46938,85850065.0,56610145.0,29239920.0,1172,746,426,79273,39902,39371,75685684.0,51041839.0,24643845.0,1.1615,0.6229,1.2792,0.6259
2023-04-07 10:20,456,277,179,32013,21181,10832,20068984.0,13253905.0,6815079.0,306,196,110,20908,14806,6102,13047348.0,9216660.0,3830687.0,0.6257,0.6292,0.6225,0.6278
2023-04-07 10:25,1501,508,993,160981,40922,120059,113642178.0,38608433.0,75033744.0,1354,452,902,161200,42291,118909,113987415.0,39471518.0,74515897.0,0.9435,0.625,0.9333,0.6267
2023-04-07 10:30,692,279,413,42615,15164,27451,26633014.0,9472976.0,17160038.0,556,216,340,40533,14600,25933,25372821.0,9090354.0,16282466.0,0.6247,0.6251,0.6226,0.6279
2023-04-07 10:35,2840,514,2326,388886,25030,363856,372412317.0,146522005.0,225890312.0,2613,384,2229,385012,26919,358093,370024052.0,147247983.0,222776069.0,5.8539,0.6208,5.47,0.6221
2023-04-07 10:40,3969,1632,2337,498282,113552,384730,323071104.0,83625147.0,239445956.0,3805,1542,2263,493821,110659,383162,320122340.0,81638578.0,238483762.0,0.7364,0.6224,0.7377,0.6224
2023-04-07 10:45,2498,1391,1107,319753,100645,219108,225369710.0,88713961.0,136655748.0,2397,1343,1054,316967,98478,218489,223573114.0,87312440.0,136260673.0,0.8815,0.6237,0.8866,0.6237
2023-04-07 10:50,2376,2104,272,218492,199666,18826,162109516.0,150338432.0,11771084.0,2282,2061,221,216510,199450,17060,160804941.0,150129405.0,10675536.0,0.7529,0.6253,0.7527,0.6258
2023-04-07 10:55,2452,723,1729,241287,60016,181271,175952353.0,63411615.0,112540737.0,2278,600,1678,234415,58475,175940,171872817.0,62435326.0,109437491.0,1.0566,0.6208,1.0677,0.622
2023-04-07 11:00,1014,322,692,68953,18473,50480,42811183.0,11422283.0,31388899.0,914,254,660,66427,17027,49400,41242010.0,10507065.0,30734945.0,0.6183,0.6218,0.6171,0.6222
2023-04-07 11:05,393,118,275,34783,4236,30547,34710433.0,15756260.0,18954173.0,310,63,247,31115,2095,29020,32471252.0,14390352.0,18080899.0,3.7196,0.6205,6.8689,0.623
2023-04-07 11:10,784,412,372,57901,23851,34050,36112450.0,14902443.0,21210006.0,716,377,339,54164,20643,33521,33699322.0,12813903.0,20885418.0,0.6248,0.6229,0.6207,0.6231
2023-04-07 11:15,230,153,77,14648,7858,6790,9228015.0,4888509.0,4339506.0,200,151,49,12909,8019,4890,8043329.0,4978918.0,3064411.0,0.6221,0.6391,0.6209,0.6267
2023-04-07 11:20,934,684,250,74694,57653,17041,85707994.0,75103722.0,10604272.0,881,650,231,75355,58224,17131,86145506.0,75459550.0,10685955.0,1.3027,0.6223,1.296,0.6238
2023-04-07 11:25,154,93,61,11410,6180,5230,7112248.0,3848579.0,3263668.0,108,66,42,7977,4086,3891,4971270.0,2542380.0,2428890.0,0.6227,0.624,0.6222,0.6242
2023-04-07 11:30,115,44,71,7127,1840,5287,4344264.0,1148770.0,3195493.0,89,34,55,4830,1713,3117,3009985.0,1062148.0,1947837.0,0.6243,0.6044,0.6201,0.6249
2023-04-07 11:35,235,140,95,19141,9969,9172,11924827.0,6218192.0,5706635.0,220,148,72,15991,9076,6915,9951631.0,5638532.0,4313099.0,0.6238,0.6222,0.6213,0.6237
2023-04-07 11:40,484,268,216,33888,20979,12909,34176400.0,26135164.0,8041235.0,437,242,195,29592,17227,12365,31492402.0,23795303.0,7697099.0,1.2458,0.6229,1.3813,0.6225
2023-04-07 11:45,177,129,48,14179,10550,3629,21916142.0,19649412.0,2266730.0,145,112,33,12807,9656,3151,21053560.0,19086365.0,1967195.0,1.8625,0.6246,1.9766,0.6243
2023-04-07 11:50,204,99,105,13173,5513,7660,8192301.0,3422059.0,4770242.0,159,77,82,11990,4808,7182,7489598.0,2980662.0,4508936.0,0.6207,0.6227,0.6199,0.6278
2023-04-07 11:55,633,343,290,41028,24811,16217,25540089.0,15423495.0,10116593.0,599,332,267,40110,24561,15549,24966228.0,15264428.0,9701799.0,0.6216,0.6238,0.6215,0.624
2023-04-07 12:00,2041,600,1441,234115,51911,182204,171898121.0,58448865.0,113449255.0,2001,576,1425,232242,51312,180930,170801062.0,58073914.0,112727148.0,1.1259,0.6226,1.1318,0.623
2023-04-07 12:05,99,60,39,7566,3730,3836,4714822.0,2320798.0,2394024.0,81,48,33,7285,3510,3775,4534894.0,2179202.0,2355691.0,0.6222,0.6241,0.6209,0.624
2023-04-07 12:10,704,550,154,74629,63965,10664,46438528.0,39796568.0,6641960.0,654,527,127,72099,62342,9757,44838867.0,38739976.0,6098891.0,0.6222,0.6228,0.6214,0.6251
2023-04-07 12:15,1123,653,470,117600,79087,38513,73163301.0,49161711.0,24001590.0,1077,631,446,116023,78774,37249,72143391.0,48906067.0,23237324.0,0.6216,0.6232,0.6208,0.6238
2023-04-07 12:20,876,445,431,81039,53332,27707,50420985.0,33143700.0,17277284.0,848,429,419,80373,53114,27259,50008645.0,33006724.0,17001920.0,0.6215,0.6236,0.6214,0.6237
2023-04-07 12:25,5194,2336,2858,648422,332869,315553,925333107.0,731981997.0,193351110.0,4264,1787,2477,552923,287625,265298,861927073.0,698652011.0,163275061.0,2.199,0.6127,2.429,0.6154
2023-04-07 12:30,1530,451,1079,139273,30407,108866,124395766.0,58085782.0,66309984.0,1252,289,963,125738,23207,102531,115981016.0,53345117.0,62635898.0,1.9103,0.6091,2.2987,0.6109
2023-04-07 12:35,1297,669,628,95478,46244,49234,84537678.0,54467106.0,30070571.0,1177,604,573,90463,43745,46718,81392832.0,52803129.0,28589703.0,1.1778,0.6108,1.2071,0.612
2023-04-07 12:40,1559,595,964,227858,42335,185523,171736352.0,58855111.0,112881240.0,1433,528,905,222984,40663,182321,167957280.0,56800279.0,111157001.0,1.3902,0.6084,1.3969,0.6097
2023-04-07 12:45,536,286,250,40807,17751,23056,24784337.0,10784612.0,13999725.0,492,250,242,36783,15752,21031,22405816.0,9562260.0,12843556.0,0.6075,0.6072,0.6071,0.6107
2023-04-07 12:50,819,270,549,80436,18447,61989,62069423.0,24299683.0,37769740.0,746,226,520,76937,15883,61054,59947015.0,22727341.0,37219674.0,1.3173,0.6093,1.4309,0.6096
2023-04-07 12:55,675,330,345,40987,17259,23728,38068748.0,23645023.0,14423725.0,575,285,290,37923,15942,21981,36224751.0,22785346.0,13439405.0,1.37,0.6079,1.4293,0.6114
2023-04-07 13:00,316,172,144,21639,8864,12775,13239973.0,5429597.0,7810376.0,236,137,99,19987,8334,11653,12179407.0,5048517.0,7130890.0,0.6125,0.6114,0.6058,0.6119
2023-04-07 13:05,407,213,194,26494,9901,16593,29334581.0,19135586.0,10198994.0,359,178,181,26396,9013,17383,29272602.0,18587504.0,10685097.0,1.9327,0.6147,2.0623,0.6147
2023-04-07 13:10,1430,308,1122,143494,15782,127712,100570708.0,22673508.0,77897200.0,1370,272,1098,141520,15585,125935,99490890.0,22561851.0,76929038.0,1.4367,0.6099,1.4477,0.6109
2023-04-07 13:15,1206,168,1038,150712,6223,144489,92211341.0,3788891.0,88422449.0,1187,152,1035,148588,5712,142876,90908493.0,3474856.0,87433637.0,0.6089,0.612,0.6083,0.612
2023-04-07 13:20,437,243,194,20125,8626,11499,12267579.0,5252212.0,7015367.0,394,223,171,20035,8015,12020,12215707.0,4874564.0,7341142.0,0.6089,0.6101,0.6082,0.6107
2023-04-07 13:25,973,309,664,97989,17756,80233,124616537.0,76222295.0,48394241.0,849,220,629,85063,13526,71537,117097600.0,73655203.0,43442397.0,4.2928,0.6032,5.4455,0.6073
2023-04-07 13:30,1713,410,1303,232042,15522,216520,231422252.0,101174161.0,130248091.0,1462,235,1227,211325,10187,201138,219252729.0,97778309.0,121474420.0,6.5181,0.6016,9.5983,0.6039
2023-04-07 13:35,858,236,622,77740,11346,66394,46738688.0,6792896.0,39945792.0,725,151,574,64857,3855,61002,39043902.0,2291457.0,36752445.0,0.5987,0.6016,0.5944,0.6025
2023-04-07 13:40,1326,397,929,173746,31224,142522,131440702.0,45081988.0,86358713.0,1207,333,874,171409,28283,143126,129965010.0,43208696.0,86756314.0,1.4438,0.6059,1.5277,0.6062
2023-04-07 13:45,490,242,248,43934,19803,24131,26413427.0,11913855.0,14499571.0,413,190,223,37696,18495,19201,22721256.0,11119411.0,11601844.0,0.6016,0.6009,0.6012,0.6042
2023-04-07 13:50,1109,545,564,127351,69728,57623,76750037.0,41934737.0,34815300.0,1076,522,554,127641,69596,58045,76911552.0,41842800.0,35068752.0,0.6014,0.6042,0.6012,0.6042
2023-04-07 13:55,785,492,293,75389,48195,27194,58674116.0,42239393.0,16434723.0,738,470,268,75251,46601,28650,58535414.0,41193015.0,17342398.0,0.8764,0.6044,0.884,0.6053
2023-04-07 14:00,777,582,195,57156,31314,25842,34513070.0,18879070.0,15634000.0,710,548,162,55340,31070,24270,33416278.0,18729219.0,14687058.0,0.6029,0.605,0.6028,0.6052
2023-04-07 14:05,543,424,119,40288,29321,10967,24291430.0,17646054.0,6645375.0,511,409,102,38965,29267,9698,23497651.0,17619817.0,5877834.0,0.6018,0.6059,0.602,0.6061
2023-04-07 14:10,347,91,256,24726,6437,18289,14927607.0,3872147.0,11055460.0,307,69,238,23255,5485,17770,14045301.0,3300098.0,10745202.0,0.6015,0.6045,0.6017,0.6047
2023-04-07 14:15,522,236,286,30569,14305,16264,18424042.0,8610128.0,9813914.0,481,211,270,29783,13702,16081,17962094.0,8248134.0,9713959.0,0.6019,0.6034,0.602,0.6041
2023-04-07 14:20,386,209,177,25312,13199,12113,15258549.0,7950937.0,7307611.0,349,182,167,24427,12433,11994,14727596.0,7482930.0,7244666.0,0.6024,0.6033,0.6019,0.604
2023-04-07 14:25,299,260,39,15823,13324,2499,9526295.0,8031103.0,1495192.0,273,244,29,15650,13499,2151,9434284.0,8133990.0,1300294.0,0.6028,0.5983,0.6026,0.6045
2023-04-07 14:30,228,145,83,18584,13069,5515,11187012.0,7865567.0,3321444.0,210,138,72,19231,13546,5685,11590419.0,8149655.0,3440764.0,0.6018,0.6023,0.6016,0.6052
2023-04-07 14:35,929,463,466,95293,61062,34231,96941637.0,76266915.0,20674722.0,889,444,445,91376,57905,33471,94479276.0,74244024.0,20235252.0,1.249,0.604,1.2822,0.6046
2023-04-07 14:40,2466,1885,581,284607,234363,50244,211175028.0,180775904.0,30399124.0,2414,1860,554,279589,230926,48663,208206957.0,178698832.0,29508124.0,0.7714,0.605,0.7738,0.6064
2023-04-07 14:45,2007,1777,230,306741,283998,22743,250950159.0,237110341.0,13839817.0,1949,1749,200,303354,281916,21438,248878329.0,235827611.0,13050717.0,0.8349,0.6085,0.8365,0.6088
2023-04-07 14:50,148,83,65,10200,5082,5118,6214225.0,3097575.0,3116650.0,104,57,47,7897,3518,4379,4800131.0,2132597.0,2667533.0,0.6095,0.609,0.6062,0.6092
2023-04-07 14:55,660,110,550,43906,15280,28626,26640390.0,9241910.0,17398480.0,635,102,533,43103,15436,27667,26148553.0,9328302.0,16820251.0,0.6048,0.6078,0.6043,0.608
2023-04-07 15:00,1098,543,555,77481,45684,31797,47060684.0,27738166.0,19322518.0,1069,528,541,76391,45101,31290,46337940.0,27321873.0,19016066.0,0.6072,0.6077,0.6058,0.6077
2023-04-07 15:05,1218,1059,159,91690,81069,10621,55606400.0,49138354.0,6468045.0,1200,1053,147,89546,81472,8074,54284245.0,49368985.0,4915260.0,0.6061,0.609,0.606,0.6088
2023-04-07 15:10,2222,1231,991,323258,219365,103893,208618048.0,145604358.0,63013690.0,2204,1222,982,319184,218985,100199,206222028.0,145364718.0,60857310.0,0.6638,0.6065,0.6638,0.6074
2023-04-07 15:15,2744,1096,1648,347135,179582,167553,223266508.0,121555499.0,101711008.0,2714,1080,1634,351376,179513,171863,225859314.0,121525244.0,104334070.0,0.6769,0.607,0.677,0.6071
2023-04-07 15:20,3439,1931,1508,473902,314839,159063,286710538.0,190099979.0,96610559.0,3425,1926,1499,473345,314623,158722,286340226.0,189936475.0,96403751.0,0.6038,0.6074,0.6037,0.6074
2023-04-07 15:25,2931,1722,1209,440747,326983,113764,266524608.0,197417514.0,69107093.0,2922,1717,1205,440555,326607,113948,266408222.0,197189553.0,69218668.0,0.6038,0.6075,0.6038,0.6075
2023-04-07 15:30,2441,1585,856,336070,281956,54114,203173174.0,170308492.0,32864682.0,2431,1579,852,336541,282510,54031,203454631.0,170635408.0,32819223.0,0.604,0.6073,0.604,0.6074
2023-04-07 15:35,2236,973,1263,242587,130334,112253,160243296.0,91997726.0,68245570.0,2212,953,1259,241284,128283,113001,159406120.0,90694099.0,68712021.0,0.7059,0.608,0.707,0.6081
2023-04-07 15:40,2529,1958,571,297961,256706,41255,206718284.0,181661737.0,25056546.0,2481,1937,544,296647,256388,40259,205876610.0,181394488.0,24482121.0,0.7077,0.6074,0.7075,0.6081
2023-04-07 15:45,3249,2337,912,406024,353658,52366,258861932.0,227030493.0,31831439.0,3239,2337,902,406882,353760,53122,259402226.0,227092518.0,32309707.0,0.6419,0.6079,0.6419,0.6082
2023-04-07 15:50,2857,1840,1017,408255,338839,69416,246917673.0,204748175.0,42169498.0,2824,1825,999,406803,338319,68484,246005900.0,204399240.0,41606660.0,0.6043,0.6075,0.6042,0.6075
2023-04-07 15:55,1899,828,1071,256186,164892,91294,168061301.0,112616915.0,55444386.0,1870,816,1054,250042,164115,85927,164319269.0,112147805.0,52171463.0,0.683,0.6073,0.6833,0.6072
2023-04-07 16:00,2760,159,2601,487618,5050,482568,295724405.0,3033367.0,292691038.0,2732,137,2595,486759,4289,482470,295364811.0,2564549.0,292800262.0,0.6007,0.6065,0.5979,0.6069
2023-04-07 16:05,2155,102,2053,380599,4946,375653,257052327.0,29182066.0,227870261.0,2132,86,2046,379909,4317,375592,256833858.0,28923559.0,227910298.0,5.9001,0.6066,6.6999,0.6068
2023-04-07 16:10,2366,148,2218,357511,6107,351404,242952014.0,29878975.0,213073038.0,2344,132,2212,357409,5637,351772,242879429.0,29579290.0,213300139.0,4.8926,0.6063,5.2473,0.6064
2023-04-07 16:15,3370,916,2454,462736,45190,417546,332515364.0,79657618.0,252857746.0,3325,887,2438,460395,44448,415947,331148529.0,79196117.0,251952411.0,1.7627,0.6056,1.7818,0.6057
2023-04-07 16:20,1274,160,1114,175923,6363,169560,106381790.0,3820276.0,102561514.0,1249,141,1108,172793,5713,167080,104465315.0,3407689.0,101057626.0,0.6004,0.6049,0.5965,0.6048
2023-04-07 16:25,1661,656,1005,248075,62423,185652,176314165.0,63778772.0,112535393.0,1636,633,1003,247505,60448,187057,175981958.0,62587892.0,113394066.0,1.0217,0.6062,1.0354,0.6062
2023-04-07 16:30,1970,1318,652,307298,192429,114869,238276215.0,168523738.0,69752476.0,1945,1308,637,301939,188402,113537,235069720.0,166077520.0,68992200.0,0.8758,0.6072,0.8815,0.6077
2023-04-07 16:35,51,35,16,8148,5635,2513,4900278.0,3393719.0,1506558.0,33,22,11,4484,3792,692,2705247.0,2283872.0,421375.0,0.6023,0.5995,0.6023,0.6089
2023-04-07 16:40,591,496,95,95192,80117,15075,57514025.0,48356923.0,9157101.0,577,492,85,94774,80051,14723,57263309.0,48314232.0,8949076.0,0.6036,0.6074,0.6035,0.6078
2023-04-07 16:45,84,71,13,9140,8358,782,5519426.0,5044193.0,475233.0,63,50,13,9280,7763,1517,5610109.0,4683824.0,926284.0,0.6035,0.6077,0.6034,0.6106
2023-04-07 16:50,162,141,21,25664,23614,2050,15492331.0,14250405.0,1241925.0,150,134,16,26073,24570,1503,15745932.0,14829948.0,915983.0,0.6035,0.6058,0.6036,0.6094
2023-04-07 16:55,60,33,27,3791,1984,1807,2314578.0,1219698.0,1094879.0,37,20,17,3556,2012,1544,2152673.0,1214087.0,938585.0,0.6148,0.6059,0.6034,0.6079
2023-04-07 17:00,173,115,58,26726,19776,6950,16152235.0,11929906.0,4222328.0,156,105,51,26111,19451,6660,15781430.0,11733391.0,4048039.0,0.6033,0.6075,0.6032,0.6078
2023-04-07 17:05,152,93,59,22791,15743,7048,13777244.0,9494095.0,4283148.0,140,86,54,23509,15179,8330,14219832.0,9155868.0,5063964.0,0.6031,0.6077,0.6032,0.6079
2023-04-07 17:10,1191,1042,149,206906,186146,20760,125033571.0,112426166.0,12607405.0,1175,1029,146,205776,185689,20087,124345676.0,112146190.0,12199485.0,0.604,0.6073,0.6039,0.6073
2023-04-07 17:15,674,636,38,163340,159968,3372,98518567.0,96498911.0,2019655.0,635,610,25,163054,159302,3752,98372143.0,96092075.0,2280068.0,0.6032,0.5989,0.6032,0.6077
2023-04-07 17:20,341,248,93,68469,58899,9570,41334773.0,35566310.0,5768463.0,319,241,78,66891,58478,8413,40422308.0,35307966.0,5114341.0,0.6039,0.6028,0.6038,0.6079
2023-04-07 17:25,147,95,52,20589,17667,2922,12430846.0,10657913.0,1772932.0,127,87,40,21490,19235,2255,12963641.0,11593760.0,1369881.0,0.6033,0.6068,0.6027,0.6075
2023-04-07 17:30,545,490,55,81435,76684,4751,62854211.0,59968116.0,2886095.0,517,469,48,80144,75067,5077,61564950.0,58480935.0,3084015.0,0.782,0.6075,0.779,0.6074
2023-04-07 17:35,514,445,69,76800,67582,9218,60230689.0,54608683.0,5622006.0,469,421,48,73743,66441,7302,58345396.0,53891584.0,4453811.0,0.808,0.6099,0.8111,0.6099
2023-04-07 17:40,635,575,60,114972,111379,3593,83339697.0,81143585.0,2196112.0,577,547,30,113556,110577,2979,82468415.0,80644580.0,1823835.0,0.7285,0.6112,0.7293,0.6122
2023-04-07 17:45,111,55,56,10536,4632,5904,6431307.0,2824415.0,3606892.0,85,45,40,9426,3784,5642,5728168.0,2281645.0,3446522.0,0.6098,0.6109,0.603,0.6109
2023-04-07 17:50,90,40,50,7392,4652,2740,18217381.0,16544283.0,1673098.0,67,25,42,5385,2812,2573,16876940.0,15305952.0,1570988.0,3.5564,0.6106,5.4431,0.6106
2023-04-07 17:55,428,328,100,45364,31573,13791,28312456.0,19214408.0,9098047.0,393,312,81,38059,30766,7293,23143130.0,18683505.0,4459625.0,0.6086,0.6597,0.6073,0.6115
2023-04-07 18:00,2171,1582,589,307104,276455,30649,273163719.0,254346466.0,18817253.0,2041,1540,501,298294,270148,28146,266824528.0,249540331.0,17284197.0,0.92,0.614,0.9237,0.6141
2023-04-07 18:05,2864,2098,766,388182,332081,56101,336930512.0,302320868.0,34609644.0,2780,2079,701,386407,332434,53973,335780862.0,302477703.0,33303159.0,0.9104,0.6169,0.9099,0.617
2023-04-07 18:10,3057,2143,914,360555,272109,88446,306047345.0,251521982.0,54525363.0,3003,2126,877,358328,270882,87446,304602604.0,250679005.0,53923599.0,0.9243,0.6165,0.9254,0.6167
2023-04-07 18:15,1583,1351,232,243263,202018,41245,149229242.0,123809150.0,25420092.0,1546,1337,209,239165,198031,41134,146760016.0,121408480.0,25351535.0,0.6129,0.6163,0.6131,0.6163
2023-04-07 18:20,2107,1825,282,286122,249271,36851,175545654.0,152836905.0,22708748.0,2066,1811,255,286802,250573,36229,175933840.0,153607234.0,22326606.0,0.6131,0.6162,0.613,0.6163
2023-04-07 18:25,1940,1518,422,257164,238430,18734,157808737.0,146296687.0,11512050.0,1900,1507,393,253430,236064,17366,155450878.0,144760490.0,10690387.0,0.6136,0.6145,0.6132,0.6156
2023-04-07 18:30,585,214,371,42318,22366,19952,40024203.0,27759798.0,12264405.0,557,203,354,40260,21269,18991,38783600.0,27097962.0,11685637.0,1.2412,0.6147,1.2741,0.6153
2023-04-07 18:35,1585,1084,501,211394,173347,38047,156964052.0,133820952.0,23143100.0,1554,1052,502,207405,173034,34371,154668597.0,133626443.0,21042154.0,0.772,0.6083,0.7723,0.6122
2023-04-10 10:00,2792,1530,1262,265509,155632,109877,174663292.0,107058899.0,67604392.0,2422,1333,1089,252826,149655,103171,159977600.0,96646641.0,63330959.0,0.6879,0.6153,0.6458,0.6138
2023-04-10 10:05,1628,242,1386,172580,21070,151510,146934467.0,53890495.0,93043972.0,1490,190,1300,167654,19395,148259,136402067.0,45319167.0,91082900.0,2.5577,0.6141,2.3366,0.6143
2023-04-10 10:10,2702,509,2193,300113,29724,270389,183449397.0,18042180.0,165407217.0,2599,434,2165,300498,31160,269338,183732190.0,18880539.0,164851651.0,0.607,0.6117,0.6059,0.6121
2023-04-10 10:15,2984,1714,1270,285262,126839,158423,269508963.0,172271837.0,97237126.0,2861,1661,1200,281343,124658,156685,267148033.0,170918745.0,96229287.0,1.3582,0.6138,1.3711,0.6142
2023-04-10 10:20,1891,1277,614,142805,93740,49065,127759543.0,97792452.0,29967091.0,1827,1249,578,140750,93048,47702,126818420.0,97629435.0,29188984.0,1.0432,0.6108,1.0492,0.6119
2023-04-10 10:25,1551,482,1069,151466,23974,127492,133492814.0,55401383.0,78091431.0,1480,432,1048,149740,23139,126601,132518538.0,54880334.0,77638203.0,2.3109,0.6125,2.3718,0.6133
2023-04-10 10:30,2137,420,1717,285614,17519,268095,175462531.0,10685647.0,164776883.0,2081,393,1688,284706,17107,267599,174917068.0,10434361.0,164482707.0,0.6099,0.6146,0.6099,0.6147
2023-04-10 10:35,930,177,753,105198,5293,99905,64609045.0,3229836.0,61379209.0,873,140,733,104012,4422,99590,63882780.0,2691281.0,61191499.0,0.6102,0.6144,0.6086,0.6144
2023-04-10 10:40,1226,471,755,132011,25567,106444,108297539.0,42862868.0,65434671.0,1161,438,723,128754,24127,104627,106248728.0,41931796.0,64316932.0,1.6765,0.6147,1.738,0.6147
2023-04-10 10:45,1372,614,758,131745,35369,96376,108053294.0,48807718.0,59245576.0,1339,606,733,130739,35034,95705,107433006.0,48600031.0,58832974.0,1.38,0.6147,1.3872,0.6147
2023-04-10 10:50,963,461,502,75122,21893,53229,86836345.0,54201175.0,32635169.0,889,405,484,70822,19649,51173,84274246.0,52804742.0,31469504.0,2.4757,0.6131,2.6874,0.615
2023-04-10 10:55,301,172,129,20295,8501,11794,12422536.0,5175082.0,7247453.0,213,109,104,15571,5319,10252,9552176.0,3243598.0,6308578.0,0.6088,0.6145,0.6098,0.6154
2023-04-10 11:00,53,19,34,3003,487,2516,1767943.0,297288.0,1470655.0,32,8,24,1942,322,1620,1191370.0,196307.0,995062.0,0.6104,0.5845,0.6097,0.6142
2023-04-10 11:05,149,32,117,16617,2216,14401,10253674.0,1358756.0,8894918.0,115,18,97,16205,3295,12910,9903110.0,1989189.0,7913920.0,0.6132,0.6177,0.6037,0.613
2023-04-10 11:10,862,430,432,66499,20809,45690,81586475.0,53519352.0,28067122.0,804,390,414,63015,18907,44108,79441699.0,52337803.0,27103896.0,2.5719,0.6143,2.7682,0.6145
2023-04-10 11:15,1429,662,767,164563,58277,106286,155371764.0,90044906.0,65326858.0,1375,631,744,161626,56869,104757,153551030.0,89164815.0,64386215.0,1.5451,0.6146,1.5679,0.6146
2023-04-10 11:20,310,135,175,20071,10756,9315,12297797.0,6583117.0,5714680.0,277,120,157,18899,9982,8917,11573627.0,6089570.0,5484056.0,0.612,0.6135,0.6101,0.615
2023-04-10 11:25,460,217,243,36126,18512,17614,22130479.0,11286301.0,10844177.0,434,207,227,35324,18182,17142,21640452.0,11085791.0,10554661.0,0.6097,0.6157,0.6097,0.6157
2023-04-10 11:30,225,77,148,12042,2741,9301,21014338.0,15279214.0,5735124.0,208,70,138,12232,3146,9086,21126297.0,15522884.0,5603412.0,5.5743,0.6166,4.9342,0.6167
2023-04-10 11:35,410,130,280,33903,4638,29265,20886132.0,2838830.0,18047302.0,392,128,264,32091,3769,28322,19784072.0,2307875.0,17476196.0,0.6121,0.6167,0.6123,0.6171
2023-04-10 11:40,170,73,97,10646,2264,8382,7647567.0,2482620.0,5164947.0,158,69,89,11668,1918,9750,7276104.0,1171981.0,6104123.0,1.0966,0.6162,0.611,0.6261
2023-04-10 11:45,542,204,338,55097,8828,46269,34023641.0,5428461.0,28595179.0,489,176,313,42843,7482,35361,26419974.0,4589528.0,21830445.0,0.6149,0.618,0.6134,0.6174
2023-04-10 11:50,701,302,399,73079,25928,47151,45045778.0,15939571.0,29106206.0,636,282,354,82042,26071,55971,50597338.0,16023267.0,34574071.0,0.6148,0.6173,0.6146,0.6177
2023-04-10 11:55,357,220,137,25555,14878,10677,29336440.0,22746978.0,6589461.0,336,210,126,25083,14774,10309,29037253.0,22681161.0,6356092.0,1.5289,0.6172,1.5352,0.6166
2023-04-10 12:00,1184,482,702,136306,39363,96943,84000063.0,24210057.0,59790005.0,1086,413,673,134505,38337,96168,82895722.0,23565729.0,59329993.0,0.615,0.6168,0.6147,0.6169
2023-04-10 12:05,631,190,441,61000,12262,48738,37620496.0,7544580.0,30075915.0,622,188,434,60946,12279,48667,37586962.0,7554989.0,30031972.0,0.6153,0.6171,0.6153,0.6171
2023-04-10 12:10,336,233,103,16776,9832,6944,10313877.0,6057486.0,4256390.0,298,213,85,16107,9336,6771,9922926.0,5743026.0,4179900.0,0.6161,0.613,0.6151,0.6173
2023-04-10 12:15,134,67,67,7443,2512,4931,4589795.0,1549889.0,3039906.0,111,60,51,7463,2889,4574,4596657.0,1775171.0,2821486.0,0.617,0.6165,0.6145,0.6169
2023-04-10 12:20,540,238,302,36321,14101,22220,22367886.0,8672041.0,13695844.0,525,230,295,36071,13971,22100,22215264.0,8592015.0,13623248.0,0.615,0.6164,0.615,0.6164
2023-04-10 12:25,621,166,455,47827,9820,38007,29510219.0,6034841.0,23475378.0,595,157,438,46385,9632,36753,28580237.0,5919585.0,22660652.0,0.6145,0.6177,0.6146,0.6166
2023-04-10 12:30,863,145,718,143862,10398,133464,102256515.0,19978771.0,82277744.0,830,133,697,140930,9786,131144,100382081.0,19601138.0,80780942.0,1.9214,0.6165,2.003,0.616
2023-04-10 12:35,1358,235,1123,177361,19571,157790,109280395.0,11998748.0,97281647.0,1345,230,1115,176886,19138,157748,109002115.0,11735130.0,97266985.0,0.6131,0.6165,0.6132,0.6166
2023-04-10 12:40,616,327,289,52032,21100,30932,32005045.0,12948378.0,19056666.0,588,314,274,51114,20586,30528,31443578.0,12631908.0,18811669.0,0.6137,0.6161,0.6136,0.6162
2023-04-10 12:45,357,54,303,28438,3741,24697,17478590.0,2290994.0,15187596.0,345,50,295,27068,3033,24035,16635387.0,1855696.0,14779691.0,0.6124,0.615,0.6118,0.6149
2023-04-10 12:50,891,238,653,100017,15805,84212,61511074.0,9690254.0,51820820.0,879,229,650,99978,15661,84317,61485966.0,9598522.0,51887444.0,0.6131,0.6154,0.6129,0.6154
2023-04-10 12:55,821,388,433,80273,21535,58738,49399205.0,13228526.0,36170679.0,800,376,424,79252,20850,58402,48747353.0,12789327.0,35958026.0,0.6143,0.6158,0.6134,0.6157
2023-04-10 13:00,5550,3091,2459,743139,350423,392716,970071339.0,723789616.0,246281722.0,4190,2500,1690,637568,289178,348390,903332297.0,684011768.0,219320528.0,2.0655,0.6271,2.3654,0.6295
2023-04-10 13:05,6194,3447,2747,698926,412840,286086,826222644.0,644475830.0,181746814.0,4936,2910,2026,606247,364911,241336,766833550.0,612602990.0,154230560.0,1.5611,0.6353,1.6788,0.6391
2023-04-10 13:10,4626,2622,2004,560398,361465,198933,576502923.0,449674437.0,126828485.0,3514,2153,1361,477666,309803,167863,523317201.0,415768246.0,107548954.0,1.244,0.6375,1.342,0.6407
2023-04-10 13:15,5182,3243,1939,512108,329974,182134,655556391.0,538773422.0,116782968.0,4172,2766,1406,474133,320276,153857,631137586.0,531734840.0,99402746.0,1.6328,0.6412,1.6602,0.6461
2023-04-10 13:20,7962,3831,4131,973343,493658,479685,999931155.0,689127045.0,310804110.0,6437,3191,3246,859465,439634,419831,926065150.0,652409443.0,273655707.0,1.396,0.6479,1.484,0.6518
2023-04-10 13:25,4659,2362,2297,419999,219839,200160,391955274.0,264064910.0,127890364.0,3815,1917,1898,372817,200979,171838,363216107.0,251850037.0,111366070.0,1.2012,0.6389,1.2531,0.6481
2023-04-10 13:30,2833,1219,1614,234587,66690,167897,217388567.0,110681619.0,106706947.0,2043,691,1352,190338,42001,148337,189860867.0,94718657.0,95142210.0,1.6596,0.6356,2.2552,0.6414
2023-04-10 13:35,2595,1007,1588,226919,54092,172827,157719440.0,48092036.0,109627404.0,1939,633,1306,192318,39907,152411,136276653.0,38929214.0,97347439.0,0.8891,0.6343,0.9755,0.6387
2023-04-10 13:40,2234,1360,874,189105,119488,69617,229616128.0,185170753.0,44445375.0,1880,1247,633,172601,112069,60532,218881801.0,180062736.0,38819065.0,1.5497,0.6384,1.6067,0.6413
2023-04-10 13:45,3019,2059,960,318734,264860,53874,312533042.0,278110172.0,34422869.0,2723,1941,782,303147,257675,45472,302356919.0,273182721.0,29174198.0,1.05,0.639,1.0602,0.6416
2023-04-10 13:50,1997,1147,850,169768,121499,48269,121647521.0,91033990.0,30613531.0,1830,1058,772,160810,118424,42386,116114264.0,88988908.0,27125356.0,0.7493,0.6342,0.7514,0.64
2023-04-10 13:55,765,368,397,46159,19551,26608,29400437.0,12423542.0,16976895.0,646,322,324,39130,17448,21682,24957266.0,11073735.0,13883531.0,0.6354,0.638,0.6347,0.6403
2023-04-10 14:00,1294,817,477,134737,106018,28719,99163119.0,81048696.0,18114423.0,1154,730,424,126073,101852,24221,93854957.0,78386625.0,15468331.0,0.7645,0.6307,0.7696,0.6386
2023-04-10 14:05,1002,534,468,84139,45192,38947,67055266.0,42335312.0,24719953.0,885,471,414,78448,42172,36276,63555674.0,40387365.0,23168309.0,0.9368,0.6347,0.9577,0.6387
2023-04-10 14:10,1192,594,598,98931,54494,44437,90260288.0,61933627.0,28326661.0,1042,514,528,90438,49131,41307,84799327.0,58433164.0,26366162.0,1.1365,0.6375,1.1893,0.6383
2023-04-10 14:15,588,315,273,35700,21058,14642,22703341.0,13433659.0,9269681.0,489,257,232,31776,19685,12091,20251337.0,12522067.0,7729270.0,0.6379,0.6331,0.6361,0.6393
2023-04-10 14:20,729,204,525,43805,11024,32781,27916218.0,7022124.0,20894093.0,611,137,474,37345,7347,29998,23846601.0,4664909.0,19181691.0,0.637,0.6374,0.6349,0.6394
2023-04-10 14:25,499,316,183,32052,18124,13928,20450444.0,11577529.0,8872914.0,436,285,151,27817,16682,11135,17726894.0,10610749.0,7116145.0,0.6388,0.6371,0.6361,0.6391
2023-04-10 14:30,427,231,196,38412,15168,23244,24399438.0,9664127.0,14735311.0,386,215,171,34039,13173,20866,21728725.0,8372887.0,13355838.0,0.6371,0.6339,0.6356,0.6401
2023-04-10 14:35,406,228,178,34935,15815,19120,22237415.0,10062434.0,12174981.0,348,185,163,31096,13805,17291,19817973.0,8762791.0,11055182.0,0.6363,0.6368,0.6348,0.6394
2023-04-10 14:40,562,437,125,61989,50590,11399,53194238.0,45923461.0,7270777.0,494,407,87,57233,46706,10527,50103960.0,43361125.0,6742835.0,0.9078,0.6378,0.9284,0.6405
2023-04-10 14:45,1835,1530,305,258791,237418,21373,192384457.0,178757649.0,13626807.0,1652,1449,203,252226,235442,16784,188154996.0,177379144.0,10775852.0,0.7529,0.6376,0.7534,0.642
2023-04-10 14:50,2461,724,1737,323739,70302,253437,247496951.0,85596233.0,161900718.0,2379,680,1699,316501,67182,249319,243054159.0,83609465.0,159444694.0,1.2176,0.6388,1.2445,0.6395
2023-04-10 14:55,1228,276,952,164555,13576,150979,132089537.0,35821905.0,96267632.0,1160,245,915,160010,12578,147432,129472550.0,35188094.0,94284456.0,2.6386,0.6376,2.7976,0.6395
2023-04-10 15:00,1462,403,1059,272902,31701,241201,174412472.0,20080277.0,154332195.0,1437,402,1035,273399,33319,240080,174703835.0,21074548.0,153629286.0,0.6334,0.6398,0.6325,0.6399
2023-04-10 15:05,1052,407,645,119144,23468,95676,76103639.0,14901771.0,61201868.0,1029,398,631,119465,23646,95819,76284937.0,14988783.0,61296154.0,0.635,0.6397,0.6339,0.6397
2023-04-10 15:10,835,537,298,76870,35509,41361,49069697.0,22622165.0,26447532.0,788,526,262,77581,36123,41458,49520942.0,22993109.0,26527833.0,0.6371,0.6394,0.6365,0.6399
2023-04-10 15:15,3545,675,2870,625854,56637,569217,440385296.0,76831291.0,363554005.0,3453,620,2833,619210,53443,565767,436126196.0,74763043.0,361363153.0,1.3566,0.6387,1.3989,0.6387
2023-04-10 15:20,2720,845,1875,492958,45653,447305,314708474.0,29021771.0,285686703.0,2659,816,1843,490645,44443,446202,313285208.0,28250090.0,285035118.0,0.6357,0.6387,0.6356,0.6388
2023-04-10 15:25,1634,244,1390,315332,14921,300411,212082161.0,20354021.0,191728140.0,1570,217,1353,309290,12916,296374,211038479.0,21777768.0,189260711.0,1.3641,0.6382,1.6861,0.6386
2023-04-10 15:30,1362,488,874,196772,36759,160013,147357498.0,45338884.0,102018614.0,1230,415,815,186321,29129,157192,140692091.0,40345522.0,100346568.0,1.2334,0.6376,1.3851,0.6384
2023-04-10 15:35,2115,1818,297,267935,249462,18473,192139795.0,180367767.0,11772027.0,2080,1810,270,266683,248525,18158,191347869.0,179760975.0,11586894.0,0.723,0.6373,0.7233,0.6381
2023-04-10 15:40,2010,1626,384,220799,199936,20863,140373682.0,127092080.0,13281602.0,1964,1609,355,219420,199699,19721,139519957.0,126935966.0,12583991.0,0.6357,0.6366,0.6356,0.6381
2023-04-10 15:45,1572,1069,503,150909,121844,29065,95950054.0,77445913.0,18504140.0,1529,1045,484,149908,121631,28277,95337921.0,77304137.0,18033783.0,0.6356,0.6366,0.6356,0.6378
2023-04-10 15:50,444,358,86,35288,29248,6040,22433778.0,18589803.0,3843975.0,412,346,66,35020,29394,5626,22279678.0,18682194.0,3597484.0,0.6356,0.6364,0.6356,0.6394
2023-04-10 15:55,1194,947,247,122805,96207,26598,78165230.0,61218744.0,16946486.0,1142,927,215,120908,95065,25843,76961350.0,60456163.0,16505186.0,0.6363,0.6371,0.6359,0.6387
2023-04-10 16:00,1224,526,698,97855,47753,50102,62318895.0,30361392.0,31957503.0,1191,515,676,97628,47298,50330,62182903.0,30060169.0,32122734.0,0.6358,0.6378,0.6355,0.6382
2023-04-10 16:05,2349,695,1654,255865,56606,199259,185624761.0,58659031.0,126965730.0,2296,675,1621,256430,57402,199028,185668992.0,58707847.0,126961145.0,1.0363,0.6372,1.0227,0.6379
2023-04-10 16:10,2080,441,1639,383318,51715,331603,266940553.0,55522998.0,211417555.0,2014,403,1611,378573,50818,327755,264024760.0,54946725.0,209078035.0,1.0736,0.6376,1.0812,0.6379
2023-04-10 16:15,3859,563,3296,742806,23165,719641,496048267.0,37361211.0,458687055.0,3792,524,3268,742595,22740,719855,495935772.0,37085527.0,458850244.0,1.6128,0.6374,1.6308,0.6374
2023-04-10 16:20,3417,866,2551,576033,45143,530890,367022204.0,28638318.0,338383886.0,3379,852,2527,574188,44817,529371,365901883.0,28424366.0,337477517.0,0.6344,0.6374,0.6342,0.6375
2023-04-10 16:25,2302,246,2056,390240,13954,376286,259916539.0,20178685.0,239737854.0,2254,219,2035,388560,13779,374781,258848719.0,20030808.0,238817911.0,1.4461,0.6371,1.4537,0.6372
2023-04-10 16:30,1921,410,1511,294017,19478,274539,232106140.0,57650092.0,174456048.0,1794,323,1471,287927,15508,272419,228370089.0,55114599.0,173255490.0,2.9598,0.6355,3.5539,0.636
2023-04-10 16:35,3980,681,3299,699373,38157,661216,489733312.0,69454732.0,420278579.0,3931,662,3269,698628,37931,660697,489300544.0,69299968.0,420000576.0,1.8202,0.6356,1.827,0.6357
2023-04-10 16:40,3588,1224,2364,574320,136535,437785,410105853.0,131790314.0,278315539.0,3527,1190,2337,568203,131951,436252,406288249.0,128852385.0,277435864.0,0.9652,0.6357,0.9765,0.636
2023-04-10 16:45,1139,616,523,112953,66470,46483,71660669.0,42109547.0,29551121.0,1098,602,496,110942,65101,45841,70388542.0,41209372.0,29179170.0,0.6335,0.6357,0.633,0.6365
2023-04-10 16:50,1582,262,1320,99525,10746,88779,63268257.0,6804803.0,56463454.0,1542,238,1304,99676,12424,87252,63307989.0,7844066.0,55463922.0,0.6332,0.636,0.6314,0.6357
2023-04-10 16:55,1415,639,776,155795,71483,84312,110387884.0,56678937.0,53708946.0,1385,626,759,153835,70537,83298,109103270.0,56039727.0,53063543.0,0.7929,0.637,0.7945,0.637
2023-04-10 17:00,161,25,136,13625,1536,12089,8683156.0,974700.0,7708455.0,120,13,107,12942,726,12216,8247612.0,457939.0,7789673.0,0.6346,0.6376,0.6308,0.6377
2023-04-10 17:05,515,126,389,48752,22776,25976,42237361.0,25741550.0,16495810.0,476,113,363,47365,22703,24662,41388947.0,25690675.0,15698272.0,1.1302,0.635,1.1316,0.6365
2023-04-10 17:10,519,398,121,85089,74491,10598,65283963.0,58532849.0,6751114.0,494,390,104,82084,73230,8854,63365096.0,57726734.0,5638362.0,0.7858,0.637,0.7883,0.6368
2023-04-10 17:15,1085,939,146,130170,113889,16281,105365309.0,94955952.0,10409356.0,1042,927,115,132161,116400,15761,106628860.0,96548860.0,10079999.0,0.8338,0.6394,0.8295,0.6396
2023-04-10 17:20,2555,2377,178,310300,289901,20399,254280105.0,241241654.0,13038450.0,2475,2339,136,303275,284922,18353,249791291.0,238043392.0,11747899.0,0.8322,0.6392,0.8355,0.6401
2023-04-10 17:25,2454,2015,439,271159,229914,41245,206805521.0,180460324.0,26345196.0,2379,1982,397,266831,228607,38224,204076028.0,179628903.0,24447125.0,0.7849,0.6387,0.7858,0.6396
2023-04-10 17:30,1792,1269,523,230749,192031,38718,192162357.0,167427420.0,24734937.0,1750,1248,502,230150,190959,39191,191809836.0,166743411.0,25066424.0,0.8719,0.6388,0.8732,0.6396
2023-04-10 17:35,1505,1468,37,202065,200091,1974,139780555.0,138519846.0,1260708.0,1467,1444,23,202424,201726,698,139974466.0,139528077.0,446388.0,0.6923,0.6387,0.6917,0.6395
2023-04-10 17:40,2470,2189,281,299546,284632,14914,190888465.0,181377022.0,9511443.0,2399,2150,249,291547,277808,13739,185997525.0,177203049.0,8794476.0,0.6372,0.6378,0.6379,0.6401
2023-04-10 17:45,2641,2125,516,353089,319218,33871,362405647.0,340623963.0,21781684.0,2254,1966,288,328444,302556,25888,346365135.0,329522491.0,16842643.0,1.0671,0.6431,1.0891,0.6506
2023-04-10 17:50,4212,3113,1099,496221,415472,80749,433051959.0,381214413.0,51837546.0,3666,2855,811,461232,397925,63307,410627934.0,369578483.0,41049451.0,0.9175,0.642,0.9288,0.6484
2023-04-10 17:55,3916,1653,2263,467019,127064,339955,693769462.0,477995240.0,215774221.0,3124,1142,1982,428346,101464,326882,669670355.0,461596374.0,208073981.0,3.7618,0.6347,4.5494,0.6365
2023-04-10 18:00,2278,635,1643,243269,32229,211040,267910983.0,133778508.0,134132474.0,2060,462,1598,237196,33061,204135,264150971.0,134099876.0,130051094.0,4.1509,0.6356,4.0561,0.6371
2023-04-10 18:05,10965,612,10353,2978474,35349,2943125,2004922252.0,135701606.0,1869220646.0,10632,417,10215,2959819,27492,2932327,1993169947.0,130656563.0,1862513384.0,3.8389,0.6351,4.7525,0.6352
2023-04-10 18:10,1888,1254,634,175563,125309,50254,122580411.0,90672727.0,31907683.0,1788,1200,588,171636,124013,47623,119996340.0,89753650.0,30242690.0,0.7236,0.6349,0.7237,0.635
2023-04-10 18:15,1567,971,596,166043,116096,49947,150498447.0,118791042.0,31707405.0,1481,895,586,160389,112993,47396,146921217.0,116778393.0,30142823.0,1.0232,0.6348,1.0335,0.636
2023-04-10 18:20,190,81,109,9209,2778,6431,5794260.0,1756605.0,4037655.0,148,57,91,8642,2250,6392,5489754.0,1419986.0,4069768.0,0.6323,0.6278,0.6311,0.6367
2023-04-10 18:25,411,175,236,25324,9032,16292,16004167.0,5710047.0,10294119.0,366,149,217,22350,7475,14875,14160246.0,4726211.0,9434035.0,0.6322,0.6319,0.6323,0.6342
2023-04-10 18:30,169,78,91,14346,3579,10767,9218639.0,2264543.0,6954095.0,139,57,82,7010,1784,5226,4449230.0,1125706.0,3323523.0,0.6327,0.6459,0.631,0.636
2023-04-10 18:35,530,204,326,34444,12042,22402,21811487.0,7624818.0,14186668.0,514,188,326,40086,11520,28566,25558485.0,7286747.0,18271738.0,0.6332,0.6333,0.6325,0.6396
2023-04-11 10:00,6066,3757,2309,848996,524076,324920,577149342.0,370162856.0,206986485.0,5599,3507,2092,822562,512893,309669,553575641.0,356332751.0,197242889.0,0.7063,0.637,0.6948,0.6369
2023-04-11 10:05,2455,1111,1344,304822,151968,152854,214699909.0,117853826.0,96846083.0,2237,993,1244,297218,148241,148977,209356129.0,114724199.0,94631929.0,0.7755,0.6336,0.7739,0.6352
2023-04-11 10:10,886,280,606,79438,11729,67709,62380034.0,18727871.0,43652163.0,695,144,551,58889,8927,49962,44670342.0,12881233.0,31789109.0,1.5967,0.6447,1.443,0.6363
2023-04-11 10:15,2742,731,2011,333474,29229,304245,357005760.0,165673333.0,191332426.0,2276,408,1868,310614,16728,293886,343105422.0,157765509.0,185339913.0,5.6681,0.6289,9.4312,0.6307
2023-04-11 10:20,1188,440,748,86506,26437,60069,76947411.0,39243797.0,37703614.0,1033,323,710,77470,23368,54102,71227152.0,37170879.0,34056273.0,1.4844,0.6277,1.5907,0.6295
2023-04-11 10:25,1356,382,974,102696,28072,74624,75740785.0,28852584.0,46888201.0,1226,318,908,94049,25058,68991,70339702.0,26979085.0,43360617.0,1.0278,0.6283,1.0767,0.6285
2023-04-11 10:30,841,220,621,56694,16497,40197,46738946.0,21595173.0,25143773.0,714,136,578,55857,15874,39983,46264611.0,21193237.0,25071374.0,1.309,0.6255,1.3351,0.6271
2023-04-11 10:35,903,586,317,67655,38943,28712,65212257.0,47060840.0,18151417.0,817,522,295,61307,35424,25883,61148389.0,44793371.0,16355018.0,1.2085,0.6322,1.2645,0.6319
2023-04-11 10:40,3873,2707,1166,470958,346618,124340,330388769.0,251829020.0,78559749.0,3740,2645,1095,460738,339454,121284,323653546.0,247033475.0,76620071.0,0.7265,0.6318,0.7277,0.6317
2023-04-11 10:45,3625,2852,773,507754,453298,54456,342816519.0,308277392.0,34539127.0,3499,2795,704,501674,449612,52062,338831955.0,305811011.0,33020943.0,0.6801,0.6343,0.6802,0.6343
2023-04-11 10:50,3128,2775,353,570432,549945,20487,415375405.0,402386232.0,12989173.0,3059,2753,306,569459,550168,19291,414776332.0,402501603.0,12274728.0,0.7317,0.634,0.7316,0.6363
2023-04-11 10:55,5456,3089,2367,776054,499466,276588,613335467.0,438356196.0,174979270.0,5354,3044,2310,772495,498765,273730,611215416.0,437894251.0,173321164.0,0.8776,0.6326,0.878,0.6332
2023-04-11 11:00,1846,775,1071,204115,130938,73177,128396931.0,82172483.0,46224448.0,1789,742,1047,201963,129251,72712,127037537.0,81107939.0,45929598.0,0.6276,0.6317,0.6275,0.6317
2023-04-11 11:05,2809,1697,1112,375677,305563,70114,258528034.0,214259353.0,44268681.0,2768,1678,1090,375352,305161,70191,258319276.0,214007462.0,44311813.0,0.7012,0.6314,0.7013,0.6313
2023-04-11 11:10,3016,1828,1188,362161,272203,89958,227863724.0,171002928.0,56860796.0,2961,1792,1169,360770,271332,89438,227010824.0,170468555.0,56542268.0,0.6282,0.6321,0.6283,0.6322
2023-04-11 11:15,982,693,289,85355,71542,13813,98977415.0,90270379.0,8707036.0,920,661,259,80690,67690,13000,96055273.0,87849775.0,8205497.0,1.2618,0.6304,1.2978,0.6312
2023-04-11 11:20,1592,1131,461,124817,96325,28492,89880547.0,71886384.0,17994162.0,1560,1116,444,122517,95807,26710,88364564.0,71519546.0,16845018.0,0.7463,0.6316,0.7465,0.6307
2023-04-11 11:25,723,251,472,46701,18809,27892,52045143.0,34475792.0,17569350.0,680,232,448,45445,18485,26960,51262937.0,34277254.0,16985683.0,1.8329,0.6299,1.8543,0.63
2023-04-11 11:30,229,126,103,13494,8106,5388,8462904.0,5086831.0,3376072.0,191,106,85,11920,7120,4800,7494976.0,4470189.0,3024786.0,0.6275,0.6266,0.6278,0.6302
2023-04-11 11:35,1166,741,425,135174,115647,19527,84933847.0,72573350.0,12360496.0,1130,716,414,133148,114909,18239,83582577.0,72084080.0,11498497.0,0.6275,0.633,0.6273,0.6304
2023-04-11 11:40,3318,1902,1416,402883,318030,84853,264790535.0,211245678.0,53544856.0,3288,1889,1399,401586,317123,84463,263887973.0,210576899.0,53311074.0,0.6642,0.631,0.664,0.6312
2023-04-11 11:45,2699,1790,909,332939,280013,52926,209299643.0,175896624.0,33403019.0,2667,1773,894,332031,279875,52156,208724176.0,175808207.0,32915969.0,0.6282,0.6311,0.6282,0.6311
2023-04-11 11:50,1817,1194,623,257345,217030,40315,161573208.0,136165854.0,25407354.0,1788,1172,616,256332,216507,39825,160923543.0,135830747.0,25092795.0,0.6274,0.6302,0.6274,0.6301
2023-04-11 11:55,322,149,173,32510,21906,10604,20406560.0,13737345.0,6669214.0,291,129,162,30570,20302,10268,19200732.0,12731601.0,6469130.0,0.6271,0.6289,0.6271,0.63
2023-04-11 12:00,575,319,256,79057,62436,16621,49622180.0,39151968.0,10470212.0,554,308,246,79601,63216,16385,49963251.0,39641300.0,10321951.0,0.6271,0.6299,0.6271,0.63
2023-04-11 12:05,1652,888,764,220720,172632,48088,138563307.0,108260252.0,30303055.0,1625,871,754,220833,172772,48061,138622985.0,108327410.0,30295575.0,0.6271,0.6302,0.627,0.6304
2023-04-11 12:10,836,585,251,90385,72831,17554,56823405.0,45758436.0,11064968.0,816,572,244,89564,72583,16981,56314521.0,45600841.0,10713679.0,0.6283,0.6303,0.6283,0.6309
2023-04-11 12:15,161,106,55,16576,10745,5831,10426604.0,6747755.0,3678849.0,145,96,49,15925,10341,5584,10016874.0,6494546.0,3522327.0,0.628,0.6309,0.628,0.6308
2023-04-11 12:20,1332,1069,263,172237,152163,20074,108301857.0,95651556.0,12650300.0,1311,1057,254,171243,152092,19151,107686528.0,95603918.0,12082610.0,0.6286,0.6302,0.6286,0.6309
2023-04-11 12:25,675,393,282,42952,25277,17675,38328230.0,27214460.0,11113770.0,641,374,267,41793,24601,17192,37663904.0,26789971.0,10873932.0,1.0766,0.6288,1.089,0.6325
2023-04-11 12:30,318,157,161,17449,6975,10474,10986599.0,4380156.0,6606442.0,292,138,154,17188,6742,10446,10815929.0,4227272.0,6588657.0,0.628,0.6307,0.627,0.6307
2023-04-11 12:35,348,293,55,13140,8912,4228,19608955.0,16946598.0,2662356.0,316,269,47,12233,8456,3777,19025305.0,16643765.0,2381540.0,1.9015,0.6297,1.9683,0.6305
2023-04-11 12:40,392,117,275,26927,7290,19637,28257712.0,15903576.0,12354135.0,358,101,257,26816,7158,19658,28204643.0,15820627.0,12384015.0,2.1816,0.6291,2.2102,0.63
2023-04-11 12:45,305,79,226,20265,5524,14741,12750356.0,3468363.0,9281992.0,278,57,221,19503,4961,14542,12270951.0,3113420.0,9157531.0,0.6279,0.6297,0.6276,0.6297
2023-04-11 12:50,93,66,27,9226,7592,1634,17127656.0,16092378.0,1035277.0,81,58,23,9216,7688,1528,17113419.0,16147225.0,966194.0,2.1196,0.6336,2.1003,0.6323
2023-04-11 12:55,78,44,34,3939,2062,1877,2490061.0,1303217.0,1186844.0,65,32,33,3766,1769,1997,2372973.0,1110093.0,1262880.0,0.632,0.6323,0.6275,0.6324
2023-04-11 13:00,298,183,115,22869,14485,8384,14373689.0,9099653.0,5274036.0,271,164,107,21905,13641,8264,13785954.0,8566708.0,5219245.0,0.6282,0.6291,0.628,0.6316
2023-04-11 13:05,253,154,99,16435,9553,6882,10297434.0,5958297.0,4339137.0,233,144,89,14949,8280,6669,9387944.0,5180716.0,4207227.0,0.6237,0.6305,0.6257,0.6309
2023-04-11 13:10,479,265,214,34813,21198,13615,21904857.0,13326581.0,8578276.0,444,246,198,32430,19336,13094,20419308.0,12149956.0,8269352.0,0.6287,0.6301,0.6284,0.6315
2023-04-11 13:15,106,53,53,5692,2597,3095,3581918.0,1633189.0,1948729.0,75,32,43,5097,2250,2847,3208532.0,1412730.0,1795801.0,0.6289,0.6296,0.6279,0.6308
2023-04-11 13:20,140,59,81,9308,4494,4814,6371225.0,2824143.0,3547082.0,121,53,68,8767,4425,4342,5508431.0,2769422.0,2739009.0,0.6284,0.7368,0.6259,0.6308
2023-04-11 13:25,1898,1335,563,215896,166368,49528,170381804.0,139043812.0,31337991.0,1854,1310,544,213754,165071,48683,168865140.0,138061439.0,30803700.0,0.8358,0.6327,0.8364,0.6327
2023-04-11 13:30,1861,1588,273,226988,211469,15519,143159530.0,133335985.0,9823545.0,1851,1583,268,227714,212211,15503,143590129.0,133776698.0,9813431.0,0.6305,0.633,0.6304,0.633
2023-04-11 13:35,2684,1132,1552,303399,197577,105822,191911799.0,124520246.0,67391552.0,2646,1116,1530,301077,197292,103785,190441284.0,124343016.0,66098267.0,0.6302,0.6368,0.6302,0.6369
2023-04-11 13:40,641,103,538,62947,12017,50930,51024324.0,18872695.0,32151629.0,619,95,524,62830,12080,50750,50957245.0,18907694.0,32049551.0,1.5705,0.6313,1.5652,0.6315
2023-04-11 13:45,445,41,404,34512,1874,32638,21765099.0,1174641.0,20590458.0,422,24,398,33807,1512,32295,21321651.0,947079.0,20374571.0,0.6268,0.6309,0.6264,0.6309
2023-04-11 13:50,1480,162,1318,121924,10249,111675,76981190.0,6457063.0,70524126.0,1454,149,1305,121818,9943,111875,76896862.0,6252034.0,70644827.0,0.63,0.6315,0.6288,0.6315
2023-04-11 13:55,681,166,515,66818,18018,48800,42111816.0,11308948.0,30802867.0,662,151,511,66316,17767,48549,41782250.0,11140187.0,30642063.0,0.6276,0.6312,0.627,0.6312
2023-04-11 14:00,85,29,56,6148,1429,4719,3880299.0,899177.0,2981122.0,69,17,52,6160,1297,4863,3886012.0,813968.0,3072044.0,0.6292,0.6317,0.6276,0.6317
2023-04-11 14:05,2112,744,1368,221272,88228,133044,139267330.0,55396835.0,83870494.0,2087,728,1359,220182,88161,132021,138683499.0,55353475.0,83330023.0,0.6279,0.6304,0.6279,0.6312
2023-04-11 14:10,1880,773,1107,238429,97157,141272,217885431.0,128956916.0,88928515.0,1868,766,1102,235683,95966,139717,216152043.0,128184542.0,87967501.0,1.3273,0.6295,1.3357,0.6296
2023-04-11 14:15,494,105,389,38821,5092,33729,47060891.0,25851595.0,21209296.0,423,47,376,35090,3767,31323,44741709.0,25016406.0,19725302.0,5.0769,0.6288,6.6409,0.6297
2023-04-11 14:20,1455,95,1360,224810,3720,221090,152626367.0,13674566.0,138951801.0,1403,50,1353,224182,3176,221006,152216451.0,13316410.0,138900040.0,3.676,0.6285,4.1928,0.6285
2023-04-11 14:25,1235,165,1070,156390,10754,145636,98293597.0,6733519.0,91560077.0,1207,150,1057,155377,9869,145508,97667093.0,6181559.0,91485534.0,0.6261,0.6287,0.6264,0.6287
2023-04-11 14:30,1021,49,972,154218,3121,151097,97363778.0,1935468.0,95428310.0,1003,38,965,153181,1533,151648,96759708.0,958372.0,95801336.0,0.6201,0.6316,0.6252,0.6317
2023-04-11 14:35,1539,75,1464,212933,3846,209087,134238397.0,2404665.0,131833732.0,1527,68,1459,212384,4248,208136,133879046.0,2647435.0,131231610.0,0.6252,0.6305,0.6232,0.6305
2023-04-11 14:40,1267,28,1239,159515,573,158942,100344044.0,354556.0,99989487.0,1253,20,1233,158986,409,158577,100015840.0,254567.0,99761273.0,0.6188,0.6291,0.6224,0.6291
2023-04-11 14:45,1165,34,1131,164567,578,163989,103540467.0,362796.0,103177670.0,1145,25,1120,164372,504,163868,103450483.0,314701.0,103135781.0,0.6277,0.6292,0.6244,0.6294
2023-04-11 14:50,969,43,926,174574,4284,170290,109977673.0,2687203.0,107290470.0,962,45,917,174701,4769,169932,110047487.0,2982457.0,107065030.0,0.6273,0.63,0.6254,0.63
2023-04-11 14:55,898,20,878,153946,198,153748,96942456.0,123778.0,96818678.0,887,6,881,155138,70,155068,97695429.0,43722.0,97651707.0,0.6251,0.6297,0.6246,0.6297
2023-04-11 15:00,932,79,853,152653,3972,148681,107611024.0,13819409.0,93791615.0,886,51,835,150942,2249,148693,106545231.0,12739228.0,93806003.0,3.4792,0.6308,5.6644,0.6309
2023-04-11 15:05,1026,54,972,182128,2679,179449,115057481.0,1652106.0,113405375.0,1015,46,969,180018,989,179029,113760503.0,619615.0,113140888.0,0.6167,0.632,0.6265,0.632
2023-04-11 15:10,1354,169,1185,241344,8178,233166,152275681.0,5175256.0,147100425.0,1330,158,1172,240377,8322,232055,151601622.0,5198285.0,146403336.0,0.6328,0.6309,0.6246,0.6309
2023-04-11 15:15,862,87,775,143957,3331,140626,91108627.0,2088592.0,89020034.0,850,80,770,144510,3791,140719,91441909.0,2359479.0,89082429.0,0.627,0.633,0.6224,0.6331
2023-04-11 15:20,1235,37,1198,199767,648,199119,126153477.0,406016.0,125747460.0,1219,27,1192,199708,548,199160,126117294.0,343242.0,125774051.0,0.6266,0.6315,0.6264,0.6315
2023-04-11 15:25,1210,551,659,136447,27521,108926,97530459.0,28627906.0,68902553.0,1193,536,657,136141,27387,108754,97331548.0,28542606.0,68788941.0,1.0402,0.6326,1.0422,0.6325
2023-04-11 15:30,1164,741,423,98484,38089,60395,62132063.0,23961293.0,38170770.0,1157,735,422,98531,37919,60612,62146039.0,23835384.0,38310655.0,0.6291,0.632,0.6286,0.6321
2023-04-11 15:35,404,151,253,44145,7165,36980,27865166.0,4493594.0,23371571.0,385,141,244,43142,6621,36521,27239595.0,4159178.0,23080416.0,0.6272,0.632,0.6282,0.632
2023-04-11 15:40,234,16,218,16916,798,16118,10653752.0,500551.0,10153201.0,228,11,217,16666,522,16144,10497289.0,327662.0,10169627.0,0.6273,0.6299,0.6277,0.6299
2023-04-11 15:45,1840,219,1621,241059,10332,230727,152179293.0,6485846.0,145693447.0,1830,210,1620,240770,10203,230567,152000471.0,6404085.0,145596386.0,0.6277,0.6315,0.6277,0.6315
2023-04-11 15:50,258,80,178,22210,4106,18104,13991466.0,2577386.0,11414080.0,243,76,167,21064,3498,17566,13264738.0,2194013.0,11070725.0,0.6277,0.6305,0.6272,0.6302
2023-04-11 15:55,816,374,442,86708,18190,68518,54712898.0,11431264.0,43281633.0,807,371,436,86167,18250,67917,54365177.0,11463972.0,42901204.0,0.6284,0.6317,0.6282,0.6317
2023-04-11 16:00,1869,279,1590,253514,18397,235117,159715754.0,11547435.0,148168318.0,1847,269,1578,252889,17957,234932,159331701.0,11269329.0,148062372.0,0.6277,0.6302,0.6276,0.6302
2023-04-11 16:05,1096,53,1043,149860,3306,146554,105840871.0,13462406.0,92378465.0,1090,49,1041,150410,4121,146289,106117165.0,13912009.0,92205156.0,4.0721,0.6303,3.3759,0.6303
2023-04-11 16:10,2111,144,1967,338274,7599,330675,224227498.0,16089456.0,208138042.0,2088,139,1949,335721,7324,328397,222779534.0,15918355.0,206861179.0,2.1173,0.6294,2.1735,0.6299
2023-04-11 16:15,2622,228,2394,401570,14149,387421,253088325.0,9391507.0,243696817.0,2550,200,2350,389557,12404,377153,245419814.0,7743670.0,237676144.0,0.6638,0.629,0.6243,0.6302
2023-04-11 16:20,1682,84,1598,222781,2905,219876,139977087.0,1822661.0,138154426.0,1653,78,1575,218493,2264,216229,137141459.0,1406207.0,135735251.0,0.6274,0.6283,0.6211,0.6277
2023-04-11 16:25,226,48,178,23104,3920,19184,14470774.0,2440427.0,12030347.0,195,39,156,20188,3249,16939,12676736.0,2027767.0,10648968.0,0.6226,0.6271,0.6241,0.6287
2023-04-11 16:30,382,183,199,20736,5849,14887,35522340.0,26305493.0,9216847.0,337,163,174,18442,5333,13109,34192817.0,25986259.0,8206558.0,4.4974,0.6191,4.8727,0.626
2023-04-11 16:35,2602,658,1944,300048,35614,264434,333233817.0,170377992.0,162855824.0,2301,486,1815,284258,29855,254403,324058232.0,166792745.0,157265487.0,4.784,0.6159,5.5868,0.6182
2023-04-11 16:40,1142,293,849,144815,18181,126634,258524318.0,181600420.0,76923897.0,890,174,716,126231,13862,112369,247932110.0,178988177.0,68943933.0,9.9885,0.6075,12.9121,0.6135
2023-04-11 16:45,4591,2042,2549,601164,207243,393921,808266901.0,567691851.0,240575050.0,4317,1844,2473,587472,197893,389579,799404984.0,561763375.0,237641609.0,2.7393,0.6107,2.8387,0.61
2023-04-11 16:50,3344,612,2732,507309,59608,447701,446033167.0,172694139.0,273339028.0,3172,492,2680,494570,50431,444139,438102743.0,166815311.0,271287431.0,2.8972,0.6105,3.3078,0.6108
2023-04-11 16:55,5230,4702,528,1230200,1187892,42308,798845411.0,772258119.0,26587292.0,5126,4637,489,1225696,1185061,40635,796115392.0,770508615.0,25606777.0,0.6501,0.6284,0.6502,0.6302
2023-04-11 17:00,2603,580,2023,441346,83350,357996,293422102.0,73666467.0,219755634.0,2524,534,1990,439421,85306,354115,292322300.0,74817659.0,217504640.0,0.8838,0.6138,0.8771,0.6142
2023-04-11 17:05,4011,1607,2404,575014,143386,431628,444009173.0,178748460.0,265260712.0,3932,1541,2391,572332,140442,431890,442389298.0,176396403.0,265992895.0,1.2466,0.6146,1.256,0.6159
2023-04-11 17:10,3288,2618,670,415738,372881,42857,276873115.0,250483064.0,26390050.0,3232,2582,650,414447,371746,42701,276600511.0,250301051.0,26299459.0,0.6718,0.6158,0.6733,0.6159
2023-04-11 17:15,3409,1927,1482,401305,146626,254679,281468548.0,124140410.0,157328137.0,3324,1872,1452,394881,142791,252090,277341439.0,121586429.0,155755010.0,0.8466,0.6178,0.8515,0.6179
2023-04-11 17:20,429,311,118,25056,18346,6710,15482481.0,11328489.0,4153991.0,371,282,89,23058,17206,5852,14215333.0,10592509.0,3622823.0,0.6175,0.6191,0.6156,0.6191
2023-04-11 17:25,574,181,393,37132,8277,28855,23072812.0,5170784.0,17902027.0,532,152,380,35973,7421,28552,22297363.0,4576285.0,17721078.0,0.6247,0.6204,0.6167,0.6207
2023-04-11 17:30,465,160,305,29509,9047,20462,29603237.0,16920831.0,12682406.0,443,142,301,28602,8358,20244,29067968.0,16500804.0,12567163.0,1.8703,0.6198,1.9743,0.6208
2023-04-11 17:35,649,383,266,50961,25976,24985,42819035.0,27349250.0,15469784.0,617,369,248,49425,25286,24139,41919038.0,26922850.0,14996188.0,1.0529,0.6192,1.0647,0.6212
2023-04-11 17:40,698,257,441,72888,20031,52857,56376807.0,23663509.0,32713298.0,659,237,422,72550,20032,52518,56191791.0,23664854.0,32526936.0,1.1813,0.6189,1.1814,0.6193
2023-04-11 17:45,701,307,394,60080,16617,43463,48494265.0,21584677.0,26909588.0,671,288,383,59207,16491,42716,47928369.0,21491882.0,26436487.0,1.299,0.6191,1.3032,0.6189
2023-04-11 17:50,435,152,283,31697,10592,21105,30943168.0,17867396.0,13075772.0,405,123,282,30960,9774,21186,30484360.0,17352320.0,13132039.0,1.6869,0.6196,1.7754,0.6198
2023-04-11 17:55,1496,549,947,102596,28476,74120,63574598.0,17565416.0,46009181.0,1465,533,932,102760,28674,74086,63670035.0,17662991.0,46007043.0,0.6168,0.6207,0.616,0.621
2023-04-11 18:00,1861,295,1566,167856,14716,153140,103607410.0,9062349.0,94545060.0,1823,271,1552,166264,14218,152046,102652233.0,8748879.0,93903354.0,0.6158,0.6174,0.6153,0.6176
2023-04-11 18:05,1195,186,1009,143850,18575,125275,100605616.0,23326947.0,77278669.0,1161,163,998,155869,17875,137994,108460566.0,22313712.0,86146854.0,1.2558,0.6169,1.2483,0.6243
2023-04-11 18:10,2087,307,1780,301659,46791,254868,186005902.0,28720308.0,157285593.0,2058,290,1768,300115,46050,254065,185080093.0,28261747.0,156818346.0,0.6138,0.6171,0.6137,0.6172
2023-04-11 18:15,1369,189,1180,278305,28793,249512,171572252.0,17667868.0,153904384.0,1356,177,1179,278389,28820,249569,171622789.0,17683646.0,153939142.0,0.6136,0.6168,0.6136,0.6168
2023-04-11 18:20,549,118,431,82777,16192,66585,51019004.0,9936588.0,41082416.0,526,105,421,81399,15890,65509,50178427.0,9751952.0,40426474.0,0.6137,0.617,0.6137,0.6171
2023-04-11 18:25,863,258,605,89815,18437,71378,168231325.0,124563088.0,43668236.0,785,217,568,82415,15719,66696,164388857.0,123488502.0,40900354.0,6.7561,0.6118,7.856,0.6132
2023-04-11 18:30,4086,1603,2483,484159,162424,321735,544794198.0,347972137.0,196822060.0,4002,1541,2461,482176,161616,320560,543587551.0,347465182.0,196122368.0,2.1424,0.6118,2.1499,0.6118
2023-04-11 18:35,1140,664,476,119146,77776,41370,83799064.0,58573470.0,25225593.0,1093,645,448,117180,77072,40108,82626555.0,58144804.0,24481751.0,0.7531,0.6098,0.7544,0.6104
2023-04-12 10:00,2012,876,1136,186604,98112,88492,148286487.0,93899090.0,54387397.0,1708,708,1000,176843,93078,83765,135981763.0,84595132.0,51386630.0,0.9571,0.6146,0.9089,0.6135
2023-04-12 10:05,1317,427,890,167747,49497,118250,110576613.0,37469589.0,73107024.0,1183,347,836,166648,45248,121400,108544356.0,33420071.0,75124284.0,0.757,0.6182,0.7386,0.6188
2023-04-12 10:10,911,244,667,101634,27507,74127,73617200.0,28125911.0,45491289.0,773,197,576,94334,24480,69854,65180144.0,22177427.0,43002717.0,1.0225,0.6137,0.9059,0.6156
2023-04-12 10:15,4047,776,3271,657577,75236,582341,558824420.0,203982954.0,354841465.0,3821,620,3201,642654,66260,576394,550084905.0,198578104.0,351506801.0,2.7112,0.6093,2.997,0.6098
2023-04-12 10:20,1921,726,1195,254813,84240,170573,245574238.0,141382262.0,104191975.0,1781,635,1146,252176,83095,169081,244044900.0,140709521.0,103335379.0,1.6783,0.6108,1.6934,0.6112
2023-04-12 10:25,2435,902,1533,234708,88378,146330,210329678.0,121311706.0,89017971.0,2366,859,1507,233206,87692,145514,209419928.0,120889923.0,88530005.0,1.3726,0.6083,1.3786,0.6084
2023-04-12 10:30,1449,1189,260,153179,140240,12939,160619632.0,152742517.0,7877114.0,1396,1158,238,152141,139619,12522,159956770.0,152346632.0,7610138.0,1.0892,0.6088,1.0912,0.6077
2023-04-12 10:35,2946,1568,1378,382840,214185,168655,288926827.0,186168282.0,102758545.0,2833,1519,1314,374557,210962,163595,283750813.0,183999833.0,99750979.0,0.8692,0.6093,0.8722,0.6097
2023-04-12 10:40,3136,1081,2055,436816,95951,340865,288754122.0,80680128.0,208073993.0,3064,1038,2026,434030,94425,339605,287029674.0,79722464.0,207307210.0,0.8408,0.6104,0.8443,0.6104
2023-04-12 10:45,2799,902,1897,248254,93411,154843,161769627.0,67712092.0,94057534.0,2760,880,1880,247006,92646,154360,161007243.0,67260755.0,93746488.0,0.7249,0.6074,0.726,0.6073
2023-04-12 10:50,2026,802,1224,172533,73714,98819,138589576.0,78560478.0,60029098.0,1954,748,1206,170543,72722,97821,137472139.0,77952180.0,59519958.0,1.0657,0.6075,1.0719,0.6085
2023-04-12 10:55,2002,301,1701,284618,16468,268150,240700533.0,77944447.0,162756086.0,1915,250,1665,280627,14718,265909,238310321.0,76882746.0,161427575.0,4.7331,0.607,5.2237,0.6071
2023-04-12 11:00,901,248,653,76118,9815,66303,46439385.0,5952889.0,40486495.0,852,221,631,75426,9831,65595,45977550.0,5920955.0,40056595.0,0.6065,0.6106,0.6023,0.6107
2023-04-12 11:05,210,107,103,15553,6850,8703,9456705.0,4152444.0,5304260.0,170,80,90,12845,4732,8113,7796908.0,2850838.0,4946070.0,0.6062,0.6095,0.6025,0.6096
2023-04-12 11:10,89,51,38,6562,2129,4433,4046738.0,1282394.0,2764344.0,50,27,23,3963,1544,2419,2405996.0,932945.0,1473051.0,0.6023,0.6236,0.6042,0.609
2023-04-12 11:15,61,42,19,3361,2703,658,2047566.0,1633064.0,414502.0,33,24,9,2068,1535,533,1256816.0,930582.0,326234.0,0.6042,0.6299,0.6062,0.6121
2023-04-12 11:20,338,241,97,22377,9580,12797,13645184.0,5792197.0,7852987.0,310,227,83,23815,11009,12806,14495761.0,6632365.0,7863396.0,0.6046,0.6137,0.6024,0.614
2023-04-12 11:25,1470,337,1133,142504,14414,128090,86714811.0,8724936.0,77989875.0,1472,346,1126,142349,14516,127833,86665685.0,8785991.0,77879694.0,0.6053,0.6089,0.6053,0.6092
2023-04-12 11:30,3618,691,2927,396536,27567,368969,241595205.0,16637815.0,224957390.0,3600,683,2917,394264,26588,367676,240145989.0,16087678.0,224058310.0,0.6035,0.6097,0.6051,0.6094
2023-04-12 11:35,816,281,535,63453,16879,46574,38723998.0,10228019.0,28495979.0,799,273,526,63900,17831,46069,38941410.0,10756821.0,28184588.0,0.606,0.6118,0.6033,0.6118
2023-04-12 11:40,366,288,78,22618,17236,5382,13752965.0,10449604.0,3303361.0,342,269,73,22171,17059,5112,13472141.0,10340450.0,3131691.0,0.6063,0.6138,0.6062,0.6126
2023-04-12 11:45,2515,1502,1013,368093,145191,222902,269829016.0,133664595.0,136164420.0,2456,1471,985,362574,140895,221679,266368908.0,130931342.0,135437566.0,0.9206,0.6109,0.9293,0.611
2023-04-12 11:50,1285,970,315,127263,107923,19340,88818237.0,76995949.0,11822288.0,1248,961,287,126617,107876,18741,88398999.0,76933720.0,11465279.0,0.7134,0.6113,0.7132,0.6118
2023-04-12 11:55,749,577,172,77177,71849,5328,58233082.0,54966934.0,3266147.0,727,562,165,76733,71593,5140,57982466.0,54812297.0,3170169.0,0.765,0.613,0.7656,0.6168
2023-04-12 12:00,3158,2293,865,395285,325271,70014,342059421.0,299355557.0,42703864.0,3117,2272,845,392747,324840,67907,340573411.0,299091727.0,41481683.0,0.9203,0.6099,0.9207,0.6109
2023-04-12 12:05,2929,1859,1070,375113,305350,69763,250451057.0,207888985.0,42562071.0,2905,1840,1065,373775,304508,69267,249625249.0,207366622.0,42258627.0,0.6808,0.6101,0.681,0.6101
2023-04-12 12:10,3330,2361,969,474899,421527,53372,288097333.0,255584313.0,32513020.0,3301,2355,946,474784,421533,53251,288033014.0,255583874.0,32449139.0,0.6063,0.6092,0.6063,0.6094
2023-04-12 12:15,2149,1263,886,248733,198427,50306,150985880.0,120313379.0,30672500.0,2139,1256,883,248581,198120,50461,150895195.0,120125130.0,30770065.0,0.6063,0.6097,0.6063,0.6098
2023-04-12 12:20,2592,1116,1476,324400,163841,160559,219936040.0,121997997.0,97938042.0,2567,1102,1465,324063,164112,159951,219764240.0,122166392.0,97597847.0,0.7446,0.61,0.7444,0.6102
2023-04-12 12:25,2587,1361,1226,269932,135541,134391,175470703.0,93519622.0,81951081.0,2559,1342,1217,269254,135540,133714,175071080.0,93518510.0,81552569.0,0.69,0.6098,0.69,0.6099
2023-04-12 12:30,4005,2117,1888,455044,221584,233460,299428979.0,157026449.0,142402530.0,3992,2106,1886,454226,221107,233119,298922742.0,156725458.0,142197284.0,0.7087,0.61,0.7088,0.61
2023-04-12 12:35,2061,1279,782,203680,119238,84442,146499769.0,95026149.0,51473619.0,2042,1268,774,202767,118771,83996,145942607.0,94736153.0,51206454.0,0.7969,0.6096,0.7976,0.6096
2023-04-12 12:40,3069,2317,752,332516,241438,91078,202084448.0,146496760.0,55587687.0,3057,2307,750,333037,241997,91040,202389696.0,146827109.0,55562587.0,0.6068,0.6103,0.6067,0.6103
2023-04-12 12:45,2900,2234,666,285450,223213,62237,173240506.0,135306556.0,37933949.0,2881,2222,659,285742,223514,62228,173417119.0,135486771.0,37930348.0,0.6062,0.6095,0.6062,0.6095
2023-04-12 12:50,2243,1637,606,200665,147831,52834,121726950.0,89550906.0,32176044.0,2235,1630,605,200416,147480,52936,121602061.0,89337952.0,32264108.0,0.6058,0.609,0.6058,0.6095
2023-04-12 12:55,841,713,128,62256,53360,8896,49169290.0,43734916.0,5434374.0,810,689,121,60803,52486,8317,48279398.0,43200826.0,5078571.0,0.8196,0.6109,0.8231,0.6106
2023-04-12 13:00,323,152,171,28044,10524,17520,28469381.0,17754803.0,10714578.0,291,130,161,27291,9900,17391,27991999.0,17354509.0,10637489.0,1.6871,0.6116,1.753,0.6117
2023-04-12 13:05,359,128,231,29961,8125,21836,18289801.0,4948272.0,13341529.0,336,115,221,28590,7512,21078,17479699.0,4563297.0,12916401.0,0.609,0.611,0.6075,0.6128
2023-04-12 13:10,281,111,170,23311,7723,15588,25616268.0,16046147.0,9570120.0,256,97,159,23104,7502,15602,25479304.0,15899900.0,9579403.0,2.0777,0.6139,2.1194,0.614
2023-04-12 13:15,382,270,112,25193,16182,9011,15419296.0,9902950.0,5516345.0,347,256,91,24664,16439,8225,15106077.0,10056275.0,5049802.0,0.612,0.6122,0.6117,0.614
2023-04-12 13:20,869,508,361,99074,62696,36378,71761547.0,49492524.0,22269022.0,851,497,354,97730,62084,35646,70940381.0,49119620.0,21820760.0,0.7894,0.6122,0.7912,0.6122
2023-04-12 13:25,492,321,171,32248,20329,11919,19712823.0,12415780.0,7297042.0,481,311,170,32045,20162,11883,19585061.0,12310185.0,7274876.0,0.6107,0.6122,0.6106,0.6122
2023-04-12 13:30,1596,1305,291,146252,111830,34422,112191164.0,91068259.0,21122905.0,1519,1247,272,144161,110032,34129,110801930.0,89860260.0,20941670.0,0.8143,0.6136,0.8167,0.6136
2023-04-12 13:35,1964,1845,119,204098,195764,8334,124823622.0,119674813.0,5148808.0,1911,1819,92,202173,195216,6957,123630819.0,119333693.0,4297126.0,0.6113,0.6178,0.6113,0.6177
2023-04-12 13:40,2278,1672,606,243691,183850,59841,160343185.0,123640164.0,36703021.0,2234,1643,591,243427,183875,59552,160194646.0,123654807.0,36539838.0,0.6725,0.6133,0.6725,0.6136
2023-04-12 13:45,634,235,399,61680,20192,41488,37781564.0,12336306.0,25445257.0,617,220,397,61103,19773,41330,37429296.0,12081240.0,25348056.0,0.611,0.6133,0.611,0.6133
2023-04-12 13:50,1284,538,746,111450,55678,55772,79594516.0,45370745.0,34223771.0,1263,523,740,106422,50466,55956,76521081.0,42186163.0,34334917.0,0.8149,0.6136,0.8359,0.6136
2023-04-12 13:55,275,40,235,15750,1578,14172,9667608.0,963987.0,8703621.0,252,24,228,15472,1548,13924,9493564.0,946720.0,8546843.0,0.6109,0.6141,0.6116,0.6138
2023-04-12 14:00,111,48,63,7559,2049,5510,4627455.0,1253108.0,3374347.0,83,28,55,7353,2001,5352,4517170.0,1223265.0,3293905.0,0.6116,0.6124,0.6113,0.6155
2023-04-12 14:05,801,477,324,67441,30810,36631,41385346.0,18859491.0,22525854.0,788,466,322,66384,30138,36246,40725231.0,18436195.0,22289036.0,0.6121,0.6149,0.6117,0.6149
2023-04-12 14:10,1655,1097,558,131515,82044,49471,92001946.0,61584771.0,30417174.0,1621,1074,547,130892,81467,49425,91626176.0,61224401.0,30401775.0,0.7506,0.6148,0.7515,0.6151
2023-04-12 14:15,622,315,307,44100,23855,20245,27074574.0,14621778.0,12452796.0,589,290,299,43065,23704,19361,26439317.0,14530339.0,11908978.0,0.6129,0.6151,0.613,0.6151
2023-04-12 14:20,557,465,92,64695,53541,11154,39612043.0,32749714.0,6862328.0,535,458,77,63935,53056,10879,39142806.0,32450682.0,6692124.0,0.6117,0.6152,0.6116,0.6151
2023-04-12 14:25,154,91,63,13613,9108,4505,8332663.0,5572776.0,2759887.0,137,85,52,13044,9028,4016,7994162.0,5523437.0,2470725.0,0.6119,0.6126,0.6118,0.6152
2023-04-12 14:30,998,434,564,103408,55414,47994,85969410.0,56557803.0,29411607.0,974,420,554,103108,55312,47796,85825393.0,56494355.0,29331038.0,1.0206,0.6128,1.0214,0.6137
2023-04-12 14:35,715,275,440,60168,30761,29407,36865075.0,18814997.0,18050077.0,691,259,432,59666,30369,29297,36533985.0,18562448.0,17971537.0,0.6117,0.6138,0.6112,0.6134
2023-04-12 14:40,1054,602,452,106229,74024,32205,76359769.0,56586735.0,19773033.0,1041,596,445,105960,74009,31951,76190430.0,56576388.0,19614041.0,0.7644,0.614,0.7645,0.6139
2023-04-12 14:45,884,492,392,75287,46938,28349,46140260.0,28727866.0,17412393.0,877,489,388,75030,46773,28257,45955828.0,28598351.0,17357476.0,0.612,0.6142,0.6114,0.6143
2023-04-12 14:50,1064,750,314,81160,67630,13530,49685903.0,41369536.0,8316367.0,1046,740,306,80895,67305,13590,49515173.0,41161432.0,8353740.0,0.6117,0.6147,0.6116,0.6147
2023-04-12 14:55,434,277,157,34023,23040,10983,20861916.0,14090892.0,6771024.0,420,271,149,33052,22852,10200,20257980.0,13975935.0,6282045.0,0.6116,0.6165,0.6116,0.6159
2023-04-12 15:00,779,130,649,100372,12178,88194,72646064.0,18766362.0,53879701.0,737,113,624,97382,11674,85708,70949478.0,18458866.0,52490612.0,1.541,0.6109,1.5812,0.6124
2023-04-12 15:05,26,11,15,1080,260,820,663333.0,161066.0,502266.0,25,12,13,4359,3582,777,2596170.0,2120289.0,475880.0,0.6195,0.6125,0.5919,0.6125
2023-04-12 15:10,26,13,13,1169,295,874,716384.0,180060.0,536324.0,22,11,11,1122,291,831,687958.0,177615.0,510342.0,0.6104,0.6136,0.6104,0.6141
2023-04-12 15:15,48,38,10,2111,1602,509,1294223.0,983518.0,310704.0,25,18,7,1840,1387,453,1125013.0,847696.0,277317.0,0.6139,0.6104,0.6112,0.6122
2023-04-12 15:20,41,34,7,1578,1400,178,965919.0,856886.0,109032.0,32,27,5,1681,1514,167,1026379.0,923099.0,103279.0,0.6121,0.6125,0.6097,0.6184
2023-04-12 15:25,40,35,5,1189,1008,181,723769.0,616762.0,107006.0,26,23,3,1163,1024,139,709892.0,624772.0,85119.0,0.6119,0.5912,0.6101,0.6124
2023-04-12 15:30,196,45,151,11881,1457,10424,18603098.0,12224305.0,6378793.0,187,40,147,11713,1391,10322,18507971.0,12182817.0,6325154.0,8.3901,0.6119,8.7583,0.6128
2023-04-12 15:35,103,59,44,7165,2622,4543,4386103.0,1599615.0,2786487.0,107,42,65,8097,2063,6034,4981306.0,1259098.0,3722208.0,0.6101,0.6134,0.6103,0.6169
2023-04-12 15:40,94,39,55,4980,1640,3340,3047890.0,1006531.0,2041358.0,74,27,47,5230,1975,3255,3196174.0,1205254.0,1990919.0,0.6137,0.6112,0.6103,0.6116
2023-04-12 15:45,73,42,31,2714,1120,1594,1649870.0,686888.0,962981.0,48,27,21,2337,1037,1300,1431791.0,632932.0,798858.0,0.6133,0.6041,0.6103,0.6145
2023-04-12 15:50,66,36,30,2875,1357,1518,1751980.0,831895.0,920085.0,57,29,28,3148,1357,1791,1926176.0,827078.0,1099097.0,0.613,0.6061,0.6095,0.6137
2023-04-12 15:55,171,30,141,18595,1486,17109,22817838.0,12264201.0,10553637.0,161,21,140,17573,1076,16497,22166370.0,11990224.0,10176146.0,8.2532,0.6168,11.1433,0.6168
2023-04-12 16:00,52,8,44,3660,318,3342,2238646.0,194675.0,2043970.0,48,5,43,3544,205,3339,2170102.0,125118.0,2044984.0,0.6122,0.6116,0.6103,0.6125
2023-04-12 16:05,48,32,16,2667,1439,1228,1629880.0,877926.0,751954.0,44,28,16,2926,1710,1216,1778602.0,1033704.0,744897.0,0.6101,0.6123,0.6045,0.6126
2023-04-12 16:10,58,28,30,2850,874,1976,1741668.0,533603.0,1208065.0,45,21,24,2778,829,1949,1697204.0,505624.0,1191580.0,0.6105,0.6114,0.6099,0.6114
2023-04-12 16:15,50,27,23,2274,642,1632,1388238.0,390923.0,997315.0,43,20,23,2200,614,1586,1343638.0,374449.0,969188.0,0.6089,0.6111,0.6099,0.6111
2023-04-12 16:20,85,29,56,7186,1231,5955,4292181.0,751883.0,3540298.0,97,11,86,6570,451,6119,4052239.0,274907.0,3777332.0,0.6108,0.5945,0.6096,0.6173
2023-04-12 16:25,115,40,75,6890,2905,3985,4198883.0,1767535.0,2431348.0,59,28,31,4391,2496,1895,2681897.0,1518427.0,1163470.0,0.6084,0.6101,0.6083,0.614
2023-04-12 16:30,148,33,115,9964,1536,8428,6070767.0,935865.0,5134901.0,133,22,111,9460,1376,8084,5778096.0,838693.0,4939403.0,0.6093,0.6093,0.6095,0.611
2023-04-12 16:35,63,15,48,4613,863,3750,2822375.0,528994.0,2293381.0,49,4,45,3954,242,3712,2417901.0,147578.0,2270322.0,0.613,0.6116,0.6098,0.6116
2023-04-12 16:40,48,17,31,6710,237,6473,4157816.0,145015.0,4012801.0,36,6,30,6694,114,6580,4141731.0,69528.0,4072203.0,0.6119,0.6199,0.6099,0.6189
2023-04-12 16:45,265,32,233,51023,1659,49364,31289301.0,1021660.0,30267641.0,251,20,231,45496,1229,44267,27913031.0,747538.0,27165493.0,0.6158,0.6132,0.6082,0.6137
2023-04-12 16:50,655,147,508,58767,6771,51996,35939144.0,4127582.0,31811561.0,630,131,499,57998,6631,51367,35490659.0,4038769.0,31451889.0,0.6096,0.6118,0.6091,0.6123
2023-04-12 16:55,65,6,59,4401,175,4226,2691737.0,107602.0,2584135.0,51,6,45,4416,194,4222,2705525.0,118160.0,2587365.0,0.6149,0.6115,0.6091,0.6128
2023-04-12 17:00,439,62,377,40140,2439,37701,35835268.0,12807110.0,23028158.0,400,40,360,39710,1766,37944,35597068.0,12403141.0,23193926.0,5.251,0.6108,7.0233,0.6113
2023-04-12 17:05,147,35,112,16944,592,16352,10353886.0,360858.0,9993028.0,139,31,108,17047,1073,15974,10409077.0,648814.0,9760263.0,0.6096,0.6111,0.6047,0.611
2023-04-12 17:10,648,33,615,90435,1194,89241,77788660.0,23402339.0,54386320.0,618,8,610,89664,998,88666,77385623.0,23256864.0,54128758.0,19.5999,0.6094,23.3035,0.6105
2023-04-12 17:15,645,156,489,123546,23912,99634,75566381.0,14633628.0,60932753.0,626,148,478,121662,22343,99319,74317705.0,13575745.0,60741959.0,0.612,0.6116,0.6076,0.6116
2023-04-12 17:20,2170,548,1622,281710,121869,159841,216750698.0,119267909.0,97482788.0,2132,528,1604,279395,121183,158212,215450222.0,118850204.0,96600017.0,0.9787,0.6099,0.9807,0.6106
2023-04-12 17:25,2112,390,1722,248956,119681,129275,162793351.0,83925223.0,78868128.0,2086,374,1712,246704,118538,128166,161413024.0,83229021.0,78184003.0,0.7012,0.6101,0.7021,0.61
2023-04-12 17:30,872,30,842,61351,12759,48592,36835466.0,7234148.0,29601318.0,854,26,828,61187,12536,48651,36739085.0,7098156.0,29640928.0,0.567,0.6092,0.5662,0.6093
2023-04-12 17:35,1091,401,690,95102,52424,42678,69343769.0,43307162.0,26036607.0,1065,379,686,78285,35729,42556,59030480.0,33065557.0,25964923.0,0.8261,0.6101,0.9255,0.6101
2023-04-12 17:40,228,114,114,10942,5042,5900,6675747.0,3080750.0,3594996.0,198,101,97,10560,4742,5818,6435720.0,2885457.0,3550263.0,0.611,0.6093,0.6085,0.6102
2023-04-12 17:45,432,187,245,43165,26809,16356,26337501.0,16347880.0,9989621.0,413,180,233,42438,26866,15572,25852981.0,16344739.0,9508241.0,0.6098,0.6108,0.6084,0.6106
2023-04-12 17:50,129,64,65,8005,5422,2583,4865799.0,3286682.0,1579117.0,108,58,50,22743,20151,2592,13854447.0,12269673.0,1584774.0,0.6062,0.6114,0.6089,0.6114
2023-04-12 17:55,370,251,119,30916,23786,7130,18728179.0,14386962.0,4341217.0,365,242,123,30903,23692,7211,18742820.0,14330376.0,4412443.0,0.6049,0.6089,0.6049,0.6119
2023-04-12 18:00,297,143,154,22969,10432,12537,13992853.0,6335664.0,7657188.0,292,143,149,23949,11592,12357,14570051.0,7017958.0,7552092.0,0.6073,0.6108,0.6054,0.6112
2023-04-12 18:05,298,32,266,63590,3275,60315,39072241.0,1984548.0,37087692.0,285,26,259,63238,2827,60411,38870055.0,1712565.0,37157489.0,0.606,0.6149,0.6058,0.6151
2023-04-12 18:10,798,414,384,109631,57664,51967,78066568.0,46328280.0,31738288.0,767,396,371,108212,57871,50341,77277702.0,46453619.0,30824082.0,0.8034,0.6107,0.8027,0.6123
2023-04-12 18:15,1076,404,672,137890,42458,95432,84228156.0,25772662.0,58455493.0,1053,385,668,137275,41618,95657,83865403.0,25263873.0,58601529.0,0.607,0.6125,0.607,0.6126
2023-04-12 18:20,672,393,279,75278,56051,19227,45702681.0,34006768.0,11695912.0,657,383,274,73334,54649,18685,44552054.0,33165252.0,11386802.0,0.6067,0.6083,0.6069,0.6094
2023-04-12 18:25,333,80,253,29887,5548,24339,29540567.0,14702851.0,14837715.0,316,68,248,29395,5348,24047,29235623.0,14577749.0,14657874.0,2.6501,0.6096,2.7258,0.6096
2023-04-12 18:30,131,30,101,13856,1551,12305,8467128.0,945385.0,7521742.0,122,22,100,13389,1362,12027,8178038.0,822893.0,7355145.0,0.6095,0.6113,0.6042,0.6116
2023-04-12 18:35,711,247,464,116348,16932,99416,82475717.0,21622619.0,60853097.0,691,237,454,116016,16885,99131,82343361.0,21591413.0,60751948.0,1.277,0.6121,1.2787,0.6128
2023-04-13 10:00,6628,3727,2901,726026,403516,322510,716053611.0,516352422.0,199701189.0,5254,2994,2260,641594,360130,281464,656085721.0,481337330.0,174748391.0,1.2796,0.6192,1.3366,0.6209
2023-04-13 10:05,3708,1939,1769,335811,146412,189399,344408201.0,226790716.0,117617485.0,2832,1445,1387,292127,129519,162608,312762847.0,211270151.0,101492695.0,1.549,0.621,1.6312,0.6242
2023-04-13 10:10,6790,4551,2239,845770,654238,191532,960070188.0,840066191.0,120003997.0,5291,3857,1434,757034,606377,150657,903609926.0,808553614.0,95056311.0,1.284,0.6265,1.3334,0.6309
2023-04-13 10:15,4868,2053,2815,458473,135590,322883,503399044.0,300598875.0,202800169.0,3802,1514,2288,415727,114276,301451,476981957.0,286957204.0,190024752.0,2.217,0.6281,2.5111,0.6304
2023-04-13 10:20,4306,1502,2804,511909,100859,411050,659460681.0,402437429.0,257023252.0,3509,1049,2460,454420,81869,372551,623239526.0,390673141.0,232566385.0,3.9901,0.6253,4.7719,0.6243
2023-04-13 10:25,2124,866,1258,213130,64626,148504,178014048.0,85497142.0,92516905.0,1851,763,1088,200713,58205,142508,170331852.0,81439964.0,88891887.0,1.323,0.623,1.3992,0.6238
2023-04-13 10:30,1514,881,633,126461,56730,69731,135462152.0,92021892.0,43440259.0,1333,783,550,134191,54025,80166,141128382.0,90104335.0,51024046.0,1.6221,0.623,1.6678,0.6365
2023-04-13 10:35,1714,1138,576,138940,80496,58444,97710235.0,61304436.0,36405798.0,1613,1079,534,133250,77335,55915,94216298.0,59346769.0,34869528.0,0.7616,0.6229,0.7674,0.6236
2023-04-13 10:40,2820,810,2010,377384,61752,315632,301511271.0,106166476.0,195344794.0,2636,652,1984,366709,57401,309308,295331282.0,103452541.0,191878741.0,1.7192,0.6189,1.8023,0.6203
2023-04-13 10:45,2605,378,2227,431078,19821,411257,289584024.0,34909105.0,254674919.0,2436,278,2158,426692,15922,410770,286910810.0,32469875.0,254440935.0,1.7612,0.6193,2.0393,0.6194
2023-04-13 10:50,1394,423,971,177852,31268,146584,155456817.0,64694792.0,90762025.0,1312,367,945,174846,29321,145525,153641159.0,63402088.0,90239071.0,2.069,0.6192,2.1623,0.6201
2023-04-13 10:55,1375,568,807,108289,43328,64961,100672834.0,60709216.0,39963617.0,1231,485,746,99992,38815,61177,95640726.0,57863565.0,37777161.0,1.4012,0.6152,1.4908,0.6175
2023-04-13 11:00,3208,1063,2145,404679,56491,348188,284290684.0,68783474.0,215507210.0,3135,1008,2127,400810,55332,345478,281837411.0,68027605.0,213809805.0,1.2176,0.6189,1.2294,0.6189
2023-04-13 11:05,2280,947,1333,227375,45878,181497,174458451.0,62256934.0,112201516.0,2221,926,1295,226067,45833,180234,173668574.0,62206201.0,111462373.0,1.357,0.6182,1.3572,0.6184
2023-04-13 11:10,1252,807,445,85982,47117,38865,64525598.0,40415477.0,24110121.0,1183,777,406,80493,45852,34641,61017225.0,39559248.0,21457976.0,0.8578,0.6204,0.8628,0.6194
2023-04-13 11:15,2331,565,1766,320504,35664,284840,209031674.0,33270236.0,175761437.0,2273,533,1740,316223,32697,283526,206496647.0,31434872.0,175061774.0,0.9329,0.6171,0.9614,0.6174
2023-04-13 11:20,1746,1141,605,194272,146507,47765,131173360.0,101696544.0,29476816.0,1681,1114,567,194226,144805,49421,130951635.0,100378362.0,30573273.0,0.6941,0.6171,0.6932,0.6186
2023-04-13 11:25,851,506,345,58381,34181,24200,36038572.0,21045542.0,14993030.0,794,476,318,54442,33860,20582,33587689.0,20840712.0,12746977.0,0.6157,0.6195,0.6155,0.6193
2023-04-13 11:30,1188,800,388,136567,114018,22549,95751151.0,81764580.0,13986570.0,1112,760,352,135289,111965,23324,94921698.0,80439042.0,14482655.0,0.7171,0.6203,0.7184,0.6209
2023-04-13 11:35,1710,1336,374,198948,178944,20004,134038328.0,121749913.0,12288415.0,1651,1307,344,195115,177258,17857,131750455.0,120686069.0,11064385.0,0.6804,0.6143,0.6808,0.6196
2023-04-13 11:40,633,298,335,51476,30555,20921,43184550.0,30222647.0,12961903.0,608,288,320,49946,29988,19958,42180199.0,29825735.0,12354464.0,0.9891,0.6196,0.9946,0.619
2023-04-13 11:45,892,698,194,112865,102400,10465,69703614.0,63281859.0,6421755.0,846,678,168,110366,101114,9252,68137404.0,62397256.0,5740148.0,0.618,0.6136,0.6171,0.6204
2023-04-13 11:50,3423,2810,613,436968,388114,48854,486751003.0,456149849.0,30601153.0,3194,2714,480,415495,379397,36098,472964871.0,450393388.0,22571483.0,1.1753,0.6264,1.1871,0.6253
2023-04-13 11:55,1959,828,1131,202162,97802,104360,148217006.0,83397277.0,64819728.0,1803,756,1047,193949,94438,99511,143287431.0,81199862.0,62087569.0,0.8527,0.6211,0.8598,0.6239
2023-04-13 12:00,2339,565,1774,326249,51492,274757,247075886.0,77058523.0,170017362.0,2250,505,1745,319008,48226,270782,243033742.0,75034929.0,167998812.0,1.4965,0.6188,1.5559,0.6204
2023-04-13 12:05,1862,435,1427,241364,18997,222367,171964960.0,34365042.0,137599917.0,1809,405,1404,239017,17773,221244,170557687.0,33610452.0,136947235.0,1.809,0.6188,1.8911,0.619
2023-04-13 12:10,2123,376,1747,326724,21090,305634,247800277.0,58357158.0,189443119.0,2093,377,1716,330430,21075,309355,250144663.0,58315262.0,191829401.0,2.7671,0.6198,2.767,0.6201
2023-04-13 12:15,1453,209,1244,216575,9497,207078,133635327.0,5874179.0,127761147.0,1396,169,1227,213352,8735,204617,131739048.0,5363832.0,126375215.0,0.6185,0.617,0.6141,0.6176
2023-04-13 12:20,888,418,470,60517,21912,38605,37394801.0,13510744.0,23884056.0,837,389,448,58587,21170,37417,36180534.0,13035985.0,23144549.0,0.6166,0.6187,0.6158,0.6186
2023-04-13 12:25,765,480,285,59304,27604,31700,47971155.0,28379171.0,19591984.0,725,456,269,57948,26742,31206,47099743.0,27815792.0,19283951.0,1.0281,0.618,1.0402,0.618
2023-04-13 12:30,132,97,35,11783,5198,6585,7532180.0,3211974.0,4320206.0,123,95,28,11253,5019,6234,7187743.0,3088481.0,4099262.0,0.6179,0.6561,0.6154,0.6576
2023-04-13 12:35,742,640,102,40338,30530,9808,47664775.0,41573523.0,6091252.0,698,619,79,38361,29236,9125,46352774.0,40686649.0,5666125.0,1.3617,0.621,1.3917,0.6209
2023-04-13 12:40,83,61,22,5806,4383,1423,3579416.0,2692974.0,886442.0,70,50,20,5442,4424,1018,3347363.0,2716126.0,631236.0,0.6144,0.6229,0.614,0.6201
2023-04-13 12:45,281,188,93,19408,12843,6565,11991619.0,7923691.0,4067928.0,272,177,95,19849,12727,7122,12282473.0,7849369.0,4433104.0,0.617,0.6196,0.6167,0.6225
2023-04-13 12:50,270,45,225,18774,4253,14521,11607861.0,2629140.0,8978720.0,252,38,214,17749,3772,13977,10967567.0,2322982.0,8644585.0,0.6182,0.6183,0.6158,0.6185
2023-04-13 12:55,891,395,496,82174,26366,55808,51003128.0,16350518.0,34652610.0,874,395,479,80938,25817,55121,50159138.0,15937189.0,34221948.0,0.6201,0.6209,0.6173,0.6209
2023-04-13 13:00,1822,739,1083,186318,66706,119612,137977379.0,63858856.0,74118523.0,1783,717,1066,184272,65867,118405,136701614.0,63305134.0,73396480.0,0.9573,0.6197,0.9611,0.6199
2023-04-13 13:05,2977,973,2004,374136,96563,277573,242552753.0,70809559.0,171743194.0,2931,939,1992,371713,96040,275673,241181199.0,70502315.0,170678883.0,0.7333,0.6187,0.7341,0.6191
2023-04-13 13:10,3187,700,2487,428037,61037,367000,297571113.0,71461964.0,226109149.0,3026,589,2437,418300,55823,362477,291819060.0,68266606.0,223552454.0,1.1708,0.6161,1.2229,0.6167
2023-04-13 13:15,2451,951,1500,344221,87452,256769,290954711.0,133094646.0,157860064.0,2263,837,1426,328328,79654,248674,281407012.0,128192394.0,153214618.0,1.5219,0.6148,1.6094,0.6161
2023-04-13 13:20,2402,350,2052,408590,19892,388698,295793076.0,57469066.0,238324010.0,2272,271,2001,398677,14609,384068,290102084.0,54244696.0,235857388.0,2.8891,0.6131,3.7131,0.6141
2023-04-13 13:25,1820,628,1192,202960,32018,170942,135762680.0,30731716.0,105030964.0,1767,595,1172,201649,30923,170726,135090931.0,30174821.0,104916109.0,0.9598,0.6144,0.9758,0.6145
2023-04-13 13:30,4461,3624,837,890917,814832,76085,625569610.0,578662621.0,46906988.0,4345,3567,778,881350,808369,72981,619569087.0,574574787.0,44994300.0,0.7102,0.6165,0.7108,0.6165
2023-04-13 13:35,2118,1371,747,374005,318154,55851,240448066.0,206111000.0,34337066.0,2092,1347,745,372884,317637,55247,239772784.0,205793025.0,33979759.0,0.6478,0.6148,0.6479,0.6151
2023-04-13 13:40,863,419,444,117255,85288,31967,71845687.0,52205014.0,19640672.0,831,397,434,117245,85481,31764,71885578.0,52323734.0,19561844.0,0.6121,0.6144,0.6121,0.6158
2023-04-13 13:45,272,89,183,28711,10404,18307,28942047.0,17717683.0,11224364.0,234,70,164,22956,8156,14800,25463439.0,16327488.0,9135951.0,1.703,0.6131,2.0019,0.6173
2023-04-13 13:50,73,17,56,5597,416,5181,3404295.0,257288.0,3147006.0,56,13,43,5232,1774,3458,3220575.0,1082229.0,2138346.0,0.6185,0.6074,0.6101,0.6184
2023-04-13 13:55,44,13,31,1895,487,1408,1131384.0,302243.0,829140.0,29,7,22,870,49,821,541032.0,29774.0,511258.0,0.6206,0.5889,0.6076,0.6227
2023-04-13 14:00,436,93,343,53494,15838,37656,44165598.0,21026579.0,23139019.0,406,75,331,48712,14205,34507,41230185.0,20020038.0,21210147.0,1.3276,0.6145,1.4094,0.6147
2023-04-13 14:05,121,72,49,8430,5286,3144,16537669.0,14603244.0,1934424.0,106,64,42,7292,4847,2445,15813351.0,14308571.0,1504780.0,2.7626,0.6153,2.952,0.6155
2023-04-13 14:10,986,458,528,100264,47291,52973,73022767.0,40409310.0,32613456.0,969,441,528,99645,46371,53274,72610763.0,39809001.0,32801761.0,0.8545,0.6157,0.8585,0.6157
2023-04-13 14:15,134,71,63,8889,5273,3616,16767248.0,14568640.0,2198607.0,115,60,55,7982,4553,3429,16251055.0,14123754.0,2127301.0,2.7629,0.608,3.1021,0.6204
2023-04-13 14:20,85,44,41,5769,3715,2054,3497705.0,2248347.0,1249357.0,67,35,32,4143,2496,1647,2534254.0,1517887.0,1016367.0,0.6052,0.6083,0.6081,0.6171
2023-04-13 14:25,105,43,62,6374,1888,4486,3914709.0,1156633.0,2758076.0,92,35,57,6141,1317,4824,3777842.0,806564.0,2971277.0,0.6126,0.6148,0.6124,0.6159
2023-04-13 14:30,345,28,317,21695,1024,20671,13348902.0,628477.0,12720425.0,320,19,301,20972,923,20049,12901860.0,565369.0,12336490.0,0.6137,0.6154,0.6125,0.6153
2023-04-13 14:35,95,31,64,6279,2066,4213,3859420.0,1266164.0,2593256.0,77,22,55,6267,1977,4290,3866815.0,1212513.0,2654302.0,0.6129,0.6155,0.6133,0.6187
2023-04-13 14:40,177,71,106,17183,7417,9766,10438459.0,4444817.0,5993641.0,151,58,93,15952,6514,9438,9802452.0,3993094.0,5809357.0,0.5993,0.6137,0.613,0.6155
2023-04-13 14:45,400,280,120,23741,15377,8364,14555719.0,9427108.0,5128611.0,381,268,113,23514,15588,7926,14433582.0,9554607.0,4878974.0,0.6131,0.6132,0.6129,0.6156
2023-04-13 14:50,756,578,178,57517,44264,13253,35293184.0,27136442.0,8156742.0,747,574,173,56836,43190,13646,34891920.0,26490500.0,8401420.0,0.6131,0.6155,0.6133,0.6157
2023-04-13 14:55,161,54,107,11067,2546,8521,6803811.0,1540853.0,5262958.0,146,47,99,10952,2676,8276,6736153.0,1623741.0,5112412.0,0.6052,0.6176,0.6068,0.6177
2023-04-13 15:00,100,61,39,7274,4053,3221,4470100.0,2473761.0,1996339.0,74,46,28,6684,4328,2356,4105578.0,2642093.0,1463484.0,0.6104,0.6198,0.6105,0.6212
2023-04-13 15:05,60,25,35,4161,1274,2887,2531531.0,756381.0,1775149.0,45,13,32,3869,758,3111,2369593.0,453028.0,1916565.0,0.5937,0.6149,0.5977,0.6161
2023-04-13 15:10,91,34,57,4632,1353,3279,2843143.0,828556.0,2014587.0,80,24,56,4535,1257,3278,2788372.0,769767.0,2018604.0,0.6124,0.6144,0.6124,0.6158
2023-04-13 15:15,139,51,88,8033,1874,6159,16199308.0,12481036.0,3718272.0,103,28,75,6938,1599,5339,15594269.0,12312689.0,3281580.0,6.6601,0.6037,7.7002,0.6146
2023-04-13 15:20,308,53,255,21909,3047,18862,13402091.0,1857566.0,11544524.0,274,30,244,20574,2737,17837,12604871.0,1664959.0,10939912.0,0.6096,0.6121,0.6083,0.6133
2023-04-13 15:25,115,40,75,11751,5968,5783,18256540.0,14746184.0,3510356.0,100,33,67,7489,2196,5293,15917660.0,12671405.0,3246255.0,2.4709,0.607,5.7702,0.6133
2023-04-13 15:30,1406,334,1072,107957,20014,87943,133409032.0,80092011.0,53317020.0,1319,277,1042,97371,16307,81064,127422856.0,77851220.0,49571636.0,4.0018,0.6063,4.7741,0.6115
2023-04-13 15:35,1298,397,901,139870,33394,106476,107986286.0,42917488.0,65068798.0,1227,338,889,137439,31509,105930,106517352.0,41767872.0,64749480.0,1.2852,0.6111,1.3256,0.6112
2023-04-13 15:40,2640,763,1877,331855,53867,277988,484160925.0,315841852.0,168319072.0,2187,467,1720,301867,36018,265849,466928920.0,304934720.0,161994200.0,5.8634,0.6055,8.4662,0.6093
2023-04-13 15:45,3279,1435,1844,413306,123944,289362,317561262.0,142694924.0,174866337.0,3000,1237,1763,409597,125105,284492,315244449.0,143115816.0,172128633.0,1.1513,0.6043,1.144,0.605
2023-04-13 15:50,2657,854,1803,326109,80179,245930,242807962.0,93715633.0,149092329.0,2535,786,1749,321399,76604,244795,239907671.0,91474574.0,148433096.0,1.1688,0.6062,1.1941,0.6064
2023-04-13 15:55,2803,638,2165,183334,28449,154885,121898841.0,28141463.0,93757377.0,2733,589,2144,180080,26009,154071,120029358.0,26714852.0,93314505.0,0.9892,0.6053,1.0271,0.6057
2023-04-13 16:00,1071,416,655,70759,25791,44968,54134661.0,26882599.0,27252062.0,999,364,635,68401,23948,44453,52726331.0,25764336.0,26961995.0,1.0423,0.606,1.0758,0.6065
2023-04-13 16:05,574,273,301,36473,20108,16365,33330746.0,23449039.0,9881706.0,512,237,275,35841,20695,15146,33001514.0,23786854.0,9214659.0,1.1662,0.6038,1.1494,0.6084
2023-04-13 16:10,1284,264,1020,97796,18087,79709,104355161.0,56223512.0,48131648.0,1191,194,997,95057,17335,77722,102854260.0,55759012.0,47095247.0,3.1085,0.6038,3.2166,0.6059
2023-04-13 16:15,1335,181,1154,102298,10228,92070,84044874.0,28778890.0,55265983.0,1221,94,1127,96258,6510,89748,80630140.0,26527682.0,54102458.0,2.8137,0.6003,4.0749,0.6028
2023-04-13 16:20,3005,1895,1110,385227,289563,95664,550038736.0,491964357.0,58074379.0,2841,1812,1029,377405,284107,93298,545020924.0,488446783.0,56574140.0,1.699,0.6071,1.7192,0.6064
2023-04-13 16:25,2609,1376,1233,323959,240085,83874,230331401.0,178931786.0,51399614.0,2512,1363,1149,320070,241259,78811,227617491.0,179547426.0,48070064.0,0.7453,0.6128,0.7442,0.6099
2023-04-13 16:30,4174,2267,1907,651158,472886,178272,461550276.0,353039783.0,108510493.0,4114,2243,1871,648102,472172,175930,459709373.0,352580188.0,107129184.0,0.7466,0.6087,0.7467,0.6089
2023-04-13 16:35,2921,1486,1435,391846,273160,118686,237147467.0,164997152.0,72150315.0,2869,1469,1400,390030,272503,117527,236083380.0,164605166.0,71478213.0,0.604,0.6079,0.604,0.6082
2023-04-13 16:40,3278,2262,1016,470271,413154,57117,294817978.0,260207504.0,34610473.0,3257,2252,1005,469900,412933,56967,294623035.0,260064277.0,34558758.0,0.6298,0.606,0.6298,0.6066
2023-04-13 16:45,1611,1003,608,252931,218159,34772,152395386.0,131322012.0,21073374.0,1584,985,599,251995,217541,34454,151820155.0,130937315.0,20882840.0,0.602,0.606,0.6019,0.6061
2023-04-13 16:50,2899,2055,844,361008,307291,53717,229608217.0,197030862.0,32577354.0,2849,2030,819,359705,306353,53352,228793423.0,196403677.0,32389745.0,0.6412,0.6065,0.6411,0.6071
2023-04-13 16:55,1656,709,947,161456,110299,51157,97612457.0,66523189.0,31089268.0,1640,702,938,160648,109831,50817,97120644.0,66238132.0,30882512.0,0.6031,0.6077,0.6031,0.6077
2023-04-13 17:00,2499,588,1911,210546,90445,120101,127814737.0,54594809.0,73219928.0,2476,574,1902,207043,90112,116931,125392955.0,54393560.0,70999395.0,0.6036,0.6097,0.6036,0.6072
2023-04-13 17:05,1551,233,1318,119131,29627,89504,72240371.0,17925037.0,54315333.0,1536,221,1315,119276,29896,89380,72300982.0,18050676.0,54250306.0,0.605,0.6068,0.6038,0.607
2023-04-13 17:10,692,134,558,58428,21588,36840,35433068.0,13049620.0,22383448.0,694,142,552,61129,21911,39218,37359324.0,13216862.0,24142461.0,0.6045,0.6076,0.6032,0.6156
2023-04-13 17:15,106,43,63,7072,2815,4257,4450993.0,1710885.0,2740108.0,88,40,48,4934,2615,2319,2982695.0,1571671.0,1411023.0,0.6078,0.6437,0.601,0.6085
2023-04-13 17:20,275,64,211,16269,6461,9808,9817814.0,3900706.0,5917108.0,243,47,196,15134,5814,9320,9175729.0,3508793.0,5666936.0,0.6037,0.6033,0.6035,0.608
2023-04-13 17:25,786,202,584,85833,45920,39913,52222327.0,27696060.0,24526267.0,775,200,575,82442,45725,36717,49871790.0,27577994.0,22293796.0,0.6031,0.6145,0.6031,0.6072
2023-04-13 17:30,72,37,35,4877,3355,1522,2952266.0,2026556.0,925710.0,70,37,33,5109,3593,1516,3084981.0,2162762.0,922218.0,0.604,0.6082,0.6019,0.6083
2023-04-13 17:35,1536,622,914,95874,41287,54587,58161264.0,24980178.0,33181086.0,1515,608,907,95654,41049,54605,58031945.0,24837962.0,33193982.0,0.605,0.6079,0.6051,0.6079
2023-04-13 17:40,1428,692,736,106262,62579,43683,64380539.0,37851809.0,26528730.0,1416,686,730,105806,62593,43213,64087021.0,37859887.0,26227134.0,0.6049,0.6073,0.6049,0.6069
2023-04-13 17:45,644,149,495,38511,11791,26720,23362017.0,7118203.0,16243814.0,627,140,487,38641,11328,27313,23430673.0,6836940.0,16593733.0,0.6037,0.6079,0.6035,0.6075
2023-04-13 17:50,6658,2904,3754,960331,352090,608241,1557876182.0,1198854906.0,359021275.0,5195,1974,3221,800606,282626,517980,1456126169.0,1149229365.0,306896803.0,3.405,0.5903,4.0663,0.5925
2023-04-13 17:55,5571,2655,2916,714789,300894,413895,811365135.0,566626636.0,244738499.0,4362,1941,2421,624141,249171,374970,757604863.0,537045726.0,220559137.0,1.8831,0.5913,2.1553,0.5882
2023-04-13 18:00,4149,2273,1876,483892,249802,234090,485925812.0,346961517.0,138964294.0,3041,1617,1424,365980,188719,177261,410474797.0,305372020.0,105102777.0,1.3889,0.5936,1.6181,0.5929
2023-04-13 18:05,2196,1138,1058,252465,85866,166599,273052371.0,174958301.0,98094070.0,1722,864,858,207426,70164,137262,244621602.0,162612244.0,82009358.0,2.0376,0.5888,2.3176,0.5975
2023-04-13 18:10,2759,898,1861,330730,64183,266547,259182381.0,102938576.0,156243805.0,2375,659,1716,319861,53285,266576,251600277.0,94495147.0,157105129.0,1.6038,0.5862,1.7734,0.5893
2023-04-13 18:15,2252,783,1469,284859,51048,233811,213905931.0,76965464.0,136940466.0,1846,556,1290,244011,37442,206569,192733299.0,71139989.0,121593310.0,1.5077,0.5857,1.9,0.5886
2023-04-13 18:20,1305,671,634,111906,47736,64170,80281824.0,42690250.0,37591574.0,1029,527,502,88506,38525,49981,67156055.0,37776325.0,29379730.0,0.8943,0.5858,0.9806,0.5878
2023-04-13 18:25,785,324,461,85229,23797,61432,64225824.0,28123354.0,36102469.0,640,269,371,88766,20607,68159,67020991.0,26854723.0,40166267.0,1.1818,0.5877,1.3032,0.5893
2023-04-13 18:30,2801,554,2247,381709,54448,327261,320195004.0,129568340.0,190626664.0,2211,295,1916,343781,44209,299572,305340199.0,129658180.0,175682018.0,2.3797,0.5825,2.9328,0.5864
2023-04-13 18:35,2143,948,1195,243809,97031,146778,227897163.0,142090141.0,85807022.0,1748,797,951,220967,85866,135101,214251332.0,134986763.0,79264569.0,1.4644,0.5846,1.5721,0.5867
2023-04-14 10:00,6551,3535,3016,979391,537575,441816,924442463.0,667171675.0,257270788.0,4863,2600,2263,797527,436460,361067,804977701.0,593710297.0,211267404.0,1.2411,0.5823,1.3603,0.5851
2023-04-14 10:05,2732,1690,1042,299678,223672,76006,284684088.0,240074346.0,44609741.0,2146,1404,742,255002,209772,45230,250456913.0,223640892.0,26816020.0,1.0733,0.5869,1.0661,0.5929
2023-04-14 10:10,1532,968,564,115999,86047,29952,80623218.0,62882436.0,17740782.0,1268,881,387,105717,83332,22385,74465737.0,61191858.0,13273879.0,0.7308,0.5923,0.7343,0.593
2023-04-14 10:15,1316,668,648,88290,51886,36404,76040380.0,54733925.0,21306455.0,996,514,482,75574,44260,31314,68882269.0,50306954.0,18575314.0,1.0549,0.5853,1.1366,0.5932
2023-04-14 10:20,580,260,320,36034,16271,19763,33235905.0,21700378.0,11535527.0,358,149,209,26868,10849,16019,28006926.0,18515348.0,9491578.0,1.3337,0.5837,1.7066,0.5925
2023-04-14 10:25,644,324,320,43007,21933,21074,25325709.0,12912082.0,12413627.0,558,266,292,39921,20076,19845,23526284.0,11801019.0,11725265.0,0.5887,0.589,0.5878,0.5908
2023-04-14 10:30,450,227,223,41017,28055,12962,36588966.0,28944730.0,7644236.0,382,218,164,34074,23286,10788,31998930.0,25552379.0,6446550.0,1.0317,0.5897,1.0973,0.5976
2023-04-14 10:35,551,352,199,36675,23209,13466,34184521.0,26234849.0,7949672.0,380,250,130,29802,20756,9046,30128566.0,24759557.0,5369008.0,1.1304,0.5904,1.1929,0.5935
2023-04-14 10:40,787,323,464,49607,18643,30964,41667929.0,23521474.0,18146454.0,687,314,373,45265,17197,28068,39268092.0,22657538.0,16610554.0,1.2617,0.5861,1.3175,0.5918
2023-04-14 10:45,400,220,180,28293,15666,12627,16634200.0,9205233.0,7428967.0,332,190,142,25400,15056,10344,17811801.0,11638895.0,6172906.0,0.5876,0.5883,0.773,0.5968
2023-04-14 10:50,174,100,74,12922,8411,4511,7611945.0,4957503.0,2654442.0,112,62,50,8531,5265,3266,5022300.0,3091860.0,1930440.0,0.5894,0.5884,0.5872,0.5911
2023-04-14 10:55,489,293,196,33700,25331,8369,32455142.0,27543688.0,4911453.0,404,255,149,31179,23864,7315,30940210.0,26606285.0,4333924.0,1.0874,0.5869,1.1149,0.5925
2023-04-14 11:00,774,559,215,69156,61384,7772,40926988.0,36349895.0,4577093.0,679,518,161,62692,57288,5404,36988183.0,33781512.0,3206671.0,0.5922,0.5889,0.5897,0.5934
2023-04-14 11:05,246,130,116,18595,13933,4662,23457875.0,20734308.0,2723567.0,179,105,74,16525,14058,2467,22232517.0,20764453.0,1468064.0,1.4881,0.5842,1.4771,0.5951
2023-04-14 11:10,1218,264,954,133124,27012,106112,140358922.0,78633820.0,61725101.0,1009,160,849,120500,23437,97063,133659970.0,76414922.0,57245048.0,2.9111,0.5817,3.2604,0.5898
2023-04-14 11:15,336,149,187,27015,11943,15072,15921667.0,7079300.0,8842367.0,234,102,132,20920,9629,11291,12293478.0,5618876.0,6674602.0,0.5928,0.5867,0.5835,0.5911
2023-04-14 11:20,669,438,231,72783,56894,15889,70455295.0,61159011.0,9296283.0,577,375,202,69747,54590,15157,68706431.0,59769342.0,8937089.0,1.075,0.5851,1.0949,0.5896
2023-04-14 11:25,785,152,633,90771,14167,76604,103225350.0,58429501.0,44795849.0,659,76,583,81488,10225,71263,97937628.0,56136084.0,41801544.0,4.1243,0.5848,5.4901,0.5866
2023-04-14 11:30,864,299,565,126161,31298,94863,98857356.0,43290041.0,55567315.0,775,244,531,116519,24411,92108,93353944.0,39299685.0,54054259.0,1.3832,0.5858,1.6099,0.5869
2023-04-14 11:35,574,194,380,65059,15993,49066,50614516.0,21997892.0,28616623.0,453,105,348,56869,9340,47529,45805400.0,17967120.0,27838279.0,1.3755,0.5832,1.9237,0.5857
2023-04-14 11:40,369,92,277,49824,7474,42350,30296351.0,5463299.0,24833051.0,347,84,263,50610,8354,42256,35327564.0,10497217.0,24830347.0,0.731,0.5864,1.2565,0.5876
2023-04-14 11:45,360,99,261,50366,8578,41788,67184230.0,42649630.0,24534600.0,299,62,237,45873,7127,38746,64547695.0,41796735.0,22750960.0,4.972,0.5871,5.8646,0.5872
2023-04-14 11:50,990,114,876,160251,5245,155006,144011649.0,53254852.0,90756797.0,924,70,854,155625,4346,151279,141433835.0,52725239.0,88708596.0,10.1535,0.5855,12.1319,0.5864
2023-04-14 11:55,647,64,583,97754,3109,94645,69708540.0,14357210.0,55351330.0,612,45,567,96689,2511,94178,69115531.0,14004967.0,55110564.0,4.618,0.5848,5.5774,0.5852
2023-04-14 12:00,665,92,573,65112,5617,59495,38035471.0,3267784.0,34767686.0,593,44,549,62970,2520,60450,36794861.0,1458467.0,35336394.0,0.5818,0.5844,0.5788,0.5846
2023-04-14 12:05,195,79,116,11446,2495,8951,6700824.0,1455196.0,5245628.0,129,37,92,10546,2216,8330,6163430.0,1275311.0,4888118.0,0.5832,0.586,0.5755,0.5868
2023-04-14 12:10,373,78,295,43131,7313,35818,25177101.0,4309891.0,20867210.0,319,43,276,36649,4106,32543,21394978.0,2384422.0,19010555.0,0.5893,0.5826,0.5807,0.5842
2023-04-14 12:15,200,118,82,21232,13229,8003,12293581.0,7712118.0,4581463.0,161,97,64,19914,13244,6670,11601471.0,7694429.0,3907042.0,0.583,0.5725,0.581,0.5858
2023-04-14 12:20,744,518,226,87201,57124,30077,50771649.0,33219113.0,17552535.0,699,487,212,85915,55913,30002,50042538.0,32508966.0,17533572.0,0.5815,0.5836,0.5814,0.5844
2023-04-14 12:25,232,129,103,14234,7066,7168,8299599.0,4112613.0,4186986.0,207,96,111,13729,6519,7210,8009075.0,3787837.0,4221237.0,0.582,0.5841,0.581,0.5855
2023-04-14 12:30,65,48,17,3232,2366,866,1896097.0,1389478.0,506619.0,45,36,9,2304,1871,433,1340485.0,1086885.0,253600.0,0.5873,0.585,0.5809,0.5857
2023-04-14 12:35,47,31,16,4914,1278,3636,15422775.0,13289891.0,2132883.0,34,22,12,4663,1075,3588,15277352.0,13172324.0,2105027.0,10.399,0.5866,12.2533,0.5867
2023-04-14 12:40,107,78,29,6911,4536,2375,4053246.0,2646296.0,1406949.0,93,66,27,5648,3370,2278,4388333.0,3036365.0,1351967.0,0.5834,0.5924,0.901,0.5935
2023-04-14 12:45,84,47,37,5368,1055,4313,3183199.0,614668.0,2568530.0,67,41,26,5909,3680,2229,3438984.0,2120323.0,1318661.0,0.5826,0.5955,0.5762,0.5916
2023-04-14 12:50,103,71,32,5089,3100,1989,2953894.0,1806744.0,1147149.0,68,42,26,3858,2026,1832,2255730.0,1180192.0,1075538.0,0.5828,0.5767,0.5825,0.5871
2023-04-14 12:55,84,42,42,6484,4554,1930,3687520.0,2559694.0,1127826.0,50,20,30,3299,2342,957,1837414.0,1277194.0,560219.0,0.5621,0.5844,0.5453,0.5854
2023-04-14 13:00,79,37,42,3912,2015,1897,2290458.0,1177427.0,1113031.0,63,29,34,2874,1317,1557,1681524.0,767235.0,914289.0,0.5843,0.5867,0.5826,0.5872
2023-04-14 13:05,90,36,54,5965,1720,4245,3511066.0,1004717.0,2506349.0,75,26,49,3959,1460,2499,2313328.0,850804.0,1462523.0,0.5841,0.5904,0.5827,0.5852
2023-04-14 13:10,471,161,310,13006,4284,8722,7565200.0,2500384.0,5064816.0,456,158,298,13302,4714,8588,7762757.0,2745330.0,5017426.0,0.5837,0.5807,0.5824,0.5842
2023-04-14 13:15,679,241,438,32580,14941,17639,19010609.0,8711530.0,10299078.0,658,229,429,32338,15042,17296,18877718.0,8770744.0,10106973.0,0.5831,0.5839,0.5831,0.5844
2023-04-14 13:20,141,60,81,8029,2610,5419,4690033.0,1522334.0,3167698.0,123,47,76,8048,2617,5431,4699466.0,1512811.0,3186655.0,0.5833,0.5846,0.5781,0.5868
2023-04-14 13:25,84,52,32,5587,1789,3798,3289251.0,1042909.0,2246341.0,64,38,26,4858,1924,2934,2842842.0,1119666.0,1723176.0,0.583,0.5915,0.5819,0.5873
2023-04-14 13:30,75,30,45,1958,1037,921,1143039.0,606480.0,536559.0,63,26,37,1725,824,901,1006941.0,480158.0,526783.0,0.5848,0.5826,0.5827,0.5847
2023-04-14 13:35,168,65,103,11028,2190,8838,6462197.0,1296443.0,5165753.0,144,50,94,10686,2129,8557,6241978.0,1240945.0,5001032.0,0.592,0.5845,0.5829,0.5844
2023-04-14 13:40,93,43,50,5516,2230,3286,3229476.0,1304532.0,1924943.0,74,32,42,3929,1822,2107,2292858.0,1058969.0,1233889.0,0.585,0.5858,0.5812,0.5856
2023-04-14 13:45,81,58,23,3834,2613,1221,2241082.0,1527433.0,713648.0,53,39,14,2320,1733,587,1346607.0,1002786.0,343821.0,0.5846,0.5845,0.5786,0.5857
2023-04-14 13:50,43,25,18,1790,1245,545,1044947.0,724467.0,320479.0,31,23,8,1581,1233,348,915653.0,712199.0,203454.0,0.5819,0.588,0.5776,0.5846
2023-04-14 13:55,1887,713,1174,286212,106332,179880,1100987447.0,998169429.0,102818017.0,1316,387,929,203385,70429,132956,1051121417.0,974229635.0,76891782.0,9.3873,0.5716,13.8328,0.5783
2023-04-14 14:00,7531,3333,4198,1115038,475559,639479,1418934153.0,1056096328.0,362837825.0,5264,2105,3159,841127,328970,512157,1261465041.0,967758985.0,293706056.0,2.2207,0.5674,2.9418,0.5735
2023-04-14 14:05,3569,1852,1717,350891,160828,190063,387320377.0,279566694.0,107753683.0,2469,1175,1294,273466,119117,154349,343192826.0,254864120.0,88328705.0,1.7383,0.5669,2.1396,0.5723
2023-04-14 14:10,1186,741,445,89192,47918,41274,82301819.0,58881965.0,23419853.0,815,516,299,60437,34653,25784,65673688.0,50885841.0,14787847.0,1.2288,0.5674,1.4684,0.5735
2023-04-14 14:15,729,405,324,65534,24858,40676,68338050.0,45463959.0,22874090.0,500,246,254,54287,26112,28175,62013305.0,45847876.0,16165428.0,1.8289,0.5623,1.7558,0.5738
2023-04-14 14:20,604,363,241,38357,21388,16969,22100700.0,12392301.0,9708398.0,441,260,181,27293,16777,10516,15522405.0,9488917.0,6033487.0,0.5794,0.5721,0.5656,0.5737
2023-04-14 14:25,429,310,119,33749,17412,16337,19407786.0,10046704.0,9361082.0,308,233,75,32140,17522,14618,18343437.0,9896443.0,8446994.0,0.577,0.573,0.5648,0.5778
2023-04-14 14:30,454,271,183,40114,20432,19682,22818783.0,11657147.0,11161636.0,292,166,126,31488,14337,17151,17943253.0,8088832.0,9854421.0,0.5705,0.5671,0.5642,0.5746
2023-04-14 14:35,469,372,97,32996,22886,10110,19049434.0,13287944.0,5761490.0,398,326,72,27760,19251,8509,15850749.0,10943646.0,4907103.0,0.5806,0.5699,0.5685,0.5767
2023-04-14 14:40,1203,941,262,184059,155722,28337,169113443.0,152884033.0,16229410.0,1002,822,180,149999,132930,17069,148040313.0,138220226.0,9820086.0,0.9818,0.5727,1.0398,0.5753
2023-04-14 14:45,813,273,540,60022,16329,43693,34286932.0,9353220.0,24933712.0,663,208,455,50624,13741,36883,28989718.0,7785192.0,21204526.0,0.5728,0.5707,0.5666,0.5749
2023-04-14 14:50,701,390,311,39304,18263,21041,22734440.0,10682658.0,12051781.0,598,323,275,38962,16677,22285,22372685.0,9518961.0,12853724.0,0.5849,0.5728,0.5708,0.5768
2023-04-14 14:55,331,218,113,16347,10871,5476,9327924.0,6238621.0,3089302.0,256,175,81,11802,7549,4253,6756255.0,4308831.0,2447424.0,0.5739,0.5642,0.5708,0.5755
2023-04-14 15:00,364,204,160,25198,11986,13212,14462591.0,6972090.0,7490501.0,273,151,122,21033,10609,10424,12087219.0,6068426.0,6018792.0,0.5817,0.5669,0.572,0.5774
2023-04-14 15:05,980,477,503,74757,32325,42432,58538635.0,34190711.0,24347923.0,898,431,467,68391,26631,41760,54854076.0,30862373.0,23991703.0,1.0577,0.5738,1.1589,0.5745
2023-04-14 15:10,1716,1280,436,153249,104936,48313,135582060.0,107713169.0,27868890.0,1504,1190,314,129061,96607,32454,121061289.0,102300022.0,18761266.0,1.0265,0.5768,1.0589,0.5781
2023-04-14 15:15,1323,474,849,152976,52001,100975,149957864.0,92203044.0,57754820.0,1197,399,798,144993,47377,97616,145732361.0,89542358.0,56190003.0,1.7731,0.572,1.89,0.5756
2023-04-14 15:20,1134,503,631,103509,48154,55355,106925872.0,74975329.0,31950542.0,977,410,567,91373,43463,47910,99393423.0,71735766.0,27657656.0,1.557,0.5772,1.6505,0.5773
2023-04-14 15:25,1036,501,535,114120,64306,49814,96960749.0,68270259.0,28690490.0,914,456,458,102953,59248,43705,90576599.0,65312408.0,25264191.0,1.0616,0.576,1.1024,0.5781
2023-04-14 15:30,1102,603,499,122923,74786,48137,70851428.0,43090633.0,27760794.0,1023,557,466,120044,74091,45953,69167800.0,42628099.0,26539701.0,0.5762,0.5767,0.5753,0.5775
2023-04-14 15:35,934,549,385,93024,56919,36105,84766629.0,64052617.0,20714011.0,862,508,354,90542,55182,35360,83386815.0,62952241.0,20434574.0,1.1253,0.5737,1.1408,0.5779
2023-04-14 15:40,402,183,219,30051,13068,16983,32866707.0,23127755.0,9738952.0,350,157,193,28727,13195,15532,32156696.0,23194241.0,8962455.0,1.7698,0.5735,1.7578,0.577
2023-04-14 15:45,608,231,377,66106,23199,42907,38046386.0,13322993.0,24723393.0,550,190,360,63844,22284,41560,36753174.0,12788888.0,23964286.0,0.5743,0.5762,0.5739,0.5766
2023-04-14 15:50,1044,245,799,97533,14102,83431,56122706.0,8126962.0,47995744.0,974,208,766,97663,15884,81779,56285213.0,9123745.0,47161467.0,0.5763,0.5753,0.5744,0.5767
2023-04-14 15:55,264,139,125,25523,14414,11109,14717416.0,8275487.0,6441929.0,235,114,121,19042,9339,9703,10967657.0,5358818.0,5608838.0,0.5741,0.5799,0.5738,0.5781
2023-04-14 16:00,429,199,230,35745,14201,21544,20597779.0,8184835.0,12412944.0,384,173,211,34730,14466,20264,19993107.0,8294795.0,11698311.0,0.5764,0.5762,0.5734,0.5773
2023-04-14 16:05,275,171,104,19619,13308,6311,11362598.0,7719891.0,3642707.0,231,135,96,16537,11286,5251,9521620.0,6486794.0,3034826.0,0.5801,0.5772,0.5748,0.578
2023-04-14 16:10,110,65,45,7344,4412,2932,4252022.0,2556258.0,1695763.0,89,44,45,8618,2800,5818,4997399.0,1607387.0,3390012.0,0.5794,0.5784,0.5741,0.5827
2023-04-14 16:15,122,53,69,8191,2410,5781,4717181.0,1389707.0,3327473.0,100,43,57,8500,3644,4856,4880653.0,2076662.0,2803990.0,0.5766,0.5756,0.5699,0.5774
2023-04-14 16:20,249,158,91,23863,16211,7652,29474364.0,25057641.0,4416723.0,209,139,70,22406,15691,6715,31165043.0,27280463.0,3884580.0,1.5457,0.5772,1.7386,0.5785
2023-04-14 16:25,172,108,64,14767,11306,3461,8505268.0,6505152.0,2000116.0,145,92,53,14904,12062,2842,8578728.0,6932052.0,1646675.0,0.5754,0.5779,0.5747,0.5794
2023-04-14 16:30,199,141,58,16396,11592,4804,9411287.0,6661842.0,2749445.0,147,112,35,14678,10530,4148,8448651.0,6043909.0,2404742.0,0.5747,0.5723,0.574,0.5797
2023-04-14 16:35,186,133,53,18522,14514,4008,10705844.0,8381852.0,2323991.0,162,126,36,16571,14331,2240,9535856.0,8240947.0,1294908.0,0.5775,0.5798,0.575,0.5781
2023-04-14 16:40,256,130,126,16004,8287,7717,9214883.0,4818157.0,4396726.0,219,110,109,14354,7974,6380,8273760.0,4579307.0,3694452.0,0.5814,0.5697,0.5743,0.5791
2023-04-14 16:45,144,80,64,8824,5115,3709,5075584.0,2940574.0,2135009.0,126,68,58,9438,5549,3889,5436994.0,3187719.0,2249275.0,0.5749,0.5756,0.5745,0.5784
2023-04-14 16:50,345,87,258,22760,11973,10787,13099439.0,6872186.0,6227253.0,319,75,244,21632,11397,10235,12455256.0,6545475.0,5909780.0,0.574,0.5773,0.5743,0.5774
2023-04-14 16:55,181,70,111,10457,4743,5714,6025590.0,2736789.0,3288800.0,150,57,93,9989,4444,5545,5789016.0,2555867.0,3233148.0,0.577,0.5756,0.5751,0.5831
2023-04-14 17:00,136,83,53,9995,3701,6294,5800046.0,2138629.0,3661416.0,111,68,43,9257,3751,5506,5343501.0,2152781.0,3190720.0,0.5779,0.5817,0.5739,0.5795
2023-04-14 17:05,154,74,80,11757,6558,5199,6768757.0,3764626.0,3004131.0,133,64,69,13386,6159,7227,7717888.0,3537454.0,4180434.0,0.5741,0.5778,0.5744,0.5784
2023-04-14 17:10,187,72,115,10609,3795,6814,6029361.0,2194525.0,3834836.0,151,52,99,8245,3166,5079,4751458.0,1819434.0,2932024.0,0.5783,0.5628,0.5747,0.5773
2023-04-14 17:15,1001,646,355,124019,104163,19856,86862247.0,75463630.0,11398616.0,961,625,336,121603,103477,18126,85520853.0,75068838.0,10452015.0,0.7245,0.5741,0.7255,0.5766
2023-04-14 17:20,207,119,88,15931,12543,3388,9152281.0,7203652.0,1948628.0,180,105,75,15852,12293,3559,9109977.0,7057909.0,2052068.0,0.5743,0.5752,0.5741,0.5766
2023-04-14 17:25,166,101,65,9548,6805,2743,5495497.0,3914889.0,1580608.0,155,102,53,10071,8368,1703,5765972.0,4782190.0,983781.0,0.5753,0.5762,0.5715,0.5777
2023-04-14 17:30,188,95,93,15685,6595,9090,9026551.0,3812202.0,5214348.0,163,80,83,14959,5992,8967,8603581.0,3431892.0,5171689.0,0.578,0.5736,0.5727,0.5767
2023-04-14 17:35,157,72,85,7649,2309,5340,4408960.0,1331023.0,3077936.0,126,56,70,7633,2872,4761,4413624.0,1647156.0,2766468.0,0.5765,0.5764,0.5735,0.5811
2023-04-14 17:40,85,47,38,5123,4004,1119,2902816.0,2260696.0,642119.0,54,34,20,1792,1104,688,1031491.0,633540.0,397951.0,0.5646,0.5738,0.5739,0.5784
2023-04-14 17:45,569,147,422,45148,13366,31782,25944506.0,7690354.0,18254152.0,543,132,411,42624,12682,29942,24559459.0,7277627.0,17281832.0,0.5754,0.5744,0.5739,0.5772
2023-04-14 17:50,783,521,262,112904,90679,22225,80474459.0,67670426.0,12804032.0,767,513,254,111131,89027,22104,79457389.0,66718581.0,12738807.0,0.7463,0.5761,0.7494,0.5763
2023-04-14 17:55,1076,780,296,134459,108253,26206,77344028.0,62223396.0,15120631.0,1036,756,280,134812,108781,26031,77521007.0,62497714.0,15023292.0,0.5748,0.577,0.5745,0.5771
2023-04-14 18:00,435,187,248,27564,13620,13944,15854571.0,7824895.0,8029676.0,400,164,236,26180,12316,13864,15083592.0,7069519.0,8014073.0,0.5745,0.5759,0.574,0.578
2023-04-14 18:05,165,91,74,8750,5881,2869,5019437.0,3379636.0,1639801.0,147,84,63,8588,6062,2526,4938847.0,3480338.0,1458509.0,0.5747,0.5716,0.5741,0.5774
2023-04-14 18:10,94,70,24,6225,5249,976,3580577.0,3017510.0,563066.0,75,58,17,4975,4105,870,2863895.0,2358697.0,505197.0,0.5749,0.5769,0.5746,0.5807
2023-04-14 18:15,154,116,38,11704,9313,2391,6742113.0,5360483.0,1381629.0,137,106,31,11219,8913,2306,6454442.0,5121736.0,1332705.0,0.5756,0.5778,0.5746,0.5779
2023-04-14 18:20,150,106,44,12343,6814,5529,7120817.0,3930673.0,3190144.0,129,91,38,10774,5185,5589,6212718.0,2977501.0,3235216.0,0.5769,0.577,0.5743,0.5789
2023-04-14 18:25,191,126,65,17922,11678,6244,10319936.0,6731524.0,3588412.0,156,110,46,17660,12195,5465,10176386.0,7009508.0,3166878.0,0.5764,0.5747,0.5748,0.5795
2023-04-14 18:30,193,99,94,16071,9563,6508,9213427.0,5500759.0,3712667.0,162,82,80,12783,7611,5172,7379700.0,4373023.0,3006677.0,0.5752,0.5705,0.5746,0.5813
2023-04-14 18:35,551,204,347,52574,28406,24168,30325632.0,16391028.0,13934604.0,543,197,346,48440,24876,23564,27898410.0,14291091.0,13607319.0,0.577,0.5766,0.5745,0.5775
2023-04-17 10:00,2761,1241,1520,471657,170398,301259,394487552.0,217782724.0,176704827.0,2314,1032,1282,433556,147619,285937,363820699.0,195808353.0,168012345.0,1.2781,0.5866,1.3264,0.5876
2023-04-17 10:05,1311,729,582,122384,45839,76545,166651195.0,121867693.0,44783502.0,1091,637,454,106006,40720,65286,156098635.0,117807430.0,38291204.0,2.6586,0.5851,2.8931,0.5865
2023-04-17 10:10,1799,942,857,202386,67662,134724,164283733.0,85999291.0,78284442.0,1674,865,809,197035,63308,133727,156241924.0,78443003.0,77798921.0,1.271,0.5811,1.2391,0.5818
2023-04-17 10:15,678,369,309,61549,26114,35435,35648310.0,15138829.0,20509480.0,563,319,244,52056,22177,29879,30171703.0,12817793.0,17353910.0,0.5797,0.5788,0.578,0.5808
2023-04-17 10:20,238,154,84,16972,10941,6031,25485361.0,21960914.0,3524447.0,157,112,45,12616,9792,2824,22929416.0,21286060.0,1643355.0,2.0072,0.5844,2.1738,0.5819
2023-04-17 10:25,1495,755,740,149783,43907,105876,133499947.0,72197108.0,61302839.0,1385,695,690,144904,41211,103693,130758403.0,70643966.0,60114436.0,1.6443,0.579,1.7142,0.5797
2023-04-17 10:30,1263,847,416,109133,67907,41226,94606971.0,70679628.0,23927343.0,1199,806,393,101472,61105,40367,89977254.0,66566639.0,23410614.0,1.0408,0.5804,1.0894,0.5799
2023-04-17 10:35,884,636,248,100918,80622,20296,136466903.0,124741833.0,11725069.0,776,598,178,93091,76635,16456,131983390.0,122381625.0,9601765.0,1.5472,0.5777,1.5969,0.5835
2023-04-17 10:40,1851,1705,146,215676,206950,8726,124842332.0,119738686.0,5103646.0,1784,1678,106,214571,206201,8370,124193721.0,119271498.0,4922223.0,0.5786,0.5849,0.5784,0.5881
2023-04-17 10:45,583,498,85,40320,32738,7582,54751358.0,50297367.0,4453990.0,505,459,46,36863,31913,4950,52679310.0,49774487.0,2904822.0,1.5364,0.5874,1.5597,0.5868
2023-04-17 10:50,556,218,338,84979,17410,67569,49846601.0,10168971.0,39677630.0,491,195,296,81797,15421,66376,47974186.0,8992024.0,38982162.0,0.5841,0.5872,0.5831,0.5873
2023-04-17 10:55,506,376,130,35873,23839,12034,20997315.0,13916309.0,7081005.0,410,338,72,31688,22360,9328,18540939.0,13048751.0,5492188.0,0.5838,0.5884,0.5836,0.5888
2023-04-17 11:00,141,65,76,13199,3128,10071,7823264.0,1895460.0,5927804.0,97,48,49,7430,2089,5341,4364295.0,1213628.0,3150666.0,0.606,0.5886,0.581,0.5899
2023-04-17 11:05,147,68,79,11654,4921,6733,6844469.0,2865834.0,3978635.0,109,49,60,8920,2916,6004,5252310.0,1695739.0,3556570.0,0.5824,0.5909,0.5815,0.5924
2023-04-17 11:10,338,121,217,22131,6350,15781,12954071.0,3705284.0,9248787.0,303,107,196,21136,5733,15403,12371934.0,3342793.0,9029141.0,0.5835,0.5861,0.5831,0.5862
2023-04-17 11:15,633,543,90,38217,34465,3752,22423718.0,20202613.0,2221105.0,550,506,44,34049,31713,2336,19897276.0,18524404.0,1372871.0,0.5862,0.592,0.5841,0.5877
2023-04-17 11:20,154,95,59,10569,7532,3037,6138342.0,4360738.0,1777603.0,113,79,34,9844,7010,2834,5717813.0,4054956.0,1662857.0,0.579,0.5853,0.5785,0.5868
2023-04-17 11:25,1102,375,727,113264,24356,88908,113022327.0,61108924.0,51913403.0,1024,332,692,110807,25034,85773,111561548.0,61398410.0,50163138.0,2.509,0.5839,2.4526,0.5848
2023-04-17 11:30,504,455,49,33374,27313,6061,19502444.0,15968282.0,3534161.0,446,429,17,29355,26713,2642,17132423.0,15583195.0,1549228.0,0.5846,0.5831,0.5834,0.5864
2023-04-17 11:35,597,495,102,37721,31070,6651,22015464.0,18134080.0,3881383.0,549,466,83,37719,30585,7134,22031936.0,17853130.0,4178806.0,0.5837,0.5836,0.5837,0.5858
2023-04-17 11:40,99,61,38,7484,5617,1867,4352327.0,3261487.0,1090840.0,85,55,30,6917,5225,1692,4035344.0,3044527.0,990817.0,0.5806,0.5843,0.5827,0.5856
2023-04-17 11:45,626,454,172,46735,34439,12296,42838793.0,35675468.0,7163325.0,596,438,158,45840,33804,12036,42346111.0,35304657.0,7041454.0,1.0359,0.5826,1.0444,0.585
2023-04-17 11:50,736,227,509,52661,13192,39469,30761383.0,7691857.0,23069526.0,706,216,490,51825,13025,38800,30291248.0,7592142.0,22699106.0,0.5831,0.5845,0.5829,0.585
2023-04-17 11:55,261,244,17,32622,28949,3673,19192990.0,16885804.0,2307185.0,247,236,11,30164,28657,1507,17582531.0,16700055.0,882476.0,0.5833,0.6281,0.5828,0.5856
2023-04-17 12:00,1057,482,575,96197,32168,64029,56259088.0,18721222.0,37537865.0,1030,474,556,94201,32156,62045,55013728.0,18726237.0,36287491.0,0.582,0.5863,0.5824,0.5849
2023-04-17 12:05,665,275,390,61612,17689,43923,35930952.0,10308706.0,25622246.0,630,255,375,60679,17250,43429,35406037.0,10025610.0,25380427.0,0.5828,0.5833,0.5812,0.5844
2023-04-17 12:10,410,229,181,43073,15183,27890,25158410.0,8845330.0,16313079.0,385,221,164,42703,15585,27118,24941081.0,9079839.0,15861242.0,0.5826,0.5849,0.5826,0.5849
2023-04-17 12:15,488,248,240,37258,13154,24104,21735742.0,7657462.0,14078279.0,462,228,234,37343,13364,23979,21806160.0,7781528.0,14024631.0,0.5821,0.5841,0.5823,0.5849
2023-04-17 12:20,375,291,84,29070,19632,9438,32584492.0,27038846.0,5545646.0,348,283,65,26510,19699,6811,31057993.0,27079086.0,3978906.0,1.3773,0.5876,1.3746,0.5842
2023-04-17 12:25,1218,313,905,163872,28309,135563,142118220.0,63277745.0,78840474.0,1145,272,873,159842,26564,133278,139986607.0,62259999.0,77726607.0,2.2353,0.5816,2.3438,0.5832
2023-04-17 12:30,1492,343,1149,202693,32384,170309,133168996.0,34319897.0,98849098.0,1426,300,1126,198299,30090,168209,130623074.0,32997239.0,97625834.0,1.0598,0.5804,1.0966,0.5804
2023-04-17 12:35,1848,377,1471,262007,31869,230138,214855151.0,81050601.0,133804550.0,1790,331,1459,258396,30718,227678,212734035.0,80219471.0,132514563.0,2.5432,0.5814,2.6115,0.582
2023-04-17 12:40,4729,2323,2406,686277,138649,547628,446535553.0,127129766.0,319405786.0,4702,2303,2399,685072,137326,547746,445829331.0,126352953.0,319476378.0,0.9169,0.5833,0.9201,0.5833
2023-04-17 12:45,4459,2034,2425,662712,109083,553629,401834357.0,78866989.0,322967368.0,4441,2022,2419,661953,108804,553149,401388337.0,78698861.0,322689476.0,0.723,0.5834,0.7233,0.5834
2023-04-17 12:50,4608,2845,1763,540396,165096,375300,330203297.0,111343819.0,218859478.0,4565,2822,1743,536674,161493,375181,328070059.0,109273654.0,218796405.0,0.6744,0.5832,0.6766,0.5832
2023-04-17 12:55,3746,1815,1931,464758,102450,362308,286388539.0,75069791.0,211318747.0,3707,1791,1916,463963,101921,362042,285924024.0,74758131.0,211165893.0,0.7327,0.5833,0.7335,0.5833
2023-04-17 13:00,1608,856,752,181667,55768,125899,105879415.0,32395270.0,73484144.0,1600,854,746,181642,55762,125880,105861950.0,32389016.0,73472934.0,0.5809,0.5837,0.5808,0.5837
2023-04-17 13:05,1413,1243,170,87433,67691,19742,50812886.0,39299268.0,11513617.0,1397,1234,163,86838,67510,19328,50471316.0,39196714.0,11274602.0,0.5806,0.5832,0.5806,0.5833
2023-04-17 13:10,1161,433,728,171719,23489,148230,100240629.0,13642758.0,86597871.0,1135,423,712,169025,22732,146293,98657535.0,13204838.0,85452697.0,0.5808,0.5842,0.5809,0.5841
2023-04-17 13:15,1228,752,476,179149,49539,129610,104580161.0,28812780.0,75767381.0,1212,735,477,181042,49242,131800,105699307.0,28635642.0,77063665.0,0.5816,0.5846,0.5815,0.5847
2023-04-17 13:20,784,649,135,101964,64041,37923,59344828.0,37190953.0,22153874.0,761,639,122,100120,63507,36613,58271116.0,36880981.0,21390135.0,0.5807,0.5842,0.5807,0.5842
2023-04-17 13:25,464,446,18,65294,64814,480,37901473.0,37620229.0,281244.0,456,444,12,65065,64720,345,37766638.0,37565513.0,201125.0,0.5804,0.5859,0.5804,0.583
2023-04-17 13:30,591,578,13,62176,62029,147,36070261.0,35990533.0,79727.0,578,573,5,61689,61614,75,35794060.0,35750197.0,43863.0,0.5802,0.5424,0.5802,0.5848
2023-04-17 13:35,1419,1184,235,113227,108380,4847,65728110.0,62904487.0,2823623.0,1404,1175,229,112482,108136,4346,65288485.0,62757195.0,2531289.0,0.5804,0.5826,0.5804,0.5824
2023-04-17 13:40,1384,1354,30,97553,97080,473,56648651.0,56372509.0,276141.0,1372,1346,26,97344,96897,447,56522762.0,56261318.0,261443.0,0.5807,0.5838,0.5806,0.5849
2023-04-17 13:45,2029,1978,51,139920,138216,1704,81253660.0,80288320.0,965340.0,2014,1966,48,139400,137755,1645,80966215.0,80005218.0,960997.0,0.5809,0.5665,0.5808,0.5842
2023-04-17 13:50,865,843,22,54720,53698,1022,31753812.0,31157581.0,596231.0,847,832,15,54350,53633,717,31542393.0,31120843.0,421550.0,0.5802,0.5834,0.5803,0.5879
2023-04-17 13:55,126,111,15,5197,4615,582,3034083.0,2693859.0,340224.0,118,104,14,4973,4308,665,2887917.0,2499252.0,388664.0,0.5837,0.5846,0.5801,0.5845
2023-04-17 14:00,481,422,59,27391,23867,3524,31518766.0,29462002.0,2056763.0,459,409,50,26746,23286,3460,31145280.0,29125129.0,2020150.0,1.2344,0.5836,1.2508,0.5839
2023-04-17 14:05,535,478,57,37554,31862,5692,21814809.0,18497407.0,3317402.0,520,471,49,37194,31777,5417,21600609.0,18443672.0,3156937.0,0.5805,0.5828,0.5804,0.5828
2023-04-17 14:10,124,110,14,7375,6918,457,4288120.0,4018191.0,269929.0,114,103,11,7278,6727,551,4226505.0,3905220.0,321285.0,0.5808,0.5907,0.5805,0.5831
2023-04-17 14:15,1692,1528,164,97877,94244,3633,56834364.0,54710500.0,2123864.0,1686,1523,163,96477,92894,3583,56038198.0,53943397.0,2094801.0,0.5805,0.5846,0.5807,0.5847
2023-04-17 14:20,1587,1538,49,99629,95981,3648,89105657.0,86973590.0,2132066.0,1576,1532,44,98966,95748,3218,88719383.0,86841132.0,1878251.0,0.9062,0.5844,0.907,0.5837
2023-04-17 14:25,2401,2362,39,161882,161218,664,94025462.0,93636985.0,388477.0,2385,2350,35,161699,161069,630,93918010.0,93549320.0,368690.0,0.5808,0.5851,0.5808,0.5852
2023-04-17 14:30,1029,1004,25,78064,77148,916,45338790.0,44802285.0,536504.0,1014,995,19,77580,77244,336,45054613.0,44857358.0,197254.0,0.5807,0.5857,0.5807,0.5871
2023-04-17 14:35,1101,1091,10,93950,93360,590,54542317.0,54197747.0,344569.0,1097,1090,7,93968,93055,913,54560581.0,54026282.0,534299.0,0.5805,0.584,0.5806,0.5852
2023-04-17 14:40,226,211,15,19326,18778,548,11218432.0,10903135.0,315296.0,213,208,5,19033,18635,398,11052434.0,10819594.0,232840.0,0.5806,0.5754,0.5806,0.585
2023-04-17 14:45,31,24,7,1911,1291,620,1121110.0,759730.0,361380.0,14,10,4,2423,802,1621,1433627.0,465826.0,967800.0,0.5885,0.5829,0.5808,0.597
2023-04-17 14:50,69,60,9,5277,3531,1746,3067938.0,2053850.0,1014087.0,56,51,5,4710,3775,935,2734008.0,2187740.0,546268.0,0.5817,0.5808,0.5795,0.5842
2023-04-17 14:55,219,217,2,876,856,20,508174.0,497508.0,10666.0,215,214,1,902,897,5,524362.0,521427.0,2935.0,0.5812,0.5333,0.5813,0.587
2023-04-17 15:00,66,55,11,3559,2542,1017,2073525.0,1479058.0,594467.0,60,55,5,2305,1659,646,1339989.0,963520.0,376469.0,0.5818,0.5845,0.5808,0.5828
2023-04-17 15:05,236,217,19,18257,16485,1772,26268629.0,25232317.0,1036311.0,203,197,6,17320,16202,1118,25680836.0,25024508.0,656328.0,1.5306,0.5848,1.5445,0.5871
2023-04-17 15:10,144,97,47,12311,7214,5097,7180564.0,4201428.0,2979136.0,133,91,42,11633,7074,4559,6777082.0,4112554.0,2664527.0,0.5824,0.5845,0.5814,0.5845
2023-04-17 15:15,386,365,21,34398,32226,2172,20016294.0,18748617.0,1267677.0,375,356,19,32980,31323,1657,19190820.0,18222792.0,968028.0,0.5818,0.5836,0.5818,0.5842
2023-04-17 15:20,441,390,51,36432,34623,1809,21205745.0,20143386.0,1062358.0,425,384,41,35366,33976,1390,20579857.0,19766210.0,813646.0,0.5818,0.5873,0.5818,0.5854
2023-04-17 15:25,341,134,207,24899,6718,18181,14557957.0,3949107.0,10608850.0,320,125,195,23580,6033,17547,13747906.0,3507844.0,10240061.0,0.5878,0.5835,0.5814,0.5836
2023-04-17 15:30,240,150,90,19544,11039,8505,11393298.0,6427337.0,4965961.0,227,146,81,20926,12256,8670,12181926.0,7116664.0,5065261.0,0.5822,0.5839,0.5807,0.5842
2023-04-17 15:35,57,18,39,9817,2250,7567,5734493.0,1308929.0,4425564.0,48,16,32,9328,2235,7093,5447189.0,1300047.0,4147142.0,0.5817,0.5849,0.5817,0.5847
2023-04-17 15:40,961,630,331,74265,46694,27571,43352229.0,27251255.0,16100974.0,937,616,321,73394,46037,27357,42791524.0,26814444.0,15977080.0,0.5836,0.584,0.5825,0.584
2023-04-17 15:45,791,449,342,59131,34055,25076,34478408.0,19836616.0,14641792.0,771,435,336,57835,33348,24487,33721545.0,19422913.0,14298631.0,0.5825,0.5839,0.5824,0.5839
2023-04-17 15:50,718,74,644,92626,7343,85283,100666448.0,51120059.0,49546388.0,691,57,634,89534,6754,82780,98997345.0,50769166.0,48228179.0,6.9617,0.581,7.5169,0.5826
2023-04-17 15:55,1642,590,1052,230484,59808,170676,181159318.0,81576709.0,99582609.0,1616,574,1042,227289,56996,170293,179332671.0,79952134.0,99380536.0,1.364,0.5835,1.4028,0.5836
2023-04-17 16:00,406,156,250,32107,9374,22733,18715369.0,5456832.0,13258537.0,382,141,241,32605,9935,22670,18996643.0,5772280.0,13224363.0,0.5821,0.5832,0.581,0.5833
2023-04-17 16:05,1588,379,1209,224818,15014,209804,131120884.0,8751348.0,122369536.0,1559,362,1197,222373,13569,208804,129703857.0,7887271.0,121816586.0,0.5829,0.5833,0.5813,0.5834
2023-04-17 16:10,1771,496,1275,214430,18891,195539,125046417.0,10969365.0,114077051.0,1754,485,1269,213014,17511,195503,124270490.0,10179281.0,114091208.0,0.5807,0.5834,0.5813,0.5836
2023-04-17 16:15,546,242,304,59422,17925,41497,34649195.0,10431206.0,24217988.0,535,236,299,59604,18496,41108,34742903.0,10753145.0,23989758.0,0.5819,0.5836,0.5814,0.5836
2023-04-17 16:20,1483,298,1185,218180,16808,201372,127306617.0,9785744.0,117520872.0,1469,292,1177,216934,15541,201393,126580399.0,9031285.0,117549114.0,0.5822,0.5836,0.5811,0.5837
2023-04-17 16:25,1105,798,307,97169,63701,33468,56544167.0,37036034.0,19508133.0,1086,791,295,97015,63683,33332,56453458.0,37023917.0,19429541.0,0.5814,0.5829,0.5814,0.5829
2023-04-17 16:30,351,85,266,29886,3315,26571,17414426.0,1925719.0,15488706.0,327,78,249,29518,3053,26465,17205667.0,1773109.0,15432558.0,0.5809,0.5829,0.5808,0.5831
2023-04-17 16:35,316,161,155,27275,11234,16041,15903282.0,6539566.0,9363716.0,304,151,153,26821,10758,16063,15637700.0,6259203.0,9378497.0,0.5821,0.5837,0.5818,0.5839
2023-04-17 16:40,576,496,80,52628,39672,12956,30652526.0,23083455.0,7569071.0,573,496,77,52694,39729,12965,30678833.0,23102874.0,7575958.0,0.5819,0.5842,0.5815,0.5843
2023-04-17 16:45,141,77,64,15452,4172,11280,9010087.0,2425893.0,6584193.0,138,75,63,15269,3914,11355,8904084.0,2276017.0,6628067.0,0.5815,0.5837,0.5815,0.5837
2023-04-17 16:50,261,248,13,5856,5341,515,3408695.0,3108308.0,300387.0,249,240,9,5712,5347,365,3321058.0,3107914.0,213144.0,0.582,0.5833,0.5812,0.584
2023-04-17 16:55,1198,304,894,156699,12060,144639,91439303.0,7015938.0,84423364.0,1186,300,886,156060,11891,144169,91084933.0,6911142.0,84173791.0,0.5818,0.5837,0.5812,0.5839
2023-04-17 17:00,1280,214,1066,149092,11762,137330,86889374.0,6829906.0,80059468.0,1270,208,1062,147768,10850,136918,86172186.0,6301812.0,79870373.0,0.5807,0.583,0.5808,0.5833
2023-04-17 17:05,110,25,85,9304,2284,7020,5421713.0,1328936.0,4092777.0,106,19,87,8905,1431,7474,5189556.0,827205.0,4362350.0,0.5818,0.583,0.5781,0.5837
2023-04-17 17:10,801,136,665,75008,7413,67595,43718646.0,4317277.0,39401369.0,788,131,657,75412,8510,66902,43952783.0,4943436.0,39009346.0,0.5824,0.5829,0.5809,0.5831
2023-04-17 17:15,390,49,341,36225,2541,33684,21082750.0,1475262.0,19607487.0,367,39,328,34932,2080,32852,20341674.0,1208392.0,19133281.0,0.5806,0.5821,0.581,0.5824
2023-04-17 17:20,221,54,167,19583,3408,16175,27501900.0,18089330.0,9412569.0,197,38,159,17647,2792,14855,25879281.0,17230543.0,8648738.0,5.3079,0.5819,6.1714,0.5822
2023-04-17 17:25,74,31,43,3763,1276,2487,2192481.0,745268.0,1447213.0,49,15,34,2852,804,2048,1659700.0,466238.0,1193461.0,0.5841,0.5819,0.5799,0.5827
2023-04-17 17:30,610,424,186,47048,29968,17080,27433922.0,17472021.0,9961901.0,593,412,181,45664,28961,16703,26578315.0,16834740.0,9743574.0,0.583,0.5832,0.5813,0.5833
2023-04-17 17:35,1370,1137,233,140817,117391,23426,98049686.0,84386530.0,13663155.0,1345,1118,227,140409,116913,23496,97797835.0,84093923.0,13703911.0,0.7189,0.5832,0.7193,0.5832
2023-04-17 17:40,356,164,192,33263,13655,19608,19376617.0,7938738.0,11437878.0,343,161,182,33486,14154,19332,19490272.0,8212635.0,11277636.0,0.5814,0.5833,0.5802,0.5834
2023-04-17 17:45,265,114,151,22271,7742,14529,12973687.0,4500555.0,8473132.0,254,107,147,21793,7643,14150,12697377.0,4443846.0,8253531.0,0.5813,0.5832,0.5814,0.5833
2023-04-17 17:50,724,237,487,86703,24342,62361,66646469.0,30274838.0,36371631.0,704,224,480,84594,23609,60985,65413554.0,29840592.0,35572961.0,1.2437,0.5832,1.2639,0.5833
2023-04-17 17:55,2316,1306,1010,288289,146955,141334,184140693.0,101640015.0,82500678.0,2278,1280,998,285321,144745,140576,182329592.0,100251741.0,82077851.0,0.6916,0.5837,0.6926,0.5839
2023-04-17 18:00,402,146,256,43948,9061,34887,25630836.0,5267109.0,20363727.0,397,143,254,45097,10081,35016,26276163.0,5837688.0,20438474.0,0.5813,0.5837,0.5791,0.5837
2023-04-17 18:05,100,60,40,9576,3291,6285,5600798.0,1913423.0,3687374.0,88,52,36,8686,3066,5620,5070260.0,1783519.0,3286740.0,0.5814,0.5867,0.5817,0.5848
2023-04-17 18:10,388,235,153,9223,3248,5975,21506258.0,18011239.0,3495019.0,102,42,60,8164,2108,6056,20886025.0,17347741.0,3538284.0,5.5453,0.5849,8.2295,0.5843
2023-04-17 18:15,2444,1962,482,306388,246156,60232,178245673.0,143035602.0,35210071.0,2443,1969,474,306469,246830,59639,178289098.0,143423874.0,34865223.0,0.5811,0.5846,0.5811,0.5846
2023-04-17 18:20,1444,1127,317,164590,123540,41050,95803918.0,71805677.0,23998240.0,1428,1117,311,164083,123005,41078,95520316.0,71493533.0,24026783.0,0.5812,0.5846,0.5812,0.5849
2023-04-17 18:25,444,436,8,55765,54759,1006,32435115.0,31842435.0,592679.0,434,425,9,56024,54499,1525,32584958.0,31690706.0,894252.0,0.5815,0.5891,0.5815,0.5864
2023-04-17 18:30,914,783,131,72261,66630,5631,42054571.0,38771013.0,3283558.0,886,761,125,71031,65598,5433,41348468.0,38171416.0,3177051.0,0.5819,0.5831,0.5819,0.5848
2023-04-17 18:35,405,368,37,18210,15268,2942,10651907.0,8929562.0,1722344.0,395,367,28,18235,15705,2530,10636379.0,9152086.0,1484293.0,0.5849,0.5854,0.5827,0.5867
2023-04-18 10:00,3754,2770,984,540176,481756,58420,390626314.0,356111133.0,34515181.0,3377,2586,791,517128,466901,50227,363175409.0,333629371.0,29546038.0,0.7392,0.5908,0.7146,0.5883
2023-04-18 10:05,2058,1202,856,216587,165785,50802,143070114.0,113127256.0,29942858.0,1913,1133,780,210864,162126,48738,138066088.0,109367853.0,28698234.0,0.6824,0.5894,0.6746,0.5888
2023-04-18 10:10,3284,2473,811,465766,401439,64327,419443703.0,381358675.0,38085028.0,2915,2320,595,440108,391350,48758,404057102.0,375234979.0,28822123.0,0.95,0.5921,0.9588,0.5911
2023-04-18 10:15,1929,1324,605,137372,80074,57298,129525431.0,95699700.0,33825730.0,1639,1189,450,128387,74732,53655,124049948.0,92343612.0,31706335.0,1.1951,0.5903,1.2357,0.5909
2023-04-18 10:20,806,401,405,76553,32150,44403,93679129.0,67540956.0,26138172.0,597,303,294,61962,23472,38490,85004631.0,62187644.0,22816986.0,2.1008,0.5887,2.6494,0.5928
2023-04-18 10:25,2086,1039,1047,222509,88821,133688,292534184.0,213676330.0,78857854.0,1872,952,920,209852,82862,126990,285134340.0,209970015.0,75164324.0,2.4057,0.5899,2.534,0.5919
2023-04-18 10:30,946,505,441,77457,42280,35177,93947076.0,73220283.0,20726792.0,840,458,382,75102,41258,33844,92613061.0,72609443.0,20003618.0,1.7318,0.5892,1.7599,0.5911
2023-04-18 10:35,614,298,316,88636,17810,70826,52456963.0,10483958.0,41973005.0,571,276,295,87628,17530,70098,51864745.0,10317634.0,41547111.0,0.5887,0.5926,0.5886,0.5927
2023-04-18 10:40,426,168,258,75516,9060,66456,60985776.0,21565461.0,39420314.0,364,134,230,72595,7290,65305,59146758.0,20416006.0,38730751.0,2.3803,0.5932,2.8005,0.5931
2023-04-18 10:45,305,221,84,20802,16091,4711,12277297.0,9485841.0,2791456.0,243,192,51,18110,14558,3552,10685975.0,8579344.0,2106631.0,0.5895,0.5925,0.5893,0.5931
2023-04-18 10:50,731,513,218,51918,35602,16316,46846142.0,37145867.0,9700275.0,677,493,184,50393,35128,15265,45924439.0,36868948.0,9055491.0,1.0434,0.5945,1.0496,0.5932
2023-04-18 10:55,4406,2290,2116,511515,289575,221940,661321647.0,529137506.0,132184141.0,3336,1703,1633,443224,251853,191371,619064591.0,505216602.0,113847989.0,1.8273,0.5956,2.006,0.5949
2023-04-18 11:00,3377,1963,1414,349167,211710,137457,421159925.0,338043124.0,83116800.0,2233,1371,862,283802,178021,105781,381579990.0,317156333.0,64423657.0,1.5967,0.6047,1.7816,0.609
2023-04-18 11:05,3610,2220,1390,456308,351340,104968,389583409.0,326055268.0,63528140.0,3133,1972,1161,427020,338741,88279,371643767.0,317979564.0,53664203.0,0.928,0.6052,0.9387,0.6079
2023-04-18 11:10,2017,1082,935,161824,78315,83509,210388876.0,160124044.0,50264832.0,1668,880,788,144564,69825,74739,200126207.0,154886268.0,45239939.0,2.0446,0.6019,2.2182,0.6053
2023-04-18 11:15,837,505,332,66554,31441,35113,72276970.0,51197565.0,21079405.0,612,374,238,49632,26735,22897,62131955.0,48282323.0,13849631.0,1.6284,0.6003,1.806,0.6049
2023-04-18 11:20,785,411,374,60865,27466,33399,52474548.0,32657264.0,19817283.0,578,290,288,50045,18420,31625,46240388.0,27159320.0,19081068.0,1.189,0.5933,1.4744,0.6034
2023-04-18 11:25,700,360,340,63944,25142,38802,38249480.0,15126252.0,23123227.0,539,267,272,49943,18548,31395,29985952.0,11081669.0,18904282.0,0.6016,0.5959,0.5975,0.6021
2023-04-18 11:30,941,524,417,83695,38760,44935,50095046.0,23187580.0,26907465.0,823,451,372,76318,37033,39285,45749977.0,22122358.0,23627619.0,0.5982,0.5988,0.5974,0.6014
2023-04-18 11:35,1355,580,775,128901,42259,86642,93830502.0,41711871.0,52118631.0,1209,488,721,113895,32002,81893,84591661.0,35321812.0,49269849.0,0.9871,0.6015,1.1037,0.6016
2023-04-18 11:40,1437,1005,432,123169,83847,39322,138697998.0,114960731.0,23737266.0,1259,922,337,118782,86426,32356,136022767.0,116441595.0,19581171.0,1.3711,0.6037,1.3473,0.6052
2023-04-18 11:45,3299,1102,2197,438516,109896,328620,311659477.0,114308209.0,197351267.0,3090,980,2110,423873,103705,320168,303607058.0,110608213.0,192998845.0,1.0401,0.6005,1.0666,0.6028
2023-04-18 11:50,3907,675,3232,599103,43327,555776,440272254.0,106522140.0,333750114.0,3724,544,3180,591038,37421,553617,435485021.0,102937134.0,332547887.0,2.4586,0.6005,2.7508,0.6007
2023-04-18 11:55,3144,1067,2077,434089,82772,351317,341241040.0,130154751.0,211086289.0,3008,988,2020,421278,76357,344921,333497694.0,126264728.0,207232965.0,1.5724,0.6008,1.6536,0.6008
2023-04-18 12:00,488,178,310,51647,10639,41008,63179172.0,38625134.0,24554038.0,404,132,272,49063,10285,38778,61671747.0,38383981.0,23287766.0,3.6305,0.5988,3.732,0.6005
2023-04-18 12:05,369,147,222,23378,7178,16200,14032270.0,4309029.0,9723241.0,321,124,197,21822,6651,15171,13094676.0,3975581.0,9119094.0,0.6003,0.6002,0.5977,0.6011
2023-04-18 12:10,672,369,303,53020,18824,34196,31968645.0,11337593.0,20631051.0,588,311,277,44179,14492,29687,26546341.0,8666866.0,17879475.0,0.6023,0.6033,0.598,0.6023
2023-04-18 12:15,1155,599,556,102372,30582,71790,109769161.0,66687138.0,43082022.0,1084,551,533,100503,29691,70812,108694126.0,66149092.0,42545034.0,2.1806,0.6001,2.2279,0.6008
2023-04-18 12:20,410,258,152,30153,16610,13543,18133876.0,9979139.0,8154737.0,362,230,132,28581,16003,12578,17149395.0,9578127.0,7571268.0,0.6008,0.6021,0.5985,0.6019
2023-04-18 12:25,2625,448,2177,399571,35594,363977,272196108.0,53564968.0,218631140.0,2545,407,2138,395936,35243,360693,270165703.0,53301365.0,216864338.0,1.5049,0.6007,1.5124,0.6012
2023-04-18 12:30,2062,320,1742,252403,19942,232461,167548900.0,28078295.0,139470605.0,1991,287,1704,249617,19013,230604,165973756.0,27487741.0,138486014.0,1.408,0.6,1.4457,0.6005
2023-04-18 12:35,2128,120,2008,283643,5683,277960,170015636.0,3361658.0,166653977.0,2060,87,1973,282635,2649,279986,169631359.0,1578922.0,168052436.0,0.5915,0.5996,0.596,0.6002
2023-04-18 12:40,1663,501,1162,200918,38760,162158,152244124.0,55260219.0,96983904.0,1512,408,1104,191605,34200,157405,146839922.0,52561846.0,94278076.0,1.4257,0.5981,1.5369,0.599
2023-04-18 12:45,1718,414,1304,224246,31014,193232,166438615.0,50744790.0,115693825.0,1614,377,1237,220605,29861,190744,164285268.0,50025573.0,114259695.0,1.6362,0.5987,1.6753,0.599
2023-04-18 12:50,2730,518,2212,359621,38692,320929,230865279.0,39179112.0,191686167.0,2597,450,2147,349765,35585,314180,225366215.0,37313992.0,188052222.0,1.0126,0.5973,1.0486,0.5985
2023-04-18 12:55,2608,142,2466,443489,4460,439029,281291084.0,18789025.0,262502058.0,2495,87,2408,435578,2969,432609,276761752.0,17878307.0,258883445.0,4.2128,0.5979,6.0217,0.5984
2023-04-18 13:00,3183,1434,1749,376504,167956,208548,400167224.0,276602722.0,123564502.0,2789,1199,1590,342542,148394,194148,380514405.0,265118252.0,115396153.0,1.6469,0.5925,1.7866,0.5944
2023-04-18 13:05,2590,1336,1254,289251,160944,128307,236195603.0,159899629.0,76295974.0,2474,1281,1193,287508,162432,125076,235084919.0,160675379.0,74409540.0,0.9935,0.5946,0.9892,0.5949
2023-04-18 13:10,3106,436,2670,397076,47373,349703,236163597.0,28073311.0,208090285.0,2995,366,2629,392369,45636,346733,233493232.0,27033100.0,206460132.0,0.5926,0.595,0.5924,0.5954
2023-04-18 13:15,2186,491,1695,295565,22686,272879,240311861.0,77988889.0,162322971.0,2087,426,1661,289658,18058,271600,236835593.0,75176433.0,161659159.0,3.4378,0.5949,4.1631,0.5952
2023-04-18 13:20,2396,681,1715,383149,38518,344631,228852990.0,22878295.0,205974694.0,2346,657,1689,381879,37965,343914,228140844.0,22550794.0,205590050.0,0.594,0.5977,0.594,0.5978
2023-04-18 13:25,1513,301,1212,244065,20237,223828,209620486.0,76470079.0,133150407.0,1471,276,1195,241759,19420,222339,208316326.0,75987530.0,132328796.0,3.7787,0.5949,3.9128,0.5952
2023-04-18 13:30,213,97,116,23705,8176,15529,14400154.0,5120187.0,9279966.0,186,76,110,17724,4462,13262,10588677.0,2645987.0,7942690.0,0.6262,0.5976,0.593,0.5989
2023-04-18 13:35,656,221,435,70637,18910,51727,58326683.0,27383979.0,30942704.0,605,183,422,67173,16446,50727,56255216.0,25904351.0,30350864.0,1.4481,0.5982,1.5751,0.5983
2023-04-18 13:40,1483,924,559,187539,110239,77300,128109248.0,81909886.0,46199361.0,1417,890,527,184413,108489,75924,126123758.0,80724255.0,45399502.0,0.743,0.5977,0.7441,0.598
2023-04-18 13:45,4974,2620,2354,709262,337833,371429,681689840.0,459802932.0,221886908.0,4762,2509,2253,685036,325268,359768,667251910.0,451903367.0,215348543.0,1.361,0.5974,1.3893,0.5986
2023-04-18 13:50,1859,1363,496,226585,201367,25218,265031584.0,249870040.0,15161544.0,1729,1312,417,219465,197378,22087,260665104.0,247310738.0,13354366.0,1.2409,0.6012,1.253,0.6046
2023-04-18 13:55,4034,2667,1367,488502,369953,118549,469640231.0,398835059.0,70805172.0,3825,2551,1274,466048,358821,107227,456166160.0,391748765.0,64417395.0,1.0781,0.5973,1.0918,0.6008
2023-04-18 14:00,1128,787,341,104410,84056,20354,94568523.0,82388045.0,12180478.0,1074,772,302,100006,81858,18148,92002006.0,81099975.0,10902031.0,0.9802,0.5984,0.9907,0.6007
2023-04-18 14:05,2578,1635,943,331201,235325,95876,309622570.0,252728411.0,56894159.0,2455,1564,891,321367,230601,90766,304211693.0,249911192.0,54300500.0,1.074,0.5934,1.0837,0.5982
2023-04-18 14:10,2013,1043,970,222232,127714,94518,164791656.0,108223999.0,56567656.0,1911,983,928,215536,124833,90703,160819236.0,106502649.0,54316587.0,0.8474,0.5985,0.8532,0.5988
2023-04-18 14:15,2301,1546,755,334024,270564,63460,199005162.0,161018389.0,37986772.0,2274,1534,740,334578,270757,63821,199328593.0,161127121.0,38201471.0,0.5951,0.5986,0.5951,0.5986
2023-04-18 14:20,2076,1441,635,233012,181279,51733,138921216.0,107919249.0,31001967.0,2023,1403,620,231104,180204,50900,137735186.0,107240361.0,30494825.0,0.5953,0.5993,0.5951,0.5991
2023-04-18 14:25,1655,659,996,107504,46557,60947,80377739.0,43891719.0,36486020.0,1636,648,988,106398,45840,60558,79720159.0,43455793.0,36264365.0,0.9428,0.5987,0.948,0.5988
2023-04-18 14:30,857,367,490,65210,23778,41432,39068967.0,14226761.0,24842206.0,834,355,479,65229,24098,41131,39069132.0,14403817.0,24665315.0,0.5983,0.5996,0.5977,0.5997
2023-04-18 14:35,696,562,134,68504,60626,7878,56993423.0,52270061.0,4723361.0,671,551,120,68291,60206,8085,56866910.0,52011765.0,4855144.0,0.8622,0.5996,0.8639,0.6005
2023-04-18 14:40,545,493,52,55846,53790,2056,33329169.0,32106142.0,1223026.0,522,483,39,55040,53468,1572,32837974.0,31893265.0,944709.0,0.5969,0.5949,0.5965,0.601
2023-04-18 14:45,1834,1484,350,263577,233750,29827,221565300.0,203720532.0,17844767.0,1792,1462,330,261659,233018,28641,220379515.0,203241588.0,17137926.0,0.8715,0.5983,0.8722,0.5984
2023-04-18 14:50,1002,780,222,141315,115368,25947,148987846.0,133583052.0,15404794.0,914,729,185,133426,110284,23142,144231909.0,130368818.0,13863091.0,1.1579,0.5937,1.1821,0.599
2023-04-18 14:55,142,97,45,14718,11783,2935,24917883.0,23156313.0,1761570.0,120,80,40,12990,10642,2348,23883358.0,22470821.0,1412536.0,1.9652,0.6002,2.1115,0.6016
2023-04-18 15:00,720,347,373,61153,33555,27598,36484928.0,20016160.0,16468767.0,698,340,358,59538,32892,26646,35583127.0,19617308.0,15965819.0,0.5965,0.5967,0.5964,0.5992
2023-04-18 15:05,218,33,185,17358,1633,15725,26539386.0,17118113.0,9421272.0,205,30,175,16468,1919,14549,25977468.0,17263196.0,8714271.0,10.4826,0.5991,8.9959,0.599
2023-04-18 15:10,223,57,166,12589,2299,10290,7519825.0,1379654.0,6140171.0,199,45,154,11716,1927,9789,7020217.0,1151440.0,5868776.0,0.6001,0.5967,0.5975,0.5995
2023-04-18 15:15,494,308,186,42137,22048,20089,105529996.0,93749541.0,11780455.0,464,291,173,39440,21042,18398,104181054.0,93152190.0,11028864.0,4.2521,0.5864,4.427,0.5995
2023-04-18 15:20,1416,446,970,189418,71354,118064,129299680.0,58608989.0,70690691.0,1381,420,961,188313,70973,117340,128662526.0,58372153.0,70290373.0,0.8214,0.5987,0.8225,0.599
2023-04-18 15:25,243,117,126,20601,8661,11940,12295923.0,5163758.0,7132164.0,230,109,121,20340,8323,12017,12151696.0,4959205.0,7192490.0,0.5962,0.5973,0.5958,0.5985
2023-04-18 15:30,179,70,109,11604,4580,7024,6910007.0,2732323.0,4177684.0,146,53,93,10993,4533,6460,6573283.0,2700001.0,3873282.0,0.5966,0.5948,0.5956,0.5996
2023-04-18 15:35,701,350,351,56739,25484,31255,50125185.0,31373350.0,18751835.0,664,330,334,54369,23677,30692,48646022.0,30248907.0,18397115.0,1.2311,0.6,1.2776,0.5994
2023-04-18 15:40,982,617,365,126628,68014,58614,75764264.0,40626789.0,35137474.0,962,610,352,126355,67972,58383,75607030.0,40595353.0,35011676.0,0.5973,0.5995,0.5972,0.5997
2023-04-18 15:45,614,401,213,54942,32887,22055,32880068.0,19658566.0,13221502.0,587,389,198,53196,32667,20529,31815547.0,19513836.0,12301710.0,0.5978,0.5995,0.5974,0.5992
2023-04-18 15:50,164,121,43,16269,11169,5100,9754145.0,6697292.0,3056853.0,149,112,37,15619,10458,5161,9340094.0,6245174.0,3094920.0,0.5996,0.5994,0.5972,0.5997
2023-04-18 15:55,207,87,120,20690,7576,13114,12226614.0,4520209.0,7706405.0,178,72,106,18062,6985,11077,10799816.0,4164159.0,6635657.0,0.5966,0.5876,0.5962,0.599
2023-04-18 16:00,1062,184,878,107470,14165,93305,64243948.0,8444220.0,55799727.0,1037,169,868,107012,13731,93281,64023155.0,8182984.0,55840170.0,0.5961,0.598,0.5959,0.5986
2023-04-18 16:05,1117,259,858,112009,21200,90809,66965771.0,12641418.0,54324353.0,1112,260,852,113173,21311,91862,67664739.0,12701276.0,54963463.0,0.5963,0.5982,0.596,0.5983
2023-04-18 16:10,1873,372,1501,299774,25109,274665,227470928.0,63323715.0,164147213.0,1831,340,1491,294897,23261,271636,224708160.0,62218765.0,162489394.0,2.522,0.5976,2.6748,0.5982
2023-04-18 16:15,3267,244,3023,554071,13269,540802,347128521.0,24026774.0,323101747.0,3228,221,3007,552555,12901,539654,346282946.0,23803100.0,322479846.0,1.8107,0.5974,1.8451,0.5976
2023-04-18 16:20,4210,189,4021,755916,8163,747753,451602984.0,4862609.0,446740375.0,4186,165,4021,756014,7784,748230,451689247.0,4633852.0,447055395.0,0.5957,0.5974,0.5953,0.5975
2023-04-18 16:25,3227,560,2667,460439,17621,442818,307536008.0,42733136.0,264802872.0,3205,540,2665,460217,17243,442974,307408414.0,42505172.0,264903241.0,2.4251,0.598,2.4651,0.598
2023-04-18 16:30,2636,415,2221,354929,20288,334641,212079106.0,12085063.0,199994043.0,2617,402,2215,351741,20058,331683,210150284.0,11934211.0,198216073.0,0.5957,0.5976,0.595,0.5976
2023-04-18 16:35,3247,2169,1078,300338,153096,147242,211469286.0,123438272.0,88031014.0,3221,2155,1066,300147,152802,147345,211344403.0,123249306.0,88095097.0,0.8063,0.5979,0.8066,0.5979
2023-04-18 16:40,1836,925,911,192576,72047,120529,115000212.0,42925744.0,72074467.0,1808,910,898,191322,71618,119704,114239301.0,42657950.0,71581351.0,0.5958,0.598,0.5956,0.598
2023-04-18 16:45,3569,2503,1066,448323,299902,148421,283985336.0,195152759.0,88832577.0,3511,2471,1040,442063,294738,147325,279969188.0,191790470.0,88178718.0,0.6507,0.5985,0.6507,0.5985
2023-04-18 16:50,5095,4143,952,680313,560552,119761,486634089.0,414930348.0,71703741.0,5042,4113,929,678414,558825,119589,485405248.0,413735537.0,71669710.0,0.7402,0.5987,0.7404,0.5993
2023-04-18 16:55,1391,1366,25,171246,170190,1056,102194353.0,101559068.0,635285.0,1371,1357,14,171186,170713,473,102109993.0,101821425.0,288567.0,0.5967,0.6016,0.5964,0.6101
2023-04-18 17:00,832,815,17,99923,99153,770,59667414.0,59203297.0,464116.0,813,802,11,99286,98504,782,59253329.0,58779955.0,473373.0,0.5971,0.6027,0.5967,0.6053
2023-04-18 17:05,2714,2647,67,367849,363408,4441,235500391.0,232834381.0,2666010.0,2670,2622,48,364505,362044,2461,233490002.0,232013078.0,1476923.0,0.6407,0.6003,0.6408,0.6001
2023-04-18 17:10,2752,2725,27,381567,380370,1197,227457907.0,226738534.0,719372.0,2732,2711,21,382002,380335,1667,227718247.0,226714503.0,1003743.0,0.5961,0.601,0.5961,0.6021
2023-04-18 17:15,1620,1563,57,318392,314221,4171,205801790.0,203349610.0,2452179.0,1585,1544,41,316349,313837,2512,204619457.0,203109329.0,1510127.0,0.6472,0.5879,0.6472,0.6012
2023-04-18 17:20,1190,1168,22,249669,247604,2065,148661972.0,147433243.0,1228729.0,1170,1149,21,249403,246986,2417,148520172.0,147071055.0,1449116.0,0.5954,0.595,0.5955,0.5996
2023-04-18 17:25,414,388,26,78688,76459,2229,62898644.0,61561827.0,1336817.0,390,370,20,75492,73989,1503,61121297.0,60218782.0,902515.0,0.8052,0.5997,0.8139,0.6005
2023-04-18 17:30,200,182,18,26630,24984,1646,15895318.0,14908173.0,987144.0,183,170,13,27283,25060,2223,16277509.0,14944296.0,1333212.0,0.5967,0.5997,0.5963,0.5997
2023-04-18 17:35,121,107,14,10679,9897,782,6365459.0,5905174.0,460284.0,106,99,7,10534,9888,646,6286843.0,5899653.0,387190.0,0.5967,0.5886,0.5966,0.5994
2023-04-18 17:40,77,48,29,7049,2565,4484,4238895.0,1534169.0,2704726.0,64,40,24,6437,2523,3914,3871740.0,1506897.0,2364843.0,0.5981,0.6032,0.5973,0.6042
2023-04-18 17:45,142,90,52,9931,7046,2885,5931248.0,4208449.0,1722798.0,116,71,45,9178,6337,2841,5489331.0,3784297.0,1705034.0,0.5973,0.5972,0.5972,0.6002
2023-04-18 17:50,277,144,133,18188,13599,4589,10872649.0,8122119.0,2750529.0,257,131,126,17911,13604,4307,10724215.0,8120966.0,2603249.0,0.5973,0.5994,0.597,0.6044
2023-04-18 17:55,210,124,86,18988,14262,4726,11330146.0,8500893.0,2829253.0,199,118,81,18838,14180,4658,11242795.0,8453818.0,2788977.0,0.5961,0.5987,0.5962,0.5987
2023-04-18 18:00,717,395,322,54046,26870,27176,32469772.0,16104863.0,16364909.0,685,375,310,49923,26604,23319,29840325.0,15859715.0,13980609.0,0.5994,0.6022,0.5961,0.5995
2023-04-18 18:05,822,427,395,65662,36567,29095,39251870.0,21826454.0,17425415.0,804,414,390,64235,35108,29127,38419257.0,20962369.0,17456888.0,0.5969,0.5989,0.5971,0.5993
2023-04-18 18:10,249,168,81,14839,12643,2196,8859886.0,7546390.0,1313496.0,229,155,74,14566,12507,2059,8697950.0,7462664.0,1235286.0,0.5969,0.5981,0.5967,0.5999
2023-04-18 18:15,301,193,108,20864,12017,8847,12489435.0,7187107.0,5302328.0,284,182,102,20373,11557,8816,12191828.0,6905101.0,5286726.0,0.5981,0.5993,0.5975,0.5997
2023-04-18 18:20,272,139,133,27307,9845,17462,16382984.0,5916614.0,10466370.0,248,122,126,26670,9298,17372,15976270.0,5556966.0,10419304.0,0.601,0.5994,0.5977,0.5998
2023-04-18 18:25,219,108,111,23261,6126,17135,13937430.0,3660469.0,10276960.0,191,86,105,20099,5528,14571,12042885.0,3301044.0,8741840.0,0.5975,0.5998,0.5971,0.5999
2023-04-18 18:30,1012,933,79,37367,27640,9727,38416035.0,32643327.0,5772708.0,241,186,55,25662,18184,7478,31459631.0,26971285.0,4488346.0,1.181,0.5935,1.4832,0.6002
2023-04-18 18:35,632,567,65,85516,73401,12115,115578541.0,108337412.0,7241129.0,618,560,58,83270,74141,9129,114251324.0,108761242.0,5490082.0,1.476,0.5977,1.467,0.6014
2023-04-19 10:00,2227,819,1408,242236,70161,172075,214370269.0,110202809.0,104167460.0,1786,603,1183,223401,64097,159304,193957470.0,97723541.0,96233928.0,1.5707,0.6054,1.5246,0.6041
2023-04-19 10:05,1606,1080,526,128032,80712,47320,129598352.0,101213588.0,28384764.0,1537,1045,492,132021,79028,52993,123445763.0,91422477.0,32023286.0,1.254,0.5998,1.1568,0.6043
2023-04-19 10:10,1036,755,281,76033,54587,21446,63222831.0,50313602.0,12909228.0,918,684,234,71632,52383,19249,60556867.0,48988098.0,11568769.0,0.9217,0.6019,0.9352,0.601
2023-04-19 10:15,3917,530,3387,525493,39630,485863,614102192.0,323262341.0,290839851.0,3736,414,3322,516650,34222,482428,608918302.0,320060494.0,288857808.0,8.157,0.5986,9.3525,0.5988
2023-04-19 10:20,3151,1133,2018,397392,86159,311233,290067150.0,104121206.0,185945944.0,2941,992,1949,387256,79615,307641,284164056.0,100150687.0,184013369.0,1.2085,0.5974,1.2579,0.5981
2023-04-19 10:25,1975,1105,870,191738,83751,107987,114472734.0,49771841.0,64700893.0,1904,1055,849,187406,79056,108350,111910141.0,47007986.0,64902155.0,0.5943,0.5992,0.5946,0.599
2023-04-19 10:30,5344,2022,3322,585674,110107,475567,385284352.0,100761519.0,284522833.0,5158,1902,3256,583072,109422,473650,383780951.0,100362409.0,283418541.0,0.9151,0.5983,0.9172,0.5984
2023-04-19 10:35,3375,327,3048,461710,19349,442361,311356478.0,46770063.0,264586415.0,3306,284,3022,460463,17553,442910,310620056.0,45699080.0,264920975.0,2.4172,0.5981,2.6035,0.5981
2023-04-19 10:40,2055,263,1792,287107,11133,275974,259718540.0,94776317.0,164942223.0,1995,218,1777,284967,10050,274917,258495307.0,94130379.0,164364928.0,8.5131,0.5977,9.3662,0.5979
2023-04-19 10:45,1740,519,1221,162168,20466,141702,132132599.0,47471714.0,84660884.0,1634,447,1187,159063,18842,140221,130265521.0,46468331.0,83797190.0,2.3195,0.5975,2.4662,0.5976
2023-04-19 10:50,13746,148,13598,2768659,7160,2761499,1718968167.0,57159617.0,1661808549.0,13711,125,13586,2767436,6156,2761280,1718244315.0,56557227.0,1661687087.0,7.9832,0.6018,9.1873,0.6018
2023-04-19 10:55,616,254,362,42932,11624,31308,43274613.0,24549663.0,18724950.0,537,206,331,40405,10910,29495,41791844.0,24131745.0,17660099.0,2.112,0.5981,2.2119,0.5987
2023-04-19 11:00,1419,317,1102,222080,19172,202908,132880970.0,11393100.0,121487869.0,1338,257,1081,216882,14059,202823,129819967.0,8357014.0,121462952.0,0.5943,0.5987,0.5944,0.5989
2023-04-19 11:05,1222,706,516,91506,35320,56186,54663355.0,21025846.0,33637509.0,1173,674,499,88517,33807,54710,52860228.0,20099179.0,32761049.0,0.5953,0.5987,0.5945,0.5988
2023-04-19 11:10,927,485,442,71034,28095,42939,42451710.0,16768827.0,25682883.0,874,445,429,68322,26210,42112,40816216.0,15599797.0,25216418.0,0.5969,0.5981,0.5952,0.5988
2023-04-19 11:15,686,310,376,54137,14894,39243,32416132.0,8898818.0,23517313.0,639,290,349,52593,14041,38552,31457788.0,8355798.0,23101990.0,0.5975,0.5993,0.5951,0.5992
2023-04-19 11:20,352,36,316,55559,2952,52607,50943805.0,19370936.0,31572869.0,325,21,304,53497,1224,52273,49733961.0,18357866.0,31376094.0,6.562,0.6002,14.9983,0.6002
2023-04-19 11:25,1997,180,1817,349021,11219,337802,208920350.0,6703157.0,202217192.0,1963,160,1803,349404,11633,337771,209149699.0,6933868.0,202215831.0,0.5975,0.5986,0.5961,0.5987
2023-04-19 11:30,1845,92,1753,349670,5598,344072,209344984.0,3334528.0,206010456.0,1809,66,1743,349076,5120,343956,208990577.0,3048022.0,205942555.0,0.5957,0.5987,0.5953,0.5987
2023-04-19 11:35,1659,157,1502,314691,7765,306926,188494867.0,4623901.0,183870966.0,1643,146,1497,314219,7576,306643,188244073.0,4513372.0,183730701.0,0.5955,0.5991,0.5957,0.5992
2023-04-19 11:40,1669,255,1414,280504,18674,261830,167912898.0,11135627.0,156777271.0,1626,226,1400,280511,18665,261846,167901469.0,11116481.0,156784988.0,0.5963,0.5988,0.5956,0.5988
2023-04-19 11:45,3113,783,2330,523946,65466,458480,330882459.0,56633590.0,274248869.0,3076,765,2311,522041,64677,457364,329781957.0,56159449.0,273622508.0,0.8651,0.5982,0.8683,0.5983
2023-04-19 11:50,3406,528,2878,487310,38128,449182,310026593.0,41258085.0,268768508.0,3369,505,2864,485405,36516,448889,307981780.0,39384319.0,268597461.0,1.0821,0.5984,1.0785,0.5984
2023-04-19 11:55,405,129,276,29189,8054,21135,17449779.0,4799714.0,12650065.0,394,125,269,28506,8056,20450,17040922.0,4801536.0,12239385.0,0.5959,0.5985,0.596,0.5985
2023-04-19 12:00,327,61,266,37217,4075,33142,22294737.0,2460933.0,19833804.0,346,79,267,32969,3961,29008,19754035.0,2357038.0,17396996.0,0.6039,0.5984,0.5951,0.5997
2023-04-19 12:05,881,427,454,74007,34246,39761,44173060.0,20398598.0,23774462.0,867,413,454,76149,34006,42143,45513522.0,20249725.0,25263797.0,0.5956,0.5979,0.5955,0.5995
2023-04-19 12:10,1643,247,1396,222038,16962,205076,150387231.0,27733249.0,122653981.0,1626,240,1386,221578,17083,204495,150119819.0,27804792.0,122315026.0,1.635,0.5981,1.6276,0.5981
2023-04-19 12:15,1618,592,1026,220130,43577,176553,149133953.0,43580872.0,105553081.0,1586,569,1017,217949,41681,176268,147832299.0,42444489.0,105387810.0,1.0001,0.5979,1.0183,0.5979
2023-04-19 12:20,1825,168,1657,282571,16046,266525,186328886.0,27180714.0,159148172.0,1796,155,1641,281655,16127,265528,185831020.0,27229662.0,158601358.0,1.6939,0.5971,1.6885,0.5973
2023-04-19 12:25,3659,508,3151,593969,48402,545567,425218344.0,99302841.0,325915503.0,3591,473,3118,591193,46651,544542,423554409.0,98251127.0,325303281.0,2.0516,0.5974,2.1061,0.5974
2023-04-19 12:30,1534,171,1363,216319,13140,203179,129163957.0,7837329.0,121326627.0,1497,166,1331,213973,11909,202064,127738835.0,7085671.0,120653163.0,0.5964,0.5971,0.595,0.5971
2023-04-19 12:35,188,36,152,38117,1300,36817,22785740.0,770994.0,22014745.0,165,22,143,37106,796,36310,22182908.0,473862.0,21709046.0,0.5931,0.598,0.5953,0.5979
2023-04-19 12:40,357,122,235,29364,9112,20252,17520329.0,5416479.0,12103849.0,342,121,221,27432,8111,19321,16387815.0,4831643.0,11556171.0,0.5944,0.5977,0.5957,0.5981
2023-04-19 12:45,629,154,475,70115,7480,62635,41905323.0,4456753.0,37448570.0,613,146,467,69951,7171,62780,41800899.0,4272099.0,37528799.0,0.5958,0.5979,0.5957,0.5978
2023-04-19 12:50,474,21,453,63938,618,63320,38202794.0,369524.0,37833269.0,449,7,442,63383,360,63023,37892759.0,214394.0,37678364.0,0.5979,0.5975,0.5955,0.5979
2023-04-19 12:55,737,335,402,67584,20119,47465,57856224.0,29624482.0,28231742.0,676,319,357,65474,19812,45662,56721251.0,29432885.0,27288365.0,1.4725,0.5948,1.4856,0.5976
2023-04-19 13:00,1633,532,1101,210272,24676,185596,143190955.0,32323544.0,110867410.0,1612,520,1092,209757,24457,185300,142880135.0,32189776.0,110690359.0,1.3099,0.5974,1.3162,0.5974
2023-04-19 13:05,1706,503,1203,224018,24550,199468,133799900.0,14612214.0,119187685.0,1698,495,1203,224011,24553,199458,133795757.0,14613880.0,119181877.0,0.5952,0.5975,0.5952,0.5975
2023-04-19 13:10,1483,278,1205,184926,13158,171768,110389411.0,7830944.0,102558466.0,1468,270,1198,184726,13082,171644,110282667.0,7784688.0,102497979.0,0.5951,0.5971,0.5951,0.5972
2023-04-19 13:15,1214,538,676,149937,31905,118032,89529461.0,19031915.0,70497545.0,1195,529,666,149670,31467,118203,89328737.0,18728684.0,70600052.0,0.5965,0.5973,0.5952,0.5973
2023-04-19 13:20,862,682,180,93242,72311,20931,55567896.0,43055273.0,12512623.0,851,675,176,92810,71944,20866,55304856.0,42832944.0,12471911.0,0.5954,0.5978,0.5954,0.5977
2023-04-19 13:25,409,277,132,39120,29209,9911,23313905.0,17395305.0,5918599.0,393,268,125,38807,29315,9492,23124229.0,17456612.0,5667617.0,0.5955,0.5972,0.5955,0.5971
2023-04-19 13:30,557,302,255,61497,37064,24433,36673206.0,22078660.0,14594546.0,546,295,251,61079,36970,24109,36423247.0,22022101.0,14401146.0,0.5957,0.5973,0.5957,0.5973
2023-04-19 13:35,443,150,293,49983,14462,35521,100309761.0,79130874.0,21178887.0,423,138,285,46349,13221,33128,98193110.0,78394980.0,19798130.0,5.4716,0.5962,5.9296,0.5976
2023-04-19 13:40,771,179,592,69653,8905,60748,41569047.0,5300157.0,36268890.0,757,172,585,69907,8845,61062,41721161.0,5264133.0,36457027.0,0.5952,0.597,0.5952,0.597
2023-04-19 13:45,412,34,378,64661,839,63822,38580053.0,504132.0,38075920.0,398,24,374,64100,531,63569,38241913.0,315734.0,37926179.0,0.6009,0.5966,0.5946,0.5966
2023-04-19 13:50,708,154,554,98412,9977,88435,58692751.0,5934426.0,52758325.0,703,143,560,96805,8844,87961,57732702.0,5257895.0,52474806.0,0.5948,0.5966,0.5945,0.5966
2023-04-19 13:55,591,31,560,123925,1655,122270,74089057.0,1001830.0,73087227.0,598,26,572,123303,679,122624,73700660.0,403324.0,73297336.0,0.6053,0.5978,0.594,0.5977
2023-04-19 14:00,1877,152,1725,270800,7734,263066,161742335.0,4612381.0,157129954.0,1860,145,1715,270355,7615,262740,161478574.0,4530651.0,156947923.0,0.5964,0.5973,0.595,0.5974
2023-04-19 14:05,1195,42,1153,207231,1443,205788,123694304.0,858415.0,122835888.0,1191,34,1157,207689,1332,206357,123968218.0,792349.0,123175869.0,0.5949,0.5969,0.5949,0.5969
2023-04-19 14:10,483,44,439,55680,1451,54229,33255368.0,863193.0,32392175.0,468,35,433,55634,1395,54239,33227425.0,829890.0,32397535.0,0.5949,0.5973,0.5949,0.5973
2023-04-19 14:15,615,350,265,52074,22687,29387,48691607.0,31135757.0,17555849.0,586,338,248,53015,23962,29053,49265416.0,31891316.0,17374100.0,1.3724,0.5974,1.3309,0.598
2023-04-19 14:20,1623,373,1250,223033,22118,200915,133221158.0,13180530.0,120040628.0,1597,360,1237,222339,21944,200395,132810496.0,13064283.0,119746212.0,0.5959,0.5975,0.5953,0.5976
2023-04-19 14:25,1489,64,1425,252383,1491,250892,150770192.0,889648.0,149880543.0,1467,51,1416,251835,1220,250615,150446437.0,725917.0,149720520.0,0.5967,0.5974,0.595,0.5974
2023-04-19 14:30,845,64,781,119376,5013,114363,71287909.0,2982393.0,68305516.0,824,53,771,119019,4861,114158,71071484.0,2888433.0,68183051.0,0.5949,0.5973,0.5942,0.5973
2023-04-19 14:35,1552,156,1396,294923,10168,284755,193775882.0,23677058.0,170098824.0,1545,151,1394,295146,10308,284838,193911124.0,23761033.0,170150091.0,2.3286,0.5974,2.3051,0.5974
2023-04-19 14:40,1084,179,905,211595,10596,200999,126360697.0,6301287.0,120059409.0,1067,170,897,211140,10374,200766,126089392.0,6169153.0,119920239.0,0.5947,0.5973,0.5947,0.5973
2023-04-19 14:45,927,53,874,164589,1794,162795,98319209.0,1078373.0,97240835.0,895,34,861,163995,1427,162568,97956606.0,848458.0,97108147.0,0.6011,0.5973,0.5946,0.5973
2023-04-19 14:50,1946,268,1678,303391,9519,293872,181349002.0,5683055.0,175665947.0,1926,258,1668,306867,10135,296732,183406746.0,6029197.0,177377549.0,0.597,0.5978,0.5949,0.5978
2023-04-19 14:55,1466,90,1376,268729,3219,265510,160867486.0,1922846.0,158944640.0,1457,86,1371,269268,3305,265963,161180754.0,1963807.0,159216947.0,0.5973,0.5986,0.5942,0.5986
2023-04-19 15:00,1350,819,531,129390,19038,110352,95078092.0,29000488.0,66077604.0,654,140,514,117981,8898,109083,88245306.0,22927671.0,65317635.0,1.5233,0.5988,2.5767,0.5988
2023-04-19 15:05,84,45,39,6019,1667,4352,3629304.0,1023686.0,2605618.0,66,39,27,4699,1322,3377,2814795.0,788665.0,2026130.0,0.6141,0.5987,0.5966,0.6
2023-04-19 15:10,75,25,50,4491,932,3559,2693717.0,560581.0,2133135.0,45,17,28,4228,883,3345,2532557.0,525686.0,2006870.0,0.6015,0.5994,0.5953,0.6
2023-04-19 15:15,344,132,212,26469,7672,18797,15833513.0,4583463.0,11250050.0,320,122,198,26437,7697,18740,15813037.0,4595734.0,11217302.0,0.5974,0.5985,0.5971,0.5986
2023-04-19 15:20,465,190,275,35716,11134,24582,21314824.0,6670130.0,14644694.0,425,179,246,34342,11133,23209,20540629.0,6644289.0,13896340.0,0.5991,0.5957,0.5968,0.5987
2023-04-19 15:25,141,36,105,12448,1401,11047,7434752.0,836577.0,6598174.0,110,33,77,9158,1821,7337,5475187.0,1076793.0,4398394.0,0.5971,0.5973,0.5913,0.5995
2023-04-19 15:30,316,25,291,20304,1438,18866,12118378.0,857899.0,11260479.0,276,21,255,19253,1068,18185,11511465.0,637507.0,10873958.0,0.5966,0.5969,0.5969,0.598
2023-04-19 15:35,231,12,219,14795,380,14415,8828327.0,229221.0,8599105.0,214,9,205,14949,856,14093,8940052.0,509124.0,8430927.0,0.6032,0.5965,0.5948,0.5982
2023-04-19 15:40,271,19,252,16141,437,15704,9649179.0,260924.0,9388254.0,264,15,249,17971,1128,16843,10788678.0,668448.0,10120230.0,0.5971,0.5978,0.5926,0.6009
2023-04-19 15:45,163,97,66,13681,2753,10928,8160589.0,1642899.0,6517689.0,129,83,46,7078,2819,4259,4227966.0,1679977.0,2547989.0,0.5968,0.5964,0.5959,0.5983
2023-04-19 15:50,447,162,285,33635,14022,19613,20516054.0,8791102.0,11724952.0,414,152,262,27760,8794,18966,16575942.0,5238527.0,11337414.0,0.627,0.5978,0.5957,0.5978
2023-04-19 15:55,131,90,41,5854,4837,1017,3489064.0,2884533.0,604531.0,116,84,32,5308,4766,542,3166586.0,2840913.0,325673.0,0.5963,0.5944,0.5961,0.6009
2023-04-19 16:00,117,100,17,9324,9073,251,5549482.0,5401973.0,147508.0,111,97,14,10719,10477,242,6376402.0,6228966.0,147435.0,0.5954,0.5877,0.5945,0.6092
2023-04-19 16:05,66,40,26,3234,2204,1030,1929274.0,1314781.0,614492.0,55,32,23,2528,1734,794,1515088.0,1033768.0,481320.0,0.5965,0.5966,0.5962,0.6062
2023-04-19 16:10,45,25,20,1439,843,596,861772.0,504786.0,356986.0,41,21,20,1086,637,449,648937.0,380112.0,268825.0,0.5988,0.599,0.5967,0.5987
2023-04-19 16:15,88,55,33,5470,4990,480,3261259.0,2976033.0,285226.0,75,48,27,5521,5189,332,3291682.0,3093144.0,198537.0,0.5964,0.5942,0.5961,0.598
2023-04-19 16:20,79,56,23,4117,3348,769,2462476.0,2017030.0,445446.0,56,45,11,3389,3013,376,2021729.0,1796135.0,225594.0,0.6025,0.5793,0.5961,0.6
2023-04-19 16:25,72,52,20,4670,3683,987,2735658.0,2199322.0,536336.0,60,48,12,3947,3604,343,2355227.0,2149736.0,205491.0,0.5972,0.5434,0.5965,0.5991
2023-04-19 16:30,109,91,18,6812,6644,168,4056840.0,3962878.0,93961.0,97,87,10,6634,6564,70,3949362.0,3906912.0,42450.0,0.5965,0.5593,0.5952,0.6064
2023-04-19 16:35,92,59,33,3919,3363,556,2338198.0,2005769.0,332428.0,86,60,26,4520,4084,436,2693501.0,2432522.0,260979.0,0.5964,0.5979,0.5956,0.5986
2023-04-19 16:40,169,118,51,7901,3040,4861,4718524.0,1810908.0,2907615.0,161,114,47,7893,3367,4526,4717000.0,2002888.0,2714111.0,0.5957,0.5982,0.5949,0.5997
2023-04-19 16:45,1400,319,1081,206944,30740,176204,141034986.0,35905217.0,105129769.0,1363,302,1061,208163,29609,178554,141871143.0,35241512.0,106629630.0,1.168,0.5966,1.1902,0.5972
2023-04-19 16:50,1491,317,1174,189879,21694,168185,113352254.0,12949758.0,100402496.0,1435,295,1140,183715,17760,165955,109670877.0,10565762.0,99105115.0,0.5969,0.597,0.5949,0.5972
2023-04-19 16:55,2272,205,2067,441215,8037,433178,263388709.0,4777386.0,258611322.0,2257,205,2052,439341,8513,430828,262444929.0,5048131.0,257396797.0,0.5944,0.597,0.593,0.5974
2023-04-19 17:00,523,25,498,90781,3026,87755,54154996.0,1775840.0,52379156.0,506,20,486,86949,391,86558,51917526.0,231072.0,51686454.0,0.5869,0.5969,0.591,0.5971
2023-04-19 17:05,1575,169,1406,312341,9172,303169,221872953.0,40707961.0,181164991.0,1536,155,1381,307521,7709,299812,219090442.0,39839770.0,179250671.0,4.4383,0.5976,5.168,0.5979
2023-04-19 17:10,520,243,277,35195,10387,24808,20930381.0,6168159.0,14762221.0,473,214,259,35240,10134,25106,20990495.0,6014185.0,14976310.0,0.5938,0.5951,0.5935,0.5965
2023-04-19 17:15,1142,60,1082,209656,2983,206673,125224465.0,1821791.0,123402674.0,1122,52,1070,208718,3074,205644,124603361.0,1814883.0,122788478.0,0.6107,0.5971,0.5904,0.5971
2023-04-19 17:20,384,81,303,47665,4631,43034,28430898.0,2751760.0,25679138.0,373,75,298,47881,4244,43637,28575214.0,2521128.0,26054086.0,0.5942,0.5967,0.594,0.5971
2023-04-19 17:25,2221,351,1870,374717,19792,354925,223631058.0,11760606.0,211870452.0,2205,341,1864,374485,19674,354811,223499759.0,11690032.0,211809726.0,0.5942,0.5969,0.5942,0.597
2023-04-19 17:30,2416,585,1831,385601,37141,348460,247903922.0,39708310.0,208195611.0,2399,578,1821,385070,37271,347799,247579462.0,39773800.0,207805661.0,1.0691,0.5975,1.0672,0.5975
2023-04-19 17:35,127,37,90,18654,2911,15743,11132547.0,1726172.0,9406374.0,111,29,82,18166,2671,15495,10842379.0,1584916.0,9257463.0,0.593,0.5975,0.5934,0.5974
2023-04-19 17:40,1675,229,1446,302030,13332,288698,197731646.0,25573037.0,172158609.0,1648,215,1433,300072,12556,287516,196617646.0,25087824.0,171529822.0,1.9182,0.5963,1.9981,0.5966
2023-04-19 17:45,1194,133,1061,169671,5779,163892,118882855.0,21064571.0,97818284.0,1180,119,1061,169606,4877,164729,118863333.0,20531345.0,98331988.0,3.645,0.5968,4.2098,0.5969
2023-04-19 17:50,1771,431,1340,256992,41715,215277,153265402.0,24788894.0,128476507.0,1751,424,1327,255493,41549,213944,152379948.0,24692965.0,127686983.0,0.5942,0.5968,0.5943,0.5968
2023-04-19 17:55,483,143,340,40927,9221,31706,24402087.0,5480937.0,18921150.0,466,130,336,40349,9221,31128,24058825.0,5479846.0,18578979.0,0.5944,0.5968,0.5943,0.5969
2023-04-19 18:00,196,63,133,14528,3174,11354,26272303.0,19516934.0,6755368.0,179,52,127,15025,3567,11458,26579873.0,19736785.0,6843088.0,6.149,0.595,5.5332,0.5972
2023-04-19 18:05,467,44,423,45356,2130,43226,27064572.0,1269485.0,25795087.0,447,31,416,43450,1524,41926,25901703.0,903826.0,24997877.0,0.596,0.5967,0.5931,0.5962
2023-04-19 18:10,537,122,415,58478,7888,50590,34842812.0,4685507.0,30157305.0,528,117,411,58388,7983,50405,34789493.0,4741273.0,30048220.0,0.594,0.5961,0.5939,0.5961
2023-04-19 18:15,608,15,593,79622,681,78941,47452133.0,404464.0,47047668.0,592,7,585,79271,366,78905,47244298.0,217295.0,47027002.0,0.5939,0.596,0.5937,0.596
2023-04-19 18:20,508,117,391,76759,7105,69654,45855814.0,4219230.0,41636584.0,493,101,392,75881,6939,68942,45321285.0,4118456.0,41202829.0,0.5938,0.5978,0.5935,0.5976
2023-04-19 18:25,1772,143,1629,216406,8832,207574,129034205.0,5246623.0,123787581.0,1766,139,1627,217327,8983,208344,129598002.0,5333838.0,124264164.0,0.594,0.5964,0.5938,0.5964
2023-04-19 18:30,332,152,180,25286,10877,14409,15058013.0,6472106.0,8585907.0,322,147,175,24472,10470,14002,14569429.0,6225699.0,8343729.0,0.595,0.5959,0.5946,0.5959
2023-04-19 18:35,671,252,419,53320,15532,37788,31751624.0,9234016.0,22517608.0,665,249,416,52834,15647,37187,31462096.0,9300842.0,22161253.0,0.5945,0.5959,0.5944,0.5959
2023-04-20 10:00,6705,3534,3171,923560,603799,319761,602102317.0,410494831.0,191607485.0,6359,3370,2989,914806,599371,315435,585254166.0,396433593.0,188820573.0,0.6799,0.5992,0.6614,0.5986
2023-04-20 10:05,1899,617,1282,152258,58188,94070,103173679.0,47010600.0,56163079.0,1863,592,1271,146015,56169,89846,98223903.0,44601452.0,53622451.0,0.8079,0.597,0.7941,0.5968
2023-04-20 10:10,687,397,290,68532,48333,20199,75907207.0,63767358.0,12139848.0,600,359,241,61513,45765,15748,66651446.0,57250465.0,9400981.0,1.3193,0.601,1.251,0.597
2023-04-20 10:15,1428,395,1033,114764,27289,87475,68313226.0,16196952.0,52116274.0,1376,372,1004,111052,25075,85977,66072256.0,14877878.0,51194378.0,0.5935,0.5958,0.5933,0.5954
2023-04-20 10:20,531,196,335,54516,20962,33554,49957280.0,30009178.0,19948102.0,473,171,302,51803,19573,32230,48370145.0,29192474.0,19177671.0,1.4316,0.5945,1.4915,0.595
2023-04-20 10:25,664,246,418,62456,19565,42891,54709834.0,29213782.0,25496052.0,609,207,402,57863,18511,39352,51975146.0,28556064.0,23419081.0,1.4932,0.5944,1.5427,0.5951
2023-04-20 10:30,104,71,33,6363,4125,2238,3730972.0,2400974.0,1329998.0,73,52,21,4092,2234,1858,2425536.0,1318677.0,1106859.0,0.5821,0.5943,0.5903,0.5957
2023-04-20 10:35,523,92,431,43238,7659,35579,25614941.0,4520757.0,21094184.0,496,76,420,47272,7134,40138,28045818.0,4210611.0,23835207.0,0.5903,0.5929,0.5902,0.5938
2023-04-20 10:40,594,161,433,37880,8250,29630,22417903.0,4869516.0,17548386.0,483,97,386,35263,7090,28173,20887629.0,4186333.0,16701296.0,0.5902,0.5923,0.5905,0.5928
2023-04-20 10:45,727,320,407,50622,21793,28829,29952573.0,12871538.0,17081034.0,701,302,399,50424,21671,28753,29851564.0,12808411.0,17043152.0,0.5906,0.5925,0.591,0.5927
2023-04-20 10:50,262,124,138,21098,5257,15841,12483058.0,3097658.0,9385400.0,226,101,125,14934,5006,9928,8850666.0,2951844.0,5898822.0,0.5892,0.5925,0.5897,0.5942
2023-04-20 10:55,1427,651,776,169674,64886,104788,381425609.0,320204060.0,61221548.0,1172,494,678,160404,56525,103879,376593686.0,315277443.0,61316243.0,4.9349,0.5842,5.5777,0.5903
2023-04-20 11:00,1109,514,595,134845,45946,88899,184971014.0,132646336.0,52324677.0,972,411,561,127985,40954,87031,181106274.0,129786492.0,51319781.0,2.887,0.5886,3.1691,0.5897
2023-04-20 11:05,466,187,279,57281,15426,41855,33668024.0,8973526.0,24694497.0,418,160,258,55540,14338,41202,32691033.0,8354910.0,24336123.0,0.5817,0.59,0.5827,0.5907
2023-04-20 11:10,1121,484,637,131904,26675,105229,115082987.0,53051344.0,62031643.0,1042,431,611,128157,24511,103646,111799883.0,50658062.0,61141820.0,1.9888,0.5895,2.0667,0.5899
2023-04-20 11:15,1387,415,972,116147,26803,89344,87086766.0,34374425.0,52712340.0,1358,396,962,115868,27089,88779,86922056.0,34536239.0,52385816.0,1.2825,0.59,1.2749,0.5901
2023-04-20 11:20,1669,735,934,156307,73848,82459,240614664.0,192355659.0,48259005.0,1553,665,888,149798,70039,79759,236893160.0,190023508.0,46869651.0,2.6048,0.5852,2.7131,0.5876
2023-04-20 11:25,1168,1093,75,124043,119174,4869,72619470.0,69748321.0,2871148.0,1141,1082,59,123573,119286,4287,72329907.0,69808263.0,2521644.0,0.5853,0.5897,0.5852,0.5882
2023-04-20 11:30,1593,1481,112,153644,146946,6698,89838125.0,85905509.0,3932616.0,1148,1051,97,151353,145278,6075,88492651.0,84926079.0,3566572.0,0.5846,0.5871,0.5846,0.5871
2023-04-20 11:35,187,81,106,9543,5262,4281,5564684.0,3072426.0,2492258.0,152,60,92,9889,6041,3848,5756832.0,3495259.0,2261573.0,0.5839,0.5822,0.5786,0.5877
2023-04-20 11:40,3551,1473,2078,342403,236738,105665,238244970.0,176001002.0,62243967.0,3502,1451,2051,337823,234525,103298,235366621.0,174518168.0,60848452.0,0.7434,0.5891,0.7441,0.5891
2023-04-20 11:45,1608,798,810,179276,112154,67122,123575175.0,84182507.0,39392667.0,1568,778,790,179350,112473,66877,123618728.0,84366608.0,39252120.0,0.7506,0.5869,0.7501,0.5869
2023-04-20 11:50,1604,1017,587,154954,114671,40283,90473051.0,66882812.0,23590239.0,1544,980,564,152493,112565,39928,89068216.0,65656936.0,23411279.0,0.5833,0.5856,0.5833,0.5863
2023-04-20 11:55,1281,705,576,121799,81995,39804,71137162.0,47794204.0,23342957.0,1242,679,563,119103,79829,39274,69591058.0,46548391.0,23042666.0,0.5829,0.5864,0.5831,0.5867
2023-04-20 12:00,2139,1211,928,246565,165343,81222,181742057.0,134027499.0,47714557.0,2102,1188,914,245599,165066,80533,181183564.0,133856100.0,47327464.0,0.8106,0.5875,0.8109,0.5877
2023-04-20 12:05,3176,1604,1572,357351,199136,158215,265774634.0,172491273.0,93283360.0,3157,1591,1566,356385,198690,157695,265202640.0,172227982.0,92974657.0,0.8662,0.5896,0.8668,0.5896
2023-04-20 12:10,1138,320,818,114021,46789,67232,66921085.0,27401542.0,39519543.0,1122,314,808,115231,48029,67202,67584861.0,28081904.0,39502957.0,0.5856,0.5878,0.5847,0.5878
2023-04-20 12:15,1292,837,455,137683,110562,27121,80648817.0,64710781.0,15938036.0,1263,813,450,137471,110203,27268,80509284.0,64483923.0,16025361.0,0.5853,0.5877,0.5851,0.5877
2023-04-20 12:20,4330,2926,1404,577204,433026,144178,450929227.0,365781090.0,85148137.0,4288,2902,1386,573766,431202,142564,448893892.0,364701496.0,84192396.0,0.8447,0.5906,0.8458,0.5906
2023-04-20 12:25,3769,954,2815,498629,137927,360702,349519334.0,136807790.0,212711544.0,3727,931,2796,498577,140210,358367,349540889.0,138089738.0,211451150.0,0.9919,0.5897,0.9849,0.59
2023-04-20 12:30,2272,1239,1033,273713,123278,150435,179915237.0,91053812.0,88861425.0,2239,1216,1023,272396,122383,150013,179148479.0,90522900.0,88625579.0,0.7386,0.5907,0.7397,0.5908
2023-04-20 12:35,3859,2065,1794,414600,221499,193101,318872522.0,204763787.0,114108734.0,3823,2047,1776,412558,220139,192419,317725526.0,203957009.0,113768517.0,0.9244,0.5909,0.9265,0.5913
2023-04-20 12:40,4445,1267,3178,525514,112082,413432,365744700.0,121678581.0,244066118.0,4407,1242,3165,524962,112151,412811,365447678.0,121717010.0,243730667.0,1.0856,0.5903,1.0853,0.5904
2023-04-20 12:45,4566,1194,3372,532642,82284,450358,314315828.0,48260789.0,266055039.0,4554,1187,3367,532327,82185,450142,314126140.0,48202304.0,265923836.0,0.5865,0.5908,0.5865,0.5908
2023-04-20 12:50,3132,1187,1945,359276,73872,285404,211969973.0,43343442.0,168626531.0,3103,1162,1941,359437,73742,285695,212063962.0,43264712.0,168799250.0,0.5867,0.5908,0.5867,0.5908
2023-04-20 12:55,3904,1570,2334,443530,106419,337111,298580799.0,99746202.0,198834597.0,3881,1553,2328,443556,106469,337087,298599998.0,99775904.0,198824093.0,0.9373,0.5898,0.9371,0.5898
2023-04-20 13:00,1996,326,1670,254417,29966,224451,150213759.0,17579880.0,132633879.0,1976,316,1660,254652,30701,223951,150339204.0,18003522.0,132335681.0,0.5867,0.5909,0.5864,0.5909
2023-04-20 13:05,1181,542,639,102267,37755,64512,97456742.0,59442904.0,38013838.0,1157,527,630,101054,36758,64296,96802596.0,58880755.0,37921840.0,1.5744,0.5893,1.6018,0.5898
2023-04-20 13:10,1170,313,857,144388,20675,123713,85158451.0,12145920.0,73012530.0,1151,300,851,143729,20542,123187,84773332.0,12070732.0,72702599.0,0.5875,0.5902,0.5876,0.5902
2023-04-20 13:15,926,212,714,125863,9730,116133,74209043.0,5721648.0,68487395.0,912,200,712,125413,9455,115958,73945016.0,5556754.0,68388261.0,0.588,0.5897,0.5877,0.5898
2023-04-20 13:20,1028,85,943,147666,3806,143860,87077142.0,2236290.0,84840851.0,1014,76,938,147047,3601,143446,86707765.0,2113026.0,84594739.0,0.5876,0.5897,0.5868,0.5897
2023-04-20 13:25,749,203,546,85610,10089,75521,50513519.0,5929451.0,44584067.0,742,201,541,85591,10138,75453,50499460.0,5957357.0,44542102.0,0.5877,0.5904,0.5876,0.5903
2023-04-20 13:30,2269,430,1839,318161,16506,301655,187591224.0,9685824.0,177905400.0,2258,421,1837,318154,16200,301954,187591592.0,9506457.0,178085134.0,0.5868,0.5898,0.5868,0.5898
2023-04-20 13:35,150,100,50,10305,4556,5749,6067468.0,2675958.0,3391510.0,136,89,47,10389,4647,5742,6113885.0,2726785.0,3387100.0,0.5873,0.5899,0.5868,0.5899
2023-04-20 13:40,2571,295,2276,326273,19497,306776,192635062.0,11447155.0,181187906.0,2555,288,2267,325619,19159,306460,192246944.0,11243680.0,181003264.0,0.5871,0.5906,0.5869,0.5906
2023-04-20 13:45,2283,227,2056,279430,13841,265589,164909809.0,8114331.0,156795477.0,2272,223,2049,279375,14011,265364,164883309.0,8221159.0,156662149.0,0.5863,0.5904,0.5868,0.5904
2023-04-20 13:50,1881,307,1574,216410,16500,199910,127632303.0,9669880.0,117962423.0,1871,303,1568,216202,16525,199677,127513133.0,9684436.0,117828697.0,0.5861,0.5901,0.586,0.5901
2023-04-20 13:55,2840,643,2197,369762,46009,323753,236346031.0,45615024.0,190731007.0,2820,627,2193,369644,45354,324290,236281647.0,45227874.0,191053773.0,0.9914,0.5891,0.9972,0.5891
2023-04-20 14:00,731,337,394,82078,20578,61500,48242751.0,12057479.0,36185272.0,710,328,382,80434,19957,60477,47268425.0,11692299.0,35576126.0,0.5859,0.5884,0.5859,0.5883
2023-04-20 14:05,722,510,212,78731,38487,40244,46419312.0,22551117.0,23868194.0,709,501,208,78335,38491,39844,46180864.0,22551663.0,23629201.0,0.5859,0.5931,0.5859,0.593
2023-04-20 14:10,702,543,159,53486,25561,27925,50154219.0,33646051.0,16508168.0,689,537,152,52084,24468,27616,49329054.0,32992279.0,16336774.0,1.3163,0.5912,1.3484,0.5916
2023-04-20 14:15,915,732,183,55815,41976,13839,51438441.0,43267558.0,8170883.0,915,730,185,55752,41846,13906,51399870.0,43190074.0,8209796.0,1.0308,0.5904,1.0321,0.5904
2023-04-20 14:20,552,298,254,41129,19973,21156,42843913.0,30358226.0,12485687.0,539,293,246,39859,19569,20290,42088742.0,30117532.0,11971210.0,1.52,0.5902,1.539,0.59
2023-04-20 14:25,700,339,361,61377,32247,29130,36171243.0,18964629.0,17206613.0,684,329,355,61258,32274,28984,36104642.0,18979327.0,17125315.0,0.5881,0.5907,0.5881,0.5909
2023-04-20 14:30,319,139,180,27731,13177,14554,16347502.0,7749184.0,8598318.0,310,139,171,27418,12843,14575,16162548.0,7551017.0,8611530.0,0.5881,0.5908,0.5879,0.5908
2023-04-20 14:35,216,86,130,16679,7032,9647,28477827.0,22782567.0,5695260.0,200,79,121,15374,5983,9391,27708214.0,22155874.0,5552340.0,3.2398,0.5904,3.7031,0.5912
2023-04-20 14:40,626,359,267,40509,16770,23739,23970928.0,9892909.0,14078019.0,611,349,262,41845,17834,24011,24758310.0,10514063.0,14244246.0,0.5899,0.593,0.5896,0.5932
2023-04-20 14:45,1205,561,644,125010,66040,58970,111314671.0,76342287.0,34972384.0,1166,544,622,119887,61773,58114,108169324.0,73711240.0,34458084.0,1.156,0.5931,1.1933,0.5929
2023-04-20 14:50,2337,1752,585,312196,256003,56193,278185956.0,244799922.0,33386034.0,2288,1734,554,306779,251949,54830,274877752.0,242287009.0,32590742.0,0.9562,0.5941,0.9617,0.5944
2023-04-20 14:55,2728,1843,885,371451,303056,68395,388682236.0,347880145.0,40802090.0,2649,1806,843,370560,304109,66451,387841007.0,348189478.0,39651528.0,1.1479,0.5966,1.1449,0.5967
2023-04-20 15:00,3610,3213,397,556569,545744,10825,443525742.0,437051533.0,6474209.0,3483,3182,301,550705,544005,6700,439920495.0,435897532.0,4022963.0,0.8008,0.5981,0.8013,0.6004
2023-04-20 15:05,3618,2213,1405,426797,335063,91734,272831851.0,217982830.0,54849021.0,3590,2205,1385,425955,335195,90760,272368822.0,218061064.0,54307758.0,0.6506,0.5979,0.6505,0.5984
2023-04-20 15:10,1803,941,862,155210,62015,93195,92627164.0,36893556.0,55733607.0,1775,927,848,155096,61736,93360,92588549.0,36718707.0,55869842.0,0.5949,0.598,0.5948,0.5984
2023-04-20 15:15,839,511,328,67180,33561,33619,58696888.0,38609090.0,20087797.0,801,498,303,66055,33175,32880,58044203.0,38380507.0,19663695.0,1.1504,0.5975,1.1569,0.598
2023-04-20 15:20,1150,816,334,85416,54004,31412,50877543.0,32108750.0,18768793.0,1126,802,324,83613,53683,29930,49812181.0,31919588.0,17892593.0,0.5946,0.5975,0.5946,0.5978
2023-04-20 15:25,300,173,127,21107,12946,8161,12542682.0,7683461.0,4859220.0,286,166,120,19891,12030,7861,11819172.0,7137625.0,4681546.0,0.5935,0.5954,0.5933,0.5955
2023-04-20 15:30,101,60,41,3596,1589,2007,2135487.0,945572.0,1189914.0,81,45,36,3496,1345,2151,2082952.0,799778.0,1283174.0,0.5951,0.5929,0.5946,0.5965
2023-04-20 15:35,47,35,12,884,646,238,521908.0,382901.0,139007.0,41,30,11,1031,621,410,615542.0,368999.0,246543.0,0.5927,0.5841,0.5942,0.6013
2023-04-20 15:40,62,33,29,3983,903,3080,2395099.0,543117.0,1851982.0,47,32,15,2858,864,1994,1715733.0,512713.0,1203019.0,0.6015,0.6013,0.5934,0.6033
2023-04-20 15:45,38,27,11,2250,1828,422,1334552.0,1085997.0,248554.0,28,24,4,2743,2017,726,1621453.0,1188690.0,432763.0,0.5941,0.589,0.5893,0.5961
2023-04-20 15:50,419,337,82,39598,26663,12935,23562194.0,15842995.0,7719199.0,403,331,72,38461,26348,12113,22893340.0,15657636.0,7235703.0,0.5942,0.5968,0.5943,0.5974
2023-04-20 15:55,787,201,586,91313,9210,82103,54538579.0,5471005.0,49067574.0,775,195,580,91066,9331,81735,54390462.0,5541894.0,48848567.0,0.594,0.5976,0.5939,0.5976
2023-04-20 16:00,1292,361,931,161140,18021,143119,96127199.0,10704832.0,85422366.0,1274,353,921,160826,17975,142851,95942193.0,10679431.0,85262761.0,0.594,0.5969,0.5941,0.5969
2023-04-20 16:05,461,252,209,35766,17996,17770,39877933.0,29325846.0,10552087.0,434,242,192,34503,17854,16649,39171219.0,29242470.0,9928749.0,1.6296,0.5938,1.6379,0.5964
2023-04-20 16:10,385,194,191,35241,10426,24815,20985971.0,6183415.0,14802555.0,361,180,181,34004,10058,23946,20249800.0,5961370.0,14288429.0,0.5931,0.5965,0.5927,0.5967
2023-04-20 16:15,976,106,870,124262,9254,115008,92446329.0,23850590.0,68595738.0,956,95,861,120444,5471,114973,90469028.0,21883167.0,68585861.0,2.5773,0.5964,3.9998,0.5965
2023-04-20 16:20,874,69,805,134420,4006,130414,80188656.0,2376760.0,77811895.0,861,62,799,133869,4076,129793,79858946.0,2417508.0,77441437.0,0.5933,0.5967,0.5931,0.5967
2023-04-20 16:25,2158,419,1739,332458,26437,306021,198240118.0,15695536.0,182544581.0,2154,419,1735,332344,26538,305806,198187933.0,15755615.0,182432317.0,0.5937,0.5965,0.5937,0.5966
2023-04-20 16:30,1421,368,1053,217344,22205,195139,129586457.0,13177284.0,116409172.0,1406,361,1045,217132,22185,194947,129454493.0,13158749.0,116295744.0,0.5934,0.5965,0.5931,0.5966
2023-04-20 16:35,934,474,460,106894,23746,83148,63612948.0,14057250.0,49555698.0,934,479,455,107519,24241,83278,63980360.0,14347325.0,49633035.0,0.592,0.596,0.5919,0.596
2023-04-20 16:40,1721,510,1211,209978,27196,182782,125119838.0,16122577.0,108997260.0,1711,502,1209,209814,26995,182819,125028687.0,15996632.0,109032055.0,0.5928,0.5963,0.5926,0.5964
2023-04-20 16:45,2455,623,1832,348086,36816,311270,207462542.0,21824005.0,185638537.0,2450,622,1828,348142,36813,311329,207493927.0,21821292.0,185672635.0,0.5928,0.5964,0.5928,0.5964
2023-04-20 16:50,532,168,364,74590,8956,65634,63073059.0,23936328.0,39136731.0,520,158,362,73843,8774,65069,62636626.0,23829289.0,38807336.0,2.6727,0.5963,2.7159,0.5964
2023-04-20 16:55,476,249,227,40231,23192,17039,23979049.0,13722709.0,10256340.0,469,244,225,39347,22544,16803,23460483.0,13345251.0,10115231.0,0.5917,0.6019,0.592,0.602
2023-04-20 17:00,291,27,264,21533,2755,18778,12732197.0,1560845.0,11171352.0,273,20,253,19906,1449,18457,11834311.0,856984.0,10977327.0,0.5665,0.5949,0.5914,0.5948
2023-04-20 17:05,235,73,162,18780,6873,11907,11141195.0,4067183.0,7074012.0,230,70,160,18784,6884,11900,11141405.0,4071428.0,7069976.0,0.5918,0.5941,0.5914,0.5941
2023-04-20 17:10,25,12,13,1113,74,1039,661251.0,43711.0,617540.0,20,6,14,1325,61,1264,788942.0,35743.0,753199.0,0.5907,0.5944,0.586,0.5959
2023-04-20 17:15,393,200,193,43811,26387,17424,44559505.0,34261157.0,10298348.0,398,211,187,42469,25915,16554,43818404.0,33978492.0,9839911.0,1.2984,0.591,1.3112,0.5944
2023-04-20 17:20,277,91,186,22828,4836,17992,13528299.0,2859069.0,10669230.0,237,59,178,21810,3784,18026,12933437.0,2232244.0,10701192.0,0.5912,0.593,0.5899,0.5937
2023-04-20 17:25,451,126,325,32485,8402,24083,37868525.0,23596377.0,14272148.0,436,119,317,31721,8197,23524,37425291.0,23477103.0,13948188.0,2.8084,0.5926,2.8641,0.5929
2023-04-20 17:30,338,137,201,25092,6149,18943,14882987.0,3624223.0,11258764.0,317,125,192,24970,6116,18854,14814378.0,3608088.0,11206289.0,0.5894,0.5943,0.5899,0.5944
2023-04-20 17:35,1203,244,959,139696,9902,129794,82994905.0,5850922.0,77143983.0,1198,242,956,139562,9975,129587,82912330.0,5893615.0,77018715.0,0.5909,0.5944,0.5908,0.5943
2023-04-20 17:40,260,41,219,18440,3224,15216,10916627.0,1905030.0,9011597.0,253,35,218,18797,3565,15232,11118104.0,2095990.0,9022114.0,0.5909,0.5922,0.5879,0.5923
2023-04-20 17:45,99,62,37,6086,3742,2344,3589620.0,2211532.0,1378088.0,92,58,34,5930,3718,2212,3507096.0,2197042.0,1310053.0,0.591,0.5879,0.5909,0.5922
2023-04-20 17:50,133,72,61,14358,10183,4175,27157265.0,24681393.0,2475872.0,125,63,62,9458,4768,4690,24237343.0,21454390.0,2782953.0,2.4238,0.593,4.4997,0.5934
2023-04-20 17:55,359,213,146,24793,14528,10265,14680539.0,8585529.0,6095010.0,349,210,139,24347,14586,9761,14427877.0,8631581.0,5796296.0,0.591,0.5938,0.5918,0.5938
2023-04-20 18:00,374,222,152,27511,16362,11149,16318310.0,9690772.0,6627538.0,361,220,141,27980,17019,10961,16563138.0,10049784.0,6513354.0,0.5923,0.5945,0.5905,0.5942
2023-04-20 18:05,460,241,219,32877,17346,15531,38128868.0,28899868.0,9229000.0,454,237,217,32144,16629,15515,37692006.0,28472736.0,9219269.0,1.6661,0.5942,1.7122,0.5942
2023-04-20 18:10,1819,939,880,190663,64704,125959,150683616.0,75603279.0,75080337.0,1806,933,873,191078,65100,125978,150909048.0,75808953.0,75100094.0,1.1684,0.5961,1.1645,0.5961
2023-04-20 18:15,3035,1440,1595,346323,82851,263472,205507205.0,49008155.0,156499050.0,3025,1435,1590,345529,82537,262992,205061636.0,48822643.0,156238992.0,0.5915,0.594,0.5915,0.5941
2023-04-20 18:20,871,472,399,59243,26872,32371,35127560.0,15902980.0,19224580.0,858,461,397,59485,26925,32560,35271790.0,15929971.0,19341819.0,0.5918,0.5939,0.5916,0.594
2023-04-20 18:25,1073,460,613,118398,21662,96736,70556420.0,12814735.0,57741685.0,1059,453,606,118056,21414,96642,70355814.0,12666350.0,57689464.0,0.5916,0.5969,0.5915,0.5969
2023-04-20 18:30,2330,703,1627,332149,44938,287211,197869279.0,26621513.0,171247765.0,2310,695,1615,331324,44651,286673,197350843.0,26429780.0,170921063.0,0.5924,0.5962,0.5919,0.5962
2023-04-20 18:35,3441,1367,2074,427893,93903,333990,254479781.0,55571007.0,198908774.0,3431,1366,2065,427912,94167,333745,254505686.0,55723329.0,198782356.0,0.5918,0.5956,0.5918,0.5956
2023-04-21 10:00,4770,1641,3129,639942,203624,436318,466584343.0,206090256.0,260494086.0,4461,1483,2978,628422,198836,429586,442387152.0,186156626.0,256230525.0,1.0121,0.597,0.9362,0.5965
2023-04-21 10:05,2601,950,1651,329147,156274,172873,252879355.0,149844872.0,103034482.0,2511,911,1600,323303,154583,168720,247488127.0,146934289.0,100553838.0,0.9589,0.596,0.9505,0.596
2023-04-21 10:10,909,472,437,87040,48997,38043,51604403.0,28974671.0,22629731.0,812,437,375,84245,47459,36786,49903042.0,28060437.0,21842604.0,0.5914,0.5948,0.5913,0.5938
2023-04-21 10:15,2647,822,1825,370274,56783,313491,239674620.0,52775965.0,186898654.0,2587,788,1799,368676,55827,312849,238713292.0,52190941.0,186522351.0,0.9294,0.5962,0.9349,0.5962
2023-04-21 10:20,2532,945,1587,312216,57430,254786,224991834.0,72729250.0,152262584.0,2418,900,1518,301620,52320,249300,218284055.0,69329070.0,148954984.0,1.2664,0.5976,1.3251,0.5975
2023-04-21 10:25,1326,814,512,100175,69650,30525,117120853.0,98866606.0,18254247.0,1165,729,436,103352,72683,30669,119006927.0,100660919.0,18346007.0,1.4195,0.598,1.3849,0.5982
2023-04-21 10:30,992,246,746,113881,27342,86539,68045998.0,16213551.0,51832447.0,941,222,719,112057,25991,86066,67007566.0,15448515.0,51559051.0,0.593,0.5989,0.5944,0.5991
2023-04-21 10:35,1828,377,1451,243987,42391,201596,146040195.0,25211090.0,120829105.0,1781,352,1429,242375,41270,201105,145068853.0,24538577.0,120530275.0,0.5947,0.5994,0.5946,0.5993
2023-04-21 10:40,627,188,439,58960,18280,40680,92914237.0,68358626.0,24555611.0,568,167,401,54817,15985,38832,90313672.0,66970081.0,23343591.0,3.7395,0.6036,4.1896,0.6011
2023-04-21 10:45,2469,940,1529,299127,73980,225147,198926543.0,63444453.0,135482090.0,2363,898,1465,294979,71038,223941,196517705.0,61695775.0,134821930.0,0.8576,0.6017,0.8685,0.602
2023-04-21 10:50,749,224,525,55385,25870,29515,33261491.0,15516473.0,17745017.0,689,212,477,52196,25111,27085,31338944.0,15050483.0,16288460.0,0.5998,0.6012,0.5994,0.6014
2023-04-21 10:55,3076,1695,1381,358321,253144,105177,328654634.0,265743700.0,62910934.0,2995,1659,1336,356516,253376,103140,327688079.0,265887522.0,61800557.0,1.0498,0.5981,1.0494,0.5992
2023-04-21 11:00,2437,907,1530,199752,96368,103384,119573935.0,57486308.0,62087627.0,2429,913,1516,196404,96633,99771,117418307.0,57644385.0,59773922.0,0.5965,0.6006,0.5965,0.5991
2023-04-21 11:05,1837,1366,471,178428,141051,37377,125779125.0,103364524.0,22414601.0,1799,1347,452,179042,138537,40505,126282289.0,101847183.0,24435106.0,0.7328,0.5997,0.7352,0.6033
2023-04-21 11:10,1145,891,254,125982,110249,15733,94707951.0,85264563.0,9443387.0,1056,848,208,124652,109857,14795,93910569.0,85009527.0,8901041.0,0.7734,0.6002,0.7738,0.6016
2023-04-21 11:15,566,440,126,61735,55538,6197,75229165.0,71513532.0,3715633.0,457,393,64,57765,53110,4655,72867510.0,70053402.0,2814108.0,1.2877,0.5996,1.319,0.6045
2023-04-21 11:20,1443,975,468,137812,101219,36593,82691394.0,60685323.0,22006071.0,1378,952,426,133524,99741,33783,80157505.0,59803217.0,20354288.0,0.5995,0.6014,0.5996,0.6025
2023-04-21 11:25,580,389,191,48698,33758,14940,29265140.0,20249084.0,9016055.0,588,422,166,48724,34215,14509,29270142.0,20517506.0,8752636.0,0.5998,0.6035,0.5997,0.6033
2023-04-21 11:30,1204,872,332,145475,117473,28002,106468777.0,89612252.0,16856525.0,1163,859,304,144061,116876,27185,105625411.0,89251545.0,16373865.0,0.7628,0.602,0.7636,0.6023
2023-04-21 11:35,811,336,475,83758,48114,35644,107677434.0,86309274.0,21368159.0,738,303,435,79973,46522,33451,105519463.0,85350560.0,20168902.0,1.7938,0.5995,1.8346,0.6029
2023-04-21 11:40,2299,957,1342,269618,156488,113130,180918801.0,112886174.0,68032626.0,2247,932,1315,264708,152759,111949,178074016.0,110687570.0,67386446.0,0.7214,0.6014,0.7246,0.6019
2023-04-21 11:45,422,138,284,44939,20060,24879,26989060.0,12014343.0,14974717.0,394,122,272,44029,19657,24372,26443581.0,11771308.0,14672273.0,0.5989,0.6019,0.5988,0.602
2023-04-21 11:50,81,25,56,4099,1359,2740,2453554.0,809195.0,1644359.0,58,16,42,3122,1383,1739,1869100.0,824122.0,1044977.0,0.5954,0.6001,0.5959,0.6009
2023-04-21 11:55,497,271,226,40637,25803,14834,24233881.0,15426590.0,8807291.0,447,237,210,39301,24750,14551,23520243.0,14786255.0,8733988.0,0.5979,0.5937,0.5974,0.6002
2023-04-21 12:00,774,468,306,78461,57502,20959,46909412.0,34341672.0,12567739.0,760,458,302,78833,57816,21017,47128628.0,34519750.0,12608878.0,0.5972,0.5996,0.5971,0.5999
2023-04-21 12:05,1821,1010,811,186147,128720,57427,111335898.0,76885795.0,34450102.0,1789,998,791,185014,128329,56685,110650440.0,76639801.0,34010639.0,0.5973,0.5999,0.5972,0.6
2023-04-21 12:10,1413,1172,241,185890,167068,18822,111024975.0,99728086.0,11296889.0,1396,1167,229,185325,166748,18577,110686695.0,99521390.0,11165305.0,0.5969,0.6002,0.5968,0.601
2023-04-21 12:15,998,506,492,87773,60451,27322,52451552.0,36096115.0,16355437.0,986,504,482,88088,61013,27075,52655699.0,36425213.0,16230486.0,0.5971,0.5986,0.597,0.5995
2023-04-21 12:20,1514,450,1064,166748,77132,89616,118916172.0,65166956.0,53749216.0,1502,445,1057,165956,76842,89114,118446759.0,64995443.0,53451315.0,0.8449,0.5998,0.8458,0.5998
2023-04-21 12:25,605,250,355,61929,45593,16336,36936367.0,27150946.0,9785420.0,581,240,341,61076,45183,15893,36434390.0,26910389.0,9524001.0,0.5955,0.599,0.5956,0.5993
2023-04-21 12:30,1419,469,950,173505,57148,116357,142086379.0,72357570.0,69728809.0,1388,457,931,168939,56607,112332,139351900.0,72034201.0,67317699.0,1.2661,0.5993,1.2725,0.5993
2023-04-21 12:35,289,140,149,22516,8543,13973,13515549.0,5135210.0,8380338.0,263,127,136,21306,7715,13591,12752971.0,4602500.0,8150471.0,0.6011,0.5998,0.5966,0.5997
2023-04-21 12:40,810,586,224,71229,54971,16258,42429808.0,32747777.0,9682031.0,801,579,222,71186,55056,16130,42464184.0,32796452.0,9667731.0,0.5957,0.5955,0.5957,0.5994
2023-04-21 12:45,945,409,536,116006,58631,57375,69371165.0,34978609.0,34392555.0,922,400,522,114899,58081,56818,68713693.0,34649736.0,34063957.0,0.5966,0.5994,0.5966,0.5995
2023-04-21 12:50,359,87,272,39414,9967,29447,61887601.0,44230145.0,17657456.0,343,81,262,38574,9561,29013,61392879.0,43993967.0,17398911.0,4.4377,0.5996,4.6014,0.5997
2023-04-21 12:55,2603,292,2311,321751,24244,297507,192854120.0,14462357.0,178391763.0,2573,280,2293,320702,24148,296554,192244809.0,14404660.0,177840148.0,0.5965,0.5996,0.5965,0.5997
2023-04-21 13:00,1453,364,1089,156498,34247,122251,93636258.0,20395347.0,73240911.0,1428,349,1079,156743,33921,122822,93858795.0,20202098.0,73656697.0,0.5955,0.5991,0.5956,0.5997
2023-04-21 13:05,559,93,466,59414,7142,52272,35540150.0,4257672.0,31282478.0,546,89,457,58541,6668,51873,35022410.0,3970966.0,31051444.0,0.5961,0.5985,0.5955,0.5986
2023-04-21 13:10,167,69,98,17131,8137,8994,10234901.0,4844693.0,5390208.0,157,64,93,16880,8085,8795,10085043.0,4813742.0,5271300.0,0.5954,0.5993,0.5954,0.5994
2023-04-21 13:15,627,264,363,57419,26554,30865,34372895.0,15897549.0,18475346.0,609,256,353,55022,25097,29925,32886798.0,14973603.0,17913195.0,0.5987,0.5986,0.5966,0.5986
2023-04-21 13:20,119,63,56,13264,6327,6937,27049810.0,22897580.0,4152230.0,95,48,47,8468,3838,4630,24192976.0,21417750.0,2775226.0,3.619,0.5986,5.5804,0.5994
2023-04-21 13:25,1167,58,1109,163875,5697,158178,98101314.0,3442184.0,94659130.0,1156,50,1106,165335,5212,160123,98937831.0,3103821.0,95834010.0,0.6042,0.5984,0.5955,0.5985
2023-04-21 13:30,1538,136,1402,214670,9993,204677,128603050.0,5958444.0,122644605.0,1533,133,1400,214241,9850,204391,128333711.0,5873202.0,122460508.0,0.5963,0.5992,0.5963,0.5991
2023-04-21 13:35,2359,244,2115,308288,17523,290765,184635705.0,10440547.0,174195157.0,2345,235,2110,307634,17402,290232,184269196.0,10367438.0,173901757.0,0.5958,0.5991,0.5958,0.5992
2023-04-21 13:40,1906,127,1779,267174,9289,257885,165720858.0,5568467.0,160152390.0,1897,121,1776,265473,8967,256506,158962602.0,5341250.0,153621352.0,0.5995,0.621,0.5957,0.5989
2023-04-21 13:45,35,26,9,2469,1946,523,1474334.0,1161349.0,312985.0,30,22,8,2401,1883,518,1429677.0,1119553.0,310124.0,0.5968,0.5984,0.5946,0.5987
2023-04-21 13:50,303,24,279,24852,1847,23005,14894745.0,1148307.0,13746437.0,298,16,282,24605,1000,23605,14704531.0,595839.0,14108692.0,0.6217,0.5975,0.5958,0.5977
2023-04-21 13:55,1928,31,1897,290422,1189,289233,173980951.0,708331.0,173272620.0,1918,26,1892,290229,1294,288935,173862423.0,770776.0,173091647.0,0.5957,0.5991,0.5957,0.5991
2023-04-21 14:00,1140,22,1118,152268,666,151602,91163733.0,396933.0,90766799.0,1130,20,1110,151971,765,151206,90986334.0,454634.0,90531699.0,0.596,0.5987,0.5943,0.5987
2023-04-21 14:05,456,122,334,32203,8584,23619,19222596.0,5115886.0,14106710.0,447,117,330,31679,8318,23361,18911968.0,4957762.0,13954206.0,0.596,0.5973,0.596,0.5973
2023-04-21 14:10,594,35,559,44361,1827,42534,26499676.0,1088600.0,25411076.0,587,33,554,44318,1849,42469,26476033.0,1101487.0,25374546.0,0.5958,0.5974,0.5957,0.5975
2023-04-21 14:15,731,134,597,53850,15653,38197,32125249.0,9295079.0,22830170.0,724,130,594,53404,15439,37965,31881892.0,9166205.0,22715687.0,0.5938,0.5977,0.5937,0.5983
2023-04-21 14:20,749,49,700,69282,4301,64981,41430090.0,2553458.0,38876632.0,733,40,693,69522,4525,64997,41567312.0,2680728.0,38886583.0,0.5937,0.5983,0.5924,0.5983
2023-04-21 14:25,1081,27,1054,102091,2195,99896,61044567.0,1305703.0,59738864.0,1075,24,1051,101769,2023,99746,60853563.0,1204819.0,59648744.0,0.5949,0.598,0.5956,0.598
2023-04-21 14:30,1598,37,1561,153774,1380,152394,91973393.0,822716.0,91150677.0,1591,30,1561,153768,1291,152477,91969990.0,769476.0,91200514.0,0.5962,0.5981,0.596,0.5981
2023-04-21 14:35,921,29,892,91323,1828,89495,54632846.0,1086342.0,53546504.0,913,25,888,90624,1316,89308,54215570.0,781744.0,53433825.0,0.5943,0.5983,0.594,0.5983
2023-04-21 14:40,970,16,954,88053,3132,84921,52486021.0,1680452.0,50805568.0,960,8,952,85412,665,84747,51097194.0,395969.0,50701225.0,0.5365,0.5983,0.5954,0.5983
2023-04-21 14:45,2327,8,2319,299727,9,299718,179497232.0,5529.0,179491702.0,2321,8,2313,300002,591,299411,179656096.0,347213.0,179308882.0,0.6144,0.5989,0.5875,0.5989
2023-04-21 14:50,145,13,132,16255,977,15278,9766819.0,625502.0,9141317.0,138,10,128,15769,528,15241,9434765.0,314461.0,9120304.0,0.6402,0.5983,0.5956,0.5984
2023-04-21 14:55,896,26,870,99458,2121,97337,59511523.0,1264298.0,58247225.0,891,20,871,99241,1881,97360,59396096.0,1120512.0,58275584.0,0.5961,0.5984,0.5957,0.5986
2023-04-21 15:00,873,19,854,166970,1029,165941,100033249.0,613092.0,99420157.0,861,14,847,166700,908,165792,99873023.0,540977.0,99332046.0,0.5958,0.5991,0.5958,0.5991
2023-04-21 15:05,696,26,670,107200,2525,104675,64189836.0,1503443.0,62686393.0,694,24,670,107253,2692,104561,64220850.0,1602805.0,62618045.0,0.5954,0.5989,0.5954,0.5989
2023-04-21 15:10,38,14,24,3513,1516,1997,2097042.0,902511.0,1194530.0,34,15,19,3167,1251,1916,1891474.0,744809.0,1146665.0,0.5953,0.5982,0.5954,0.5985
2023-04-21 15:15,33,17,16,2089,981,1108,1249705.0,586719.0,662986.0,23,13,10,2344,1237,1107,1398362.0,735998.0,662364.0,0.5981,0.5984,0.595,0.5983
2023-04-21 15:20,47,9,38,6569,542,6027,3924601.0,322444.0,3602157.0,45,8,37,6557,537,6020,3922332.0,319489.0,3602843.0,0.5949,0.5977,0.595,0.5985
2023-04-21 15:25,65,20,45,5119,575,4544,3057977.0,343229.0,2714748.0,54,11,43,5236,533,4703,3131854.0,317303.0,2814550.0,0.5969,0.5974,0.5953,0.5985
2023-04-21 15:30,1229,264,965,165744,46474,119270,190295888.0,119531266.0,70764622.0,1160,221,939,155110,39937,115173,180198825.0,111503030.0,68695794.0,2.572,0.5933,2.792,0.5965
2023-04-21 15:35,1588,59,1529,273020,3165,269855,185927940.0,24780579.0,161147361.0,1578,53,1525,274205,4329,269876,186628608.0,25468555.0,161160052.0,7.8296,0.5972,5.8832,0.5972
2023-04-21 15:40,1370,631,739,193918,93641,100277,115329260.0,55554001.0,59775259.0,1364,630,734,193548,93621,99927,115114828.0,55540276.0,59574552.0,0.5933,0.5961,0.5932,0.5962
2023-04-21 15:45,666,283,383,74366,17118,57248,44299616.0,10170973.0,34128642.0,664,283,381,74116,16770,57346,44150551.0,9964780.0,34185770.0,0.5942,0.5962,0.5942,0.5961
2023-04-21 15:50,703,496,207,56248,33658,22590,33508227.0,20001100.0,13507127.0,696,492,204,55352,33968,21384,32933216.0,20184385.0,12748830.0,0.5942,0.5979,0.5942,0.5962
2023-04-21 15:55,880,540,340,93094,30855,62239,55514535.0,18340384.0,37174150.0,860,530,330,92540,30501,62039,55180284.0,18125249.0,37055034.0,0.5944,0.5973,0.5943,0.5973
2023-04-21 16:00,1705,571,1134,230538,23164,207374,137595877.0,13769611.0,123826265.0,1689,557,1132,230513,23173,207340,137580181.0,13774146.0,123806034.0,0.5944,0.5971,0.5944,0.5971
2023-04-21 16:05,441,166,275,41604,5193,36411,24814343.0,3088125.0,21726218.0,438,166,272,41707,5212,36495,24875111.0,3098671.0,21776440.0,0.5947,0.5967,0.5945,0.5967
2023-04-21 16:10,1446,805,641,122190,33895,88295,72855798.0,20145818.0,52709980.0,1445,807,638,122602,33957,88645,73102753.0,20182422.0,52920331.0,0.5944,0.597,0.5944,0.597
2023-04-21 16:15,1673,1024,649,117624,45812,71812,70132074.0,27242052.0,42890022.0,1667,1020,647,118785,45588,73197,70851373.0,27094065.0,43757308.0,0.5946,0.5973,0.5943,0.5978
2023-04-21 16:20,860,323,537,122512,20044,102468,73219959.0,11914353.0,61305606.0,848,318,530,122390,20109,102281,73144571.0,11952760.0,61191810.0,0.5944,0.5983,0.5944,0.5983
2023-04-21 16:25,394,137,257,45557,8537,37020,27203364.0,5080241.0,22123122.0,388,135,253,45255,8454,36801,27024646.0,5029917.0,21994729.0,0.5951,0.5976,0.595,0.5977
2023-04-21 16:30,1716,377,1339,264710,51483,213227,157852033.0,30550991.0,127301041.0,1706,373,1333,264083,51207,212876,157484891.0,30387114.0,127097777.0,0.5934,0.597,0.5934,0.5971
2023-04-21 16:35,4042,949,3093,620855,136370,484485,392701781.0,103791169.0,288910611.0,4027,942,3085,620796,136322,484474,392687620.0,103759363.0,288928257.0,0.7611,0.5963,0.7611,0.5964
2023-04-21 16:40,4860,563,4297,742843,36404,706439,442825064.0,21591121.0,421233943.0,4837,549,4288,742766,36322,706444,442781970.0,21541609.0,421240361.0,0.5931,0.5963,0.5931,0.5963
2023-04-21 16:45,3249,594,2655,530005,54094,475911,315862568.0,32090066.0,283772502.0,3201,556,2645,528155,53535,474620,314784441.0,31755903.0,283028537.0,0.5932,0.5963,0.5932,0.5963
2023-04-21 16:50,1976,319,1657,335138,33209,301929,199821275.0,19703638.0,180117636.0,1950,301,1649,334451,32740,301711,199409859.0,19423896.0,179985963.0,0.5933,0.5966,0.5933,0.5966
2023-04-21 16:55,2015,834,1181,245177,82827,162350,145910777.0,49145397.0,96765379.0,2003,827,1176,245177,82769,162408,145913623.0,49110899.0,96802724.0,0.5933,0.596,0.5933,0.596
2023-04-21 17:00,1932,377,1555,306251,27883,278368,182504411.0,16541040.0,165963371.0,1928,378,1550,306269,28007,278262,182516146.0,16614709.0,165901436.0,0.5932,0.5962,0.5932,0.5962
2023-04-21 17:05,2237,682,1555,416689,99232,317457,293771903.0,104588499.0,189183404.0,2207,663,1544,415153,98415,316738,292921785.0,104103916.0,188817869.0,1.054,0.5959,1.0578,0.5961
2023-04-21 17:10,1193,650,543,216243,108548,107695,128520161.0,64268947.0,64251213.0,1189,650,539,216425,108704,107721,128625926.0,64358450.0,64267475.0,0.5921,0.5966,0.5921,0.5966
2023-04-21 17:15,1299,655,644,212854,100559,112295,126513886.0,59558637.0,66955249.0,1288,648,640,212924,100418,112506,126558262.0,59464769.0,67093492.0,0.5923,0.5962,0.5922,0.5964
2023-04-21 17:20,526,144,382,76614,16367,60247,45610116.0,9692706.0,35917409.0,515,139,376,76570,16332,60238,45583023.0,9671915.0,35911107.0,0.5922,0.5962,0.5922,0.5962
2023-04-21 17:25,1465,402,1063,258436,52526,205910,153944622.0,31118613.0,122826009.0,1461,402,1059,258524,52663,205861,153995410.0,31198068.0,122797342.0,0.5924,0.5965,0.5924,0.5965
2023-04-21 17:30,214,146,68,15375,7787,7588,9148808.0,4624919.0,4523888.0,207,142,65,15253,7674,7579,9078443.0,4558175.0,4520268.0,0.5939,0.5962,0.594,0.5964
2023-04-21 17:35,3327,652,2675,632794,65759,567035,467851608.0,130538352.0,337313255.0,3300,631,2669,631128,65198,565930,466969305.0,130206144.0,336763161.0,1.9851,0.5949,1.9971,0.5951
2023-04-21 17:40,3614,372,3242,695776,36443,659333,413687007.0,21565683.0,392121323.0,3599,360,3239,696267,36414,659853,413983554.0,21546863.0,392436691.0,0.5918,0.5947,0.5917,0.5947
2023-04-21 17:45,3278,509,2769,634476,26269,608207,377676245.0,15571643.0,362104601.0,3259,500,2759,633947,26399,607548,377352641.0,15642781.0,361709860.0,0.5928,0.5954,0.5926,0.5954
2023-04-21 17:50,3517,675,2842,672254,43525,628729,422900158.0,48674926.0,374225232.0,3506,668,2838,672031,43762,628269,422811328.0,48813037.0,373998290.0,1.1183,0.5952,1.1154,0.5953
2023-04-21 17:55,4226,450,3776,867720,25994,841726,538970309.0,38277980.0,500692328.0,4195,429,3766,864120,25324,838796,536784875.0,37881348.0,498903526.0,1.4726,0.5948,1.4959,0.5948
2023-04-21 18:00,4063,976,3087,779741,47104,732637,463926739.0,27861196.0,436065543.0,4057,974,3083,779697,47787,731910,463838122.0,28246659.0,435591463.0,0.5915,0.5952,0.5911,0.5951
2023-04-21 18:05,2308,823,1485,377617,43087,334530,224633880.0,25482699.0,199151181.0,2298,817,1481,377853,43141,334712,224771565.0,25512478.0,199259087.0,0.5914,0.5953,0.5914,0.5953
2023-04-21 18:10,1848,523,1325,263050,24940,238110,179273764.0,37649766.0,141623998.0,1805,493,1312,258818,24000,234818,176781768.0,37094221.0,139687547.0,1.5096,0.5948,1.5456,0.5949
2023-04-21 18:15,1845,100,1745,277615,3741,273874,164675223.0,2209685.0,162465538.0,1814,77,1737,276637,3120,273517,164105900.0,1839687.0,162266213.0,0.5907,0.5932,0.5896,0.5933
2023-04-21 18:20,2451,476,1975,394231,20170,374061,257153028.0,34818210.0,222334817.0,2433,465,1968,394173,20061,374112,257111654.0,34750594.0,222361060.0,1.7262,0.5944,1.7322,0.5944
2023-04-21 18:25,3256,418,2838,557598,15874,541724,354015207.0,32282391.0,321732815.0,3233,407,2826,556260,15839,540421,353230668.0,32261424.0,320969244.0,2.0337,0.5939,2.0368,0.5939
2023-04-21 18:30,763,212,551,101133,3673,97460,82831386.0,25082342.0,57749044.0,748,197,551,100046,3246,96800,82186719.0,24818174.0,57368545.0,6.8288,0.5925,7.6458,0.5927
2023-04-21 18:35,244,86,158,12148,2646,9502,7205787.0,1564909.0,5640877.0,238,83,155,12684,2641,10043,7521391.0,1559992.0,5961399.0,0.5914,0.5937,0.5907,0.5936
2023-04-24 10:00,3880,492,3388,582466,23945,558521,359117090.0,26896625.0,332220465.0,3577,336,3241,570373,19289,551084,343169912.0,15683195.0,327486717.0,1.1233,0.5948,0.8131,0.5943
2023-04-24 10:05,2806,365,2441,419328,15132,404196,249024734.0,8948760.0,240075973.0,2725,320,2405,417946,14084,403862,248173099.0,8316996.0,239856103.0,0.5914,0.594,0.5905,0.5939
2023-04-24 10:10,3127,828,2299,396275,54476,341799,343115203.0,140543273.0,202571930.0,2999,748,2251,390404,51222,339182,326729129.0,125615109.0,201114020.0,2.5799,0.5927,2.4524,0.5929
2023-04-24 10:15,1335,848,487,101443,61761,39682,197862860.0,174329281.0,23533578.0,1066,689,377,88322,57146,31176,175617042.0,157150586.0,18466456.0,2.8226,0.5931,2.75,0.5923
2023-04-24 10:20,926,487,439,63557,36881,26676,37970975.0,22040188.0,15930786.0,686,454,232,55363,35740,19623,33127959.0,21301371.0,11826587.0,0.5976,0.5972,0.596,0.6027
2023-04-24 10:25,457,261,196,46024,31290,14734,27436565.0,18577868.0,8858696.0,346,207,139,39318,29997,9321,23399832.0,17798630.0,5601202.0,0.5937,0.6012,0.5933,0.6009
2023-04-24 10:30,393,217,176,27077,15913,11164,16178098.0,9496640.0,6681457.0,379,219,160,25133,15609,9524,15042649.0,9314822.0,5727826.0,0.5968,0.5985,0.5968,0.6014
2023-04-24 10:35,379,282,97,32633,25957,6676,19718354.0,15540274.0,4178079.0,306,267,39,28653,25515,3138,17136108.0,15250471.0,1885636.0,0.5987,0.6258,0.5977,0.6009
2023-04-24 10:40,454,365,89,51163,41053,10110,30557705.0,24485501.0,6072203.0,418,353,65,50344,40702,9642,30078901.0,24282921.0,5795980.0,0.5964,0.6006,0.5966,0.6011
2023-04-24 10:45,312,238,74,24211,19266,4945,14556174.0,11533448.0,3022726.0,271,218,53,22506,19000,3506,13429059.0,11313756.0,2115303.0,0.5986,0.6113,0.5955,0.6033
2023-04-24 10:50,1472,503,969,111371,55959,55412,90671392.0,57364517.0,33306874.0,1416,499,917,109108,55099,54009,86934664.0,54442156.0,32492507.0,1.0251,0.6011,0.9881,0.6016
2023-04-24 10:55,238,120,118,14090,6844,7246,8448840.0,4093817.0,4355022.0,193,94,99,13295,6403,6892,7981209.0,3830165.0,4151043.0,0.5982,0.601,0.5982,0.6023
2023-04-24 11:00,263,75,188,15782,4940,10842,9487828.0,2968257.0,6519571.0,224,61,163,15250,4611,10639,9152285.0,2756348.0,6395937.0,0.6009,0.6013,0.5978,0.6012
2023-04-24 11:05,168,110,58,11145,7985,3160,6657077.0,4760745.0,1896332.0,130,98,32,8676,6164,2512,5203201.0,3684548.0,1518652.0,0.5962,0.6001,0.5978,0.6046
2023-04-24 11:10,162,101,61,9552,6000,3552,5702085.0,3597858.0,2104226.0,146,94,52,9231,5823,3408,5543648.0,3489682.0,2053965.0,0.5996,0.5924,0.5993,0.6027
2023-04-24 11:15,39,12,27,2689,545,2144,1613466.0,325952.0,1287514.0,26,10,16,2115,540,1575,1269632.0,322913.0,946719.0,0.5981,0.6005,0.598,0.6011
2023-04-24 11:20,224,47,177,11158,2959,8199,6685729.0,1771419.0,4914309.0,202,38,164,10537,2883,7654,6322247.0,1724752.0,4597495.0,0.5987,0.5994,0.5982,0.6007
2023-04-24 11:25,267,144,123,16442,9129,7313,9873317.0,5480024.0,4393292.0,247,143,104,16077,8988,7089,9642606.0,5385644.0,4256962.0,0.6003,0.6008,0.5992,0.6005
2023-04-24 11:30,91,59,32,8429,5290,3139,5008428.0,3168873.0,1839554.0,74,50,24,7176,5232,1944,4301009.0,3129725.0,1171284.0,0.599,0.586,0.5982,0.6025
2023-04-24 11:35,1016,874,142,120529,111721,8808,96342911.0,91024690.0,5318221.0,974,890,84,116092,109992,6100,93617611.0,89939330.0,3678281.0,0.8148,0.6038,0.8177,0.603
2023-04-24 11:40,920,775,145,93556,85258,8298,56122976.0,51124657.0,4998319.0,858,741,117,89850,82600,7250,53894143.0,49527445.0,4366698.0,0.5996,0.6024,0.5996,0.6023
2023-04-24 11:45,533,385,148,37440,30123,7317,46525177.0,42157435.0,4367742.0,488,370,118,36899,31030,5869,46239170.0,42707396.0,3531774.0,1.3995,0.5969,1.3763,0.6018
2023-04-24 11:50,331,296,35,24720,23360,1360,14802809.0,13984046.0,818762.0,314,292,22,24036,23074,962,14394815.0,13816987.0,577827.0,0.5986,0.602,0.5988,0.6007
2023-04-24 11:55,98,77,21,4886,4224,662,2934151.0,2533608.0,400543.0,77,67,10,4369,4014,355,2620108.0,2406703.0,213405.0,0.5998,0.6051,0.5996,0.6011
2023-04-24 12:00,137,118,19,11801,10367,1434,7070771.0,6201009.0,869762.0,125,112,13,10765,9857,908,6462889.0,5909369.0,553520.0,0.5981,0.6065,0.5995,0.6096
2023-04-24 12:05,35,15,20,2123,1476,647,1265191.0,884795.0,380395.0,22,12,10,1423,1176,247,853473.0,704915.0,148558.0,0.5995,0.5879,0.5994,0.6014
2023-04-24 12:10,61,38,23,3250,2806,444,1948113.0,1681387.0,266726.0,46,35,11,3034,2628,406,1819130.0,1575107.0,244022.0,0.5992,0.6007,0.5994,0.601
2023-04-24 12:15,48,30,18,2899,1898,1001,1738759.0,1141839.0,596919.0,43,29,14,2633,1862,771,1579528.0,1115244.0,464284.0,0.6016,0.5963,0.5989,0.6022
2023-04-24 12:20,43,27,16,2745,2276,469,1645993.0,1363333.0,282660.0,30,23,7,2372,2237,135,1420819.0,1339678.0,81141.0,0.599,0.6027,0.5989,0.601
2023-04-24 12:25,138,102,36,9687,6136,3551,5873062.0,3656395.0,2216667.0,123,96,27,7694,5701,1993,4614588.0,3416813.0,1197775.0,0.5959,0.6242,0.5993,0.601
2023-04-24 12:30,272,152,120,18695,10881,7814,11216285.0,6522103.0,4694181.0,260,140,120,18795,10763,8032,11279872.0,6452723.0,4827149.0,0.5994,0.6007,0.5995,0.601
2023-04-24 12:35,430,411,19,28746,28277,469,17245439.0,16963326.0,282113.0,422,411,11,28759,28342,417,17253895.0,17002297.0,251597.0,0.5999,0.6015,0.5999,0.6034
2023-04-24 12:40,81,46,35,9997,5253,4744,5994005.0,3148966.0,2845038.0,63,37,26,6482,4768,1714,3887052.0,2857268.0,1029783.0,0.5995,0.5997,0.5993,0.6008
2023-04-24 12:45,1278,853,425,165782,137669,28113,174062374.0,154402924.0,19659450.0,1218,827,391,161277,135809,25468,168554340.0,153290652.0,15263687.0,1.1216,0.6993,1.1287,0.5993
2023-04-24 12:50,969,865,104,134970,128450,6520,104832762.0,100925085.0,3907676.0,920,824,96,132171,126174,5997,103048927.0,99456418.0,3592509.0,0.7857,0.5993,0.7882,0.5991
2023-04-24 12:55,660,517,143,67109,64921,2188,64615152.0,63296656.0,1318496.0,623,494,129,60649,58814,1835,60440655.0,59334125.0,1106529.0,0.975,0.6026,1.0088,0.603
2023-04-24 13:00,149,111,38,13817,12076,1741,8255850.0,7251174.0,1004676.0,101,87,14,8349,8151,198,5014111.0,4893475.0,120635.0,0.6005,0.5771,0.6004,0.6093
2023-04-24 13:05,192,98,94,15966,8737,7229,9672233.0,5226511.0,4445722.0,181,104,77,13666,8200,5466,8358324.0,4906729.0,3451595.0,0.5982,0.615,0.5984,0.6315
2023-04-24 13:10,337,308,29,21842,19628,2214,13115875.0,11810796.0,1305078.0,296,279,17,23660,21996,1664,14194341.0,13192031.0,1002310.0,0.6017,0.5895,0.5997,0.6023
2023-04-24 13:15,101,38,63,7911,1911,6000,4764027.0,1149628.0,3614398.0,83,28,55,6363,1433,4930,3832288.0,861515.0,2970772.0,0.6016,0.6024,0.6012,0.6026
2023-04-24 13:20,147,85,62,12540,8395,4145,7541273.0,5040267.0,2501005.0,131,79,52,12178,8388,3790,7318965.0,5034981.0,2283983.0,0.6004,0.6034,0.6003,0.6026
2023-04-24 13:25,284,147,137,23023,13084,9939,13870394.0,7877396.0,5992997.0,267,143,124,22588,12970,9618,13598289.0,7801098.0,5797190.0,0.6021,0.603,0.6015,0.6027
2023-04-24 13:30,245,135,110,17099,9806,7293,10266415.0,5875781.0,4390634.0,231,129,102,16420,9077,7343,9885825.0,5460925.0,4424899.0,0.5992,0.602,0.6016,0.6026
2023-04-24 13:35,99,53,46,7645,4563,3082,4604176.0,2748048.0,1856127.0,79,48,31,6081,4452,1629,3659397.0,2676030.0,983366.0,0.6022,0.6022,0.6011,0.6037
2023-04-24 13:40,47,34,13,2694,1975,719,1589129.0,1182822.0,406307.0,37,30,7,2837,2373,464,1700105.0,1420446.0,279659.0,0.5989,0.5651,0.5986,0.6027
2023-04-24 13:45,55,36,19,2912,2411,501,1752985.0,1456123.0,296862.0,38,29,9,2081,1674,407,1251494.0,1005802.0,245691.0,0.604,0.5925,0.6008,0.6037
2023-04-24 13:50,369,108,261,32082,17619,14463,19125811.0,10436744.0,8689067.0,359,105,254,32162,17939,14223,19188215.0,10625515.0,8562699.0,0.5924,0.6008,0.5923,0.602
2023-04-24 13:55,124,70,54,11198,7823,3375,6699636.0,4660672.0,2038964.0,109,64,45,10031,7337,2694,5994293.0,4372350.0,1621943.0,0.5958,0.6041,0.5959,0.6021
2023-04-24 14:00,158,101,57,13826,8232,5594,8395662.0,5029638.0,3366023.0,140,89,51,10612,6823,3789,6371813.0,4091507.0,2280305.0,0.611,0.6017,0.5997,0.6018
2023-04-24 14:05,175,139,36,12272,9991,2281,7360336.0,5992600.0,1367736.0,167,136,31,12131,10044,2087,7278558.0,6023130.0,1255427.0,0.5998,0.5996,0.5997,0.6015
2023-04-24 14:10,68,42,26,5445,3373,2072,3265787.0,2018714.0,1247073.0,64,42,22,5430,3379,2051,3258013.0,2023114.0,1234899.0,0.5985,0.6019,0.5987,0.6021
2023-04-24 14:15,158,122,36,11925,9858,2067,7153307.0,5910012.0,1243295.0,153,122,31,11776,9659,2117,7065310.0,5790681.0,1274628.0,0.5995,0.6015,0.5995,0.6021
2023-04-24 14:20,210,184,26,20660,18852,1808,12405388.0,11316552.0,1088836.0,197,180,17,20425,18839,1586,12260354.0,11305608.0,954745.0,0.6003,0.6022,0.6001,0.602
2023-04-24 14:25,43,37,6,3299,3239,60,1978973.0,1942288.0,36685.0,37,35,2,3289,3287,2,1969984.0,1968751.0,1233.0,0.5997,0.6114,0.599,0.6165
2023-04-24 14:30,35,25,10,3033,2570,463,1817391.0,1540043.0,277348.0,30,21,9,2515,1901,614,1509192.0,1139263.0,369928.0,0.5992,0.599,0.5993,0.6025
2023-04-24 14:35,51,35,16,6238,2636,3602,3791810.0,1580472.0,2211337.0,46,33,13,4188,2767,1421,2513227.0,1657394.0,855832.0,0.5996,0.6139,0.599,0.6023
2023-04-24 14:40,61,38,23,5586,2425,3161,3317235.0,1449667.0,1867567.0,50,33,17,5260,2808,2452,3154932.0,1678604.0,1476327.0,0.5978,0.5908,0.5978,0.6021
2023-04-24 14:45,766,505,261,55658,33874,21784,33438927.0,20330575.0,13108352.0,758,504,254,55707,33857,21850,33468632.0,20320054.0,13148578.0,0.6002,0.6017,0.6002,0.6018
2023-04-24 14:50,202,54,148,18714,4682,14032,11245985.0,2803993.0,8441991.0,204,55,149,19185,4835,14350,11525812.0,2892802.0,8633009.0,0.5989,0.6016,0.5983,0.6016
2023-04-24 14:55,725,557,168,82820,76282,6538,49620072.0,45704485.0,3915587.0,709,552,157,82663,76448,6215,49545552.0,45803477.0,3742075.0,0.5992,0.5989,0.5991,0.6021
2023-04-24 15:00,706,339,367,70571,53196,17375,42352274.0,31901239.0,10451034.0,695,332,363,70879,53116,17763,42537961.0,31852450.0,10685511.0,0.5997,0.6015,0.5997,0.6016
2023-04-24 15:05,200,77,123,18515,5467,13048,35213566.0,27371383.0,7842183.0,182,67,115,16842,4620,12222,34213598.0,26867704.0,7345893.0,5.0067,0.601,5.8155,0.601
2023-04-24 15:10,819,648,171,75235,58461,16774,45096985.0,35017535.0,10079450.0,812,647,165,75237,58708,16529,45094992.0,35162817.0,9932174.0,0.599,0.6009,0.5989,0.6009
2023-04-24 15:15,1123,419,704,88203,40443,47760,52767500.0,24069807.0,28697692.0,1111,410,701,87743,40160,47583,52477557.0,23886268.0,28591288.0,0.5952,0.6009,0.5948,0.6009
2023-04-24 15:20,125,43,82,12404,2666,9738,7448923.0,1595431.0,5853492.0,125,44,81,12042,2337,9705,7234348.0,1401299.0,5833048.0,0.5984,0.6011,0.5996,0.601
2023-04-24 15:25,164,135,29,7667,4758,2909,4602341.0,2853118.0,1749223.0,160,133,27,7903,5037,2866,4741694.0,3017357.0,1724337.0,0.5996,0.6013,0.599,0.6017
2023-04-24 15:30,259,32,227,17607,1730,15877,10573257.0,1037119.0,9536138.0,250,30,220,18628,1710,16918,11193103.0,1025012.0,10168091.0,0.5995,0.6006,0.5994,0.601
2023-04-24 15:35,314,282,32,17205,13341,3864,10319431.0,7996627.0,2322803.0,303,276,27,16827,12975,3852,10097838.0,7780194.0,2317643.0,0.5994,0.6011,0.5996,0.6017
2023-04-24 15:40,527,505,22,51387,49800,1587,30624234.0,29669443.0,954790.0,522,502,20,51500,49873,1627,30691635.0,29712369.0,979266.0,0.5958,0.6016,0.5958,0.6019
2023-04-24 15:45,159,122,37,7028,5347,1681,4201251.0,3192662.0,1008588.0,112,80,32,6707,5198,1509,4010518.0,3103838.0,906680.0,0.5971,0.6,0.5971,0.6008
2023-04-24 15:50,587,19,568,24581,498,24083,14758015.0,295204.0,14462811.0,579,15,564,24859,767,24092,14919264.0,449850.0,14469413.0,0.5928,0.6005,0.5865,0.6006
2023-04-24 15:55,1670,1069,601,173134,141056,32078,103638711.0,84430498.0,19208212.0,1650,1058,592,171281,140278,31003,102597935.0,83961261.0,18636674.0,0.5986,0.5988,0.5985,0.6011
2023-04-24 16:00,2118,718,1400,270395,86273,184122,258320844.0,147926984.0,110393860.0,2091,705,1386,268288,85394,182894,257173577.0,147419119.0,109754458.0,1.7146,0.5996,1.7263,0.6001
2023-04-24 16:05,2056,237,1819,258964,19502,239462,155389163.0,11635774.0,143753388.0,2042,229,1813,257643,18196,239447,154605070.0,10861785.0,143743285.0,0.5966,0.6003,0.5969,0.6003
2023-04-24 16:10,1616,99,1517,229078,6978,222100,137461844.0,4163518.0,133298325.0,1606,93,1513,228841,6670,222171,137323570.0,3982297.0,133341273.0,0.5967,0.6002,0.597,0.6002
2023-04-24 16:15,2520,816,1704,300014,56557,243457,179960798.0,33812028.0,146148770.0,2509,809,1700,299647,56450,243197,179738304.0,33745550.0,145992754.0,0.5978,0.6003,0.5978,0.6003
2023-04-24 16:20,1529,288,1241,198692,14812,183880,119365664.0,8856160.0,110509504.0,1521,284,1237,198721,14874,183847,119382988.0,8893061.0,110489926.0,0.5979,0.601,0.5979,0.601
2023-04-24 16:25,795,501,294,62017,31246,30771,37158776.0,18683193.0,18475583.0,788,498,290,61934,31225,30709,37108308.0,18670492.0,18437816.0,0.5979,0.6004,0.5979,0.6004
2023-04-24 16:30,1330,936,394,167221,79590,87631,124508541.0,71818577.0,52689963.0,1301,918,383,164552,78293,86259,122840300.0,70971139.0,51869160.0,0.9024,0.6013,0.9065,0.6013
2023-04-24 16:35,2218,2093,125,187514,156646,30868,112414452.0,93829005.0,18585447.0,2219,2099,120,186863,156446,30417,112015933.0,93701088.0,18314845.0,0.599,0.6021,0.5989,0.6021
2023-04-24 16:40,308,192,116,39904,13581,26323,23934563.0,8114816.0,15819747.0,282,182,100,39746,13656,26090,23850879.0,8162453.0,15688426.0,0.5975,0.601,0.5977,0.6013
2023-04-24 16:45,996,75,921,156208,3634,152574,117803284.0,26275423.0,91527860.0,980,68,912,155298,3428,151870,117262838.0,26155645.0,91107192.0,7.2304,0.5999,7.63,0.5999
2023-04-24 16:50,370,300,70,27683,18608,9075,16564615.0,11122866.0,5441748.0,373,296,77,27178,18484,8694,16263791.0,11050086.0,5213704.0,0.5977,0.5996,0.5978,0.5997
2023-04-24 16:55,1111,739,372,111859,42223,69636,91158672.0,49359723.0,41798948.0,1100,733,367,111271,42181,69090,90800789.0,49332140.0,41468649.0,1.169,0.6002,1.1695,0.6002
2023-04-24 17:00,469,414,55,32897,20151,12746,19715121.0,12053019.0,7662102.0,464,408,56,33334,19691,13643,19977870.0,11776478.0,8201392.0,0.5981,0.6011,0.5981,0.6011
2023-04-24 17:05,153,22,131,34206,913,33293,20562204.0,545730.0,20016473.0,148,21,127,34165,797,33368,20537792.0,476421.0,20061371.0,0.5977,0.6012,0.5978,0.6012
2023-04-24 17:10,62,32,30,5875,1399,4476,3524798.0,835968.0,2688829.0,62,36,26,5740,1389,4351,3439473.0,825516.0,2613956.0,0.5975,0.6007,0.5943,0.6008
2023-04-24 17:15,13,8,5,390,231,159,228672.0,138478.0,90194.0,9,5,4,340,232,108,203486.0,138452.0,65033.0,0.5995,0.5673,0.5968,0.6022
2023-04-24 17:20,46,21,25,4187,795,3392,2512560.0,473532.0,2039028.0,37,18,19,4483,1060,3423,2690266.0,630954.0,2059311.0,0.5956,0.6011,0.5952,0.6016
2023-04-24 17:25,162,135,27,15041,10789,4252,9007710.0,6450120.0,2557590.0,149,128,21,14255,10505,3750,8537740.0,6280387.0,2257353.0,0.5978,0.6015,0.5978,0.602
2023-04-24 17:30,287,26,261,65131,890,64241,39203905.0,531957.0,38671947.0,275,20,255,65227,759,64468,39263773.0,453682.0,38810090.0,0.5977,0.602,0.5977,0.602
2023-04-24 17:35,265,60,205,51353,3862,47491,30879931.0,2313542.0,28566389.0,265,56,209,50629,3134,47495,30443988.0,1875026.0,28568961.0,0.5991,0.6015,0.5983,0.6015
2023-04-24 17:40,90,50,40,11767,2836,8931,7067792.0,1696771.0,5371020.0,90,48,42,11418,2758,8660,6858338.0,1650023.0,5208315.0,0.5983,0.6014,0.5983,0.6014
2023-04-24 17:45,136,74,62,18604,4358,14246,11162340.0,2605273.0,8557066.0,126,70,56,18664,4324,14340,11197805.0,2584295.0,8613509.0,0.5978,0.6007,0.5977,0.6007
2023-04-24 17:50,13,9,4,197,173,24,117921.0,103457.0,14463.0,10,6,4,235,211,24,140691.0,126103.0,14587.0,0.598,0.6026,0.5976,0.6078
2023-04-24 17:55,75,45,30,7375,2818,4557,4415174.0,1679164.0,2736009.0,69,41,28,7190,2683,4507,4307833.0,1598627.0,2709206.0,0.5959,0.6004,0.5958,0.6011
2023-04-24 18:00,33,23,10,5042,3348,1694,3054003.0,2027470.0,1026532.0,26,21,5,2233,1706,527,1313388.0,996224.0,317164.0,0.6056,0.606,0.584,0.6018
2023-04-24 18:05,182,92,90,24673,5808,18865,38941408.0,27591532.0,11349875.0,159,77,82,24278,5546,18732,38697860.0,27427571.0,11270289.0,4.7506,0.6016,4.9455,0.6017
2023-04-24 18:10,46,34,12,1159,1019,140,701525.0,617325.0,84200.0,31,27,4,850,817,33,510163.0,490277.0,19886.0,0.6058,0.6014,0.6001,0.6026
2023-04-24 18:15,59,52,7,3189,2865,324,1908562.0,1713905.0,194657.0,56,52,4,5202,4925,277,3113059.0,2946086.0,166973.0,0.5982,0.6008,0.5982,0.6028
2023-04-24 18:20,410,371,39,41869,33457,8412,25105269.0,20045367.0,5059902.0,400,363,37,42045,33665,8380,25206102.0,20163662.0,5042440.0,0.5991,0.6015,0.599,0.6017
2023-04-24 18:25,223,188,35,12805,9387,3418,7686282.0,5636779.0,2049503.0,197,172,25,11957,9125,2832,7172763.0,5465289.0,1707473.0,0.6005,0.5996,0.5989,0.6029
2023-04-24 18:30,695,589,106,59242,43121,16121,156159601.0,146436237.0,9723363.0,681,588,93,57171,41685,15486,154886318.0,145548986.0,9337331.0,3.3959,0.6031,3.4916,0.603
2023-04-24 18:35,1590,1227,363,166039,147117,18922,123428286.0,112093448.0,11334838.0,1555,1215,340,162947,146348,16599,121603256.0,111602317.0,10000938.0,0.7619,0.599,0.7626,0.6025
2023-04-25 10:00,2014,1735,279,195460,178322,17138,132203253.0,121473196.0,10730057.0,1714,1591,123,182138,172465,9673,116719649.0,110855853.0,5863796.0,0.6812,0.6261,0.6428,0.6062
2023-04-25 10:05,1316,1070,246,119517,109359,10158,95927605.0,89786930.0,6140674.0,1237,1040,197,118224,108663,9561,78272976.0,72483312.0,5789663.0,0.821,0.6045,0.667,0.6055
2023-04-25 10:10,496,359,137,26036,22007,4029,15688824.0,13248001.0,2440823.0,357,293,64,24118,21138,2980,14508624.0,12708431.0,1800193.0,0.602,0.6058,0.6012,0.6041
2023-04-25 10:15,1492,816,676,142913,89835,53078,85977293.0,53917941.0,32059351.0,1436,795,641,141733,89377,52356,85269374.0,53644564.0,31624809.0,0.6002,0.604,0.6002,0.604
2023-04-25 10:20,1281,860,421,122788,91304,31484,73871258.0,54773625.0,19097633.0,1220,827,393,119672,90064,29608,71931251.0,54048181.0,17883069.0,0.5999,0.6066,0.6001,0.604
2023-04-25 10:25,2373,1364,1009,259213,201437,57776,155706634.0,120782422.0,34924211.0,2330,1344,986,255949,200807,55142,153699230.0,120406656.0,33292573.0,0.5996,0.6045,0.5996,0.6038
2023-04-25 10:30,2425,2090,335,274303,254294,20009,164595651.0,152555053.0,12040598.0,2391,2080,311,272086,253030,19056,163305006.0,151796947.0,11508059.0,0.5999,0.6018,0.5999,0.6039
2023-04-25 10:35,2208,1376,832,247226,171627,75599,172747844.0,127243383.0,45504461.0,2148,1340,808,244770,171123,73647,171316808.0,126923303.0,44393505.0,0.7414,0.6019,0.7417,0.6028
2023-04-25 10:40,1426,402,1024,100064,11597,88467,60134034.0,6873800.0,53260233.0,1407,395,1012,98209,10751,87458,59114759.0,6433958.0,52680801.0,0.5927,0.602,0.5985,0.6024
2023-04-25 10:45,901,163,738,81473,5374,76099,49040643.0,3215601.0,45825041.0,833,132,701,79124,4250,74874,47641666.0,2545969.0,45095696.0,0.5984,0.6022,0.5991,0.6023
2023-04-25 10:50,2619,1118,1501,344891,112925,231966,327951088.0,188232608.0,139718479.0,2582,1103,1479,342816,111747,231069,326694792.0,187471144.0,139223648.0,1.6669,0.6023,1.6776,0.6025
2023-04-25 10:55,3698,1319,2379,502885,95569,407316,350801293.0,105463966.0,245337326.0,3677,1312,2365,502030,95512,406518,350295251.0,105426162.0,244869088.0,1.1035,0.6023,1.1038,0.6024
2023-04-25 11:00,3388,415,2973,491434,23638,467796,295931024.0,14153037.0,281777986.0,3367,401,2966,490825,23282,467543,295567765.0,13941488.0,281626277.0,0.5987,0.6024,0.5988,0.6024
2023-04-25 11:05,1900,106,1794,352628,4336,348292,212538560.0,2595013.0,209943546.0,1877,96,1781,352266,4109,348157,212329255.0,2459320.0,209869935.0,0.5985,0.6028,0.5985,0.6028
2023-04-25 11:10,351,264,87,32529,16265,16264,19547853.0,9742818.0,9805035.0,336,252,84,31770,16120,15650,19092464.0,9656045.0,9436418.0,0.599,0.6029,0.599,0.603
2023-04-25 11:15,359,304,55,24535,19494,5041,14688066.0,11649985.0,3038081.0,332,292,40,24217,19328,4889,14503393.0,11553252.0,2950140.0,0.5976,0.6027,0.5977,0.6034
2023-04-25 11:20,65,52,13,3234,2870,364,1932819.0,1710306.0,222512.0,50,42,8,2678,2509,169,1600362.0,1498873.0,101489.0,0.5959,0.6113,0.5974,0.6005
2023-04-25 11:25,960,43,917,225843,2532,223311,136085940.0,1520718.0,134565222.0,950,34,916,225144,1640,223504,135662498.0,979604.0,134682894.0,0.6006,0.6026,0.5973,0.6026
2023-04-25 11:30,1893,73,1820,389746,2333,387413,234801796.0,1396059.0,233405737.0,1874,65,1809,389465,2132,387333,234632009.0,1276504.0,233355505.0,0.5984,0.6025,0.5987,0.6025
2023-04-25 11:35,2006,729,1277,309231,50262,258969,210440089.0,54299209.0,156140879.0,1967,706,1261,308105,49610,258495,209742379.0,53881532.0,155860846.0,1.0803,0.6029,1.0861,0.603
2023-04-25 11:40,3259,977,2282,407267,81160,326107,245454460.0,48732230.0,196722230.0,3211,940,2271,406541,80790,325751,245007605.0,48501538.0,196506067.0,0.6004,0.6032,0.6003,0.6032
2023-04-25 11:45,942,319,623,112284,22888,89396,67600622.0,13734035.0,53866586.0,926,314,612,111327,22910,88417,67021795.0,13744092.0,53277702.0,0.6001,0.6026,0.5999,0.6026
2023-04-25 11:50,81,47,34,8887,3238,5649,5347679.0,1936599.0,3411080.0,125,68,57,5643,1752,3891,3395092.0,1046648.0,2348444.0,0.5981,0.6038,0.5974,0.6036
2023-04-25 11:55,480,254,226,34821,17731,17090,20967140.0,10691859.0,10275280.0,467,245,222,33729,16302,17427,20247619.0,9772026.0,10475593.0,0.603,0.6012,0.5994,0.6011
2023-04-25 12:00,226,59,167,17533,2427,15106,10554459.0,1463627.0,9090832.0,208,50,158,17346,2755,14591,10428929.0,1647863.0,8781066.0,0.6031,0.6018,0.5981,0.6018
2023-04-25 12:05,2011,128,1883,214904,5633,209271,129284384.0,3358409.0,125925974.0,1998,121,1877,215065,5388,209677,129389580.0,3214432.0,126175148.0,0.5962,0.6017,0.5966,0.6018
2023-04-25 12:10,1893,307,1586,189587,26725,162862,114049250.0,16031267.0,98017983.0,1876,298,1578,188845,26561,162284,113601527.0,15931758.0,97669769.0,0.5999,0.6018,0.5998,0.6018
2023-04-25 12:15,688,58,630,73358,4906,68452,44131920.0,2933569.0,41198350.0,687,53,634,73986,5054,68932,44509915.0,3019529.0,41490386.0,0.598,0.6019,0.5975,0.6019
2023-04-25 12:20,694,25,669,78658,1629,77029,47323233.0,974124.0,46349109.0,685,23,662,78163,1548,76615,47025487.0,925819.0,46099668.0,0.598,0.6017,0.5981,0.6017
2023-04-25 12:25,1751,211,1540,183740,10646,173094,110553573.0,6383577.0,104169995.0,1746,207,1539,183966,10712,173254,110690089.0,6423173.0,104266916.0,0.5996,0.6018,0.5996,0.6018
2023-04-25 12:30,1330,122,1208,157866,6435,151431,95058827.0,3857180.0,91201646.0,1320,119,1201,157171,6330,150841,94640534.0,3794370.0,90846164.0,0.5994,0.6023,0.5994,0.6023
2023-04-25 12:35,1112,125,987,116047,9123,106924,93896754.0,29554714.0,64342039.0,1092,119,973,114021,8538,105483,92702989.0,29220769.0,63482219.0,3.2396,0.6018,3.4224,0.6018
2023-04-25 12:40,214,93,121,16080,5114,10966,9649130.0,3054368.0,6594761.0,205,88,117,16120,5177,10943,9669803.0,3093569.0,6576234.0,0.5973,0.6014,0.5976,0.601
2023-04-25 12:45,275,92,183,21204,6311,14893,36797398.0,27874836.0,8922562.0,251,79,172,19624,5760,13864,35869735.0,27545766.0,8323968.0,4.4169,0.5991,4.7823,0.6004
2023-04-25 12:50,811,242,569,56728,12160,44568,34021376.0,7278956.0,26742419.0,785,223,562,55686,11416,44270,33387540.0,6809046.0,26578493.0,0.5986,0.6,0.5964,0.6004
2023-04-25 12:55,1669,125,1544,145402,2310,143092,87229810.0,1378040.0,85851770.0,1655,114,1541,145249,2104,143145,87139319.0,1255608.0,85883711.0,0.5966,0.6,0.5968,0.6
2023-04-25 13:00,2389,231,2158,247067,26598,220469,148132759.0,15884061.0,132248698.0,2368,216,2152,246517,26595,219922,147806768.0,15883240.0,131923528.0,0.5972,0.5999,0.5972,0.5999
2023-04-25 13:05,1361,634,727,169635,76735,92900,101608669.0,45866415.0,55742254.0,1346,626,720,169144,76509,92635,101316017.0,45730614.0,55585403.0,0.5977,0.6,0.5977,0.6
2023-04-25 13:10,1810,563,1247,203962,38511,165451,122220300.0,23008279.0,99212021.0,1791,552,1239,202115,37811,164304,121100313.0,22575721.0,98524592.0,0.5974,0.5996,0.5971,0.5996
2023-04-25 13:15,1770,1296,474,203433,141123,62310,121677240.0,84279491.0,37397749.0,1765,1295,470,204545,141313,63232,122344820.0,84393699.0,37951120.0,0.5972,0.6002,0.5972,0.6002
2023-04-25 13:20,1945,959,986,208959,76119,132840,173311568.0,93635427.0,79676140.0,1931,948,983,208643,75871,132772,173140366.0,93489558.0,79650808.0,1.2301,0.5998,1.2322,0.5999
2023-04-25 13:25,2018,335,1683,219792,25173,194619,131783576.0,15045699.0,116737877.0,2012,332,1680,219815,25093,194722,131794224.0,14994222.0,116800002.0,0.5977,0.5998,0.5975,0.5998
2023-04-25 13:30,2552,445,2107,260533,33243,227290,156163966.0,19861015.0,136302951.0,2542,438,2104,260112,33135,226977,155922739.0,19796827.0,136125911.0,0.5974,0.5997,0.5975,0.5997
2023-04-25 13:35,3868,1609,2259,578518,234107,344411,370670459.0,164144012.0,206526447.0,3854,1602,2252,577944,233774,344170,370303583.0,163923312.0,206380271.0,0.7011,0.5997,0.7012,0.5996
2023-04-25 13:40,808,256,552,85476,19398,66078,51226992.0,11592726.0,39634265.0,796,251,545,83863,19058,64805,50261711.0,11390228.0,38871482.0,0.5976,0.5998,0.5977,0.5998
2023-04-25 13:45,354,73,281,39974,3621,36353,23937714.0,2162664.0,21775049.0,344,71,273,38691,3545,35146,23168295.0,2117311.0,21050984.0,0.5973,0.599,0.5973,0.599
2023-04-25 13:50,1131,170,961,114737,10345,104392,68758068.0,6186853.0,62571215.0,1141,182,959,116852,10441,106411,70024551.0,6240139.0,63784411.0,0.5981,0.5994,0.5977,0.5994
2023-04-25 13:55,621,160,461,58376,6105,52271,35010071.0,3646780.0,31363290.0,606,154,452,56155,5978,50177,33680492.0,3571029.0,30109463.0,0.5973,0.6,0.5974,0.6001
2023-04-25 14:00,119,18,101,13339,823,12516,7986740.0,491244.0,7495496.0,119,18,101,13388,823,12565,8015553.0,491350.0,7524202.0,0.5969,0.5989,0.597,0.5988
2023-04-25 14:05,2235,332,1903,227999,13826,214173,136660492.0,8263229.0,128397262.0,2233,329,1904,229551,13843,215708,137591079.0,8273421.0,129317657.0,0.5977,0.5995,0.5977,0.5995
2023-04-25 14:10,2181,343,1838,225279,15142,210137,135034618.0,9049184.0,125985433.0,2179,342,1837,225560,15211,210349,135211692.0,9090382.0,126121309.0,0.5976,0.5995,0.5976,0.5996
2023-04-25 14:15,1990,258,1732,236576,11531,225045,141813312.0,6891378.0,134921933.0,1978,252,1726,236065,11411,224654,141508779.0,6819681.0,134689098.0,0.5976,0.5995,0.5976,0.5995
2023-04-25 14:20,2823,108,2715,344576,6024,338552,206563509.0,3593341.0,202970168.0,2816,103,2713,343766,4940,338826,206082695.0,2947114.0,203135581.0,0.5965,0.5995,0.5966,0.5995
2023-04-25 14:25,1455,101,1354,139628,3439,136189,83705218.0,2054227.0,81650990.0,1446,98,1348,139512,3374,136138,83635184.0,2015290.0,81619894.0,0.5973,0.5995,0.5973,0.5995
2023-04-25 14:30,882,105,777,107625,3003,104622,64511719.0,1788218.0,62723501.0,876,102,774,107713,3164,104549,64561381.0,1882491.0,62678890.0,0.5955,0.5995,0.595,0.5995
2023-04-25 14:35,797,209,588,100437,5937,94500,60196963.0,3541971.0,56654991.0,788,206,582,99999,5724,94275,59937473.0,3416638.0,56520835.0,0.5966,0.5995,0.5969,0.5995
2023-04-25 14:40,1742,235,1507,197580,6089,191491,118424405.0,3633080.0,114791325.0,1735,232,1503,197312,6008,191304,118271752.0,3585067.0,114686685.0,0.5967,0.5995,0.5967,0.5995
2023-04-25 14:45,295,50,245,39066,1314,37752,23415675.0,785362.0,22630312.0,286,47,239,38850,1211,37639,23290114.0,723704.0,22566409.0,0.5977,0.5994,0.5976,0.5995
2023-04-25 14:50,1369,238,1131,165589,11656,153933,99223605.0,6960311.0,92263293.0,1362,236,1126,165076,12093,152983,98934342.0,7217937.0,91716405.0,0.5971,0.5994,0.5969,0.5995
2023-04-25 14:55,1810,391,1419,277601,28573,249028,214458059.0,65237816.0,149220243.0,1776,372,1404,275937,28041,247896,213563552.0,64922299.0,148641253.0,2.2832,0.5992,2.3153,0.5996
2023-04-25 15:00,1743,105,1638,298441,4641,293800,178522549.0,2756025.0,175766524.0,1738,99,1639,298854,4444,294410,178782149.0,2638859.0,176143289.0,0.5938,0.5983,0.5938,0.5983
2023-04-25 15:05,1655,28,1627,268794,786,268008,160836307.0,463125.0,160373181.0,1647,23,1624,268316,389,267927,160554490.0,231374.0,160323116.0,0.5892,0.5984,0.5948,0.5984
2023-04-25 15:10,1226,27,1199,190347,3469,186878,138045440.0,26177682.0,111867758.0,1218,23,1195,189608,2671,186937,137599110.0,25697178.0,111901932.0,7.5462,0.5986,9.6208,0.5986
2023-04-25 15:15,1242,368,874,140153,24891,115262,108066180.0,38980713.0,69085467.0,1230,363,867,139152,24588,114564,107463218.0,38798499.0,68664719.0,1.5661,0.5994,1.5779,0.5994
2023-04-25 15:20,630,381,249,39674,18584,21090,23759613.0,11112797.0,12646816.0,625,379,246,39977,18578,21399,23942199.0,11108550.0,12833648.0,0.598,0.5997,0.5979,0.5997
2023-04-25 15:25,284,150,134,19051,8571,10480,11412966.0,5127298.0,6285668.0,277,145,132,19155,8549,10606,11475312.0,5113725.0,6361587.0,0.5982,0.5998,0.5982,0.5998
2023-04-25 15:30,201,108,93,13662,4525,9137,8186950.0,2707198.0,5479751.0,189,103,86,12848,4268,8580,7698618.0,2553333.0,5145285.0,0.5983,0.5997,0.5983,0.5997
2023-04-25 15:35,84,42,42,8669,3037,5632,5223678.0,1817417.0,3406260.0,81,39,42,8680,3014,5666,5228124.0,1803671.0,3424453.0,0.5984,0.6048,0.5984,0.6044
2023-04-25 15:40,321,37,284,37389,2519,34870,22490851.0,1509840.0,20981011.0,315,32,283,37310,2158,35152,22450363.0,1289811.0,21160551.0,0.5994,0.6017,0.5977,0.602
2023-04-25 15:45,8,4,4,314,172,142,188058.0,102850.0,85208.0,9,5,4,315,173,142,188778.0,103569.0,85208.0,0.598,0.6001,0.5987,0.6001
2023-04-25 15:50,24,10,14,2333,587,1746,1400359.0,351350.0,1049008.0,27,11,16,2468,590,1878,1483325.0,353120.0,1130205.0,0.5986,0.6008,0.5985,0.6018
2023-04-25 15:55,22,10,12,577,324,253,343866.0,193280.0,150586.0,8,6,2,318,316,2,189621.0,188398.0,1223.0,0.5965,0.5952,0.5962,0.6115
2023-04-25 16:00,39,24,15,2200,1094,1106,1323535.0,658531.0,665004.0,32,20,12,2141,1019,1122,1283855.0,609156.0,674699.0,0.6019,0.6013,0.5978,0.6013
2023-04-25 16:05,225,187,38,17341,12734,4607,10401446.0,7625865.0,2775581.0,215,182,33,17173,12928,4245,10298984.0,7741783.0,2557201.0,0.5989,0.6025,0.5988,0.6024
2023-04-25 16:10,79,41,38,9320,4000,5320,5601259.0,2395143.0,3206116.0,75,39,36,9304,3782,5522,5591359.0,2263784.0,3327574.0,0.5988,0.6027,0.5986,0.6026
2023-04-25 16:15,143,48,95,14499,4111,10388,8709854.0,2459571.0,6250283.0,139,45,94,14120,4098,10022,8480474.0,2451331.0,6029142.0,0.5983,0.6017,0.5982,0.6016
2023-04-25 16:20,156,54,102,11565,4146,7419,31102398.0,26645652.0,4456746.0,144,48,96,11043,3783,7260,30727861.0,26367849.0,4360012.0,6.4268,0.6007,6.9701,0.6006
2023-04-25 16:25,273,30,243,19003,1748,17255,11401571.0,1044316.0,10357255.0,262,23,239,18803,1643,17160,11281078.0,981358.0,10299719.0,0.5974,0.6002,0.5973,0.6002
2023-04-25 16:30,91,48,43,5988,2520,3468,3591209.0,1505184.0,2086025.0,70,40,30,5803,2434,3369,3481354.0,1452642.0,2028712.0,0.5973,0.6015,0.5968,0.6022
2023-04-25 16:35,69,30,39,6913,1631,5282,4162250.0,979325.0,3182925.0,68,27,41,6974,1606,5368,4198750.0,962250.0,3236499.0,0.6004,0.6026,0.5992,0.6029
2023-04-25 16:40,111,37,74,9887,2367,7520,5939444.0,1417067.0,4522376.0,102,35,67,9415,2260,7155,5656241.0,1353281.0,4302960.0,0.5987,0.6014,0.5988,0.6014
2023-04-25 16:45,878,107,771,108082,5520,102562,64883490.0,3302675.0,61580815.0,866,103,763,107818,5670,102148,64779398.0,3391559.0,61387839.0,0.5983,0.6004,0.5982,0.601
2023-04-25 16:50,1702,37,1665,257620,783,256837,154829210.0,468692.0,154360518.0,1687,29,1658,257156,577,256579,154550962.0,345274.0,154205687.0,0.5986,0.601,0.5984,0.601
2023-04-25 16:55,808,21,787,107197,769,106428,64378923.0,459694.0,63919228.0,805,20,785,107160,677,106483,64360235.0,404800.0,63955434.0,0.5978,0.6006,0.5979,0.6006
2023-04-25 17:00,341,16,325,36466,359,36107,21915135.0,214541.0,21700594.0,337,15,322,36728,506,36222,22073089.0,302549.0,21770540.0,0.5976,0.601,0.5979,0.601
2023-04-25 17:05,122,22,100,13465,458,13007,8097164.0,275095.0,7822068.0,132,30,102,13165,433,12732,7914515.0,258674.0,7655841.0,0.6006,0.6014,0.5974,0.6013
2023-04-25 17:10,607,57,550,101830,826,101004,61258298.0,501724.0,60756574.0,595,48,547,101622,506,101116,61129212.0,302038.0,60827173.0,0.6074,0.6015,0.5969,0.6016
2023-04-25 17:15,61,28,33,4005,853,3152,2409901.0,514237.0,1895664.0,41,20,21,2963,791,2172,1778400.0,472388.0,1306012.0,0.6029,0.6014,0.5972,0.6013
2023-04-25 17:20,81,39,42,5985,1331,4654,3592235.0,795627.0,2796607.0,55,24,31,6349,1300,5049,3813314.0,777400.0,3035913.0,0.5978,0.6009,0.598,0.6013
2023-04-25 17:25,1800,38,1762,268456,3890,264566,209056216.0,50531864.0,158524352.0,1781,31,1750,267044,3470,263574,208265642.0,50281690.0,157983951.0,12.9902,0.5992,14.4904,0.5994
2023-04-25 17:30,2665,265,2400,382558,10964,371594,253359778.0,30654161.0,222705617.0,2652,256,2396,382260,10905,371355,253176098.0,30614318.0,222561779.0,2.7959,0.5993,2.8074,0.5993
2023-04-25 17:35,1684,225,1459,263457,7442,256015,157899186.0,4448939.0,153450247.0,1680,221,1459,263687,7299,256388,158029505.0,4356379.0,153673126.0,0.5978,0.5994,0.5968,0.5994
2023-04-25 17:40,1319,328,991,188599,12495,176104,113068705.0,7450838.0,105617866.0,1312,326,986,187886,12559,175327,112647634.0,7491825.0,105155809.0,0.5963,0.5997,0.5965,0.5998
2023-04-25 17:45,2046,498,1548,287702,19629,268073,172414231.0,11709732.0,160704499.0,2049,496,1553,287921,19782,268139,172545786.0,11800382.0,160745404.0,0.5966,0.5995,0.5965,0.5995
2023-04-25 17:50,908,481,427,72354,24450,47904,43276591.0,14580887.0,28695704.0,896,472,424,72284,24427,47857,43242818.0,14564683.0,28678135.0,0.5964,0.599,0.5963,0.5992
2023-04-25 17:55,775,269,506,98933,15682,83251,59288452.0,9357801.0,49930650.0,772,266,506,98967,15552,83415,59307740.0,9280844.0,50026896.0,0.5967,0.5998,0.5968,0.5997
2023-04-25 18:00,276,125,151,23841,7673,16168,14264902.0,4579498.0,9685404.0,273,124,149,24621,8435,16186,14715815.0,5019658.0,9696156.0,0.5968,0.599,0.5951,0.599
2023-04-25 18:05,1034,176,858,168401,7675,160726,100987418.0,4580535.0,96406882.0,1031,175,856,168345,7717,160628,100953840.0,4605615.0,96348224.0,0.5968,0.5998,0.5968,0.5998
2023-04-25 18:10,609,104,505,95452,4280,91172,57257162.0,2554250.0,54702912.0,604,101,503,95436,4228,91208,57255863.0,2523307.0,54732555.0,0.5968,0.6,0.5968,0.6001
2023-04-25 18:15,2297,599,1698,301713,24199,277514,180982744.0,14437516.0,166545227.0,2284,587,1697,301274,24050,277224,180719132.0,14347529.0,166371602.0,0.5966,0.6001,0.5966,0.6001
2023-04-25 18:20,1811,111,1700,294453,3522,290931,176603589.0,2104921.0,174498668.0,1802,106,1696,294193,3281,290912,176446898.0,1957790.0,174489108.0,0.5976,0.5998,0.5967,0.5998
2023-04-25 18:25,1633,170,1463,287462,3063,284399,172344381.0,1827234.0,170517146.0,1617,157,1460,286599,2087,284512,171828936.0,1246371.0,170582565.0,0.5966,0.5996,0.5972,0.5996
2023-04-25 18:30,142,56,86,12285,1904,10381,7347466.0,1134835.0,6212631.0,156,66,90,12772,2441,10331,7651408.0,1454196.0,6197212.0,0.596,0.5985,0.5957,0.5999
2023-04-25 18:35,2558,375,2183,468830,2704,466126,281203897.0,1613903.0,279589994.0,2552,369,2183,469545,3195,466350,281637595.0,1900308.0,279737286.0,0.5969,0.5998,0.5948,0.5998
2023-04-26 10:00,6017,1479,4538,811540,131727,679813,645801172.0,237425010.0,408376162.0,5708,1328,4380,799327,126454,672873,623987798.0,219948881.0,404038916.0,1.8024,0.6007,1.7394,0.6005
2023-04-26 10:05,3094,318,2776,323756,19553,304203,242550640.0,59909900.0,182640740.0,3018,280,2738,323503,18954,304549,232772307.0,49906028.0,182866278.0,3.064,0.6004,2.633,0.6004
2023-04-26 10:10,2389,315,2074,293930,17590,276340,176282498.0,10467812.0,165814686.0,2278,242,2036,291002,16531,274471,174469034.0,9865793.0,164603241.0,0.5951,0.6,0.5968,0.5997
2023-04-26 10:15,768,47,721,85448,2781,82667,75353245.0,25773797.0,49579447.0,745,35,710,84925,2362,82563,75028570.0,25520420.0,49508150.0,9.2678,0.5997,10.8046,0.5996
2023-04-26 10:20,583,129,454,48708,7137,41571,53366039.0,28399429.0,24966610.0,534,107,427,49959,6313,43646,54148711.0,27883883.0,26264827.0,3.9792,0.6006,4.4169,0.6018
2023-04-26 10:25,483,299,184,28658,15007,13651,17204376.0,8998750.0,8205625.0,449,290,159,27379,14631,12748,16433186.0,8763589.0,7669597.0,0.5996,0.6011,0.599,0.6016
2023-04-26 10:30,178,25,153,11262,597,10665,6765794.0,357193.0,6408601.0,156,13,143,10538,528,10010,6324536.0,316199.0,6008337.0,0.5983,0.6009,0.5989,0.6002
2023-04-26 10:35,187,116,71,13281,6770,6511,7920770.0,4002502.0,3918267.0,129,74,55,9788,3761,6027,5882020.0,2250933.0,3631086.0,0.5912,0.6018,0.5985,0.6025
2023-04-26 10:40,827,536,291,52880,32451,20429,31787007.0,19496305.0,12290702.0,782,512,270,51727,31587,20140,31055806.0,18931496.0,12124310.0,0.6008,0.6016,0.5993,0.602
2023-04-26 10:45,314,183,131,18313,10971,7342,35731266.0,31300319.0,4430946.0,254,148,106,17589,10735,6854,34670971.0,30540787.0,4130184.0,2.853,0.6035,2.845,0.6026
2023-04-26 10:50,489,228,261,33709,16799,16910,20252119.0,10082174.0,10169945.0,469,220,249,32910,16317,16593,19770632.0,9793877.0,9976755.0,0.6002,0.6014,0.6002,0.6013
2023-04-26 10:55,265,99,166,21876,4779,17097,13148989.0,2868614.0,10280375.0,265,105,160,21225,4634,16591,12763932.0,2779023.0,9984908.0,0.6003,0.6013,0.5997,0.6018
2023-04-26 11:00,440,161,279,30937,8781,22156,18601905.0,5270908.0,13330997.0,382,127,255,28941,7571,21370,17403327.0,4541082.0,12862244.0,0.6003,0.6017,0.5998,0.6019
2023-04-26 11:05,227,34,193,20958,2129,18829,12599362.0,1271815.0,11327546.0,202,20,182,19297,886,18411,11606682.0,528982.0,11077700.0,0.5974,0.6016,0.597,0.6017
2023-04-26 11:10,301,68,233,22892,3729,19163,13755042.0,2233914.0,11521128.0,287,59,228,22689,3635,19054,13632051.0,2178106.0,11453944.0,0.5991,0.6012,0.5992,0.6011
2023-04-26 11:15,104,55,49,5187,889,4298,3121294.0,535301.0,2585992.0,80,35,45,6228,1980,4248,3721437.0,1166170.0,2555267.0,0.6021,0.6017,0.589,0.6015
2023-04-26 11:20,112,73,39,4571,2681,1890,2729859.0,1604347.0,1125512.0,93,62,31,4373,2678,1695,2618050.0,1599177.0,1018873.0,0.5984,0.5955,0.5972,0.6011
2023-04-26 11:25,1329,989,340,99821,65205,34616,85105202.0,64154798.0,20950403.0,1272,963,309,95089,61734,33355,81978707.0,61791176.0,20187531.0,0.9839,0.6052,1.0009,0.6052
2023-04-26 11:30,2468,2149,319,297200,272774,24426,203994783.0,189217558.0,14777225.0,2337,2094,243,290010,267772,22238,199600028.0,186136129.0,13463899.0,0.6937,0.605,0.6951,0.6054
2023-04-26 11:35,1418,712,706,161010,106430,54580,121987905.0,88840233.0,33147672.0,1361,691,670,155517,105865,49652,118569821.0,88494668.0,30075153.0,0.8347,0.6073,0.8359,0.6057
2023-04-26 11:40,1494,276,1218,193001,38257,154744,116604099.0,23028679.0,93575420.0,1450,251,1199,192578,37800,154778,116355861.0,22751983.0,93603877.0,0.6019,0.6047,0.6019,0.6048
2023-04-26 11:45,1134,353,781,117924,33359,84565,71234425.0,20089770.0,51144655.0,1105,340,765,116184,33041,83143,70157745.0,19897324.0,50260420.0,0.6022,0.6048,0.6022,0.6045
2023-04-26 11:50,519,250,269,36440,14625,21815,22034319.0,8841866.0,13192452.0,484,234,250,35712,13925,21787,21591694.0,8392360.0,13199333.0,0.6046,0.6047,0.6027,0.6058
2023-04-26 11:55,750,397,353,56458,19381,37077,34208567.0,11694339.0,22514228.0,719,389,330,55754,19115,36639,33771309.0,11520054.0,22251254.0,0.6034,0.6072,0.6027,0.6073
2023-04-26 12:00,150,108,42,7198,6169,1029,4346614.0,3722561.0,624053.0,154,125,29,6871,5725,1146,4142895.0,3446131.0,696764.0,0.6034,0.6065,0.6019,0.608
2023-04-26 12:05,270,199,71,24404,21861,2543,14709709.0,13181284.0,1528425.0,247,194,53,23581,21452,2129,14211568.0,12924441.0,1287126.0,0.603,0.601,0.6025,0.6046
2023-04-26 12:10,304,70,234,17014,6062,10952,10260331.0,3652115.0,6608216.0,286,61,225,16474,6200,10274,9942414.0,3733777.0,6208636.0,0.6025,0.6034,0.6022,0.6043
2023-04-26 12:15,259,131,128,18163,9547,8616,10948550.0,5750856.0,5197693.0,242,124,118,17760,9506,8254,10709872.0,5725679.0,4984192.0,0.6024,0.6033,0.6023,0.6039
2023-04-26 12:20,326,146,180,35296,11303,23993,21277962.0,6803560.0,14474402.0,306,130,176,34570,10736,23834,20859147.0,6461651.0,14397496.0,0.6019,0.6033,0.6019,0.6041
2023-04-26 12:25,684,180,504,87794,13594,74200,53022299.0,8186175.0,44836123.0,673,172,501,87197,13299,73898,52658691.0,8006915.0,44651776.0,0.6022,0.6043,0.6021,0.6042
2023-04-26 12:30,745,712,33,51278,50393,885,30914334.0,30379800.0,534533.0,718,698,20,50467,49940,527,30423639.0,30105055.0,318583.0,0.6029,0.604,0.6028,0.6045
2023-04-26 12:35,237,223,14,16267,15831,436,11498749.0,11231905.0,266843.0,225,218,7,16224,15757,467,9785522.0,9501494.0,284028.0,0.7095,0.612,0.603,0.6082
2023-04-26 12:40,1551,298,1253,196426,34843,161583,143883143.0,46279877.0,97603265.0,1520,290,1230,194133,34015,160118,141943558.0,45180991.0,96762566.0,1.3282,0.604,1.3283,0.6043
2023-04-26 12:45,2092,518,1574,285591,66372,219219,172283995.0,39902648.0,132381347.0,2079,516,1563,285387,66318,219069,172158939.0,39869272.0,132289667.0,0.6012,0.6039,0.6012,0.6039
2023-04-26 12:50,1760,268,1492,242404,37647,204757,146193427.0,22625546.0,123567881.0,1757,265,1492,242411,37777,204634,146204524.0,22704443.0,123500081.0,0.601,0.6035,0.601,0.6035
2023-04-26 12:55,2737,449,2288,372362,47484,324878,224560214.0,28517477.0,196042736.0,2722,441,2281,370570,47192,323378,223480871.0,28342101.0,195138769.0,0.6006,0.6034,0.6006,0.6034
2023-04-26 13:00,47,24,23,3111,1805,1306,1917371.0,1132016.0,785354.0,33,15,18,2931,1288,1643,1765606.0,772860.0,992746.0,0.6272,0.6013,0.6,0.6042
2023-04-26 13:05,354,43,311,29599,3366,26233,17827484.0,2020395.0,15807088.0,328,36,292,28206,3334,24872,16997755.0,2002005.0,14995749.0,0.6002,0.6026,0.6005,0.6029
2023-04-26 13:10,81,33,48,5831,2699,3132,3509891.0,1623726.0,1886165.0,73,32,41,4829,2499,2330,2904698.0,1500303.0,1404395.0,0.6016,0.6022,0.6004,0.6027
2023-04-26 13:15,619,234,385,58779,20080,38699,60713328.0,37381378.0,23331949.0,559,190,369,52946,15223,37723,57195328.0,34449059.0,22746268.0,1.8616,0.6029,2.263,0.603
2023-04-26 13:20,853,567,286,61599,36554,25045,62416035.0,47303229.0,15112805.0,797,537,260,62239,38778,23461,62794610.0,48633110.0,14161499.0,1.2941,0.6034,1.2541,0.6036
2023-04-26 13:25,1326,480,846,161468,32693,128775,122579206.0,44933070.0,77646136.0,1276,444,832,158740,32159,126581,120954779.0,44607756.0,76347022.0,1.3744,0.603,1.3871,0.6031
2023-04-26 13:30,1294,480,814,187411,50657,136754,138263454.0,55755045.0,82508408.0,1256,465,791,183994,49775,134219,136166096.0,55204934.0,80961162.0,1.1006,0.6033,1.1091,0.6032
2023-04-26 13:35,1666,1241,425,202897,160262,42635,172494842.0,146898011.0,25596831.0,1624,1218,406,200496,158666,41830,171111365.0,145905958.0,25205406.0,0.9166,0.6004,0.9196,0.6026
2023-04-26 13:40,2473,1972,501,329250,286364,42886,273703417.0,247863599.0,25839817.0,2424,1963,461,328571,285890,42681,273298235.0,247570900.0,25727335.0,0.8656,0.6025,0.866,0.6028
2023-04-26 13:45,1845,1683,162,241867,231822,10045,246537932.0,240470074.0,6067858.0,1784,1683,101,242026,232032,9994,246629624.0,240596064.0,6033559.0,1.0373,0.6041,1.0369,0.6037
2023-04-26 13:50,1773,646,1127,192314,83414,108900,115675055.0,50088482.0,65586572.0,1765,645,1120,192270,83468,108802,115647992.0,50120365.0,65527627.0,0.6005,0.6023,0.6005,0.6023
2023-04-26 13:55,1232,330,902,116491,41167,75324,70103021.0,24718103.0,45384918.0,1210,320,890,115966,41060,74906,69775801.0,24651689.0,45124112.0,0.6004,0.6025,0.6004,0.6024
2023-04-26 14:00,1356,1002,354,144649,112799,31850,86977108.0,67765149.0,19211958.0,1339,992,347,144237,112445,31792,86728649.0,67540358.0,19188291.0,0.6008,0.6032,0.6007,0.6036
2023-04-26 14:05,793,122,671,70102,11460,58642,42223921.0,6878901.0,35345020.0,784,117,667,70238,11761,58477,42303499.0,7057244.0,35246254.0,0.6003,0.6027,0.6001,0.6027
2023-04-26 14:10,502,110,392,43880,9970,33910,26423910.0,5986268.0,20437641.0,490,105,385,43751,9911,33840,26344790.0,5950509.0,20394281.0,0.6004,0.6027,0.6004,0.6027
2023-04-26 14:15,84,27,57,3367,1318,2049,2021259.0,794693.0,1226565.0,71,19,52,3346,1267,2079,2015760.0,759065.0,1256694.0,0.603,0.5986,0.5991,0.6045
2023-04-26 14:20,563,496,67,44839,41415,3424,26938300.0,24876037.0,2062263.0,556,491,65,44231,40806,3425,26574285.0,24510948.0,2063336.0,0.6007,0.6023,0.6007,0.6024
2023-04-26 14:25,715,617,98,46390,42325,4065,27859570.0,25420041.0,2439529.0,697,610,87,47290,42166,5124,28506399.0,25322132.0,3184267.0,0.6006,0.6001,0.6005,0.6214
2023-04-26 14:30,280,255,25,19066,17770,1296,11455456.0,10671670.0,783785.0,264,246,18,19140,17893,1247,11499967.0,10745770.0,754196.0,0.6005,0.6048,0.6006,0.6048
2023-04-26 14:35,79,48,31,4429,2872,1557,2666785.0,1724217.0,942567.0,70,43,27,4153,2684,1469,2500842.0,1611287.0,889554.0,0.6004,0.6054,0.6003,0.6056
2023-04-26 14:40,21,12,9,984,728,256,587971.0,435500.0,152471.0,17,10,7,746,423,323,448428.0,252538.0,195890.0,0.5982,0.5956,0.597,0.6065
2023-04-26 14:45,33,18,15,3659,3302,357,2196540.0,1981312.0,215228.0,33,22,11,1246,933,313,746756.0,558366.0,188389.0,0.6,0.6029,0.5985,0.6019
2023-04-26 14:50,57,33,24,3002,2127,875,1793438.0,1276362.0,517076.0,44,27,17,2613,1951,662,1571929.0,1170474.0,401454.0,0.6001,0.5909,0.5999,0.6064
2023-04-26 14:55,59,26,33,4710,3041,1669,2817974.0,1822487.0,995487.0,49,25,24,4265,2928,1337,2560575.0,1755054.0,805521.0,0.5993,0.5965,0.5994,0.6025
2023-04-26 15:00,47,19,28,2910,1559,1351,1753461.0,935174.0,818287.0,33,12,21,2552,1422,1130,1532453.0,852615.0,679838.0,0.5999,0.6057,0.5996,0.6016
2023-04-26 15:05,497,347,150,22198,12284,9914,13341588.0,7374613.0,5966975.0,496,345,151,24424,12261,12163,14701113.0,7360489.0,7340624.0,0.6003,0.6019,0.6003,0.6035
2023-04-26 15:10,1463,893,570,177318,92063,85255,182857882.0,131447824.0,51410058.0,1432,878,554,172035,88872,83163,179512273.0,129323900.0,50188373.0,1.4278,0.603,1.4552,0.6035
2023-04-26 15:15,1837,1110,727,267628,171328,96300,161141135.0,103005071.0,58136064.0,1819,1101,718,265720,170830,94890,159920791.0,102671935.0,57248856.0,0.6012,0.6037,0.601,0.6033
2023-04-26 15:20,1387,899,488,197638,155856,41782,118931745.0,93728624.0,25203121.0,1374,899,475,196911,155671,41240,118464598.0,93591884.0,24872713.0,0.6014,0.6032,0.6012,0.6031
2023-04-26 15:25,1500,1307,193,261164,246638,14526,156946549.0,148186764.0,8759785.0,1487,1300,187,260921,246492,14429,156785370.0,148084136.0,8701233.0,0.6008,0.603,0.6008,0.603
2023-04-26 15:30,1358,1236,122,218247,212973,5274,131253106.0,128071939.0,3181167.0,1341,1236,105,216695,212149,4546,130277249.0,127533299.0,2743949.0,0.6014,0.6032,0.6011,0.6036
2023-04-26 15:35,980,443,537,97018,73058,23960,58390010.0,43927507.0,14462502.0,967,439,528,96833,72716,24117,58280065.0,43721695.0,14558370.0,0.6013,0.6036,0.6013,0.6037
2023-04-26 15:40,331,321,10,34662,34297,365,20856662.0,20636046.0,220616.0,324,317,7,33495,33330,165,20152266.0,20052534.0,99732.0,0.6017,0.6044,0.6016,0.6044
2023-04-26 15:45,1419,1323,96,229410,224836,4574,163423151.0,160650318.0,2772832.0,1392,1309,83,229632,223344,6288,163599422.0,159749763.0,3849659.0,0.7145,0.6062,0.7153,0.6122
2023-04-26 15:50,2614,2500,114,461442,456848,4594,277854513.0,275078778.0,2775735.0,2591,2489,102,460975,456683,4292,277574968.0,274978409.0,2596558.0,0.6021,0.6042,0.6021,0.605
2023-04-26 15:55,2023,1867,156,389101,376856,12245,259678039.0,252164084.0,7513955.0,1984,1850,134,383857,375335,8522,256400162.0,251246385.0,5153776.0,0.6691,0.6136,0.6694,0.6048
2023-04-26 16:00,680,329,351,75096,23802,51294,45379985.0,14359996.0,31019988.0,649,306,343,75489,23234,52255,45608703.0,13999697.0,31609006.0,0.6033,0.6047,0.6026,0.6049
2023-04-26 16:05,849,503,346,53819,26220,27599,57862531.0,41150778.0,16711753.0,826,495,331,53074,25917,27157,57388619.0,40944106.0,16444512.0,1.5694,0.6055,1.5798,0.6055
2023-04-26 16:10,51,28,23,5240,1705,3535,3195495.0,1026841.0,2168654.0,43,30,13,2898,2192,706,1747540.0,1319956.0,427584.0,0.6023,0.6135,0.6022,0.6056
2023-04-26 16:15,117,76,41,7955,4834,3121,4808782.0,2916502.0,1892280.0,122,82,40,7513,4108,3405,4542788.0,2476989.0,2065799.0,0.6033,0.6063,0.603,0.6067
2023-04-26 16:20,308,230,78,16467,8841,7626,9977837.0,5340378.0,4637459.0,275,210,65,15884,8764,7120,9615368.0,5284838.0,4330530.0,0.604,0.6081,0.603,0.6082
2023-04-26 16:25,576,566,10,20721,20639,82,12502165.0,12452565.0,49599.0,568,561,7,20623,20554,69,12441542.0,12399779.0,41763.0,0.6034,0.6049,0.6033,0.6053
2023-04-26 16:30,999,840,159,65370,55692,9678,90216416.0,84350701.0,5865715.0,881,761,120,61192,52744,8448,87597225.0,82461963.0,5135261.0,1.5146,0.6061,1.5634,0.6079
2023-04-26 16:35,735,536,199,46792,36071,10721,79160310.0,72640271.0,6520039.0,579,464,115,40288,31719,8569,75086182.0,69860568.0,5225613.0,2.0138,0.6082,2.2025,0.6098
2023-04-26 16:40,378,223,155,22331,14314,8017,13630099.0,8768292.0,4861806.0,238,168,70,17640,13086,4554,10699292.0,7918681.0,2780610.0,0.6126,0.6064,0.6051,0.6106
2023-04-26 16:45,3305,934,2371,409555,67329,342226,375499620.0,167377988.0,208121632.0,3213,889,2324,404858,65902,338956,372740672.0,166503594.0,206237077.0,2.486,0.6081,2.5265,0.6084
2023-04-26 16:50,1666,546,1120,191307,59154,132153,166838283.0,86424601.0,80413682.0,1639,533,1106,190190,58141,132049,166166734.0,85810726.0,80356008.0,1.461,0.6085,1.4759,0.6085
2023-04-26 16:55,882,191,691,50888,13435,37453,56262024.0,33464578.0,22797446.0,857,179,678,50303,13647,36656,55899678.0,33587043.0,22312635.0,2.4909,0.6087,2.4611,0.6087
2023-04-26 17:00,447,95,352,44060,11153,32907,52097180.0,32077934.0,20019246.0,412,83,329,42530,10618,31912,51173914.0,31748687.0,19425226.0,2.8762,0.6084,2.9901,0.6087
2023-04-26 17:05,586,47,539,67492,3672,63820,41073095.0,2238733.0,38834362.0,554,32,522,66429,3322,63107,40413587.0,2004964.0,38408622.0,0.6097,0.6085,0.6035,0.6086
2023-04-26 17:10,790,151,639,104896,13634,91262,63807730.0,8280993.0,55526737.0,739,125,614,102503,12531,89972,62355779.0,7587982.0,54767797.0,0.6074,0.6084,0.6055,0.6087
2023-04-26 17:15,110,51,59,7816,3870,3946,4731721.0,2345977.0,2385743.0,89,42,47,7152,3496,3656,4344181.0,2114589.0,2229592.0,0.6062,0.6046,0.6049,0.6098
2023-04-26 17:20,209,76,133,19270,4830,14440,11676257.0,2925311.0,8750946.0,185,63,122,18285,4432,13853,11111467.0,2681477.0,8429990.0,0.6057,0.606,0.605,0.6085
2023-04-26 17:25,266,141,125,20829,7015,13814,12615820.0,4247594.0,8368226.0,243,128,115,20301,6925,13376,12323601.0,4187519.0,8136082.0,0.6055,0.6058,0.6047,0.6083
2023-04-26 17:30,155,104,51,11672,6746,4926,7078781.0,4086718.0,2992063.0,133,90,43,10565,6358,4207,6403783.0,3846764.0,2557019.0,0.6058,0.6074,0.605,0.6078
2023-04-26 17:35,186,131,55,16579,9878,6701,35331437.0,31301831.0,4029606.0,159,116,43,14669,10577,4092,34187983.0,31700761.0,2487222.0,3.1688,0.6013,2.9971,0.6078
2023-04-26 17:40,557,390,167,46673,23775,22898,78874081.0,65006020.0,13868060.0,529,371,158,45585,23318,22267,78261118.0,64724340.0,13536778.0,2.7342,0.6056,2.7757,0.6079
2023-04-26 17:45,96,45,51,7425,2233,5192,4499808.0,1349119.0,3150688.0,77,32,45,6865,1676,5189,4161017.0,1011728.0,3149288.0,0.6042,0.6068,0.6037,0.6069
2023-04-26 17:50,256,115,141,20396,4567,15829,12369704.0,2772147.0,9597557.0,228,98,130,19797,4233,15564,12006412.0,2558912.0,9447500.0,0.607,0.6063,0.6045,0.607
2023-04-26 17:55,306,243,63,15794,8876,6918,9566703.0,5368977.0,4197726.0,284,228,56,15159,8615,6544,9179012.0,5207439.0,3971572.0,0.6049,0.6068,0.6045,0.6069
2023-04-26 18:00,134,91,43,8453,3760,4693,5093039.0,2272996.0,2820043.0,123,86,37,8860,4595,4265,5343320.0,2753035.0,2590285.0,0.6045,0.6009,0.5991,0.6073
2023-04-26 18:05,262,150,112,18688,10713,7975,11305453.0,6473969.0,4831483.0,246,138,108,17268,9524,7744,10445193.0,5754270.0,4690922.0,0.6043,0.6058,0.6042,0.6057
2023-04-26 18:10,120,66,54,6884,2551,4333,4170318.0,1542753.0,2627565.0,113,57,56,6753,2130,4623,4090860.0,1286930.0,2803930.0,0.6048,0.6064,0.6042,0.6065
2023-04-26 18:15,1423,593,830,183853,41044,142809,137045054.0,50177410.0,86867643.0,1382,572,810,181642,39388,142254,135705797.0,49159004.0,86546792.0,1.2225,0.6083,1.2481,0.6084
2023-04-26 18:20,2836,633,2203,455019,46857,408162,326696475.0,78944025.0,247752449.0,2808,619,2189,451969,46215,405754,324912516.0,78566505.0,246346011.0,1.6848,0.607,1.7,0.6071
2023-04-26 18:25,1679,628,1051,288927,38419,250508,200891257.0,48558890.0,152332367.0,1666,623,1043,289962,39277,250685,201520172.0,49068961.0,152451210.0,1.2639,0.6081,1.2493,0.6081
2023-04-26 18:30,607,196,411,57790,4486,53304,35092308.0,2727490.0,32364818.0,595,187,408,57122,4065,53057,34673285.0,2458004.0,32215281.0,0.608,0.6072,0.6047,0.6072
2023-04-26 18:35,361,66,295,63048,3553,59495,38352181.0,2150763.0,36201417.0,350,56,294,64657,2835,61822,39348719.0,1714414.0,37634305.0,0.6053,0.6085,0.6047,0.6088
2023-04-27 10:00,1364,780,584,100675,45118,55557,96043629.0,62001958.0,34041670.0,1036,637,399,89081,40022,49059,73466926.0,43547245.0,29919681.0,1.3742,0.6127,1.0881,0.6099
2023-04-27 10:05,999,428,571,85434,30461,54973,90681417.0,57034459.0,33646958.0,878,354,524,78996,29063,49933,82783700.0,52337952.0,30445748.0,1.8724,0.6121,1.8008,0.6097
2023-04-27 10:10,2643,754,1889,308830,41310,267520,263712515.0,100981097.0,162731417.0,2488,656,1832,304937,39284,265653,255393868.0,93720219.0,161673648.0,2.4445,0.6083,2.3857,0.6086
2023-04-27 10:15,2674,537,2137,395093,28946,366147,265522566.0,42852838.0,222669728.0,2602,499,2103,394087,27911,366176,264905031.0,42218250.0,222686780.0,1.4804,0.6081,1.5126,0.6081
2023-04-27 10:20,594,339,255,37977,16227,21750,48375540.0,35145531.0,13230009.0,548,319,229,36545,15920,20625,47514052.0,34958987.0,12555065.0,2.1659,0.6083,2.1959,0.6087
2023-04-27 10:25,653,228,425,35105,11627,23478,21288057.0,7036406.0,14251651.0,604,196,408,34140,11187,22953,20714990.0,6769286.0,13945704.0,0.6052,0.607,0.6051,0.6076
2023-04-27 10:30,463,281,182,37407,18226,19181,73337187.0,61669299.0,11667888.0,401,250,151,32697,15702,16995,70484376.0,60136810.0,10347565.0,3.3836,0.6083,3.8299,0.6089
2023-04-27 10:35,3009,850,2159,375020,67791,307229,353648169.0,167474545.0,186173624.0,2909,783,2126,371023,66515,304508,351258153.0,166680671.0,184577481.0,2.4705,0.606,2.5059,0.6061
2023-04-27 10:40,1424,274,1150,169684,12556,157128,102665756.0,7577748.0,95088007.0,1353,233,1120,165384,10661,154723,100075992.0,6421152.0,93654840.0,0.6035,0.6052,0.6023,0.6053
2023-04-27 10:45,3440,1413,2027,350347,52985,297362,237244836.0,57181412.0,180063424.0,3416,1400,2016,348799,51614,297185,236390591.0,56428316.0,179962275.0,1.0792,0.6055,1.0933,0.6056
2023-04-27 10:50,3248,884,2364,390922,40369,350553,261840476.0,49653406.0,212187070.0,3247,886,2361,390042,39749,350293,261296934.0,49267511.0,212029422.0,1.23,0.6053,1.2395,0.6053
2023-04-27 10:55,3680,2073,1607,411245,115392,295853,375404229.0,196140245.0,179263983.0,3629,2044,1585,409927,114734,295193,374605177.0,195727418.0,178877758.0,1.6998,0.6059,1.7059,0.606
2023-04-27 11:00,2779,2517,262,227292,186820,40472,390517606.0,365981513.0,24536093.0,2747,2501,246,225250,185579,39671,389286209.0,365227527.0,24058682.0,1.959,0.6062,1.968,0.6065
2023-04-27 11:05,2247,1557,690,243730,136927,106803,223565774.0,158665553.0,64900221.0,2212,1549,663,240210,135932,104278,221435469.0,158064073.0,63371395.0,1.1588,0.6077,1.1628,0.6077
2023-04-27 11:10,1842,955,887,205706,79490,126216,124505677.0,47944207.0,76561469.0,1819,939,880,205203,78967,126236,124198398.0,47624413.0,76573984.0,0.6031,0.6066,0.6031,0.6066
2023-04-27 11:15,3233,2666,567,247460,187767,59693,149574785.0,113383925.0,36190860.0,3214,2658,556,246419,187049,59370,148956649.0,112951694.0,36004955.0,0.6039,0.6063,0.6039,0.6065
2023-04-27 11:20,2537,2221,316,193494,150899,42595,142330029.0,116486478.0,25843551.0,2514,2206,308,192950,150475,42475,141960863.0,116191493.0,25769370.0,0.7719,0.6067,0.7722,0.6067
2023-04-27 11:25,1775,1062,713,133187,72754,60433,80673407.0,43999031.0,36674376.0,1748,1054,694,131901,72252,59649,79884865.0,43688021.0,36196844.0,0.6048,0.6069,0.6047,0.6068
2023-04-27 11:30,210,156,54,10887,9007,1880,6593581.0,5447846.0,1145734.0,195,153,42,10985,8977,2008,6652851.0,5430474.0,1222377.0,0.6048,0.6094,0.6049,0.6088
2023-04-27 11:35,112,71,41,6546,5113,1433,3958506.0,3091384.0,867122.0,98,66,32,6390,5035,1355,3866780.0,3044145.0,822635.0,0.6046,0.6051,0.6046,0.6071
2023-04-27 11:40,311,182,129,24319,13601,10718,14651929.0,8224443.0,6427485.0,274,162,112,22310,12913,9397,13520091.0,7802269.0,5717822.0,0.6047,0.5997,0.6042,0.6085
2023-04-27 11:45,137,85,52,7309,5274,2035,4414047.0,3186557.0,1227490.0,119,78,41,6945,5017,1928,4200765.0,3031201.0,1169564.0,0.6042,0.6032,0.6042,0.6066
2023-04-27 11:50,738,396,342,67237,30892,36345,40768216.0,18684218.0,22083997.0,714,384,330,66830,30463,36367,40533593.0,18423306.0,22110287.0,0.6048,0.6076,0.6048,0.608
2023-04-27 11:55,421,292,129,26838,15375,11463,16258453.0,9296898.0,6961555.0,402,283,119,26864,15686,11178,16242142.0,9450711.0,6791431.0,0.6047,0.6073,0.6025,0.6076
2023-04-27 12:00,857,329,528,60611,16502,44109,37073862.0,9981150.0,27092712.0,839,322,517,46857,16459,30398,28409733.0,9946719.0,18463013.0,0.6048,0.6142,0.6043,0.6074
2023-04-27 12:05,1182,322,860,100803,14751,86052,86346247.0,34221914.0,52124333.0,1153,308,845,97764,14345,83419,84507297.0,33981026.0,50526270.0,2.32,0.6057,2.3688,0.6057
2023-04-27 12:10,1326,59,1267,142800,3007,139793,86457508.0,1814410.0,84643097.0,1313,51,1262,141772,2183,139589,85833998.0,1312697.0,84521301.0,0.6034,0.6055,0.6013,0.6055
2023-04-27 12:15,1994,223,1771,233846,11115,222731,166833285.0,32011668.0,134821617.0,1975,217,1758,232558,11071,221487,166097420.0,31982504.0,134114915.0,2.88,0.6053,2.8889,0.6055
2023-04-27 12:20,2696,357,2339,377345,18704,358641,303794358.0,87190443.0,216603914.0,2601,299,2302,372493,17302,355191,300869286.0,86328311.0,214540975.0,4.6616,0.604,4.9895,0.604
2023-04-27 12:25,4502,2372,2130,448952,150041,298911,270923797.0,90176182.0,180747614.0,4479,2355,2124,448538,148966,299572,270667038.0,89521697.0,181145340.0,0.601,0.6047,0.601,0.6047
2023-04-27 12:30,2650,1365,1285,255085,82654,172431,229525897.0,125591242.0,103934655.0,2595,1338,1257,246737,79203,167534,224544217.0,123529313.0,101014903.0,1.5195,0.6028,1.5597,0.603
2023-04-27 12:35,2003,230,1773,252453,7862,244591,253013942.0,105974445.0,147039497.0,1895,157,1738,249033,6085,242948,251018031.0,104893703.0,146124328.0,13.4793,0.6012,17.2381,0.6015
2023-04-27 12:40,1674,178,1496,207745,9577,198168,150307830.0,31057063.0,119250766.0,1603,133,1470,205089,8118,196971,148745920.0,30175074.0,118570845.0,3.2429,0.6018,3.7171,0.602
2023-04-27 12:45,2190,135,2055,325962,5404,320558,271978194.0,79172961.0,192805233.0,2126,89,2037,323938,4691,319247,270828305.0,78743982.0,192084322.0,14.6508,0.6015,16.7862,0.6017
2023-04-27 12:50,1601,173,1428,232210,5903,226307,190056910.0,54165551.0,135891359.0,1512,106,1406,241898,3858,238040,196356642.0,52928226.0,143428416.0,9.1759,0.6005,13.7191,0.6025
2023-04-27 12:55,2060,95,1965,333153,3670,329483,200277903.0,2194239.0,198083663.0,2042,79,1963,333379,3637,329742,200416008.0,2171218.0,198244789.0,0.5979,0.6012,0.597,0.6012
2023-04-27 13:00,1014,136,878,142245,4784,137461,110806272.0,28184234.0,82622038.0,994,130,864,141916,5088,136828,110593906.0,28347435.0,82246471.0,5.8914,0.6011,5.5714,0.6011
2023-04-27 13:05,926,107,819,88611,6572,82039,53179868.0,3909309.0,49270559.0,901,93,808,86531,4810,81721,51960155.0,2875043.0,49085111.0,0.5948,0.6006,0.5977,0.6006
2023-04-27 13:10,976,521,455,102971,27056,75915,61868445.0,16189840.0,45678604.0,942,494,448,101263,25633,75630,60822461.0,15323819.0,45498642.0,0.5984,0.6017,0.5978,0.6016
2023-04-27 13:15,1408,434,974,124039,21804,102235,99570978.0,38351121.0,61219857.0,1313,408,905,122337,22357,99980,98549737.0,38667933.0,59881804.0,1.7589,0.5988,1.7296,0.5989
2023-04-27 13:20,780,115,665,94579,7493,87086,82142552.0,29799033.0,52343519.0,748,92,656,91099,4675,86424,80047800.0,28103818.0,51943981.0,3.9769,0.6011,6.0115,0.601
2023-04-27 13:25,717,149,568,83581,6961,76620,50078618.0,4166466.0,45912151.0,697,131,566,83779,7424,76355,50192378.0,4429552.0,45762826.0,0.5985,0.5992,0.5967,0.5993
2023-04-27 13:30,579,496,83,28870,20225,8645,17277563.0,12082469.0,5195094.0,550,478,72,28053,19968,8085,16797600.0,11929867.0,4867733.0,0.5974,0.6009,0.5974,0.6021
2023-04-27 13:35,916,512,404,81695,15855,65840,49046483.0,9479503.0,39566979.0,887,492,395,80937,15568,65369,48588951.0,9298655.0,39290295.0,0.5979,0.601,0.5973,0.6011
2023-04-27 13:40,419,87,332,25814,2918,22896,15458225.0,1744236.0,13713989.0,401,71,330,26253,2986,23267,15717158.0,1781722.0,13935436.0,0.5978,0.599,0.5967,0.5989
2023-04-27 13:45,720,292,428,111885,13964,97921,67276792.0,8346946.0,58929846.0,697,279,418,110799,13416,97383,66620368.0,8013962.0,58606406.0,0.5977,0.6018,0.5973,0.6018
2023-04-27 13:50,504,377,127,39163,18407,20756,23496037.0,10983892.0,12512145.0,489,369,120,37950,17806,20144,22766555.0,10637867.0,12128687.0,0.5967,0.6028,0.5974,0.6021
2023-04-27 13:55,521,106,415,34240,3324,30916,20482070.0,1983203.0,18498866.0,479,83,396,33136,3056,30080,19868253.0,1822703.0,18045549.0,0.5966,0.5984,0.5964,0.5999
2023-04-27 14:00,440,75,365,34690,2209,32481,20817840.0,1321892.0,19495948.0,424,65,359,34696,2148,32548,20825991.0,1282090.0,19543901.0,0.5984,0.6002,0.5969,0.6005
2023-04-27 14:05,1163,248,915,287328,11392,275936,172855006.0,6801829.0,166053176.0,1149,236,913,287082,11030,276052,172705651.0,6584350.0,166121301.0,0.5971,0.6018,0.5969,0.6018
2023-04-27 14:10,1519,298,1221,255528,15647,239881,153557996.0,9360057.0,144197938.0,1501,288,1213,255676,16440,239236,153622873.0,9812658.0,143810214.0,0.5982,0.6011,0.5969,0.6011
2023-04-27 14:15,1363,156,1207,224451,8910,215541,134862720.0,5325613.0,129537106.0,1345,142,1203,222532,7401,215131,133724507.0,4423854.0,129300653.0,0.5977,0.601,0.5977,0.601
2023-04-27 14:20,2727,85,2642,546316,4859,541457,328478540.0,2899954.0,325578586.0,2709,76,2633,544181,4305,539876,327191533.0,2569509.0,324622023.0,0.5968,0.6013,0.5969,0.6013
2023-04-27 14:25,3543,319,3224,680741,13900,666841,434727906.0,33650126.0,401077779.0,3523,307,3216,681234,14632,666602,434999816.0,34066612.0,400933204.0,2.4209,0.6015,2.3282,0.6015
2023-04-27 14:30,2696,328,2368,481158,17504,463654,289439782.0,10482610.0,278957172.0,2678,321,2357,480739,17234,463505,289190106.0,10309226.0,278880880.0,0.5989,0.6016,0.5982,0.6017
2023-04-27 14:35,3471,633,2838,652326,30192,622134,392672412.0,18076675.0,374595737.0,3451,618,2833,650713,29247,621466,391705484.0,17511586.0,374193897.0,0.5987,0.6021,0.5987,0.6021
2023-04-27 14:40,2748,777,1971,418414,36626,381788,251657807.0,21934547.0,229723260.0,2731,766,1965,418669,36452,382217,251816004.0,21825630.0,229990374.0,0.5989,0.6017,0.5987,0.6017
2023-04-27 14:45,1409,119,1290,240672,6792,233880,170283509.0,29397131.0,140886377.0,1390,107,1283,239626,6114,233512,169643255.0,28974144.0,140669110.0,4.3282,0.6024,4.739,0.6024
2023-04-27 14:50,1617,76,1541,310257,3137,307120,186942862.0,1877874.0,185064987.0,1612,73,1539,310611,3074,307537,187169344.0,1839283.0,185330061.0,0.5986,0.6026,0.5983,0.6026
2023-04-27 14:55,3783,504,3279,623723,27162,596561,400540322.0,41578909.0,358961412.0,3777,500,3277,623359,27035,596324,400315375.0,41495518.0,358819856.0,1.5308,0.6017,1.5349,0.6017
2023-04-27 15:00,4078,819,3259,601706,27761,573945,361611350.0,16612391.0,344998959.0,4049,798,3251,601435,27740,573695,361451117.0,16599312.0,344851805.0,0.5984,0.6011,0.5984,0.6011
2023-04-27 15:05,2700,295,2405,379194,12115,367079,227944341.0,7260931.0,220683410.0,2688,292,2396,379022,12134,366888,227834498.0,7266150.0,220568347.0,0.5993,0.6012,0.5988,0.6012
2023-04-27 15:10,2434,812,1622,250523,33815,216708,150500805.0,20239820.0,130260985.0,2430,809,1621,250556,33724,216832,150521084.0,20184873.0,130336210.0,0.5985,0.6011,0.5985,0.6011
2023-04-27 15:15,2044,57,1987,314960,1314,313646,189436554.0,787471.0,188649082.0,2034,52,1982,314641,1277,313364,189244228.0,764560.0,188479668.0,0.5993,0.6015,0.5987,0.6015
2023-04-27 15:20,1518,173,1345,231493,12773,218720,139208408.0,7646608.0,131561800.0,1512,170,1342,231412,12722,218690,139162214.0,7616024.0,131546189.0,0.5987,0.6015,0.5986,0.6015
2023-04-27 15:25,597,35,562,101856,2430,99426,61288564.0,1455517.0,59833046.0,594,34,560,103203,3728,99475,62092076.0,2228478.0,59863598.0,0.599,0.6018,0.5978,0.6018
2023-04-27 15:30,1514,536,978,224653,42003,182650,134935062.0,25141799.0,109793263.0,1505,532,973,224228,41942,182286,134680330.0,25104991.0,109575339.0,0.5986,0.6011,0.5986,0.6011
2023-04-27 15:35,1819,582,1237,252856,34598,218258,151876501.0,20706783.0,131169718.0,1813,580,1233,252808,34511,218297,151848480.0,20654865.0,131193614.0,0.5985,0.601,0.5985,0.601
2023-04-27 15:40,2387,240,2147,358084,6468,351616,215138650.0,3871225.0,211267424.0,2384,237,2147,357946,6624,351322,215054360.0,3962457.0,211091902.0,0.5985,0.6008,0.5982,0.6009
2023-04-27 15:45,1660,171,1489,285470,8542,276928,171560377.0,5111060.0,166449317.0,1655,167,1488,285959,8546,277413,171854923.0,5113119.0,166741803.0,0.5983,0.6011,0.5983,0.6011
2023-04-27 15:50,1694,149,1545,273401,8923,264478,164299341.0,5334558.0,158964783.0,1689,147,1542,273154,8796,264358,164153248.0,5260444.0,158892804.0,0.5978,0.6011,0.598,0.6011
2023-04-27 15:55,263,43,220,20919,2942,17977,12552628.0,1761136.0,10791491.0,254,36,218,20638,2866,17772,12382922.0,1713642.0,10669280.0,0.5986,0.6003,0.5979,0.6003
2023-04-27 16:00,1671,287,1384,196818,14690,182128,118243251.0,8810103.0,109433147.0,1662,281,1381,195885,14101,181784,117661968.0,8435944.0,109226024.0,0.5997,0.6009,0.5983,0.6009
2023-04-27 16:05,1100,45,1055,188859,1982,186877,113502381.0,1186512.0,112315868.0,1100,46,1054,189153,2109,187044,113677758.0,1261683.0,112416075.0,0.5986,0.601,0.5982,0.601
2023-04-27 16:10,465,191,274,40216,12738,27478,24133859.0,7627222.0,16506637.0,462,189,273,39948,12560,27388,23971391.0,7520415.0,16450976.0,0.5988,0.6007,0.5988,0.6007
2023-04-27 16:15,517,143,374,53636,10456,43180,32219508.0,6258476.0,25961031.0,502,136,366,53044,9983,43061,31869212.0,5973358.0,25895853.0,0.5986,0.6012,0.5984,0.6014
2023-04-27 16:20,104,27,77,7062,1059,6003,4248963.0,640088.0,3608875.0,95,25,70,6934,1105,5829,4163698.0,658998.0,3504699.0,0.6044,0.6012,0.5964,0.6013
2023-04-27 16:25,193,54,139,14338,2577,11761,8611616.0,1544259.0,7067357.0,185,46,139,14054,2550,11504,8437465.0,1524968.0,6912497.0,0.5992,0.6009,0.598,0.6009
2023-04-27 16:30,99,45,54,5678,1689,3989,3406751.0,1010600.0,2396150.0,97,45,52,5052,1627,3425,3030773.0,973255.0,2057517.0,0.5983,0.6007,0.5982,0.6007
2023-04-27 16:35,319,156,163,20293,12517,7776,12146935.0,7488785.0,4658149.0,310,152,158,20294,12545,7749,12148951.0,7505507.0,4643443.0,0.5983,0.599,0.5983,0.5992
2023-04-27 16:40,276,59,217,15840,1434,14406,9498535.0,859763.0,8638771.0,267,52,215,16054,1454,14600,9630470.0,869794.0,8760675.0,0.5996,0.5997,0.5982,0.6
2023-04-27 16:45,427,38,389,32422,2696,29726,19452872.0,1613311.0,17839561.0,424,31,393,34197,2420,31777,20561415.0,1447734.0,19113681.0,0.5984,0.6001,0.5982,0.6015
2023-04-27 16:50,145,20,125,9106,1909,7197,5477367.0,1143922.0,4333445.0,139,19,120,8446,2020,6426,5077430.0,1208122.0,3869308.0,0.5992,0.6021,0.5981,0.6021
2023-04-27 16:55,108,30,78,6705,2074,4631,4032941.0,1250518.0,2782423.0,96,24,72,6233,1849,4384,3739139.0,1105847.0,2633291.0,0.603,0.6008,0.5981,0.6007
2023-04-27 17:00,159,42,117,14429,5416,9013,8652605.0,3238984.0,5413621.0,158,42,116,14393,5448,8945,8631906.0,3258157.0,5373748.0,0.598,0.6006,0.598,0.6008
2023-04-27 17:05,296,19,277,21317,2902,18415,12771097.0,1733245.0,11037852.0,296,17,279,23038,2997,20041,13817486.0,1790069.0,12027416.0,0.5973,0.5994,0.5973,0.6001
2023-04-27 17:10,127,27,100,8223,1246,6977,4935376.0,745373.0,4190002.0,118,21,97,7730,1159,6571,4638714.0,693076.0,3945638.0,0.5982,0.6005,0.598,0.6005
2023-04-27 17:15,51,15,36,4566,1960,2606,2735839.0,1172783.0,1563055.0,41,12,29,4302,1704,2598,2579710.0,1019438.0,1560272.0,0.5984,0.5998,0.5983,0.6006
2023-04-27 17:20,28,9,19,2648,1081,1567,1587143.0,646718.0,940425.0,46,23,23,2853,1268,1585,1709476.0,758061.0,951415.0,0.5983,0.6001,0.5978,0.6003
2023-04-27 17:25,71,40,31,5354,989,4365,3206995.0,589005.0,2617990.0,37,14,23,4751,484,4267,2847200.0,288482.0,2558718.0,0.5956,0.5998,0.596,0.5997
2023-04-27 17:30,1579,331,1248,282624,55931,226693,371411795.0,235848353.0,135563442.0,1374,229,1145,260465,46620,213845,358359052.0,230295280.0,128063771.0,4.2168,0.598,4.9398,0.5989
2023-04-27 17:35,2298,184,2114,352870,30350,322520,236184705.0,43348287.0,192836418.0,2226,131,2095,350539,29598,320941,234774798.0,42858839.0,191915959.0,1.4283,0.5979,1.448,0.598
2023-04-27 17:40,1394,399,995,179983,38286,141697,133097764.0,48186057.0,84911706.0,1369,389,980,177365,36558,140807,131473544.0,47098724.0,84374819.0,1.2586,0.5992,1.2883,0.5992
2023-04-27 17:45,626,165,461,116317,17632,98685,69667837.0,10508660.0,59159176.0,598,156,442,117816,19802,98014,70548194.0,11790645.0,58757549.0,0.596,0.5995,0.5954,0.5995
2023-04-27 17:50,822,261,561,139389,30069,109320,83568582.0,17923559.0,65645022.0,829,268,561,138994,29692,109302,83354573.0,17697761.0,65656811.0,0.5961,0.6005,0.596,0.6007
2023-04-27 17:55,388,139,249,57021,17419,39602,34146090.0,10384884.0,23761206.0,386,139,247,57027,17499,39528,34146018.0,10431264.0,23714754.0,0.5962,0.6,0.5961,0.5999
2023-04-27 18:00,781,193,588,84929,19776,65153,50898964.0,11801985.0,39096978.0,741,165,576,82605,17619,64986,49502949.0,10501450.0,39001499.0,0.5968,0.6001,0.596,0.6002
2023-04-27 18:05,251,55,196,27841,3913,23928,16705610.0,2338392.0,14367218.0,245,51,194,28059,3837,24222,16836578.0,2292638.0,14543940.0,0.5976,0.6004,0.5975,0.6004
2023-04-27 18:10,713,371,342,50029,22577,27452,55285124.0,38806596.0,16478527.0,706,366,340,53209,25491,27718,57174779.0,40534633.0,16640145.0,1.7189,0.6003,1.5902,0.6003
2023-04-27 18:15,1969,371,1598,265630,37391,228239,159557095.0,22319310.0,137237785.0,1960,366,1594,265060,37292,227768,159211292.0,22259958.0,136951334.0,0.5969,0.6013,0.5969,0.6013
2023-04-27 18:20,2455,737,1718,360345,71684,288661,291953131.0,118708537.0,173244593.0,2432,723,1709,359510,71237,288273,291497679.0,118443259.0,173054419.0,1.656,0.6002,1.6627,0.6003
2023-04-27 18:25,760,254,506,76392,22762,53630,71051212.0,38891950.0,32159262.0,735,238,497,74769,22264,52505,70070518.0,38586966.0,31483552.0,1.7086,0.5997,1.7332,0.5996
2023-04-27 18:30,827,384,443,75745,23185,52560,45417530.0,13865811.0,31551719.0,827,385,442,75105,22721,52384,45031946.0,13585782.0,31446164.0,0.5981,0.6003,0.5979,0.6003
2023-04-27 18:35,226,89,137,21193,6923,14270,12667316.0,4139807.0,8527509.0,217,85,132,21685,7124,14561,13006663.0,4256321.0,8750342.0,0.598,0.5976,0.5975,0.6009
2023-04-28 10:00,1567,549,1018,109735,33452,76283,71492854.0,25555368.0,45937486.0,1227,390,837,100419,29045,71374,60100417.0,17324643.0,42775773.0,0.7639,0.6022,0.5965,0.5993
2023-04-28 10:05,843,247,596,49661,13542,36119,29712966.0,8071295.0,21641671.0,773,210,563,48904,13279,35625,29261023.0,7916625.0,21344398.0,0.596,0.5992,0.5962,0.5991
2023-04-28 10:10,675,205,470,44792,15483,29309,26716488.0,9215478.0,17501010.0,629,180,449,41859,13014,28845,25032482.0,7766602.0,17265880.0,0.5952,0.5971,0.5968,0.5986
2023-04-28 10:15,217,46,171,13095,1651,11444,7854553.0,977892.0,6876661.0,189,33,156,11729,1821,9908,7022789.0,1082951.0,5939838.0,0.5923,0.6009,0.5947,0.5995
2023-04-28 10:20,717,27,690,46581,272,46309,27889856.0,162195.0,27727660.0,673,15,658,46264,98,46166,27700014.0,58054.0,27641959.0,0.5963,0.5988,0.5924,0.5988
2023-04-28 10:25,274,120,154,18850,8276,10574,11245079.0,4929381.0,6315698.0,249,107,142,16403,7009,9394,9806495.0,4185404.0,5621090.0,0.5956,0.5973,0.5971,0.5984
2023-04-28 10:30,155,76,79,6631,1962,4669,3970459.0,1168898.0,2801560.0,74,25,49,5868,1448,4420,3511649.0,864785.0,2646863.0,0.5958,0.6,0.5972,0.5988
2023-04-28 10:35,48,29,19,1952,990,962,1170001.0,594345.0,575656.0,34,23,11,1827,947,880,1091967.0,565185.0,526781.0,0.6003,0.5984,0.5968,0.5986
2023-04-28 10:40,101,71,30,6287,3676,2611,3883844.0,2190998.0,1692845.0,80,54,26,5286,2801,2485,3233423.0,1671264.0,1562159.0,0.596,0.6484,0.5967,0.6286
2023-04-28 10:45,172,95,77,7830,3755,4075,4683653.0,2244073.0,2439580.0,156,86,70,8071,3673,4398,4826527.0,2193040.0,2633487.0,0.5976,0.5987,0.5971,0.5988
2023-04-28 10:50,204,125,79,10360,5447,4913,6177998.0,3242635.0,2935362.0,176,109,67,9645,4970,4675,5767385.0,2968336.0,2799049.0,0.5953,0.5975,0.5973,0.5987
2023-04-28 10:55,311,130,181,19457,7691,11766,11623787.0,4589141.0,7034645.0,289,120,169,18203,7534,10669,10880384.0,4495630.0,6384754.0,0.5967,0.5979,0.5967,0.5984
2023-04-28 11:00,1002,258,744,84542,17487,67055,50809694.0,10433760.0,40375934.0,983,251,732,82853,16126,66727,49799971.0,9624934.0,40175037.0,0.5967,0.6021,0.5969,0.6021
2023-04-28 11:05,533,238,295,41526,14648,26878,24868304.0,8742254.0,16126050.0,514,229,285,40934,14636,26298,24504372.0,8735419.0,15768953.0,0.5968,0.6,0.5968,0.5996
2023-04-28 11:10,262,16,246,19994,288,19706,11976098.0,170987.0,11805111.0,258,13,245,19802,202,19600,11859927.0,120406.0,11739520.0,0.5937,0.5991,0.5961,0.599
2023-04-28 11:15,1091,435,656,101613,27149,74464,60990903.0,16198653.0,44792250.0,1068,421,647,100729,26643,74086,60469056.0,15890176.0,44578880.0,0.5967,0.6015,0.5964,0.6017
2023-04-28 11:20,2041,623,1418,197436,35221,162215,118180938.0,20997997.0,97182941.0,2024,619,1405,197001,35318,161683,117915417.0,21055547.0,96859870.0,0.5962,0.5991,0.5962,0.5991
2023-04-28 11:25,125,69,56,7691,3811,3880,29904779.0,27582374.0,2322404.0,111,62,49,7556,3306,4250,10283375.0,7725065.0,2558309.0,7.2376,0.5986,2.3367,0.602
2023-04-28 11:30,138,50,88,7800,2152,5648,4699572.0,1283545.0,3416027.0,107,34,73,5832,1489,4343,3506526.0,886981.0,2619545.0,0.5964,0.6048,0.5957,0.6032
2023-04-28 11:35,118,41,77,6152,1518,4634,3691896.0,908032.0,2783863.0,103,33,70,5852,1467,4385,3507522.0,873759.0,2633763.0,0.5982,0.6007,0.5956,0.6006
2023-04-28 11:40,98,23,75,9452,1113,8339,5679589.0,663544.0,5016045.0,79,16,63,9352,1008,8344,5629434.0,600257.0,5029177.0,0.5962,0.6015,0.5955,0.6027
2023-04-28 11:45,95,30,65,5623,1151,4472,3362646.0,687239.0,2675407.0,79,24,55,5647,1124,4523,3376235.0,669544.0,2706691.0,0.5971,0.5983,0.5957,0.5984
2023-04-28 11:50,338,35,303,59838,3065,56773,35771855.0,1825849.0,33946006.0,327,28,299,59670,3051,56619,35673809.0,1817207.0,33856602.0,0.5957,0.5979,0.5956,0.598
2023-04-28 11:55,930,198,732,98058,13438,84620,58652731.0,8008231.0,50644500.0,911,189,722,97179,13206,83973,58117896.0,7868906.0,50248989.0,0.5959,0.5985,0.5959,0.5984
2023-04-28 12:00,385,148,237,22028,9135,12893,13148444.0,5434737.0,7713706.0,394,147,247,21618,8920,12698,12895648.0,5308951.0,7586696.0,0.5949,0.5983,0.5952,0.5975
2023-04-28 12:05,57,28,29,2825,1012,1813,1692525.0,602909.0,1089616.0,46,25,21,2069,1052,1017,1236564.0,626705.0,609858.0,0.5958,0.601,0.5957,0.5997
2023-04-28 12:10,47,21,26,3219,1580,1639,1920847.0,936867.0,983979.0,38,14,24,2409,756,1653,1436826.0,447748.0,989078.0,0.593,0.6004,0.5923,0.5984
2023-04-28 12:15,72,25,47,5613,1487,4126,3357629.0,886058.0,2471571.0,65,18,47,7060,1410,5650,4222527.0,840101.0,3382425.0,0.5959,0.599,0.5958,0.5987
2023-04-28 12:20,40,15,25,3104,513,2591,1854340.0,305574.0,1548766.0,36,14,22,2931,517,2414,1751020.0,307931.0,1443089.0,0.5957,0.5977,0.5956,0.5978
2023-04-28 12:25,34,15,19,1877,301,1576,1125703.0,179192.0,946510.0,24,7,17,1932,100,1832,1159757.0,59421.0,1100335.0,0.5953,0.6006,0.5942,0.6006
2023-04-28 12:30,408,47,361,42238,3555,38683,25293709.0,2118203.0,23175506.0,387,34,353,42987,3527,39460,25765077.0,2101660.0,23663417.0,0.5958,0.5991,0.5959,0.5997
2023-04-28 12:35,133,28,105,15621,1139,14482,9405988.0,691446.0,8714542.0,121,22,99,14967,962,14005,8998967.0,573342.0,8425625.0,0.6071,0.6017,0.596,0.6016
2023-04-28 12:40,340,50,290,50246,2492,47754,30112783.0,1483138.0,28629645.0,330,48,282,50074,2413,47661,30016892.0,1436118.0,28580774.0,0.5952,0.5995,0.5952,0.5997
2023-04-28 12:45,224,51,173,29818,1828,27990,17856681.0,1089761.0,16766919.0,217,45,172,29673,1679,27994,17768926.0,999934.0,16768992.0,0.5961,0.599,0.5956,0.599
2023-04-28 12:50,356,63,293,38582,3246,35336,23136797.0,1930871.0,21205926.0,342,57,285,38168,2962,35206,22891027.0,1763304.0,21127722.0,0.5948,0.6001,0.5953,0.6001
2023-04-28 12:55,488,110,378,52642,6548,46094,31547952.0,3899246.0,27648706.0,489,106,383,52558,6386,46172,31499886.0,3802601.0,27697284.0,0.5955,0.5998,0.5955,0.5999
2023-04-28 13:00,616,57,559,98946,6513,92433,59280214.0,3879192.0,55401022.0,602,52,550,97873,6491,91382,58651874.0,3866058.0,54785816.0,0.5956,0.5994,0.5956,0.5995
2023-04-28 13:05,1011,249,762,139478,20726,118752,83339130.0,12348143.0,70990987.0,1007,246,761,139369,20634,118735,83279905.0,12292490.0,70987415.0,0.5958,0.5978,0.5957,0.5979
2023-04-28 13:10,972,161,811,199917,19973,179944,119458193.0,11896226.0,107561966.0,959,154,805,199802,19895,179907,119388160.0,11849154.0,107539005.0,0.5956,0.5978,0.5956,0.5977
2023-04-28 13:15,1216,274,942,187277,28753,158524,111961749.0,17125593.0,94836156.0,1206,265,941,186946,28646,158300,111768759.0,17061722.0,94707036.0,0.5956,0.5982,0.5956,0.5983
2023-04-28 13:20,2014,389,1625,280010,38860,241150,167326817.0,23145344.0,144181472.0,2007,387,1620,279914,38778,241136,167270381.0,23096406.0,144173974.0,0.5956,0.5979,0.5956,0.5979
2023-04-28 13:25,812,160,652,104427,13411,91016,62411798.0,7997871.0,54413927.0,799,154,645,103828,13198,90630,62035645.0,7853734.0,54181911.0,0.5964,0.5979,0.5951,0.5978
2023-04-28 13:30,1537,481,1056,188804,58442,130362,112676418.0,34744909.0,77931509.0,1526,474,1052,187983,58372,129611,112197103.0,34701141.0,77495961.0,0.5945,0.5978,0.5945,0.5979
2023-04-28 13:35,1149,228,921,109294,21389,87905,65265897.0,12738128.0,52527769.0,1140,224,916,109226,21261,87965,65264812.0,12661964.0,52602847.0,0.5955,0.5976,0.5955,0.598
2023-04-28 13:40,1342,160,1182,109451,10410,99041,65350094.0,6197532.0,59152561.0,1326,154,1172,108752,10437,98315,64938074.0,6213138.0,58724936.0,0.5953,0.5973,0.5953,0.5973
2023-04-28 13:45,284,44,240,24635,2469,22166,14759795.0,1469388.0,13290407.0,268,32,236,24146,2204,21942,14459001.0,1310811.0,13148189.0,0.5951,0.5996,0.5947,0.5992
2023-04-28 13:50,283,23,260,20716,517,20199,12412775.0,307760.0,12105015.0,279,19,260,21832,1587,20245,13071706.0,937162.0,12134544.0,0.5953,0.5993,0.5905,0.5994
2023-04-28 13:55,483,36,447,33406,1415,31991,20063372.0,840739.0,19222633.0,471,25,446,33401,1195,32206,20066989.0,711348.0,19355640.0,0.5942,0.6009,0.5953,0.601
2023-04-28 14:00,1769,938,831,179494,88714,90780,107279178.0,52927242.0,54351936.0,1739,929,810,176733,87574,89159,105540691.0,52166447.0,53374244.0,0.5966,0.5987,0.5957,0.5986
2023-04-28 14:05,1347,156,1191,152721,10057,142664,91257472.0,5988054.0,85269418.0,1338,151,1187,152403,10023,142380,91094205.0,5969656.0,85124549.0,0.5954,0.5977,0.5956,0.5979
2023-04-28 14:10,2514,173,2341,257981,13718,244263,153968396.0,8143788.0,145824607.0,2508,168,2340,258306,13541,244765,154190249.0,8038908.0,146151341.0,0.5937,0.597,0.5937,0.5971
2023-04-28 14:15,1444,299,1145,140472,19642,120830,108998464.0,36966743.0,72031721.0,1387,275,1112,138286,19499,118787,107750045.0,36876857.0,70873188.0,1.882,0.5961,1.8912,0.5966
2023-04-28 14:20,3361,269,3092,484195,17421,466774,313493887.0,35632617.0,277861270.0,3280,216,3064,481376,16906,464470,311958693.0,35326042.0,276632650.0,2.0454,0.5953,2.0896,0.5956
2023-04-28 14:25,4067,594,3473,732742,33130,699612,486071687.0,70208888.0,415862798.0,3994,539,3455,730879,32344,698535,485076997.0,69739209.0,415337788.0,2.1192,0.5944,2.1562,0.5946
2023-04-28 14:30,1957,687,1270,251895,57269,194626,200040032.0,84489990.0,115550041.0,1914,659,1255,252016,57029,194987,200140824.0,84346380.0,115794443.0,1.4753,0.5937,1.479,0.5939
2023-04-28 14:35,467,163,304,42638,10346,32292,25320189.0,6125234.0,19194954.0,436,147,289,41255,9838,31417,24506166.0,5819125.0,18687040.0,0.592,0.5944,0.5915,0.5948
2023-04-28 14:40,557,271,286,42104,16975,25129,24926208.0,10029371.0,14896837.0,535,260,275,40911,16812,24099,24224605.0,9930253.0,14294352.0,0.5908,0.5928,0.5907,0.5932
2023-04-28 14:45,141,61,80,8612,3147,5465,5096915.0,1857611.0,3239304.0,112,39,73,7963,2563,5400,4721399.0,1512470.0,3208928.0,0.5903,0.5927,0.5901,0.5942
2023-04-28 14:50,148,35,113,8595,474,8121,5096162.0,281820.0,4814341.0,131,20,111,8555,252,8303,5071803.0,148811.0,4922992.0,0.5946,0.5928,0.5905,0.5929
2023-04-28 14:55,123,83,40,8566,5081,3485,5083578.0,3010441.0,2073136.0,104,75,29,8444,5216,3228,5002621.0,3083828.0,1918792.0,0.5925,0.5949,0.5912,0.5944
2023-04-28 15:00,789,98,691,90717,2581,88136,79155929.0,26840588.0,52315341.0,769,86,683,90355,2414,87941,78932706.0,26738936.0,52193770.0,10.3993,0.5936,11.0766,0.5935
2023-04-28 15:05,589,272,317,64096,13615,50481,38004562.0,8044899.0,29959662.0,579,262,317,63877,13238,50639,37883562.0,7826761.0,30056801.0,0.5909,0.5935,0.5912,0.5936
2023-04-28 15:10,59,15,44,5951,591,5360,3531411.0,346888.0,3184522.0,70,23,47,5318,660,4658,3154560.0,387438.0,2767121.0,0.587,0.5941,0.587,0.5941
2023-04-28 15:15,77,33,44,4685,763,3922,2781799.0,451095.0,2330704.0,57,18,39,4889,753,4136,2903313.0,445045.0,2458268.0,0.5912,0.5943,0.591,0.5944
2023-04-28 15:20,133,37,96,9649,1773,7876,5716731.0,1047488.0,4669243.0,117,24,93,9330,1655,7675,5532980.0,978488.0,4554492.0,0.5908,0.5928,0.5912,0.5934
2023-04-28 15:25,68,32,36,3948,1438,2510,2337690.0,846940.0,1490750.0,53,21,32,3935,1204,2731,2335323.0,711904.0,1623418.0,0.589,0.5939,0.5913,0.5944
2023-04-28 15:30,247,25,222,24285,603,23682,14423397.0,356430.0,14066966.0,226,15,211,23574,418,23156,13999508.0,246422.0,13753086.0,0.5911,0.594,0.5895,0.5939
2023-04-28 15:35,100,28,72,9215,1056,8159,5467312.0,630245.0,4837066.0,88,21,67,8326,632,7694,4947193.0,372980.0,4574212.0,0.5968,0.5929,0.5902,0.5945
2023-04-28 15:40,308,18,290,39643,792,38851,23720502.0,467687.0,23252815.0,293,14,279,39917,699,39218,23886387.0,412744.0,23473642.0,0.5905,0.5985,0.5905,0.5985
2023-04-28 15:45,113,28,85,9062,1223,7839,5397180.0,744431.0,4652749.0,97,18,79,8482,931,7551,5033375.0,550344.0,4483031.0,0.6087,0.5935,0.5911,0.5937
2023-04-28 15:50,93,24,69,9748,1286,8462,5766647.0,762044.0,5004603.0,82,16,66,9824,1354,8470,5834207.0,801104.0,5033103.0,0.5926,0.5914,0.5917,0.5942
2023-04-28 15:55,114,13,101,12430,354,12076,7391047.0,209079.0,7181968.0,107,9,98,11966,56,11910,7116418.0,33096.0,7083321.0,0.5906,0.5947,0.591,0.5947
2023-04-28 16:00,196,10,186,33820,124,33696,20072996.0,72715.0,20000281.0,187,6,181,33333,120,33213,19797937.0,70265.0,19727671.0,0.5864,0.5936,0.5855,0.594
2023-04-28 16:05,26,11,15,1446,311,1135,856898.0,183889.0,673009.0,15,3,12,938,138,800,555263.0,81313.0,473950.0,0.5913,0.593,0.5892,0.5924
2023-04-28 16:10,26,7,19,1185,164,1021,698657.0,98680.0,599977.0,17,2,15,1417,112,1305,841204.0,66232.0,774972.0,0.6017,0.5876,0.5914,0.5938
2023-04-28 16:15,296,9,287,27768,470,27298,16468624.0,277946.0,16190677.0,290,3,287,28149,500,27649,16685658.0,286830.0,16398828.0,0.5914,0.5931,0.5737,0.5931
2023-04-28 16:20,80,17,63,5555,603,4952,3292785.0,355451.0,2937334.0,72,11,61,5733,449,5284,3400539.0,265425.0,3135114.0,0.5895,0.5932,0.5911,0.5933
2023-04-28 16:25,67,15,52,5346,336,5010,3157912.0,198924.0,2958988.0,58,8,50,5009,244,4765,2972699.0,143386.0,2829313.0,0.592,0.5906,0.5877,0.5938
2023-04-28 16:30,130,12,118,13528,676,12852,8013315.0,384325.0,7628989.0,119,6,113,12487,323,12164,7397000.0,174809.0,7222191.0,0.5685,0.5936,0.5412,0.5937
2023-04-28 16:35,47,17,30,2493,616,1877,1476880.0,362985.0,1113895.0,32,7,25,1807,287,1520,1071843.0,169583.0,902259.0,0.5893,0.5934,0.5909,0.5936
2023-04-28 16:40,346,259,87,19487,13803,5684,11542137.0,8168951.0,3373186.0,326,246,80,18866,13294,5572,11172750.0,7863526.0,3309224.0,0.5918,0.5935,0.5915,0.5939
2023-04-28 16:45,546,479,67,29619,21757,7862,17542788.0,12873343.0,4669445.0,545,479,66,29046,21756,7290,17201128.0,12872448.0,4328680.0,0.5917,0.5939,0.5917,0.5938
2023-04-28 16:50,28,14,14,1310,263,1047,762977.0,154265.0,608712.0,26,11,15,1705,272,1433,1012377.0,159283.0,853093.0,0.5866,0.5814,0.5856,0.5953
2023-04-28 16:55,53,30,23,3144,964,2180,1874469.0,570506.0,1303962.0,39,23,16,2514,861,1653,1496301.0,508909.0,987392.0,0.5918,0.5981,0.5911,0.5973
2023-04-28 17:00,746,165,581,141938,11653,130285,84289212.0,6938389.0,77350823.0,740,160,580,141555,10938,130617,84022607.0,6471611.0,77550995.0,0.5954,0.5937,0.5917,0.5937
2023-04-28 17:05,980,156,824,167856,9995,157861,99675847.0,5915814.0,93760033.0,965,144,821,167848,9831,158017,99669462.0,5816271.0,93853191.0,0.5919,0.5939,0.5916,0.5939
2023-04-28 17:10,482,143,339,78705,9301,69404,46696314.0,5503529.0,41192785.0,475,141,334,78572,9327,69245,46615363.0,5517651.0,41097712.0,0.5917,0.5935,0.5916,0.5935
2023-04-28 17:15,124,62,62,11717,3174,8543,6955508.0,1877825.0,5077682.0,122,61,61,11260,3161,8099,6668782.0,1852466.0,4816316.0,0.5916,0.5944,0.586,0.5947
2023-04-28 17:20,602,26,576,145369,785,144584,86557436.0,464543.0,86092893.0,597,23,574,144537,717,143820,86069270.0,424183.0,85645087.0,0.5918,0.5955,0.5916,0.5955
2023-04-28 17:25,735,41,694,173233,797,172436,103000464.0,471318.0,102529145.0,729,37,692,173287,853,172434,103030970.0,504411.0,102526558.0,0.5914,0.5946,0.5913,0.5946
2023-04-28 17:30,206,47,159,27334,995,26339,16261708.0,594263.0,15667445.0,192,37,155,27504,896,26608,16359477.0,529944.0,15829533.0,0.5972,0.5948,0.5915,0.5949
2023-04-28 17:35,281,46,235,21625,823,20802,12849576.0,488930.0,12360645.0,269,40,229,21926,1195,20731,13029689.0,706823.0,12322865.0,0.5941,0.5942,0.5915,0.5944
2023-04-28 17:40,1790,573,1217,219765,29934,189831,130332428.0,17716541.0,112615886.0,1781,566,1215,219059,29535,189524,129913781.0,17466986.0,112446794.0,0.5919,0.5932,0.5914,0.5933
2023-04-28 17:45,1823,509,1314,217015,26515,190500,128712114.0,15685288.0,113026825.0,1819,507,1312,216962,26488,190474,128674952.0,15664494.0,113010458.0,0.5916,0.5933,0.5914,0.5933
2023-04-28 17:50,1239,251,988,148919,10351,138568,88344902.0,6123293.0,82221608.0,1234,251,983,148983,10174,138809,88382301.0,6018527.0,82363773.0,0.5916,0.5934,0.5916,0.5934
2023-04-28 17:55,893,185,708,132759,6989,125770,78758724.0,4132931.0,74625793.0,893,185,708,132949,7034,125915,78871599.0,4159528.0,74712071.0,0.5913,0.5934,0.5913,0.5934
2023-04-28 18:00,421,101,320,51869,3003,48866,30775608.0,1777579.0,28998028.0,410,95,315,52072,3506,48566,30879143.0,2060575.0,28818567.0,0.5919,0.5934,0.5877,0.5934
2023-04-28 18:05,81,43,38,2775,1190,1585,1646348.0,703925.0,942422.0,76,41,35,2887,1304,1583,1712856.0,771314.0,941542.0,0.5915,0.5946,0.5915,0.5948
2023-04-28 18:10,787,62,725,126128,2516,123612,100040503.0,26795768.0,73244735.0,783,57,726,125146,2123,123023,99508151.0,26566549.0,72941602.0,10.6501,0.5925,12.5137,0.5929
2023-04-28 18:15,464,55,409,62560,2286,60274,37067088.0,1346561.0,35720527.0,452,48,404,62326,2091,60235,36931480.0,1233572.0,35697908.0,0.589,0.5926,0.5899,0.5926
2023-04-28 18:20,116,19,97,10695,775,9920,6363870.0,475360.0,5888510.0,100,7,93,10306,355,9951,6115942.0,209422.0,5906519.0,0.6134,0.5936,0.5899,0.5936
2023-04-28 18:25,67,12,55,5527,85,5442,3285823.0,50275.0,3235548.0,51,6,45,4628,67,4561,2752181.0,39518.0,2712662.0,0.5915,0.5946,0.5898,0.5948
2023-04-28 18:30,153,21,132,10663,894,9769,6303389.0,528137.0,5775252.0,164,29,135,9817,827,8990,5807288.0,486565.0,5320722.0,0.5908,0.5912,0.5884,0.5918
2023-04-28 18:35,126,44,82,9678,1740,7938,5734364.0,1025380.0,4708983.0,117,33,84,11105,1552,9553,6586305.0,911407.0,5674898.0,0.5893,0.5932,0.5872,0.594
2023-05-02 10:00,1814,264,1550,180114,8739,171375,112453324.0,10780655.0,101672669.0,1463,131,1332,171596,5157,166439,101627486.0,3035779.0,98591707.0,1.2336,0.5933,0.5887,0.5924
2023-05-02 10:05,4575,422,4153,634665,20114,614551,525913760.0,163601766.0,362311993.0,4303,289,4014,628806,17364,611442,503091210.0,142504066.0,360587143.0,8.1337,0.5896,8.2069,0.5897
2023-05-02 10:10,3472,921,2551,417807,53298,364509,296459323.0,81793669.0,214665653.0,3343,803,2540,412380,48053,364327,293286422.0,78728153.0,214558269.0,1.5346,0.5889,1.6384,0.5889
2023-05-02 10:15,3270,334,2936,334338,12379,321959,196913631.0,7255975.0,189657655.0,3153,269,2884,331718,11093,320625,195398136.0,6502610.0,188895526.0,0.5862,0.5891,0.5862,0.5891
2023-05-02 10:20,2405,511,1894,235892,25132,210760,138945082.0,14724711.0,124220371.0,2338,479,1859,234157,24511,209646,137970522.0,14360121.0,123610401.0,0.5859,0.5894,0.5859,0.5896
2023-05-02 10:25,1575,469,1106,159515,24373,135142,93937386.0,14277410.0,79659976.0,1542,445,1097,158717,23799,134918,93474262.0,13938872.0,79535390.0,0.5858,0.5895,0.5857,0.5895
2023-05-02 10:30,1846,641,1205,179293,30472,148821,130710618.0,43162425.0,87548192.0,1807,617,1190,178410,29936,148474,130250553.0,42848886.0,87401666.0,1.4165,0.5883,1.4313,0.5887
2023-05-02 10:35,651,235,416,68191,7311,60880,40188678.0,4281598.0,35907080.0,618,216,402,67523,7341,60182,39778428.0,4297723.0,35480704.0,0.5856,0.5898,0.5854,0.5896
2023-05-02 10:40,3101,793,2308,377299,23784,353515,272474672.0,64521313.0,207953359.0,3025,739,2286,376369,23363,353006,271981613.0,64278452.0,207703161.0,2.7128,0.5882,2.7513,0.5884
2023-05-02 10:45,1348,419,929,123477,12967,110510,72597051.0,7575486.0,65021564.0,1266,379,887,122863,12395,110468,72206020.0,7243469.0,64962550.0,0.5842,0.5884,0.5844,0.5881
2023-05-02 10:50,1133,242,891,107351,8634,98717,62899144.0,5041855.0,57857289.0,1091,217,874,107215,9481,97734,62835773.0,5537557.0,57298216.0,0.584,0.5861,0.5841,0.5863
2023-05-02 10:55,2154,525,1629,285463,22778,262685,192913996.0,38599796.0,154314200.0,2087,483,1604,283248,21300,261948,191633206.0,37740398.0,153892808.0,1.6946,0.5874,1.7718,0.5875
2023-05-02 11:00,1124,322,802,119976,9516,110460,70280481.0,5542241.0,64738239.0,1059,278,781,119590,9080,110510,70058432.0,5288602.0,64769830.0,0.5824,0.5861,0.5824,0.5861
2023-05-02 11:05,720,197,523,62237,8454,53783,36417813.0,4929980.0,31487832.0,666,157,509,58197,7357,50840,34058346.0,4285188.0,29773157.0,0.5832,0.5855,0.5825,0.5856
2023-05-02 11:10,1282,317,965,176315,12448,163867,128709026.0,32548354.0,96160672.0,1181,256,925,174211,11392,162819,127536935.0,31933931.0,95603003.0,2.6147,0.5868,2.8032,0.5872
2023-05-02 11:15,2527,511,2016,278298,22539,255759,187523472.0,38378850.0,149144622.0,2471,468,2003,274498,22265,252233,185412828.0,38211671.0,147201157.0,1.7028,0.5831,1.7162,0.5836
2023-05-02 11:20,2959,687,2272,301737,34226,267511,176010848.0,19833471.0,156177376.0,2908,650,2258,300312,33739,266573,175196791.0,19549844.0,155646946.0,0.5795,0.5838,0.5794,0.5839
2023-05-02 11:25,1149,225,924,131973,13436,118537,76954473.0,7781251.0,69173222.0,1100,193,907,130861,12804,118057,76302188.0,7404708.0,68897479.0,0.5791,0.5836,0.5783,0.5836
2023-05-02 11:30,3103,682,2421,414678,24912,389766,418324813.0,191620592.0,226704221.0,2933,562,2371,410527,23631,386896,416121087.0,190874421.0,225246665.0,7.6919,0.5816,8.0773,0.5822
2023-05-02 11:35,2001,309,1692,252839,7824,245015,172096832.0,29815308.0,142281523.0,1946,262,1684,248394,3689,244705,169543850.0,27438646.0,142105204.0,3.8108,0.5807,7.438,0.5807
2023-05-02 11:40,555,273,282,42147,14475,27672,24495238.0,8390038.0,16105200.0,503,230,273,43497,16845,26652,25232186.0,9718284.0,15513901.0,0.5796,0.582,0.5769,0.5821
2023-05-02 11:45,692,272,420,74121,19744,54377,43042047.0,11407138.0,31634909.0,669,256,413,73053,19009,54044,42428125.0,10990804.0,31437321.0,0.5778,0.5818,0.5782,0.5817
2023-05-02 11:50,2037,958,1079,236413,65761,170652,162808280.0,63474565.0,99333715.0,1983,926,1057,234145,64059,170086,161394571.0,62387347.0,99007224.0,0.9652,0.5821,0.9739,0.5821
2023-05-02 11:55,3016,1329,1687,245852,90717,155135,142824653.0,52549999.0,90274654.0,2964,1295,1669,244484,89878,154606,142069720.0,52065322.0,90004397.0,0.5793,0.5819,0.5793,0.5822
2023-05-02 12:00,3503,1517,1986,387314,88925,298389,225425454.0,51513717.0,173911736.0,3472,1493,1979,385740,88084,297656,224495902.0,51004848.0,173491053.0,0.5793,0.5828,0.579,0.5829
2023-05-02 12:05,2491,1104,1387,234503,70671,163832,136270108.0,40914739.0,95355369.0,2486,1099,1387,234359,70505,163854,136186989.0,40817730.0,95369259.0,0.5789,0.582,0.5789,0.582
2023-05-02 12:10,1977,1202,775,166498,95315,71183,96612032.0,55198074.0,41413957.0,1935,1177,758,166191,95062,71129,96420312.0,55037614.0,41382697.0,0.5791,0.5818,0.579,0.5818
2023-05-02 12:15,681,269,412,51009,17895,33114,29691664.0,10371514.0,19320149.0,638,251,387,47888,17726,30162,27814236.0,10273813.0,17540422.0,0.5796,0.5834,0.5796,0.5815
2023-05-02 12:20,743,157,586,68140,12412,55728,65033986.0,32514992.0,32518993.0,731,149,582,67157,11457,55700,64461932.0,31958817.0,32503115.0,2.6196,0.5835,2.7895,0.5835
2023-05-02 12:25,431,140,291,40631,11850,28781,23651455.0,6862556.0,16788899.0,401,120,281,40145,11485,28660,23380405.0,6662016.0,16718388.0,0.5791,0.5833,0.5801,0.5833
2023-05-02 12:30,2048,541,1507,209521,29405,180116,122098759.0,17070043.0,105028716.0,2030,527,1503,209182,28902,180280,121913107.0,16778605.0,105134501.0,0.5805,0.5831,0.5805,0.5832
2023-05-02 12:35,2392,908,1484,303667,82074,221593,202469702.0,73074294.0,129395408.0,2361,886,1475,301395,80749,220646,201053556.0,72229063.0,128824492.0,0.8903,0.5839,0.8945,0.5839
2023-05-02 12:40,2730,1149,1581,336944,100255,236689,221842175.0,83577795.0,138264379.0,2700,1137,1563,335142,99934,235208,220868875.0,83391346.0,137477528.0,0.8337,0.5842,0.8345,0.5845
2023-05-02 12:45,3716,1136,2580,438435,91314,347121,280945836.0,78306189.0,202639647.0,3695,1122,2573,438454,91187,347267,280968986.0,78233246.0,202735740.0,0.8575,0.5838,0.8579,0.5838
2023-05-02 12:50,2628,842,1786,320166,83526,236640,186584441.0,48480578.0,138103862.0,2610,833,1777,319972,83514,236458,186477209.0,48473648.0,138003561.0,0.5804,0.5836,0.5804,0.5836
2023-05-02 12:55,3957,941,3016,508500,41796,466704,296544861.0,24248039.0,272296822.0,3929,921,3008,507958,41921,466037,296234547.0,24320103.0,271914444.0,0.5802,0.5834,0.5801,0.5835
2023-05-02 13:00,3742,849,2893,528291,18800,509491,308185352.0,10893387.0,297291965.0,3736,842,2894,529020,19079,509941,308605767.0,11051488.0,297554278.0,0.5794,0.5835,0.5792,0.5835
2023-05-02 13:05,1760,423,1337,233169,16179,216990,136024941.0,9375209.0,126649732.0,1746,415,1331,231984,15574,216410,135335390.0,9023857.0,126311532.0,0.5795,0.5837,0.5794,0.5837
2023-05-02 13:10,1955,178,1777,244266,6439,237827,142610689.0,3728073.0,138882615.0,1942,174,1768,243907,6387,237520,142400410.0,3697839.0,138702570.0,0.579,0.584,0.579,0.584
2023-05-02 13:15,1574,122,1452,215347,4213,211134,125729667.0,2441231.0,123288436.0,1564,115,1449,215305,4178,211127,125704238.0,2419385.0,123284853.0,0.5795,0.5839,0.5791,0.5839
2023-05-02 13:20,1578,314,1264,219151,14248,204903,127943686.0,8258471.0,119685214.0,1629,350,1279,220725,15476,205249,128850790.0,8959653.0,119891136.0,0.5796,0.5841,0.5789,0.5841
2023-05-02 13:25,221,59,162,23262,2811,20451,13573004.0,1629254.0,11943750.0,204,53,151,22570,2910,19660,13165018.0,1685578.0,11479439.0,0.5796,0.584,0.5792,0.5839
2023-05-02 13:30,1411,397,1014,164774,21384,143390,120880911.0,37105358.0,83775552.0,1341,340,1001,162993,19653,143340,120459032.0,36716544.0,83742488.0,1.7352,0.5842,1.8682,0.5842
2023-05-02 13:35,1868,326,1542,222748,24014,198734,130071216.0,13943788.0,116127428.0,1851,316,1535,221688,23621,198067,129474139.0,13717078.0,115757061.0,0.5807,0.5843,0.5807,0.5844
2023-05-02 13:40,3454,1843,1611,416745,123067,293678,268401832.0,96345621.0,172056211.0,3396,1823,1573,413742,120393,293349,266637646.0,94752634.0,171885011.0,0.7829,0.5859,0.787,0.5859
2023-05-02 13:45,2787,1552,1235,327546,100444,227102,240891966.0,107876103.0,133015862.0,2758,1532,1226,326603,99380,227223,240333490.0,107246411.0,133087078.0,1.074,0.5857,1.0792,0.5857
2023-05-02 13:50,766,324,442,68721,23749,44972,40151912.0,13860391.0,26291521.0,735,308,427,67655,23610,44045,39537019.0,13749611.0,25787407.0,0.5836,0.5846,0.5824,0.5855
2023-05-02 13:55,810,414,396,76264,25653,50611,69317813.0,39668191.0,29649621.0,778,401,377,74901,25206,49695,68509059.0,39404074.0,29104984.0,1.5463,0.5858,1.5633,0.5857
2023-05-02 14:00,1629,694,935,174532,37879,136653,102273205.0,22085518.0,80187687.0,1618,704,914,174890,38616,136274,102476846.0,22509629.0,79967217.0,0.5831,0.5868,0.5829,0.5868
2023-05-02 14:05,251,193,58,15785,10643,5142,9202299.0,6199030.0,3003268.0,244,191,53,16015,10647,5368,9344434.0,6201126.0,3143307.0,0.5825,0.5841,0.5824,0.5856
2023-05-02 14:10,1230,652,578,139438,48441,90997,106202689.0,52924442.0,53278247.0,1221,644,577,139705,48358,91347,106367703.0,52877399.0,53490303.0,1.0926,0.5855,1.0935,0.5856
2023-05-02 14:15,2457,1078,1379,296656,96592,200064,173199319.0,56196875.0,117002443.0,2443,1071,1372,295813,96576,199237,172707595.0,56187549.0,116520046.0,0.5818,0.5848,0.5818,0.5848
2023-05-02 14:20,483,75,408,73803,6190,67613,43120600.0,3601000.0,39519599.0,481,73,408,73962,6165,67797,43213252.0,3586228.0,39627023.0,0.5817,0.5845,0.5817,0.5845
2023-05-02 14:25,673,533,140,49182,33093,16089,28672294.0,19270497.0,9401797.0,657,521,136,49110,32880,16230,28627892.0,19143609.0,9484283.0,0.5823,0.5844,0.5822,0.5844
2023-05-02 14:30,980,636,344,99362,40842,58520,58014157.0,23779162.0,34234994.0,975,634,341,99088,40830,58258,57854913.0,23772120.0,34082792.0,0.5822,0.585,0.5822,0.585
2023-05-02 14:35,1426,521,905,190985,42756,148229,136224540.0,49581567.0,86642973.0,1412,515,897,189764,42591,147173,135573004.0,49486814.0,86086189.0,1.1596,0.5845,1.1619,0.5849
2023-05-02 14:40,160,64,96,16688,3559,13129,9742561.0,2065784.0,7676776.0,152,60,92,16542,3611,12931,9658727.0,2096649.0,7562078.0,0.5804,0.5847,0.5806,0.5848
2023-05-02 14:45,779,352,427,90803,30993,59810,52875760.0,17990478.0,34885282.0,774,349,425,90805,30911,59894,52880007.0,17943675.0,34936331.0,0.5805,0.5833,0.5805,0.5833
2023-05-02 14:50,740,287,453,68870,20322,48548,40083543.0,11797460.0,28286082.0,813,332,481,70888,21553,49335,41252288.0,12499887.0,28752400.0,0.5805,0.5826,0.58,0.5828
2023-05-02 14:55,1649,727,922,172670,66848,105822,100496785.0,38809041.0,61687743.0,1647,726,921,172248,66719,105529,100254389.0,38734225.0,61520163.0,0.5806,0.5829,0.5806,0.583
2023-05-02 15:00,2130,792,1338,221366,69193,152173,129020489.0,40160278.0,88860211.0,2121,791,1330,220767,69165,151602,128671867.0,40143433.0,88528434.0,0.5804,0.5839,0.5804,0.584
2023-05-02 15:05,1810,936,874,177090,83942,93148,103101222.0,48732046.0,54369175.0,1805,934,871,177121,84116,93005,103114047.0,48828105.0,54285942.0,0.5805,0.5837,0.5805,0.5837
2023-05-02 15:10,741,190,551,61492,19371,42121,35773542.0,11247615.0,24525926.0,731,183,548,61328,19165,42163,35673878.0,11123213.0,24550664.0,0.5806,0.5823,0.5804,0.5823
2023-05-02 15:15,1833,845,988,179931,80176,99755,104680982.0,46526109.0,58154873.0,1824,842,982,179699,80231,99468,104546066.0,46557810.0,57988256.0,0.5803,0.583,0.5803,0.583
2023-05-02 15:20,734,258,476,88999,30484,58515,51799184.0,17681301.0,34117883.0,733,258,475,89280,30348,58932,51983328.0,17602856.0,34380471.0,0.58,0.5831,0.58,0.5834
2023-05-02 15:25,1148,213,935,171380,19778,151602,99915243.0,11458615.0,88456628.0,1134,204,930,168794,19780,149014,98401254.0,11450974.0,86950280.0,0.5794,0.5835,0.5789,0.5835
2023-05-02 15:30,557,97,460,44672,6010,38662,50723889.0,28186403.0,22537486.0,554,99,455,44743,5269,39474,50776352.0,27757771.0,23018581.0,4.6899,0.5829,5.2681,0.5831
2023-05-02 15:35,139,20,119,8712,1124,7588,5036833.0,650016.0,4386817.0,121,11,110,8185,1110,7075,4748078.0,641911.0,4106167.0,0.5783,0.5781,0.5783,0.5804
2023-05-02 15:40,274,23,251,17050,991,16059,9881405.0,573493.0,9307912.0,251,9,242,16705,769,15936,9693314.0,444654.0,9248660.0,0.5787,0.5796,0.5782,0.5804
2023-05-02 15:45,926,226,700,77666,11930,65736,45123128.0,6910069.0,38213058.0,886,211,675,75914,12000,63914,44122059.0,6939778.0,37182280.0,0.5792,0.5813,0.5783,0.5818
2023-05-02 15:50,1021,166,855,86785,8402,78383,75011283.0,29570421.0,45440862.0,992,153,839,84380,8153,76227,73595168.0,29417480.0,44177688.0,3.5195,0.5797,3.6082,0.5796
2023-05-02 15:55,1157,192,965,168088,15579,152509,121812018.0,33668244.0,88143774.0,1112,166,946,165628,15239,150389,120615586.0,33472930.0,87142655.0,2.1611,0.578,2.1965,0.5794
2023-05-02 16:00,1605,340,1265,241753,28344,213409,139741069.0,16268894.0,123472174.0,1538,298,1240,238239,26463,211776,137741063.0,15203717.0,122537345.0,0.574,0.5786,0.5745,0.5786
2023-05-02 16:05,928,277,651,72907,20041,52866,66718415.0,36206591.0,30511824.0,847,220,627,70714,18556,52158,65484905.0,35351154.0,30133750.0,1.8066,0.5772,1.9051,0.5777
2023-05-02 16:10,5016,2556,2460,653061,240768,412293,971155040.0,732292119.0,238862921.0,4947,2517,2430,647273,237600,409673,967583204.0,730197506.0,237385697.0,3.0415,0.5794,3.0732,0.5795
2023-05-02 16:15,2275,848,1427,316921,95949,220972,183224761.0,55269196.0,127955564.0,2253,832,1421,316547,95550,220997,183009016.0,55039202.0,127969814.0,0.576,0.5791,0.576,0.5791
2023-05-02 16:20,3935,1534,2401,548487,166816,381671,317288185.0,96181335.0,221106850.0,3922,1525,2397,547209,166553,380656,316539821.0,96018966.0,220520855.0,0.5766,0.5793,0.5765,0.5793
2023-05-02 16:25,1192,567,625,118028,57624,60404,68113673.0,33202625.0,34911048.0,1168,556,612,117619,57267,60352,67877776.0,32993337.0,34884438.0,0.5762,0.578,0.5761,0.578
2023-05-02 16:30,435,215,220,52220,30954,21266,30147901.0,17841329.0,12306572.0,416,203,213,51320,30826,20494,29627301.0,17767906.0,11859395.0,0.5764,0.5787,0.5764,0.5787
2023-05-02 16:35,717,139,578,70176,12280,57896,65200176.0,31775978.0,33424198.0,698,129,569,70913,12459,58454,65675046.0,31879821.0,33795225.0,2.5876,0.5773,2.5588,0.5782
2023-05-02 16:40,2407,541,1866,307304,29180,278124,226322016.0,66123809.0,160198207.0,2303,468,1835,302921,27028,275893,223974479.0,64889415.0,159085064.0,2.2661,0.576,2.4008,0.5766
2023-05-02 16:45,3255,736,2519,362611,28125,334486,331454410.0,139569498.0,191884912.0,3026,593,2433,359163,26939,332224,329600302.0,138880192.0,190720110.0,4.9625,0.5737,5.1554,0.5741
2023-05-02 16:50,3777,973,2804,539320,87150,452170,850833169.0,593026004.0,257807165.0,3495,805,2690,524715,78233,446482,842603187.0,587912940.0,254690247.0,6.8047,0.5702,7.5149,0.5704
2023-05-02 16:55,1220,380,840,132861,35201,97660,75854361.0,19925744.0,55928617.0,1181,349,832,132391,34683,97708,75588470.0,19623009.0,55965460.0,0.5661,0.5727,0.5658,0.5728
2023-05-02 17:00,173,48,125,12056,1121,10935,6905346.0,638474.0,6266872.0,125,16,109,10771,1055,9716,6168134.0,594319.0,5573815.0,0.5696,0.5731,0.5633,0.5737
2023-05-02 17:05,107,47,60,5846,1845,4001,3319163.0,1048766.0,2270396.0,78,24,54,5414,1637,3777,3080031.0,928191.0,2151840.0,0.5684,0.5675,0.567,0.5697
2023-05-02 17:10,270,38,232,14730,1974,12756,8383147.0,1117120.0,7266026.0,247,25,222,14654,2108,12546,8339941.0,1191608.0,7148332.0,0.5659,0.5696,0.5653,0.5698
2023-05-02 17:15,1910,423,1487,174033,42211,131822,99029883.0,23906820.0,75123062.0,1878,405,1473,173384,42049,131335,98684200.0,23812006.0,74872193.0,0.5664,0.5699,0.5663,0.5701
2023-05-02 17:20,3991,1437,2554,391576,126571,265005,222568408.0,71676195.0,150892212.0,3975,1428,2547,391501,126439,265062,222526990.0,71598944.0,150928046.0,0.5663,0.5694,0.5663,0.5694
2023-05-02 17:25,3641,1240,2401,399009,86725,312284,322710851.0,145494787.0,177216064.0,3528,1183,2345,395980,86159,309821,321716037.0,145783837.0,175932199.0,1.6777,0.5675,1.692,0.5679
2023-05-02 17:30,3664,634,3030,509227,25296,483931,622665777.0,351464032.0,271201745.0,3192,290,2902,491659,14433,477226,613076391.0,345495652.0,267580738.0,13.8941,0.5604,23.9379,0.5607
2023-05-02 17:35,1992,398,1594,299035,22635,276400,334961903.0,181235285.0,153726617.0,1755,236,1519,288463,20352,268111,329249919.0,179901796.0,149348123.0,8.0069,0.5562,8.8395,0.557
2023-05-02 17:40,2941,1512,1429,316555,149761,166794,489131311.0,396215785.0,92915526.0,2781,1399,1382,310456,145841,164615,485699141.0,393968533.0,91730608.0,2.6457,0.5571,2.7014,0.5572
2023-05-02 17:45,1165,676,489,100046,61747,38299,127861258.0,106540256.0,21321002.0,1086,619,467,97796,60104,37692,126629754.0,105607626.0,21022128.0,1.7254,0.5567,1.7571,0.5577
2023-05-02 17:50,969,331,638,83864,12474,71390,46703568.0,6913341.0,39790227.0,903,286,617,79747,10275,69472,44436732.0,5694642.0,38742090.0,0.5542,0.5574,0.5542,0.5577
2023-05-02 17:55,1716,707,1009,160630,22332,138298,113617141.0,36472780.0,77144360.0,1670,670,1000,159960,21693,138267,113263447.0,36105862.0,77157584.0,1.6332,0.5578,1.6644,0.558
2023-05-02 18:00,1286,467,819,106771,20961,85810,107588891.0,59799693.0,47789197.0,1179,399,780,103159,19127,84032,105598532.0,58780460.0,46818072.0,2.8529,0.5569,3.0732,0.5571
2023-05-02 18:05,2454,860,1594,294070,56617,237453,285097717.0,152014896.0,133082820.0,2366,786,1580,290576,54006,236570,283127675.0,150517658.0,132610017.0,2.685,0.5605,2.7871,0.5606
2023-05-02 18:10,6419,3146,3273,714526,283142,431384,617646096.0,374695444.0,242950652.0,6333,3091,3242,712658,282607,430051,616522417.0,374317826.0,242204591.0,1.3233,0.5632,1.3245,0.5632
2023-05-02 18:15,2549,1951,598,220219,205490,14729,147409587.0,139127301.0,8282285.0,2469,1897,572,218698,204332,14366,146530119.0,138448846.0,8081272.0,0.6771,0.5623,0.6776,0.5625
2023-05-02 18:20,1482,675,807,92952,55427,37525,100698144.0,79376163.0,21321980.0,1422,637,785,91841,54656,37185,100019426.0,78880782.0,21138644.0,1.4321,0.5682,1.4432,0.5685
2023-05-02 18:25,2478,1798,680,271843,192348,79495,394498109.0,349351349.0,45146760.0,2406,1759,647,268256,190832,77424,392470886.0,348486089.0,43984796.0,1.8162,0.5679,1.8261,0.5681
2023-05-02 18:30,1804,638,1166,146331,59720,86611,155061631.0,105969405.0,49092226.0,1772,615,1157,145516,59642,85874,154599682.0,105921121.0,48678560.0,1.7744,0.5668,1.7759,0.5669
2023-05-02 18:35,2123,531,1592,186077,43453,142624,105352416.0,24479760.0,80872656.0,2088,515,1573,182363,40853,141510,103267045.0,23010781.0,80256263.0,0.5634,0.567,0.5633,0.5671
2023-05-03 10:00,5562,1266,4296,743255,99837,643418,453453073.0,86382507.0,367070566.0,5171,1096,4075,722258,86373,635885,429509864.0,66814835.0,362695028.0,0.8652,0.5705,0.7736,0.5704
2023-05-03 10:05,8134,2414,5720,1303452,163587,1139865,765398366.0,116308825.0,649089541.0,7993,2361,5632,1297062,160071,1136991,750253406.0,102881280.0,647372126.0,0.711,0.5694,0.6427,0.5694
2023-05-03 10:10,5692,1848,3844,741834,87074,654760,492981384.0,121374624.0,371606759.0,5617,1807,3810,740115,86343,653772,492020276.0,120967533.0,371052743.0,1.3939,0.5675,1.401,0.5676
2023-05-03 10:15,5722,1231,4491,864702,30895,833807,585286600.0,113661129.0,471625470.0,5648,1178,4470,860298,27039,833259,583033489.0,111555936.0,471477552.0,3.6789,0.5656,4.1257,0.5658
2023-05-03 10:20,3952,919,3033,526512,36741,489771,536292294.0,261416594.0,274875699.0,3796,837,2959,518347,32790,485557,532169843.0,259271555.0,272898288.0,7.1151,0.5612,7.907,0.562
2023-05-03 10:25,4840,1823,3017,546432,197800,348632,925347271.0,734200379.0,191146891.0,4199,1436,2763,518028,183334,334694,910091356.0,726394721.0,183696635.0,3.7118,0.5483,3.9621,0.5488
2023-05-03 10:30,3796,3022,774,565148,518432,46716,596808812.0,571125466.0,25683345.0,3697,2931,766,560976,514357,46619,594234414.0,568603488.0,25630925.0,1.1016,0.5498,1.1055,0.5498
2023-05-03 10:35,5446,3912,1534,676097,560604,115493,1338422532.0,1273949125.0,64473407.0,5129,3800,1329,666165,555611,110554,1332579851.0,1270855082.0,61724768.0,2.2725,0.5582,2.2873,0.5583
2023-05-03 10:40,3065,2061,1004,312200,260792,51408,366440364.0,337606954.0,28833410.0,2952,2004,948,310784,262638,48146,365207347.0,338258763.0,26948583.0,1.2945,0.5609,1.2879,0.5597
2023-05-03 10:45,3242,2341,901,333733,284009,49724,258223262.0,230334640.0,27888622.0,3138,2300,838,331391,282659,48732,256910731.0,229571980.0,27338751.0,0.811,0.5609,0.8122,0.561
2023-05-03 10:50,4666,3896,770,617331,596628,20703,343868019.0,332249763.0,11618255.0,4577,3838,739,614841,595219,19622,342454141.0,331451925.0,11002216.0,0.5569,0.5612,0.5569,0.5607
2023-05-03 10:55,5865,4636,1229,786795,765728,21067,462720058.0,450894505.0,11825553.0,5822,4613,1209,786329,765804,20525,462459117.0,450934283.0,11524833.0,0.5888,0.5613,0.5888,0.5615
2023-05-03 11:00,5917,4180,1737,658549,620906,37643,439409023.0,418267482.0,21141541.0,5869,4159,1710,657777,620556,37221,438982226.0,418076318.0,20905908.0,0.6736,0.5616,0.6737,0.5617
2023-05-03 11:05,5585,4453,1132,705186,679445,25741,418136945.0,403663062.0,14473882.0,5530,4415,1115,703915,678630,25285,417391337.0,403174202.0,14217135.0,0.5941,0.5623,0.5941,0.5623
2023-05-03 11:10,4514,3569,945,554462,523604,30858,430702903.0,413255053.0,17447850.0,4483,3578,905,554385,523681,30704,430622576.0,413254467.0,17368108.0,0.7893,0.5654,0.7891,0.5657
2023-05-03 11:15,3002,1629,1373,291126,207208,83918,187579899.0,140183562.0,47396336.0,2964,1623,1341,288563,206703,81860,186144695.0,139907644.0,46237051.0,0.6765,0.5648,0.6769,0.5648
2023-05-03 11:20,5482,1610,3872,655059,232606,422453,414814259.0,177754571.0,237059688.0,5391,1540,3851,652493,231001,421492,413474166.0,176869842.0,236604324.0,0.7642,0.5612,0.7657,0.5613
2023-05-03 11:25,6700,2657,4043,771615,330658,440957,431838848.0,184202681.0,247636167.0,6660,2630,4030,770289,329721,440568,431082302.0,183663672.0,247418630.0,0.5571,0.5616,0.557,0.5616
2023-05-03 11:30,3053,1248,1805,322739,124263,198476,180455953.0,69120958.0,111334995.0,3020,1229,1791,321290,123372,197918,179648728.0,68626755.0,111021972.0,0.5562,0.5609,0.5563,0.5609
2023-05-03 11:35,1646,788,858,160458,64109,96349,89676565.0,35622900.0,54053664.0,1594,740,854,159766,63784,95982,89300036.0,35449821.0,53850215.0,0.5557,0.561,0.5558,0.561
2023-05-03 11:40,1065,582,483,94994,43913,51081,77145922.0,48521521.0,28624401.0,1052,578,474,94622,43634,50988,76937855.0,48365181.0,28572674.0,1.1049,0.5604,1.1084,0.5604
2023-05-03 11:45,1025,488,537,75955,23041,52914,42485526.0,12820001.0,29665525.0,1002,473,529,75184,22474,52710,42044374.0,12492230.0,29552144.0,0.5564,0.5606,0.5559,0.5607
2023-05-03 11:50,614,268,346,41236,12875,28361,23087683.0,7177008.0,15910675.0,596,259,337,41685,13204,28481,23320949.0,7340427.0,15980521.0,0.5574,0.561,0.5559,0.5611
2023-05-03 11:55,1366,577,789,88658,47432,41226,49437487.0,26286659.0,23150828.0,1344,562,782,87837,46848,40989,48990690.0,25973850.0,23016839.0,0.5542,0.5616,0.5544,0.5615
2023-05-03 12:00,354,106,248,9375,5171,4204,5236802.0,2883212.0,2353590.0,341,97,244,8992,4889,4103,5020876.0,2723208.0,2297668.0,0.5576,0.5598,0.557,0.56
2023-05-03 12:05,1182,801,381,112459,79365,33094,62748631.0,44150108.0,18598523.0,1148,781,367,111079,78620,32459,61995285.0,43735918.0,18259366.0,0.5563,0.562,0.5563,0.5625
2023-05-03 12:10,2122,1511,611,199810,150285,49525,111173977.0,83399769.0,27774208.0,2104,1498,606,199609,150070,49539,111072663.0,83288282.0,27784381.0,0.5549,0.5608,0.555,0.5609
2023-05-03 12:15,2444,1288,1156,245765,158852,86913,136761085.0,88106737.0,48654348.0,2426,1278,1148,244636,158274,86362,136129570.0,87782216.0,48347354.0,0.5546,0.5598,0.5546,0.5598
2023-05-03 12:20,5262,3226,2036,669658,452591,217067,446726944.0,324691756.0,122035188.0,5225,3204,2021,665229,449265,215964,444158795.0,322745815.0,121412980.0,0.7174,0.5622,0.7184,0.5622
2023-05-03 12:25,3930,2178,1752,430826,281542,149284,240852734.0,156932748.0,83919986.0,3979,2224,1755,431536,282306,149230,241222556.0,157353624.0,83868932.0,0.5574,0.5621,0.5574,0.562
2023-05-03 12:30,2950,1422,1528,272645,148646,123999,152728592.0,82967105.0,69761487.0,2890,1374,1516,271596,147843,123753,152134269.0,82514267.0,69620002.0,0.5582,0.5626,0.5581,0.5626
2023-05-03 12:35,4570,2578,1992,617534,441934,175600,393768637.0,294876474.0,98892163.0,4542,2556,1986,616284,440984,175300,393059015.0,294336781.0,98722234.0,0.6672,0.5632,0.6675,0.5632
2023-05-03 12:40,1859,1573,286,256605,232898,23707,143775572.0,130383841.0,13391731.0,1826,1550,276,254989,231871,23118,142859898.0,129788169.0,13071729.0,0.5598,0.5649,0.5597,0.5654
2023-05-03 12:45,2240,1459,781,238418,200570,37848,182325297.0,160922236.0,21403060.0,2208,1444,764,237737,199297,38440,181993228.0,160191528.0,21801699.0,0.8023,0.5655,0.8038,0.5672
2023-05-03 12:50,2758,2265,493,363966,350877,13089,252891435.0,245278042.0,7613393.0,2778,2300,478,364396,352812,11584,252999204.0,246353380.0,6645823.0,0.699,0.5817,0.6983,0.5737
2023-05-03 12:55,299,268,31,25323,24833,490,14223087.0,13945094.0,277993.0,229,201,28,22780,22588,192,12804865.0,12696003.0,108862.0,0.5616,0.5673,0.5621,0.567
2023-05-03 13:00,568,469,99,57567,55679,1888,32415337.0,31347448.0,1067888.0,546,458,88,56991,55601,1390,32090797.0,31300539.0,790258.0,0.563,0.5656,0.5629,0.5685
2023-05-03 13:05,4591,1682,2909,651566,166260,485306,992819720.0,719542184.0,273277535.0,4523,1635,2888,644230,163871,480359,988727410.0,718175116.0,270552294.0,4.3278,0.5631,4.3826,0.5632
2023-05-03 13:10,2944,904,2040,384981,66993,317988,241008283.0,61671525.0,179336757.0,2853,865,1988,383034,66415,316619,239911870.0,61351916.0,178559953.0,0.9206,0.564,0.9238,0.564
2023-05-03 13:15,3334,1348,1986,430632,104093,326539,339141675.0,154824745.0,184316930.0,3318,1337,1981,430372,104010,326362,338983015.0,154772141.0,184210874.0,1.4874,0.5645,1.4881,0.5644
2023-05-03 13:20,2259,1307,952,248065,94799,153266,139645386.0,53208029.0,86437356.0,2246,1298,948,247892,94709,153183,139550100.0,53156775.0,86393324.0,0.5613,0.564,0.5613,0.564
2023-05-03 13:25,3312,2571,741,359300,290455,68845,226245267.0,187353846.0,38891421.0,3283,2553,730,357928,289292,68636,225471498.0,186699569.0,38771929.0,0.645,0.5649,0.6454,0.5649
2023-05-03 13:30,4770,3868,902,553760,482103,71657,745511649.0,705020118.0,40491530.0,4761,3862,899,553409,482339,71070,745309378.0,705151660.0,40157718.0,1.4624,0.5651,1.4619,0.565
2023-05-03 13:35,3020,2520,500,348574,321060,27514,196003027.0,180363009.0,15640017.0,3010,2516,494,348518,320880,27638,195970760.0,180262131.0,15708628.0,0.5618,0.5684,0.5618,0.5684
2023-05-03 13:40,3307,2328,979,344000,309572,34428,193422415.0,173900438.0,19521976.0,3296,2322,974,344129,309713,34416,193496753.0,173979950.0,19516803.0,0.5617,0.567,0.5617,0.5671
2023-05-03 13:45,3923,3115,808,471383,425899,45484,337540706.0,311748230.0,25792476.0,3949,3141,808,472020,426206,45814,337889238.0,311911815.0,25977423.0,0.732,0.5671,0.7318,0.567
2023-05-03 13:50,3070,2565,505,376693,350246,26447,211771100.0,196775637.0,14995462.0,3034,2546,488,375217,349438,25779,210937086.0,196321531.0,14615555.0,0.5618,0.567,0.5618,0.567
2023-05-03 13:55,1488,1187,301,163047,159845,3202,91655990.0,89840036.0,1815953.0,1462,1171,291,162107,158838,3269,91138191.0,89287168.0,1851023.0,0.562,0.5671,0.5621,0.5662
2023-05-03 14:00,2637,1945,692,263973,206815,57158,245763858.0,213261502.0,32502355.0,2621,1929,692,262957,205415,57542,245160976.0,212444365.0,32716610.0,1.0312,0.5686,1.0342,0.5686
2023-05-03 14:05,2347,1958,389,213909,189760,24149,145420312.0,131618231.0,13802081.0,2266,1921,345,210575,187272,23303,143434758.0,130130843.0,13303915.0,0.6936,0.5715,0.6949,0.5709
2023-05-03 14:10,5013,4009,1004,570230,471856,98374,419833835.0,363695389.0,56138446.0,4998,4028,970,572079,473548,98531,420881992.0,364647987.0,56234005.0,0.7708,0.5707,0.77,0.5707
2023-05-03 14:15,4128,2622,1506,413036,252195,160841,234650462.0,142883360.0,91767102.0,4067,2577,1490,411529,251296,160233,233795191.0,142375030.0,91420161.0,0.5666,0.5705,0.5666,0.5705
2023-05-03 14:20,1105,745,360,108805,78032,30773,85850587.0,68299789.0,17550798.0,1088,738,350,108604,77874,30730,85732527.0,68208577.0,17523950.0,0.8753,0.5703,0.8759,0.5703
2023-05-03 14:25,1572,907,665,170621,94226,76395,97090112.0,53389209.0,43700903.0,1544,895,649,169853,93752,76101,96655027.0,53121135.0,43533892.0,0.5666,0.572,0.5666,0.5721
2023-05-03 14:30,1202,872,330,131308,108644,22664,74506688.0,61569028.0,12937660.0,1187,871,316,130612,108721,21891,74099047.0,61602853.0,12496194.0,0.5667,0.5708,0.5666,0.5708
2023-05-03 14:35,593,489,104,49230,43210,6020,28000757.0,24555645.0,3445111.0,577,473,104,49051,42951,6100,27858970.0,24368131.0,3490838.0,0.5683,0.5723,0.5673,0.5723
2023-05-03 14:40,641,331,310,57765,38589,19176,32799757.0,21867929.0,10931827.0,629,332,297,57405,38598,18807,32604802.0,21873056.0,10731746.0,0.5667,0.5701,0.5667,0.5706
2023-05-03 14:45,2479,2024,455,260639,219551,41088,171848967.0,148429908.0,23419059.0,2477,2028,449,260464,219988,40476,171784766.0,148682740.0,23102025.0,0.6761,0.57,0.6759,0.5708
2023-05-03 14:50,4745,1899,2846,563549,159737,403812,368370119.0,138618385.0,229751733.0,4704,1871,2833,561670,158526,403144,367358149.0,137933322.0,229424827.0,0.8678,0.569,0.8701,0.5691
2023-05-03 14:55,4605,2213,2392,591824,116259,475565,336911028.0,65866481.0,271044546.0,4582,2200,2382,591936,116086,475850,336962258.0,65756337.0,271205920.0,0.5665,0.5699,0.5664,0.5699
2023-05-03 15:00,3434,1610,1824,406300,89152,317148,231150246.0,50514775.0,180635471.0,3440,1613,1827,406395,88846,317549,231202234.0,50333160.0,180869074.0,0.5666,0.5696,0.5665,0.5696
2023-05-03 15:05,1519,565,954,121275,26912,94363,92986043.0,39318777.0,53667266.0,1422,543,879,120874,27157,93717,92772434.0,39458703.0,53313731.0,1.461,0.5687,1.453,0.5689
2023-05-03 15:10,574,249,325,55449,14665,40784,31488685.0,8295982.0,23192703.0,546,226,320,54782,14010,40772,31117794.0,7926542.0,23191251.0,0.5657,0.5687,0.5658,0.5688
2023-05-03 15:15,1852,535,1317,154517,38009,116508,87840183.0,21547675.0,66292508.0,1833,527,1306,153964,37634,116330,87521039.0,21326744.0,66194295.0,0.5669,0.569,0.5667,0.569
2023-05-03 15:20,1061,612,449,98999,49372,49627,56179882.0,27967283.0,28212599.0,1046,607,439,98584,49322,49262,55961708.0,27939054.0,28022654.0,0.5665,0.5685,0.5665,0.5688
2023-05-03 15:25,308,114,194,22623,7368,15255,12843595.0,4171932.0,8671663.0,302,112,190,22535,7310,15225,12791869.0,4137878.0,8653991.0,0.5662,0.5684,0.5661,0.5684
2023-05-03 15:30,850,360,490,86532,24618,61914,49182394.0,13945306.0,35237088.0,841,356,485,86290,23992,62298,49046941.0,13588154.0,35458787.0,0.5665,0.5691,0.5664,0.5692
2023-05-03 15:35,1839,1102,737,152260,57345,94915,110617195.0,56577063.0,54040132.0,1858,1127,731,151314,57247,94067,110064207.0,56507671.0,53556535.0,0.9866,0.5694,0.9871,0.5693
2023-05-03 15:40,423,239,184,48947,16261,32686,51884569.0,33297296.0,18587273.0,412,238,174,48324,17246,31078,51535566.0,33856353.0,17679213.0,2.0477,0.5687,1.9631,0.5689
2023-05-03 15:45,278,221,57,10315,6645,3670,5786980.0,3747511.0,2039468.0,265,219,46,9554,6696,2858,5400111.0,3775865.0,1624246.0,0.564,0.5557,0.5639,0.5683
2023-05-03 15:50,818,636,182,44132,26887,17245,25008142.0,15167319.0,9840823.0,800,633,167,43348,26963,16385,24560563.0,15211208.0,9349354.0,0.5641,0.5706,0.5642,0.5706
2023-05-03 15:55,3470,1351,2119,431210,98280,332930,292233949.0,103576654.0,188657294.0,3447,1343,2104,429498,97857,331641,291337711.0,103341229.0,187996482.0,1.0539,0.5667,1.056,0.5669
2023-05-03 16:00,4760,1564,3196,677956,103248,574708,383289048.0,58057548.0,325231500.0,4747,1558,3189,677212,102885,574327,382870437.0,57854225.0,325016211.0,0.5623,0.5659,0.5623,0.5659
2023-05-03 16:05,4369,1688,2681,595348,131706,463642,336441339.0,74096409.0,262344929.0,4354,1678,2676,594282,131156,463126,335842509.0,73781924.0,262060585.0,0.5626,0.5658,0.5626,0.5659
2023-05-03 16:10,3370,1239,2131,431610,105866,325744,244025829.0,59590380.0,184435449.0,3362,1235,2127,431702,105939,325763,244080707.0,59631078.0,184449628.0,0.5629,0.5662,0.5629,0.5662
2023-05-03 16:15,3721,1658,2063,436854,124042,312812,246841474.0,69816463.0,177025010.0,3712,1651,2061,436695,123792,312903,246749920.0,69672904.0,177077015.0,0.5628,0.5659,0.5628,0.5659
2023-05-03 16:20,1960,673,1287,230181,37870,192311,130116958.0,21320577.0,108796381.0,1956,673,1283,230107,38233,191874,130076499.0,21524073.0,108552426.0,0.563,0.5657,0.563,0.5657
2023-05-03 16:25,4808,1342,3466,681604,90244,591360,385318383.0,50770414.0,334547969.0,4793,1333,3460,680406,89332,591074,384682031.0,50262484.0,334419547.0,0.5626,0.5657,0.5626,0.5658
2023-05-03 16:30,3342,1238,2104,458614,65119,393495,259031222.0,36568212.0,222463009.0,3368,1236,2132,458909,65832,393077,259197630.0,36963547.0,222234083.0,0.5616,0.5654,0.5615,0.5654
2023-05-03 16:35,2127,679,1448,287782,51298,236484,186536078.0,52881709.0,133654369.0,2118,653,1465,287421,50346,237075,186347241.0,52348281.0,133998960.0,1.0309,0.5652,1.0398,0.5652
2023-05-03 16:40,365,196,169,28031,9005,19026,15803879.0,5052978.0,10750901.0,341,178,163,27253,8765,18488,15367683.0,4919032.0,10448651.0,0.5611,0.5651,0.5612,0.5652
2023-05-03 16:45,357,127,230,50074,5253,44821,28344335.0,2946751.0,25397583.0,346,118,228,49880,5086,44794,28235005.0,2852001.0,25383004.0,0.561,0.5666,0.5608,0.5667
2023-05-03 16:50,253,94,159,35215,5884,29331,19897387.0,3300063.0,16597324.0,249,95,154,35245,5940,29305,19916920.0,3330790.0,16586130.0,0.5609,0.5659,0.5607,0.566
2023-05-03 16:55,372,113,259,47414,5764,41650,26819195.0,3233845.0,23585350.0,368,110,258,47042,5688,41354,26607350.0,3191077.0,23416273.0,0.561,0.5663,0.561,0.5662
2023-05-03 17:00,548,245,303,63433,13039,50394,35906947.0,7334542.0,28572404.0,538,242,296,63353,12824,50529,35844623.0,7193345.0,28651278.0,0.5625,0.567,0.5609,0.567
2023-05-03 17:05,235,131,104,18115,6822,11293,10192608.0,3825976.0,6366632.0,225,126,99,18146,6629,11517,10211669.0,3717551.0,6494117.0,0.5608,0.5638,0.5608,0.5639
2023-05-03 17:10,687,332,355,73315,20187,53128,41319897.0,11327408.0,29992488.0,690,337,353,72738,19910,52828,40998808.0,11169905.0,29828902.0,0.5611,0.5645,0.561,0.5646
2023-05-03 17:15,388,212,176,41929,15472,26457,23607923.0,8672102.0,14935821.0,377,205,172,42023,15464,26559,23663497.0,8667665.0,14995832.0,0.5605,0.5645,0.5605,0.5646
2023-05-03 17:20,198,103,95,19935,6209,13726,11210665.0,3480655.0,7730010.0,175,96,79,18687,6245,12442,10531835.0,3500968.0,7030867.0,0.5606,0.5632,0.5606,0.5651
2023-05-03 17:25,1008,243,765,118170,11081,107089,66627790.0,6209684.0,60418106.0,972,242,730,114672,11153,103519,64650146.0,6241303.0,58408842.0,0.5604,0.5642,0.5596,0.5642
2023-05-03 17:30,2206,846,1360,245277,68892,176385,137930392.0,38568121.0,99362270.0,2190,833,1357,245918,68413,177505,138279774.0,38283962.0,99995811.0,0.5598,0.5633,0.5596,0.5633
2023-05-03 17:35,1001,436,565,68519,27479,41040,38411168.0,15374914.0,23036253.0,991,431,560,68666,27714,40952,38485721.0,15491631.0,22994090.0,0.5595,0.5613,0.559,0.5615
2023-05-03 17:40,1884,707,1177,188024,74542,113482,105596916.0,41768947.0,63827968.0,1873,703,1170,187881,74207,113674,105493241.0,41562809.0,63930431.0,0.5603,0.5625,0.5601,0.5624
2023-05-03 17:45,1504,664,840,134228,56704,77524,75363978.0,31768762.0,43595216.0,1493,660,833,133536,56348,77188,74973983.0,31567362.0,43406620.0,0.5603,0.5623,0.5602,0.5623
2023-05-03 17:50,654,85,569,48242,6180,42062,51229701.0,27563507.0,23666194.0,647,80,567,48542,6368,42174,51400603.0,27669728.0,23730875.0,4.4601,0.5627,4.3451,0.5627
2023-05-03 17:55,1386,124,1262,112969,10078,102891,63558240.0,5644354.0,57913886.0,1374,118,1256,112832,9962,102870,63477588.0,5574435.0,57903152.0,0.5601,0.5629,0.5596,0.5629
2023-05-03 18:00,2150,380,1770,263132,41331,221801,147944703.0,23139330.0,124805373.0,2142,371,1771,264540,41903,222637,148725407.0,23446091.0,125279315.0,0.5599,0.5627,0.5595,0.5627
2023-05-03 18:05,1578,169,1409,160720,21915,138805,90358423.0,12278124.0,78080298.0,1568,161,1407,160678,21804,138874,90335143.0,12216087.0,78119056.0,0.5603,0.5625,0.5603,0.5625
2023-05-03 18:10,1525,362,1163,149293,34568,114725,83903220.0,19367230.0,64535990.0,1516,355,1161,149007,34487,114520,83746426.0,19322178.0,64424247.0,0.5603,0.5625,0.5603,0.5626
2023-05-03 18:15,2065,549,1516,217386,42662,174724,146199704.0,47966279.0,98233424.0,2027,538,1489,214452,42641,171811,144554628.0,47955506.0,96599121.0,1.1243,0.5622,1.1246,0.5622
2023-05-03 18:20,1582,107,1475,240144,1625,238519,134853499.0,904827.0,133948671.0,1565,91,1474,240233,1532,238701,134909306.0,851676.0,134057630.0,0.5568,0.5616,0.5559,0.5616
2023-05-03 18:25,1999,131,1868,348627,954,347673,195866737.0,531444.0,195335292.0,1978,116,1862,347928,544,347384,195493213.0,303452.0,195189761.0,0.5571,0.5618,0.5578,0.5619
2023-05-03 18:30,3280,987,2293,442120,60444,381676,296589783.0,81857329.0,214732453.0,3278,984,2294,440540,59578,380962,295706201.0,81370092.0,214336109.0,1.3543,0.5626,1.3658,0.5626
2023-05-03 18:35,2356,866,1490,309677,47909,261768,174000007.0,26719872.0,147280135.0,2356,866,1490,310091,47918,262173,174234725.0,26723789.0,147510935.0,0.5577,0.5626,0.5577,0.5626
2023-05-04 10:00,7137,2384,4753,980228,184913,795315,573919797.0,127498095.0,446421702.0,6757,2182,4575,961611,171193,790418,549606980.0,106042237.0,443564743.0,0.6895,0.5613,0.6194,0.5612
2023-05-04 10:05,3794,1739,2055,489962,189457,300505,298728041.0,129596008.0,169132033.0,3745,1763,1982,478320,186294,292026,282308882.0,118194026.0,164114855.0,0.684,0.5628,0.6344,0.562
2023-05-04 10:10,842,622,220,50983,27330,23653,28601051.0,15257550.0,13343500.0,768,547,221,52671,25509,27162,29542833.0,14242658.0,15300174.0,0.5583,0.5641,0.5583,0.5633
2023-05-04 10:15,721,260,461,81833,24943,56890,70009552.0,38005284.0,32004267.0,723,282,441,81731,25536,56195,69938446.0,38330725.0,31607721.0,1.5237,0.5626,1.501,0.5625
2023-05-04 10:20,1599,736,863,137914,38716,99198,77511328.0,21709222.0,55802105.0,1483,679,804,137030,37826,99204,77012667.0,21184891.0,55827776.0,0.5607,0.5625,0.5601,0.5628
2023-05-04 10:25,1566,456,1110,132987,28365,104622,74669824.0,15849471.0,58820352.0,1547,445,1102,131854,27945,103909,74027393.0,15610408.0,58416984.0,0.5588,0.5622,0.5586,0.5622
2023-05-04 10:30,1316,361,955,119761,17526,102235,67280541.0,9790091.0,57490450.0,1289,351,938,119716,17986,101730,67236230.0,10034351.0,57201878.0,0.5586,0.5623,0.5579,0.5623
2023-05-04 10:35,902,156,746,72454,10308,62146,65976095.0,31064284.0,34911810.0,910,158,752,72419,10650,61769,64770688.0,30043554.0,34727134.0,3.0136,0.5618,2.821,0.5622
2023-05-04 10:40,1972,889,1083,162329,91045,71284,115620349.0,75794254.0,39826095.0,1905,854,1051,160460,90425,70035,114619864.0,75459813.0,39160051.0,0.8325,0.5587,0.8345,0.5591
2023-05-04 10:45,4820,2464,2356,663901,419370,244531,849689337.0,713018929.0,136670407.0,4782,2433,2349,661212,417600,243612,848232881.0,712027973.0,136204908.0,1.7002,0.5589,1.705,0.5591
2023-05-04 10:50,4859,1485,3374,543628,120693,422935,454839572.0,218856770.0,235982801.0,4789,1444,3345,539439,118568,420871,452540003.0,217693698.0,234846304.0,1.8133,0.558,1.836,0.558
2023-05-04 10:55,2139,508,1631,237879,10723,227156,132702329.0,5911420.0,126790909.0,2107,480,1627,238620,11589,227031,133122631.0,6400018.0,126722612.0,0.5513,0.5582,0.5522,0.5582
2023-05-04 11:00,2510,1085,1425,237260,79739,157521,131514207.0,43805232.0,87708975.0,2476,1062,1414,234958,77676,157282,130302590.0,42742798.0,87559791.0,0.5494,0.5568,0.5503,0.5567
2023-05-04 11:05,3945,1790,2155,367706,143756,223950,229511349.0,104679439.0,124831910.0,3901,1757,2144,367190,143385,223805,229216140.0,104467418.0,124748721.0,0.7282,0.5574,0.7286,0.5574
2023-05-04 11:10,3956,2740,1216,428312,281615,146697,288912569.0,206821856.0,82090712.0,3925,2722,1203,427492,281340,146152,288448203.0,206664893.0,81783310.0,0.7344,0.5596,0.7346,0.5596
2023-05-04 11:15,3330,2365,965,401480,319458,82022,273824681.0,227932687.0,45891994.0,3299,2342,957,399473,318237,81236,272695830.0,227240897.0,45454933.0,0.7135,0.5595,0.7141,0.5595
2023-05-04 11:20,5715,3544,2171,603850,431047,172803,361395901.0,264630335.0,96765566.0,5678,3520,2158,601321,429052,172269,359950489.0,263484046.0,96466442.0,0.6139,0.56,0.6141,0.56
2023-05-04 11:25,4832,3128,1704,497877,410748,87129,327821471.0,279022802.0,48798669.0,4826,3114,1712,497006,410051,86955,327316969.0,278610569.0,48706399.0,0.6793,0.5601,0.6795,0.5601
2023-05-04 11:30,4547,2838,1709,459603,364915,94688,256208192.0,203023046.0,53185146.0,4517,2828,1689,459959,365160,94799,256412244.0,203158578.0,53253666.0,0.5564,0.5617,0.5564,0.5618
2023-05-04 11:35,6229,4068,2161,662443,529420,133023,369128498.0,294365829.0,74762669.0,6218,4061,2157,662299,529442,132857,369048951.0,294378269.0,74670681.0,0.556,0.562,0.556,0.562
2023-05-04 11:40,3876,2405,1471,381629,305384,76245,212619741.0,169807498.0,42812243.0,3855,2392,1463,381132,305060,76072,212349346.0,169628917.0,42720428.0,0.556,0.5615,0.5561,0.5616
2023-05-04 11:45,3988,2811,1177,419404,378123,41281,233193713.0,210086288.0,23107424.0,3973,2800,1173,418994,377668,41326,232967152.0,209835486.0,23131665.0,0.5556,0.5598,0.5556,0.5597
2023-05-04 11:50,1226,718,508,102073,87924,14149,56796973.0,48877151.0,7919822.0,1210,708,502,101346,87603,13743,56357828.0,48662954.0,7694874.0,0.5559,0.5597,0.5555,0.5599
2023-05-04 11:55,83,72,11,7593,6649,944,4244436.0,3717860.0,526576.0,72,66,6,7012,6379,633,3895672.0,3541610.0,354062.0,0.5592,0.5578,0.5552,0.5593
2023-05-04 12:00,432,189,243,22891,11685,11206,12752802.0,6500600.0,6252202.0,419,183,236,22901,11591,11310,12771650.0,6448728.0,6322921.0,0.5563,0.5579,0.5564,0.5591
2023-05-04 12:05,304,152,152,14631,10029,4602,8181963.0,5609971.0,2571992.0,293,146,147,13565,9502,4063,7557358.0,5286674.0,2270684.0,0.5594,0.5589,0.5564,0.5589
2023-05-04 12:10,228,118,110,8009,5280,2729,4473219.0,2947253.0,1525966.0,220,109,111,8056,5285,2771,4496694.0,2947265.0,1549429.0,0.5582,0.5592,0.5577,0.5592
2023-05-04 12:15,320,175,145,12953,8874,4079,7226174.0,4944178.0,2281995.0,297,162,135,12447,8675,3772,6943392.0,4832670.0,2110721.0,0.5572,0.5594,0.5571,0.5596
2023-05-04 12:20,209,140,69,10018,8304,1714,5596285.0,4639209.0,957076.0,191,131,60,9621,8176,1445,5368986.0,4559455.0,809531.0,0.5587,0.5584,0.5577,0.5602
2023-05-04 12:25,206,136,70,16128,12280,3848,8999970.0,6847447.0,2152523.0,194,127,67,15627,11953,3674,8720272.0,6661985.0,2058286.0,0.5576,0.5594,0.5573,0.5602
2023-05-04 12:30,363,226,137,26053,22305,3748,14540728.0,12427074.0,2113654.0,354,220,134,26097,22296,3801,14564959.0,12422559.0,2142400.0,0.5571,0.5639,0.5572,0.5636
2023-05-04 12:35,230,160,70,14041,12409,1632,7821408.0,6909775.0,911633.0,214,151,63,14152,12610,1542,7889191.0,7022199.0,866992.0,0.5568,0.5586,0.5569,0.5623
2023-05-04 12:40,566,356,210,37617,30335,7282,20980554.0,16894805.0,4085748.0,554,349,205,37267,30176,7091,20784432.0,16795546.0,3988885.0,0.5569,0.5611,0.5566,0.5625
2023-05-04 12:45,255,184,71,19974,17253,2721,11129228.0,9607564.0,1521664.0,247,179,68,19475,16926,2549,10852337.0,9426002.0,1426335.0,0.5569,0.5592,0.5569,0.5596
2023-05-04 12:50,270,188,82,23771,19364,4407,13230439.0,10766162.0,2464277.0,261,185,76,23622,19455,4167,13147696.0,10817861.0,2329835.0,0.556,0.5592,0.556,0.5591
2023-05-04 12:55,242,165,77,21162,17568,3594,11780659.0,9770666.0,2009992.0,233,161,72,21044,17431,3613,11715518.0,9695113.0,2020404.0,0.5562,0.5593,0.5562,0.5592
2023-05-04 13:00,341,267,74,29526,26758,2768,16432698.0,14884744.0,1547953.0,330,257,73,28848,26319,2529,16061755.0,14647650.0,1414105.0,0.5563,0.5592,0.5565,0.5592
2023-05-04 13:05,150,112,38,12872,10425,2447,7218109.0,5806206.0,1411902.0,140,110,30,11286,10203,1083,6288772.0,5681893.0,606879.0,0.557,0.577,0.5569,0.5604
2023-05-04 13:10,250,233,17,16009,15758,251,8905200.0,8765173.0,140027.0,245,227,18,16561,15681,880,9212870.0,8721729.0,491141.0,0.5562,0.5579,0.5562,0.5581
2023-05-04 13:15,233,191,42,11704,10628,1076,6518981.0,5914961.0,604020.0,228,188,40,11682,10611,1071,6508143.0,5906898.0,601245.0,0.5565,0.5614,0.5567,0.5614
2023-05-04 13:20,220,200,20,17794,16948,846,9894964.0,9422107.0,472857.0,215,196,19,17730,16950,780,9858962.0,9422998.0,435964.0,0.5559,0.5589,0.5559,0.5589
2023-05-04 13:25,130,85,45,5407,4242,1165,3018686.0,2366744.0,651942.0,112,81,31,5059,4043,1016,2821192.0,2252552.0,568640.0,0.5579,0.5596,0.5571,0.5597
2023-05-04 13:30,198,143,55,9415,7663,1752,5240550.0,4262434.0,978115.0,200,141,59,9787,7653,2134,5454039.0,4257505.0,1196534.0,0.5562,0.5583,0.5563,0.5607
2023-05-04 13:35,229,161,68,11061,8531,2530,6172419.0,4757062.0,1415357.0,222,152,70,11056,8317,2739,6171402.0,4636418.0,1534984.0,0.5576,0.5594,0.5575,0.5604
2023-05-04 13:40,103,84,19,5990,5426,564,3342991.0,3025705.0,317286.0,96,77,19,5702,5138,564,3183763.0,2866702.0,317061.0,0.5576,0.5626,0.5579,0.5622
2023-05-04 13:45,268,240,28,16726,16119,607,9338043.0,8998017.0,340026.0,262,235,27,16843,16151,692,9401959.0,9014268.0,387690.0,0.5582,0.5602,0.5581,0.5602
2023-05-04 13:50,246,188,58,16701,13744,2957,9291569.0,7637220.0,1654348.0,238,183,55,15625,12851,2774,8717035.0,7166029.0,1551005.0,0.5557,0.5595,0.5576,0.5591
2023-05-04 13:55,146,105,41,10370,5835,4535,31107156.0,28570532.0,2536623.0,141,104,37,10017,5700,4317,30907999.0,28493288.0,2414710.0,4.8964,0.5593,4.9988,0.5593
2023-05-04 14:00,229,150,79,12056,8363,3693,31980572.0,29978482.0,2002090.0,204,135,69,10366,7723,2643,31099228.0,29617847.0,1481381.0,3.5847,0.5421,3.835,0.5605
2023-05-04 14:05,437,107,330,17776,8899,8877,60552859.0,55586012.0,4966846.0,422,103,319,17418,8441,8977,60353698.0,55330264.0,5023434.0,6.2463,0.5595,6.5549,0.5596
2023-05-04 14:10,336,239,97,18249,13434,4815,35501207.0,32804184.0,2697022.0,288,227,61,17100,12541,4559,34859124.0,32302705.0,2556418.0,2.4419,0.5601,2.5758,0.5607
2023-05-04 14:15,180,140,40,10490,7112,3378,5861693.0,3967911.0,1893781.0,177,136,41,10336,7046,3290,5774961.0,3930118.0,1844842.0,0.5579,0.5606,0.5578,0.5607
2023-05-04 14:20,207,182,25,15433,14011,1422,8619027.0,7821694.0,797333.0,199,175,24,15210,13872,1338,8494035.0,7742866.0,751168.0,0.5583,0.5607,0.5582,0.5614
2023-05-04 14:25,698,591,107,86975,75360,11615,48586093.0,42059303.0,6526790.0,682,582,100,86539,74965,11574,48311205.0,41807770.0,6503435.0,0.5581,0.5619,0.5577,0.5619
2023-05-04 14:30,369,248,121,37438,26602,10836,46258595.0,40168317.0,6090278.0,346,244,102,36629,26537,10092,45799891.0,40130461.0,5669430.0,1.51,0.562,1.5122,0.5618
2023-05-04 14:35,69,53,16,6890,5991,899,3853305.0,3340663.0,512642.0,68,54,14,6431,5842,589,3591492.0,3260616.0,330876.0,0.5576,0.5702,0.5581,0.5618
2023-05-04 14:40,160,119,41,17282,14770,2512,9648347.0,8237915.0,1410431.0,154,113,41,17176,14598,2578,9590735.0,8142390.0,1448345.0,0.5577,0.5615,0.5578,0.5618
2023-05-04 14:45,324,211,113,29142,18848,10294,16290733.0,10512732.0,5778000.0,312,209,103,28848,18879,9969,16124416.0,10529614.0,5594802.0,0.5578,0.5613,0.5577,0.5612
2023-05-04 14:50,59,28,31,2837,938,1899,1591682.0,524478.0,1067203.0,54,24,30,2819,942,1877,1581446.0,526634.0,1054812.0,0.5591,0.562,0.5591,0.562
2023-05-04 14:55,89,34,55,7034,1588,5446,3932104.0,879563.0,3052540.0,86,32,54,7024,1558,5466,3937443.0,871290.0,3066153.0,0.5539,0.5605,0.5592,0.561
2023-05-04 15:00,329,193,136,31894,19030,12864,17843151.0,10619238.0,7223912.0,337,184,153,32641,18825,13816,18267302.0,10504609.0,7762693.0,0.558,0.5616,0.558,0.5619
2023-05-04 15:05,1077,843,234,136655,120171,16484,76265031.0,67003034.0,9261997.0,1048,839,209,134676,120177,14499,75142355.0,67006188.0,8136167.0,0.5576,0.5619,0.5576,0.5612
2023-05-04 15:10,834,692,142,103567,97468,6099,57790721.0,54347183.0,3443537.0,823,691,132,102829,97553,5276,57354930.0,54393014.0,2961915.0,0.5576,0.5646,0.5576,0.5614
2023-05-04 15:15,897,633,264,111360,87616,23744,62188952.0,48864111.0,13324841.0,890,630,260,111236,87528,23708,62120516.0,48815413.0,13305103.0,0.5577,0.5612,0.5577,0.5612
2023-05-04 15:20,531,376,155,63269,51753,11516,35331153.0,28865036.0,6466116.0,522,368,154,63017,51678,11339,35190283.0,28823628.0,6366654.0,0.5577,0.5615,0.5578,0.5615
2023-05-04 15:25,588,376,212,48890,31809,17081,27373308.0,17785254.0,9588053.0,585,373,212,48916,31677,17239,27388257.0,17710525.0,9677732.0,0.5591,0.5613,0.5591,0.5614
2023-05-04 15:30,1184,663,521,113557,67254,46303,88804605.0,62859499.0,25945105.0,1172,660,512,113554,67493,46061,88804623.0,62993788.0,25810835.0,0.9347,0.5603,0.9333,0.5604
2023-05-04 15:35,1551,1067,484,181053,146058,34995,126347364.0,106653874.0,19693490.0,1548,1067,481,180812,145947,34865,126217867.0,106591713.0,19626154.0,0.7302,0.5628,0.7303,0.5629
2023-05-04 15:40,967,739,228,111682,97749,13933,87600394.0,79774267.0,7826127.0,962,736,226,111285,97236,14049,87379323.0,79488210.0,7891113.0,0.8161,0.5617,0.8175,0.5617
2023-05-04 15:45,1683,1425,258,177659,157094,20565,99106037.0,87585666.0,11520371.0,1674,1419,255,177357,157101,20256,98934074.0,87587531.0,11346543.0,0.5575,0.5602,0.5575,0.5602
2023-05-04 15:50,1772,1552,220,174467,156343,18124,97312604.0,87159413.0,10153190.0,1766,1548,218,174421,156154,18267,97287131.0,87053788.0,10233343.0,0.5575,0.5602,0.5575,0.5602
2023-05-04 15:55,1496,1329,167,115777,107889,7888,64484335.0,60063052.0,4421283.0,1497,1331,166,115637,107817,7820,64483395.0,60099964.0,4383430.0,0.5567,0.5605,0.5574,0.5605
2023-05-04 16:00,950,804,146,95319,86876,8443,53135577.0,48409309.0,4726267.0,943,800,143,95539,87124,8415,53182667.0,48469997.0,4712670.0,0.5572,0.5598,0.5563,0.56
2023-05-04 16:05,1410,1099,311,165640,135686,29954,92367946.0,75586851.0,16781095.0,1401,1096,305,165628,135631,29997,92364139.0,75555916.0,16808223.0,0.5571,0.5602,0.5571,0.5603
2023-05-04 16:10,225,140,85,18225,11600,6625,10183593.0,6468258.0,3715335.0,219,137,82,18211,11635,6576,10175619.0,6487857.0,3687762.0,0.5576,0.5608,0.5576,0.5608
2023-05-04 16:15,731,541,190,65419,48486,16933,36513558.0,27034739.0,9478818.0,724,538,186,65078,48221,16857,36325938.0,26887327.0,9438610.0,0.5576,0.5598,0.5576,0.5599
2023-05-04 16:20,176,97,79,15610,8603,7007,8714882.0,4793014.0,3921868.0,173,94,79,15726,8757,6969,8779162.0,4878757.0,3900404.0,0.5571,0.5597,0.5571,0.5597
2023-05-04 16:25,166,105,61,13369,9923,3446,7468568.0,5535384.0,1933184.0,162,104,58,13325,9895,3430,7443728.0,5519441.0,1924286.0,0.5578,0.561,0.5578,0.561
2023-05-04 16:30,342,281,61,28195,25902,2293,15732842.0,14448354.0,1284487.0,336,277,59,27751,25580,2171,15484504.0,14268267.0,1216237.0,0.5578,0.5602,0.5578,0.5602
2023-05-04 16:35,141,87,54,9341,7411,1930,5217555.0,4133844.0,1083710.0,133,84,49,9012,7243,1769,5033069.0,4039575.0,993493.0,0.5578,0.5615,0.5577,0.5616
2023-05-04 16:40,153,97,56,12662,9261,3401,7080861.0,5174038.0,1906823.0,148,95,53,11396,9190,2206,6371666.0,5134104.0,1237561.0,0.5587,0.5607,0.5587,0.561
2023-05-04 16:45,116,67,49,7828,5127,2701,4380624.0,2863516.0,1517108.0,112,62,50,8906,5086,3820,4986486.0,2840130.0,2146356.0,0.5585,0.5617,0.5584,0.5619
2023-05-04 16:50,17,12,5,681,614,67,381142.0,343571.0,37571.0,15,11,4,676,612,64,378153.0,342262.0,35891.0,0.5596,0.5608,0.5593,0.5608
2023-05-04 16:55,73,39,34,4733,2949,1784,2652474.0,1659057.0,993416.0,65,34,31,4445,2758,1687,2487787.0,1541404.0,946383.0,0.5626,0.5568,0.5589,0.561
2023-05-04 17:00,52,42,10,4353,4030,323,2430620.0,2248010.0,182610.0,48,38,10,4287,3964,323,2393885.0,2211324.0,182561.0,0.5578,0.5654,0.5579,0.5652
2023-05-04 17:05,202,116,86,13062,9334,3728,7289962.0,5201861.0,2088101.0,196,110,86,13683,9372,4311,7644001.0,5223139.0,2420862.0,0.5573,0.5601,0.5573,0.5616
2023-05-04 17:10,365,261,104,26769,18705,8064,14982477.0,10457775.0,4524701.0,383,261,122,29321,19449,9872,16440301.0,10870164.0,5570136.0,0.5591,0.5611,0.5589,0.5642
2023-05-04 17:15,1146,526,620,93577,47110,46467,77473656.0,51542259.0,25931397.0,1131,513,618,92042,46211,45831,76673553.0,51042438.0,25631114.0,1.0941,0.5581,1.1046,0.5593
2023-05-04 17:20,1005,423,582,89719,49963,39756,50028429.0,27786321.0,22242107.0,998,421,577,89669,49983,39686,50000261.0,27797104.0,22203156.0,0.5561,0.5595,0.5561,0.5595
2023-05-04 17:25,701,282,419,70460,29422,41038,64542474.0,41663250.0,22879224.0,679,271,408,61156,28359,32797,59378379.0,41072729.0,18305650.0,1.4161,0.5575,1.4483,0.5582
2023-05-04 17:30,439,303,136,30152,20495,9657,42054950.0,36675678.0,5379271.0,403,288,115,28900,19811,9089,41369797.0,36298188.0,5071609.0,1.7895,0.557,1.8322,0.558
2023-05-04 17:35,612,441,171,49537,32185,17352,78133885.0,68468505.0,9665380.0,583,422,161,48727,31204,17523,77662915.0,67911722.0,9751193.0,2.1273,0.557,2.1764,0.5565
2023-05-04 17:40,213,159,54,8438,5271,3167,4672484.0,2913083.0,1759400.0,195,144,51,7768,4767,3001,4302105.0,2634576.0,1667528.0,0.5527,0.5555,0.5527,0.5557
2023-05-04 17:45,186,102,84,8969,3807,5162,4980505.0,2102511.0,2877993.0,171,92,79,9249,3400,5849,5149966.0,1876941.0,3273025.0,0.5523,0.5575,0.552,0.5596
2023-05-04 17:50,84,62,22,4043,2601,1442,2253647.0,1440142.0,813505.0,75,56,19,3737,2008,1729,2089100.0,1109646.0,979454.0,0.5537,0.5642,0.5526,0.5665
2023-05-04 17:55,79,38,41,7231,1193,6038,4015832.0,657742.0,3358090.0,63,30,33,8905,984,7921,4958461.0,543331.0,4415130.0,0.5513,0.5562,0.5522,0.5574
2023-05-04 18:00,61,36,25,2269,863,1406,1254953.0,474437.0,780516.0,45,25,20,3246,1858,1388,1778382.0,1007529.0,770853.0,0.5498,0.5551,0.5423,0.5554
2023-05-04 18:05,416,153,263,14922,7435,7487,84156982.0,80013906.0,4143076.0,373,121,252,14720,6871,7849,84020068.0,79669667.0,4350400.0,10.7618,0.5534,11.5951,0.5543
2023-05-04 18:10,296,78,218,3892,2043,1849,2147610.0,1125048.0,1022562.0,279,64,215,4101,1675,2426,2263974.0,921941.0,1342032.0,0.5507,0.553,0.5504,0.5532
2023-05-04 18:15,372,330,42,19303,17665,1638,10644373.0,9740034.0,904338.0,353,319,34,18854,17548,1306,10398742.0,9674249.0,724493.0,0.5514,0.5521,0.5513,0.5547
2023-05-04 18:20,182,118,64,10103,6394,3709,30882045.0,28835605.0,2046440.0,147,96,51,7793,5601,2192,29613608.0,28395215.0,1218393.0,4.5098,0.5517,5.0697,0.5558
2023-05-04 18:25,518,207,311,45055,5669,39386,24966047.0,3163454.0,21802593.0,450,155,295,43771,4766,39005,24205572.0,2621589.0,21583983.0,0.558,0.5536,0.5501,0.5534
2023-05-04 18:30,1673,429,1244,199781,8651,191130,186253835.0,80689990.0,105563844.0,1598,353,1245,200854,7470,193384,186919785.0,80038836.0,106880948.0,9.3272,0.5523,10.7147,0.5527
2023-05-04 18:35,691,149,542,99541,4792,94749,105624765.0,53256317.0,52368448.0,666,132,534,100058,5720,94338,105892678.0,53744147.0,52148531.0,11.1136,0.5527,9.3958,0.5528
2023-05-05 10:00,1813,915,898,100795,47307,53488,99573676.0,69761861.0,29811814.0,1500,786,714,78436,32015,46421,72011775.0,46414940.0,25596835.0,1.4747,0.5574,1.4498,0.5514
2023-05-05 10:05,1642,793,849,110864,52184,58680,86551906.0,53970955.0,32580950.0,1545,736,809,110754,52477,58277,76694004.0,44297816.0,32396188.0,1.0342,0.5552,0.8441,0.5559
2023-05-05 10:10,3267,1171,2096,386518,69799,316719,291213670.0,114522635.0,176691034.0,3179,1121,2058,382842,67776,315066,289094531.0,113352773.0,175741758.0,1.6407,0.5579,1.6725,0.5578
2023-05-05 10:15,3725,2052,1673,313321,176272,137049,198766870.0,122565503.0,76201367.0,3649,2010,1639,305471,174545,130926,194338191.0,121592873.0,72745318.0,0.6953,0.556,0.6966,0.5556
2023-05-05 10:20,1384,819,565,139271,80722,58549,152797597.0,120287006.0,32510590.0,1320,776,544,135255,77278,57977,150607331.0,118407275.0,32200056.0,1.4901,0.5553,1.5322,0.5554
2023-05-05 10:25,1986,1438,548,244415,178603,65812,134959121.0,98388314.0,36570806.0,1953,1417,536,244032,178043,65989,134754093.0,98076507.0,36677585.0,0.5509,0.5557,0.5509,0.5558
2023-05-05 10:30,1781,1374,407,181947,140852,41095,100451084.0,77513341.0,22937743.0,1671,1332,339,179044,140720,38324,98720968.0,77445612.0,21275355.0,0.5503,0.5582,0.5504,0.5551
2023-05-05 10:35,970,584,386,82330,56500,25830,45374128.0,31038253.0,14335875.0,911,570,341,81568,56133,25435,44946715.0,30833762.0,14112953.0,0.5493,0.555,0.5493,0.5549
2023-05-05 10:40,766,222,544,47610,14779,32831,26381351.0,8178160.0,18203191.0,748,205,543,48681,14705,33976,26965818.0,8126049.0,18839768.0,0.5534,0.5545,0.5526,0.5545
2023-05-05 10:45,1878,1444,434,247924,198984,48940,213170079.0,185929823.0,27240255.0,1837,1417,420,245897,197151,48746,212027155.0,184890518.0,27136636.0,0.9344,0.5566,0.9378,0.5567
2023-05-05 10:50,399,295,104,26153,18649,7504,14506456.0,10323513.0,4182943.0,389,290,99,26438,19092,7346,14654258.0,10559310.0,4094948.0,0.5536,0.5574,0.5531,0.5574
2023-05-05 10:55,2189,1560,629,235206,192775,42431,460069676.0,436311117.0,23758558.0,2072,1511,561,231436,191347,40089,457986039.0,435495262.0,22490777.0,2.2633,0.5599,2.2759,0.561
2023-05-05 11:00,2587,1244,1343,337034,222177,114857,365039897.0,300718877.0,64321020.0,2541,1217,1324,335408,220898,114510,364154491.0,299990320.0,64164170.0,1.3535,0.56,1.358,0.5603
2023-05-05 11:05,3206,1083,2123,371565,142789,228776,232498688.0,104638255.0,127860432.0,3171,1067,2104,369395,142865,226530,231309148.0,104668791.0,126640356.0,0.7328,0.5589,0.7326,0.559
2023-05-05 11:10,3417,438,2979,453509,17530,435979,253498816.0,9733237.0,243765578.0,3404,429,2975,452494,17367,435127,252886660.0,9643918.0,243242742.0,0.5552,0.5591,0.5553,0.559
2023-05-05 11:15,2221,783,1438,246092,40753,205339,213462699.0,98617799.0,114844900.0,2182,762,1420,243484,37975,205509,212034872.0,97074643.0,114960228.0,2.4199,0.5593,2.5563,0.5594
2023-05-05 11:20,417,214,203,30571,9195,21376,17116808.0,5132280.0,11984527.0,390,199,191,30134,9022,21112,16869606.0,5031566.0,11838039.0,0.5582,0.5607,0.5577,0.5607
2023-05-05 11:25,197,118,79,12539,5224,7315,7101343.0,2910372.0,4190971.0,182,118,64,11109,5415,5694,6203593.0,3017280.0,3186312.0,0.5571,0.5729,0.5572,0.5596
2023-05-05 11:30,951,757,194,71980,53590,18390,40069296.0,29795465.0,10273830.0,931,742,189,72570,54053,18517,40400097.0,30052782.0,10347314.0,0.556,0.5587,0.556,0.5588
2023-05-05 11:35,1126,984,142,100281,86218,14063,55779630.0,47925281.0,7854349.0,1143,989,154,100558,86482,14076,55932360.0,48070323.0,7862036.0,0.5559,0.5585,0.5558,0.5585
2023-05-05 11:40,1547,1316,231,114432,96334,18098,88945363.0,78836817.0,10108546.0,1515,1306,209,114066,95963,18103,88745580.0,78632809.0,10112770.0,0.8184,0.5585,0.8194,0.5586
2023-05-05 11:45,3020,1400,1620,337502,122625,214877,415599715.0,295746674.0,119853040.0,2928,1349,1579,329144,118260,210884,410991980.0,293329487.0,117662492.0,2.4118,0.5578,2.4804,0.5579
2023-05-05 11:50,4355,2742,1613,539856,393513,146343,783224848.0,701095243.0,82129605.0,3788,2380,1408,508138,376818,131320,765032907.0,691179236.0,73853671.0,1.7816,0.5612,1.8343,0.5624
2023-05-05 11:55,2981,1645,1336,309529,214130,95399,274270568.0,220881025.0,53389543.0,2808,1582,1226,306396,213059,93337,272744782.0,220236223.0,52508558.0,1.0315,0.5596,1.0337,0.5626
2023-05-05 12:00,1865,1299,566,200125,166619,33506,111524722.0,92756142.0,18768580.0,1779,1262,517,195780,164867,30913,109117543.0,91766143.0,17351400.0,0.5567,0.5602,0.5566,0.5613
2023-05-05 12:05,1616,1271,345,199867,183368,16499,137005076.0,127746112.0,9258963.0,1547,1228,319,195855,180644,15211,134660593.0,126105514.0,8555078.0,0.6967,0.5612,0.6981,0.5624
2023-05-05 12:10,2681,2472,209,310080,300191,9889,325597632.0,320020786.0,5576845.0,2592,2436,156,305009,296506,8503,322611134.0,317803378.0,4807756.0,1.0661,0.5639,1.0718,0.5654
2023-05-05 12:15,2182,1779,403,275029,252416,22613,204906459.0,192180898.0,12725561.0,2068,1739,329,268405,249498,18907,201138770.0,190477272.0,10661498.0,0.7614,0.5628,0.7634,0.5639
2023-05-05 12:20,1559,1113,446,165869,138628,27241,270862498.0,255435965.0,15426533.0,1420,1057,363,159553,134307,25246,267239721.0,252840287.0,14399434.0,1.8426,0.5663,1.8826,0.5704
2023-05-05 12:25,1631,899,732,161597,106675,54922,91406738.0,60249875.0,31156862.0,1516,867,649,158576,106455,52121,89712921.0,60092911.0,29620010.0,0.5648,0.5673,0.5645,0.5683
2023-05-05 12:30,2059,768,1291,163074,56818,106256,193020081.0,133209697.0,59810384.0,1948,697,1251,157714,54910,102804,190177658.0,132102552.0,58075105.0,2.3445,0.5629,2.4058,0.5649
2023-05-05 12:35,1535,660,875,144881,41706,103175,157422972.0,99380821.0,58042150.0,1388,580,808,140313,37627,102686,154997875.0,97029018.0,57968856.0,2.3829,0.5626,2.5787,0.5645
2023-05-05 12:40,2130,799,1331,229670,55500,174170,180372961.0,81823343.0,98549617.0,2090,778,1312,229456,55946,173510,180304053.0,82071301.0,98232752.0,1.4743,0.5658,1.467,0.5662
2023-05-05 12:45,2443,738,1705,281941,73296,208645,613650927.0,496589593.0,117061334.0,2296,658,1638,268218,67848,200370,606207601.0,493522525.0,112685075.0,6.7751,0.5611,7.2739,0.5624
2023-05-05 12:50,1093,211,882,174908,11209,163699,123707129.0,31586496.0,92120633.0,1048,190,858,172917,10860,162057,122592431.0,31386209.0,91206222.0,2.818,0.5627,2.8901,0.5628
2023-05-05 12:55,758,368,390,46728,15378,31350,51534755.0,33921384.0,17613371.0,738,355,383,45819,14958,30861,51047593.0,33681361.0,17366232.0,2.2058,0.5618,2.2517,0.5627
2023-05-05 13:00,2081,269,1812,280150,14248,265902,157573676.0,7958009.0,149615666.0,2059,258,1801,279716,14498,265218,157308023.0,8099142.0,149208881.0,0.5585,0.5627,0.5586,0.5626
2023-05-05 13:05,1044,193,851,114876,11501,103375,64553628.0,6430412.0,58123215.0,1030,182,848,113955,10839,103116,64075855.0,6057374.0,58018480.0,0.5591,0.5623,0.5588,0.5627
2023-05-05 13:10,1316,759,557,138173,60272,77901,127983241.0,84290276.0,43692965.0,1287,741,546,136768,59459,77309,127279265.0,83836580.0,43442684.0,1.3985,0.5609,1.41,0.5619
2023-05-05 13:15,3071,796,2275,439539,73608,365931,296465888.0,91632198.0,204833689.0,3048,781,2267,437730,73229,364501,295514809.0,91420106.0,204094702.0,1.2449,0.5598,1.2484,0.5599
2023-05-05 13:20,1342,207,1135,168242,13509,154733,94217357.0,7526354.0,86691003.0,1317,196,1121,167824,13105,154719,93978860.0,7292603.0,86686257.0,0.5571,0.5603,0.5565,0.5603
2023-05-05 13:25,99,45,54,7846,2259,5587,4404660.0,1257706.0,3146954.0,99,45,54,7028,2721,4307,3922386.0,1513925.0,2408461.0,0.5568,0.5633,0.5564,0.5592
2023-05-05 13:30,1694,326,1368,227659,31239,196420,178005995.0,68090174.0,109915821.0,1675,311,1364,228622,30145,198477,178528932.0,67424929.0,111104002.0,2.1797,0.5596,2.2367,0.5598
2023-05-05 13:35,843,505,338,87585,40234,47351,74249503.0,47754216.0,26495287.0,829,501,328,86939,39984,46955,73888883.0,47613005.0,26275877.0,1.1869,0.5596,1.1908,0.5596
2023-05-05 13:40,824,484,340,76724,36754,39970,68142759.0,45793240.0,22349518.0,796,466,330,75545,36261,39284,67495581.0,45519245.0,21976335.0,1.2459,0.5592,1.2553,0.5594
2023-05-05 13:45,904,258,646,85346,21074,64272,47676417.0,11740151.0,35936265.0,882,242,640,85492,20381,65111,47755775.0,11347709.0,36408065.0,0.5571,0.5591,0.5568,0.5592
2023-05-05 13:50,595,386,209,42070,17657,24413,48873952.0,35183623.0,13690329.0,575,376,199,38468,17029,21439,46836665.0,34820986.0,12015679.0,1.9926,0.5608,2.0448,0.5605
2023-05-05 13:55,383,281,102,26277,19967,6310,14673622.0,11151223.0,3522398.0,370,278,92,27535,20032,7503,15394839.0,11185788.0,4209051.0,0.5585,0.5582,0.5584,0.561
2023-05-05 14:00,647,208,439,57808,18734,39074,32322359.0,10444995.0,21877364.0,643,205,438,58485,18805,39680,32719458.0,10484649.0,22234809.0,0.5575,0.5599,0.5575,0.5604
2023-05-05 14:05,500,190,310,35709,17963,17746,19924748.0,9998826.0,9925922.0,490,182,308,35015,17431,17584,19539568.0,9704449.0,9835118.0,0.5566,0.5593,0.5567,0.5593
2023-05-05 14:10,219,70,149,15059,3163,11896,8376674.0,1764268.0,6612406.0,229,69,160,14426,3135,11291,8068045.0,1749691.0,6318353.0,0.5578,0.5559,0.5581,0.5596
2023-05-05 14:15,270,111,159,19183,6782,12401,10787451.0,3841242.0,6946209.0,214,83,131,18064,5316,12748,10130075.0,2968917.0,7161158.0,0.5664,0.5601,0.5585,0.5617
2023-05-05 14:20,211,115,96,16039,7223,8816,9003454.0,4063321.0,4940132.0,177,91,86,15173,6772,8401,8496822.0,3783244.0,4713577.0,0.5626,0.5604,0.5587,0.5611
2023-05-05 14:25,702,403,299,68757,30498,38259,38515712.0,17048664.0,21467048.0,694,393,301,68015,29974,38041,38099986.0,16754048.0,21345938.0,0.559,0.5611,0.559,0.5611
2023-05-05 14:30,1404,557,847,164728,45184,119544,117788783.0,50604960.0,67183823.0,1371,537,834,162893,45064,117829,116732727.0,50530025.0,66202702.0,1.12,0.562,1.1213,0.5619
2023-05-05 14:35,658,372,286,62400,33246,29154,34983642.0,18614907.0,16368735.0,641,360,281,61811,32568,29243,34631964.0,18211767.0,16420197.0,0.5599,0.5615,0.5592,0.5615
2023-05-05 14:40,697,382,315,83847,35439,48408,47064021.0,19842989.0,27221032.0,682,372,310,83662,35324,48338,46946607.0,19766824.0,27179782.0,0.5599,0.5623,0.5596,0.5623
2023-05-05 14:45,592,342,250,63739,29728,34011,61322221.0,42188954.0,19133267.0,570,327,243,58147,26052,32095,57962630.0,39907228.0,18055401.0,1.4192,0.5626,1.5318,0.5626
2023-05-05 14:50,1029,409,620,110959,29421,81538,62387015.0,16506345.0,45880670.0,1002,399,603,109412,29157,80255,61509601.0,16343556.0,45166044.0,0.561,0.5627,0.5605,0.5628
2023-05-05 14:55,477,164,313,51257,11177,40080,28806402.0,6256473.0,22549928.0,470,159,311,51086,11123,39963,28710306.0,6226387.0,22483919.0,0.5598,0.5626,0.5598,0.5626
2023-05-05 15:00,1175,579,596,112384,43505,68879,63248610.0,24410082.0,38838527.0,1117,534,583,110680,42315,68365,62204137.0,23702775.0,38501362.0,0.5611,0.5639,0.5602,0.5632
2023-05-05 15:05,561,445,116,36571,32288,4283,20546551.0,18143735.0,2402816.0,519,435,84,34737,32255,2482,19500728.0,18098220.0,1402508.0,0.5619,0.561,0.5611,0.5651
2023-05-05 15:10,470,348,122,31158,25248,5910,17515169.0,14178481.0,3336688.0,453,337,116,32557,24987,7570,18332000.0,14024934.0,4307066.0,0.5616,0.5646,0.5613,0.569
2023-05-05 15:15,758,592,166,35214,30546,4668,19774418.0,17147429.0,2626989.0,739,583,156,34379,30413,3966,19308220.0,17073297.0,2234923.0,0.5614,0.5628,0.5614,0.5635
2023-05-05 15:20,380,258,122,27391,19551,7840,15455512.0,11008135.0,4447377.0,351,242,109,22930,18295,4635,12898475.0,10269509.0,2628965.0,0.563,0.5673,0.5613,0.5672
2023-05-05 15:25,276,139,137,14041,8681,5360,7890657.0,4875051.0,3015605.0,253,128,125,13328,8181,5147,7493267.0,4592966.0,2900301.0,0.5616,0.5626,0.5614,0.5635
2023-05-05 15:30,179,121,58,11415,8211,3204,6431195.0,4612240.0,1818955.0,158,106,52,11376,8945,2431,6399299.0,5018408.0,1380890.0,0.5617,0.5677,0.561,0.568
2023-05-05 15:35,363,236,127,23886,18893,4993,13478199.0,10595757.0,2882442.0,346,228,118,21679,17912,3767,12181287.0,10050625.0,2130662.0,0.5608,0.5773,0.5611,0.5656
2023-05-05 15:40,613,169,444,55922,10275,45647,31337754.0,5756146.0,25581608.0,592,154,438,54637,9774,44863,30719679.0,5476483.0,25243196.0,0.5602,0.5604,0.5603,0.5627
2023-05-05 15:45,936,477,459,98514,48499,50015,55388484.0,27241417.0,28147067.0,924,477,447,97809,48204,49605,54910484.0,26992959.0,27917524.0,0.5617,0.5628,0.56,0.5628
2023-05-05 15:50,468,388,80,51462,47866,3596,28833166.0,26808124.0,2025041.0,450,378,72,49424,46063,3361,27691552.0,25798537.0,1893015.0,0.5601,0.5631,0.5601,0.5632
2023-05-05 15:55,542,414,128,44678,38826,5852,25040993.0,21755307.0,3285686.0,510,404,106,43733,38668,5065,24517425.0,21667249.0,2850175.0,0.5603,0.5615,0.5603,0.5627
2023-05-05 16:00,590,234,356,63042,35867,27175,60614990.0,45369634.0,15245356.0,567,218,349,61108,34970,26138,59580826.0,44868675.0,14712151.0,1.2649,0.561,1.2831,0.5629
2023-05-05 16:05,764,251,513,56046,12351,43695,31438987.0,6914381.0,24524606.0,752,242,510,58371,12658,45713,32737785.0,7068977.0,25668807.0,0.5598,0.5613,0.5585,0.5615
2023-05-05 16:10,1274,644,630,110960,58204,52756,62133984.0,32521258.0,29612725.0,1261,634,627,107890,57109,50781,60419745.0,31908989.0,28510755.0,0.5587,0.5613,0.5587,0.5614
2023-05-05 16:15,1206,489,717,103045,45647,57398,57690959.0,25497036.0,32193923.0,1191,483,708,102515,45204,57311,57408082.0,25253077.0,32155005.0,0.5586,0.5609,0.5586,0.5611
2023-05-05 16:20,466,312,154,27400,15173,12227,15316237.0,8464261.0,6851976.0,454,305,149,27630,15412,12218,15444847.0,8592645.0,6852202.0,0.5579,0.5604,0.5575,0.5608
2023-05-05 16:25,2323,567,1756,351940,41176,310764,298045513.0,124205698.0,173839815.0,2286,549,1737,347951,40443,307508,296115509.0,123798150.0,172317359.0,3.0165,0.5594,3.0611,0.5604
2023-05-05 16:30,7840,4372,3468,1132371,690925,441446,1135540177.0,889305083.0,246235094.0,7723,4294,3429,1123244,686146,437098,1130708565.0,886541780.0,244166785.0,1.2871,0.5578,1.2921,0.5586
2023-05-05 16:35,6013,3846,2167,799807,612235,187572,443800834.0,339113250.0,104687584.0,5994,3830,2164,798341,611415,186926,442986978.0,338659837.0,104327140.0,0.5539,0.5581,0.5539,0.5581
2023-05-05 16:40,2887,1781,1106,305505,227792,77713,219993812.0,176706474.0,43287338.0,2875,1775,1100,306122,227368,78754,220438029.0,176471187.0,43966842.0,0.7757,0.557,0.7761,0.5583
2023-05-05 16:45,2246,615,1631,182652,70345,112307,101533804.0,38933666.0,62600137.0,2252,613,1639,181448,69424,112024,100867418.0,38422884.0,62444534.0,0.5535,0.5574,0.5535,0.5574
2023-05-05 16:50,2910,1125,1785,297102,166243,130859,164955214.0,91982299.0,72972915.0,2883,1115,1768,296436,165718,130718,164589492.0,91692564.0,72896928.0,0.5533,0.5576,0.5533,0.5577
2023-05-05 16:55,2696,1323,1373,308794,188820,119974,171449280.0,104542997.0,66906283.0,2680,1309,1371,308441,188375,120066,171280063.0,104295844.0,66984219.0,0.5537,0.5577,0.5537,0.5579
2023-05-05 17:00,1748,558,1190,183110,70880,112230,101859321.0,39253141.0,62606179.0,1739,555,1184,183036,71156,111880,101818277.0,39402583.0,62415693.0,0.5538,0.5578,0.5537,0.5579
2023-05-05 17:05,1116,374,742,105927,42386,63541,58924887.0,23482894.0,35441992.0,1107,368,739,105537,42255,63282,58708593.0,23409918.0,35298675.0,0.554,0.5578,0.554,0.5578
2023-05-05 17:10,607,234,373,60961,23782,37179,59229756.0,38480787.0,20748969.0,590,224,366,61140,23653,37487,59353705.0,38414766.0,20938939.0,1.6181,0.5581,1.6241,0.5586
2023-05-05 17:15,109,64,45,7115,5098,2017,3946862.0,2823235.0,1123626.0,95,55,40,6278,4254,2024,3480517.0,2351771.0,1128745.0,0.5538,0.5571,0.5528,0.5577
2023-05-05 17:20,33,19,14,2871,1289,1582,1597589.0,718913.0,878675.0,24,14,10,2015,1327,688,1117989.0,735095.0,382894.0,0.5577,0.5554,0.554,0.5565
2023-05-05 17:25,162,115,47,13749,9791,3958,7789105.0,5500803.0,2288301.0,145,106,39,11067,8542,2525,6134296.0,4728191.0,1406105.0,0.5618,0.5781,0.5535,0.5569
2023-05-05 17:30,404,139,265,33166,9481,23685,43756087.0,30566730.0,13189357.0,393,131,262,33121,9790,23331,43745982.0,30736999.0,13008983.0,3.224,0.5569,3.1396,0.5576
2023-05-05 17:35,495,177,318,43637,11683,31954,24291687.0,6474804.0,17816882.0,489,174,315,43547,11383,32164,24242647.0,6308089.0,17934558.0,0.5542,0.5576,0.5542,0.5576
2023-05-05 17:40,1288,202,1086,141981,12719,129262,79200552.0,7055662.0,72144890.0,1286,200,1086,142828,13721,129107,79660772.0,7600471.0,72060300.0,0.5547,0.5581,0.5539,0.5581
2023-05-05 17:45,1739,262,1477,209613,18169,191444,116895994.0,10069175.0,106826818.0,1734,259,1475,209162,18070,191092,116646102.0,10013521.0,106632580.0,0.5542,0.558,0.5542,0.558
2023-05-05 17:50,333,129,204,28708,7725,20983,16021467.0,4293702.0,11727765.0,324,123,201,28602,7646,20956,15951362.0,4238751.0,11712611.0,0.5558,0.5589,0.5544,0.5589
2023-05-05 17:55,360,154,206,26704,11249,15455,14861008.0,6227336.0,8633671.0,353,149,204,26728,11181,15547,14883440.0,6189701.0,8693739.0,0.5536,0.5586,0.5536,0.5592
2023-05-05 18:00,667,241,426,51642,16655,34987,28781429.0,9213539.0,19567889.0,662,237,425,51896,17136,34760,28899206.0,9460542.0,19438663.0,0.5532,0.5593,0.5521,0.5592
2023-05-05 18:05,419,87,332,46723,6330,40393,26072615.0,3515452.0,22557163.0,408,80,328,46909,6381,40528,26167934.0,3533969.0,22633965.0,0.5554,0.5584,0.5538,0.5585
2023-05-05 18:10,876,524,352,91392,56158,35234,76279861.0,56589088.0,19690773.0,829,497,332,89022,54335,34687,74901173.0,55491295.0,19409878.0,1.0077,0.5589,1.0213,0.5596
2023-05-05 18:15,796,480,316,75117,46460,28657,41826749.0,25812221.0,16014528.0,779,466,313,74830,46319,28511,41655950.0,25723669.0,15932280.0,0.5556,0.5588,0.5554,0.5588
2023-05-05 18:20,689,328,361,60321,30070,30251,33617400.0,16705499.0,16911900.0,671,322,349,60162,30207,29955,33524647.0,16778209.0,16746438.0,0.5556,0.5591,0.5554,0.5591
2023-05-05 18:25,272,205,67,26497,22043,4454,14736588.0,12247841.0,2488746.0,261,201,60,26562,21875,4687,14771898.0,12150651.0,2621247.0,0.5556,0.5588,0.5555,0.5593
2023-05-05 18:30,391,287,104,41509,32592,8917,23072241.0,18087380.0,4984861.0,400,286,114,41006,32472,8534,22785326.0,18013802.0,4771524.0,0.555,0.559,0.5547,0.5591
2023-05-05 18:35,318,229,89,19265,12059,7206,10739946.0,6719686.0,4020260.0,307,220,87,20515,13096,7419,11427143.0,7278807.0,4148335.0,0.5572,0.5579,0.5558,0.5592
2023-05-08 10:00,6087,2598,3489,632230,264153,368077,403314828.0,197255174.0,206059654.0,5787,2470,3317,609886,250601,359285,373790197.0,173077711.0,200712485.0,0.7467,0.5598,0.6907,0.5586
2023-05-08 10:05,3208,1114,2094,296641,89143,207498,165385579.0,49416754.0,115968824.0,3138,1069,2069,295867,88164,207703,164959742.0,48886858.0,116072883.0,0.5544,0.5589,0.5545,0.5588
2023-05-08 10:10,1672,698,974,165806,53428,112378,92504924.0,29644427.0,62860497.0,1639,676,963,165251,53311,111940,92280496.0,29588589.0,62691907.0,0.5548,0.5594,0.555,0.56
2023-05-08 10:15,1022,510,512,91874,43164,48710,76425531.0,49226501.0,27199030.0,952,491,461,91281,42700,48581,68146221.0,41015068.0,27131153.0,1.1405,0.5584,0.9605,0.5585
2023-05-08 10:20,1826,987,839,171995,92767,79228,146084532.0,101836208.0,44248324.0,1797,973,824,171184,92601,78583,145637079.0,101743305.0,43893774.0,1.0978,0.5585,1.0987,0.5586
2023-05-08 10:25,648,251,397,68025,21107,46918,37871842.0,11647763.0,26224079.0,630,239,391,66607,20837,45770,37084485.0,11498761.0,25585724.0,0.5518,0.5589,0.5518,0.559
2023-05-08 10:30,1498,843,655,113534,76231,37303,88007317.0,67338034.0,20669282.0,1453,808,645,112338,75751,36587,87395049.0,67072742.0,20322307.0,0.8833,0.5541,0.8854,0.5555
2023-05-08 10:35,486,359,127,33041,24374,8667,18238431.0,13425932.0,4812499.0,450,335,115,32353,23828,8525,17851006.0,13118095.0,4732910.0,0.5508,0.5553,0.5505,0.5552
2023-05-08 10:40,1545,1096,449,152342,105341,47001,84198261.0,58040902.0,26157359.0,1457,1050,407,151615,104786,46829,83790858.0,57747298.0,26043560.0,0.551,0.5565,0.5511,0.5561
2023-05-08 10:45,411,206,205,36096,15236,20860,20010058.0,8402420.0,11607638.0,398,198,200,35526,14817,20709,19698364.0,8179991.0,11518373.0,0.5515,0.5565,0.5521,0.5562
2023-05-08 10:50,170,70,100,14860,4131,10729,8245931.0,2282807.0,5963124.0,164,67,97,14851,4195,10656,8242040.0,2318289.0,5923750.0,0.5526,0.5558,0.5526,0.5559
2023-05-08 10:55,289,139,150,32124,15832,16292,17783084.0,8727038.0,9056046.0,281,135,146,31576,15460,16116,17485913.0,8524572.0,8961341.0,0.5512,0.5559,0.5514,0.5561
2023-05-08 11:00,471,162,309,46975,16809,30166,51365202.0,34580373.0,16784828.0,455,148,307,46756,16701,30055,51244072.0,34521854.0,16722218.0,2.0573,0.5564,2.0671,0.5564
2023-05-08 11:05,889,637,252,111944,89481,22463,239416441.0,226876487.0,12539953.0,849,612,237,108759,87029,21730,237461719.0,225332518.0,12129200.0,2.5355,0.5582,2.5892,0.5582
2023-05-08 11:10,1225,1066,159,161429,150521,10908,342782886.0,336673111.0,6109774.0,1221,1078,143,160830,150290,10540,342448946.0,336542558.0,5906388.0,2.2367,0.5601,2.2393,0.5604
2023-05-08 11:15,1415,1212,203,168365,154537,13828,118803954.0,111074740.0,7729213.0,1385,1188,197,167551,154171,13380,118362450.0,110869035.0,7493414.0,0.7188,0.559,0.7191,0.56
2023-05-08 11:20,2366,1962,404,269081,240358,28723,301440394.0,285340144.0,16100250.0,2346,1952,394,268861,240150,28711,301326820.0,285232093.0,16094727.0,1.1871,0.5605,1.1877,0.5606
2023-05-08 11:25,872,710,162,95474,84202,11272,53046028.0,46733876.0,6312151.0,866,708,158,95584,84388,11196,53106251.0,46838086.0,6268165.0,0.555,0.56,0.555,0.5599
2023-05-08 11:30,1827,1705,122,226642,217733,8909,151110946.0,146099858.0,5011088.0,1819,1703,116,226467,217619,8848,151012377.0,146036736.0,4975641.0,0.671,0.5625,0.6711,0.5623
2023-05-08 11:35,1343,1165,178,166442,153814,12628,92441067.0,85342146.0,7098921.0,1329,1160,169,166290,153622,12668,92353892.0,85233255.0,7120636.0,0.5548,0.5622,0.5548,0.5621
2023-05-08 11:40,535,472,63,60462,55333,5129,33599002.0,30715444.0,2883558.0,527,465,62,60175,55045,5130,33439945.0,30555907.0,2884038.0,0.5551,0.5622,0.5551,0.5622
2023-05-08 11:45,210,181,29,17577,15906,1671,9787492.0,8841794.0,945697.0,205,181,24,17979,16386,1593,10006616.0,9109748.0,896867.0,0.5559,0.5659,0.5559,0.563
2023-05-08 11:50,762,501,261,65809,50830,14979,36592044.0,28206795.0,8385249.0,752,498,254,65497,50735,14762,36427518.0,28154542.0,8272976.0,0.5549,0.5598,0.5549,0.5604
2023-05-08 11:55,867,692,175,93284,88494,4790,51713727.0,49032801.0,2680925.0,854,685,169,92759,88005,4754,51423899.0,48763008.0,2660890.0,0.5541,0.5597,0.5541,0.5597
2023-05-08 12:00,655,594,61,72144,70938,1206,39988915.0,39315117.0,673797.0,650,589,61,72014,70808,1206,39918481.0,39244684.0,673797.0,0.5542,0.5587,0.5542,0.5587
2023-05-08 12:05,943,821,122,114848,110966,3882,63715161.0,61527176.0,2187984.0,938,819,119,114626,110856,3770,63582061.0,61465586.0,2116474.0,0.5545,0.5636,0.5545,0.5614
2023-05-08 12:10,388,323,65,45281,43241,2040,25099687.0,23966006.0,1133681.0,375,315,60,44596,42833,1763,24725165.0,23737006.0,988159.0,0.5542,0.5557,0.5542,0.5605
2023-05-08 12:15,50,28,22,3672,2593,1079,2038526.0,1433580.0,604945.0,46,24,22,3674,2575,1099,2039420.0,1423144.0,616276.0,0.5529,0.5607,0.5527,0.5608
2023-05-08 12:20,60,24,36,3051,816,2235,1700022.0,450813.0,1249209.0,43,17,26,3058,763,2295,1707126.0,421398.0,1285727.0,0.5525,0.5589,0.5523,0.5602
2023-05-08 12:25,232,175,57,26500,23630,2870,14703477.0,13100955.0,1602521.0,223,172,51,26438,23622,2816,14669238.0,13096730.0,1572508.0,0.5544,0.5584,0.5544,0.5584
2023-05-08 12:30,662,566,96,81183,78036,3147,45027786.0,43270373.0,1757413.0,645,562,83,81235,78110,3125,45054682.0,43309917.0,1744765.0,0.5545,0.5584,0.5545,0.5583
2023-05-08 12:35,669,518,151,78114,72254,5860,68653032.0,65385254.0,3267778.0,663,516,147,77595,71896,5699,68365807.0,65187019.0,3178788.0,0.9049,0.5576,0.9067,0.5578
2023-05-08 12:40,851,580,271,88959,79217,9742,49346327.0,43914848.0,5431478.0,835,569,266,88880,79098,9782,49310705.0,43854323.0,5456381.0,0.5544,0.5575,0.5544,0.5578
2023-05-08 12:45,833,654,179,73156,67151,6005,40591979.0,37244832.0,3347146.0,829,653,176,73347,67458,5889,40698378.0,37414970.0,3283407.0,0.5546,0.5574,0.5546,0.5575
2023-05-08 12:50,822,564,258,45863,35726,10137,25483581.0,19835104.0,5648477.0,821,563,258,46036,35799,10237,25579812.0,19874086.0,5705726.0,0.5552,0.5572,0.5552,0.5574
2023-05-08 12:55,782,397,385,64711,36597,28114,35975564.0,20312058.0,15663506.0,769,390,379,64468,36466,28002,35848484.0,20241188.0,15607296.0,0.555,0.5571,0.5551,0.5574
2023-05-08 13:00,890,484,406,70853,46265,24588,39363402.0,25666571.0,13696830.0,883,479,404,70801,46312,24489,39335007.0,25693311.0,13641695.0,0.5548,0.5571,0.5548,0.5571
2023-05-08 13:05,802,525,277,50163,28107,22056,27892709.0,15606304.0,12286404.0,802,526,276,50746,28652,22094,28217967.0,15910189.0,12307777.0,0.5552,0.5571,0.5553,0.5571
2023-05-08 13:10,763,425,338,65805,40804,25001,36536541.0,22610339.0,13926202.0,757,420,337,65366,40271,25095,36296406.0,22314117.0,13982288.0,0.5541,0.557,0.5541,0.5572
2023-05-08 13:15,982,564,418,84749,49580,35169,47059862.0,27449823.0,19610038.0,969,556,413,84225,49188,35037,46775973.0,27238106.0,19537866.0,0.5536,0.5576,0.5538,0.5576
2023-05-08 13:20,946,392,554,59741,32962,26779,33198556.0,18279971.0,14918585.0,942,391,551,59780,33005,26775,33223376.0,18303848.0,14919528.0,0.5546,0.5571,0.5546,0.5572
2023-05-08 13:25,906,414,492,61171,30855,30316,34013849.0,17121272.0,16892576.0,899,411,488,60804,30496,30308,33812557.0,16922517.0,16890039.0,0.5549,0.5572,0.5549,0.5573
2023-05-08 13:30,703,318,385,48407,21856,26551,26922547.0,12128251.0,14794295.0,704,319,385,48479,21799,26680,26961562.0,12095461.0,14866101.0,0.5549,0.5572,0.5549,0.5572
2023-05-08 13:35,786,492,294,59657,38336,21321,33116024.0,21233786.0,11882237.0,778,491,287,59409,38618,20791,32973754.0,21390997.0,11582757.0,0.5539,0.5573,0.5539,0.5571
2023-05-08 13:40,723,341,382,72280,41721,30559,40108605.0,23061555.0,17047050.0,719,337,382,72022,41688,30334,39963936.0,23042466.0,16921470.0,0.5528,0.5578,0.5527,0.5578
2023-05-08 13:45,677,335,342,68203,38424,29779,37873111.0,21233621.0,16639490.0,668,329,339,67135,38058,29077,37241189.0,21040074.0,16201115.0,0.5526,0.5588,0.5528,0.5572
2023-05-08 13:50,618,308,310,61116,36174,24942,33927324.0,20018910.0,13908414.0,620,309,311,61037,36123,24914,33881848.0,19989109.0,13892739.0,0.5534,0.5576,0.5534,0.5576
2023-05-08 13:55,475,269,206,43755,24055,19700,24332668.0,13338154.0,10994513.0,466,265,201,42885,23243,19642,23849708.0,12887869.0,10961839.0,0.5545,0.5581,0.5545,0.5581
2023-05-08 14:00,401,86,315,27090,4101,22989,15090610.0,2274987.0,12815623.0,390,81,309,26348,4398,21950,14674738.0,2437596.0,12237141.0,0.5547,0.5575,0.5543,0.5575
2023-05-08 14:05,284,33,251,19440,2000,17440,10817561.0,1107419.0,9710142.0,283,31,252,19339,1883,17456,10763599.0,1044067.0,9719531.0,0.5537,0.5568,0.5545,0.5568
2023-05-08 14:10,146,73,73,7366,3415,3951,4095658.0,1889152.0,2206506.0,143,74,69,7135,3261,3874,3969054.0,1805847.0,2163207.0,0.5532,0.5585,0.5538,0.5584
2023-05-08 14:15,333,101,232,23155,7680,15475,12868642.0,4252476.0,8616165.0,325,95,230,22902,7384,15518,12730279.0,4088960.0,8641319.0,0.5537,0.5568,0.5538,0.5569
2023-05-08 14:20,522,26,496,36116,859,35257,20103506.0,475951.0,19627555.0,525,27,498,36156,817,35339,20125701.0,452382.0,19673319.0,0.5541,0.5567,0.5537,0.5567
2023-05-08 14:25,507,34,473,34477,895,33582,19191766.0,495815.0,18695950.0,504,33,471,34462,939,33523,19182767.0,519745.0,18663021.0,0.554,0.5567,0.5535,0.5567
2023-05-08 14:30,50,30,20,3095,1336,1759,1721190.0,739055.0,982135.0,47,28,19,2972,1233,1739,1653301.0,682228.0,971073.0,0.5532,0.5583,0.5533,0.5584
2023-05-08 14:35,107,52,55,6811,2891,3920,3790776.0,1601821.0,2188955.0,104,51,53,6621,2861,3760,3684066.0,1584649.0,2099416.0,0.5541,0.5584,0.5539,0.5584
2023-05-08 14:40,184,68,116,9788,3038,6750,5452616.0,1685003.0,3767612.0,182,69,113,10007,3257,6750,5573286.0,1805632.0,3767654.0,0.5546,0.5582,0.5544,0.5582
2023-05-08 14:45,147,68,79,10594,4776,5818,5896435.0,2650774.0,3245660.0,143,65,78,10577,4678,5899,5884313.0,2593031.0,3291282.0,0.555,0.5579,0.5543,0.5579
2023-05-08 14:50,97,54,43,6824,3481,3343,3793243.0,1926166.0,1867076.0,95,53,42,6686,3425,3261,3720066.0,1893127.0,1826938.0,0.5533,0.5585,0.5527,0.5602
2023-05-08 14:55,153,97,56,11407,7978,3429,6324864.0,4411446.0,1913418.0,152,97,55,11414,8025,3389,6328079.0,4436862.0,1891216.0,0.553,0.558,0.5529,0.558
2023-05-08 15:00,339,284,55,25106,21007,4099,13942219.0,11656579.0,2285640.0,334,280,54,24806,20870,3936,13774267.0,11579982.0,2194284.0,0.5549,0.5576,0.5549,0.5575
2023-05-08 15:05,438,158,280,37240,15646,21594,45952014.0,33968762.0,11983252.0,422,146,276,34985,14994,19991,44717653.0,33605443.0,11112210.0,2.1711,0.5549,2.2413,0.5559
2023-05-08 15:10,512,74,438,37721,7790,29931,20922243.0,4308186.0,16614056.0,503,69,434,37642,7899,29743,20895039.0,4365244.0,16529794.0,0.553,0.5551,0.5526,0.5558
2023-05-08 15:15,310,82,228,20605,5073,15532,11430734.0,2801574.0,8629160.0,303,75,228,20027,4459,15568,11116519.0,2467842.0,8648676.0,0.5523,0.5556,0.5535,0.5555
2023-05-08 15:20,517,177,340,39547,14974,24573,47263518.0,33591954.0,13671564.0,511,174,337,39822,14979,24843,47416159.0,33593267.0,13822892.0,2.2434,0.5564,2.2427,0.5564
2023-05-08 15:25,460,103,357,36900,6296,30604,20522209.0,3484843.0,17037366.0,458,101,357,36730,6206,30524,20427792.0,3435016.0,16992775.0,0.5535,0.5567,0.5535,0.5567
2023-05-08 15:30,286,103,183,21931,5991,15940,12193467.0,3318884.0,8874583.0,286,103,183,21735,6043,15692,12082161.0,3345731.0,8736430.0,0.554,0.5567,0.5537,0.5567
2023-05-08 15:35,412,207,205,31535,16016,15519,17507249.0,8874664.0,8632585.0,404,201,203,31293,15838,15455,17372760.0,8775337.0,8597423.0,0.5541,0.5563,0.5541,0.5563
2023-05-08 15:40,897,299,598,71669,27301,44368,39768163.0,15091062.0,24677101.0,895,297,598,71561,27122,44439,39707874.0,14989334.0,24718540.0,0.5528,0.5562,0.5527,0.5562
2023-05-08 15:45,403,152,251,28014,11664,16350,15547948.0,6453701.0,9094247.0,401,150,251,27982,11628,16354,15529198.0,6432789.0,9096409.0,0.5533,0.5562,0.5532,0.5562
2023-05-08 15:50,323,148,175,25611,14028,11583,14192698.0,7749287.0,6443410.0,323,147,176,25955,13150,12805,14433366.0,7265558.0,7167808.0,0.5524,0.5563,0.5525,0.5598
2023-05-08 15:55,652,326,326,53531,32029,21502,29684805.0,17720501.0,11964304.0,650,326,324,54544,33010,21534,30243960.0,18261761.0,11982198.0,0.5533,0.5564,0.5532,0.5564
2023-05-08 16:00,832,285,547,62731,24457,38274,34793009.0,13497524.0,21295485.0,826,280,546,62502,24307,38195,34672843.0,13421504.0,21251338.0,0.5519,0.5564,0.5522,0.5564
2023-05-08 16:05,928,363,565,79498,40077,39421,69382051.0,47441710.0,21940341.0,913,353,560,78646,39752,38894,68890871.0,47262556.0,21628314.0,1.1838,0.5566,1.1889,0.5561
2023-05-08 16:10,697,187,510,53954,19032,34922,29913134.0,10504589.0,19408544.0,697,188,509,54028,19049,34979,29954017.0,10513456.0,19440560.0,0.5519,0.5558,0.5519,0.5558
2023-05-08 16:15,1086,547,539,87273,47833,39440,48291106.0,26374275.0,21916830.0,1082,544,538,87454,48216,39238,48389046.0,26584349.0,21804697.0,0.5514,0.5557,0.5514,0.5557
2023-05-08 16:20,900,492,408,81553,52701,28852,45113687.0,29075175.0,16038511.0,899,490,409,81586,52507,29079,45132263.0,28967714.0,16164549.0,0.5517,0.5559,0.5517,0.5559
2023-05-08 16:25,1357,669,688,116841,69582,47259,89996047.0,63717400.0,26278647.0,1354,665,689,117401,69661,47740,90304728.0,63758277.0,26546450.0,0.9157,0.5561,0.9153,0.5561
2023-05-08 16:30,1536,778,758,136643,80927,55716,75616914.0,44642825.0,30974089.0,1530,778,752,136274,81045,55229,75411463.0,44708853.0,30702610.0,0.5516,0.5559,0.5517,0.5559
2023-05-08 16:35,1336,750,586,118943,74592,44351,91133532.0,66436321.0,24697210.0,1332,749,583,118546,74749,43797,90887246.0,66521639.0,24365606.0,0.8907,0.5569,0.8899,0.5563
2023-05-08 16:40,1600,1057,543,139365,97089,42276,77114512.0,53596965.0,23517547.0,1592,1055,537,138786,96994,41792,76792332.0,53544436.0,23247896.0,0.552,0.5563,0.552,0.5563
2023-05-08 16:45,1158,685,473,100293,59067,41226,55562960.0,32628263.0,22934697.0,1158,686,472,100364,59190,41174,55603304.0,32696993.0,22906310.0,0.5524,0.5563,0.5524,0.5563
2023-05-08 16:50,523,240,283,41656,17460,24196,23106216.0,9648882.0,13457334.0,518,236,282,41535,17285,24250,23038808.0,9551523.0,13487284.0,0.5526,0.5562,0.5526,0.5562
2023-05-08 16:55,1004,112,892,79708,6216,73492,44298168.0,3439033.0,40859135.0,1004,110,894,79668,6266,73402,44275428.0,3466471.0,40808957.0,0.5533,0.556,0.5532,0.556
2023-05-08 17:00,479,123,356,35533,7732,27801,19719205.0,4268668.0,15450537.0,472,119,353,35532,7941,27591,19721387.0,4384847.0,15336540.0,0.5521,0.5558,0.5522,0.5559
2023-05-08 17:05,76,37,39,5346,2089,3257,28283913.0,26469745.0,1814167.0,66,34,32,5181,1983,3198,28190111.0,26410250.0,1779860.0,12.671,0.557,13.3183,0.5566
2023-05-08 17:10,174,71,103,9487,1652,7835,5280318.0,915135.0,4365182.0,173,71,102,9554,1633,7921,5317820.0,904593.0,4413226.0,0.554,0.5571,0.5539,0.5572
2023-05-08 17:15,180,91,89,10775,2986,7789,5991301.0,1651066.0,4340235.0,170,86,84,10268,2674,7594,5706803.0,1475253.0,4231549.0,0.5529,0.5572,0.5517,0.5572
2023-05-08 17:20,294,157,137,19223,8335,10888,10680589.0,4612820.0,6067768.0,290,156,134,19184,8266,10918,10658676.0,4574229.0,6084446.0,0.5534,0.5573,0.5534,0.5573
2023-05-08 17:25,446,245,201,29658,15442,14216,16473325.0,8551665.0,7921660.0,438,243,195,29496,15309,14187,16383318.0,8477747.0,7905570.0,0.5538,0.5572,0.5538,0.5572
2023-05-08 17:30,284,180,104,18053,10653,7400,10024012.0,5901391.0,4122621.0,285,180,105,18068,10675,7393,10031775.0,5913037.0,4118738.0,0.554,0.5571,0.5539,0.5571
2023-05-08 17:35,247,151,96,16748,9063,7685,9309676.0,5027650.0,4282025.0,245,146,99,16980,9045,7935,9441379.0,5017661.0,4423718.0,0.5547,0.5572,0.5547,0.5575
2023-05-08 17:40,225,120,105,12283,4181,8102,6774861.0,2312093.0,4462767.0,206,109,97,11120,3939,7181,6172807.0,2177540.0,3995267.0,0.553,0.5508,0.5528,0.5564
2023-05-08 17:45,858,552,306,72731,49605,23126,65504590.0,52651008.0,12853581.0,854,549,305,72133,49439,22694,65175597.0,52559308.0,12616289.0,1.0614,0.5558,1.0631,0.5559
2023-05-08 17:50,964,516,448,86932,49921,37011,48114136.0,27543579.0,20570556.0,958,512,446,86610,49643,36967,47913483.0,27367383.0,20546100.0,0.5517,0.5558,0.5513,0.5558
2023-05-08 17:55,699,430,269,57860,38206,19654,31983577.0,21065825.0,10917752.0,690,427,263,57651,38365,19286,31876453.0,21153323.0,10723130.0,0.5514,0.5555,0.5514,0.556
2023-05-08 18:00,890,465,425,71148,42959,28189,39381186.0,23724681.0,15656505.0,884,458,426,71453,43179,28274,39534200.0,23830423.0,15703776.0,0.5523,0.5554,0.5519,0.5554
2023-05-08 18:05,1120,509,611,85257,42805,42452,47260143.0,23686485.0,23573658.0,1114,506,608,85109,42766,42343,47178387.0,23665141.0,23513245.0,0.5534,0.5553,0.5534,0.5553
2023-05-08 18:10,497,330,167,43016,31432,11584,23806573.0,17361744.0,6444829.0,494,329,165,43112,31486,11626,23859565.0,17391370.0,6468195.0,0.5524,0.5564,0.5524,0.5564
2023-05-08 18:15,880,575,305,76259,57491,18768,42203175.0,31764689.0,10438486.0,864,569,295,76250,57450,18800,42200696.0,31742602.0,10458094.0,0.5525,0.5562,0.5525,0.5563
2023-05-08 18:20,1014,773,241,106862,93195,13667,58904683.0,51306451.0,7598232.0,1012,771,241,106876,93094,13782,58912249.0,51250326.0,7661923.0,0.5505,0.556,0.5505,0.5559
2023-05-08 18:25,606,437,169,57544,47921,9623,57141201.0,51784081.0,5357119.0,597,429,168,57119,47473,9646,56905555.0,51535332.0,5370223.0,1.0806,0.5567,1.0856,0.5567
2023-05-08 18:30,105,61,44,6321,4207,2114,3506186.0,2327406.0,1178779.0,117,59,58,6285,4216,2069,3485719.0,2331389.0,1154329.0,0.5532,0.5576,0.553,0.5579
2023-05-08 18:35,372,239,133,24130,14954,9176,13400127.0,8293076.0,5107051.0,373,240,133,25245,15641,9604,14019671.0,8668201.0,5351469.0,0.5546,0.5566,0.5542,0.5572
2023-05-10 10:00,2233,845,1388,184130,75637,108493,133571375.0,73523711.0,60047663.0,1821,648,1173,155911,55388,100523,111835345.0,56211641.0,55623703.0,0.9721,0.5535,1.0149,0.5533
2023-05-10 10:05,3060,1974,1086,324516,227421,97095,229953006.0,176015709.0,53937296.0,2941,1900,1041,321658,225457,96201,222467042.0,169022655.0,53444386.0,0.774,0.5555,0.7497,0.5555
2023-05-10 10:10,3533,2455,1078,320023,233158,86865,316613173.0,268266660.0,48346513.0,3438,2411,1027,315021,229271,85750,313717386.0,266023163.0,47694222.0,1.1506,0.5566,1.1603,0.5562
2023-05-10 10:15,2772,2082,690,232444,183095,49349,179844917.0,152281524.0,27563393.0,2729,2069,660,230477,182770,47707,178632905.0,152024697.0,26608207.0,0.8317,0.5585,0.8318,0.5577
2023-05-10 10:20,3982,3687,295,333040,317415,15625,324684653.0,315894469.0,8790184.0,3935,3655,280,330515,316730,13785,323210667.0,315468250.0,7742416.0,0.9952,0.5626,0.996,0.5617
2023-05-10 10:25,2914,2278,636,310921,203560,107361,211907155.0,151485018.0,60422136.0,2875,2259,616,309127,202063,107064,210888224.0,150646677.0,60241547.0,0.7442,0.5628,0.7455,0.5627
2023-05-10 10:30,2499,2178,321,229587,220684,8903,140673435.0,135691094.0,4982341.0,2449,2162,287,229325,220477,8848,140550833.0,135563745.0,4987087.0,0.6149,0.5596,0.6149,0.5636
2023-05-10 10:35,2157,2044,113,191958,186231,5727,107135542.0,103930637.0,3204904.0,2131,2030,101,192490,186417,6073,107427898.0,104022473.0,3405425.0,0.5581,0.5596,0.558,0.5607
2023-05-10 10:40,1615,1456,159,121442,111220,10222,67829773.0,62073482.0,5756291.0,1506,1401,105,119216,109309,9907,66600886.0,61026454.0,5574432.0,0.5581,0.5631,0.5583,0.5627
2023-05-10 10:45,1398,938,460,94032,76029,18003,52723899.0,42450524.0,10273375.0,1371,923,448,90726,75752,14974,50698955.0,42298202.0,8400753.0,0.5583,0.5706,0.5584,0.561
2023-05-10 10:50,1121,643,478,65946,44781,21165,36837232.0,24979431.0,11857800.0,1102,639,463,65759,45021,20738,36740803.0,25114537.0,11626266.0,0.5578,0.5603,0.5578,0.5606
2023-05-10 10:55,2022,1264,758,192984,157559,35425,120205223.0,100386513.0,19818710.0,1993,1246,747,191942,156683,35259,119629960.0,99898187.0,19731773.0,0.6371,0.5595,0.6376,0.5596
2023-05-10 11:00,3842,1358,2484,533578,174427,359151,335812074.0,134996811.0,200815262.0,3814,1337,2477,532501,174878,357623,335279572.0,135261885.0,200017687.0,0.7739,0.5591,0.7735,0.5593
2023-05-10 11:05,3348,606,2742,476025,62372,413653,304058557.0,72640799.0,231417758.0,3307,580,2727,473159,61776,411383,302435064.0,72309928.0,230125135.0,1.1646,0.5594,1.1705,0.5594
2023-05-10 11:10,2273,472,1801,354726,32878,321848,249079799.0,68953147.0,180126652.0,2134,350,1784,354218,33055,321163,248730276.0,69003017.0,179727259.0,2.0972,0.5597,2.0875,0.5596
2023-05-10 11:15,783,450,333,57325,30618,26707,32068936.0,17099816.0,14969120.0,767,442,325,56762,30250,26512,31752022.0,16892645.0,14859377.0,0.5585,0.5605,0.5584,0.5605
2023-05-10 11:20,370,85,285,25101,3971,21130,14049890.0,2214602.0,11835288.0,352,71,281,24886,3824,21062,13930029.0,2132940.0,11797088.0,0.5577,0.5601,0.5578,0.5601
2023-05-10 11:25,139,72,67,13061,4807,8254,7305560.0,2679661.0,4625899.0,123,56,67,12435,4168,8267,6959085.0,2325791.0,4633293.0,0.5574,0.5604,0.558,0.5605
2023-05-10 11:30,234,118,116,21073,8670,12403,11781944.0,4833152.0,6948792.0,229,118,111,21319,9102,12217,11911395.0,5066627.0,6844768.0,0.5575,0.5603,0.5566,0.5603
2023-05-10 11:35,131,83,48,9721,3734,5987,5444816.0,2084272.0,3360543.0,116,72,44,9414,3501,5913,5265618.0,1951357.0,3314261.0,0.5582,0.5613,0.5574,0.5605
2023-05-10 11:40,111,74,37,6717,2827,3890,3759989.0,1577628.0,2182360.0,101,67,34,6254,2384,3870,3498824.0,1328166.0,2170657.0,0.5581,0.561,0.5571,0.5609
2023-05-10 11:45,268,230,38,16371,14867,1504,9163207.0,8323774.0,839432.0,254,225,29,16280,14844,1436,9117517.0,8311120.0,806397.0,0.5599,0.5581,0.5599,0.5616
2023-05-10 11:50,90,63,27,3217,2286,931,14500649.0,13980547.0,520101.0,63,43,20,2192,1516,676,13884753.0,13505078.0,379675.0,6.1157,0.5586,8.9084,0.5616
2023-05-10 11:55,1976,466,1510,291552,23451,268101,177081447.0,25817767.0,151263679.0,1929,436,1493,289585,21747,267838,175979722.0,24830666.0,151149055.0,1.1009,0.5642,1.1418,0.5643
2023-05-10 12:00,925,438,487,77752,29661,48091,56352379.0,29273891.0,27078487.0,906,431,475,77123,29133,47990,55996479.0,28973657.0,27022821.0,0.9869,0.5631,0.9945,0.5631
2023-05-10 12:05,1448,1346,102,114786,106584,8202,64244143.0,59632359.0,4611784.0,1418,1326,92,114460,106410,8050,64060468.0,59532294.0,4528174.0,0.5595,0.5623,0.5595,0.5625
2023-05-10 12:10,721,590,131,47191,45417,1774,39098998.0,38101900.0,997098.0,706,587,119,47291,45557,1734,39149621.0,38174555.0,975066.0,0.8389,0.5621,0.838,0.5623
2023-05-10 12:15,288,191,97,15779,12581,3198,8864408.0,7064925.0,1799482.0,277,189,88,15531,12465,3066,8726281.0,6999931.0,1726349.0,0.5616,0.5627,0.5616,0.5631
2023-05-10 12:20,320,137,183,9108,3070,6038,5118646.0,1719635.0,3399011.0,313,135,178,9361,3039,6322,5264254.0,1701258.0,3562995.0,0.5601,0.5629,0.5598,0.5636
2023-05-10 12:25,362,319,43,26071,23820,2251,14599768.0,13332228.0,1267539.0,348,310,38,25671,23538,2133,14373881.0,13172448.0,1201433.0,0.5597,0.5631,0.5596,0.5633
2023-05-10 12:30,1015,660,355,65259,49038,16221,36608895.0,27471794.0,9137100.0,997,651,346,64414,48595,15819,36130823.0,27222996.0,8907827.0,0.5602,0.5633,0.5602,0.5631
2023-05-10 12:35,460,417,43,27622,24926,2696,15519627.0,14000654.0,1518972.0,456,414,42,27595,24905,2690,15504753.0,13988986.0,1515767.0,0.5617,0.5634,0.5617,0.5635
2023-05-10 12:40,455,332,123,29545,24257,5288,16588746.0,13610508.0,2978238.0,448,329,119,30005,24427,5578,16845656.0,13700244.0,3145411.0,0.5611,0.5632,0.5609,0.5639
2023-05-10 12:45,1005,745,260,68955,57225,11730,38735696.0,32131086.0,6604610.0,983,731,252,69039,56968,12071,38773435.0,31976054.0,6797380.0,0.5615,0.5631,0.5613,0.5631
2023-05-10 12:50,333,222,111,24948,20413,4535,26687452.0,24127008.0,2560444.0,317,214,103,23817,19614,4203,26046434.0,23673411.0,2373023.0,1.1819,0.5646,1.207,0.5646
2023-05-10 12:55,305,275,30,21328,17387,3941,12112030.0,9777573.0,2334457.0,297,276,21,21216,17359,3857,12107447.0,9763382.0,2344065.0,0.5623,0.5924,0.5624,0.6077
2023-05-10 13:00,679,634,45,48414,44059,4355,27379298.0,24795251.0,2584046.0,663,629,34,45256,43565,1691,25482195.0,24526513.0,955682.0,0.5628,0.5934,0.563,0.5652
2023-05-10 13:05,680,508,172,56243,42263,13980,31626226.0,23743535.0,7882690.0,673,504,169,56823,42827,13996,31951688.0,24059637.0,7892051.0,0.5618,0.5639,0.5618,0.5639
2023-05-10 13:10,391,340,51,30790,26601,4189,17305976.0,14944988.0,2360988.0,381,334,47,30483,26399,4084,17133020.0,14830873.0,2302146.0,0.5618,0.5636,0.5618,0.5637
2023-05-10 13:15,448,389,59,51046,41755,9291,28696497.0,23455960.0,5240536.0,433,377,56,50913,41937,8976,28610894.0,23547415.0,5063479.0,0.5618,0.564,0.5615,0.5641
2023-05-10 13:20,412,379,33,31622,28724,2898,17773492.0,16145055.0,1628437.0,400,376,24,31129,28555,2574,17502450.0,16050924.0,1451526.0,0.5621,0.5619,0.5621,0.5639
2023-05-10 13:25,960,763,197,86001,54596,31405,48369484.0,30672809.0,17696674.0,948,757,191,85953,54598,31355,48342715.0,30674535.0,17668180.0,0.5618,0.5635,0.5618,0.5635
2023-05-10 13:30,190,136,54,17565,9655,7910,9878488.0,5422892.0,4455595.0,179,130,49,17478,9635,7843,9830769.0,5411532.0,4419237.0,0.5617,0.5633,0.5617,0.5635
2023-05-10 13:35,272,254,18,19225,17360,1865,10803857.0,9753862.0,1049995.0,264,247,17,18974,17262,1712,10661446.0,9697051.0,964395.0,0.5619,0.563,0.5618,0.5633
2023-05-10 13:40,239,198,41,18685,14218,4467,10508229.0,7990276.0,2517953.0,228,191,37,17998,13497,4501,10119259.0,7582332.0,2536927.0,0.562,0.5637,0.5618,0.5636
2023-05-10 13:45,881,858,23,84355,83588,767,47390133.0,46958181.0,431951.0,868,851,17,83723,83053,670,47033242.0,46655474.0,377768.0,0.5618,0.5632,0.5618,0.5638
2023-05-10 13:50,151,130,21,10526,9557,969,5918189.0,5371313.0,546876.0,147,126,21,10361,9503,858,5825813.0,5340901.0,484912.0,0.562,0.5644,0.562,0.5652
2023-05-10 13:55,510,439,71,38276,36971,1305,21509408.0,20774594.0,734813.0,501,434,67,38229,37002,1227,21481976.0,20789543.0,692433.0,0.5619,0.5631,0.5618,0.5643
2023-05-10 14:00,168,148,20,11399,11094,305,6427029.0,6254856.0,172173.0,147,135,12,10754,10566,188,6038163.0,5930170.0,107992.0,0.5638,0.5645,0.5613,0.5744
2023-05-10 14:05,220,194,26,18563,17014,1549,10461834.0,9583379.0,878454.0,203,184,19,17996,16789,1207,10124169.0,9441976.0,682192.0,0.5633,0.5671,0.5624,0.5652
2023-05-10 14:10,1491,1460,31,172298,171288,1010,96995569.0,96427383.0,568186.0,1477,1457,20,171724,171083,641,96649600.0,96286789.0,362810.0,0.563,0.5626,0.5628,0.566
2023-05-10 14:15,288,261,27,32112,31833,279,18064969.0,17909495.0,155474.0,279,259,20,32195,31988,207,18114155.0,17997126.0,117029.0,0.5626,0.5573,0.5626,0.5654
2023-05-10 14:20,1596,1158,438,152738,126294,26444,85996729.0,71073760.0,14922968.0,1583,1152,431,152106,126312,25794,85654993.0,71082609.0,14572384.0,0.5628,0.5643,0.5628,0.565
2023-05-10 14:25,1640,1263,377,156178,138499,17679,87920501.0,77939473.0,9981028.0,1627,1256,371,155487,138234,17253,87530963.0,77790376.0,9740587.0,0.5627,0.5646,0.5627,0.5646
2023-05-10 14:30,553,312,241,38030,21025,17005,21424138.0,11825364.0,9598774.0,543,305,238,36871,21022,15849,20773858.0,11823098.0,8950759.0,0.5624,0.5645,0.5624,0.5648
2023-05-10 14:35,838,459,379,67405,47151,20254,37893415.0,26477787.0,11415628.0,824,449,375,67459,47247,20212,37916905.0,26519602.0,11397302.0,0.5616,0.5636,0.5613,0.5639
2023-05-10 14:40,241,226,15,22907,22564,343,12888194.0,12693489.0,194705.0,228,218,10,22552,22204,348,12684351.0,12487104.0,197246.0,0.5626,0.5677,0.5624,0.5668
2023-05-10 14:45,567,510,57,49579,46784,2795,27901234.0,26324644.0,1576590.0,543,498,45,49204,46545,2659,27681248.0,26181210.0,1500038.0,0.5627,0.5641,0.5625,0.5641
2023-05-10 14:50,180,163,17,15083,14597,486,8476103.0,8205107.0,270996.0,174,163,11,14978,14586,392,8420199.0,8199095.0,221103.0,0.5621,0.5576,0.5621,0.564
2023-05-10 14:55,24,23,1,1896,1895,1,1065985.0,1065415.0,570.0,23,22,1,2058,2054,4,1156438.0,1154161.0,2276.0,0.5622,0.57,0.5619,0.5692
2023-05-10 15:00,301,296,5,23405,23218,187,13173156.0,13065936.0,107220.0,294,290,4,23093,22896,197,12996411.0,12883440.0,112970.0,0.5628,0.5734,0.5627,0.5735
2023-05-10 15:05,861,470,391,57363,42246,15117,32316783.0,23788243.0,8528539.0,836,449,387,55341,40893,14448,31162460.0,23006385.0,8156075.0,0.5631,0.5642,0.5626,0.5645
2023-05-10 15:10,420,114,306,20011,8446,11565,11314212.0,4787226.0,6526986.0,414,110,304,19743,8184,11559,11137225.0,4612209.0,6525016.0,0.5668,0.5644,0.5636,0.5645
2023-05-10 15:15,233,160,73,19727,14716,5011,23803220.0,20985095.0,2818125.0,199,140,59,18256,14020,4236,22970337.0,20572117.0,2398220.0,1.426,0.5624,1.4673,0.5662
2023-05-10 15:20,518,470,48,42340,38836,3504,23872709.0,21889639.0,1983069.0,511,463,48,42876,39640,3236,24165528.0,22333981.0,1831546.0,0.5636,0.5659,0.5634,0.566
2023-05-10 15:25,593,499,94,51156,44602,6554,28885164.0,25178106.0,3707057.0,574,485,89,50894,44207,6687,28712904.0,24929938.0,3782966.0,0.5645,0.5656,0.5639,0.5657
2023-05-10 15:30,129,74,55,8556,5077,3479,4823590.0,2862336.0,1961254.0,108,68,40,8375,5027,3348,4727382.0,2833317.0,1894065.0,0.5638,0.5637,0.5636,0.5657
2023-05-10 15:35,471,193,278,33136,14082,19054,18706629.0,7941654.0,10764975.0,468,189,279,33013,14103,18910,18637238.0,7953636.0,10683602.0,0.564,0.565,0.564,0.565
2023-05-10 15:40,158,78,80,12156,5243,6913,6862046.0,2956245.0,3905800.0,145,70,75,11518,4898,6620,6505114.0,2760459.0,3744654.0,0.5638,0.565,0.5636,0.5657
2023-05-10 15:45,304,54,250,20875,2910,17965,11777817.0,1639632.0,10138184.0,289,46,243,20345,2999,17346,11496226.0,1689906.0,9806320.0,0.5634,0.5643,0.5635,0.5653
2023-05-10 15:50,27,6,21,1606,100,1506,906781.0,56322.0,850458.0,23,3,20,1685,294,1391,951360.0,165016.0,786344.0,0.5632,0.5647,0.5613,0.5653
2023-05-10 15:55,51,19,32,2245,571,1674,1269301.0,322179.0,947121.0,41,14,27,2320,686,1634,1309439.0,385836.0,923602.0,0.5642,0.5658,0.5624,0.5652
2023-05-10 16:00,110,52,58,8410,3745,4665,4750042.0,2111096.0,2638946.0,103,48,55,8323,3494,4829,4702199.0,1969972.0,2732227.0,0.5637,0.5657,0.5638,0.5658
2023-05-10 16:05,190,51,139,13102,2849,10253,7414663.0,1611960.0,5802702.0,176,37,139,13416,3090,10326,7583878.0,1740142.0,5843735.0,0.5658,0.566,0.5632,0.5659
2023-05-10 16:10,600,210,390,48256,17066,31190,27280880.0,9629299.0,17651580.0,592,204,388,47783,16680,31103,27015551.0,9413057.0,17602494.0,0.5642,0.5659,0.5643,0.5659
2023-05-10 16:15,920,331,589,76982,23597,53385,43515934.0,13312889.0,30203045.0,915,328,587,76689,23640,53049,43348493.0,13335252.0,30013240.0,0.5642,0.5658,0.5641,0.5658
2023-05-10 16:20,373,113,260,28786,7278,21508,16259456.0,4105959.0,12153496.0,361,106,255,28649,7257,21392,16187150.0,4093261.0,12093889.0,0.5642,0.5651,0.564,0.5653
2023-05-10 16:25,313,63,250,22085,3103,18982,12499174.0,1763842.0,10735331.0,307,56,251,22262,3046,19216,12583877.0,1716385.0,10867491.0,0.5684,0.5656,0.5635,0.5655
2023-05-10 16:30,106,48,58,8888,3349,5539,5023115.0,1888768.0,3134346.0,98,44,54,7421,2131,5290,4192266.0,1198839.0,2993427.0,0.564,0.5659,0.5626,0.5659
2023-05-10 16:35,322,189,133,23782,12727,11055,24898462.0,18637557.0,6260904.0,311,187,124,24290,13465,10825,26394256.0,20257373.0,6136882.0,1.4644,0.5663,1.5044,0.5669
2023-05-10 16:40,1767,1356,411,104663,77202,27461,59166751.0,43599449.0,15567301.0,1749,1348,401,104213,76877,27336,58903915.0,43406675.0,15497240.0,0.5647,0.5669,0.5646,0.5669
2023-05-10 16:45,310,255,55,19739,15825,3914,11165830.0,8936268.0,2229562.0,293,251,42,19656,16026,3630,11107051.0,9045122.0,2061929.0,0.5647,0.5696,0.5644,0.568
2023-05-10 16:50,277,55,222,18566,3401,15165,10516100.0,1917349.0,8598750.0,263,44,219,18406,3240,15166,10428276.0,1826327.0,8601948.0,0.5638,0.567,0.5637,0.5672
2023-05-10 16:55,23,12,11,1117,621,496,631599.0,350918.0,280681.0,19,9,10,1030,603,427,582006.0,339939.0,242066.0,0.5651,0.5659,0.5637,0.5669
2023-05-10 17:00,1303,826,477,119057,64527,54530,78694907.0,47821825.0,30873081.0,1291,822,469,117824,64397,53427,78012007.0,47748178.0,30263828.0,0.7411,0.5662,0.7415,0.5665
2023-05-10 17:05,796,243,553,57508,17297,40211,32498604.0,9758692.0,22739912.0,786,241,545,57178,17177,40001,32325713.0,9691814.0,22633899.0,0.5642,0.5655,0.5642,0.5658
2023-05-10 17:10,899,137,762,70795,6710,64085,40029058.0,3794606.0,36234451.0,893,133,760,70360,6467,63893,39789603.0,3646399.0,36143203.0,0.5655,0.5654,0.5638,0.5657
2023-05-10 17:15,751,84,667,64829,4590,60239,36615163.0,2580729.0,34034433.0,738,77,661,63652,4265,59387,35964671.0,2400700.0,33563970.0,0.5623,0.565,0.5629,0.5652
2023-05-10 17:20,718,39,679,75363,3016,72347,42590283.0,1702430.0,40887852.0,711,35,676,75261,3048,72213,42528549.0,1716789.0,40811759.0,0.5645,0.5652,0.5633,0.5652
2023-05-10 17:25,91,30,61,7623,2007,5616,4295393.0,1130677.0,3164715.0,83,28,55,7176,1798,5378,4052161.0,1012883.0,3039278.0,0.5634,0.5635,0.5633,0.5651
2023-05-10 17:30,436,75,361,38721,6432,32289,21879915.0,3635019.0,18244896.0,423,70,353,38503,6145,32358,21744957.0,3461037.0,18283920.0,0.5651,0.565,0.5632,0.5651
2023-05-10 17:35,811,266,545,71019,22072,48947,51665122.0,23974846.0,27690275.0,793,257,536,69716,19535,50181,50928776.0,22461163.0,28467612.0,1.0862,0.5657,1.1498,0.5673
2023-05-10 17:40,899,575,324,87331,51690,35641,72346864.0,52091032.0,20255832.0,888,568,320,86082,52211,33871,71590823.0,52379637.0,19211186.0,1.0078,0.5683,1.0032,0.5672
2023-05-10 17:45,370,328,42,31709,29178,2531,17917964.0,16486273.0,1431691.0,354,317,37,31383,28741,2642,17733804.0,16238699.0,1495105.0,0.565,0.5657,0.565,0.5659
2023-05-10 17:50,61,31,30,5299,3648,1651,2993709.0,2059951.0,933758.0,49,23,26,3938,2350,1588,2224856.0,1326234.0,898622.0,0.5647,0.5656,0.5644,0.5659
2023-05-10 17:55,76,28,48,5841,2144,3697,3281664.0,1210525.0,2071139.0,61,22,39,5091,2015,3076,2878261.0,1137713.0,1740548.0,0.5646,0.5602,0.5646,0.5658
2023-05-10 18:00,271,29,242,18517,1455,17062,10461568.0,818747.0,9642821.0,264,24,240,18487,1440,17047,10458532.0,810632.0,9647900.0,0.5627,0.5652,0.5629,0.566
2023-05-10 18:05,36,18,18,2276,1120,1156,1240123.0,630545.0,609578.0,26,15,11,1782,1174,608,1004916.0,660964.0,343952.0,0.563,0.5273,0.563,0.5657
2023-05-10 18:10,496,305,191,44398,29468,14930,36558326.0,28151859.0,8406466.0,469,290,179,40469,27282,13187,34341476.0,26864236.0,7477240.0,0.9553,0.5631,0.9847,0.567
2023-05-10 18:15,975,455,520,66494,33069,33425,72050680.0,53057693.0,18992986.0,949,446,503,65376,32588,32788,71377165.0,52752521.0,18624643.0,1.6045,0.5682,1.6188,0.568
2023-05-10 18:20,672,239,433,43825,15536,28289,24846955.0,8782093.0,16064862.0,668,238,430,44278,15411,28867,25111110.0,8711307.0,16399802.0,0.5653,0.5679,0.5653,0.5681
2023-05-10 18:25,724,247,477,51041,19412,31629,51831956.0,33864528.0,17967427.0,708,241,467,50359,19683,30676,51434913.0,34016183.0,17418730.0,1.7445,0.5681,1.7282,0.5678
2023-05-10 18:30,141,98,43,7277,5467,1810,4102577.0,3086268.0,1016309.0,150,99,51,6802,5061,1741,3845251.0,2856322.0,988929.0,0.5645,0.5615,0.5644,0.568
2023-05-10 18:35,246,157,89,12019,7808,4211,18262466.0,15868684.0,2393781.0,249,159,90,12894,8220,4674,18757949.0,16094259.0,2663690.0,2.0324,0.5685,1.9579,0.5699
2023-05-11 10:00,3765,2611,1154,439644,360599,79045,404430922.0,358826407.0,45604515.0,3137,2359,778,399352,334730,64622,371861895.0,334765686.0,37096209.0,0.9951,0.5769,1.0001,0.574
2023-05-11 10:05,4350,2898,1452,561121,447036,114085,549295817.0,482019927.0,67275889.0,3874,2720,1154,530178,435781,94397,529627943.0,474216049.0,55411893.0,1.0783,0.5897,1.0882,0.587
2023-05-11 10:10,3394,2094,1300,411581,261447,150134,250991143.0,163042413.0,87948730.0,3226,2010,1216,407788,259522,148266,248815797.0,161883792.0,86932004.0,0.6236,0.5858,0.6238,0.5863
2023-05-11 10:15,2866,765,2101,359567,50516,309051,241188761.0,60941568.0,180247192.0,2647,643,2004,353575,48455,305120,237831981.0,59738894.0,178093086.0,1.2064,0.5832,1.2329,0.5837
2023-05-11 10:20,1534,654,880,158681,47603,111078,92500276.0,27647106.0,64853169.0,1460,617,843,147643,46415,101228,86081189.0,26946747.0,59134441.0,0.5808,0.5839,0.5806,0.5842
2023-05-11 10:25,1590,386,1204,164838,28818,136020,116854232.0,37794466.0,79059766.0,1412,358,1054,161997,27820,134177,115215804.0,37213030.0,78002773.0,1.3115,0.5812,1.3376,0.5813
2023-05-11 10:30,2762,256,2506,397964,15875,382089,231196138.0,9173759.0,222022379.0,2663,210,2453,397884,13355,384529,231257641.0,7721241.0,223536400.0,0.5779,0.5811,0.5782,0.5813
2023-05-11 10:35,2857,345,2512,465957,19305,446652,270693105.0,11181217.0,259511887.0,2814,319,2495,464219,17880,446339,269681775.0,10334835.0,259346940.0,0.5792,0.581,0.578,0.5811
2023-05-11 10:40,2804,752,2052,425158,53429,371729,268157376.0,52017709.0,216139666.0,2775,733,2042,422658,51045,371613,266672401.0,50595212.0,216077188.0,0.9736,0.5814,0.9912,0.5815
2023-05-11 10:45,917,313,604,138946,22542,116404,80795697.0,13045291.0,67750405.0,897,301,596,138336,21883,116453,80460484.0,12665350.0,67795133.0,0.5787,0.582,0.5788,0.5822
2023-05-11 10:50,352,172,180,31550,13799,17751,28835601.0,18542536.0,10293065.0,319,158,161,32801,15552,17249,29605023.0,19553044.0,10051978.0,1.3438,0.5799,1.2573,0.5828
2023-05-11 10:55,1181,525,656,115917,32701,83216,67497637.0,18981591.0,48516046.0,1153,509,644,114470,31863,82607,66638310.0,18461774.0,48176536.0,0.5805,0.583,0.5794,0.5832
2023-05-11 11:00,1870,700,1170,243938,37895,206043,142016209.0,21969169.0,120047040.0,1847,689,1158,243394,37760,205634,141706623.0,21879813.0,119826810.0,0.5797,0.5826,0.5794,0.5827
2023-05-11 11:05,1001,716,285,70709,39837,30872,41134426.0,23094838.0,18039588.0,975,700,275,70397,39674,30723,40958785.0,23000886.0,17957898.0,0.5797,0.5843,0.5797,0.5845
2023-05-11 11:10,772,288,484,60667,20201,40466,35255629.0,11714226.0,23541402.0,753,279,474,59752,19944,39808,34750603.0,11564436.0,23186167.0,0.5799,0.5818,0.5798,0.5824
2023-05-11 11:15,334,194,140,22602,14615,7987,13128849.0,8476504.0,4652345.0,316,183,133,22295,14382,7913,12948890.0,8340300.0,4608590.0,0.58,0.5825,0.5799,0.5824
2023-05-11 11:20,85,49,36,6385,3173,3212,3778087.0,1842576.0,1935510.0,71,42,29,5153,3037,2116,2998747.0,1761757.0,1236990.0,0.5807,0.6026,0.5801,0.5846
2023-05-11 11:25,223,124,99,13855,7713,6142,8057348.0,4477428.0,3579920.0,205,113,92,12996,7144,5852,7554688.0,4146047.0,3408641.0,0.5805,0.5829,0.5804,0.5825
2023-05-11 11:30,682,350,332,79575,17481,62094,57022465.0,20709245.0,36313219.0,662,343,319,78490,17363,61127,56388395.0,20639352.0,35749042.0,1.1847,0.5848,1.1887,0.5848
2023-05-11 11:35,560,482,78,44858,32714,12144,26116689.0,19015276.0,7101413.0,548,473,75,44715,32472,12243,26027431.0,18865731.0,7161700.0,0.5813,0.5848,0.581,0.585
2023-05-11 11:40,533,110,423,63035,5038,57997,47221826.0,13468860.0,33752965.0,511,103,408,66916,5224,61692,49692503.0,13576720.0,36115782.0,2.6735,0.582,2.5989,0.5854
2023-05-11 11:45,120,40,80,7215,2167,5048,4204144.0,1257373.0,2946771.0,110,34,76,7270,2115,5155,4235977.0,1226524.0,3009452.0,0.5802,0.5838,0.5799,0.5838
2023-05-11 11:50,193,69,124,10873,3521,7352,6332318.0,2041763.0,4290555.0,177,61,116,10392,3524,6868,6042240.0,2043365.0,3998874.0,0.5799,0.5836,0.5798,0.5822
2023-05-11 11:55,284,124,160,14811,6288,8523,8622301.0,3649225.0,4973076.0,263,114,149,14667,6326,8341,8532786.0,3669746.0,4863040.0,0.5803,0.5835,0.5801,0.583
2023-05-11 12:00,473,364,109,21898,16860,5038,12725360.0,9788344.0,2937016.0,451,356,95,21698,16766,4932,12603256.0,9724896.0,2878360.0,0.5806,0.583,0.58,0.5836
2023-05-11 12:05,831,324,507,53636,15855,37781,31169584.0,9203047.0,21966537.0,806,311,495,53104,15671,37433,30873581.0,9093138.0,21780443.0,0.5805,0.5814,0.5803,0.5819
2023-05-11 12:10,274,223,51,17934,14306,3628,10414148.0,8298760.0,2115388.0,269,223,46,17802,14251,3551,10339005.0,8266872.0,2072132.0,0.5801,0.5831,0.5801,0.5835
2023-05-11 12:15,115,58,57,5425,1794,3631,3160191.0,1039782.0,2120408.0,102,50,52,5636,1874,3762,3280816.0,1086221.0,2194594.0,0.5796,0.584,0.5796,0.5834
2023-05-11 12:20,196,99,97,10245,3588,6657,5943304.0,2081558.0,3861746.0,180,96,84,9640,3593,6047,5600786.0,2080210.0,3520575.0,0.5801,0.5801,0.579,0.5822
2023-05-11 12:25,535,482,53,35414,32852,2562,20579332.0,19089974.0,1489358.0,514,471,43,34190,31689,2501,19850345.0,18395554.0,1454791.0,0.5811,0.5813,0.5805,0.5817
2023-05-11 12:30,312,103,209,23400,3907,19493,13675662.0,2266709.0,11408953.0,297,100,197,20311,3960,16351,11822685.0,2297103.0,9525581.0,0.5802,0.5853,0.5801,0.5826
2023-05-11 12:35,320,203,117,19640,8572,11068,11443872.0,4975521.0,6468350.0,314,199,115,19588,8559,11029,11413580.0,4967723.0,6445857.0,0.5804,0.5844,0.5804,0.5844
2023-05-11 12:40,262,203,59,16461,12304,4157,9588459.0,7143342.0,2445116.0,257,203,54,15646,12290,3356,9087243.0,7134893.0,1952350.0,0.5806,0.5882,0.5805,0.5817
2023-05-11 12:45,409,46,363,29284,1566,27718,17023857.0,907744.0,16116112.0,394,45,349,30092,2528,27564,17482226.0,1456049.0,16026176.0,0.5797,0.5814,0.576,0.5814
2023-05-11 12:50,315,26,289,22829,1502,21327,13285957.0,878954.0,12407002.0,301,20,281,22228,871,21357,12934581.0,504947.0,12429634.0,0.5852,0.5818,0.5797,0.582
2023-05-11 12:55,399,169,230,18717,4524,14193,10869126.0,2623416.0,8245709.0,390,169,221,18371,4506,13865,10669026.0,2612487.0,8056538.0,0.5799,0.581,0.5798,0.5811
2023-05-11 13:00,105,59,46,6156,3988,2168,3582944.0,2305522.0,1277422.0,98,58,40,5484,3642,1842,3181473.0,2108407.0,1073065.0,0.5781,0.5892,0.5789,0.5826
2023-05-11 13:05,95,55,40,4293,2620,1673,2462343.0,1520094.0,942248.0,77,46,31,6785,2508,4277,3997621.0,1455068.0,2542553.0,0.5802,0.5632,0.5802,0.5945
2023-05-11 13:10,98,61,37,7251,2113,5138,4245025.0,1230667.0,3014357.0,66,37,29,3496,1786,1710,2030286.0,1035529.0,994757.0,0.5824,0.5867,0.5798,0.5817
2023-05-11 13:15,132,75,57,6966,2730,4236,4056005.0,1589608.0,2466396.0,122,68,54,7427,3159,4268,4310655.0,1825503.0,2485152.0,0.5823,0.5822,0.5779,0.5823
2023-05-11 13:20,451,146,305,30534,7014,23520,17742555.0,4070046.0,13672509.0,434,136,298,29441,6325,23116,17107163.0,3669383.0,13437780.0,0.5803,0.5813,0.5801,0.5813
2023-05-11 13:25,170,86,84,8464,3501,4963,4924775.0,2044360.0,2880415.0,148,74,74,7603,3102,4501,4414657.0,1797706.0,2616950.0,0.5839,0.5804,0.5795,0.5814
2023-05-11 13:30,677,211,466,40559,10922,29637,23556482.0,6333147.0,17223335.0,652,192,460,40165,10621,29544,23328747.0,6159508.0,17169239.0,0.5799,0.5811,0.5799,0.5811
2023-05-11 13:35,612,93,519,51357,2878,48479,40271789.0,12206832.0,28064956.0,588,77,511,50453,3100,47353,39838872.0,12337166.0,27501705.0,4.2414,0.5789,3.9797,0.5808
2023-05-11 13:40,2187,361,1826,285146,26895,258251,165650754.0,15514218.0,150136535.0,2145,336,1809,283275,25680,257595,164580892.0,14793246.0,149787646.0,0.5768,0.5814,0.5761,0.5815
2023-05-11 13:45,1870,212,1658,212736,11033,201703,123358696.0,6360510.0,116998185.0,1838,186,1652,212632,10811,201821,123319850.0,6231460.0,117088390.0,0.5765,0.5801,0.5764,0.5802
2023-05-11 13:50,2618,259,2359,366060,16834,349226,222939213.0,20269244.0,202669968.0,2588,243,2345,364423,16516,347907,222010259.0,20085773.0,201924486.0,1.2041,0.5803,1.2161,0.5804
2023-05-11 13:55,1948,103,1845,289281,4635,284646,167423474.0,2663530.0,164759943.0,1915,82,1833,288317,4281,284036,166967743.0,2461188.0,164506555.0,0.5747,0.5788,0.5749,0.5792
2023-05-11 14:00,2989,149,2840,443981,6252,437729,257294634.0,3601997.0,253692637.0,2981,147,2834,444555,6916,437639,257622943.0,3981389.0,253641553.0,0.5761,0.5796,0.5757,0.5796
2023-05-11 14:05,1721,48,1673,283142,1925,281217,164000071.0,1108655.0,162891416.0,1710,42,1668,282689,1696,280993,163748508.0,976589.0,162771919.0,0.5759,0.5792,0.5758,0.5793
2023-05-11 14:10,2205,578,1627,316560,45283,271277,183190510.0,26105687.0,157084823.0,2190,569,1621,315666,44956,270710,182694921.0,25908432.0,156786489.0,0.5765,0.5791,0.5763,0.5792
2023-05-11 14:15,3197,570,2627,541344,37921,503423,313458518.0,21878572.0,291579946.0,3193,567,2626,540008,36106,503902,312684042.0,20825194.0,291858847.0,0.577,0.5792,0.5768,0.5792
2023-05-11 14:20,1684,290,1394,224674,16252,208422,130133156.0,9277351.0,120855804.0,1667,280,1387,222689,14453,208236,129082620.0,8337588.0,120745032.0,0.5708,0.5799,0.5769,0.5798
2023-05-11 14:25,1430,116,1314,210378,4598,205780,122136745.0,2656107.0,119480638.0,1419,111,1308,210866,5023,205843,122418481.0,2897297.0,119521183.0,0.5777,0.5806,0.5768,0.5806
2023-05-11 14:30,1176,74,1102,200662,2765,197897,116588837.0,1595175.0,114993661.0,1167,71,1096,200632,2912,197720,116574352.0,1677075.0,114897277.0,0.5769,0.5811,0.5759,0.5811
2023-05-11 14:35,1887,43,1844,298160,1521,296639,173060187.0,875975.0,172184211.0,1880,39,1841,298456,1532,296924,173231949.0,882273.0,172349675.0,0.5759,0.5805,0.5759,0.5805
2023-05-11 14:40,2176,254,1922,344195,12801,331394,199778813.0,7384591.0,192394222.0,2162,248,1914,343808,12720,331088,199551793.0,7337775.0,192214018.0,0.5769,0.5806,0.5769,0.5806
2023-05-11 14:45,1267,465,802,170303,30095,140208,98818579.0,17370454.0,81448124.0,1267,467,800,170593,30237,140356,98989235.0,17451835.0,81537400.0,0.5772,0.5809,0.5772,0.5809
2023-05-11 14:50,1636,117,1519,267689,6985,260704,155493429.0,4029479.0,151463949.0,1623,109,1514,267389,6832,260557,155341572.0,3941899.0,151399673.0,0.5769,0.581,0.577,0.5811
2023-05-11 14:55,972,69,903,172090,3974,168116,99843336.0,2290193.0,97553142.0,961,64,897,171618,3886,167732,99579187.0,2238665.0,97340521.0,0.5763,0.5803,0.5761,0.5803
2023-05-11 15:00,345,80,265,25236,6139,19097,14575367.0,3535509.0,11039857.0,332,74,258,26837,8247,18590,15499206.0,4750470.0,10748735.0,0.5759,0.5781,0.576,0.5782
2023-05-11 15:05,439,26,413,30693,2203,28490,17718184.0,1267309.0,16450874.0,435,20,415,30289,2168,28121,17481726.0,1247007.0,16234719.0,0.5753,0.5774,0.5752,0.5773
2023-05-11 15:10,499,89,410,38864,9830,29034,35879289.0,19120424.0,16758865.0,489,82,407,36180,7126,29054,31420651.0,14650094.0,16770556.0,1.9451,0.5772,2.0559,0.5772
2023-05-11 15:15,75,38,37,4039,1751,2288,2334009.0,1011346.0,1322663.0,93,46,47,3966,1639,2327,2288194.0,942551.0,1345643.0,0.5776,0.5781,0.5751,0.5783
2023-05-11 15:20,511,70,441,40185,6252,33933,23228607.0,3604283.0,19624324.0,505,65,440,40391,6132,34259,23349375.0,3534641.0,19814734.0,0.5765,0.5783,0.5764,0.5784
2023-05-11 15:25,853,625,228,126311,101363,24948,86164766.0,71706949.0,14457817.0,813,607,206,123080,99092,23988,84570918.0,70668217.0,13902701.0,0.7074,0.5795,0.7132,0.5796
2023-05-11 15:30,2433,1735,698,315554,260329,55225,182296626.0,150291708.0,32004918.0,2419,1732,687,315145,259952,55193,182052374.0,150064801.0,31987572.0,0.5773,0.5795,0.5773,0.5796
2023-05-11 15:35,1742,1463,279,226683,204179,22504,130953407.0,117911401.0,13042006.0,1740,1462,278,227057,204627,22430,131169237.0,118170170.0,12999067.0,0.5775,0.5795,0.5775,0.5795
2023-05-11 15:40,836,375,461,79229,46416,32813,45759791.0,26759798.0,18999993.0,825,371,454,78708,45987,32721,45464286.0,26516441.0,18947844.0,0.5765,0.579,0.5766,0.5791
2023-05-11 15:45,1267,339,928,125329,59730,65599,72457300.0,34469616.0,37987684.0,1267,340,927,125617,60122,65495,72616913.0,34691715.0,37925197.0,0.5771,0.5791,0.577,0.5791
2023-05-11 15:50,1383,789,594,175923,129944,45979,101626726.0,74988343.0,26638383.0,1377,789,588,175862,129950,45912,101591019.0,74991871.0,26599148.0,0.5771,0.5794,0.5771,0.5794
2023-05-11 15:55,811,735,76,84152,79096,5056,48604860.0,45676316.0,2928543.0,810,733,77,83808,78775,5033,48406113.0,45490978.0,2915134.0,0.5775,0.5792,0.5775,0.5792
2023-05-11 16:00,1089,718,371,145004,120941,24063,83725963.0,69788370.0,13937593.0,1084,715,369,145034,120990,24044,83744481.0,69816384.0,13928096.0,0.577,0.5792,0.577,0.5793
2023-05-11 16:05,1929,1707,222,313376,312431,945,181047229.0,180490357.0,556872.0,1919,1702,217,313327,312609,718,181009258.0,180592146.0,417111.0,0.5777,0.5893,0.5777,0.5809
2023-05-11 16:10,1707,1295,412,248236,234395,13841,143418519.0,135395689.0,8022830.0,1700,1288,412,247854,233949,13905,143195626.0,135135877.0,8059748.0,0.5776,0.5796,0.5776,0.5796
2023-05-11 16:15,1507,1175,332,213329,192468,20861,136388053.0,124283590.0,12104463.0,1501,1172,329,213912,192835,21077,136724267.0,124495237.0,12229029.0,0.6457,0.5802,0.6456,0.5802
2023-05-11 16:20,2194,1952,242,388175,369433,18742,237504465.0,226615539.0,10888925.0,2178,1946,232,387477,369006,18471,237106279.0,226372350.0,10733929.0,0.6134,0.581,0.6135,0.5811
2023-05-11 16:25,2246,1372,874,315373,262833,52540,182248283.0,151797419.0,30450863.0,2238,1365,873,315403,263078,52325,182278514.0,151938417.0,30340097.0,0.5775,0.5796,0.5775,0.5798
2023-05-11 16:30,684,518,166,88191,78534,9657,50955662.0,45358889.0,5596772.0,676,512,164,87650,78105,9545,50652410.0,45115505.0,5536904.0,0.5776,0.5796,0.5776,0.5801
2023-05-11 16:35,1204,954,250,147372,130496,16876,98096194.0,88316345.0,9779849.0,1191,949,242,147046,130513,16533,97874988.0,88291487.0,9583501.0,0.6768,0.5795,0.6765,0.5797
2023-05-11 16:40,519,424,95,75825,65228,10597,43850477.0,37700592.0,6149884.0,511,422,89,75608,65213,10395,43726854.0,37692572.0,6034282.0,0.578,0.5803,0.578,0.5805
2023-05-11 16:45,302,170,132,32516,18273,14243,18792216.0,10524309.0,8267907.0,294,167,127,32337,18170,14167,18684489.0,10460353.0,8224135.0,0.5759,0.5805,0.5757,0.5805
2023-05-11 16:50,293,173,120,28797,18439,10358,16630087.0,10620249.0,6009838.0,287,170,117,28768,18329,10439,16613264.0,10556399.0,6056865.0,0.576,0.5802,0.5759,0.5802
2023-05-11 16:55,631,462,169,68578,51668,16910,39624398.0,29805974.0,9818424.0,628,460,168,68833,51941,16892,39770140.0,29962216.0,9807923.0,0.5769,0.5806,0.5769,0.5806
2023-05-11 17:00,434,159,275,41055,17526,23529,23755720.0,10109773.0,13645946.0,430,157,273,40682,17196,23486,23545317.0,9923612.0,13621705.0,0.5768,0.58,0.5771,0.58
2023-05-11 17:05,61,14,47,2773,723,2050,1606657.0,416862.0,1189795.0,32,13,19,2722,722,2000,1577479.0,416260.0,1161219.0,0.5766,0.5804,0.5765,0.5806
2023-05-11 17:10,76,37,39,7575,5015,2560,4362502.0,2883253.0,1479248.0,67,36,31,7808,5392,2416,4498522.0,3095978.0,1402544.0,0.5749,0.5778,0.5742,0.5805
2023-05-11 17:15,116,55,61,8529,5014,3515,4933483.0,2895583.0,2037899.0,108,52,56,8621,5194,3427,4988852.0,2999391.0,1989461.0,0.5775,0.5798,0.5775,0.5805
2023-05-11 17:20,72,32,40,4281,1672,2609,2479658.0,964313.0,1515345.0,72,33,39,6247,3718,2529,3612079.0,2143820.0,1468259.0,0.5767,0.5808,0.5766,0.5806
2023-05-11 17:25,528,391,137,27576,15203,12373,15963599.0,8784751.0,7178848.0,521,387,134,27365,15022,12343,15832554.0,8671270.0,7161284.0,0.5778,0.5802,0.5772,0.5802
2023-05-11 17:30,414,131,283,30369,7112,23257,17590997.0,4097259.0,13493738.0,410,128,282,30189,7012,23177,17486455.0,4039175.0,13447280.0,0.5761,0.5802,0.576,0.5802
2023-05-11 17:35,312,263,49,23120,19458,3662,13378226.0,11253872.0,2124354.0,312,263,49,23659,19735,3924,13690690.0,11409211.0,2281478.0,0.5784,0.5801,0.5781,0.5814
2023-05-11 17:40,487,432,55,48471,43872,4599,28038399.0,25369479.0,2668920.0,483,431,52,48076,43484,4592,27815211.0,25149932.0,2665278.0,0.5783,0.5803,0.5784,0.5804
2023-05-11 17:45,484,341,143,39572,31847,7725,22885847.0,18415617.0,4470230.0,479,339,140,39698,32034,7664,22967273.0,18523891.0,4443382.0,0.5783,0.5787,0.5783,0.5798
2023-05-11 17:50,1539,328,1211,101543,28860,72683,58802109.0,16676438.0,42125671.0,1517,320,1197,101107,28605,72502,58549064.0,16528602.0,42020461.0,0.5778,0.5796,0.5778,0.5796
2023-05-11 17:55,1903,443,1460,133167,30975,102192,77116470.0,17891394.0,59225076.0,1900,440,1460,133168,30961,102207,77114897.0,17881105.0,59233792.0,0.5776,0.5795,0.5775,0.5795
2023-05-11 18:00,2535,1178,1357,204862,101382,103480,118318008.0,58331511.0,59986497.0,2522,1169,1353,204693,101181,103512,118203302.0,58198225.0,60005077.0,0.5754,0.5797,0.5752,0.5797
2023-05-11 18:05,1144,359,785,78349,19530,58819,45379988.0,11287228.0,34092759.0,1139,357,782,78251,19570,58681,45323676.0,11310572.0,34013104.0,0.5779,0.5796,0.578,0.5796
2023-05-11 18:10,284,91,193,20611,7061,13550,11928519.0,4080640.0,7847878.0,281,91,190,21049,7477,13572,12160982.0,4300567.0,7860415.0,0.5779,0.5792,0.5752,0.5792
2023-05-11 18:15,274,15,259,18456,1073,17383,10692028.0,620337.0,10071690.0,272,15,257,18737,1092,17645,10874593.0,630994.0,10243598.0,0.5781,0.5794,0.5778,0.5805
2023-05-11 18:20,8,5,3,90,74,16,52892.0,42859.0,10033.0,7,4,3,89,73,16,52229.0,42196.0,10033.0,0.5792,0.6271,0.578,0.6271
2023-05-11 18:25,15,7,8,422,129,293,239481.0,74503.0,164978.0,12,6,6,422,188,234,244328.0,108712.0,135615.0,0.5775,0.5631,0.5783,0.5796
2023-05-11 18:30,1376,709,667,141488,92736,48752,81910766.0,53613849.0,28296917.0,1375,707,668,141130,92478,48652,81656073.0,53416859.0,28239214.0,0.5781,0.5804,0.5776,0.5804
2023-05-11 18:35,1373,1021,352,163536,139167,24369,107687526.0,93519494.0,14168032.0,1361,1018,343,162643,138630,24013,107151341.0,93192330.0,13959010.0,0.672,0.5814,0.6722,0.5813
2023-05-12 10:00,1815,264,1551,168735,28709,140026,120709331.0,39146869.0,81562462.0,1537,119,1418,152437,16429,136008,104215650.0,25033184.0,79182465.0,1.3636,0.5825,1.5237,0.5822
2023-05-12 10:05,1987,726,1261,175057,65295,109762,240014976.0,176745573.0,63269402.0,1785,616,1169,166665,62722,103943,230619248.0,170439654.0,60179594.0,2.7069,0.5764,2.7174,0.579
2023-05-12 10:10,1134,780,354,90683,61471,29212,51885693.0,35144928.0,16740764.0,1059,726,333,87456,59406,28050,49949668.0,33877980.0,16071687.0,0.5717,0.5731,0.5703,0.573
2023-05-12 10:15,1228,437,791,77765,21046,56719,44527992.0,12011724.0,32516268.0,1067,332,735,75200,19544,55656,43061348.0,11155597.0,31905751.0,0.5707,0.5733,0.5708,0.5733
2023-05-12 10:20,864,268,596,69868,11397,58471,52704013.0,19170831.0,33533182.0,808,230,578,67018,9255,57763,51079740.0,17940504.0,33139236.0,1.6821,0.5735,1.9385,0.5737
2023-05-12 10:25,2148,380,1768,231255,6706,224549,132708496.0,3820595.0,128887901.0,2126,362,1764,231142,6683,224459,132652056.0,3815280.0,128836775.0,0.5697,0.574,0.5709,0.574
2023-05-12 10:30,476,95,381,35260,2584,32676,20232039.0,1475456.0,18756582.0,421,55,366,34574,2075,32499,19835892.0,1185419.0,18650473.0,0.571,0.574,0.5713,0.5739
2023-05-12 10:35,579,304,275,29295,11739,17556,16789374.0,6718791.0,10070582.0,548,283,265,28633,11284,17349,16409192.0,6458082.0,9951109.0,0.5723,0.5736,0.5723,0.5736
2023-05-12 10:40,424,57,367,29003,2725,26278,16631228.0,1554579.0,15076648.0,409,51,358,28976,2803,26173,16612239.0,1601122.0,15011117.0,0.5705,0.5737,0.5712,0.5735
2023-05-12 10:45,2733,832,1901,283874,57698,226176,162810693.0,33018104.0,129792589.0,2713,820,1893,283627,57289,226338,162676580.0,32779834.0,129896746.0,0.5723,0.5739,0.5722,0.5739
2023-05-12 10:50,224,81,143,11521,3041,8480,19274796.0,14406800.0,4867996.0,196,64,132,10756,2694,8062,18838909.0,14207068.0,4631840.0,4.7375,0.5741,5.2736,0.5745
2023-05-12 10:55,2104,889,1215,249115,93543,155572,155520143.0,66113459.0,89406684.0,2096,884,1212,248475,93135,155340,155158190.0,65903999.0,89254190.0,0.7068,0.5747,0.7076,0.5746
2023-05-12 11:00,1684,441,1243,199459,42469,156990,114704206.0,24308038.0,90396168.0,1666,427,1239,198283,41399,156884,114017377.0,23683357.0,90334019.0,0.5724,0.5758,0.5721,0.5758
2023-05-12 11:05,2155,868,1287,248780,83335,165445,168379419.0,73086790.0,95292628.0,2149,878,1271,247724,83916,163808,167773883.0,73418565.0,94355318.0,0.877,0.576,0.8749,0.576
2023-05-12 11:10,3033,1364,1669,434676,109377,325299,261738969.0,75180213.0,186558756.0,2975,1322,1653,432539,108243,324296,260549655.0,74537278.0,186012376.0,0.6873,0.5735,0.6886,0.5736
2023-05-12 11:15,1457,614,843,122161,41821,80340,82703736.0,36578045.0,46125691.0,1443,613,830,123398,42934,80464,83418150.0,37215013.0,46203137.0,0.8746,0.5741,0.8668,0.5742
2023-05-12 11:20,1390,318,1072,152272,18186,134086,99969519.0,23059189.0,76910330.0,1352,294,1058,149804,16722,133082,98567384.0,22222472.0,76344912.0,1.268,0.5736,1.3289,0.5737
2023-05-12 11:25,539,52,487,35451,2892,32559,20324025.0,1654353.0,18669672.0,533,43,490,35627,2785,32842,20425099.0,1592765.0,18832334.0,0.572,0.5734,0.5719,0.5734
2023-05-12 11:30,873,598,275,112839,75023,37816,64486571.0,42775100.0,21711471.0,882,622,260,112892,75284,37608,64516555.0,42921465.0,21595090.0,0.5702,0.5741,0.5701,0.5742
2023-05-12 11:35,858,590,268,69524,49804,19720,39734267.0,28450725.0,11283542.0,819,563,256,66814,48086,18728,38235481.0,27507877.0,10727603.0,0.5713,0.5722,0.5721,0.5728
2023-05-12 11:40,175,50,125,14991,2882,12109,8597194.0,1659153.0,6938041.0,153,32,121,14617,2405,12212,8379095.0,1372768.0,7006327.0,0.5757,0.573,0.5708,0.5737
2023-05-12 11:45,38,6,32,1682,156,1526,963221.0,88447.0,874773.0,30,4,26,1482,162,1320,849850.0,91495.0,758354.0,0.567,0.5732,0.5648,0.5745
2023-05-12 11:50,69,21,48,5237,1278,3959,15670336.0,13396992.0,2273343.0,60,14,46,4720,1074,3646,15375079.0,13280924.0,2094154.0,10.4828,0.5742,12.3659,0.5744
2023-05-12 11:55,325,6,319,40955,20,40935,23472852.0,11346.0,23461506.0,320,4,316,40891,9,40882,23436339.0,5099.0,23431239.0,0.5673,0.5731,0.5666,0.5731
2023-05-12 12:00,220,9,211,18265,245,18020,10470447.0,139485.0,10330962.0,212,5,207,19349,166,19183,11091853.0,94640.0,10997212.0,0.5693,0.5733,0.5701,0.5733
2023-05-12 12:05,907,41,866,137554,2750,134804,78972923.0,1570622.0,77402301.0,885,29,856,136127,1722,134405,78166175.0,983015.0,77183159.0,0.5711,0.5742,0.5709,0.5743
2023-05-12 12:10,118,18,100,6957,670,6287,3979161.0,382884.0,3596276.0,108,12,96,7125,584,6541,4079195.0,333624.0,3745571.0,0.5715,0.572,0.5713,0.5726
2023-05-12 12:15,108,12,96,14401,757,13644,8292363.0,431727.0,7860636.0,107,14,93,14735,1270,13465,8480240.0,723357.0,7756882.0,0.5703,0.5761,0.5696,0.5761
2023-05-12 12:20,956,19,937,100210,863,99347,57441393.0,493469.0,56947924.0,943,13,930,100249,998,99251,57465787.0,569969.0,56895818.0,0.5718,0.5732,0.5711,0.5733
2023-05-12 12:25,153,21,132,16784,1506,15278,34889962.0,26198109.0,8691852.0,144,16,128,15595,1120,14475,34275052.0,25974905.0,8300147.0,17.3958,0.5689,23.1919,0.5734
2023-05-12 12:30,1740,747,993,182756,35475,147281,104644582.0,20212040.0,84432542.0,1740,747,993,182358,35418,146940,104416872.0,20179631.0,84237241.0,0.5698,0.5733,0.5698,0.5733
2023-05-12 12:35,1263,395,868,151923,18968,132955,87024407.0,10810550.0,76213856.0,1256,389,867,152058,18822,133236,87099520.0,10727224.0,76372296.0,0.5699,0.5732,0.5699,0.5732
2023-05-12 12:40,2345,100,2245,341046,8829,332217,195604078.0,5028895.0,190575182.0,2333,94,2239,339010,8381,330629,194449735.0,4783980.0,189665755.0,0.5696,0.5736,0.5708,0.5737
2023-05-12 12:45,1608,204,1404,236845,20369,216476,135829846.0,11627668.0,124202178.0,1597,194,1403,237070,20322,216748,135959339.0,11601216.0,124358123.0,0.5709,0.5737,0.5709,0.5737
2023-05-12 12:50,287,22,265,43665,2169,41496,25051162.0,1238085.0,23813077.0,289,21,268,43677,1981,41696,25056593.0,1130530.0,23926062.0,0.5708,0.5739,0.5707,0.5738
2023-05-12 12:55,473,56,417,31704,2752,28952,18136986.0,1572023.0,16564963.0,463,50,413,31439,2695,28744,17999839.0,1539628.0,16460211.0,0.5712,0.5722,0.5713,0.5726
2023-05-12 13:00,99,15,84,6517,57,6460,3741889.0,32340.0,3709549.0,89,8,81,6130,31,6099,3516700.0,17502.0,3499197.0,0.5674,0.5742,0.5646,0.5737
2023-05-12 13:05,248,12,236,17019,309,16710,9744822.0,176553.0,9568269.0,238,4,234,16799,124,16675,9619228.0,70834.0,9548394.0,0.5714,0.5726,0.5712,0.5726
2023-05-12 13:10,468,324,144,32400,22914,9486,18534398.0,13102010.0,5432387.0,460,321,139,32514,23170,9344,18599655.0,13248169.0,5351485.0,0.5718,0.5727,0.5718,0.5727
2023-05-12 13:15,139,57,82,7918,2435,5483,4535395.0,1392363.0,3143032.0,129,49,80,8011,2196,5815,4591670.0,1255704.0,3335965.0,0.5718,0.5732,0.5718,0.5737
2023-05-12 13:20,77,30,47,8393,1960,6433,4809972.0,1121944.0,3688027.0,66,23,43,7732,1651,6081,4430604.0,943889.0,3486714.0,0.5724,0.5733,0.5717,0.5734
2023-05-12 13:25,313,24,289,16903,1712,15191,9676116.0,977847.0,8698269.0,317,31,286,16598,1544,15054,9503550.0,881918.0,8621632.0,0.5712,0.5726,0.5712,0.5727
2023-05-12 13:30,201,14,187,9926,852,9074,5684194.0,486688.0,5197505.0,196,12,184,9979,831,9148,5714950.0,474708.0,5240242.0,0.5712,0.5728,0.5712,0.5728
2023-05-12 13:35,95,31,64,6341,781,5560,3612284.0,445996.0,3166287.0,84,28,56,5969,704,5265,3417355.0,402098.0,3015257.0,0.5711,0.5695,0.5712,0.5727
2023-05-12 13:40,135,26,109,9341,713,8628,5362047.0,406471.0,4955576.0,106,14,92,7924,108,7816,4546197.0,60864.0,4485333.0,0.5701,0.5744,0.5636,0.5739
2023-05-12 13:45,67,9,58,3918,333,3585,2270711.0,189768.0,2080943.0,64,4,60,3632,265,3367,2104187.0,151221.0,1952966.0,0.5699,0.5805,0.5706,0.58
2023-05-12 13:50,54,6,48,2295,116,2179,1314779.0,65833.0,1248946.0,51,4,47,2534,6,2528,1455584.0,3402.0,1452182.0,0.5675,0.5732,0.567,0.5744
2023-05-12 13:55,51,22,29,4901,1026,3875,2803142.0,585231.0,2217910.0,48,20,28,5016,1111,3905,2868949.0,633778.0,2235171.0,0.5704,0.5724,0.5705,0.5724
2023-05-12 14:00,460,118,342,26205,903,25302,14993331.0,515046.0,14478285.0,457,115,342,26131,861,25270,14951381.0,491158.0,14460223.0,0.5704,0.5722,0.5705,0.5722
2023-05-12 14:05,56,13,43,2544,428,2116,1455310.0,243325.0,1211985.0,54,10,44,2572,275,2297,1472674.0,156967.0,1315707.0,0.5685,0.5728,0.5708,0.5728
2023-05-12 14:10,49,8,41,4218,86,4132,2416217.0,49449.0,2366767.0,44,5,39,4201,123,4078,2405652.0,70023.0,2335629.0,0.575,0.5728,0.5693,0.5727
2023-05-12 14:15,576,380,196,32169,18534,13635,18451457.0,10633404.0,7818053.0,560,371,189,31092,17806,13286,17776120.0,10161640.0,7614480.0,0.5737,0.5734,0.5707,0.5731
2023-05-12 14:20,55,23,32,3002,995,2007,1719624.0,568698.0,1150926.0,49,19,30,2716,720,1996,1555429.0,411546.0,1143882.0,0.5716,0.5735,0.5716,0.5731
2023-05-12 14:25,533,437,96,25923,20472,5451,14808416.0,11683399.0,3125016.0,533,437,96,25886,20473,5413,14787255.0,11683985.0,3103270.0,0.5707,0.5733,0.5707,0.5733
2023-05-12 14:30,90,49,41,5567,2752,2815,3187678.0,1572863.0,1614815.0,79,38,41,5827,2680,3147,3339000.0,1530256.0,1808744.0,0.5715,0.5736,0.571,0.5748
2023-05-12 14:35,80,54,26,3388,1411,1977,1941084.0,807824.0,1133260.0,73,47,26,3399,1392,2007,1945992.0,795533.0,1150458.0,0.5725,0.5732,0.5715,0.5732
2023-05-12 14:40,46,28,18,1971,59,1912,1129080.0,33443.0,1095637.0,41,26,15,1958,56,1902,1122631.0,31993.0,1090638.0,0.5668,0.573,0.5713,0.5734
2023-05-12 14:45,614,55,559,44500,1256,43244,38065160.0,13384704.0,24680456.0,576,33,543,40954,855,40099,36098537.0,13155713.0,22942824.0,10.6566,0.5707,15.3868,0.5722
2023-05-12 14:50,3116,398,2718,428863,31798,397065,296227609.0,68735434.0,227492175.0,3074,359,2715,425674,29403,396271,294423879.0,67366996.0,227056883.0,2.1616,0.5729,2.2912,0.573
2023-05-12 14:55,5038,762,4276,758930,67134,691796,482454861.0,88616220.0,393838640.0,4878,666,4212,753537,65258,688279,479581248.0,87531083.0,392050165.0,1.32,0.5693,1.3413,0.5696
2023-05-12 15:00,1671,649,1022,207866,49357,158509,117949706.0,27888285.0,90061421.0,1604,591,1013,206590,48061,158529,117185981.0,27109512.0,90076469.0,0.565,0.5682,0.5641,0.5682
2023-05-12 15:05,460,309,151,34097,23979,10118,44636117.0,38894098.0,5742019.0,427,286,141,33009,22970,10039,44032470.0,38328835.0,5703635.0,1.622,0.5675,1.6686,0.5681
2023-05-12 15:10,777,228,549,52095,16163,35932,42242529.0,21823409.0,20419120.0,755,213,542,51459,15346,36113,41890695.0,21346012.0,20544683.0,1.3502,0.5683,1.391,0.5689
2023-05-12 15:15,1715,391,1324,211594,28352,183242,158444240.0,54113236.0,104331003.0,1670,363,1307,209066,27760,181306,156954697.0,53719143.0,103235554.0,1.9086,0.5694,1.9351,0.5694
2023-05-12 15:20,1815,640,1175,226437,46543,179894,128531075.0,26191483.0,102339592.0,1779,612,1167,224159,44831,179328,127334488.0,25315953.0,102018535.0,0.5627,0.5689,0.5647,0.5689
2023-05-12 15:25,1444,232,1212,188128,14203,173925,144268784.0,45996899.0,98271884.0,1385,193,1192,185669,13132,172537,142947769.0,45391115.0,97556653.0,3.2385,0.565,3.4565,0.5654
2023-05-12 15:30,214,93,121,18850,6620,12230,23361629.0,16417184.0,6944445.0,170,58,112,15579,3736,11843,21482469.0,14765612.0,6716856.0,2.4799,0.5678,3.9523,0.5672
2023-05-12 15:35,613,97,516,50083,6768,43315,28441292.0,3820705.0,24620586.0,601,85,516,50483,6485,43998,28681025.0,3666636.0,25014389.0,0.5645,0.5684,0.5654,0.5685
2023-05-12 15:40,167,43,124,14645,2715,11930,21004911.0,14206644.0,6798267.0,140,29,111,13129,2196,10933,20138499.0,13911192.0,6227307.0,5.2326,0.5698,6.3348,0.5696
2023-05-12 15:45,598,93,505,50146,6270,43876,28537002.0,3579118.0,24957883.0,591,88,503,50356,6430,43926,28622812.0,3632900.0,24989912.0,0.5708,0.5688,0.565,0.5689
2023-05-12 15:50,1252,97,1155,200890,4177,196713,126742629.0,15054944.0,111687685.0,1232,86,1146,198780,3261,195519,125585561.0,14511402.0,111074159.0,3.6042,0.5678,4.45,0.5681
2023-05-12 15:55,532,138,394,55992,7155,48837,44533519.0,16745496.0,27788023.0,517,126,391,55813,6692,49121,44413708.0,16460606.0,27953102.0,2.3404,0.569,2.4597,0.5691
2023-05-12 16:00,412,141,271,45830,8328,37502,26056283.0,4720382.0,21335901.0,403,128,275,46434,8700,37734,26393042.0,4928981.0,21464061.0,0.5668,0.5689,0.5665,0.5688
2023-05-12 16:05,355,60,295,29547,2415,27132,16830923.0,1370790.0,15460133.0,329,45,284,28752,2000,26752,16381294.0,1134909.0,15246384.0,0.5676,0.5698,0.5675,0.5699
2023-05-12 16:10,88,32,56,6873,1282,5591,3909717.0,727140.0,3182577.0,69,18,51,5850,1002,4848,3329388.0,568235.0,2761153.0,0.5672,0.5692,0.5671,0.5695
2023-05-12 16:15,274,31,243,18796,1926,16870,10664724.0,1090584.0,9574140.0,260,29,231,18268,1608,16660,10372907.0,909943.0,9462963.0,0.5662,0.5675,0.5659,0.568
2023-05-12 16:20,608,164,444,52413,11700,40713,29794883.0,6626536.0,23168346.0,588,151,437,52293,11612,40681,29741684.0,6576959.0,23164724.0,0.5664,0.5691,0.5664,0.5694
2023-05-12 16:25,143,70,73,10283,2791,7492,5836629.0,1577743.0,4258885.0,127,58,69,9534,2630,6904,5411441.0,1487851.0,3923590.0,0.5653,0.5685,0.5657,0.5683
2023-05-12 16:30,403,96,307,31775,6842,24933,18058209.0,3876658.0,14181551.0,397,86,311,31484,6006,25478,17888975.0,3397147.0,14491827.0,0.5666,0.5688,0.5656,0.5688
2023-05-12 16:35,716,101,615,77424,4731,72693,56386172.0,14968823.0,41417348.0,709,98,611,76954,4665,72289,56494435.0,15310055.0,41184379.0,3.164,0.5698,3.2819,0.5697
2023-05-12 16:40,1021,99,922,112361,3599,108762,64057141.0,2041368.0,62015772.0,1012,93,919,112073,3372,108701,63897695.0,1911811.0,61985884.0,0.5672,0.5702,0.567,0.5702
2023-05-12 16:45,896,279,617,92511,18816,73695,52718892.0,10692402.0,42026490.0,885,277,608,92206,18564,73642,52545019.0,10547302.0,41997717.0,0.5683,0.5703,0.5682,0.5703
2023-05-12 16:50,736,43,693,65954,539,65415,37550749.0,305632.0,37245117.0,731,38,693,65943,583,65360,37544585.0,330552.0,37214033.0,0.567,0.5694,0.567,0.5694
2023-05-12 16:55,939,66,873,91376,2285,89091,52036305.0,1298981.0,50737323.0,931,62,869,91045,2079,88966,51845233.0,1179615.0,50665617.0,0.5685,0.5695,0.5674,0.5695
2023-05-12 17:00,157,19,138,10549,563,9986,6012606.0,317779.0,5694827.0,153,15,138,10743,645,10098,6123100.0,364582.0,5758518.0,0.5644,0.5703,0.5652,0.5703
2023-05-12 17:05,224,13,211,27274,417,26857,15543677.0,236922.0,15306755.0,213,6,207,26615,129,26486,15173237.0,73277.0,15099959.0,0.5682,0.5699,0.568,0.5701
2023-05-12 17:10,1189,26,1163,197821,4466,193355,113117139.0,2542891.0,110574247.0,1171,18,1153,194267,2836,191431,111084473.0,1612370.0,109472102.0,0.5694,0.5719,0.5685,0.5719
2023-05-12 17:15,907,46,861,119242,2194,117048,80417388.0,13519589.0,66897798.0,888,34,854,119778,2941,116837,80720328.0,13942568.0,66777760.0,6.1621,0.5715,4.7408,0.5715
2023-05-12 17:20,1144,33,1111,151557,1533,150024,86567552.0,872017.0,85695534.0,1136,31,1105,150413,773,149640,85913358.0,436851.0,85476506.0,0.5688,0.5712,0.5651,0.5712
2023-05-12 17:25,691,156,535,64399,7770,56629,36782145.0,4426186.0,32355958.0,680,150,530,64000,7285,56715,36551802.0,4147023.0,32404779.0,0.5697,0.5714,0.5693,0.5714
2023-05-12 17:30,90,25,65,6010,1044,4966,3430977.0,593067.0,2837910.0,84,25,59,6522,1770,4752,3709269.0,994232.0,2715037.0,0.5681,0.5715,0.5617,0.5713
2023-05-12 17:35,98,29,69,6966,1184,5782,3987005.0,674296.0,3312708.0,90,26,64,6754,1030,5724,3866212.0,586824.0,3279388.0,0.5695,0.5729,0.5697,0.5729
2023-05-12 17:40,177,23,154,17772,754,17018,10180885.0,429483.0,9751402.0,168,18,150,18289,1734,16555,10472388.0,983963.0,9488424.0,0.5696,0.573,0.5675,0.5731
2023-05-12 17:45,535,53,482,62373,2083,60290,35816175.0,1183815.0,34632360.0,533,52,481,62831,2126,60705,36082005.0,1208669.0,34873336.0,0.5683,0.5744,0.5685,0.5745
2023-05-12 17:50,780,47,733,113798,1610,112188,65581134.0,915780.0,64665354.0,770,44,726,113062,1272,111790,65157011.0,723430.0,64433580.0,0.5688,0.5764,0.5687,0.5764
2023-05-12 17:55,312,12,300,43154,120,43034,24834079.0,77850.0,24756228.0,299,7,292,43100,23,43077,24795125.0,13077.0,24782047.0,0.6488,0.5753,0.5686,0.5753
2023-05-12 18:00,35,21,14,2106,607,1499,1200574.0,343701.0,856872.0,31,18,13,2489,1092,1397,1410021.0,610899.0,799122.0,0.5662,0.5716,0.5594,0.572
2023-05-12 18:05,78,15,63,7161,435,6726,4095701.0,247920.0,3847781.0,72,16,56,7682,560,7122,4395450.0,317186.0,4078264.0,0.5699,0.5721,0.5664,0.5726
2023-05-12 18:10,673,132,541,49306,7017,42289,28070098.0,3993056.0,24077042.0,655,121,534,47855,6551,41304,27310746.0,3728607.0,23582139.0,0.5691,0.5693,0.5692,0.5709
2023-05-12 18:15,529,86,443,47352,5514,41838,27030577.0,3139887.0,23890690.0,521,83,438,45033,5547,39486,25697513.0,3147233.0,22550280.0,0.5694,0.571,0.5674,0.5711
2023-05-12 18:20,1028,302,726,164580,23604,140976,167008843.0,87021113.0,79987730.0,1002,276,726,159998,20826,139172,164546686.0,85455682.0,79091004.0,3.6867,0.5674,4.1033,0.5683
2023-05-12 18:25,1406,293,1113,141729,29072,112657,129758479.0,65702456.0,64056023.0,1327,254,1073,137621,25650,111971,127288800.0,63607107.0,63681692.0,2.26,0.5686,2.4798,0.5687
2023-05-12 18:30,1273,377,896,97230,26591,70639,92086906.0,51878789.0,40208116.0,1260,365,895,96848,26841,70007,91862588.0,52011137.0,39851450.0,1.951,0.5692,1.9377,0.5692
2023-05-12 18:35,986,45,941,92009,2759,89250,52424850.0,1561477.0,50863373.0,976,36,940,92809,3056,89753,52882813.0,1728278.0,51154534.0,0.566,0.5699,0.5655,0.5699
2023-05-15 10:00,2138,800,1338,167209,54191,113018,102746199.0,37992201.0,64753998.0,1792,650,1142,147947,40793,107154,86695129.0,25507526.0,61187603.0,0.7011,0.573,0.6253,0.571
2023-05-15 10:05,1096,470,626,124104,39765,84339,82955574.0,34554181.0,48401392.0,981,424,557,118623,37794,80829,73404146.0,27034246.0,46369900.0,0.869,0.5739,0.7153,0.5737
2023-05-15 10:10,189,100,89,9571,4246,5325,5465733.0,2423574.0,3042158.0,147,73,74,8276,3821,4455,4727511.0,2179848.0,2547663.0,0.5708,0.5713,0.5705,0.5719
2023-05-15 10:15,731,356,375,68820,24521,44299,39485771.0,14045625.0,25440146.0,693,337,356,65877,22444,43433,37738982.0,12802348.0,24936633.0,0.5728,0.5743,0.5704,0.5741
2023-05-15 10:20,3205,445,2760,445672,21727,423945,266971541.0,24223655.0,242747886.0,3155,417,2738,442558,20171,422387,265263727.0,23337761.0,241925966.0,1.1149,0.5726,1.157,0.5728
2023-05-15 10:25,2494,1168,1326,226245,101593,124652,141101112.0,69770944.0,71330168.0,2315,1089,1226,222422,99818,122604,138936199.0,68709544.0,70226655.0,0.6868,0.5722,0.6883,0.5728
2023-05-15 10:30,2616,848,1768,305651,65853,239798,186220692.0,49159544.0,137061147.0,2565,814,1751,303727,63821,239906,185192476.0,48064731.0,137127745.0,0.7465,0.5716,0.7531,0.5716
2023-05-15 10:35,484,272,212,34056,17289,16767,31262493.0,21666216.0,9596277.0,457,257,200,32658,16055,16603,30526848.0,21028948.0,9497900.0,1.2532,0.5723,1.3098,0.5721
2023-05-15 10:40,402,294,108,25310,17297,8013,14431416.0,9864824.0,4566592.0,386,287,99,24910,17253,7657,14211253.0,9835394.0,4375859.0,0.5703,0.5699,0.5701,0.5715
2023-05-15 10:45,336,251,85,21325,15072,6253,12165363.0,8590166.0,3575197.0,313,238,75,20674,14671,6003,11795568.0,8362821.0,3432747.0,0.5699,0.5718,0.57,0.5718
2023-05-15 10:50,519,336,183,28753,15577,13176,28271939.0,20745240.0,7526698.0,488,327,161,28674,15775,12899,28220945.0,20856955.0,7363990.0,1.3318,0.5712,1.3222,0.5709
2023-05-15 10:55,1613,1195,418,87030,56680,30350,49586873.0,32264078.0,17322794.0,1593,1185,408,86805,56557,30248,49456794.0,32193318.0,17263475.0,0.5692,0.5708,0.5692,0.5707
2023-05-15 11:00,987,710,277,58840,39062,19778,33544753.0,22240868.0,11303884.0,976,707,269,58308,38885,19423,33228567.0,22138840.0,11089727.0,0.5694,0.5715,0.5693,0.571
2023-05-15 11:05,408,281,127,23873,15485,8388,25485435.0,20696378.0,4789057.0,385,269,116,23635,15575,8060,25350848.0,20743181.0,4607666.0,1.3365,0.5709,1.3318,0.5717
2023-05-15 11:10,855,585,270,73691,44437,29254,42020783.0,25294828.0,16725955.0,845,578,267,73519,44379,29140,41921722.0,25261414.0,16660307.0,0.5692,0.5717,0.5692,0.5717
2023-05-15 11:15,560,394,166,45785,30705,15080,26100529.0,17476856.0,8623673.0,550,384,166,45344,30109,15235,25850047.0,17136631.0,8713416.0,0.5692,0.5719,0.5692,0.5719
2023-05-15 11:20,1595,1236,359,137254,90562,46692,78458101.0,51625130.0,26832970.0,1579,1229,350,136223,90252,45971,77848149.0,51433103.0,26415046.0,0.5701,0.5747,0.5699,0.5746
2023-05-15 11:25,1640,1546,94,131225,123356,7869,86695449.0,82189728.0,4505721.0,1620,1531,89,130900,123121,7779,86509772.0,82055176.0,4454596.0,0.6663,0.5726,0.6665,0.5726
2023-05-15 11:30,82,39,43,6015,1729,4286,3445349.0,984883.0,2460466.0,69,32,37,5804,1440,4364,3320763.0,819099.0,2501664.0,0.5696,0.5741,0.5688,0.5733
2023-05-15 11:35,479,31,448,63779,1550,62229,36634447.0,892703.0,35741744.0,461,20,441,63207,1310,61897,36308879.0,746798.0,35562080.0,0.5759,0.5744,0.5701,0.5745
2023-05-15 11:40,676,59,617,74547,4117,70430,42732737.0,2352131.0,40380606.0,674,60,614,74496,4092,70404,42704344.0,2337816.0,40366527.0,0.5713,0.5733,0.5713,0.5734
2023-05-15 11:45,426,135,291,41677,9641,32036,23894016.0,5504845.0,18389170.0,405,128,277,40516,9144,31372,23203248.0,5220133.0,17983114.0,0.571,0.574,0.5709,0.5732
2023-05-15 11:50,1755,1353,402,171843,118032,53811,98217968.0,67379614.0,30838354.0,1743,1347,396,171638,117810,53828,98096654.0,67246485.0,30850168.0,0.5709,0.5731,0.5708,0.5731
2023-05-15 11:55,1193,921,272,110993,80832,30161,63392797.0,46106334.0,17286463.0,1181,919,262,110724,80687,30037,63239940.0,46028866.0,17211074.0,0.5704,0.5731,0.5705,0.573
2023-05-15 12:00,950,607,343,86392,56142,30250,49320829.0,31989848.0,17330981.0,950,608,342,87156,56581,30575,49738686.0,32220736.0,17517949.0,0.5698,0.5729,0.5695,0.573
2023-05-15 12:05,23,14,9,521,345,176,308172.0,205311.0,102861.0,18,12,6,443,348,95,253561.0,199036.0,54525.0,0.5951,0.5844,0.5719,0.574
2023-05-15 12:10,44,19,25,2410,966,1444,1380963.0,551847.0,829115.0,30,11,19,1487,466,1021,852086.0,266309.0,585776.0,0.5713,0.5742,0.5715,0.5737
2023-05-15 12:15,156,86,70,12917,6924,5993,19269650.0,15828605.0,3441044.0,143,81,62,11285,5831,5454,18332665.0,15201154.0,3131510.0,2.286,0.5742,2.607,0.5742
2023-05-15 12:20,111,56,55,6956,3678,3278,3981968.0,2096999.0,1884968.0,99,54,45,6722,3610,3112,3845813.0,2056854.0,1788959.0,0.5701,0.575,0.5698,0.5749
2023-05-15 12:25,1842,1127,715,171673,100452,71221,110417304.0,69404999.0,41012305.0,1811,1113,698,171365,100040,71325,110229348.0,69154865.0,41074483.0,0.6909,0.5758,0.6913,0.5759
2023-05-15 12:30,1548,865,683,141048,77176,63872,92900977.0,56101059.0,36799917.0,1526,867,659,139915,76547,63368,92252116.0,55736046.0,36516069.0,0.7269,0.5762,0.7281,0.5763
2023-05-15 12:35,286,37,249,18822,2875,15947,10840609.0,1643119.0,9197489.0,271,30,241,18683,2545,16138,10771932.0,1460954.0,9310978.0,0.5715,0.5768,0.574,0.577
2023-05-15 12:40,2160,1654,506,200389,157208,43181,115023730.0,90155267.0,24868463.0,2138,1642,496,199028,156480,42548,114239462.0,89736063.0,24503398.0,0.5735,0.5759,0.5735,0.5759
2023-05-15 12:45,3668,2927,741,359927,302028,57899,206464353.0,173134168.0,33330185.0,3661,2929,732,361359,303908,57451,207274987.0,174207502.0,33067485.0,0.5732,0.5757,0.5732,0.5756
2023-05-15 12:50,1904,1222,682,195046,134290,60756,207002623.0,171983800.0,35018823.0,1885,1215,670,194745,134220,60525,206850264.0,171944191.0,34906072.0,1.2807,0.5764,1.2811,0.5767
2023-05-15 12:55,998,328,670,75160,25222,49938,43147910.0,14443817.0,28704092.0,991,322,669,74872,25201,49671,42979501.0,14429237.0,28550264.0,0.5727,0.5748,0.5726,0.5748
2023-05-15 13:00,914,657,257,75516,51923,23593,43321946.0,29752624.0,13569322.0,899,652,247,75242,51574,23668,43179477.0,29552729.0,13626748.0,0.573,0.5751,0.573,0.5757
2023-05-15 13:05,547,253,294,43916,19116,24800,37169153.0,22851966.0,14317186.0,531,246,285,41737,19117,22620,35865022.0,22835986.0,13029035.0,1.1954,0.5773,1.1945,0.576
2023-05-15 13:10,1249,370,879,110831,28364,82467,63888636.0,16251679.0,47636956.0,1240,367,873,107782,26760,81022,62056277.0,15370710.0,46685567.0,0.573,0.5776,0.5744,0.5762
2023-05-15 13:15,599,182,417,56988,14195,42793,32819617.0,8149718.0,24669898.0,589,178,411,56720,14292,42428,32646437.0,8198452.0,24447984.0,0.5741,0.5765,0.5736,0.5762
2023-05-15 13:20,370,178,192,33099,13747,19352,19089340.0,7934420.0,11154919.0,360,169,191,32997,13239,19758,18999349.0,7607457.0,11391891.0,0.5772,0.5764,0.5746,0.5766
2023-05-15 13:25,733,300,433,61723,22137,39586,35541079.0,12725067.0,22816012.0,720,294,426,61412,22165,39247,35358270.0,12737861.0,22620408.0,0.5748,0.5764,0.5747,0.5764
2023-05-15 13:30,198,85,113,10684,4242,6442,6149369.0,2436812.0,3712557.0,187,79,108,10511,4110,6401,6050441.0,2360793.0,3689647.0,0.5744,0.5763,0.5744,0.5764
2023-05-15 13:35,92,16,76,6429,1320,5109,3694009.0,747118.0,2946890.0,89,16,73,5787,591,5196,3336841.0,339804.0,2997037.0,0.566,0.5768,0.575,0.5768
2023-05-15 13:40,381,86,295,25074,6437,18637,14466143.0,3696124.0,10770019.0,357,77,280,22714,5500,17214,13079911.0,3159919.0,9919991.0,0.5742,0.5779,0.5745,0.5763
2023-05-15 13:45,644,233,411,52532,14129,38403,42246513.0,20016222.0,22230290.0,594,211,383,50685,13061,37624,41171483.0,19389826.0,21781656.0,1.4167,0.5789,1.4846,0.5789
2023-05-15 13:50,159,103,56,9861,6731,3130,5678092.0,3872398.0,1805693.0,142,98,44,12031,7536,4495,6960587.0,4335361.0,2625225.0,0.5753,0.5769,0.5753,0.584
2023-05-15 13:55,235,150,85,17728,12420,5308,10218915.0,7150042.0,3068873.0,226,145,81,17639,12422,5217,10164242.0,7146961.0,3017281.0,0.5757,0.5782,0.5753,0.5784
2023-05-15 14:00,223,165,58,18762,14938,3824,10803515.0,8590570.0,2212945.0,220,164,56,18499,14497,4002,10653493.0,8338340.0,2315153.0,0.5751,0.5787,0.5752,0.5785
2023-05-15 14:05,392,207,185,29944,16337,13607,17252652.0,9398801.0,7853850.0,376,201,175,29427,16066,13361,16963479.0,9243890.0,7719589.0,0.5753,0.5772,0.5754,0.5778
2023-05-15 14:10,260,163,97,15434,10156,5278,20739752.0,17716843.0,3022908.0,247,161,86,14882,10364,4518,20439267.0,17835657.0,2603610.0,1.7445,0.5727,1.7209,0.5763
2023-05-15 14:15,207,120,87,12321,6956,5365,7087292.0,3995040.0,3092251.0,191,112,79,11588,6330,5258,6666102.0,3635437.0,3030664.0,0.5743,0.5764,0.5743,0.5764
2023-05-15 14:20,174,74,100,10750,3850,6900,6184361.0,2213736.0,3970625.0,165,71,94,10117,3749,6368,5825409.0,2155511.0,3669898.0,0.575,0.5755,0.575,0.5763
2023-05-15 14:25,142,82,60,10741,6578,4163,6181699.0,3780620.0,2401078.0,142,81,61,10894,6583,4311,6269739.0,3783383.0,2486355.0,0.5747,0.5768,0.5747,0.5767
2023-05-15 14:30,71,46,25,3178,1543,1635,1829083.0,886972.0,942111.0,62,40,22,2993,1460,1533,1722800.0,839403.0,883397.0,0.5748,0.5762,0.5749,0.5763
2023-05-15 14:35,94,35,59,5970,1898,4072,3449577.0,1090968.0,2358609.0,82,30,52,5445,1864,3581,3138666.0,1070964.0,2067701.0,0.5748,0.5792,0.5746,0.5774
2023-05-15 14:40,291,169,122,15648,6102,9546,8994054.0,3502996.0,5491058.0,284,167,117,15398,6094,9304,8855285.0,3498710.0,5356574.0,0.5741,0.5752,0.5741,0.5757
2023-05-15 14:45,555,269,286,41889,22043,19846,24078392.0,12659429.0,11418963.0,548,265,283,41576,21839,19737,23899348.0,12542829.0,11356518.0,0.5743,0.5754,0.5743,0.5754
2023-05-15 14:50,663,400,263,45107,27005,18102,25930055.0,15507513.0,10422541.0,657,397,260,45099,26951,18148,25925341.0,15476350.0,10448991.0,0.5742,0.5758,0.5742,0.5758
2023-05-15 14:55,1080,338,742,82286,26940,55346,47274568.0,15445567.0,31829000.0,1065,331,734,81622,26650,54972,46894116.0,15279460.0,31614656.0,0.5733,0.5751,0.5733,0.5751
2023-05-15 15:00,648,272,376,46531,18300,28231,26718366.0,10489756.0,16228610.0,645,271,374,46441,18495,27946,26666644.0,10601810.0,16064834.0,0.5732,0.5749,0.5732,0.5749
2023-05-15 15:05,1072,462,610,88976,39504,49472,51083799.0,22637930.0,28445868.0,1063,456,607,89057,39510,49547,51130299.0,22641320.0,28488978.0,0.5731,0.575,0.5731,0.575
2023-05-15 15:10,1429,404,1025,114278,33252,81026,65662966.0,19051445.0,46611520.0,1425,401,1024,114217,33266,80951,65626800.0,19058627.0,46568172.0,0.5729,0.5753,0.5729,0.5753
2023-05-15 15:15,1093,420,673,87976,33001,54975,50642415.0,18968559.0,31673856.0,1078,412,666,86966,32291,54675,50011478.0,18509889.0,31501589.0,0.5748,0.5762,0.5732,0.5762
2023-05-15 15:20,707,630,77,55252,51981,3271,31696903.0,29810447.0,1886455.0,703,630,73,55489,52368,3121,31828973.0,30029232.0,1799740.0,0.5735,0.5767,0.5734,0.5767
2023-05-15 15:25,705,567,138,38648,27554,11094,22207354.0,15816840.0,6390513.0,698,565,133,38056,27351,10705,21868840.0,15700045.0,6168794.0,0.574,0.576,0.574,0.5763
2023-05-15 15:30,270,141,129,16744,7318,9426,9632537.0,4198833.0,5433704.0,266,140,126,16445,7180,9265,9461050.0,4119779.0,5341270.0,0.5738,0.5765,0.5738,0.5765
2023-05-15 15:35,835,758,77,34564,25946,8618,19825303.0,14870050.0,4955252.0,830,757,73,34542,25945,8597,19813129.0,14869620.0,4943509.0,0.5731,0.575,0.5731,0.575
2023-05-15 15:40,659,581,78,23430,18912,4518,13421605.0,10833931.0,2587673.0,652,577,75,23064,18840,4224,13220603.0,10791821.0,2428782.0,0.5729,0.5727,0.5728,0.575
2023-05-15 15:45,589,425,164,29793,19068,10725,17098458.0,10934006.0,6164452.0,580,421,159,29660,18959,10701,17014667.0,10863801.0,6150865.0,0.5734,0.5748,0.573,0.5748
2023-05-15 15:50,494,434,60,28725,25391,3334,16472431.0,14560770.0,1911660.0,484,430,54,28610,25537,3073,16410262.0,14644071.0,1766191.0,0.5735,0.5734,0.5734,0.5747
2023-05-15 15:55,775,635,140,39942,29005,10937,22923692.0,16630841.0,6292851.0,774,633,141,39816,29003,10813,22851074.0,16629721.0,6221353.0,0.5734,0.5754,0.5734,0.5754
2023-05-15 16:00,508,254,254,28196,10730,17466,16178384.0,6141932.0,10036452.0,503,252,251,28073,10557,17516,16110020.0,6042751.0,10067268.0,0.5724,0.5746,0.5724,0.5747
2023-05-15 16:05,685,366,319,38984,17242,21742,22386692.0,9889439.0,12497253.0,680,365,315,38999,17334,21665,22386170.0,9933187.0,12452982.0,0.5736,0.5748,0.573,0.5748
2023-05-15 16:10,370,289,81,19583,14080,5503,11234902.0,8072052.0,3162850.0,359,285,74,19415,13936,5479,11138754.0,7988793.0,3149960.0,0.5733,0.5748,0.5732,0.5749
2023-05-15 16:15,921,513,408,54783,23298,31485,31457424.0,13356008.0,18101416.0,917,511,406,54922,23465,31457,31536912.0,13451644.0,18085268.0,0.5733,0.5749,0.5733,0.5749
2023-05-15 16:20,1447,1060,387,111175,82167,29008,63783180.0,47108855.0,16674325.0,1446,1059,387,111275,82049,29226,63841438.0,47041219.0,16800218.0,0.5733,0.5748,0.5733,0.5748
2023-05-15 16:25,1357,1038,319,101906,80003,21903,58458992.0,45868260.0,12590732.0,1350,1035,315,101929,79982,21947,58472700.0,45856307.0,12616393.0,0.5733,0.5748,0.5733,0.5749
2023-05-15 16:30,1810,1282,528,141004,105347,35657,80866796.0,60372185.0,20494610.0,1802,1277,525,140882,105259,35623,80797494.0,60320980.0,20476514.0,0.5731,0.5748,0.5731,0.5748
2023-05-15 16:35,1560,1179,381,123915,95161,28754,71068432.0,54540921.0,16527510.0,1556,1177,379,123773,95082,28691,70981713.0,54490264.0,16491449.0,0.5731,0.5748,0.5731,0.5748
2023-05-15 16:40,1481,1105,376,116684,87078,29606,66924880.0,49910874.0,17014005.0,1475,1102,373,116578,87026,29552,66868210.0,49881039.0,16987171.0,0.5732,0.5747,0.5732,0.5748
2023-05-15 16:45,349,244,105,24289,18986,5303,13963399.0,10914564.0,3048835.0,340,240,100,23714,18657,5057,13598118.0,10690741.0,2907377.0,0.5749,0.5749,0.573,0.5749
2023-05-15 16:50,641,599,42,32010,30566,1444,18338739.0,17508338.0,830400.0,635,593,42,31660,30083,1577,18137892.0,17231084.0,906808.0,0.5728,0.5751,0.5728,0.575
2023-05-15 16:55,1662,629,1033,218528,67875,150653,232279594.0,145753410.0,86526184.0,1591,587,1004,209782,62899,146883,227291260.0,142892735.0,84398525.0,2.1474,0.5743,2.2718,0.5746
2023-05-15 17:00,2914,1703,1211,361630,268753,92877,219387286.0,165985870.0,53401415.0,2864,1679,1185,357735,267319,90416,217089630.0,165065342.0,52024287.0,0.6176,0.575,0.6175,0.5754
2023-05-15 17:05,2567,1666,901,290556,224852,65704,166895617.0,128961152.0,37934465.0,2544,1659,885,289682,224668,65014,166363785.0,128825221.0,37538564.0,0.5735,0.5774,0.5734,0.5774
2023-05-15 17:10,2087,412,1675,244171,49825,194346,163962958.0,52298075.0,111664883.0,2051,390,1661,241720,48444,193276,162624325.0,51489161.0,111135163.0,1.0496,0.5746,1.0629,0.575
2023-05-15 17:15,608,142,466,65863,20613,45250,61619094.0,35550226.0,26068867.0,576,119,457,64344,19702,44642,60747705.0,35027947.0,25719758.0,1.7247,0.5761,1.7779,0.5761
2023-05-15 17:20,422,91,331,49020,12132,36888,40089709.0,18824551.0,21265157.0,405,81,324,48900,12199,36701,40042052.0,18862395.0,21179657.0,1.5516,0.5765,1.5462,0.5771
2023-05-15 17:25,1008,273,735,118693,36854,81839,68294125.0,21100146.0,47193979.0,996,267,729,118150,36567,81583,67976756.0,20929147.0,47047609.0,0.5725,0.5767,0.5724,0.5767
2023-05-15 17:30,917,429,488,77815,38199,39616,44728345.0,21899506.0,22828839.0,903,418,485,77682,38122,39560,44649590.0,21853198.0,22796391.0,0.5733,0.5763,0.5732,0.5762
2023-05-15 17:35,314,257,57,20014,16449,3565,23365828.0,21324770.0,2041058.0,293,239,54,19507,16102,3405,23084842.0,21123721.0,1961120.0,1.2964,0.5725,1.3119,0.576
2023-05-15 17:40,98,66,32,6842,4066,2776,3935728.0,2334530.0,1601198.0,93,65,28,6356,3965,2391,3655232.0,2276353.0,1378878.0,0.5742,0.5768,0.5741,0.5767
2023-05-15 17:45,94,61,33,3551,2214,1337,2034831.0,1272231.0,762599.0,78,47,31,3579,2167,1412,2055402.0,1241441.0,813960.0,0.5746,0.5704,0.5729,0.5765
2023-05-15 17:50,293,69,224,19869,3885,15984,11429316.0,2233731.0,9195584.0,279,57,222,18436,3692,14744,10601812.0,2118731.0,8483081.0,0.575,0.5753,0.5739,0.5754
2023-05-15 17:55,159,116,43,10187,8694,1493,5826127.0,4987482.0,838645.0,144,108,36,9579,8120,1459,5500689.0,4657778.0,842911.0,0.5737,0.5617,0.5736,0.5777
2023-05-15 18:00,165,123,42,9713,8508,1205,5574132.0,4879578.0,694554.0,157,117,40,10406,9149,1257,5947130.0,5221064.0,726066.0,0.5735,0.5764,0.5707,0.5776
2023-05-15 18:05,98,54,44,5271,3251,2020,3033027.0,1865260.0,1167766.0,85,47,38,4438,2910,1528,2548999.0,1668832.0,880167.0,0.5737,0.5781,0.5735,0.576
2023-05-15 18:10,313,269,44,6952,4668,2284,3997351.0,2678954.0,1318397.0,308,266,42,7048,4799,2249,4051693.0,2753602.0,1298091.0,0.5739,0.5772,0.5738,0.5772
2023-05-15 18:15,101,79,22,5155,4383,772,2960157.0,2515842.0,444315.0,88,70,18,4991,4294,697,2864813.0,2463657.0,401156.0,0.574,0.5755,0.5737,0.5755
2023-05-15 18:20,54,41,13,2646,1685,961,1521146.0,967272.0,553873.0,48,36,12,2683,1723,960,1542453.0,988813.0,553639.0,0.574,0.5764,0.5739,0.5767
2023-05-15 18:25,259,138,121,17908,11905,6003,10292776.0,6835506.0,3457269.0,251,135,116,17420,11314,6106,10011839.0,6495434.0,3516405.0,0.5742,0.5759,0.5741,0.5759
2023-05-15 18:30,286,167,119,20677,15257,5420,11883251.0,8762801.0,3120450.0,304,175,129,21095,15671,5424,12121626.0,8998179.0,3123447.0,0.5743,0.5757,0.5742,0.5759
2023-05-15 18:35,385,109,276,27893,9751,18142,16048884.0,5599104.0,10449780.0,386,109,277,29044,10167,18877,16712442.0,5832588.0,10879853.0,0.5742,0.576,0.5737,0.5764
2023-05-16 10:00,1139,694,445,95661,69774,25887,63993689.0,48803931.0,15189758.0,797,535,262,74426,53828,20598,45332676.0,33354261.0,11978415.0,0.6995,0.5868,0.6196,0.5815
2023-05-16 10:05,2489,437,2052,369047,47077,321970,231030091.0,43084771.0,187945320.0,2344,392,1952,368705,49395,319310,230003590.0,43603241.0,186400348.0,0.9152,0.5837,0.8827,0.5838
2023-05-16 10:10,1194,431,763,93262,31564,61698,54136981.0,18228262.0,35908718.0,1133,400,733,91542,31017,60525,53120984.0,17909402.0,35211582.0,0.5775,0.582,0.5774,0.5818
2023-05-16 10:15,1667,658,1009,192384,47120,145264,123695913.0,39189999.0,84505914.0,1592,621,971,185086,42229,142857,115591135.0,32386252.0,83204883.0,0.8317,0.5817,0.7669,0.5824
2023-05-16 10:20,662,216,446,63535,19278,44257,36806374.0,11211900.0,25594474.0,592,187,405,56747,16353,40394,33070597.0,9500851.0,23569746.0,0.5816,0.5783,0.581,0.5835
2023-05-16 10:25,2471,1458,1013,360377,259992,100385,268179997.0,209820317.0,58359680.0,2409,1430,979,358076,260200,97876,266866870.0,209885999.0,56980870.0,0.807,0.5814,0.8066,0.5822
2023-05-16 10:30,3640,2871,769,533049,475612,57437,368934000.0,335357167.0,33576832.0,3551,2831,720,526136,471954,54182,364695563.0,333114650.0,31580913.0,0.7051,0.5846,0.7058,0.5829
2023-05-16 10:35,3284,1935,1349,436680,329033,107647,349279186.0,286276807.0,63002379.0,3116,1883,1233,430413,327236,103177,345737399.0,285226648.0,60510751.0,0.8701,0.5853,0.8716,0.5865
2023-05-16 10:40,1774,770,1004,223986,146991,76995,142103129.0,97112983.0,44990145.0,1743,758,985,223138,146649,76489,141628721.0,96911746.0,44716974.0,0.6607,0.5843,0.6608,0.5846
2023-05-16 10:45,3235,1933,1302,383148,285993,97155,234774834.0,178013420.0,56761414.0,3208,1921,1287,381356,286911,94445,233692707.0,178507802.0,55184904.0,0.6224,0.5842,0.6222,0.5843
2023-05-16 10:50,1752,895,857,171749,100094,71655,111932893.0,70060910.0,41871982.0,1654,841,813,170644,99457,71187,111300246.0,69679045.0,41621200.0,0.7,0.5844,0.7006,0.5847
2023-05-16 10:55,3683,1440,2243,423606,181924,241682,271133053.0,129709734.0,141423319.0,3641,1424,2217,421623,181275,240348,269969071.0,129276816.0,140692255.0,0.713,0.5852,0.7132,0.5854
2023-05-16 11:00,2516,1028,1488,290955,83254,207701,170039240.0,48429930.0,121609309.0,2486,1008,1478,290573,82659,207914,169802883.0,48063968.0,121738915.0,0.5817,0.5855,0.5815,0.5855
2023-05-16 11:05,1583,992,591,155532,86977,68555,90809424.0,50681469.0,40127954.0,1543,977,566,152881,86455,66426,89274504.0,50378178.0,38896325.0,0.5827,0.5853,0.5827,0.5856
2023-05-16 11:10,315,143,172,21921,11803,10118,12778956.0,6887252.0,5891703.0,299,136,163,19737,10570,9167,11504290.0,6154444.0,5349845.0,0.5835,0.5823,0.5823,0.5836
2023-05-16 11:15,694,432,262,42975,27923,15052,25006209.0,16224713.0,8781496.0,657,414,243,44710,27857,16853,26033018.0,16186607.0,9846411.0,0.5811,0.5834,0.5811,0.5843
2023-05-16 11:20,750,318,432,48245,22100,26145,39911023.0,24695196.0,15215826.0,731,309,422,47188,21513,25675,39352670.0,24380537.0,14972132.0,1.1174,0.582,1.1333,0.5831
2023-05-16 11:25,417,173,244,23699,10973,12726,13784849.0,6377265.0,7407583.0,401,165,236,23297,10655,12642,13565057.0,6194117.0,7370940.0,0.5812,0.5821,0.5813,0.5831
2023-05-16 11:30,1433,764,669,100010,57598,42412,58121054.0,33406540.0,24714514.0,1414,758,656,99961,57553,42408,58089337.0,33375967.0,24713370.0,0.58,0.5827,0.5799,0.5828
2023-05-16 11:35,1932,1045,887,148049,70877,77172,86102256.0,41046441.0,45055814.0,1913,1033,880,146529,70503,76026,85202971.0,40845252.0,44357718.0,0.5791,0.5838,0.5793,0.5835
2023-05-16 11:40,602,247,355,50491,20448,30043,41185823.0,23724289.0,17461533.0,578,228,350,49032,19976,29056,40376337.0,23451198.0,16925139.0,1.1602,0.5812,1.174,0.5825
2023-05-16 11:45,222,57,165,14479,2830,11649,20309818.0,13513331.0,6796486.0,205,45,160,13892,2337,11555,19974631.0,13231457.0,6743174.0,4.775,0.5834,5.6617,0.5836
2023-05-16 11:50,93,37,56,6212,3321,2891,3608849.0,1925839.0,1683010.0,75,28,47,5564,2972,2592,3233851.0,1723179.0,1510672.0,0.5799,0.5822,0.5798,0.5828
2023-05-16 11:55,342,51,291,21835,3423,18412,12711333.0,1984133.0,10727200.0,327,45,282,21254,3205,18049,12369238.0,1853944.0,10515293.0,0.5796,0.5826,0.5785,0.5826
2023-05-16 12:00,126,52,74,7389,2024,5365,4305384.0,1174707.0,3130677.0,106,42,64,7085,1942,5143,4128555.0,1125899.0,3002656.0,0.5804,0.5835,0.5798,0.5838
2023-05-16 12:05,215,120,95,9159,5265,3894,5318836.0,3054968.0,2263868.0,206,116,90,9104,5219,3885,5291732.0,3028835.0,2262896.0,0.5802,0.5814,0.5803,0.5825
2023-05-16 12:10,350,84,266,22262,3829,18433,24807740.0,14096705.0,10711035.0,337,77,260,22068,3818,18250,24695926.0,14090981.0,10604944.0,3.6816,0.5811,3.6907,0.5811
2023-05-16 12:15,491,241,250,32244,16490,15754,18709174.0,9558734.0,9150440.0,482,240,242,31994,16476,15518,18564060.0,9551002.0,9013058.0,0.5797,0.5808,0.5797,0.5808
2023-05-16 12:20,139,87,52,8277,5430,2847,4785706.0,3142791.0,1642914.0,127,81,46,7922,5385,2537,4595506.0,3117155.0,1478350.0,0.5788,0.5771,0.5789,0.5827
2023-05-16 12:25,386,273,113,29263,19085,10178,40719571.0,34802102.0,5917468.0,370,271,99,28476,19043,9433,40275230.0,34781732.0,5493498.0,1.8235,0.5814,1.8265,0.5824
2023-05-16 12:30,251,93,158,13691,4120,9571,8176565.0,2380697.0,5795868.0,242,84,158,13082,3708,9374,7586463.0,2138891.0,5447571.0,0.5778,0.6056,0.5768,0.5811
2023-05-16 12:35,752,112,640,57630,8038,49592,33775857.0,4621778.0,29154078.0,744,101,643,54942,5488,49454,32307244.0,3171839.0,29135405.0,0.575,0.5879,0.578,0.5891
2023-05-16 12:40,690,246,444,44064,12796,31268,37371506.0,19262446.0,18109059.0,674,237,437,43543,12708,30835,37279672.0,19208053.0,18071619.0,1.5053,0.5792,1.5115,0.5861
2023-05-16 12:45,1502,372,1130,125330,26002,99328,72637451.0,15003744.0,57633707.0,1486,365,1121,125271,25858,99413,72604166.0,14920186.0,57683980.0,0.577,0.5802,0.577,0.5802
2023-05-16 12:50,1697,512,1185,119069,37784,81285,68878878.0,21797623.0,47081254.0,1683,503,1180,119037,37649,81388,68860015.0,21719039.0,47140976.0,0.5769,0.5792,0.5769,0.5792
2023-05-16 12:55,1364,435,929,108393,29236,79157,62780559.0,16883962.0,45896596.0,1340,422,918,107525,28719,78806,62280978.0,16584445.0,45696533.0,0.5775,0.5798,0.5775,0.5799
2023-05-16 13:00,973,475,498,92339,36246,56093,65393040.0,32825427.0,32567613.0,971,475,496,93852,37692,56160,66240509.0,33634304.0,32606204.0,0.9056,0.5806,0.8923,0.5806
2023-05-16 13:05,70,36,34,2729,1800,929,1575377.0,1042990.0,532387.0,65,33,32,2789,1883,906,1614590.0,1088317.0,526272.0,0.5794,0.5731,0.578,0.5809
2023-05-16 13:10,208,52,156,9766,3420,6346,5658497.0,1978512.0,3679984.0,211,53,158,9849,3515,6334,5706557.0,2031915.0,3674641.0,0.5785,0.5799,0.5781,0.5801
2023-05-16 13:15,387,88,299,21890,4093,17797,12695824.0,2370522.0,10325302.0,371,75,296,21799,4020,17779,12640187.0,2324204.0,10315982.0,0.5792,0.5802,0.5782,0.5802
2023-05-16 13:20,163,63,100,10745,4392,6353,6263888.0,2566428.0,3697459.0,150,58,92,10348,3822,6526,6009163.0,2210569.0,3798594.0,0.5843,0.582,0.5784,0.5821
2023-05-16 13:25,690,463,227,59989,34144,25845,34799338.0,19769856.0,15029482.0,678,458,220,59901,34376,25525,34749122.0,19903750.0,14845371.0,0.579,0.5815,0.579,0.5816
2023-05-16 13:30,1647,727,920,160943,61962,98981,93446680.0,35883531.0,57563148.0,1643,722,921,160854,61649,99205,93389804.0,35697064.0,57692739.0,0.5791,0.5816,0.579,0.5816
2023-05-16 13:35,2214,1112,1102,232411,95429,136982,158725504.0,79040602.0,79684902.0,2209,1112,1097,232326,95389,136937,158675534.0,79016787.0,79658746.0,0.8283,0.5817,0.8284,0.5817
2023-05-16 13:40,1555,876,679,164664,80769,83895,95667313.0,46792293.0,48875019.0,1522,860,662,164550,80721,83829,95599024.0,46763556.0,48835467.0,0.5793,0.5826,0.5793,0.5826
2023-05-16 13:45,418,229,189,34061,18931,15130,19793611.0,10969854.0,8823756.0,416,229,187,34107,19097,15010,19819912.0,11065823.0,8754088.0,0.5795,0.5832,0.5795,0.5832
2023-05-16 13:50,380,287,93,24570,19692,4878,14250718.0,11412654.0,2838064.0,368,277,91,24332,19566,4766,14116800.0,11338787.0,2778012.0,0.5796,0.5818,0.5795,0.5829
2023-05-16 13:55,1313,765,548,114919,56420,58499,66731068.0,32693098.0,34037969.0,1297,753,544,114819,56344,58475,66675251.0,32648672.0,34026578.0,0.5795,0.5819,0.5795,0.5819
2023-05-16 14:00,1097,422,675,88335,28890,59445,51333526.0,16733719.0,34599806.0,1081,414,667,88130,28830,59300,51214426.0,16699764.0,34514661.0,0.5792,0.582,0.5792,0.582
2023-05-16 14:05,629,196,433,55597,11069,44528,32370466.0,6412365.0,25958101.0,624,192,432,55645,11088,44557,32395175.0,6422659.0,25972516.0,0.5793,0.583,0.5792,0.5829
2023-05-16 14:10,667,270,397,71746,14386,57360,41743850.0,8335106.0,33408743.0,668,273,395,71411,14138,57273,41550648.0,8190615.0,33360033.0,0.5794,0.5824,0.5793,0.5825
2023-05-16 14:15,158,75,83,9377,3945,5432,5452286.0,2285401.0,3166884.0,154,75,79,9383,3978,5405,5455574.0,2303969.0,3151604.0,0.5793,0.583,0.5792,0.5831
2023-05-16 14:20,1168,286,882,144022,25604,118418,83741080.0,14822640.0,68918440.0,1161,282,879,143443,25387,118056,83405659.0,14697696.0,68707962.0,0.5789,0.582,0.5789,0.582
2023-05-16 14:25,1615,356,1259,156316,22696,133620,90788197.0,13145372.0,77642825.0,1620,356,1264,156105,22654,133451,90666346.0,13120206.0,77546139.0,0.5792,0.5811,0.5792,0.5811
2023-05-16 14:30,1122,363,759,114652,17586,97066,66647850.0,10188042.0,56459808.0,1084,340,744,114400,17448,96952,66498072.0,10107266.0,56390805.0,0.5793,0.5817,0.5793,0.5816
2023-05-16 14:35,1041,559,482,106222,38431,67791,73702390.0,34159153.0,39543236.0,1024,550,474,105544,37815,67729,73297310.0,33789773.0,39507537.0,0.8888,0.5833,0.8936,0.5833
2023-05-16 14:40,1131,705,426,149171,51285,97886,86895296.0,29760027.0,57135269.0,1117,699,418,148245,50767,97478,86354882.0,29454694.0,56900187.0,0.5803,0.5837,0.5802,0.5837
2023-05-16 14:45,1678,847,831,256857,57185,199672,149708626.0,33184405.0,116524220.0,1667,843,824,256819,57235,199584,149678734.0,33208905.0,116469829.0,0.5803,0.5836,0.5802,0.5836
2023-05-16 14:50,1047,590,457,148116,45694,102422,86346237.0,26530864.0,59815373.0,1038,586,452,147717,45450,102267,86117027.0,26387466.0,59729561.0,0.5806,0.584,0.5806,0.5841
2023-05-16 14:55,331,235,96,30065,19036,11029,17474526.0,11050466.0,6424060.0,321,229,92,29954,18748,11206,17411651.0,10882331.0,6529320.0,0.5805,0.5825,0.5805,0.5827
2023-05-16 15:00,443,412,31,19305,17595,1710,23113682.0,22117685.0,995997.0,428,409,19,18307,16879,1428,22530268.0,21696403.0,833865.0,1.257,0.5825,1.2854,0.5839
2023-05-16 15:05,133,98,35,9760,5962,3798,5779625.0,3471080.0,2308544.0,122,96,26,7125,6047,1078,4146721.0,3517719.0,629002.0,0.5822,0.6078,0.5817,0.5835
2023-05-16 15:10,207,154,53,14039,11831,2208,8163076.0,6877211.0,1285865.0,202,152,50,13873,11797,2076,8066814.0,6857036.0,1209778.0,0.5813,0.5824,0.5813,0.5827
2023-05-16 15:15,582,542,40,41315,39951,1364,24024274.0,23229216.0,795058.0,578,541,37,41299,40271,1028,24012955.0,23413462.0,599493.0,0.5814,0.5829,0.5814,0.5832
2023-05-16 15:20,316,295,21,21894,21243,651,12729235.0,12351054.0,378181.0,310,294,16,21797,21377,420,12673748.0,12428907.0,244841.0,0.5814,0.5809,0.5814,0.583
2023-05-16 15:25,916,835,81,67068,64281,2787,39013879.0,37381346.0,1632532.0,900,826,74,66393,63377,3016,38614466.0,36846320.0,1768145.0,0.5815,0.5858,0.5814,0.5863
2023-05-16 15:30,577,339,238,29565,26970,2595,17192431.0,15680388.0,1512043.0,571,334,237,29468,26833,2635,17134023.0,15597844.0,1536179.0,0.5814,0.5827,0.5813,0.583
2023-05-16 15:35,202,171,31,19934,17618,2316,11584553.0,10232997.0,1351556.0,189,167,22,18361,17725,636,10667649.0,10294968.0,372681.0,0.5808,0.5836,0.5808,0.586
2023-05-16 15:40,678,442,236,50326,36218,14108,29236705.0,21045445.0,8191260.0,670,439,231,49808,35965,13843,28955890.0,20898229.0,8057660.0,0.5811,0.5806,0.5811,0.5821
2023-05-16 15:45,245,206,39,21629,19648,1981,13881960.0,12726311.0,1155648.0,236,204,32,21617,20040,1577,12562011.0,11643456.0,918554.0,0.6477,0.5834,0.581,0.5825
2023-05-16 15:50,388,346,42,28895,28462,433,16800472.0,16549805.0,250666.0,387,347,40,28715,28311,404,16698230.0,16462062.0,236168.0,0.5815,0.5789,0.5815,0.5846
2023-05-16 15:55,253,167,86,15985,15066,919,9291304.0,8761086.0,530217.0,242,158,84,15261,14444,817,8874356.0,8397889.0,476467.0,0.5815,0.577,0.5814,0.5832
2023-05-16 16:00,333,307,26,8859,8513,346,5149108.0,4947911.0,201196.0,321,303,18,8598,8313,285,4998294.0,4831889.0,166404.0,0.5812,0.5815,0.5812,0.5839
2023-05-16 16:05,114,81,33,8740,6285,2455,5097858.0,3654317.0,1443541.0,110,78,32,9594,6976,2618,5588278.0,4048961.0,1539317.0,0.5814,0.588,0.5804,0.588
2023-05-16 16:10,415,368,47,32810,28466,4344,19558271.0,17052291.0,2505980.0,404,363,41,30811,27774,3037,19225164.0,17450209.0,1774955.0,0.599,0.5769,0.6283,0.5844
2023-05-16 16:15,282,249,33,17585,16149,1436,10218302.0,9386628.0,831674.0,265,242,23,17528,16085,1443,10192418.0,9350002.0,842415.0,0.5813,0.5792,0.5813,0.5838
2023-05-16 16:20,85,54,31,4675,2843,1832,2696628.0,1650931.0,1045696.0,69,43,26,4410,2753,1657,2563921.0,1598802.0,965119.0,0.5807,0.5708,0.5807,0.5824
2023-05-16 16:25,315,247,68,19915,16124,3791,11580696.0,9373547.0,2207149.0,313,246,67,19948,16172,3776,11598897.0,9400465.0,2198432.0,0.5813,0.5822,0.5813,0.5822
2023-05-16 16:30,155,126,29,5809,4757,1052,3376236.0,2763009.0,613227.0,151,123,28,5719,4708,1011,3323781.0,2734450.0,589330.0,0.5808,0.5829,0.5808,0.5829
2023-05-16 16:35,217,127,90,11956,6672,5284,6946570.0,3877466.0,3069103.0,210,122,88,12206,6631,5575,7100039.0,3853659.0,3246380.0,0.5812,0.5808,0.5812,0.5823
2023-05-16 16:40,280,35,245,18159,1512,16647,10559696.0,876334.0,9683361.0,275,31,244,17257,1369,15888,10036142.0,793270.0,9242871.0,0.5796,0.5817,0.5795,0.5818
2023-05-16 16:45,82,54,28,4468,2797,1671,14642031.0,13669976.0,972055.0,74,51,23,3844,2703,1141,14619704.0,13953907.0,665796.0,4.8874,0.5817,5.1624,0.5835
2023-05-16 16:50,134,26,108,13862,1130,12732,8081209.0,654902.0,7426307.0,130,26,104,13876,1147,12729,8089752.0,664817.0,7424935.0,0.5796,0.5833,0.5796,0.5833
2023-05-16 16:55,293,56,237,33079,2995,30084,19249697.0,1740153.0,17509543.0,284,48,236,33136,2846,30290,19278183.0,1648682.0,17629500.0,0.581,0.582,0.5793,0.582
2023-05-16 17:00,614,94,520,68172,10837,57335,39667950.0,6278481.0,33389469.0,609,91,518,67831,10903,56928,39468597.0,6316806.0,33151790.0,0.5794,0.5824,0.5794,0.5823
2023-05-16 17:05,45,23,22,2197,1329,868,1273814.0,769866.0,503948.0,42,22,20,2543,1220,1323,1486461.0,706410.0,780050.0,0.5793,0.5806,0.579,0.5896
2023-05-16 17:10,84,37,47,5499,1953,3546,3127508.0,1132318.0,1995190.0,69,29,40,4218,1620,2598,2452824.0,938312.0,1514512.0,0.5798,0.5627,0.5792,0.583
2023-05-16 17:15,112,49,63,10336,3560,6776,6001977.0,2063386.0,3938591.0,105,45,60,10169,3538,6631,5930325.0,2048188.0,3882136.0,0.5796,0.5813,0.5789,0.5855
2023-05-16 17:20,58,21,37,12617,1840,10777,7324493.0,1063507.0,6260986.0,58,22,36,12467,2078,10389,7236682.0,1201569.0,6035112.0,0.578,0.581,0.5782,0.5809
2023-05-16 17:25,119,87,32,4555,2350,2205,2642838.0,1362792.0,1280046.0,109,78,31,4269,2066,2203,2476001.0,1196913.0,1279087.0,0.5799,0.5805,0.5793,0.5806
2023-05-16 17:30,2877,2127,750,411612,356780,54832,395811491.0,363658424.0,32153067.0,2406,1874,532,362687,328527,34160,366811952.0,346715395.0,20096557.0,1.0193,0.5864,1.0554,0.5883
2023-05-16 17:35,1456,844,612,142475,85348,57127,95779678.0,62249283.0,33530394.0,1248,736,512,131176,77833,53343,88651599.0,57311353.0,31340246.0,0.7294,0.5869,0.7363,0.5875
2023-05-16 17:40,1228,918,310,104996,93500,11496,73183324.0,66500944.0,6682380.0,1130,872,258,101736,91849,9887,71287109.0,65470373.0,5816736.0,0.7112,0.5813,0.7128,0.5883
2023-05-16 17:45,1855,639,1216,163299,81131,82168,118759839.0,70952521.0,47807318.0,1776,597,1179,160632,82017,78615,117452960.0,71459801.0,45993159.0,0.8745,0.5818,0.8713,0.585
2023-05-16 17:50,985,462,523,72320,38462,33858,42252496.0,22438616.0,19813880.0,948,448,500,70268,37866,32402,41037813.0,22063109.0,18974704.0,0.5834,0.5852,0.5827,0.5856
2023-05-16 17:55,1948,526,1422,221871,59716,162155,224300931.0,129607705.0,94693225.0,1847,453,1394,214015,55115,158900,219790641.0,126990115.0,92800526.0,2.1704,0.584,2.3041,0.584
2023-05-16 18:00,2310,440,1870,280448,18001,262447,163647038.0,10491007.0,153156031.0,2237,401,1836,280073,18414,261659,163379587.0,10674859.0,152704727.0,0.5828,0.5836,0.5797,0.5836
2023-05-16 18:05,1072,337,735,78205,15156,63049,57601458.0,20754347.0,36847111.0,1035,314,721,76650,14010,62640,56654459.0,20016197.0,36638262.0,1.3694,0.5844,1.4287,0.5849
2023-05-16 18:10,371,195,176,25141,10935,14206,14709195.0,6385655.0,8323540.0,344,185,159,24391,10632,13759,14271533.0,6199871.0,8071662.0,0.584,0.5859,0.5831,0.5866
2023-05-16 18:15,310,156,154,21286,7185,14101,12482980.0,4223030.0,8259949.0,264,132,132,19001,6207,12794,11117384.0,3618854.0,7498530.0,0.5878,0.5858,0.583,0.5861
2023-05-16 18:20,145,90,55,8259,4417,3842,4795294.0,2585299.0,2209995.0,114,73,41,7092,3875,3217,4144021.0,2256159.0,1887862.0,0.5853,0.5752,0.5822,0.5868
2023-05-16 18:25,1884,369,1515,251192,20235,230957,158073631.0,23608848.0,134464783.0,1867,355,1512,251546,21732,229814,158331664.0,24405783.0,133925880.0,1.1667,0.5822,1.123,0.5828
2023-05-16 18:30,3153,1132,2021,365874,51304,314570,212981684.0,29760812.0,183220871.0,3135,1118,2017,363606,50020,313586,211701393.0,29015959.0,182685434.0,0.5801,0.5824,0.5801,0.5826
2023-05-16 18:35,2802,1933,869,266872,180117,86755,178958723.0,128360831.0,50597892.0,2787,1929,858,265066,180640,84426,177846251.0,128622317.0,49223934.0,0.7127,0.5832,0.712,0.583
2023-05-17 10:00,2209,1377,832,181728,105172,76556,112570064.0,67535960.0,45034103.0,1825,1193,632,159039,89529,69510,95351413.0,54565204.0,40786208.0,0.6421,0.5883,0.6095,0.5868
2023-05-17 10:05,1631,1368,263,122080,105460,16620,83335303.0,73456564.0,9878739.0,1514,1301,213,114952,101281,13671,71884978.0,63844562.0,8040416.0,0.6965,0.5944,0.6304,0.5881
2023-05-17 10:10,1890,1121,769,137755,96907,40848,104297623.0,80361194.0,23936428.0,1751,1039,712,134615,95153,39462,102380090.0,79243351.0,23136739.0,0.8293,0.586,0.8328,0.5863
2023-05-17 10:15,787,466,321,62893,35861,27032,36914654.0,20957585.0,15957069.0,711,432,279,58807,34761,24046,34444414.0,20286948.0,14157465.0,0.5844,0.5903,0.5836,0.5888
2023-05-17 10:20,684,568,116,41434,36197,5237,24267435.0,21204790.0,3062645.0,638,545,93,39554,35204,4350,23161639.0,20606268.0,2555371.0,0.5858,0.5848,0.5853,0.5874
2023-05-17 10:25,280,161,119,15126,9687,5439,8807026.0,5645700.0,3161326.0,245,149,96,13892,9079,4813,8122910.0,5298622.0,2824287.0,0.5828,0.5812,0.5836,0.5868
2023-05-17 10:30,1406,1272,134,137799,128957,8842,116044802.0,110854100.0,5190702.0,1351,1249,102,135751,128512,7239,114826273.0,110579513.0,4246760.0,0.8596,0.5871,0.8605,0.5867
2023-05-17 10:35,2497,2358,139,365919,361007,4912,249714467.0,246836084.0,2878383.0,2451,2341,110,364220,359985,4235,248722360.0,246226393.0,2495966.0,0.6837,0.586,0.684,0.5894
2023-05-17 10:40,3137,2960,177,416011,412613,3398,255731351.0,253727136.0,2004215.0,3025,2916,109,411113,409426,1687,252651459.0,251655909.0,995550.0,0.6149,0.5898,0.6147,0.5901
2023-05-17 10:45,913,824,89,86292,82618,3674,50591842.0,48425263.0,2166579.0,875,807,68,85431,81981,3450,50085715.0,48051193.0,2034522.0,0.5861,0.5897,0.5861,0.5897
2023-05-17 10:50,1042,477,565,59639,32955,26684,35025775.0,19328219.0,15697556.0,1012,463,549,58102,31735,26367,34132473.0,18609353.0,15523120.0,0.5865,0.5883,0.5864,0.5887
2023-05-17 10:55,562,327,235,31311,20458,10853,18369165.0,11980278.0,6388886.0,550,324,226,31582,21031,10551,18515268.0,12305554.0,6209713.0,0.5856,0.5887,0.5851,0.5885
2023-05-17 11:00,642,566,76,39246,37601,1645,23041605.0,22072107.0,969498.0,587,531,56,38738,37276,1462,22740998.0,21879271.0,861727.0,0.587,0.5894,0.587,0.5894
2023-05-17 11:05,576,309,267,38134,23213,14921,34217646.0,25448784.0,8768861.0,526,283,243,35606,21810,13796,32742216.0,24626094.0,8116121.0,1.0963,0.5877,1.1291,0.5883
2023-05-17 11:10,629,219,410,46764,21259,25505,39336290.0,24323454.0,15012836.0,589,191,398,44439,19471,24968,37969685.0,23272150.0,14697534.0,1.1441,0.5886,1.1952,0.5887
2023-05-17 11:15,805,387,418,64096,33664,30432,37655086.0,19748530.0,17906556.0,762,365,397,62287,33220,29067,36585150.0,19479835.0,17105315.0,0.5866,0.5884,0.5864,0.5885
2023-05-17 11:20,662,182,480,52462,17960,34502,30825900.0,10538968.0,20286931.0,626,170,456,51613,17665,33948,30306219.0,10341962.0,19964257.0,0.5868,0.588,0.5854,0.5881
2023-05-17 11:25,585,350,235,55176,44121,11055,44104530.0,37595354.0,6509175.0,559,336,223,54086,43903,10183,43449746.0,37461474.0,5988272.0,0.8521,0.5888,0.8533,0.5881
2023-05-17 11:30,442,347,95,46628,41559,5069,39002875.0,36116039.0,2886836.0,408,331,77,44889,40987,3902,38069186.0,35774066.0,2295119.0,0.869,0.5695,0.8728,0.5882
2023-05-17 11:35,1480,1018,462,140819,99527,41292,82427742.0,58246420.0,24181322.0,1449,999,450,139430,99133,40297,81668525.0,58017140.0,23651385.0,0.5852,0.5856,0.5852,0.5869
2023-05-17 11:40,690,389,301,63593,35411,28182,49148190.0,32599144.0,16549046.0,667,377,290,62479,34732,27747,48490194.0,32198667.0,16291527.0,0.9206,0.5872,0.9271,0.5871
2023-05-17 11:45,333,104,229,19174,6739,12435,11227343.0,3940131.0,7287212.0,307,91,216,18270,6300,11970,10712846.0,3681954.0,7030892.0,0.5847,0.586,0.5844,0.5874
2023-05-17 11:50,949,429,520,65959,33395,32564,38679215.0,19546402.0,19132812.0,933,419,514,65912,33267,32645,38652311.0,19471309.0,19181001.0,0.5853,0.5875,0.5853,0.5876
2023-05-17 11:55,1725,554,1171,152732,23111,129621,101384738.0,25385114.0,75999623.0,1705,540,1165,151038,23000,128038,100492449.0,25320132.0,75172317.0,1.0984,0.5863,1.1009,0.5871
2023-05-17 12:00,3509,1450,2059,339007,77026,261981,198792104.0,45021174.0,153770929.0,3482,1435,2047,338558,76774,261784,198488902.0,44833188.0,153655714.0,0.5845,0.587,0.584,0.587
2023-05-17 12:05,2034,1036,998,193446,78936,114510,113273251.0,46063219.0,67210031.0,2026,1029,997,192801,78406,114395,112900920.0,45758282.0,67142638.0,0.5836,0.5869,0.5836,0.5869
2023-05-17 12:10,981,326,655,81909,20119,61790,48010734.0,11758015.0,36252719.0,979,326,653,82445,20638,61807,48319122.0,12056279.0,36262842.0,0.5844,0.5867,0.5842,0.5867
2023-05-17 12:15,593,359,234,48682,22583,26099,28504404.0,13186651.0,15317753.0,585,354,231,47982,21920,26062,28105509.0,12807381.0,15298128.0,0.5839,0.5869,0.5843,0.587
2023-05-17 12:20,1503,700,803,144146,36196,107950,84526378.0,21155687.0,63370691.0,1484,686,798,143629,36090,107539,84226222.0,21093106.0,63133116.0,0.5845,0.587,0.5845,0.5871
2023-05-17 12:25,1866,632,1234,218510,24309,194201,128220756.0,14200814.0,114019942.0,1853,626,1227,217730,24317,193413,127756073.0,14204145.0,113551928.0,0.5842,0.5871,0.5841,0.5871
2023-05-17 12:30,829,337,492,80746,14423,66323,47351786.0,8426485.0,38925300.0,811,320,491,80540,14255,66285,47227025.0,8323949.0,38903075.0,0.5842,0.5869,0.5839,0.5869
2023-05-17 12:35,2223,1049,1174,245298,60688,184610,143827326.0,35441888.0,108385438.0,2205,1037,1168,244976,60683,184293,143654948.0,35438191.0,108216757.0,0.584,0.5871,0.584,0.5872
2023-05-17 12:40,1182,264,918,136145,6932,129213,79853055.0,4044293.0,75808762.0,1172,258,914,136077,6935,129142,79819586.0,4047101.0,75772485.0,0.5834,0.5867,0.5836,0.5867
2023-05-17 12:45,1149,102,1047,139625,2308,137317,81888483.0,1345204.0,80543278.0,1141,98,1043,139192,2297,136895,81634079.0,1339092.0,80294987.0,0.5828,0.5865,0.583,0.5865
2023-05-17 12:50,1366,257,1109,161833,7450,154383,94897708.0,4350593.0,90547114.0,1355,248,1107,161704,7297,154407,94822030.0,4260648.0,90561382.0,0.584,0.5865,0.5839,0.5865
2023-05-17 12:55,1331,409,922,137232,17933,119299,80404118.0,10467319.0,69936798.0,1323,406,917,137147,18015,119132,80365420.0,10515145.0,69850275.0,0.5837,0.5862,0.5837,0.5863
2023-05-17 13:00,1766,279,1487,223933,13973,209960,131334017.0,8154273.0,123179743.0,1746,267,1479,223366,13496,209870,131004023.0,7876903.0,123127119.0,0.5836,0.5867,0.5836,0.5867
2023-05-17 13:05,1591,434,1157,212507,22200,190307,124680794.0,12959452.0,111721342.0,1582,425,1157,212587,22037,190550,124727049.0,12862958.0,111864091.0,0.5838,0.5871,0.5837,0.5871
2023-05-17 13:10,2418,655,1763,327277,31958,295319,191924275.0,18673687.0,173250588.0,2396,638,1758,326743,31835,294908,191650280.0,18601033.0,173049246.0,0.5843,0.5867,0.5843,0.5868
2023-05-17 13:15,1437,735,702,159080,85730,73350,93139916.0,50124094.0,43015822.0,1409,718,691,156968,84139,72829,91805022.0,49094476.0,42710545.0,0.5847,0.5864,0.5835,0.5864
2023-05-17 13:20,1451,731,720,158241,71053,87188,127873487.0,77071497.0,50801990.0,1421,719,702,153412,70589,82823,125292149.0,76802174.0,48489974.0,1.0847,0.5827,1.088,0.5855
2023-05-17 13:25,772,65,707,84156,2861,81295,61199838.0,13544708.0,47655130.0,768,61,707,85391,3045,82346,61920780.0,13651504.0,48269276.0,4.7343,0.5862,4.4833,0.5862
2023-05-17 13:30,1561,248,1313,191430,12161,179269,112239752.0,7102567.0,105137184.0,1549,241,1308,191340,12009,179331,112177420.0,7003946.0,105173474.0,0.584,0.5865,0.5832,0.5865
2023-05-17 13:35,1672,215,1457,174203,9606,164597,102088278.0,5604011.0,96484267.0,1660,208,1452,174401,9885,164516,102210513.0,5761695.0,96448817.0,0.5834,0.5862,0.5829,0.5863
2023-05-17 13:40,1418,175,1243,143036,11652,131384,83761695.0,6731221.0,77030473.0,1406,172,1234,142810,11725,131085,83628753.0,6773899.0,76854853.0,0.5777,0.5863,0.5777,0.5863
2023-05-17 13:45,1855,222,1633,234792,17804,216988,137640783.0,10324010.0,127316773.0,1842,214,1628,233956,17623,216333,137150531.0,10219075.0,126931455.0,0.5799,0.5867,0.5799,0.5867
2023-05-17 13:50,295,125,170,27769,7361,20408,16275263.0,4300390.0,11974873.0,264,105,159,25794,6386,19408,15102398.0,3709377.0,11393021.0,0.5842,0.5868,0.5809,0.587
2023-05-17 13:55,491,46,445,36735,1821,34914,21487050.0,1059660.0,20427389.0,479,32,447,37145,1478,35667,21727255.0,859272.0,20867983.0,0.5819,0.5851,0.5814,0.5851
2023-05-17 14:00,426,81,345,32988,3667,29321,19299977.0,2136749.0,17163228.0,414,73,341,32466,3607,28859,18994630.0,2101808.0,16892821.0,0.5827,0.5854,0.5827,0.5854
2023-05-17 14:05,393,75,318,34075,5922,28153,19950391.0,3458005.0,16492386.0,377,65,312,29904,3937,25967,17482368.0,2278816.0,15203552.0,0.5839,0.5858,0.5788,0.5855
2023-05-17 14:10,193,44,149,12426,2107,10319,7270011.0,1226222.0,6043789.0,200,44,156,17533,4258,13275,10263956.0,2480290.0,7783666.0,0.582,0.5857,0.5825,0.5863
2023-05-17 14:15,359,348,11,42173,39759,2414,24651777.0,23199133.0,1452644.0,358,347,11,41969,39584,2385,24541249.0,23096058.0,1445191.0,0.5835,0.6018,0.5835,0.606
2023-05-17 14:20,260,43,217,17936,3184,14752,10473031.0,1848219.0,8624811.0,252,37,215,17833,3109,14724,10430798.0,1804302.0,8626496.0,0.5805,0.5847,0.5803,0.5859
2023-05-17 14:25,333,261,72,25035,18864,6171,14625190.0,11007597.0,3617593.0,316,254,62,21681,16821,4860,12667878.0,9817770.0,2850107.0,0.5835,0.5862,0.5837,0.5864
2023-05-17 14:30,68,40,28,3053,1458,1595,1784887.0,850728.0,934158.0,61,35,26,3471,1308,2163,2029965.0,762957.0,1267008.0,0.5835,0.5857,0.5833,0.5858
2023-05-17 14:35,101,32,69,7867,858,7009,4600364.0,500993.0,4099370.0,84,27,57,6180,642,5538,3618923.0,374899.0,3244024.0,0.5839,0.5849,0.584,0.5858
2023-05-17 14:40,61,21,40,3750,741,3009,2226751.0,461662.0,1765088.0,56,16,40,3444,482,2962,2018938.0,281661.0,1737277.0,0.623,0.5866,0.5844,0.5865
2023-05-17 14:45,61,26,35,4016,942,3074,2350248.0,549186.0,1801062.0,53,20,33,4090,846,3244,2394800.0,492960.0,1901840.0,0.583,0.5859,0.5827,0.5863
2023-05-17 14:50,26,13,13,1052,234,818,617156.0,137014.0,480141.0,17,7,10,783,223,560,459382.0,130333.0,329048.0,0.5855,0.587,0.5845,0.5876
2023-05-17 14:55,321,117,204,27108,7589,19519,15867140.0,4434255.0,11432884.0,314,112,202,27211,7461,19750,15927504.0,4359481.0,11568023.0,0.5843,0.5857,0.5843,0.5857
2023-05-17 15:00,212,41,171,19925,1690,18235,11674764.0,988025.0,10686738.0,204,34,170,19370,1423,17947,11350672.0,831828.0,10518843.0,0.5846,0.5861,0.5846,0.5861
2023-05-17 15:05,401,56,345,31147,2692,28455,18250620.0,1573818.0,16676801.0,395,53,342,31249,2666,28583,18310367.0,1558342.0,16752025.0,0.5846,0.5861,0.5845,0.5861
2023-05-17 15:10,58,6,52,4633,19,4614,2715555.0,11658.0,2703896.0,50,3,47,4452,3,4449,2609058.0,1735.0,2607323.0,0.6136,0.586,0.5783,0.586
2023-05-17 15:15,77,27,50,5968,1382,4586,3494068.0,806449.0,2687619.0,71,22,49,5592,915,4677,3275363.0,533430.0,2741932.0,0.5835,0.586,0.583,0.5863
2023-05-17 15:20,89,13,76,9335,642,8693,5472964.0,375450.0,5097513.0,86,11,75,9354,632,8722,5486032.0,369521.0,5116510.0,0.5848,0.5864,0.5847,0.5866
2023-05-17 15:25,269,89,180,24483,5709,18774,14326009.0,3309563.0,11016446.0,271,87,184,25128,5767,19361,14703886.0,3342688.0,11361198.0,0.5797,0.5868,0.5796,0.5868
2023-05-17 15:30,273,139,134,18101,8152,9949,10599352.0,4767055.0,5832297.0,271,135,136,18194,8309,9885,10650424.0,4855609.0,5794814.0,0.5848,0.5862,0.5844,0.5862
2023-05-17 15:35,107,52,55,8026,3128,4898,4698686.0,1819986.0,2878700.0,90,44,46,7338,2976,4362,4291866.0,1731632.0,2560234.0,0.5818,0.5877,0.5819,0.5869
2023-05-17 15:40,320,87,233,26666,5433,21233,27459865.0,15019108.0,12440757.0,292,68,224,25614,5035,20579,26863106.0,14785747.0,12077359.0,2.7644,0.5859,2.9366,0.5869
2023-05-17 15:45,416,113,303,45590,8727,36863,26705250.0,5056042.0,21649208.0,397,99,298,45423,8507,36916,26603981.0,4923882.0,21680098.0,0.5794,0.5873,0.5788,0.5873
2023-05-17 15:50,451,76,375,41975,4174,37801,24600215.0,2417927.0,22182288.0,436,65,371,41877,4097,37780,24546312.0,2373007.0,22173304.0,0.5793,0.5868,0.5792,0.5869
2023-05-17 15:55,79,34,45,6154,3100,3054,3586522.0,1795968.0,1790554.0,74,32,42,5429,2744,2685,3161428.0,1586862.0,1574566.0,0.5793,0.5863,0.5783,0.5864
2023-05-17 16:00,431,50,381,34519,2669,31850,20224033.0,1552218.0,18671815.0,431,51,380,34356,2740,31616,20129525.0,1593983.0,18535542.0,0.5816,0.5862,0.5817,0.5863
2023-05-17 16:05,86,43,43,8559,4740,3819,5005913.0,2769124.0,2236788.0,71,33,38,8427,4743,3684,4928451.0,2767637.0,2160813.0,0.5842,0.5857,0.5835,0.5865
2023-05-17 16:10,105,28,77,7621,1520,6101,4459131.0,888069.0,3571062.0,93,20,73,8870,2965,5905,5191993.0,1731579.0,3460414.0,0.5843,0.5853,0.584,0.586
2023-05-17 16:15,556,44,512,40772,3014,37758,23854236.0,1757857.0,22096379.0,546,36,510,40715,2985,37730,23831205.0,1741093.0,22090111.0,0.5832,0.5852,0.5833,0.5855
2023-05-17 16:20,572,56,516,45780,6532,39248,26783930.0,3803925.0,22980004.0,563,51,512,45240,6045,39195,26467700.0,3518691.0,22949009.0,0.5824,0.5855,0.5821,0.5855
2023-05-17 16:25,482,83,399,39935,9251,30684,23370187.0,5400361.0,17969826.0,478,82,396,39975,9413,30562,23393787.0,5494911.0,17898876.0,0.5838,0.5856,0.5838,0.5857
2023-05-17 16:30,380,101,279,33151,9821,23330,19420876.0,5750159.0,13670717.0,369,95,274,32920,9604,23316,19263846.0,5600383.0,13663463.0,0.5855,0.586,0.5831,0.586
2023-05-17 16:35,340,111,229,25606,7015,18591,14984880.0,4084982.0,10899897.0,327,103,224,25156,6521,18635,14727502.0,3799909.0,10927592.0,0.5823,0.5863,0.5827,0.5864
2023-05-17 16:40,181,68,113,13199,5187,8012,7719441.0,3024052.0,4695389.0,171,62,109,13064,5139,7925,7642090.0,2996077.0,4646013.0,0.583,0.586,0.583,0.5862
2023-05-17 16:45,309,41,268,21616,3056,18560,12645812.0,1778534.0,10867277.0,310,42,268,21505,3130,18375,12580311.0,1821407.0,10758904.0,0.582,0.5855,0.5819,0.5855
2023-05-17 16:50,150,47,103,12293,3142,9151,7185504.0,1824945.0,5360558.0,144,46,98,11941,3048,8893,6981747.0,1769728.0,5212018.0,0.5808,0.5858,0.5806,0.5861
2023-05-17 16:55,626,99,527,46061,4954,41107,26961642.0,2887143.0,24074498.0,608,87,521,45980,4930,41050,26910459.0,2868660.0,24041798.0,0.5828,0.5857,0.5819,0.5857
2023-05-17 17:00,41,11,30,2487,366,2121,1453604.0,211732.0,1241871.0,38,8,30,2442,341,2101,1426423.0,196315.0,1230108.0,0.5785,0.5855,0.5757,0.5855
2023-05-17 17:05,77,19,58,4735,610,4125,2772544.0,356058.0,2416486.0,72,15,57,4695,440,4255,2749417.0,256850.0,2492566.0,0.5837,0.5858,0.5838,0.5858
2023-05-17 17:10,10,6,4,77,66,11,45021.0,38576.0,6444.0,6,4,2,10,8,2,5841.0,4646.0,1194.0,0.5845,0.5858,0.5808,0.5971
2023-05-17 17:15,72,25,47,4130,1113,3017,2398772.0,648856.0,1749915.0,62,20,42,3602,969,2633,2105991.0,564473.0,1541518.0,0.583,0.58,0.5825,0.5855
2023-05-17 17:20,50,7,43,3754,475,3279,2199214.0,276890.0,1922323.0,49,7,42,3807,354,3453,2233039.0,206371.0,2026667.0,0.5829,0.5863,0.583,0.5869
2023-05-17 17:25,91,28,63,6027,1090,4937,3520656.0,639149.0,2881507.0,84,23,61,5572,1010,4562,3261415.0,589180.0,2672234.0,0.5864,0.5837,0.5833,0.5858
2023-05-17 17:30,134,12,122,8301,87,8214,4859134.0,52712.0,4806422.0,126,7,119,8313,12,8301,4864700.0,6978.0,4857721.0,0.6059,0.5852,0.5816,0.5852
2023-05-17 17:35,56,13,43,3813,751,3062,2226981.0,438254.0,1788727.0,54,11,43,3618,589,3029,2117926.0,343679.0,1774246.0,0.5836,0.5842,0.5835,0.5858
2023-05-17 17:40,190,57,133,15130,1678,13452,8871294.0,980348.0,7890946.0,182,55,127,15016,1878,13138,8797124.0,1096958.0,7700165.0,0.5842,0.5866,0.5841,0.5861
2023-05-17 17:45,193,122,71,10912,5284,5628,6387932.0,3091096.0,3296836.0,186,117,69,10742,5138,5604,6283886.0,3001192.0,3282693.0,0.585,0.5858,0.5841,0.5858
2023-05-17 17:50,269,112,157,20824,6218,14606,12188842.0,3631060.0,8557782.0,266,108,158,21172,6256,14916,12395836.0,3652981.0,8742855.0,0.584,0.5859,0.5839,0.5861
2023-05-17 17:55,183,63,120,15655,3057,12598,9171629.0,1784157.0,7387472.0,177,61,116,15496,3086,12410,9079405.0,1801127.0,7278277.0,0.5836,0.5864,0.5836,0.5865
2023-05-17 18:00,104,50,54,9409,2991,6418,5508658.0,1745761.0,3762897.0,115,57,58,9731,3684,6047,5678073.0,2130531.0,3547542.0,0.5837,0.5863,0.5783,0.5867
2023-05-17 18:05,65,41,24,5240,3785,1455,3062985.0,2209571.0,853414.0,56,35,21,5521,3628,1893,3226672.0,2116835.0,1109837.0,0.5838,0.5865,0.5835,0.5863
2023-05-17 18:10,938,269,669,86651,20393,66258,62520959.0,23758173.0,38762786.0,920,257,663,85308,20196,65112,61754997.0,23641998.0,38112999.0,1.165,0.585,1.1706,0.5853
2023-05-17 18:15,373,141,232,33625,8312,25313,19669892.0,4835726.0,14834166.0,368,139,229,33725,8395,25330,19728063.0,4882724.0,14845338.0,0.5818,0.586,0.5816,0.5861
2023-05-17 18:20,227,87,140,17346,5400,11946,10130409.0,3136456.0,6993953.0,215,81,134,17295,5423,11872,10101977.0,3147197.0,6954780.0,0.5808,0.5855,0.5803,0.5858
2023-05-17 18:25,260,147,113,17324,9371,7953,10126723.0,5468049.0,4658674.0,254,145,109,17641,9554,8087,10312339.0,5574805.0,4737534.0,0.5835,0.5858,0.5835,0.5858
2023-05-17 18:30,518,156,362,37049,6318,30731,21679811.0,3686026.0,17993785.0,530,160,370,37129,6353,30776,21726000.0,3705611.0,18020389.0,0.5834,0.5855,0.5833,0.5855
2023-05-17 18:35,1049,588,461,72981,32483,40498,42298798.0,18616571.0,23682226.0,1038,581,457,73421,32496,40925,42568190.0,18620270.0,23947919.0,0.5731,0.5848,0.573,0.5852
2023-05-18 10:00,3744,684,3060,431850,81351,350499,254130878.0,48670753.0,205460124.0,3465,547,2918,413332,68166,345166,241713376.0,39613389.0,202099986.0,0.5983,0.5862,0.5811,0.5855
2023-05-18 10:05,751,211,540,65916,12762,53154,38603373.0,7374503.0,31228870.0,674,165,509,56570,10430,46140,33067730.0,6071129.0,26996600.0,0.5778,0.5875,0.5821,0.5851
2023-05-18 10:10,422,121,301,26742,7810,18932,15619903.0,4535686.0,11084216.0,396,108,288,30070,7630,22440,17573449.0,4440480.0,13132968.0,0.5808,0.5855,0.582,0.5852
2023-05-18 10:15,1824,381,1443,196309,30359,165950,114883933.0,17661770.0,97222163.0,1723,324,1399,192564,30043,162521,112673845.0,17479840.0,95194004.0,0.5818,0.5859,0.5818,0.5857
2023-05-18 10:20,1738,421,1317,172404,41184,131220,100759897.0,23926135.0,76833761.0,1723,408,1315,173054,40957,132097,101146664.0,23798502.0,77348162.0,0.581,0.5855,0.5811,0.5855
2023-05-18 10:25,1972,652,1320,221056,65890,155166,141150343.0,50180656.0,90969686.0,1943,641,1302,224014,65809,158205,133322750.0,40558857.0,92763893.0,0.7616,0.5863,0.6163,0.5864
2023-05-18 10:30,1220,406,814,108135,26154,81981,63359828.0,15250596.0,48109232.0,1178,388,790,103426,25611,77815,60584375.0,14936520.0,45647854.0,0.5831,0.5868,0.5832,0.5866
2023-05-18 10:35,570,319,251,39788,21388,18400,23265508.0,12485431.0,10780077.0,552,312,240,38016,21050,16966,22229717.0,12293578.0,9936139.0,0.5838,0.5859,0.584,0.5857
2023-05-18 10:40,410,185,225,32343,16602,15741,18899966.0,9671959.0,9228007.0,374,165,209,30840,16107,14733,18037738.0,9407810.0,8629928.0,0.5826,0.5862,0.5841,0.5858
2023-05-18 10:45,553,231,322,44038,18134,25904,37608108.0,22459362.0,15148746.0,527,211,316,42329,17641,24688,36616599.0,22170653.0,14445946.0,1.2385,0.5848,1.2568,0.5851
2023-05-18 10:50,790,218,572,53077,12066,41011,31046937.0,7039516.0,24007421.0,791,215,576,54416,11894,42522,31807469.0,6936341.0,24871127.0,0.5834,0.5854,0.5832,0.5849
2023-05-18 10:55,199,93,106,13468,3128,10340,7936545.0,1823928.0,6112617.0,164,75,89,10884,2493,8391,6361381.0,1453424.0,4907957.0,0.5831,0.5912,0.583,0.5849
2023-05-18 11:00,474,175,299,27252,5492,21760,15880393.0,3194620.0,12685773.0,449,161,288,26069,4904,21165,15242503.0,2855569.0,12386933.0,0.5817,0.583,0.5823,0.5853
2023-05-18 11:05,510,136,374,33401,6436,26965,19526686.0,3750659.0,15776026.0,489,128,361,33209,6455,26754,19411890.0,3761735.0,15650155.0,0.5828,0.5851,0.5828,0.585
2023-05-18 11:10,2161,406,1755,214216,23637,190579,125153314.0,13743682.0,111409632.0,2130,386,1744,214874,23532,191342,125552803.0,13682550.0,111870253.0,0.5814,0.5846,0.5814,0.5847
2023-05-18 11:15,767,186,581,73489,14315,59174,66596533.0,32038170.0,34558363.0,721,158,563,70788,13630,57158,65065055.0,31652951.0,33412104.0,2.2381,0.584,2.3223,0.5846
2023-05-18 11:20,629,101,528,40984,3652,37332,23704081.0,2111848.0,21592233.0,566,54,512,39161,2801,36360,22745255.0,1617161.0,21128094.0,0.5783,0.5784,0.5774,0.5811
2023-05-18 11:25,97,56,41,4163,2085,2078,2405616.0,1204064.0,1201552.0,64,33,31,2878,1325,1553,1676428.0,765743.0,910684.0,0.5775,0.5782,0.5779,0.5864
2023-05-18 11:30,945,278,667,87693,14401,73292,74582004.0,32072296.0,42509707.0,893,250,643,84674,14141,70533,72898262.0,31922573.0,40975689.0,2.2271,0.58,2.2574,0.5809
2023-05-18 11:35,882,350,532,71469,16287,55182,53271980.0,21296998.0,31974982.0,798,286,512,72901,15018,57883,54081258.0,20528925.0,33552332.0,1.3076,0.5794,1.367,0.5797
2023-05-18 11:40,2009,303,1706,201357,20540,180817,116597042.0,11843463.0,104753578.0,1896,207,1689,200451,16681,183770,116203605.0,9602259.0,106601345.0,0.5766,0.5793,0.5756,0.5801
2023-05-18 11:45,2019,814,1205,202582,73910,128672,128962588.0,54446100.0,74516488.0,1968,776,1192,200735,72842,127893,127884223.0,53824558.0,74059664.0,0.7367,0.5791,0.7389,0.5791
2023-05-18 11:50,185,133,52,10060,5966,4094,5825805.0,3452266.0,2373538.0,148,104,44,9046,5374,3672,5232191.0,3103170.0,2129021.0,0.5787,0.5798,0.5774,0.5798
2023-05-18 11:55,141,95,46,10346,7270,3076,5988877.0,4200431.0,1788446.0,129,84,45,9810,6769,3041,5679018.0,3910590.0,1768428.0,0.5778,0.5814,0.5777,0.5815
2023-05-18 12:00,519,36,483,38525,1947,36578,22342641.0,1110633.0,21232008.0,501,25,476,37163,1459,35704,21535225.0,841769.0,20693455.0,0.5704,0.5805,0.5769,0.5796
2023-05-18 12:05,232,106,126,16148,5500,10648,9372755.0,3179967.0,6192788.0,244,111,133,18115,7084,11031,10497612.0,4078432.0,6419180.0,0.5782,0.5816,0.5757,0.5819
2023-05-18 12:10,50,35,15,3184,1533,1651,1852704.0,885346.0,967358.0,48,35,13,2389,1421,968,1388900.0,820065.0,568834.0,0.5775,0.5859,0.5771,0.5876
2023-05-18 12:15,116,83,33,6446,3920,2526,3742929.0,2264800.0,1478128.0,96,71,25,5884,3838,2046,3414197.0,2216361.0,1197836.0,0.5778,0.5852,0.5775,0.5855
2023-05-18 12:20,395,63,332,25423,2509,22914,14724647.0,1448737.0,13275910.0,385,56,329,25105,2323,22782,14541723.0,1341356.0,13200367.0,0.5774,0.5794,0.5774,0.5794
2023-05-18 12:25,128,75,53,6151,3213,2938,3564543.0,1855806.0,1708737.0,112,67,45,5991,3132,2859,3472185.0,1809185.0,1662999.0,0.5776,0.5816,0.5776,0.5817
2023-05-18 12:30,311,52,259,18972,2056,16916,10977385.0,1184147.0,9793238.0,283,38,245,19030,2083,16947,11019809.0,1198879.0,9820929.0,0.5759,0.5789,0.5756,0.5795
2023-05-18 12:35,181,45,136,9853,1046,8807,5701479.0,603742.0,5097736.0,163,28,135,9669,1014,8655,5595625.0,585633.0,5009992.0,0.5772,0.5788,0.5775,0.5789
2023-05-18 12:40,334,41,293,31129,1799,29330,18043610.0,1038462.0,17005148.0,319,32,287,31542,1861,29681,18286602.0,1072345.0,17214256.0,0.5772,0.5798,0.5762,0.58
2023-05-18 12:45,270,33,237,17750,1031,16719,10268776.0,594195.0,9674581.0,250,16,234,16896,697,16199,9789300.0,402053.0,9387247.0,0.5763,0.5787,0.5768,0.5795
2023-05-18 12:50,1326,275,1051,160586,12340,148246,199689805.0,113982267.0,85707537.0,1258,232,1026,159380,12074,147306,199036596.0,113828702.0,85207893.0,9.2368,0.5781,9.4276,0.5784
2023-05-18 12:55,3738,1400,2338,587842,118069,469773,562463713.0,292775126.0,269688587.0,3159,985,2174,539685,76602,463083,535163172.0,269266582.0,265896590.0,2.4797,0.5741,3.5151,0.5742
2023-05-18 13:00,539,298,241,37583,24614,12969,45254028.0,37806610.0,7447417.0,420,259,161,38110,27720,10390,45505513.0,39528139.0,5977374.0,1.536,0.5742,1.426,0.5753
2023-05-18 13:05,593,302,291,39677,13108,26569,58386445.0,43144604.0,15241840.0,464,198,266,41644,18047,23597,59415126.0,45868244.0,13546881.0,3.2915,0.5737,2.5416,0.5741
2023-05-18 13:10,969,546,423,88498,41301,47197,62841057.0,35624169.0,27216888.0,853,489,364,82228,38008,44220,59121205.0,33607992.0,25513212.0,0.8625,0.5767,0.8842,0.577
2023-05-18 13:15,1351,667,684,113278,48774,64504,76821403.0,39797349.0,37024053.0,1294,634,660,117621,54490,63131,79325495.0,43036092.0,36289403.0,0.816,0.574,0.7898,0.5748
2023-05-18 13:20,1451,478,973,125647,27725,97922,72059904.0,15860263.0,56199641.0,1419,453,966,124829,27647,97182,71588081.0,15795706.0,55792374.0,0.5721,0.5739,0.5713,0.5741
2023-05-18 13:25,1223,212,1011,143661,8712,134949,94151887.0,16848041.0,77303845.0,1182,185,997,142399,8177,134222,93497699.0,16537132.0,76960567.0,1.9339,0.5728,2.0224,0.5734
2023-05-18 13:30,1612,449,1163,188348,24177,164171,107746921.0,13789726.0,93957195.0,1543,386,1157,185339,21709,163630,106084122.0,12367736.0,93716386.0,0.5704,0.5723,0.5697,0.5727
2023-05-18 13:35,1629,493,1136,145779,27420,118359,83403641.0,15627476.0,67776164.0,1532,416,1116,140987,27733,113254,80619049.0,15771931.0,64847118.0,0.5699,0.5726,0.5687,0.5726
2023-05-18 13:40,1336,431,905,100899,32530,68369,57682237.0,18495464.0,39186773.0,1290,400,890,99559,31267,68292,56909158.0,17765414.0,39143743.0,0.5686,0.5732,0.5682,0.5732
2023-05-18 13:45,973,238,735,71793,15959,55834,41025451.0,9078672.0,31946779.0,943,213,730,71313,16086,55227,40739900.0,9141973.0,31597926.0,0.5689,0.5722,0.5683,0.5721
2023-05-18 13:50,346,143,203,23891,11219,12672,13610085.0,6373551.0,7236534.0,308,116,192,22993,10414,12579,13116948.0,5916529.0,7200418.0,0.5681,0.5711,0.5681,0.5724
2023-05-18 13:55,391,123,268,19647,5791,13856,11208767.0,3289569.0,7919198.0,343,83,260,17515,4471,13044,9990857.0,2534142.0,7456714.0,0.568,0.5715,0.5668,0.5717
2023-05-18 14:00,626,196,430,38148,12222,25926,57345198.0,42555879.0,14789319.0,572,155,417,35800,11548,24252,56039998.0,42169381.0,13870616.0,3.4819,0.5704,3.6517,0.5719
2023-05-18 14:05,539,128,411,43488,9377,34111,36593971.0,17188278.0,19405692.0,498,96,402,41682,8675,33007,35669783.0,16787158.0,18882625.0,1.833,0.5689,1.9351,0.5721
2023-05-18 14:10,1443,336,1107,121845,28656,93189,81403579.0,28141297.0,53262281.0,1399,298,1101,121474,28015,93459,81187208.0,27771458.0,53415749.0,0.982,0.5716,0.9913,0.5715
2023-05-18 14:15,418,229,189,30105,14828,15277,29046263.0,20299172.0,8747091.0,397,211,186,30188,14963,15225,29095054.0,20375342.0,8719712.0,1.369,0.5726,1.3617,0.5727
2023-05-18 14:20,141,70,71,7069,2928,4141,15919207.0,13546807.0,2372400.0,114,50,64,6120,2126,3994,15375726.0,13086310.0,2289416.0,4.6266,0.5729,6.1554,0.5732
2023-05-18 14:25,123,51,72,8748,1035,7713,5028026.0,595656.0,4432370.0,88,21,67,8035,475,7560,4622794.0,270954.0,4351840.0,0.5755,0.5747,0.5704,0.5756
2023-05-18 14:30,513,230,283,24872,9666,15206,14224713.0,5530519.0,8694194.0,488,211,277,24491,9233,15258,13988686.0,5264278.0,8724408.0,0.5722,0.5718,0.5702,0.5718
2023-05-18 14:35,223,94,129,9766,4223,5543,5590558.0,2421452.0,3169106.0,199,76,123,8783,3283,5500,5021188.0,1873308.0,3147879.0,0.5734,0.5717,0.5706,0.5723
2023-05-18 14:40,278,222,56,17433,14270,3163,9969222.0,8149025.0,1820197.0,260,207,53,17367,14044,3323,9933034.0,8020411.0,1912622.0,0.5711,0.5755,0.5711,0.5756
2023-05-18 14:45,187,69,118,12575,5472,7103,7220831.0,3147289.0,4073542.0,197,69,128,12568,5197,7371,7195168.0,2967253.0,4227914.0,0.5752,0.5735,0.571,0.5736
2023-05-18 14:50,426,157,269,28004,10106,17898,27928526.0,17656861.0,10271665.0,376,127,249,27598,9986,17612,27675623.0,17570518.0,10105105.0,1.7472,0.5739,1.7595,0.5738
2023-05-18 14:55,217,87,130,14054,5655,8399,8058376.0,3241633.0,4816743.0,202,78,124,13315,5248,8067,7624588.0,2996291.0,4628296.0,0.5732,0.5735,0.5709,0.5737
2023-05-18 15:00,577,169,408,42770,13575,29195,24507539.0,7752472.0,16755067.0,562,156,406,42563,13514,29049,24387769.0,7716876.0,16670893.0,0.5711,0.5739,0.571,0.5739
2023-05-18 15:05,118,71,47,8355,5457,2898,4779028.0,3117141.0,1661887.0,132,78,54,8616,5543,3073,4925427.0,3162594.0,1762832.0,0.5712,0.5735,0.5706,0.5737
2023-05-18 15:10,232,78,154,10636,3499,7137,6086263.0,1997572.0,4088691.0,186,53,133,10200,3464,6736,5833899.0,1974633.0,3859265.0,0.5709,0.5729,0.57,0.5729
2023-05-18 15:15,377,85,292,26460,4794,21666,27009569.0,14603507.0,12406062.0,352,71,281,25426,4165,21261,26428904.0,14248807.0,12180097.0,3.0462,0.5726,3.4211,0.5729
2023-05-18 15:20,1376,136,1240,140370,3891,136479,92171731.0,14082179.0,78089551.0,1349,111,1238,139187,3207,135980,91498989.0,13690064.0,77808925.0,3.6192,0.5722,4.2688,0.5722
2023-05-18 15:25,1488,349,1139,143337,25814,117523,81723371.0,14587668.0,67135702.0,1462,331,1131,142604,25897,116707,81333015.0,14633471.0,66699544.0,0.5651,0.5713,0.5651,0.5715
2023-05-18 15:30,1374,507,867,149326,42781,106545,85186392.0,24294403.0,60891989.0,1353,493,860,149094,42477,106617,85056827.0,24122073.0,60934754.0,0.5679,0.5715,0.5679,0.5715
2023-05-18 15:35,2419,799,1620,287698,80680,207018,199403307.0,81490885.0,117912422.0,2256,684,1572,281671,77567,204104,196131229.0,79721684.0,116409544.0,1.0101,0.5696,1.0278,0.5703
2023-05-18 15:40,926,285,641,135120,15650,119470,88952150.0,20736415.0,68215735.0,830,209,621,133461,15062,118399,88004013.0,20397779.0,67606233.0,1.325,0.571,1.3543,0.571
2023-05-18 15:45,787,464,323,52589,29507,23082,29900129.0,16770539.0,13129590.0,746,437,309,51736,28735,23001,29366724.0,16279693.0,13087030.0,0.5684,0.5688,0.5665,0.569
2023-05-18 15:50,258,134,124,14635,6093,8542,8333798.0,3462460.0,4871337.0,245,124,121,14595,6102,8493,8298175.0,3451845.0,4846329.0,0.5683,0.5703,0.5657,0.5706
2023-05-18 15:55,132,70,62,7212,3119,4093,4100620.0,1766390.0,2334229.0,115,55,60,7659,3060,4599,4365950.0,1730675.0,2635275.0,0.5663,0.5703,0.5656,0.573
2023-05-18 16:00,484,210,274,54229,12040,42189,30881878.0,6807689.0,24074189.0,464,198,266,53829,11810,42019,30664466.0,6676790.0,23987675.0,0.5654,0.5706,0.5654,0.5709
2023-05-18 16:05,365,76,289,24845,2981,21864,14143943.0,1692498.0,12451444.0,352,63,289,24666,2949,21717,14041375.0,1673368.0,12368007.0,0.5678,0.5695,0.5674,0.5695
2023-05-18 16:10,488,286,202,24834,9190,15644,14130489.0,5216682.0,8913807.0,487,286,201,25516,9231,16285,14536840.0,5239697.0,9297143.0,0.5676,0.5698,0.5676,0.5709
2023-05-18 16:15,329,86,243,20573,4367,16206,11709814.0,2479786.0,9230028.0,322,78,244,20822,4421,16401,11846919.0,2506207.0,9340712.0,0.5678,0.5695,0.5669,0.5695
2023-05-18 16:20,83,41,42,5706,2027,3679,15120917.0,13022428.0,2098489.0,72,31,41,5416,1899,3517,14955422.0,12949502.0,2005920.0,6.4245,0.5704,6.8191,0.5703
2023-05-18 16:25,460,95,365,35239,5712,29527,20047349.0,3228326.0,16819023.0,443,81,362,34967,5640,29327,19893605.0,3187920.0,16705685.0,0.5652,0.5696,0.5652,0.5696
2023-05-18 16:30,353,119,234,30640,6991,23649,17436004.0,3963141.0,13472862.0,345,111,234,30943,6903,24040,17611131.0,3912973.0,13698158.0,0.5669,0.5697,0.5669,0.5698
2023-05-18 16:35,750,303,447,73100,19724,53376,41694002.0,11205636.0,30488366.0,739,296,443,72815,19625,53190,41526925.0,11147064.0,30379861.0,0.5681,0.5712,0.568,0.5712
2023-05-18 16:40,439,106,333,37489,5753,31736,21374076.0,3268745.0,18105330.0,454,108,346,37617,5686,31931,21451407.0,3229321.0,18222085.0,0.5682,0.5705,0.5679,0.5707
2023-05-18 16:45,392,82,310,27264,3373,23891,15541006.0,1918265.0,13622740.0,359,63,296,27299,3275,24024,15558424.0,1860350.0,13698073.0,0.5687,0.5702,0.568,0.5702
2023-05-18 16:50,356,251,105,30185,15944,14241,17202514.0,9061206.0,8141308.0,349,245,104,29987,15905,14082,17092999.0,9040591.0,8052408.0,0.5683,0.5717,0.5684,0.5718
2023-05-18 16:55,308,233,75,23088,13562,9526,13168664.0,7708601.0,5460063.0,285,217,68,22712,13080,9632,12951952.0,7433736.0,5518216.0,0.5684,0.5732,0.5683,0.5729
2023-05-18 17:00,144,62,82,8037,3638,4399,4581658.0,2070148.0,2511510.0,125,52,73,7499,3282,4217,4273918.0,1865945.0,2407972.0,0.569,0.5709,0.5685,0.571
2023-05-18 17:05,448,108,340,33905,8646,25259,31257427.0,16803724.0,14453702.0,420,89,331,31974,7176,24798,30147955.0,15958532.0,14189423.0,1.9435,0.5722,2.2239,0.5722
2023-05-18 17:10,84,35,49,5610,2464,3146,3202969.0,1403021.0,1799947.0,76,31,45,5288,2323,2965,3016806.0,1320255.0,1696551.0,0.5694,0.5721,0.5683,0.5722
2023-05-18 17:15,468,26,442,31801,1033,30768,18196381.0,588971.0,17607409.0,454,16,438,30712,633,30079,17572431.0,360261.0,17212170.0,0.5702,0.5723,0.5691,0.5722
2023-05-18 17:20,56,17,39,2528,804,1724,1442639.0,457599.0,985039.0,48,15,33,2705,903,1802,1543180.0,512510.0,1030669.0,0.5692,0.5714,0.5676,0.572
2023-05-18 17:25,246,23,223,16257,1362,14895,9295749.0,774355.0,8521394.0,235,13,222,15533,643,14890,8885431.0,366833.0,8518598.0,0.5685,0.5721,0.5705,0.5721
2023-05-18 17:30,317,36,281,25057,1598,23459,26213131.0,12788312.0,13424819.0,301,29,272,24907,1637,23270,26130411.0,12810292.0,13320118.0,8.0027,0.5723,7.8255,0.5724
2023-05-18 17:35,56,34,22,2986,728,2258,1709905.0,416730.0,1293175.0,43,27,16,2454,718,1736,1404860.0,409104.0,995756.0,0.5724,0.5727,0.5698,0.5736
2023-05-18 17:40,104,38,66,8289,1670,6619,4745681.0,951506.0,3794175.0,98,34,64,8004,1532,6472,4580671.0,872408.0,3708262.0,0.5698,0.5732,0.5695,0.573
2023-05-18 17:45,97,62,35,5447,3761,1686,3109572.0,2144299.0,965272.0,96,59,37,5801,3851,1950,3313586.0,2195692.0,1117894.0,0.5701,0.5725,0.5702,0.5733
2023-05-18 17:50,159,73,86,10476,2963,7513,5989075.0,1694049.0,4295026.0,147,65,82,10922,3048,7874,6252192.0,1737844.0,4514348.0,0.5717,0.5717,0.5702,0.5733
2023-05-18 17:55,342,66,276,25629,3658,21971,14618468.0,2052494.0,12565974.0,337,60,277,24825,2875,21950,14193839.0,1639974.0,12553864.0,0.5611,0.5719,0.5704,0.5719
2023-05-18 18:00,365,179,186,26290,10797,15493,15030906.0,6161702.0,8869204.0,356,173,183,26553,11445,15108,15170456.0,6521540.0,8648916.0,0.5707,0.5725,0.5698,0.5725
2023-05-18 18:05,382,96,286,28328,4839,23489,16194817.0,2758681.0,13436136.0,382,97,285,28501,5003,23498,16294093.0,2851422.0,13442670.0,0.5701,0.572,0.5699,0.5721
2023-05-18 18:10,133,59,74,7915,2630,5285,4527713.0,1502997.0,3024715.0,118,47,71,7802,2612,5190,4461480.0,1490137.0,2971343.0,0.5715,0.5723,0.5705,0.5725
2023-05-18 18:15,126,65,61,8464,3079,5385,4851476.0,1754949.0,3096527.0,121,62,59,7757,3044,4713,4431132.0,1733181.0,2697951.0,0.57,0.575,0.5694,0.5724
2023-05-18 18:20,138,72,66,10004,5188,4816,5710802.0,2958451.0,2752351.0,128,66,62,9634,5140,4494,5500622.0,2930605.0,2570017.0,0.5702,0.5715,0.5702,0.5719
2023-05-18 18:25,690,197,493,53171,18650,34521,42224533.0,22497297.0,19727235.0,664,191,473,52166,18506,33660,41645890.0,22415810.0,19230079.0,1.2063,0.5715,1.2113,0.5713
2023-05-18 18:30,757,279,478,73224,25961,47263,41845771.0,14790268.0,27055503.0,768,279,489,72509,25052,47457,41434352.0,14264209.0,27170142.0,0.5697,0.5724,0.5694,0.5725
2023-05-18 18:35,144,85,59,9783,5096,4687,5578439.0,2899685.0,2678754.0,147,86,61,10383,5574,4809,5922631.0,3166180.0,2756450.0,0.569,0.5715,0.568,0.5732
2023-05-19 10:00,2961,705,2256,430594,53407,377187,254480214.0,38275572.0,216204641.0,2678,571,2107,415521,41181,374340,240277454.0,25764114.0,214513339.0,0.7167,0.5732,0.6256,0.573
2023-05-19 10:05,2241,467,1774,309060,25598,283462,188897435.0,26465047.0,162432388.0,2153,419,1734,304843,23935,280908,180892712.0,19944231.0,160948480.0,1.0339,0.573,0.8333,0.573
2023-05-19 10:10,3809,844,2965,552033,65215,486818,351447191.0,72640197.0,278806993.0,3741,799,2942,546522,63014,483508,348193929.0,71432942.0,276760986.0,1.1139,0.5727,1.1336,0.5724
2023-05-19 10:15,1650,532,1118,139608,26972,112636,79615096.0,15299438.0,64315657.0,1516,456,1060,139988,27629,112359,79828386.0,15660859.0,64167527.0,0.5672,0.571,0.5668,0.5711
2023-05-19 10:20,966,400,566,72045,24639,47406,41063928.0,14014502.0,27049426.0,929,376,553,71225,24182,47043,40563702.0,13719985.0,26843717.0,0.5688,0.5706,0.5674,0.5706
2023-05-19 10:25,882,277,605,58558,16161,42397,33314424.0,9123382.0,24191041.0,836,243,593,55607,14897,40710,31644394.0,8449350.0,23195044.0,0.5645,0.5706,0.5672,0.5698
2023-05-19 10:30,833,314,519,64940,11993,52947,36998909.0,6793951.0,30204957.0,789,284,505,65151,11731,53420,37118428.0,6648608.0,30469820.0,0.5665,0.5705,0.5668,0.5704
2023-05-19 10:35,831,205,626,80997,12247,68750,46123211.0,6935892.0,39187319.0,807,186,621,78335,11290,67045,44611980.0,6394630.0,38217350.0,0.5663,0.57,0.5664,0.57
2023-05-19 10:40,977,125,852,123587,8232,115355,82226631.0,16540734.0,65685896.0,959,117,842,123768,7480,116288,82333576.0,16112591.0,66220984.0,2.0093,0.5694,2.1541,0.5695
2023-05-19 10:45,924,197,727,115076,9054,106022,65460339.0,5127594.0,60332744.0,901,178,723,114652,8893,105759,65237772.0,5036371.0,60201401.0,0.5663,0.5691,0.5663,0.5692
2023-05-19 10:50,2320,383,1937,313147,19656,293491,189911653.0,22988706.0,166922947.0,2278,356,1922,311788,19441,292347,189145416.0,22869059.0,166276356.0,1.1696,0.5687,1.1763,0.5688
2023-05-19 10:55,2223,371,1852,287446,20101,267345,175336511.0,23248587.0,152087923.0,2199,352,1847,287294,19667,267627,175248734.0,23005607.0,152243127.0,1.1566,0.5689,1.1698,0.5689
2023-05-19 11:00,1995,235,1760,295787,10485,285302,168436133.0,5935178.0,162500955.0,1974,219,1755,295238,10413,284825,168123880.0,5894267.0,162229612.0,0.5661,0.5696,0.566,0.5696
2023-05-19 11:05,2542,962,1580,333943,85183,248760,213909861.0,72073820.0,141836041.0,2505,939,1566,330103,82157,247946,211737476.0,70348877.0,141388598.0,0.8461,0.5702,0.8563,0.5702
2023-05-19 11:10,1727,373,1354,185976,50911,135065,105793973.0,28814794.0,76979179.0,1706,353,1353,185917,50578,135339,105760977.0,28625764.0,77135212.0,0.566,0.5699,0.566,0.5699
2023-05-19 11:15,772,160,612,62268,12350,49918,35423066.0,6998657.0,28424408.0,757,154,603,61801,12457,49344,35154178.0,7058981.0,28095197.0,0.5667,0.5694,0.5667,0.5694
2023-05-19 11:20,1340,466,874,121302,48211,73091,68990413.0,27321403.0,41669009.0,1332,461,871,121259,48325,72934,68965407.0,27385696.0,41579711.0,0.5667,0.5701,0.5667,0.5701
2023-05-19 11:25,669,253,416,50096,21938,28158,28488899.0,12430474.0,16058425.0,656,246,410,49750,21584,28166,28297308.0,12232221.0,16065087.0,0.5666,0.5703,0.5667,0.5704
2023-05-19 11:30,413,164,249,26397,12571,13826,14994269.0,7116736.0,7877532.0,408,160,248,26168,12375,13793,14865982.0,7007309.0,7858672.0,0.5661,0.5698,0.5662,0.5698
2023-05-19 11:35,547,69,478,45972,3418,42554,26161552.0,1935969.0,24225583.0,535,62,473,44799,3238,41561,25544367.0,1835517.0,23708849.0,0.5664,0.5693,0.5669,0.5705
2023-05-19 11:40,630,155,475,50685,9454,41231,28875189.0,5360594.0,23514595.0,622,151,471,50730,9448,41282,28902366.0,5356586.0,23545779.0,0.567,0.5703,0.567,0.5704
2023-05-19 11:45,820,118,702,55258,7563,47695,31471912.0,4292415.0,27179497.0,802,105,697,54876,7335,47541,31264854.0,4165901.0,27098953.0,0.5676,0.5699,0.5679,0.57
2023-05-19 11:50,189,68,121,14996,5170,9826,8546323.0,2931928.0,5614395.0,185,66,119,14259,4438,9821,8124498.0,2513707.0,5610790.0,0.5671,0.5714,0.5664,0.5713
2023-05-19 11:55,179,53,126,8640,2911,5729,16798436.0,13533644.0,3264792.0,162,41,121,8666,2964,5702,16805987.0,13555792.0,3250194.0,4.6491,0.5699,4.5735,0.57
2023-05-19 12:00,405,124,281,33432,5023,28409,19095543.0,2846824.0,16248718.0,380,107,273,33083,4721,28362,18900985.0,2675799.0,16225186.0,0.5668,0.572,0.5668,0.5721
2023-05-19 12:05,531,46,485,85124,1825,83299,48700545.0,1035389.0,47665156.0,517,35,482,84992,1653,83339,48626265.0,938286.0,47687978.0,0.5673,0.5722,0.5676,0.5722
2023-05-19 12:10,856,243,613,93179,9912,83267,53245321.0,5615348.0,47629973.0,849,239,610,93321,10042,83279,53326358.0,5687927.0,47638430.0,0.5665,0.572,0.5664,0.572
2023-05-19 12:15,1056,202,854,139300,8495,130805,79654298.0,4814888.0,74839409.0,1041,188,853,138606,7785,130821,79258513.0,4411316.0,74847196.0,0.5668,0.5721,0.5666,0.5721
2023-05-19 12:20,2257,299,1958,274275,17229,257046,156746052.0,9788019.0,146958032.0,2248,299,1949,274702,17739,256963,156990479.0,10077998.0,146912481.0,0.5681,0.5717,0.5681,0.5717
2023-05-19 12:25,1625,119,1506,211414,9351,202063,120798948.0,5303957.0,115494990.0,1607,105,1502,211252,9220,202032,120703721.0,5226322.0,115477398.0,0.5672,0.5716,0.5668,0.5716
2023-05-19 12:30,2589,740,1849,309995,61571,248424,200889330.0,58786668.0,142102662.0,2559,720,1839,309821,61221,248600,200766701.0,58571439.0,142195262.0,0.9548,0.572,0.9567,0.572
2023-05-19 12:35,2326,1082,1244,220691,75393,145298,126035229.0,42906385.0,83128843.0,2306,1075,1231,220272,75168,145104,125786232.0,42769057.0,83017174.0,0.5691,0.5721,0.569,0.5721
2023-05-19 12:40,1884,1107,777,138665,82805,55860,91049929.0,59036877.0,32013052.0,1873,1102,771,138089,82667,55422,90706441.0,58948130.0,31758310.0,0.713,0.5731,0.7131,0.573
2023-05-19 12:45,1573,1081,492,110472,89774,20698,62961659.0,51105229.0,11856430.0,1564,1074,490,110704,89968,20736,63093720.0,51215903.0,11877817.0,0.5693,0.5728,0.5693,0.5728
2023-05-19 12:50,1062,709,353,73357,61341,12016,41806884.0,34932721.0,6874163.0,1057,704,353,72872,61192,11680,41529063.0,34848425.0,6680638.0,0.5695,0.5721,0.5695,0.572
2023-05-19 12:55,112,48,64,5953,3231,2722,3393152.0,1838498.0,1554654.0,102,44,58,5730,3123,2607,3267238.0,1775866.0,1491371.0,0.569,0.5711,0.5686,0.5721
2023-05-19 13:00,356,180,176,16582,10135,6447,9476053.0,5785637.0,3690415.0,348,176,172,16344,9879,6465,9325492.0,5624742.0,3700749.0,0.5709,0.5724,0.5694,0.5724
2023-05-19 13:05,136,49,87,7312,2687,4625,16062452.0,13408391.0,2654060.0,124,43,81,6915,2447,4468,15833874.0,13269795.0,2564078.0,4.9901,0.5739,5.4229,0.5739
2023-05-19 13:10,140,58,82,5798,2772,3026,3311914.0,1579806.0,1732107.0,127,52,75,5598,2723,2875,3196891.0,1550574.0,1646316.0,0.5699,0.5724,0.5694,0.5726
2023-05-19 13:15,308,211,97,22351,16588,5763,12767898.0,9430069.0,3337828.0,284,199,85,21367,16224,5143,12174455.0,9231800.0,2942655.0,0.5685,0.5792,0.569,0.5722
2023-05-19 13:20,226,160,66,13625,12286,1339,7755957.0,6990673.0,765283.0,213,151,62,13362,12042,1320,7605242.0,6850817.0,754425.0,0.569,0.5715,0.5689,0.5715
2023-05-19 13:25,172,81,91,8504,3828,4676,16728514.0,14056910.0,2671603.0,157,73,84,8065,3762,4303,16482040.0,14019613.0,2462427.0,3.6721,0.5713,3.7266,0.5723
2023-05-19 13:30,223,130,93,11167,6593,4574,6363967.0,3748624.0,2615343.0,212,123,89,11043,6486,4557,6294180.0,3687934.0,2606246.0,0.5686,0.5718,0.5686,0.5719
2023-05-19 13:35,105,58,47,5930,3176,2754,3381785.0,1807537.0,1574248.0,102,55,47,5610,2873,2737,3199383.0,1634995.0,1564388.0,0.5691,0.5716,0.5691,0.5716
2023-05-19 13:40,254,176,78,18482,15931,2551,10526682.0,9068606.0,1458076.0,244,169,75,18447,15870,2577,10504128.0,9030965.0,1473162.0,0.5692,0.5716,0.5691,0.5717
2023-05-19 13:45,413,121,292,23028,10538,12490,13112871.0,5982039.0,7130832.0,404,115,289,22683,10577,12106,12916529.0,6004381.0,6912148.0,0.5677,0.5709,0.5677,0.571
2023-05-19 13:50,722,98,624,29420,8403,21017,16758753.0,4767826.0,11990926.0,702,80,622,29179,8167,21012,16622207.0,4634139.0,11988068.0,0.5674,0.5705,0.5674,0.5705
2023-05-19 13:55,155,95,60,8871,6037,2834,5050369.0,3432435.0,1617934.0,139,80,59,8907,6093,2814,5064269.0,3457852.0,1606416.0,0.5686,0.5709,0.5675,0.5709
2023-05-19 14:00,293,191,102,22097,13400,8697,12605891.0,7626766.0,4979124.0,286,188,98,21002,13393,7609,11979488.0,7621976.0,4357512.0,0.5692,0.5725,0.5691,0.5727
2023-05-19 14:05,285,159,126,22653,12217,10436,12914988.0,6963547.0,5951440.0,264,149,115,18930,8810,10120,10805509.0,5015759.0,5789749.0,0.57,0.5703,0.5693,0.5721
2023-05-19 14:10,79,44,35,4668,2105,2563,2667857.0,1198669.0,1469187.0,73,41,32,4836,2055,2781,2762007.0,1170227.0,1591779.0,0.5694,0.5732,0.5695,0.5724
2023-05-19 14:15,69,31,38,4552,1289,3263,2604078.0,731981.0,1872097.0,64,28,36,4507,1266,3241,2578721.0,719116.0,1859605.0,0.5679,0.5737,0.568,0.5738
2023-05-19 14:20,524,247,277,27708,7759,19949,27669587.0,16282885.0,11386702.0,507,239,268,23765,7724,16041,25425848.0,16263521.0,9162326.0,2.0986,0.5708,2.1056,0.5712
2023-05-19 14:25,727,322,405,35572,12784,22788,20284900.0,7271868.0,13013031.0,716,314,402,35319,12585,22734,20129283.0,7148983.0,12980300.0,0.5688,0.571,0.5681,0.571
2023-05-19 14:30,429,226,203,25729,9825,15904,14644717.0,5578486.0,9066231.0,411,216,195,25416,9675,15741,14493700.0,5491638.0,9002061.0,0.5678,0.5701,0.5676,0.5719
2023-05-19 14:35,422,125,297,30105,8720,21385,17152971.0,4945582.0,12207389.0,411,118,293,29681,8416,21265,16931878.0,4772434.0,12159444.0,0.5672,0.5708,0.5671,0.5718
2023-05-19 14:40,148,40,108,9858,1735,8123,5622794.0,984984.0,4637810.0,135,32,103,9280,1674,7606,5292655.0,949513.0,4343142.0,0.5677,0.5709,0.5672,0.571
2023-05-19 14:45,208,66,142,14652,3295,11357,8345681.0,1869524.0,6476157.0,197,59,138,15027,3268,11759,8566487.0,1854014.0,6712473.0,0.5674,0.5702,0.5673,0.5708
2023-05-19 14:50,597,97,500,40996,5622,35374,23373759.0,3187463.0,20186295.0,576,84,492,40891,5607,35284,23314320.0,3178100.0,20136220.0,0.567,0.5707,0.5668,0.5707
2023-05-19 14:55,325,77,248,26468,3449,23019,15084136.0,1952016.0,13132119.0,317,70,247,26432,3531,22901,15062681.0,1997770.0,13064910.0,0.566,0.5705,0.5658,0.5705
2023-05-19 15:00,592,313,279,39353,18850,20503,22412357.0,10699384.0,11712972.0,587,312,275,38972,18803,20169,22194197.0,10672563.0,11521634.0,0.5676,0.5713,0.5676,0.5713
2023-05-19 15:05,578,132,446,35066,7411,27655,31870567.0,16080916.0,15789651.0,568,123,445,34740,7067,27673,31689458.0,15885037.0,15804421.0,2.1699,0.571,2.2478,0.5711
2023-05-19 15:10,722,293,429,56293,14736,41557,32130949.0,8387358.0,23743590.0,711,288,423,55631,14550,41081,31752185.0,8279817.0,23472368.0,0.5692,0.5713,0.5691,0.5714
2023-05-19 15:15,2490,855,1635,342084,86261,255823,218443988.0,72694575.0,145749413.0,2462,835,1627,340614,85836,254778,217754979.0,72453324.0,145301655.0,0.8427,0.5697,0.8441,0.5703
2023-05-19 15:20,2764,1017,1747,297504,86215,211289,169325967.0,48914206.0,120411761.0,2747,1004,1743,297632,86022,211610,169404533.0,48804931.0,120599602.0,0.5674,0.5699,0.5674,0.5699
2023-05-19 15:25,2659,800,1859,302756,54301,248455,172408744.0,30790556.0,141618188.0,2647,792,1855,302492,54206,248286,172259610.0,30737414.0,141522195.0,0.567,0.57,0.567,0.57
2023-05-19 15:30,868,182,686,81959,9252,72707,46700297.0,5242923.0,41457374.0,861,177,684,82202,9425,72777,46843558.0,5341767.0,41501791.0,0.5667,0.5702,0.5668,0.5703
2023-05-19 15:35,780,191,589,64520,6673,57847,36802388.0,3785580.0,33016808.0,766,183,583,62360,6617,55743,35573822.0,3754142.0,31819680.0,0.5673,0.5708,0.5673,0.5708
2023-05-19 15:40,69,43,26,4092,1848,2244,2323017.0,1047267.0,1275750.0,62,36,26,4088,1842,2246,2319906.0,1042961.0,1276945.0,0.5667,0.5685,0.5662,0.5685
2023-05-19 15:45,324,200,124,18501,9812,8689,10503002.0,5559397.0,4943604.0,315,192,123,18526,9829,8697,10515994.0,5567928.0,4948066.0,0.5666,0.5689,0.5665,0.5689
2023-05-19 15:50,859,396,463,88067,23171,64896,50203343.0,13139553.0,37063790.0,855,392,463,89557,22845,66712,51054768.0,12956787.0,38097980.0,0.5671,0.5711,0.5672,0.5711
2023-05-19 15:55,742,387,355,67425,21279,46146,38427094.0,12067673.0,26359420.0,732,383,349,65751,21310,44441,37475369.0,12084968.0,25390401.0,0.5671,0.5712,0.5671,0.5713
2023-05-19 16:00,209,136,73,10871,7763,3108,6175919.0,4397606.0,1778312.0,200,128,72,10839,7634,3205,6158438.0,4324603.0,1833835.0,0.5665,0.5722,0.5665,0.5722
2023-05-19 16:05,298,143,155,17564,8186,9378,21780172.0,16510763.0,5269408.0,277,131,146,16038,7662,8376,20979009.0,16212954.0,4766054.0,2.017,0.5619,2.116,0.569
2023-05-19 16:10,2789,390,2399,409114,14270,394844,243990736.0,19932776.0,224057960.0,2721,335,2386,407021,13299,393722,242915877.0,19385725.0,223530152.0,1.3968,0.5675,1.4577,0.5677
2023-05-19 16:15,2434,391,2043,383046,8036,375010,217401560.0,4531624.0,212869936.0,2378,344,2034,382490,6843,375647,217119185.0,3863521.0,213255664.0,0.5639,0.5676,0.5646,0.5677
2023-05-19 16:20,201,96,105,8521,1283,7238,16661253.0,12603912.0,4057341.0,155,61,94,8084,1006,7078,16445258.0,12443901.0,4001357.0,9.8238,0.5606,12.3697,0.5653
2023-05-19 16:25,179,87,92,11969,3200,8769,18696880.0,13760426.0,4936454.0,152,63,89,10840,2381,8459,18061118.0,13300791.0,4760327.0,4.3001,0.5629,5.5862,0.5628
2023-05-19 16:30,2256,909,1347,289356,52592,236764,164316269.0,29736715.0,134579554.0,2232,892,1340,287733,51125,236608,163396037.0,28903887.0,134492150.0,0.5654,0.5684,0.5654,0.5684
2023-05-19 16:35,964,220,744,147265,14708,132557,83677008.0,8314790.0,75362218.0,944,204,740,147053,14390,132663,83559121.0,8136737.0,75422383.0,0.5653,0.5685,0.5654,0.5685
2023-05-19 16:40,1293,244,1049,153588,15362,138226,87291273.0,8704122.0,78587150.0,1288,239,1049,153348,15300,138048,87142613.0,8657420.0,78485193.0,0.5666,0.5685,0.5658,0.5685
2023-05-19 16:45,1900,566,1334,235601,33068,202533,133825669.0,18716837.0,115108832.0,1888,560,1328,234674,32642,202032,133326662.0,18475979.0,114850682.0,0.566,0.5683,0.566,0.5685
2023-05-19 16:50,782,24,758,108800,337,108463,61816986.0,190453.0,61626533.0,770,19,751,107418,258,107160,61030572.0,145877.0,60884694.0,0.5651,0.5682,0.5654,0.5682
2023-05-19 16:55,1967,112,1855,262205,3491,258714,149063458.0,1975253.0,147088205.0,1959,102,1857,263286,3508,259778,149677471.0,1983138.0,147694332.0,0.5658,0.5685,0.5653,0.5685
2023-05-19 17:00,2839,1346,1493,415613,215473,200140,248266170.0,134262854.0,114003315.0,2817,1336,1481,413605,213997,199608,246935887.0,133236421.0,113699465.0,0.6231,0.5696,0.6226,0.5696
2023-05-19 17:05,1732,1058,674,234486,190290,44196,144847345.0,119671307.0,25176038.0,1717,1046,671,234132,189806,44326,144649579.0,119399321.0,25250258.0,0.6289,0.5696,0.6291,0.5696
2023-05-19 17:10,2137,1458,679,305810,256220,49590,173440929.0,145194698.0,28246231.0,2120,1447,673,305328,255920,49408,173162504.0,145019899.0,28142604.0,0.5667,0.5696,0.5667,0.5696
2023-05-19 17:15,2845,2041,804,431767,369817,61950,244950111.0,209672220.0,35277891.0,2831,2031,800,431918,370151,61767,245036790.0,209861272.0,35175518.0,0.567,0.5695,0.567,0.5695
2023-05-19 17:20,2644,1739,905,361057,298234,62823,204801657.0,169038420.0,35763237.0,2626,1722,904,360630,297669,62961,204555729.0,168714427.0,35841301.0,0.5668,0.5693,0.5668,0.5693
2023-05-19 17:25,2772,1678,1094,360432,292316,68116,204386869.0,165604460.0,38782408.0,2767,1675,1092,360474,292233,68241,204409786.0,165556331.0,38853455.0,0.5665,0.5694,0.5665,0.5694
2023-05-19 17:30,2269,1418,851,282150,229287,52863,160018331.0,129917522.0,30100809.0,2268,1419,849,282675,229740,52935,160318228.0,130174158.0,30144070.0,0.5666,0.5694,0.5666,0.5695
2023-05-19 17:35,2710,1489,1221,372884,253300,119584,246834854.0,178982989.0,67851864.0,2683,1471,1212,369340,252499,116841,245014513.0,178529262.0,66485250.0,0.7066,0.5674,0.707,0.569
2023-05-19 17:40,2760,1212,1548,314945,161317,153628,237894967.0,150495827.0,87399139.0,2742,1203,1539,314087,160622,153465,237411512.0,150103866.0,87307646.0,0.9329,0.5689,0.9345,0.5689
2023-05-19 17:45,361,185,176,19407,10652,8755,10992263.0,6021635.0,4970628.0,332,171,161,18894,10756,8138,10685545.0,6065502.0,4620042.0,0.5653,0.5677,0.5639,0.5677
2023-05-19 17:50,326,185,141,23959,12881,11078,13549158.0,7260010.0,6289148.0,299,162,137,23649,12624,11025,13370322.0,7110925.0,6259397.0,0.5636,0.5677,0.5633,0.5677
2023-05-19 17:55,211,111,100,16318,7881,8437,9196026.0,4445917.0,4750109.0,195,104,91,14974,7675,7299,8472300.0,4329348.0,4142951.0,0.5641,0.563,0.5641,0.5676
2023-05-19 18:00,450,145,305,29957,6931,23026,28839893.0,15784547.0,13055346.0,440,141,299,30791,7933,22858,29294313.0,16333802.0,12960511.0,2.2774,0.567,2.059,0.567
2023-05-19 18:05,753,261,492,44335,8756,35579,25113818.0,4948917.0,20164901.0,741,254,487,44276,8710,35566,25080210.0,4922688.0,20157522.0,0.5652,0.5668,0.5652,0.5668
2023-05-19 18:10,1087,373,714,68457,17681,50776,38761676.0,9984671.0,28777004.0,1067,355,712,68189,17636,50553,38611613.0,9958470.0,28653143.0,0.5647,0.5667,0.5647,0.5668
2023-05-19 18:15,507,132,375,45275,6179,39096,25617071.0,3482979.0,22134091.0,485,114,371,33647,5547,28100,19053726.0,3131087.0,15922639.0,0.5637,0.5661,0.5645,0.5666
2023-05-19 18:20,99,52,47,7028,3519,3509,3967024.0,1985572.0,1981452.0,84,41,43,6574,3463,3111,3713961.0,1953743.0,1760218.0,0.5642,0.5647,0.5642,0.5658
2023-05-19 18:25,373,96,277,27863,4741,23122,27613559.0,14559028.0,13054530.0,355,86,269,26935,4852,22083,27081020.0,14608028.0,12472991.0,3.0709,0.5646,3.0107,0.5648
2023-05-19 18:30,718,538,180,70473,61188,9285,39654704.0,34408520.0,5246184.0,665,499,166,69455,60440,9015,39082888.0,33986635.0,5096253.0,0.5623,0.565,0.5623,0.5653
2023-05-19 18:35,1029,693,336,103709,88879,14830,58336920.0,49971920.0,8365000.0,999,670,329,103123,88214,14909,58018516.0,49602193.0,8416323.0,0.5622,0.5641,0.5623,0.5645
2023-05-22 10:00,1253,450,803,76762,34538,42224,52196906.0,28175208.0,24021698.0,939,303,636,58312,19121,39191,35253521.0,13058398.0,22195123.0,0.8158,0.5689,0.6829,0.5663
2023-05-22 10:05,2586,1345,1241,188563,115047,73516,142761049.0,100726268.0,42034781.0,2383,1253,1130,182990,110637,72353,134876980.0,93527682.0,41349298.0,0.8755,0.5718,0.8454,0.5715
2023-05-22 10:10,1771,1232,539,148979,118196,30783,84622445.0,67044575.0,17577869.0,1698,1203,495,148023,117949,30074,84068197.0,66905826.0,17162371.0,0.5672,0.571,0.5672,0.5707
2023-05-22 10:15,1635,583,1052,111964,46243,65721,63734391.0,26230765.0,37503626.0,1589,550,1039,110464,44907,65557,62894223.0,25479907.0,37414315.0,0.5672,0.5706,0.5674,0.5707
2023-05-22 10:20,2340,1419,921,243322,176905,66417,245710844.0,207669487.0,38041356.0,2243,1372,871,239418,174799,64619,243388848.0,206372979.0,37015868.0,1.1739,0.5728,1.1806,0.5728
2023-05-22 10:25,1522,748,774,127072,67603,59469,96405483.0,62350259.0,34055224.0,1437,705,732,123327,65978,57349,94228303.0,61380181.0,32848122.0,0.9223,0.5727,0.9303,0.5728
2023-05-22 10:30,2197,1569,628,296310,240051,56259,204796107.0,172549294.0,32246813.0,2137,1538,599,292875,237942,54933,202817142.0,171330641.0,31486500.0,0.7188,0.5732,0.7201,0.5732
2023-05-22 10:35,2125,1430,695,268939,218522,50417,177879578.0,148882879.0,28996699.0,1988,1382,606,259514,213330,46184,172214099.0,145655549.0,26558550.0,0.6813,0.5751,0.6828,0.5751
2023-05-22 10:40,1502,839,663,146275,103266,43009,119971828.0,95007799.0,24964029.0,1333,777,556,141511,102780,38731,117089620.0,94687062.0,22402557.0,0.92,0.5804,0.9213,0.5784
2023-05-22 10:45,2133,1102,1031,218799,142883,75916,160625181.0,117165504.0,43459677.0,2052,1054,998,207849,139621,68228,154470582.0,115329565.0,39141016.0,0.82,0.5725,0.826,0.5737
2023-05-22 10:50,2174,1442,732,233891,170616,63275,169344273.0,133028776.0,36315496.0,2140,1422,718,233943,170887,63056,169378509.0,133178870.0,36199639.0,0.7797,0.5739,0.7793,0.5741
2023-05-22 10:55,968,657,311,92421,72998,19423,52834652.0,41683525.0,11151127.0,927,641,286,91852,73058,18794,52501758.0,41711360.0,10790397.0,0.571,0.5741,0.5709,0.5741
2023-05-22 11:00,730,413,317,56288,37417,18871,32192569.0,21363566.0,10829003.0,685,395,290,54179,36324,17855,30986484.0,20738929.0,10247554.0,0.571,0.5738,0.5709,0.5739
2023-05-22 11:05,833,561,272,73669,55614,18055,42136881.0,31770627.0,10366253.0,808,550,258,72453,55246,17207,41439432.0,31558121.0,9881311.0,0.5713,0.5741,0.5712,0.5743
2023-05-22 11:10,778,524,254,69070,52182,16888,39461226.0,29779220.0,9682005.0,762,516,246,68637,51997,16640,39215522.0,29673937.0,9541585.0,0.5707,0.5733,0.5707,0.5734
2023-05-22 11:15,775,221,554,64324,38504,25820,36767697.0,21957542.0,14810155.0,752,203,549,63995,38287,25708,36581019.0,21835348.0,14745671.0,0.5703,0.5736,0.5703,0.5736
2023-05-22 11:20,223,141,82,26046,21075,4971,14867087.0,12015662.0,2851425.0,209,133,76,25070,20893,4177,14308206.0,11912218.0,2395988.0,0.5701,0.5736,0.5702,0.5736
2023-05-22 11:25,1182,573,609,118968,84735,34233,79741754.0,60151557.0,19590196.0,1113,530,583,117742,84551,33191,79047068.0,60047509.0,18999558.0,0.7099,0.5723,0.7102,0.5724
2023-05-22 11:30,1675,805,870,178929,131678,47251,102114828.0,75065587.0,27049240.0,1652,783,869,178419,130743,47676,101826482.0,74530413.0,27296069.0,0.5701,0.5725,0.5701,0.5725
2023-05-22 11:35,1507,911,596,166776,148003,18773,95141920.0,84388498.0,10753422.0,1494,904,590,166843,148216,18627,95183386.0,84509546.0,10673840.0,0.5702,0.5728,0.5702,0.573
2023-05-22 11:40,1237,791,446,130677,105416,25261,74522262.0,60075155.0,14447107.0,1157,752,405,128842,104702,24140,73493679.0,59668681.0,13824997.0,0.5699,0.5719,0.5699,0.5727
2023-05-22 11:45,1238,749,489,143699,120240,23459,81941053.0,68517725.0,13423327.0,1247,765,482,143070,120005,23065,81582981.0,68383307.0,13199674.0,0.5698,0.5722,0.5698,0.5723
2023-05-22 11:50,500,330,170,52253,44474,7779,29788110.0,25339430.0,4448680.0,492,321,171,52666,44504,8162,30029449.0,25356070.0,4673378.0,0.5698,0.5719,0.5697,0.5726
2023-05-22 11:55,137,77,60,14712,11733,2979,8385868.0,6677910.0,1707958.0,143,75,68,13819,10754,3065,7876119.0,6120443.0,1755676.0,0.5692,0.5733,0.5691,0.5728
2023-05-22 12:00,112,51,61,9588,5241,4347,5442980.0,2980394.0,2462586.0,104,54,50,10676,6307,4369,6087881.0,3584628.0,2503253.0,0.5687,0.5665,0.5684,0.573
2023-05-22 12:05,501,305,196,58061,44306,13755,33058142.0,25211212.0,7846930.0,462,286,176,56901,43504,13397,32422410.0,24756084.0,7666326.0,0.569,0.5705,0.5691,0.5722
2023-05-22 12:10,98,34,64,4862,729,4133,2783239.0,414793.0,2368445.0,86,31,55,4598,771,3827,2629032.0,438587.0,2190444.0,0.569,0.5731,0.5689,0.5724
2023-05-22 12:15,198,12,186,10189,632,9557,5845754.0,360417.0,5485337.0,207,12,195,10373,678,9695,5954995.0,386580.0,5568414.0,0.5703,0.574,0.5702,0.5744
2023-05-22 12:20,237,61,176,14038,3497,10541,8059416.0,1991797.0,6067618.0,229,61,168,13863,3536,10327,7947215.0,2014300.0,5932915.0,0.5696,0.5756,0.5697,0.5745
2023-05-22 12:25,470,201,269,35452,19429,16023,20210392.0,11045134.0,9165258.0,478,205,273,35380,19477,15903,20170547.0,11072684.0,9097862.0,0.5685,0.572,0.5685,0.5721
2023-05-22 12:30,459,296,163,63062,54913,8149,35832390.0,31185943.0,4646447.0,423,278,145,62879,54889,7990,35735072.0,31172057.0,4563015.0,0.5679,0.5702,0.5679,0.5711
2023-05-22 12:35,843,430,413,90467,67618,22849,63297056.0,50282961.0,13014095.0,811,415,396,89608,67778,21830,62838794.0,50374352.0,12464441.0,0.7436,0.5696,0.7432,0.571
2023-05-22 12:40,924,470,454,141345,111184,30161,92052344.0,74858843.0,17193501.0,897,458,439,140148,110546,29602,91376316.0,74500772.0,16875544.0,0.6733,0.5701,0.6739,0.5701
2023-05-22 12:45,745,324,421,88570,64189,24381,50251628.0,36327326.0,13924302.0,726,314,412,86906,63713,23193,49282660.0,36066656.0,13216003.0,0.5659,0.5711,0.5661,0.5698
2023-05-22 12:50,620,338,282,57959,37414,20545,44868888.0,33151198.0,11717689.0,590,327,263,57281,37103,20178,44423210.0,32915802.0,11507407.0,0.8861,0.5703,0.8871,0.5703
2023-05-22 12:55,861,377,484,68816,34405,34411,39189518.0,19556942.0,19632575.0,846,369,477,68970,34263,34707,39278383.0,19475655.0,19802728.0,0.5684,0.5705,0.5684,0.5706
2023-05-22 13:00,892,333,559,72163,39974,32189,41053350.0,22687993.0,18365357.0,854,317,537,71535,39784,31751,40688948.0,22574793.0,18114154.0,0.5676,0.5705,0.5674,0.5705
2023-05-22 13:05,602,284,318,59116,39458,19658,33655172.0,22437168.0,11218003.0,591,278,313,59079,39443,19636,33633859.0,22428603.0,11205256.0,0.5686,0.5707,0.5686,0.5706
2023-05-22 13:10,410,132,278,23898,6777,17121,13618032.0,3851565.0,9766467.0,400,127,273,23754,6674,17080,13535583.0,3792327.0,9743256.0,0.5683,0.5704,0.5682,0.5704
2023-05-22 13:15,669,263,406,35923,11540,24383,20467988.0,6558676.0,13909312.0,662,259,403,35907,11524,24383,20459936.0,6550039.0,13909897.0,0.5683,0.5705,0.5684,0.5705
2023-05-22 13:20,360,93,267,20038,5719,14319,11411985.0,3250077.0,8161908.0,363,83,280,20106,5740,14366,11458489.0,3260935.0,8197553.0,0.5683,0.57,0.5681,0.5706
2023-05-22 13:25,662,196,466,33739,8930,24809,19238845.0,5077007.0,14161838.0,652,189,463,33447,8543,24904,19074133.0,4856811.0,14217322.0,0.5685,0.5708,0.5685,0.5709
2023-05-22 13:30,591,291,300,33424,17785,15639,19047239.0,10109785.0,8937453.0,555,260,295,32770,17377,15393,18673704.0,9878381.0,8795323.0,0.5684,0.5715,0.5685,0.5714
2023-05-22 13:35,450,279,171,31979,22985,8994,18196580.0,13063973.0,5132606.0,430,260,170,33603,22660,10943,19234828.0,12881468.0,6353360.0,0.5684,0.5707,0.5685,0.5806
2023-05-22 13:40,445,221,224,27115,16038,11077,15445958.0,9118555.0,6327402.0,434,213,221,27460,16165,11295,15645341.0,9190475.0,6454866.0,0.5686,0.5712,0.5685,0.5715
2023-05-22 13:45,287,119,168,25667,16881,8786,14584438.0,9567615.0,5016823.0,281,114,167,22948,14173,8775,13054623.0,8042789.0,5011833.0,0.5668,0.571,0.5675,0.5711
2023-05-22 13:50,644,238,406,36185,13597,22588,20624122.0,7731547.0,12892575.0,640,235,405,36149,13546,22603,20604140.0,7702937.0,12901203.0,0.5686,0.5708,0.5687,0.5708
2023-05-22 13:55,601,266,335,57297,40982,16315,32601883.0,23295095.0,9306788.0,597,263,334,56647,40246,16401,32248936.0,22885575.0,9363361.0,0.5684,0.5704,0.5686,0.5709
2023-05-22 14:00,198,112,86,16130,11071,5059,9184337.0,6292151.0,2892185.0,193,110,83,15814,10850,4964,9003671.0,6166893.0,2836777.0,0.5683,0.5717,0.5684,0.5715
2023-05-22 14:05,543,277,266,28305,16104,12201,16122514.0,9161995.0,6960519.0,529,266,263,28156,15978,12178,16039290.0,9089936.0,6949353.0,0.5689,0.5705,0.5689,0.5706
2023-05-22 14:10,240,94,146,19922,11553,8369,11349207.0,6567948.0,4781259.0,244,99,145,20004,11598,8406,11393750.0,6591501.0,4802249.0,0.5685,0.5713,0.5683,0.5713
2023-05-22 14:15,351,157,194,22479,13835,8644,24711703.0,19766889.0,4944814.0,344,173,171,21403,13248,8155,24073161.0,19408441.0,4664719.0,1.4288,0.5721,1.465,0.572
2023-05-22 14:20,113,68,45,4846,3662,1184,2755363.0,2078276.0,677087.0,95,62,33,5323,4310,1013,3026976.0,2446398.0,580577.0,0.5675,0.5719,0.5676,0.5731
2023-05-22 14:25,30,20,10,1317,1101,216,750504.0,626875.0,123628.0,28,18,10,917,766,151,521905.0,435505.0,86400.0,0.5694,0.5724,0.5685,0.5722
2023-05-22 14:30,70,29,41,2330,1035,1295,1329313.0,587628.0,741684.0,66,28,38,2284,1084,1200,1303523.0,616383.0,687140.0,0.5678,0.5727,0.5686,0.5726
2023-05-22 14:35,36,16,20,1290,972,318,734286.0,552596.0,181690.0,27,11,16,989,736,253,562536.0,417982.0,144554.0,0.5685,0.5714,0.5679,0.5714
2023-05-22 14:40,33,17,16,1891,1558,333,1077205.0,885882.0,191323.0,26,12,14,1740,1100,640,993076.0,624785.0,368290.0,0.5686,0.5745,0.568,0.5755
2023-05-22 14:45,87,51,36,4615,2900,1715,2632828.0,1651361.0,981466.0,76,45,31,4231,2700,1531,2414020.0,1537521.0,876499.0,0.5694,0.5723,0.5695,0.5725
2023-05-22 14:50,128,54,74,8798,2381,6417,5024987.0,1354912.0,3670075.0,118,49,69,7943,2271,5672,4533525.0,1292439.0,3241086.0,0.5691,0.5719,0.5691,0.5714
2023-05-22 14:55,358,198,160,29913,21057,8856,17013065.0,11972489.0,5040575.0,337,186,151,29144,20592,8552,16594817.0,11706121.0,4888696.0,0.5686,0.5692,0.5685,0.5716
2023-05-22 15:00,126,95,31,13719,12219,1500,7805377.0,6947835.0,857542.0,120,94,26,13837,12572,1265,7873212.0,7147678.0,725534.0,0.5686,0.5717,0.5685,0.5735
2023-05-22 15:05,363,222,141,35321,30292,5029,20098210.0,17222796.0,2875413.0,356,220,136,34884,29825,5059,19850238.0,16958020.0,2892218.0,0.5686,0.5718,0.5686,0.5717
2023-05-22 15:10,269,29,240,13045,2307,10738,7444249.0,1312458.0,6131790.0,269,28,241,13018,2266,10752,7429009.0,1289158.0,6139850.0,0.5689,0.571,0.5689,0.571
2023-05-22 15:15,538,158,380,27284,9928,17356,15554287.0,5648543.0,9905744.0,527,157,370,26997,9978,17019,15394998.0,5676976.0,9718021.0,0.569,0.5707,0.5689,0.571
2023-05-22 15:20,600,251,349,30107,14467,15640,17156095.0,8229925.0,8926170.0,598,249,349,30070,14437,15633,17135193.0,8212921.0,8922272.0,0.5689,0.5707,0.5689,0.5707
2023-05-22 15:25,766,132,634,46980,16315,30665,26772015.0,9267964.0,17504050.0,758,128,630,47270,16653,30617,26934483.0,9459410.0,17475073.0,0.5681,0.5708,0.568,0.5708
2023-05-22 15:30,691,160,531,43883,18984,24899,36881655.0,22670067.0,14211588.0,682,159,523,43875,19142,24733,36877745.0,22759871.0,14117874.0,1.1942,0.5708,1.189,0.5708
2023-05-22 15:35,657,105,552,36570,12597,23973,20839402.0,7160822.0,13678579.0,653,99,554,36658,12551,24107,20893710.0,7134207.0,13759502.0,0.5685,0.5706,0.5684,0.5708
2023-05-22 15:40,532,85,447,23763,5852,17911,13537460.0,3319622.0,10217838.0,520,81,439,23594,5836,17758,13438359.0,3306157.0,10132201.0,0.5673,0.5705,0.5665,0.5706
2023-05-22 15:45,574,99,475,29385,10180,19205,16723874.0,5775070.0,10948803.0,570,97,473,29258,10170,19088,16659253.0,5769839.0,10889414.0,0.5673,0.5701,0.5673,0.5705
2023-05-22 15:50,373,32,341,14043,3243,10800,7995254.0,1839413.0,6155840.0,371,30,341,14009,3306,10703,7975379.0,1875000.0,6100379.0,0.5672,0.57,0.5672,0.57
2023-05-22 15:55,97,38,59,7783,5073,2710,4414677.0,2877237.0,1537439.0,90,34,56,7210,4509,2701,4099665.0,2557135.0,1542530.0,0.5672,0.5673,0.5671,0.5711
2023-05-22 16:00,527,42,485,22149,3940,18209,12607851.0,2230277.0,10377573.0,528,40,488,21882,3818,18064,12460524.0,2164385.0,10296138.0,0.5661,0.5699,0.5669,0.57
2023-05-22 16:05,362,81,281,24649,11632,13017,14015673.0,6599765.0,7415907.0,359,78,281,24790,11774,13016,14096738.0,6679923.0,7416815.0,0.5674,0.5697,0.5673,0.5698
2023-05-22 16:10,389,234,155,57635,49921,7714,32718325.0,28318964.0,4399360.0,379,225,154,57539,49826,7713,32667165.0,28268550.0,4398615.0,0.5673,0.5703,0.5673,0.5703
2023-05-22 16:15,262,31,231,12482,1285,11197,7109668.0,729298.0,6380369.0,252,28,224,12280,1280,11000,6993066.0,726493.0,6266573.0,0.5675,0.5698,0.5676,0.5697
2023-05-22 16:20,300,27,273,15849,1367,14482,9025337.0,774847.0,8250489.0,289,19,270,15396,994,14402,8766117.0,562114.0,8204002.0,0.5668,0.5697,0.5655,0.5696
2023-05-22 16:25,675,165,510,68628,37446,31182,38998255.0,21245852.0,17752402.0,665,156,509,68534,37409,31125,38944666.0,21224810.0,17719855.0,0.5674,0.5693,0.5674,0.5693
2023-05-22 16:30,473,81,392,44731,15616,29115,25440936.0,8859129.0,16581807.0,469,79,390,44884,15780,29104,25527902.0,8952304.0,16575597.0,0.5673,0.5695,0.5673,0.5695
2023-05-22 16:35,230,95,135,27405,17297,10108,15563030.0,9812623.0,5750406.0,221,89,132,27291,17385,9906,15509672.0,9862597.0,5647075.0,0.5673,0.5689,0.5673,0.5701
2023-05-22 16:40,905,477,428,128038,96035,32003,72720199.0,54493751.0,18226448.0,906,477,429,128552,96422,32130,73013026.0,54712977.0,18300049.0,0.5674,0.5695,0.5674,0.5696
2023-05-22 16:45,795,374,421,101124,70093,31031,57446967.0,39773177.0,17673789.0,810,387,423,101030,69781,31249,57394531.0,39595772.0,17798758.0,0.5674,0.5696,0.5674,0.5696
2023-05-22 16:50,721,162,559,69018,27022,41996,39250527.0,15329964.0,23920563.0,717,159,558,69241,27131,42110,39377032.0,15391560.0,23985471.0,0.5673,0.5696,0.5673,0.5696
2023-05-22 16:55,999,428,571,126740,84502,42238,72007829.0,47940597.0,24067231.0,992,422,570,126068,84043,42025,71626542.0,47680787.0,23945755.0,0.5673,0.5698,0.5673,0.5698
2023-05-22 17:00,392,200,192,54887,39455,15432,31172571.0,22379863.0,8792708.0,387,198,189,54974,39464,15510,31223604.0,22384913.0,8838691.0,0.5672,0.5698,0.5672,0.5699
2023-05-22 17:05,297,135,162,29609,15912,13697,28713616.0,20910237.0,7803379.0,283,129,154,28771,15935,12836,28237702.0,20923083.0,7314619.0,1.3141,0.5697,1.313,0.5699
2023-05-22 17:10,222,166,56,23308,20335,2973,13247643.0,11549404.0,1698238.0,209,157,52,23342,20210,3132,13261471.0,11472558.0,1788913.0,0.568,0.5712,0.5677,0.5712
2023-05-22 17:15,222,106,116,18775,10596,8179,10673832.0,6010424.0,4663407.0,217,104,113,18627,10475,8152,10590300.0,5941616.0,4648684.0,0.5672,0.5702,0.5672,0.5703
2023-05-22 17:20,74,41,33,5752,3634,2118,3262617.0,2055353.0,1207263.0,68,38,30,5238,3252,1986,2971899.0,1838170.0,1133729.0,0.5656,0.57,0.5652,0.5709
2023-05-22 17:25,485,218,267,47078,38240,8838,38635829.0,33597690.0,5038138.0,476,212,264,46498,37720,8778,38304090.0,33300419.0,5003671.0,0.8786,0.5701,0.8828,0.57
2023-05-22 17:30,878,767,111,140734,134162,6572,79984269.0,76226849.0,3757419.0,873,764,109,140541,134066,6475,79872739.0,76171906.0,3700833.0,0.5682,0.5717,0.5682,0.5716
2023-05-22 17:35,488,389,99,75070,71038,4032,42668421.0,40361810.0,2306610.0,485,387,98,75190,71159,4031,42736827.0,40430796.0,2306030.0,0.5682,0.5721,0.5682,0.5721
2023-05-22 17:40,109,87,22,18535,17587,948,10539604.0,9996957.0,542646.0,105,85,20,18571,17573,998,10554616.0,9983140.0,571476.0,0.5684,0.5724,0.5681,0.5726
2023-05-22 17:45,311,197,114,37452,31673,5779,21299974.0,17994731.0,3305243.0,309,197,112,37565,31796,5769,21362969.0,18063946.0,3299023.0,0.5681,0.5719,0.5681,0.5719
2023-05-22 17:50,23,12,11,1377,687,690,784615.0,390159.0,394456.0,18,7,11,960,288,672,547916.0,163761.0,384154.0,0.5679,0.5717,0.5686,0.5717
2023-05-22 17:55,944,756,188,143418,134906,8512,81542610.0,76678153.0,4864456.0,936,751,185,143472,134788,8684,81574924.0,76611459.0,4963465.0,0.5684,0.5715,0.5684,0.5716
2023-05-22 18:00,578,343,235,66962,59789,7173,38070570.0,33976177.0,4094392.0,575,345,230,67714,60669,7045,38478007.0,34455723.0,4022284.0,0.5683,0.5708,0.5679,0.5709
2023-05-22 18:05,540,285,255,50505,42471,8034,28719229.0,24136047.0,4583181.0,535,281,254,50625,42645,7980,28788857.0,24236271.0,4552586.0,0.5683,0.5705,0.5683,0.5705
2023-05-22 18:10,838,599,239,96909,88607,8302,55085285.0,50353367.0,4731917.0,831,597,234,96912,88669,8243,55094148.0,50388574.0,4705574.0,0.5683,0.57,0.5683,0.5709
2023-05-22 18:15,1155,854,301,140864,130557,10307,80087643.0,74202015.0,5885628.0,1146,848,298,140746,130456,10290,80020693.0,74144426.0,5876266.0,0.5683,0.571,0.5683,0.5711
2023-05-22 18:20,1073,729,344,106956,96582,10374,60808659.0,54886152.0,5922506.0,1071,735,336,106669,96550,10119,60645720.0,54868092.0,5777628.0,0.5683,0.5709,0.5683,0.571
2023-05-22 18:25,415,184,231,31089,22727,8362,29546664.0,24789624.0,4757040.0,433,180,253,31816,23229,8587,29968406.0,25066122.0,4902284.0,1.0908,0.5689,1.0791,0.5709
2023-05-22 18:30,239,116,123,21270,15759,5511,12072290.0,8948887.0,3123402.0,242,110,132,20500,15437,5063,11653176.0,8762281.0,2890895.0,0.5679,0.5668,0.5676,0.571
2023-05-22 18:35,1213,1063,150,151815,144753,7062,86305803.0,82272058.0,4033745.0,1202,1059,143,151202,144257,6945,85969169.0,81987577.0,3981591.0,0.5684,0.5712,0.5683,0.5733
2023-05-23 10:00,3239,2745,494,251726,221783,29943,187202064.0,169842873.0,17359190.0,2967,2609,358,233273,208186,25087,170190997.0,155820915.0,14370081.0,0.7658,0.5797,0.7485,0.5728
2023-05-23 10:05,2710,1666,1044,229235,125784,103451,142418851.0,83324268.0,59094583.0,2663,1650,1013,227248,125291,101957,136484040.0,78271803.0,58212237.0,0.6624,0.5712,0.6247,0.5709
2023-05-23 10:10,2491,1230,1261,216789,86918,129871,135464097.0,61252512.0,74211584.0,2388,1182,1206,216617,86758,129859,135347397.0,61162746.0,74184650.0,0.7047,0.5714,0.705,0.5713
2023-05-23 10:15,1277,960,317,82751,63756,18995,47085299.0,36214245.0,10871053.0,1256,950,306,81903,63725,18178,46591625.0,36199980.0,10391644.0,0.568,0.5723,0.5681,0.5717
2023-05-23 10:20,626,378,248,42186,22521,19665,24051015.0,12783530.0,11267485.0,609,370,239,42434,22907,19527,24199180.0,13001827.0,11197353.0,0.5676,0.573,0.5676,0.5734
2023-05-23 10:25,570,297,273,37159,18863,18296,21142285.0,10697298.0,10444986.0,543,284,259,36389,18416,17973,20711385.0,10444694.0,10266691.0,0.5671,0.5709,0.5672,0.5712
2023-05-23 10:30,1325,935,390,91561,61992,29569,52125348.0,35225474.0,16899874.0,1323,939,384,90553,61291,29262,51511285.0,34784129.0,16727156.0,0.5682,0.5715,0.5675,0.5716
2023-05-23 10:35,2548,1971,577,218697,155958,62739,124659076.0,88621500.0,36037576.0,2530,1960,570,215285,154001,61284,122615503.0,87538115.0,35077388.0,0.5682,0.5744,0.5684,0.5724
2023-05-23 10:40,1509,1284,225,130609,111776,18833,86178567.0,75436697.0,10741870.0,1499,1281,218,128958,112027,16931,85244921.0,75576643.0,9668277.0,0.6749,0.5704,0.6746,0.571
2023-05-23 10:45,1197,995,202,102030,86783,15247,69917735.0,61201502.0,8716232.0,1179,988,191,101534,86403,15131,69627151.0,60981158.0,8645993.0,0.7052,0.5717,0.7058,0.5714
2023-05-23 10:50,918,761,157,62865,51836,11029,47618326.0,41316926.0,6301400.0,899,747,152,62464,51660,10804,47388578.0,41215952.0,6172625.0,0.7971,0.5713,0.7978,0.5713
2023-05-23 10:55,849,693,156,50681,42269,8412,28801578.0,23988435.0,4813142.0,831,683,148,50242,41942,8300,28548677.0,23801241.0,4747436.0,0.5675,0.5722,0.5675,0.572
2023-05-23 11:00,375,317,58,31663,30545,1118,17968987.0,17329062.0,639925.0,361,308,53,31247,30118,1129,17736483.0,17090016.0,646466.0,0.5673,0.5724,0.5674,0.5726
2023-05-23 11:05,450,394,56,26550,24971,1579,15093082.0,14185960.0,907121.0,442,393,49,28023,25257,2766,15929572.0,14348114.0,1581458.0,0.5681,0.5745,0.5681,0.5717
2023-05-23 11:10,153,112,41,4832,3740,1092,2754530.0,2125828.0,628702.0,131,101,30,4279,3436,843,2435207.0,1952753.0,482454.0,0.5684,0.5757,0.5683,0.5723
2023-05-23 11:15,628,551,77,33055,30769,2286,18781231.0,17472791.0,1308440.0,622,549,73,33099,30929,2170,18807481.0,17564499.0,1242981.0,0.5679,0.5724,0.5679,0.5728
2023-05-23 11:20,179,97,82,3509,3020,489,2016057.0,1735794.0,280262.0,170,94,76,3210,2846,364,1825989.0,1617747.0,208241.0,0.5748,0.5731,0.5684,0.5721
2023-05-23 11:25,68,49,19,2642,2343,299,1513463.0,1337402.0,176060.0,57,44,13,2299,2225,74,1307599.0,1265310.0,42288.0,0.5708,0.5888,0.5687,0.5715
2023-05-23 11:30,325,284,41,6155,5079,1076,3500224.0,2885206.0,615017.0,315,278,37,5918,4791,1127,3370090.0,2725453.0,644636.0,0.5681,0.5716,0.5689,0.572
2023-05-23 11:35,161,124,37,9171,6586,2585,5207192.0,3732213.0,1474978.0,150,115,35,7448,6332,1116,4229561.0,3590530.0,639031.0,0.5667,0.5706,0.567,0.5726
2023-05-23 11:40,272,136,136,9751,7167,2584,5546844.0,4070886.0,1475958.0,250,127,123,9771,7434,2337,5552525.0,4217541.0,1334983.0,0.568,0.5712,0.5673,0.5712
2023-05-23 11:45,739,286,453,59822,19291,40531,45889963.0,22802571.0,23087391.0,712,276,436,58500,19355,39145,45134131.0,22840447.0,22293684.0,1.182,0.5696,1.1801,0.5695
2023-05-23 11:50,2504,850,1654,218626,36958,181668,124327735.0,20931783.0,103395952.0,2469,825,1644,217620,36480,181140,123765078.0,20662249.0,103102828.0,0.5664,0.5691,0.5664,0.5692
2023-05-23 11:55,4348,1427,2921,474376,101996,372380,281403382.0,69481654.0,211921728.0,4316,1408,2908,473783,101582,372201,281090800.0,69257250.0,211833550.0,0.6812,0.5691,0.6818,0.5691
2023-05-23 12:00,3662,872,2790,350361,30462,319899,222573175.0,40940929.0,181632246.0,3610,835,2775,350284,30230,320054,222577997.0,40806998.0,181770998.0,1.344,0.5678,1.3499,0.5679
2023-05-23 12:05,2664,942,1722,208433,35111,173322,118056214.0,19811024.0,98245190.0,2642,926,1716,207998,34806,173192,117806189.0,19638755.0,98167434.0,0.5642,0.5668,0.5642,0.5668
2023-05-23 12:10,1329,620,709,112347,24608,87739,75723590.0,25825115.0,49898475.0,1306,603,703,109922,23396,86526,74286744.0,25088050.0,49198694.0,1.0495,0.5687,1.0723,0.5686
2023-05-23 12:15,163,137,26,7275,5195,2080,4125502.0,2940594.0,1184908.0,158,136,22,7133,5152,1981,4044322.0,2916060.0,1128262.0,0.566,0.5697,0.566,0.5695
2023-05-23 12:20,1452,830,622,159510,40003,119507,90849675.0,22669056.0,68180619.0,1441,820,621,159370,39765,119605,90773375.0,22534139.0,68239235.0,0.5667,0.5705,0.5667,0.5705
2023-05-23 12:25,1682,788,894,209514,34454,175060,119388039.0,19518157.0,99869881.0,1669,781,888,209582,34503,175079,119428095.0,19545316.0,99882778.0,0.5665,0.5705,0.5665,0.5705
2023-05-23 12:30,2243,790,1453,299023,28617,270406,170475442.0,16211188.0,154264254.0,2232,786,1446,298999,28611,270388,170461707.0,16207808.0,154253899.0,0.5665,0.5705,0.5665,0.5705
2023-05-23 12:35,1831,642,1189,235900,22300,213600,146423171.0,24510919.0,121912252.0,1817,634,1183,235721,22180,213541,146320138.0,24442583.0,121877555.0,1.0991,0.5708,1.102,0.5707
2023-05-23 12:40,1857,665,1192,233470,22207,211263,133213249.0,12578841.0,120634408.0,1849,659,1190,232414,21552,210862,132617176.0,12214065.0,120403111.0,0.5664,0.571,0.5667,0.571
2023-05-23 12:45,1370,557,813,158789,13003,145786,90562286.0,7367574.0,83194712.0,1358,548,810,158445,12863,145582,90367410.0,7288506.0,83078903.0,0.5666,0.5707,0.5666,0.5707
2023-05-23 12:50,664,290,374,51113,9584,41529,29104291.0,5430515.0,23673776.0,653,281,372,51298,9610,41688,29212529.0,5444938.0,23767591.0,0.5666,0.5701,0.5666,0.5701
2023-05-23 12:55,1271,470,801,162944,17081,145863,92953323.0,9682190.0,83271132.0,1267,468,799,162931,16945,145986,92946763.0,9605266.0,83341497.0,0.5668,0.5709,0.5668,0.5709
2023-05-23 13:00,1093,294,799,151167,10720,140447,86265430.0,6078657.0,80186772.0,1086,291,795,151242,10722,140520,86308962.0,6077360.0,80231602.0,0.567,0.5709,0.5668,0.571
2023-05-23 13:05,1050,265,785,147817,9042,138775,84342107.0,5122943.0,79219163.0,1046,265,781,147555,9031,138524,84190051.0,5116779.0,79073271.0,0.5666,0.5708,0.5666,0.5708
2023-05-23 13:10,1014,352,662,126308,11711,114597,72067336.0,6638781.0,65428554.0,1009,348,661,126258,11682,114576,72037804.0,6621264.0,65416539.0,0.5669,0.5709,0.5668,0.5709
2023-05-23 13:15,1075,259,816,164046,9612,154434,93560346.0,5444567.0,88115779.0,1074,260,814,164162,9742,154420,93628402.0,5518040.0,88110362.0,0.5664,0.5706,0.5664,0.5706
2023-05-23 13:20,1140,331,809,166565,12963,153602,95028418.0,7345462.0,87682956.0,1132,325,807,165436,12884,152552,94369904.0,7300420.0,87069484.0,0.5666,0.5708,0.5666,0.5708
2023-05-23 13:25,1201,350,851,166723,12623,154100,95058944.0,7152829.0,87906115.0,1196,345,851,166605,12642,153963,94987420.0,7159191.0,87828228.0,0.5667,0.5704,0.5663,0.5705
2023-05-23 13:30,1108,296,812,161298,9953,151345,91999939.0,5639668.0,86360271.0,1104,295,809,161414,10036,151378,92065092.0,5686130.0,86378962.0,0.5666,0.5706,0.5666,0.5706
2023-05-23 13:35,1286,459,827,170616,15390,155226,97301907.0,8723398.0,88578509.0,1279,453,826,170450,15224,155226,97209203.0,8629747.0,88579455.0,0.5668,0.5706,0.5669,0.5706
2023-05-23 13:40,717,257,460,91044,9178,81866,51941328.0,5176829.0,46764499.0,714,256,458,90195,8987,81208,51431377.0,5081325.0,46350051.0,0.564,0.5712,0.5654,0.5708
2023-05-23 13:45,1019,396,623,127598,13304,114294,72803665.0,7552045.0,65251620.0,1013,390,623,127802,13349,114453,72898807.0,7553841.0,65344965.0,0.5677,0.5709,0.5659,0.5709
2023-05-23 13:50,779,304,475,98824,11550,87274,56398213.0,6538099.0,49860113.0,778,305,473,98429,11388,87041,56180170.0,6455710.0,49724460.0,0.5661,0.5713,0.5669,0.5713
2023-05-23 13:55,223,110,113,22212,4624,17588,12675268.0,2623274.0,10051994.0,215,105,110,22144,4549,17595,12633651.0,2578180.0,10055471.0,0.5673,0.5715,0.5668,0.5715
2023-05-23 14:00,853,275,578,106533,10280,96253,60796254.0,5822584.0,54973669.0,840,266,574,105912,10182,95730,60447927.0,5768789.0,54679138.0,0.5664,0.5711,0.5666,0.5712
2023-05-23 14:05,624,167,457,77529,5940,71589,44259405.0,3366389.0,40893015.0,614,160,454,77468,5792,71676,44224282.0,3281433.0,40942848.0,0.5667,0.5712,0.5665,0.5712
2023-05-23 14:10,179,112,67,10498,7245,3253,5960953.0,4105917.0,1855036.0,177,113,64,10458,7174,3284,5938394.0,4065658.0,1872736.0,0.5667,0.5703,0.5667,0.5703
2023-05-23 14:15,303,285,18,12081,11412,669,6852068.0,6469507.0,382561.0,294,278,16,11938,11357,581,6769409.0,6436997.0,332412.0,0.5669,0.5718,0.5668,0.5721
2023-05-23 14:20,152,82,70,10398,2756,7642,5914866.0,1561708.0,4353158.0,147,79,68,10429,2787,7642,5932197.0,1579021.0,4353176.0,0.5667,0.5696,0.5666,0.5696
2023-05-23 14:25,114,72,42,6866,2283,4583,3904579.0,1293599.0,2610979.0,111,70,41,6881,2310,4571,3913357.0,1308930.0,2604426.0,0.5666,0.5697,0.5666,0.5698
2023-05-23 14:30,71,64,7,3014,2845,169,1712607.0,1616356.0,96250.0,66,59,7,2945,2707,238,1668428.0,1532951.0,135477.0,0.5681,0.5695,0.5663,0.5692
2023-05-23 14:35,83,77,6,4782,4458,324,2713413.0,2528961.0,184452.0,82,75,7,4736,4398,338,2685144.0,2491810.0,193334.0,0.5673,0.5693,0.5666,0.572
2023-05-23 14:40,166,86,80,12087,4423,7664,6872451.0,2508449.0,4364002.0,162,81,81,11957,4357,7600,6796665.0,2469087.0,4327578.0,0.5671,0.5694,0.5667,0.5694
2023-05-23 14:45,163,94,69,11557,5306,6251,6566486.0,3005291.0,3561194.0,157,90,67,11080,5030,6050,6294559.0,2848229.0,3446330.0,0.5664,0.5697,0.5662,0.5696
2023-05-23 14:50,145,104,41,8993,5896,3097,5101362.0,3337884.0,1763478.0,144,105,39,9110,5919,3191,5167941.0,3350657.0,1817283.0,0.5661,0.5694,0.5661,0.5695
2023-05-23 14:55,446,291,155,42375,14674,27701,24160025.0,8328183.0,15831841.0,440,286,154,42296,14036,28260,24118118.0,7964663.0,16153454.0,0.5675,0.5715,0.5674,0.5716
2023-05-23 15:00,847,643,204,71344,36803,34541,40649730.0,20890057.0,19759673.0,837,638,199,70922,36785,34137,40408856.0,20879716.0,19529140.0,0.5676,0.5721,0.5676,0.5721
2023-05-23 15:05,646,424,222,68369,25969,42400,38967294.0,14740511.0,24226783.0,644,423,221,68305,25931,42374,38931175.0,14719053.0,24212121.0,0.5676,0.5714,0.5676,0.5714
2023-05-23 15:10,1582,919,663,181638,51782,129856,103607256.0,29383948.0,74223307.0,1581,919,662,181702,51809,129893,103639931.0,29399102.0,74240829.0,0.5675,0.5716,0.5675,0.5716
2023-05-23 15:15,705,395,310,85180,31422,53758,48561898.0,17829550.0,30732348.0,702,392,310,85082,31415,53667,48507271.0,17826022.0,30681248.0,0.5674,0.5717,0.5674,0.5717
2023-05-23 15:20,900,539,361,78497,33171,45326,44766865.0,18829397.0,25937468.0,894,538,356,78514,33103,45411,44780234.0,18790948.0,25989286.0,0.5676,0.5722,0.5677,0.5723
2023-05-23 15:25,612,499,113,43313,30883,12430,24660462.0,17545259.0,7115203.0,601,496,105,43017,30837,12180,24491772.0,17518108.0,6973663.0,0.5681,0.5724,0.5681,0.5726
2023-05-23 15:30,1648,1000,648,178091,65693,112398,125102346.0,61044116.0,64058229.0,1646,998,648,178262,65652,112610,125202495.0,61020864.0,64181631.0,0.9292,0.5699,0.9295,0.5699
2023-05-23 15:35,1201,635,566,119181,29131,90050,67980893.0,16511638.0,51469254.0,1186,631,555,118558,29268,89290,67643728.0,16590070.0,51053657.0,0.5668,0.5716,0.5668,0.5718
2023-05-23 15:40,650,566,84,37407,26702,10705,21270382.0,15135522.0,6134859.0,633,561,72,37181,26754,10427,21139735.0,15163913.0,5975821.0,0.5668,0.5731,0.5668,0.5731
2023-05-23 15:45,639,312,327,66902,16153,50749,49969749.0,21027449.0,28942299.0,621,305,316,66303,15999,50304,49637177.0,20940327.0,28696849.0,1.3018,0.5703,1.3089,0.5705
2023-05-23 15:50,281,72,209,6094,5234,860,3451961.0,2963712.0,488249.0,276,69,207,5925,5073,852,3355985.0,2872269.0,483715.0,0.5662,0.5677,0.5662,0.5677
2023-05-23 15:55,307,68,239,8571,6037,2534,4860537.0,3418281.0,1442255.0,293,68,225,8203,6036,2167,4648492.0,3417887.0,1230604.0,0.5662,0.5692,0.5663,0.5679
2023-05-23 16:00,186,97,89,15521,7934,7587,8803113.0,4489335.0,4313778.0,180,94,86,15332,7823,7509,8696157.0,4426443.0,4269713.0,0.5658,0.5686,0.5658,0.5686
2023-05-23 16:05,133,82,51,9728,4427,5301,5513199.0,2504006.0,3009192.0,128,77,51,9922,4490,5432,5626699.0,2538989.0,3087709.0,0.5656,0.5677,0.5655,0.5684
2023-05-23 16:10,164,59,105,15745,3637,12108,8972325.0,2085559.0,6886765.0,156,52,104,15349,3518,11831,8719135.0,1989396.0,6729738.0,0.5734,0.5688,0.5655,0.5688
2023-05-23 16:15,376,124,252,38786,6891,31895,22069010.0,3896766.0,18172244.0,370,119,251,39114,6858,32256,22254184.0,3877599.0,18376584.0,0.5655,0.5698,0.5654,0.5697
2023-05-23 16:20,497,218,279,47969,13625,34344,27283870.0,7712023.0,19571846.0,496,217,279,47761,13474,34287,27165754.0,7626281.0,19539473.0,0.566,0.5699,0.566,0.5699
2023-05-23 16:25,210,118,92,18974,7366,11608,10790831.0,4169655.0,6621175.0,203,113,90,18975,7366,11609,10791695.0,4169399.0,6622295.0,0.5661,0.5704,0.566,0.5704
2023-05-23 16:30,180,108,72,15107,7715,7392,8582759.0,4369096.0,4213663.0,175,103,72,14783,7477,7306,8397740.0,4233991.0,4163748.0,0.5663,0.57,0.5663,0.5699
2023-05-23 16:35,215,69,146,16065,5997,10068,9114806.0,3394850.0,5719955.0,205,66,139,15542,5796,9746,8819058.0,3281641.0,5537417.0,0.5661,0.5681,0.5662,0.5682
2023-05-23 16:40,575,45,530,40234,2096,38138,22840352.0,1184863.0,21655488.0,571,43,528,40317,2132,38185,22886642.0,1204278.0,21682364.0,0.5653,0.5678,0.5649,0.5678
2023-05-23 16:45,209,74,135,15406,5979,9427,8740288.0,3383957.0,5356331.0,206,71,135,15345,6003,9342,8704951.0,3397151.0,5307799.0,0.566,0.5682,0.5659,0.5682
2023-05-23 16:50,713,119,594,58480,6647,51833,33261950.0,3766479.0,29495471.0,711,117,594,58550,6643,51907,33295642.0,3757268.0,29538373.0,0.5666,0.569,0.5656,0.5691
2023-05-23 16:55,210,76,134,21482,3991,17491,12230591.0,2256890.0,9973700.0,201,71,130,21247,3894,17353,12097659.0,2202268.0,9895390.0,0.5655,0.5702,0.5656,0.5702
2023-05-23 17:00,163,78,85,11598,5153,6445,6584443.0,2917364.0,3667079.0,162,80,82,11556,5221,6335,6558987.0,2955766.0,3603221.0,0.5661,0.569,0.5661,0.5688
2023-05-23 17:05,208,66,142,20026,3939,16087,11402013.0,2230981.0,9171032.0,229,63,166,20209,3565,16644,11510068.0,2016895.0,9493173.0,0.5664,0.5701,0.5657,0.5704
2023-05-23 17:10,414,76,338,35084,3429,31655,19976805.0,1941125.0,18035680.0,405,70,335,35248,3339,31909,20073144.0,1889437.0,18183706.0,0.5661,0.5698,0.5659,0.5699
2023-05-23 17:15,243,135,108,11560,4418,7142,18464994.0,14385641.0,4079353.0,232,126,106,11136,4371,6765,18211859.0,14350704.0,3861154.0,3.2561,0.5712,3.2832,0.5708
2023-05-23 17:20,204,126,78,8926,5117,3809,5070668.0,2903557.0,2167110.0,195,122,73,8591,4921,3670,4881404.0,2791267.0,2090136.0,0.5674,0.5689,0.5672,0.5695
2023-05-23 17:25,93,50,43,2836,1620,1216,1613436.0,919053.0,694383.0,89,50,39,3914,1586,2328,2341825.0,899756.0,1442069.0,0.5673,0.571,0.5673,0.6194
2023-05-23 17:30,281,42,239,17711,1368,16343,10088066.0,775844.0,9312222.0,276,37,239,17566,1219,16347,10005638.0,691236.0,9314401.0,0.5671,0.5698,0.5671,0.5698
2023-05-23 17:35,487,49,438,32580,2366,30214,18550550.0,1342659.0,17207891.0,482,47,435,32532,2289,30243,18522926.0,1298555.0,17224371.0,0.5675,0.5695,0.5673,0.5695
2023-05-23 17:40,59,28,31,2085,708,1377,1187809.0,402385.0,785423.0,64,29,35,2823,1134,1689,1606667.0,643435.0,963231.0,0.5683,0.5704,0.5674,0.5703
2023-05-23 17:45,378,118,260,23190,6211,16979,13183774.0,3526610.0,9657163.0,356,105,251,22162,5528,16634,12603411.0,3137384.0,9466027.0,0.5678,0.5688,0.5675,0.5691
2023-05-23 17:50,268,121,147,14891,5311,9580,8453954.0,3013768.0,5440185.0,260,118,142,14415,5212,9203,8201445.0,2956192.0,5245252.0,0.5675,0.5679,0.5672,0.57
2023-05-23 17:55,410,122,288,29092,8608,20484,16554101.0,4886341.0,11667760.0,403,116,287,29097,8661,20436,16555176.0,4914983.0,11640192.0,0.5677,0.5696,0.5675,0.5696
2023-05-23 18:00,148,49,99,9625,2633,6992,5481457.0,1495127.0,3986330.0,148,47,101,10295,3057,7238,5846200.0,1719516.0,4126683.0,0.5678,0.5701,0.5625,0.5701
2023-05-23 18:05,967,177,790,92885,11025,81860,52964415.0,6262691.0,46701723.0,956,173,783,92492,10881,81611,52732367.0,6172555.0,46559811.0,0.568,0.5705,0.5673,0.5705
2023-05-23 18:10,584,173,411,62021,8811,53210,35407276.0,4997114.0,30410162.0,566,170,396,61809,8902,52907,35287020.0,5047933.0,30239087.0,0.5671,0.5715,0.5671,0.5716
2023-05-23 18:15,1052,314,738,98481,23735,74746,56122381.0,13466462.0,42655918.0,1041,306,735,98209,23538,74671,55967938.0,13353924.0,42614014.0,0.5674,0.5707,0.5673,0.5707
2023-05-23 18:20,2235,677,1558,270396,46561,223835,154257639.0,26410253.0,127847385.0,2228,675,1553,270270,46527,223743,154185928.0,26390931.0,127794997.0,0.5672,0.5712,0.5672,0.5712
2023-05-23 18:25,110,64,46,6466,4612,1854,3671248.0,2615573.0,1055675.0,105,60,45,6301,4463,1838,3578151.0,2531252.0,1046898.0,0.5671,0.5694,0.5672,0.5696
2023-05-23 18:30,234,109,125,16410,9195,7215,9326153.0,5216086.0,4110066.0,229,104,125,16176,9161,7015,9195452.0,5196653.0,3998799.0,0.5673,0.5697,0.5673,0.57
2023-05-23 18:35,615,353,262,37468,20945,16523,33217108.0,23775117.0,9441990.0,613,350,263,38154,21288,16866,33604060.0,23964679.0,9639381.0,1.1351,0.5714,1.1257,0.5715
2023-05-24 10:00,3220,2785,435,282786,265228,17558,179163621.0,168809348.0,10354272.0,2947,2667,280,259211,249505,9706,161508269.0,155933276.0,5574993.0,0.6365,0.5897,0.625,0.5744
2023-05-24 10:05,1000,876,124,48845,45051,3794,39706197.0,37519298.0,2186898.0,942,857,85,47329,44417,2912,31665630.0,29988985.0,1676645.0,0.8328,0.5764,0.6752,0.5758
2023-05-24 10:10,1844,1181,663,124549,94098,30451,70820289.0,53426418.0,17393871.0,1801,1157,644,123967,93934,30033,70510283.0,53344645.0,17165637.0,0.5678,0.5712,0.5679,0.5716
2023-05-24 10:15,2584,1393,1191,196005,123294,72711,111629402.0,70058596.0,41570805.0,2482,1347,1135,195367,122831,72536,111264581.0,69796677.0,41467903.0,0.5682,0.5717,0.5682,0.5717
2023-05-24 10:20,2334,1759,575,166126,128548,37578,153961371.0,132466586.0,21494785.0,2281,1734,547,164992,127189,37803,153316922.0,131646318.0,21670604.0,1.0305,0.572,1.035,0.5733
2023-05-24 10:25,312,247,65,24402,17091,7311,13937655.0,9724253.0,4213401.0,286,235,51,23413,16458,6955,13372156.0,9364321.0,4007835.0,0.569,0.5763,0.569,0.5763
2023-05-24 10:30,585,364,221,52397,19207,33190,41895496.0,22828190.0,19067305.0,555,353,202,51592,18738,32854,41440554.0,22556055.0,18884498.0,1.1885,0.5745,1.2038,0.5748
2023-05-24 10:35,406,182,224,39775,10296,29479,22780178.0,5820736.0,16959442.0,371,164,207,38551,9333,29218,22133268.0,5322447.0,16810820.0,0.5653,0.5753,0.5703,0.5754
2023-05-24 10:40,418,214,204,35014,11750,23264,20094378.0,6706361.0,13388017.0,369,187,182,33414,11260,22154,19167137.0,6417786.0,12749351.0,0.5708,0.5755,0.57,0.5755
2023-05-24 10:45,261,172,89,9693,6600,3093,5523921.0,3764437.0,1759483.0,246,168,78,9499,6656,2843,5427324.0,3794697.0,1632627.0,0.5704,0.5689,0.5701,0.5743
2023-05-24 10:50,197,88,109,10804,4881,5923,18020581.0,14603157.0,3417424.0,172,77,95,9279,3623,5656,17201455.0,13942283.0,3259171.0,2.9918,0.577,3.8483,0.5762
2023-05-24 10:55,2686,2610,76,151876,148775,3101,98993651.0,97200772.0,1792879.0,2633,2593,40,151407,148145,3262,98721635.0,96833650.0,1887984.0,0.6533,0.5782,0.6536,0.5788
2023-05-24 11:00,1738,1350,388,165273,68047,97226,106880696.0,50915642.0,55965053.0,1701,1333,368,165218,68295,96923,106848911.0,51054625.0,55794285.0,0.7482,0.5756,0.7476,0.5757
2023-05-24 11:05,263,163,100,10287,7013,3274,5912501.0,4014397.0,1898103.0,237,148,89,8855,6244,2611,5087350.0,3579580.0,1507769.0,0.5724,0.5798,0.5733,0.5775
2023-05-24 11:10,1518,397,1121,126518,27400,99118,107870563.0,51241606.0,56628956.0,1484,382,1102,123606,27077,96529,106388706.0,51056769.0,55331936.0,1.8701,0.5713,1.8856,0.5732
2023-05-24 11:15,1001,268,733,82189,17414,64775,47480301.0,9905372.0,37574929.0,977,255,722,81183,17175,64008,46389144.0,9768358.0,36620786.0,0.5688,0.5801,0.5688,0.5721
2023-05-24 11:20,1261,537,724,88540,29657,58883,51047460.0,16863493.0,34183966.0,1246,527,719,88421,29402,59019,50991011.0,16721105.0,34269906.0,0.5686,0.5805,0.5687,0.5807
2023-05-24 11:25,1706,222,1484,146520,10573,135947,83934514.0,6045319.0,77889195.0,1692,211,1481,145594,10286,135308,83358454.0,5848788.0,77509666.0,0.5718,0.5729,0.5686,0.5728
2023-05-24 11:30,2158,374,1784,180557,23718,156839,103532708.0,13523952.0,90008755.0,2150,369,1781,180351,23333,157018,103730415.0,13275552.0,90454863.0,0.5702,0.5739,0.569,0.5761
2023-05-24 11:35,882,163,719,70483,6418,64065,40526349.0,3651930.0,36874419.0,865,150,715,70197,6179,64018,40362830.0,3513206.0,36849624.0,0.569,0.5756,0.5686,0.5756
2023-05-24 11:40,765,75,690,52715,1986,50729,30199600.0,1129899.0,29069701.0,757,69,688,52353,1931,50422,29990342.0,1098097.0,28892245.0,0.5689,0.573,0.5687,0.573
2023-05-24 11:45,1202,202,1000,154405,12491,141914,147742527.0,66528212.0,81214315.0,1166,179,987,151626,11171,140455,146188184.0,65733064.0,80455120.0,5.3261,0.5723,5.8843,0.5728
2023-05-24 11:50,432,104,328,33464,4005,29459,19111567.0,2274452.0,16837115.0,412,87,325,32958,3880,29078,18822937.0,2204470.0,16618466.0,0.5679,0.5715,0.5682,0.5715
2023-05-24 11:55,858,460,398,46356,22998,23358,38273797.0,24946555.0,13327242.0,838,450,388,46016,22850,23166,38088298.0,24860787.0,13227511.0,1.0847,0.5706,1.088,0.571
2023-05-24 12:00,233,143,90,10215,6079,4136,5814416.0,3452029.0,2362386.0,226,138,88,10056,5948,4108,5724125.0,3377335.0,2346789.0,0.5679,0.5712,0.5678,0.5713
2023-05-24 12:05,206,90,116,10246,3232,7014,5844889.0,1836114.0,4008774.0,197,83,114,10072,3120,6952,5745224.0,1772232.0,3972992.0,0.5681,0.5715,0.568,0.5715
2023-05-24 12:10,322,67,255,19352,4159,15193,11028522.0,2355180.0,8673341.0,314,62,252,19295,4023,15272,11001823.0,2283194.0,8718629.0,0.5663,0.5709,0.5675,0.5709
2023-05-24 12:15,154,67,87,15233,3841,11392,8692924.0,2183794.0,6509130.0,150,66,84,15149,3785,11364,8643926.0,2151600.0,6492325.0,0.5685,0.5714,0.5685,0.5713
2023-05-24 12:20,364,120,244,21022,6564,14458,11994532.0,3734050.0,8260482.0,355,114,241,20735,6381,14354,11831224.0,3632850.0,8198374.0,0.5689,0.5713,0.5693,0.5712
2023-05-24 12:25,483,171,312,26964,7821,19143,15381855.0,4441111.0,10940744.0,479,170,309,27062,7844,19218,15437701.0,4454237.0,10983464.0,0.5678,0.5715,0.5679,0.5715
2023-05-24 12:30,1001,536,465,63292,32793,30499,36149697.0,18698275.0,17451421.0,995,534,461,62869,32486,30383,35860497.0,18475213.0,17385284.0,0.5702,0.5722,0.5687,0.5722
2023-05-24 12:35,1030,578,452,60402,37877,22525,34415361.0,21524382.0,12890978.0,1022,576,446,59821,37245,22576,34094037.0,21171535.0,12922501.0,0.5683,0.5723,0.5684,0.5724
2023-05-24 12:40,1838,649,1189,207707,49276,158431,130286244.0,39882764.0,90403479.0,1819,644,1175,205969,49630,156339,129336678.0,40082896.0,89253781.0,0.8094,0.5706,0.8076,0.5709
2023-05-24 12:45,1778,312,1466,193440,15387,178053,110374547.0,8745358.0,101629189.0,1764,301,1463,193336,15050,178286,110314548.0,8551629.0,101762919.0,0.5684,0.5708,0.5682,0.5708
2023-05-24 12:50,1708,380,1328,195202,22351,172851,111329941.0,12697750.0,98632191.0,1696,372,1324,195370,22593,172777,111424911.0,12834688.0,98590223.0,0.5681,0.5706,0.5681,0.5706
2023-05-24 12:55,1617,296,1321,176168,6507,169661,100504655.0,3701974.0,96802681.0,1608,290,1318,175677,6202,169475,100220666.0,3522831.0,96697835.0,0.5689,0.5706,0.568,0.5706
2023-05-24 13:00,797,143,654,74085,9046,65039,54180168.0,17025681.0,37154486.0,779,133,646,72663,8795,63868,53325108.0,16870256.0,36454851.0,1.8821,0.5713,1.9182,0.5708
2023-05-24 13:05,722,159,563,79409,7907,71502,45309177.0,4488152.0,40821024.0,717,152,565,80009,7746,72263,45652558.0,4396923.0,41255635.0,0.5676,0.5709,0.5676,0.5709
2023-05-24 13:10,968,118,850,83272,5218,78054,47538337.0,2960810.0,44577527.0,952,109,843,82390,5127,77263,47031729.0,2908799.0,44122929.0,0.5674,0.5711,0.5673,0.5711
2023-05-24 13:15,330,167,163,23238,9573,13665,13261501.0,5432202.0,7829299.0,318,161,157,22903,9092,13811,13075624.0,5161199.0,7914425.0,0.5675,0.5729,0.5677,0.5731
2023-05-24 13:20,365,107,258,34987,6568,28419,19953772.0,3729994.0,16223777.0,361,106,255,34963,6680,28283,19941461.0,3793724.0,16147737.0,0.5679,0.5709,0.5679,0.5709
2023-05-24 13:25,229,87,142,16405,7772,8633,9205985.0,4279566.0,4926419.0,224,83,141,14455,5779,8676,8233392.0,3282338.0,4951053.0,0.5506,0.5706,0.568,0.5707
2023-05-24 13:30,462,112,350,44719,5596,39123,25517496.0,3176201.0,22341295.0,455,106,349,44508,5576,38932,25398398.0,3164889.0,22233508.0,0.5676,0.5711,0.5676,0.5711
2023-05-24 13:35,427,98,329,39924,6011,33913,22777970.0,3412910.0,19365059.0,425,93,332,40596,6356,34240,23157964.0,3602866.0,19555097.0,0.5678,0.571,0.5668,0.5711
2023-05-24 13:40,311,126,185,20301,5442,14859,11614342.0,3123220.0,8491122.0,299,115,184,19924,5015,14909,11373720.0,2850859.0,8522860.0,0.5739,0.5714,0.5685,0.5717
2023-05-24 13:45,222,93,129,14949,3657,11292,8534403.0,2078097.0,6456306.0,216,91,125,14921,3633,11288,8516590.0,2062469.0,6454121.0,0.5683,0.5718,0.5677,0.5718
2023-05-24 13:50,478,98,380,26640,4984,21656,15225071.0,2830993.0,12394077.0,458,90,368,26304,4612,21692,15046623.0,2621191.0,12425431.0,0.568,0.5723,0.5683,0.5728
2023-05-24 13:55,887,112,775,36765,4676,32089,21029866.0,2664506.0,18365359.0,874,110,764,36545,4706,31839,20897151.0,2674267.0,18222883.0,0.5698,0.5723,0.5683,0.5723
2023-05-24 14:00,108,38,70,5072,1880,3192,2890861.0,1066408.0,1824452.0,99,34,65,4642,1620,3022,2647458.0,920580.0,1726878.0,0.5672,0.5716,0.5683,0.5714
2023-05-24 14:05,194,112,82,13519,8059,5460,7705976.0,4581007.0,3124969.0,191,109,82,13757,8253,5504,7839365.0,4689117.0,3150247.0,0.5684,0.5723,0.5682,0.5724
2023-05-24 14:10,1109,876,233,100131,86294,13837,81154889.0,73209369.0,7945520.0,1093,864,229,96428,82993,13435,78812674.0,71100503.0,7712170.0,0.8484,0.5742,0.8567,0.574
2023-05-24 14:15,3294,2496,798,340305,213168,127137,218430235.0,145459117.0,72971117.0,3275,2483,792,340021,212907,127114,218264056.0,145307454.0,72956601.0,0.6824,0.574,0.6825,0.5739
2023-05-24 14:20,1841,1376,465,186075,105712,80363,106490338.0,60378156.0,46112181.0,1835,1372,463,186245,105683,80562,106590883.0,60361472.0,46229411.0,0.5712,0.5738,0.5712,0.5738
2023-05-24 14:25,3701,2785,916,353509,260202,93307,202106051.0,148524255.0,53581796.0,3685,2779,906,353036,260008,93028,201834867.0,148411463.0,53423404.0,0.5708,0.5743,0.5708,0.5743
2023-05-24 14:30,2808,2040,768,234444,172327,62117,134034483.0,98371387.0,35663096.0,2805,2041,764,234663,172475,62188,134159181.0,98455170.0,35704011.0,0.5708,0.5741,0.5708,0.5741
2023-05-24 14:35,2837,2005,832,236860,162941,73919,147299317.0,104873654.0,42425663.0,2831,2003,828,236503,162882,73621,147099877.0,104842717.0,42257159.0,0.6436,0.5739,0.6437,0.574
2023-05-24 14:40,2300,1464,836,253984,117250,136734,145290884.0,66818022.0,78472861.0,2293,1462,831,253707,117244,136463,145126830.0,66813875.0,78312955.0,0.5699,0.5739,0.5699,0.5739
2023-05-24 14:45,3113,2058,1055,297457,175590,121867,217568578.0,147686504.0,69882074.0,3104,2049,1055,297334,175424,121910,217496718.0,147590450.0,69906267.0,0.8411,0.5734,0.8413,0.5734
2023-05-24 14:50,2704,1882,822,280545,208112,72433,195938846.0,154392515.0,41546330.0,2695,1880,815,279977,208035,71942,195615694.0,154349060.0,41266633.0,0.7419,0.5736,0.7419,0.5736
2023-05-24 14:55,2174,1639,535,179654,144890,34764,150112135.0,130180558.0,19931576.0,2165,1635,530,179514,144932,34582,150031056.0,130204288.0,19826768.0,0.8985,0.5733,0.8984,0.5733
2023-05-24 15:00,2916,1830,1086,371079,206171,164908,235948726.0,141472471.0,94476255.0,2907,1826,1081,370727,205943,164784,235741279.0,141341083.0,94400196.0,0.6862,0.5729,0.6863,0.5729
2023-05-24 15:05,993,669,324,87225,67270,19955,49865031.0,38419888.0,11445142.0,977,658,319,86902,67303,19599,49678346.0,38437187.0,11241159.0,0.5711,0.5735,0.5711,0.5736
2023-05-24 15:10,477,264,213,41628,24718,16910,59422053.0,49737701.0,9684351.0,465,258,207,40118,24274,15844,58560434.0,49484351.0,9076083.0,2.0122,0.5727,2.0386,0.5728
2023-05-24 15:15,798,154,644,72118,10792,61326,64998813.0,29898381.0,35100431.0,787,149,638,71259,10545,60714,64492991.0,29760967.0,34732024.0,2.7704,0.5724,2.8223,0.5721
2023-05-24 15:20,139,49,90,13461,4035,9426,7687826.0,2296214.0,5391612.0,136,48,88,13145,4034,9111,7506346.0,2295638.0,5210708.0,0.5691,0.572,0.5691,0.5719
2023-05-24 15:25,185,70,115,16129,5748,10381,9209827.0,3273649.0,5936178.0,180,68,112,16460,5743,10717,9399246.0,3270541.0,6128705.0,0.5695,0.5718,0.5695,0.5719
2023-05-24 15:30,267,149,118,22880,11915,10965,24954103.0,18671902.0,6282200.0,258,144,114,22335,11785,10550,24639245.0,18597537.0,6041707.0,1.5671,0.5729,1.5781,0.5727
2023-05-24 15:35,32,16,16,1901,1418,483,1084373.0,807124.0,277249.0,26,13,13,1695,1266,429,969115.0,721750.0,247365.0,0.5692,0.574,0.5701,0.5766
2023-05-24 15:40,550,146,404,65843,18228,47615,37746365.0,10398025.0,27348340.0,548,144,404,66243,18149,48094,37975987.0,10352958.0,27623029.0,0.5704,0.5744,0.5704,0.5744
2023-05-24 15:45,741,216,525,103068,21982,81086,59048396.0,12541780.0,46506616.0,734,210,524,103538,22018,81520,59319447.0,12561168.0,46758279.0,0.5705,0.5735,0.5705,0.5736
2023-05-24 15:50,486,172,314,31380,9095,22285,17968020.0,5191234.0,12776786.0,483,175,308,30954,9245,21709,17719463.0,5274523.0,12444940.0,0.5708,0.5733,0.5705,0.5733
2023-05-24 15:55,191,89,102,14387,6643,7744,8227339.0,3789760.0,4437579.0,183,88,95,14562,6824,7738,8325557.0,3890390.0,4435167.0,0.5705,0.573,0.5701,0.5732
2023-05-24 16:00,579,235,344,57768,22085,35683,33042608.0,12600185.0,20442423.0,571,229,342,58156,22095,36061,33289315.0,12605723.0,20683591.0,0.5705,0.5729,0.5705,0.5736
2023-05-24 16:05,1412,283,1129,155921,26389,129532,89259000.0,15048021.0,74210979.0,1408,279,1129,155676,26317,129359,89117885.0,15005955.0,74111930.0,0.5702,0.5729,0.5702,0.5729
2023-05-24 16:10,670,195,475,66262,15497,50765,37999731.0,8840733.0,29158998.0,660,190,470,66367,15395,50972,38059534.0,8782390.0,29277143.0,0.5705,0.5744,0.5705,0.5744
2023-05-24 16:15,176,81,95,22430,7268,15162,12874822.0,4147659.0,8727163.0,172,80,92,22036,7340,14696,12645295.0,4188002.0,8457292.0,0.5707,0.5756,0.5706,0.5755
2023-05-24 16:20,329,107,222,44862,10957,33905,25748253.0,6252465.0,19495788.0,328,107,221,45403,11048,34355,26063071.0,6304459.0,19758612.0,0.5706,0.575,0.5706,0.5751
2023-05-24 16:25,1742,697,1045,205868,67298,138570,117807748.0,38408845.0,79398902.0,1713,687,1026,205117,67000,138117,117387638.0,38232660.0,79154978.0,0.5707,0.573,0.5706,0.5731
2023-05-24 16:30,2416,903,1513,268433,91237,177196,153588579.0,52049353.0,101539226.0,2405,899,1506,268177,91308,176869,153446114.0,52088948.0,101357166.0,0.5705,0.573,0.5705,0.5731
2023-05-24 16:35,2175,704,1471,272588,66979,205609,156054024.0,38208276.0,117845748.0,2169,700,1469,272636,66890,205746,156081777.0,38157570.0,117924206.0,0.5705,0.5732,0.5705,0.5732
2023-05-24 16:40,2048,623,1425,231598,64038,167560,132560687.0,36525983.0,96034703.0,2038,620,1418,231174,64106,167068,132321804.0,36564437.0,95757367.0,0.5704,0.5731,0.5704,0.5732
2023-05-24 16:45,2599,913,1686,323790,88753,235037,185282903.0,50595871.0,134687032.0,2591,906,1685,324065,88478,235587,185443514.0,50439167.0,135004347.0,0.5701,0.573,0.5701,0.5731
2023-05-24 16:50,2032,647,1385,274295,60008,214287,157011958.0,34211847.0,122800110.0,2027,644,1383,274501,59941,214560,157131307.0,34174550.0,122956757.0,0.5701,0.5731,0.5701,0.5731
2023-05-24 16:55,1094,482,612,97886,38857,59029,55979898.0,22160483.0,33819415.0,1086,479,607,97465,38768,58697,55733380.0,22104688.0,33628692.0,0.5703,0.5729,0.5702,0.5729
2023-05-24 17:00,739,406,333,57595,24836,32759,32925475.0,14160302.0,18765172.0,731,399,332,57600,24837,32763,32926641.0,14158746.0,18767894.0,0.5702,0.5728,0.5701,0.5728
2023-05-24 17:05,1052,400,652,80511,27296,53215,57868614.0,27429054.0,30439559.0,1047,397,650,80149,27445,52704,57666555.0,27510883.0,30155671.0,1.0049,0.572,1.0024,0.5722
2023-05-24 17:10,648,167,481,56562,12632,43930,32297653.0,7191284.0,25106368.0,634,157,477,56163,12337,43826,32092637.0,7021101.0,25071535.0,0.5693,0.5715,0.5691,0.5721
2023-05-24 17:15,596,255,341,51921,18852,33069,29656293.0,10733949.0,18922343.0,583,248,335,51264,18723,32541,29289876.0,10658190.0,18631685.0,0.5694,0.5722,0.5693,0.5726
2023-05-24 17:20,140,56,84,14126,4094,10032,8081495.0,2330416.0,5751078.0,136,55,81,14545,4156,10389,8321696.0,2365418.0,5956277.0,0.5692,0.5733,0.5692,0.5733
2023-05-24 17:25,583,267,316,41563,17848,23715,23728526.0,10166552.0,13561973.0,581,266,315,40943,17715,23228,23373612.0,10090717.0,13282894.0,0.5696,0.5719,0.5696,0.5718
2023-05-24 17:30,323,135,188,30110,8353,21757,17207196.0,4753980.0,12453215.0,318,129,189,30247,8409,21838,17287348.0,4784890.0,12502458.0,0.5691,0.5724,0.569,0.5725
2023-05-24 17:35,159,82,77,12752,8172,4580,7274181.0,4654756.0,2619424.0,152,80,72,12372,8153,4219,7056851.0,4643621.0,2413230.0,0.5696,0.5719,0.5696,0.572
2023-05-24 17:40,360,79,281,27598,7035,20563,15763152.0,4003582.0,11759570.0,355,75,280,27716,7010,20706,15831361.0,3988842.0,11842519.0,0.5691,0.5719,0.569,0.5719
2023-05-24 17:45,822,309,513,91594,25753,65841,52344763.0,14663885.0,37680877.0,808,301,507,90705,25606,65099,51837583.0,14580021.0,37257562.0,0.5694,0.5723,0.5694,0.5723
2023-05-24 17:50,770,267,503,54627,11971,42656,31198680.0,6811670.0,24387010.0,761,261,500,54444,12090,42354,31092887.0,6878318.0,24214569.0,0.569,0.5717,0.5689,0.5717
2023-05-24 17:55,369,126,243,35812,8739,27073,20462792.0,4974929.0,15487862.0,361,121,240,35317,8086,27231,20181217.0,4603166.0,15578050.0,0.5693,0.5721,0.5693,0.5721
2023-05-24 18:00,582,219,363,44897,13705,31192,25638837.0,7804641.0,17834195.0,576,219,357,45328,14357,30971,25869911.0,8160055.0,17709855.0,0.5695,0.5718,0.5684,0.5718
2023-05-24 18:05,281,31,250,24511,1239,23272,14020648.0,714069.0,13306579.0,271,23,248,24004,1051,22953,13720282.0,598456.0,13121826.0,0.5763,0.5718,0.5694,0.5717
2023-05-24 18:10,280,24,256,25408,1157,24251,14538464.0,675802.0,13862661.0,274,19,255,25136,885,24251,14366548.0,504055.0,13862493.0,0.5841,0.5716,0.5696,0.5716
2023-05-24 18:15,323,115,208,32501,9233,23268,18591694.0,5278527.0,13313167.0,317,112,205,32790,9094,23696,18742314.0,5179841.0,13562473.0,0.5717,0.5722,0.5696,0.5724
2023-05-24 18:20,700,142,558,67032,11739,55293,38323680.0,6687726.0,31635953.0,702,144,558,67570,12156,55414,38630196.0,6921830.0,31708365.0,0.5697,0.5722,0.5694,0.5722
2023-05-24 18:25,180,73,107,14290,4125,10165,8166102.0,2347242.0,5818859.0,176,72,104,14114,4175,9939,8065500.0,2375453.0,5690046.0,0.569,0.5724,0.569,0.5725
2023-05-24 18:30,540,296,244,52704,28248,24456,30093257.0,16093901.0,13999356.0,522,288,234,51968,27620,24348,29672060.0,15734362.0,13937698.0,0.5697,0.5724,0.5697,0.5724
2023-05-24 18:35,868,464,404,79620,43338,36282,45454047.0,24692774.0,20761273.0,871,466,405,80113,43828,36285,45730363.0,24967059.0,20763303.0,0.5698,0.5722,0.5697,0.5722
2023-05-25 10:00,2198,803,1395,227526,62106,165420,131705955.0,36864564.0,94841391.0,1954,684,1270,210224,49130,161094,120268873.0,27971534.0,92297338.0,0.5936,0.5733,0.5693,0.5729
2023-05-25 10:05,1336,230,1106,149328,24153,125175,85452912.0,13709089.0,71743822.0,1275,198,1077,144685,22063,122622,82702590.0,12554367.0,70148222.0,0.5676,0.5731,0.569,0.5721
2023-05-25 10:10,1437,268,1169,129203,22896,106307,73714283.0,12997518.0,60716764.0,1410,254,1156,127545,21471,106074,72772304.0,12205508.0,60566796.0,0.5677,0.5711,0.5685,0.571
2023-05-25 10:15,1560,297,1263,105002,17096,87906,59880449.0,9724576.0,50155873.0,1445,239,1206,104111,16823,87288,59385634.0,9559721.0,49825912.0,0.5688,0.5706,0.5683,0.5708
2023-05-25 10:20,1387,293,1094,89389,13564,75825,51001655.0,7714032.0,43287623.0,1359,272,1087,89253,13439,75814,50916208.0,7636592.0,43279616.0,0.5687,0.5709,0.5682,0.5709
2023-05-25 10:25,655,281,374,37552,12096,25456,21426793.0,6872756.0,14554036.0,638,267,371,36939,11609,25330,21075857.0,6598549.0,14477307.0,0.5682,0.5717,0.5684,0.5715
2023-05-25 10:30,665,280,385,40372,11076,29296,23047003.0,6285179.0,16761823.0,638,265,373,39845,10770,29075,22755710.0,6120690.0,16635020.0,0.5675,0.5722,0.5683,0.5721
2023-05-25 10:35,780,273,507,59149,10256,48893,33809343.0,5830324.0,27979019.0,767,266,501,58750,9994,48756,33585986.0,5685123.0,27900863.0,0.5685,0.5722,0.5689,0.5723
2023-05-25 10:40,769,444,325,50526,25791,24735,34483138.0,14703499.0,19779639.0,753,435,318,48512,25406,23106,27693184.0,14459040.0,13234144.0,0.5701,0.7997,0.5691,0.5728
2023-05-25 10:45,360,92,268,24460,5234,19226,13896135.0,2977653.0,10918482.0,337,77,260,23075,4617,18458,13159198.0,2621803.0,10537395.0,0.5689,0.5679,0.5679,0.5709
2023-05-25 10:50,200,76,124,12641,3588,9053,7191036.0,2034523.0,5156513.0,181,65,116,12510,3559,8951,7128268.0,2019632.0,5108635.0,0.567,0.5696,0.5675,0.5707
2023-05-25 10:55,173,63,110,14152,3157,10995,8087178.0,1789527.0,6297651.0,159,54,105,12880,3179,9701,7360696.0,1803463.0,5557233.0,0.5668,0.5728,0.5673,0.5729
2023-05-25 11:00,270,130,140,17412,7432,9980,9948879.0,4255686.0,5693192.0,252,114,138,17162,6926,10236,9769789.0,3928024.0,5841764.0,0.5726,0.5705,0.5671,0.5707
2023-05-25 11:05,358,182,176,21283,8029,13254,24014706.0,16439274.0,7575431.0,342,173,169,20973,7913,13060,14267355.0,6799059.0,7468296.0,2.0475,0.5716,0.8592,0.5718
2023-05-25 11:10,458,195,263,42680,9042,33638,24422842.0,5135557.0,19287285.0,443,181,262,42732,8806,33926,24452287.0,5000445.0,19451842.0,0.568,0.5734,0.5678,0.5734
2023-05-25 11:15,128,83,45,5437,3830,1607,3106374.0,2182209.0,924164.0,116,73,43,4734,3677,1057,2692384.0,2087519.0,604865.0,0.5698,0.5751,0.5677,0.5722
2023-05-25 11:20,498,51,447,36470,2293,34177,20784005.0,1300638.0,19483367.0,485,41,444,36348,1860,34488,20728438.0,1056474.0,19671963.0,0.5672,0.5701,0.568,0.5704
2023-05-25 11:25,436,196,240,30064,9710,20354,22636529.0,5540447.0,17096081.0,427,191,236,29540,9757,19783,22448804.0,5543694.0,16905109.0,0.5706,0.8399,0.5682,0.8545
2023-05-25 11:30,625,203,422,52467,12844,39623,29871686.0,7292275.0,22579410.0,618,201,417,52450,12793,39657,29864542.0,7263172.0,22601369.0,0.5678,0.5699,0.5677,0.5699
2023-05-25 11:35,158,81,77,11937,5183,6754,6791353.0,2943431.0,3847922.0,144,72,72,11456,4813,6643,6523461.0,2731469.0,3791992.0,0.5679,0.5697,0.5675,0.5708
2023-05-25 11:40,446,243,203,36554,18411,18143,20794718.0,10457396.0,10337321.0,438,240,198,36193,18331,17862,20585313.0,10408898.0,10176415.0,0.568,0.5698,0.5678,0.5697
2023-05-25 11:45,283,180,103,16438,8813,7625,9338930.0,5003671.0,4335258.0,264,167,97,16169,8790,7379,9201332.0,4989179.0,4212153.0,0.5678,0.5686,0.5676,0.5708
2023-05-25 11:50,531,326,205,33262,19446,13816,18888352.0,11009679.0,7878672.0,521,320,201,32723,19044,13679,18600867.0,10808072.0,7792794.0,0.5662,0.5703,0.5675,0.5697
2023-05-25 11:55,793,247,546,79160,11325,67835,45051872.0,6426584.0,38625288.0,741,231,510,78961,11181,67780,44937793.0,6341918.0,38595874.0,0.5675,0.5694,0.5672,0.5694
2023-05-25 12:00,1602,535,1067,133670,28375,105295,76082676.0,16090039.0,59992637.0,1570,514,1056,133483,28367,105116,75990694.0,16085408.0,59905285.0,0.567,0.5698,0.567,0.5699
2023-05-25 12:05,828,419,409,52678,18787,33891,30006058.0,10659634.0,19346423.0,804,404,400,52752,18670,34082,30053418.0,10592878.0,19460540.0,0.5674,0.5708,0.5674,0.571
2023-05-25 12:10,714,312,402,47898,17289,30609,27227119.0,9803866.0,17423253.0,697,301,396,47823,17197,30626,27181352.0,9748315.0,17433036.0,0.5671,0.5692,0.5669,0.5692
2023-05-25 12:15,1587,362,1225,154183,15966,138217,99515228.0,20916663.0,78598564.0,1556,343,1213,152979,15585,137394,98867040.0,20700524.0,78166515.0,1.3101,0.5687,1.3282,0.5689
2023-05-25 12:20,426,229,197,21405,10922,10483,12160672.0,6189784.0,5970888.0,422,224,198,21358,10872,10486,12133492.0,6160940.0,5972551.0,0.5667,0.5696,0.5667,0.5696
2023-05-25 12:25,439,285,154,23954,16602,7352,13604944.0,9414965.0,4189978.0,429,281,148,23903,16819,7084,13574892.0,9536350.0,4038542.0,0.5671,0.5699,0.567,0.5701
2023-05-25 12:30,1826,812,1014,109277,44134,65143,62226851.0,24992811.0,37234039.0,1785,778,1007,108222,43686,64536,61627260.0,24742088.0,36885172.0,0.5663,0.5716,0.5664,0.5715
2023-05-25 12:35,807,393,414,47780,21608,26172,27194024.0,12229691.0,14964333.0,798,386,412,48328,21656,26672,27507870.0,12255572.0,15252298.0,0.566,0.5718,0.5659,0.5718
2023-05-25 12:40,2033,753,1280,213487,47315,166172,121297463.0,26765997.0,94531465.0,2013,744,1269,212793,47229,165564,120904339.0,26717905.0,94186433.0,0.5657,0.5689,0.5657,0.5689
2023-05-25 12:45,1695,640,1055,131905,24784,107121,74945052.0,14026790.0,60918261.0,1683,629,1054,132201,24599,107602,75111646.0,13920812.0,61190834.0,0.566,0.5687,0.5659,0.5687
2023-05-25 12:50,1422,616,806,113596,21849,91747,64590484.0,12356033.0,52234450.0,1403,600,803,111890,21342,90548,63590485.0,12077558.0,51512927.0,0.5655,0.5693,0.5659,0.5689
2023-05-25 12:55,378,169,209,33032,4843,28189,18825677.0,2740818.0,16084859.0,367,164,203,32422,4882,27540,18480208.0,2762743.0,15717464.0,0.5659,0.5706,0.5659,0.5707
2023-05-25 13:00,787,209,578,52807,6160,46647,30066313.0,3486597.0,26579715.0,784,205,579,53658,6203,47455,30553024.0,3510562.0,27042462.0,0.566,0.5698,0.5659,0.5699
2023-05-25 13:05,389,158,231,36131,5416,30715,20606619.0,3063185.0,17543434.0,378,151,227,35716,5207,30509,20373086.0,2946579.0,17426506.0,0.5656,0.5712,0.5659,0.5712
2023-05-25 13:10,251,108,143,22026,4115,17911,12534125.0,2328373.0,10205752.0,244,104,140,22065,4014,18051,12558253.0,2272212.0,10286040.0,0.5658,0.5698,0.5661,0.5698
2023-05-25 13:15,562,96,466,33132,2791,30341,18834515.0,1579793.0,17254722.0,552,91,461,33053,2745,30308,18789060.0,1552907.0,17236152.0,0.566,0.5687,0.5657,0.5687
2023-05-25 13:20,552,304,248,45718,15264,30454,25973241.0,8642613.0,17330627.0,544,297,247,45660,15232,30428,25940744.0,8624687.0,17316056.0,0.5662,0.5691,0.5662,0.5691
2023-05-25 13:25,850,256,594,73265,17335,55930,41623500.0,9813753.0,31809746.0,844,250,594,73414,17296,56118,41707900.0,9791356.0,31916543.0,0.5661,0.5687,0.5661,0.5687
2023-05-25 13:30,856,334,522,60619,15509,45110,34448284.0,8778737.0,25669546.0,843,324,519,60389,15527,44862,34315355.0,8786961.0,25528393.0,0.566,0.569,0.5659,0.569
2023-05-25 13:35,358,173,185,22192,5356,16836,12619472.0,3033921.0,9585551.0,350,165,185,22051,5285,16766,12539334.0,2993552.0,9545782.0,0.5665,0.5693,0.5664,0.5694
2023-05-25 13:40,110,82,28,3030,2179,851,1718091.0,1234118.0,483973.0,103,76,27,3088,2237,851,1750754.0,1266755.0,483998.0,0.5664,0.5687,0.5663,0.5687
2023-05-25 13:45,525,336,189,37013,17716,19297,21016843.0,10029120.0,10987722.0,518,331,187,37126,17646,19480,21081753.0,9989131.0,11092621.0,0.5661,0.5694,0.5661,0.5694
2023-05-25 13:50,510,260,250,35697,13533,22164,20271751.0,7663503.0,12608247.0,499,253,246,35597,13380,22217,20214136.0,7574281.0,12639854.0,0.5663,0.5689,0.5661,0.5689
2023-05-25 13:55,734,298,436,48404,20404,28000,27487836.0,11554666.0,15933169.0,726,293,433,48236,20396,27840,27386614.0,11549875.0,15836739.0,0.5663,0.569,0.5663,0.5688
2023-05-25 14:00,219,93,126,12279,4168,8111,6987254.0,2361367.0,4625886.0,215,93,122,12202,4280,7922,6942587.0,2424370.0,4518216.0,0.5665,0.5703,0.5664,0.5703
2023-05-25 14:05,400,92,308,20487,3686,16801,23537926.0,13963005.0,9574920.0,394,87,307,20482,3654,16828,23532815.0,13942643.0,9590171.0,3.7881,0.5699,3.8157,0.5699
2023-05-25 14:10,305,191,114,10703,6019,4684,6086707.0,3412054.0,2674652.0,298,184,114,10418,5765,4653,5925991.0,3269125.0,2656866.0,0.5669,0.571,0.5671,0.571
2023-05-25 14:15,594,260,334,25840,8510,17330,14690852.0,4823779.0,9867072.0,589,260,329,25928,8563,17365,14744388.0,4853917.0,9890470.0,0.5668,0.5694,0.5668,0.5696
2023-05-25 14:20,599,439,160,38939,28305,10634,22121440.0,16061226.0,6060213.0,576,420,156,37838,27775,10063,21490521.0,15754679.0,5735842.0,0.5674,0.5699,0.5672,0.57
2023-05-25 14:25,1139,370,769,110105,27609,82496,98143600.0,51264700.0,46878899.0,1119,359,760,108964,27331,81633,97553528.0,51108362.0,46445166.0,1.8568,0.5683,1.87,0.569
2023-05-25 14:30,706,181,525,57767,13494,44273,32809789.0,7638874.0,25170914.0,681,164,517,57480,13350,44130,32644340.0,7553798.0,25090542.0,0.5661,0.5685,0.5658,0.5686
2023-05-25 14:35,1347,473,874,120514,31866,88648,80357391.0,29916547.0,50440844.0,1326,456,870,120470,31609,88861,80324909.0,29763119.0,50561789.0,0.9388,0.569,0.9416,0.569
2023-05-25 14:40,400,245,155,19340,10055,9285,10981815.0,5695243.0,5286572.0,389,236,153,19030,9752,9278,10804640.0,5522389.0,5282251.0,0.5664,0.5694,0.5663,0.5693
2023-05-25 14:45,78,35,43,4684,2013,2671,2669119.0,1144160.0,1524959.0,67,30,37,4089,1903,2186,2321583.0,1076628.0,1244954.0,0.5684,0.5709,0.5658,0.5695
2023-05-25 14:50,473,209,264,41821,21277,20544,23703614.0,12055485.0,11648129.0,466,205,261,41289,20690,20599,23447381.0,11724302.0,11723079.0,0.5666,0.567,0.5667,0.5691
2023-05-25 14:55,94,42,52,8690,4054,4636,4940388.0,2298806.0,2641582.0,88,38,50,8100,3860,4240,4601368.0,2187918.0,2413450.0,0.567,0.5698,0.5668,0.5692
2023-05-25 15:00,132,60,72,11165,5004,6161,6367580.0,2837776.0,3529804.0,127,57,70,11192,5152,6040,6378840.0,2918553.0,3460287.0,0.5671,0.5729,0.5665,0.5729
2023-05-25 15:05,181,120,61,14093,9957,4136,8001391.0,5646965.0,2354426.0,177,117,60,14116,9889,4227,8014594.0,5608193.0,2406401.0,0.5671,0.5693,0.5671,0.5693
2023-05-25 15:10,313,91,222,16332,5857,10475,9287891.0,3323360.0,5964531.0,297,79,218,16054,5753,10301,9127842.0,3263374.0,5864468.0,0.5674,0.5694,0.5672,0.5693
2023-05-25 15:15,97,72,25,6321,4579,1742,3597771.0,2602252.0,995519.0,89,66,23,6373,4598,1775,3624067.0,2609692.0,1014375.0,0.5683,0.5715,0.5676,0.5715
2023-05-25 15:20,231,192,39,20208,18186,2022,23364720.0,22209306.0,1155414.0,219,186,33,19438,17696,1742,22913333.0,21919489.0,993844.0,1.2212,0.5714,1.2387,0.5705
2023-05-25 15:25,167,116,51,12406,9525,2881,7050538.0,5407458.0,1643080.0,157,110,47,12440,9493,2947,7068620.0,5388908.0,1679711.0,0.5677,0.5703,0.5677,0.57
2023-05-25 15:30,391,229,162,27388,15702,11686,15586045.0,8925252.0,6660793.0,388,225,163,27253,15694,11559,15508027.0,8920474.0,6587553.0,0.5684,0.57,0.5684,0.5699
2023-05-25 15:35,574,328,246,49583,29548,20035,28213813.0,16797994.0,11415818.0,572,327,245,49720,29706,20014,28291151.0,16887259.0,11403891.0,0.5685,0.5698,0.5685,0.5698
2023-05-25 15:40,294,176,118,26339,17986,8353,14976912.0,10218847.0,4758064.0,286,172,114,25847,17650,8197,14699583.0,10027583.0,4672000.0,0.5682,0.5696,0.5681,0.57
2023-05-25 15:45,624,226,398,51859,17489,34370,29518004.0,9932431.0,19585573.0,619,220,399,52116,17519,34597,29664877.0,9949269.0,19715608.0,0.5679,0.5698,0.5679,0.5699
2023-05-25 15:50,310,229,81,27668,19039,8629,15737214.0,10816877.0,4920337.0,306,228,78,27441,19094,8347,15608134.0,10848538.0,4759595.0,0.5681,0.5702,0.5682,0.5702
2023-05-25 15:55,306,193,113,26080,16343,9737,14842437.0,9280478.0,5561959.0,293,185,108,26105,15917,10188,14870261.0,9039964.0,5830297.0,0.5679,0.5712,0.5679,0.5723
2023-05-25 16:00,256,142,114,20902,12428,8474,11903575.0,7056306.0,4847268.0,250,140,110,20479,12366,8113,11658869.0,7020427.0,4638441.0,0.5678,0.572,0.5677,0.5717
2023-05-25 16:05,454,321,133,37258,27061,10197,21178189.0,15364940.0,5813249.0,447,317,130,37720,27293,10427,21444620.0,15496561.0,5948058.0,0.5678,0.5701,0.5678,0.5704
2023-05-25 16:10,711,313,398,71027,30409,40618,40422083.0,17271083.0,23150999.0,697,303,394,70456,29959,40497,40100414.0,17012665.0,23087749.0,0.568,0.57,0.5679,0.5701
2023-05-25 16:15,112,66,46,9216,5795,3421,5242793.0,3292009.0,1950784.0,108,61,47,9288,5907,3381,5281793.0,3354218.0,1927575.0,0.5681,0.5702,0.5678,0.5701
2023-05-25 16:20,306,172,134,23380,12395,10985,13303941.0,7039813.0,6264128.0,301,168,133,23119,12117,11002,13155480.0,6881586.0,6273894.0,0.568,0.5702,0.5679,0.5703
2023-05-25 16:25,148,73,75,12458,5892,6566,7085761.0,3346667.0,3739093.0,143,71,72,12624,6157,6467,7185902.0,3497208.0,3688694.0,0.568,0.5695,0.568,0.5704
2023-05-25 16:30,934,465,469,105055,53437,51618,59750227.0,30335198.0,29415028.0,929,463,466,104600,53328,51272,59492358.0,30273599.0,29218759.0,0.5677,0.5699,0.5677,0.5699
2023-05-25 16:35,354,219,135,39777,26038,13739,34478768.0,26652203.0,7826564.0,342,212,130,39742,25880,13862,34458727.0,26561191.0,7897535.0,1.0236,0.5697,1.0263,0.5697
2023-05-25 16:40,685,405,280,78040,48930,29110,44366094.0,27772169.0,16593925.0,681,402,279,78255,49065,29190,44484463.0,27848566.0,16635896.0,0.5676,0.57,0.5676,0.5699
2023-05-25 16:45,462,184,278,44890,19960,24930,25587637.0,11328233.0,14259404.0,455,183,272,44749,19968,24781,25507218.0,11332957.0,14174260.0,0.5675,0.572,0.5676,0.572
2023-05-25 16:50,124,63,61,11647,6954,4693,6628565.0,3945993.0,2682571.0,119,60,59,12071,6941,5130,6873679.0,3938309.0,2935370.0,0.5674,0.5716,0.5674,0.5722
2023-05-25 16:55,132,74,58,10698,6478,4220,6086027.0,3676579.0,2409447.0,127,72,55,10152,6534,3618,5770440.0,3707563.0,2062877.0,0.5675,0.571,0.5674,0.5702
2023-05-25 17:00,208,128,80,22107,15422,6685,24446706.0,20632054.0,3814651.0,205,127,78,21811,15145,6666,24277021.0,20473877.0,3803143.0,1.3378,0.5706,1.3519,0.5705
2023-05-25 17:05,94,82,12,7229,6987,242,4109896.0,3971892.0,138003.0,86,76,10,7235,6919,316,4109186.0,3929033.0,180152.0,0.5685,0.5703,0.5679,0.5701
2023-05-25 17:10,31,16,15,1161,424,737,659501.0,237139.0,422362.0,25,11,14,956,274,682,546581.0,155458.0,391123.0,0.5593,0.5731,0.5674,0.5735
2023-05-25 17:15,192,151,41,15453,12212,3241,8781728.0,6945806.0,1835921.0,174,136,38,14911,11599,3312,8485916.0,6587625.0,1898291.0,0.5688,0.5665,0.5679,0.5732
2023-05-25 17:20,121,96,25,9404,8005,1399,5345628.0,4546241.0,799387.0,119,93,26,9520,8124,1396,5411641.0,4613981.0,797660.0,0.5679,0.5714,0.5679,0.5714
2023-05-25 17:25,217,203,14,15368,14937,431,8726599.0,8480628.0,245971.0,213,201,12,15398,15036,362,8743067.0,8536469.0,206597.0,0.5678,0.5707,0.5677,0.5707
2023-05-25 17:30,295,235,60,24930,17290,7640,14194107.0,9822932.0,4371174.0,291,233,58,24853,17405,7448,14148852.0,9887223.0,4261629.0,0.5681,0.5721,0.5681,0.5722
2023-05-25 17:35,257,201,56,25116,14056,11060,14305031.0,7986588.0,6318443.0,252,198,54,25232,13807,11425,14372677.0,7844924.0,6527752.0,0.5682,0.5713,0.5682,0.5714
2023-05-25 17:40,103,86,17,9217,6677,2540,5245277.0,3792782.0,1452495.0,99,84,15,9108,6708,2400,5182979.0,3810230.0,1372749.0,0.568,0.5718,0.568,0.572
2023-05-25 17:45,140,101,39,11133,6177,4956,6351594.0,3508475.0,2843119.0,138,99,39,10969,6141,4828,6258190.0,3487540.0,2770650.0,0.568,0.5737,0.5679,0.5739
2023-05-25 17:50,93,80,13,5787,4545,1242,3293021.0,2580847.0,712173.0,79,69,10,5400,4546,854,3068630.0,2581224.0,487406.0,0.5678,0.5734,0.5678,0.5707
2023-05-25 17:55,91,72,19,5918,4417,1501,3373167.0,2509911.0,863255.0,79,64,15,6216,4350,1866,3545890.0,2470932.0,1074958.0,0.5682,0.5751,0.568,0.5761
2023-05-25 18:00,140,99,41,7420,5502,1918,4221859.0,3124714.0,1097145.0,136,97,39,8115,6136,1979,4602757.0,3470219.0,1132537.0,0.5679,0.572,0.5656,0.5723
2023-05-25 18:05,222,182,40,13051,11551,1500,7415323.0,6557060.0,858262.0,218,181,37,13373,11634,1739,7599422.0,6604222.0,995200.0,0.5677,0.5722,0.5677,0.5723
2023-05-25 18:10,291,216,75,17423,12098,5325,9907156.0,6865105.0,3042051.0,276,209,67,16913,12003,4910,9615732.0,6811274.0,2804458.0,0.5675,0.5713,0.5675,0.5712
2023-05-25 18:15,172,149,23,8911,6687,2224,5069676.0,3796446.0,1273229.0,170,148,22,9228,6684,2544,5251715.0,3794671.0,1457044.0,0.5677,0.5725,0.5677,0.5727
2023-05-25 18:20,194,118,76,9548,6587,2961,5428735.0,3738347.0,1690387.0,189,113,76,9303,6756,2547,5285164.0,3832536.0,1452627.0,0.5675,0.5709,0.5673,0.5703
2023-05-25 18:25,200,167,33,13654,11686,1968,7766185.0,6636198.0,1129986.0,191,161,30,13506,11665,1841,7678205.0,6621026.0,1057179.0,0.5679,0.5742,0.5676,0.5742
2023-05-25 18:30,170,128,42,10513,6920,3593,5992202.0,3927804.0,2064398.0,157,122,35,9945,6592,3353,5668383.0,3740853.0,1927530.0,0.5676,0.5746,0.5675,0.5749
2023-05-25 18:35,82,67,15,5960,4239,1721,3393809.0,2406704.0,987105.0,79,64,15,6456,4469,1987,3677894.0,2533901.0,1143992.0,0.5678,0.5736,0.567,0.5757
2023-05-26 10:00,1272,1052,220,77894,64786,13108,61364464.0,53787126.0,7577337.0,1023,912,111,69146,59805,9341,50928169.0,45602610.0,5325559.0,0.8302,0.5781,0.7625,0.5701
2023-05-26 10:05,656,562,94,44123,39360,4763,25038346.0,22273203.0,2765143.0,614,542,72,42905,39539,3366,24318550.0,22378991.0,1939559.0,0.5659,0.5805,0.566,0.5762
2023-05-26 10:10,328,216,112,13538,11236,2302,7693738.0,6366709.0,1327028.0,203,161,42,12646,10831,1815,7179150.0,6138620.0,1040529.0,0.5666,0.5765,0.5668,0.5733
2023-05-26 10:15,185,113,72,9553,6291,3262,5446778.0,3558334.0,1888444.0,161,100,61,8844,6201,2643,5027895.0,3512282.0,1515612.0,0.5656,0.5789,0.5664,0.5734
2023-05-26 10:20,206,164,42,11469,9455,2014,6496423.0,5357796.0,1138626.0,188,152,36,11201,9349,1852,6358174.0,5297941.0,1060233.0,0.5667,0.5654,0.5667,0.5725
2023-05-26 10:25,186,137,49,7991,6388,1603,4535956.0,3619963.0,915992.0,158,119,39,8043,6364,1679,4575104.0,3606902.0,968201.0,0.5667,0.5714,0.5668,0.5767
2023-05-26 10:30,83,47,36,2645,1515,1130,1495964.0,853497.0,642467.0,69,36,33,2601,1505,1096,1478604.0,851310.0,627293.0,0.5634,0.5686,0.5657,0.5723
2023-05-26 10:35,843,358,485,81959,26303,55656,70301861.0,38598408.0,31703453.0,787,319,468,79856,25921,53935,62763533.0,32014043.0,30749490.0,1.4675,0.5696,1.2351,0.5701
2023-05-26 10:40,1129,362,767,145637,23000,122637,94594191.0,24848010.0,69746181.0,1090,333,757,144503,21777,122726,93959258.0,24166902.0,69792356.0,1.0803,0.5687,1.1097,0.5687
2023-05-26 10:45,752,446,306,48876,18100,30776,39525413.0,22081965.0,17443447.0,696,404,292,47863,17529,30334,38985723.0,21761899.0,17223823.0,1.22,0.5668,1.2415,0.5678
2023-05-26 10:50,1878,1055,823,254997,140902,114095,168324442.0,103596893.0,64727549.0,1721,959,762,249590,136221,113369,165176456.0,100841909.0,64334547.0,0.7352,0.5673,0.7403,0.5675
2023-05-26 10:55,959,908,51,129564,127457,2107,73497220.0,72292823.0,1204396.0,943,905,38,128464,127495,969,72864330.0,72311558.0,552771.0,0.5672,0.5716,0.5672,0.5705
2023-05-26 11:00,1297,1232,65,206123,200830,5293,116933116.0,113905500.0,3027615.0,1277,1217,60,206316,201104,5212,117049697.0,114068643.0,2981053.0,0.5672,0.572,0.5672,0.572
2023-05-26 11:05,782,65,717,57505,6631,50874,44482896.0,15637851.0,28845045.0,751,50,701,53596,5193,48403,42345459.0,14813524.0,27531934.0,2.3583,0.567,2.8526,0.5688
2023-05-26 11:10,1251,685,566,79315,33107,46208,56956442.0,30681763.0,26274679.0,1207,652,555,77316,32013,45303,55829317.0,30022522.0,25806794.0,0.9267,0.5686,0.9378,0.5696
2023-05-26 11:15,428,331,97,26244,16048,10196,14910295.0,9086076.0,5824218.0,420,330,90,25984,15956,10028,14758070.0,9035608.0,5722462.0,0.5662,0.5712,0.5663,0.5706
2023-05-26 11:20,512,385,127,33497,19575,13922,30953988.0,22970974.0,7983014.0,499,378,121,33920,20012,13908,31187700.0,23211575.0,7976124.0,1.1735,0.5734,1.1599,0.5735
2023-05-26 11:25,392,268,124,28128,14045,14083,16055682.0,7962245.0,8093437.0,378,259,119,27073,13701,13372,15423519.0,7773519.0,7650000.0,0.5669,0.5747,0.5674,0.5721
2023-05-26 11:30,1648,1194,454,119585,67818,51767,67974772.0,38412808.0,29561963.0,1638,1180,458,118859,67165,51694,67565748.0,38041883.0,29523864.0,0.5664,0.5711,0.5664,0.5711
2023-05-26 11:35,1867,1452,415,126114,82091,44023,71656331.0,46517830.0,25138500.0,1848,1443,405,125627,81893,43734,71351512.0,46392889.0,24958623.0,0.5667,0.571,0.5665,0.5707
2023-05-26 11:40,805,629,176,52973,34815,18158,30090405.0,19728255.0,10362150.0,788,622,166,52482,34691,17791,29809579.0,19657606.0,10151973.0,0.5667,0.5707,0.5666,0.5706
2023-05-26 11:45,892,770,122,55477,46382,9095,31474816.0,26290950.0,5183865.0,882,764,118,55177,46269,8908,31302896.0,26225676.0,5077220.0,0.5668,0.57,0.5668,0.57
2023-05-26 11:50,172,88,84,13855,5437,8418,7885048.0,3081393.0,4803654.0,160,80,80,13926,5430,8496,7924043.0,3077089.0,4846954.0,0.5667,0.5706,0.5667,0.5705
2023-05-26 11:55,891,499,392,95724,29429,66295,54473797.0,16675553.0,37798244.0,880,494,386,96513,30838,65675,54924090.0,17471882.0,37452207.0,0.5666,0.5702,0.5666,0.5703
2023-05-26 12:00,902,721,181,53546,37831,15715,30374598.0,21429084.0,8945513.0,888,712,176,53175,37618,15557,30163447.0,21307643.0,8855804.0,0.5664,0.5692,0.5664,0.5692
2023-05-26 12:05,1198,1002,196,72676,53863,18813,41228861.0,30517800.0,10711060.0,1197,1002,195,72733,53983,18750,41260771.0,30585600.0,10675171.0,0.5666,0.5693,0.5666,0.5693
2023-05-26 12:10,1330,1149,181,81841,63334,18507,46493123.0,35866882.0,10626241.0,1319,1142,177,79313,62923,16390,44989144.0,35649907.0,9339237.0,0.5663,0.5742,0.5666,0.5698
2023-05-26 12:15,1104,741,363,74418,32821,41597,42287544.0,18595105.0,23692439.0,1088,727,361,74574,32762,41812,42401531.0,18561292.0,23840239.0,0.5666,0.5696,0.5665,0.5702
2023-05-26 12:20,385,295,90,15137,9670,5467,8597399.0,5478964.0,3118434.0,370,285,85,13557,8104,5453,7702385.0,4591945.0,3110439.0,0.5666,0.5704,0.5666,0.5704
2023-05-26 12:25,244,202,42,10417,7015,3402,5920774.0,3975563.0,1945210.0,234,200,34,9879,6959,2920,5612796.0,3943555.0,1669241.0,0.5667,0.5718,0.5667,0.5717
2023-05-26 12:30,684,492,192,27769,16775,10994,15824783.0,9505870.0,6318913.0,674,486,188,27922,16740,11182,15917002.0,9485973.0,6431029.0,0.5667,0.5748,0.5667,0.5751
2023-05-26 12:35,1121,155,966,148004,4407,143597,84210896.0,2497741.0,81713155.0,1104,144,960,147225,4431,142794,83810129.0,2510509.0,81299620.0,0.5668,0.569,0.5666,0.5693
2023-05-26 12:40,1115,93,1022,164830,1282,163548,93881503.0,729051.0,93152452.0,1106,87,1019,165303,1463,163840,94130776.0,812458.0,93318318.0,0.5687,0.5696,0.5553,0.5696
2023-05-26 12:45,237,73,164,26156,1401,24755,14963437.0,799623.0,14163814.0,225,62,163,25466,1067,24399,14560586.0,603933.0,13956653.0,0.5708,0.5722,0.566,0.572
2023-05-26 12:50,124,46,78,9558,1587,7971,5455069.0,898800.0,4556269.0,115,40,75,9325,1573,7752,5323066.0,890748.0,4432318.0,0.5664,0.5716,0.5663,0.5718
2023-05-26 12:55,216,72,144,17650,1559,16091,10099576.0,884951.0,9214624.0,196,60,136,16923,1397,15526,9685784.0,791304.0,8894480.0,0.5676,0.5727,0.5664,0.5729
2023-05-26 13:00,38,21,17,1580,425,1155,904572.0,240164.0,664407.0,29,14,15,1491,388,1103,855588.0,219341.0,636247.0,0.5651,0.5752,0.5653,0.5768
2023-05-26 13:05,663,130,533,83754,3647,80107,59526431.0,13936250.0,45590181.0,642,112,530,83463,3579,79884,59379574.0,13900078.0,45479495.0,3.8213,0.5691,3.8838,0.5693
2023-05-26 13:10,2059,1014,1045,309681,145611,164070,187626585.0,94407925.0,93218660.0,2027,996,1031,307100,143569,163531,186068218.0,93153285.0,92914933.0,0.6484,0.5682,0.6488,0.5682
2023-05-26 13:15,683,634,49,105805,103899,1906,59907163.0,58823071.0,1084092.0,669,621,48,105783,103729,2054,59896719.0,58724449.0,1172269.0,0.5662,0.5688,0.5661,0.5707
2023-05-26 13:20,807,790,17,119221,118806,415,67539433.0,67301940.0,237493.0,796,781,15,119235,118807,428,67550774.0,67305566.0,245208.0,0.5665,0.5723,0.5665,0.5729
2023-05-26 13:25,1439,1323,116,194329,188069,6260,110094001.0,106521353.0,3572648.0,1426,1315,111,193947,187732,6215,109882315.0,106330339.0,3551976.0,0.5664,0.5707,0.5664,0.5715
2023-05-26 13:30,1575,1466,109,229551,224246,5305,130045084.0,127012113.0,3032971.0,1577,1469,108,229885,224651,5234,130233748.0,127241222.0,2992526.0,0.5664,0.5717,0.5664,0.5717
2023-05-26 13:35,987,860,127,119811,112772,7039,67895477.0,63876399.0,4019078.0,982,856,126,119928,112747,7181,67962200.0,63862230.0,4099970.0,0.5664,0.571,0.5664,0.5709
2023-05-26 13:40,1225,262,963,174500,37762,136738,110987231.0,33257522.0,77729709.0,1199,246,953,171442,36959,134483,109263379.0,32804326.0,76459053.0,0.8807,0.5685,0.8876,0.5685
2023-05-26 13:45,1889,76,1813,271133,1894,269239,154119032.0,1071771.0,153047261.0,1873,63,1810,269962,1772,268190,153430595.0,1000415.0,152430179.0,0.5659,0.5684,0.5646,0.5684
2023-05-26 13:50,2252,175,2077,302916,5852,297064,172024118.0,3304579.0,168719539.0,2245,169,2076,301804,5278,296526,171395681.0,2979768.0,168415912.0,0.5647,0.568,0.5646,0.568
2023-05-26 13:55,1793,88,1705,259598,2324,257274,147646789.0,1313893.0,146332895.0,1780,81,1699,259534,2123,257411,147609447.0,1198326.0,146411120.0,0.5654,0.5688,0.5644,0.5688
2023-05-26 14:00,1695,31,1664,297231,801,296430,180714702.0,12329006.0,168385696.0,1677,19,1658,296859,786,296073,180533665.0,12319674.0,168213990.0,15.392,0.568,15.6739,0.5682
2023-05-26 14:05,2206,81,2125,357197,1192,356005,214691763.0,12552291.0,202139472.0,2184,64,2120,357615,1271,356344,214924993.0,12592674.0,202332318.0,10.5304,0.5678,9.9077,0.5678
2023-05-26 14:10,841,75,766,132020,1508,130512,86938425.0,12725284.0,74213140.0,828,64,764,131347,1512,129835,86559874.0,12728040.0,73831834.0,8.4385,0.5686,8.418,0.5687
2023-05-26 14:15,1153,116,1037,218561,2523,216038,135750565.0,13286149.0,122464416.0,1057,37,1020,217261,1684,215577,135036375.0,12813604.0,122222771.0,5.266,0.5669,7.609,0.567
2023-05-26 14:20,2053,190,1863,332067,8857,323210,212048605.0,28780062.0,183268543.0,2008,160,1848,330584,7886,322698,211179867.0,28189240.0,182990627.0,3.2494,0.567,3.5746,0.5671
2023-05-26 14:25,291,72,219,27936,2163,25773,15844192.0,1217012.0,14627179.0,262,49,213,27547,2064,25483,15621500.0,1160200.0,14461299.0,0.5627,0.5675,0.5621,0.5675
2023-05-26 14:30,935,76,859,145998,2298,143700,94489938.0,13166371.0,81323567.0,881,36,845,143813,1978,141835,93266703.0,12985894.0,80280808.0,5.7295,0.5659,6.5652,0.566
2023-05-26 14:35,404,52,352,59027,1339,57688,45284708.0,12627468.0,32657239.0,374,24,350,58640,1045,57595,45064706.0,12461006.0,32603699.0,9.4305,0.5661,11.9244,0.5661
2023-05-26 14:40,204,88,116,8592,1838,6754,4841434.0,1029384.0,3812049.0,160,51,109,7897,1610,6287,4457355.0,901049.0,3556306.0,0.5601,0.5644,0.5597,0.5657
2023-05-26 14:45,293,82,211,26561,3534,23027,15012448.0,1985848.0,13026599.0,274,69,205,26172,3316,22856,14787553.0,1857890.0,12929663.0,0.5619,0.5657,0.5603,0.5657
2023-05-26 14:50,1164,522,642,118134,12373,105761,90453329.0,30707655.0,59745673.0,1136,504,632,117490,12047,105443,90109462.0,30522404.0,59587058.0,2.4818,0.5649,2.5336,0.5651
2023-05-26 14:55,641,154,487,75435,9065,66370,42589425.0,5085865.0,37503560.0,623,137,486,75270,8852,66418,42501098.0,4967160.0,37533938.0,0.561,0.5651,0.5611,0.5651
2023-05-26 15:00,178,84,94,10528,3778,6750,5949709.0,2132845.0,3816863.0,149,60,89,10305,3555,6750,5809275.0,1994813.0,3814462.0,0.5645,0.5655,0.5611,0.5651
2023-05-26 15:05,60,18,42,1455,45,1410,821050.0,25665.0,795385.0,40,4,36,1409,5,1404,795216.0,2802.0,792413.0,0.5703,0.5641,0.5604,0.5644
2023-05-26 15:10,71,26,45,3730,531,3199,13991764.0,12187346.0,1804418.0,48,9,39,3439,306,3133,13816594.0,12048325.0,1768269.0,22.9517,0.5641,39.3736,0.5644
2023-05-26 15:15,324,174,150,24611,14108,10503,13869730.0,7934640.0,5935090.0,308,161,147,24232,13700,10532,13655856.0,7705258.0,5950598.0,0.5624,0.5651,0.5624,0.565
2023-05-26 15:20,216,136,80,14312,11793,2519,8053235.0,6631170.0,1422065.0,204,126,78,14317,11806,2511,8053874.0,6636328.0,1417545.0,0.5623,0.5645,0.5621,0.5645
2023-05-26 15:25,174,81,93,10258,6010,4248,5782063.0,3380482.0,2401580.0,163,71,92,10112,5885,4227,5699614.0,3309557.0,2390057.0,0.5625,0.5653,0.5624,0.5654
2023-05-26 15:30,194,138,56,16045,12977,3068,9034698.0,7300773.0,1733925.0,182,129,53,16029,12706,3323,9029043.0,7148174.0,1880869.0,0.5626,0.5652,0.5626,0.566
2023-05-26 15:35,38,22,16,2046,572,1474,1164698.0,322305.0,842392.0,24,12,12,1671,563,1108,949372.0,317186.0,632186.0,0.5635,0.5715,0.5634,0.5706
2023-05-26 15:40,193,134,59,17198,14454,2744,9694381.0,8135154.0,1559226.0,186,126,60,17475,14304,3171,9849781.0,8048564.0,1801217.0,0.5628,0.5682,0.5627,0.568
2023-05-26 15:45,202,127,75,18833,13926,4907,10618639.0,7831174.0,2787465.0,191,123,68,18674,13872,4802,10531489.0,7800825.0,2730663.0,0.5623,0.5681,0.5623,0.5687
2023-05-26 15:50,153,105,48,11773,8711,3062,6633141.0,4896369.0,1736772.0,143,98,45,11658,8652,3006,6571219.0,4865081.0,1706138.0,0.5621,0.5672,0.5623,0.5676
2023-05-26 15:55,69,45,24,4281,2750,1531,2414814.0,1546501.0,868313.0,57,36,21,3867,2764,1103,2178724.0,1553573.0,625151.0,0.5624,0.5672,0.5621,0.5668
2023-05-26 16:00,117,89,28,8428,7021,1407,4745195.0,3949282.0,795913.0,109,81,28,11704,7203,4501,6706391.0,4046329.0,2660062.0,0.5625,0.5657,0.5618,0.591
2023-05-26 16:05,65,42,23,5141,3996,1145,2895892.0,2249676.0,646215.0,60,40,20,4884,3771,1113,2752701.0,2122698.0,630002.0,0.563,0.5644,0.5629,0.566
2023-05-26 16:10,25,17,8,1091,1026,65,609426.0,576505.0,32920.0,15,11,4,932,904,28,523857.0,507782.0,16074.0,0.5619,0.5065,0.5617,0.5741
2023-05-26 16:15,33,9,24,1303,418,885,734836.0,234775.0,500061.0,26,6,20,1265,395,870,714038.0,221891.0,492147.0,0.5617,0.565,0.5618,0.5657
2023-05-26 16:20,14,3,11,720,4,716,405979.0,2245.0,403733.0,9,1,8,677,1,676,382221.0,559.0,381662.0,0.5614,0.5639,0.5596,0.5646
2023-05-26 16:25,46,29,17,3485,2740,745,1960013.0,1543209.0,416803.0,37,24,13,3677,2918,759,2072177.0,1643264.0,428912.0,0.5632,0.5595,0.5631,0.5651
2023-05-26 16:30,73,54,19,5540,4415,1125,3122453.0,2486730.0,635722.0,62,44,18,5358,4197,1161,3017664.0,2361237.0,656427.0,0.5632,0.5651,0.5626,0.5654
2023-05-26 16:35,94,54,40,8446,4626,3820,4753165.0,2602195.0,2150970.0,83,47,36,8333,4484,3849,4713791.0,2523457.0,2190334.0,0.5625,0.5631,0.5628,0.5691
2023-05-26 16:40,165,83,82,12591,6774,5817,7124772.0,3812477.0,3312295.0,150,75,75,11566,6160,5406,6541535.0,3464923.0,3076612.0,0.5628,0.5694,0.5625,0.5691
2023-05-26 16:45,88,55,33,5579,3753,1826,3150219.0,2118156.0,1032062.0,77,49,28,5475,3769,1706,3083856.0,2119283.0,964573.0,0.5644,0.5652,0.5623,0.5654
2023-05-26 16:50,292,171,121,17224,10283,6941,9718304.0,5787875.0,3930428.0,253,146,107,14593,9078,5515,8232733.0,5105244.0,3127489.0,0.5629,0.5663,0.5624,0.5671
2023-05-26 16:55,67,34,33,3726,2517,1209,2098511.0,1414974.0,683536.0,60,29,31,3632,2434,1198,2044654.0,1367075.0,677579.0,0.5622,0.5654,0.5617,0.5656
2023-05-26 17:00,52,26,26,3740,2328,1412,2111696.0,1313475.0,798221.0,50,21,29,3583,2130,1453,2017721.0,1196335.0,821386.0,0.5642,0.5653,0.5617,0.5653
2023-05-26 17:05,38,17,21,1930,1316,614,1093569.0,744736.0,348833.0,25,8,17,1127,522,605,637313.0,293888.0,343424.0,0.5659,0.5681,0.563,0.5676
2023-05-26 17:10,101,41,60,9635,4594,5041,5438624.0,2590185.0,2848438.0,75,36,39,8868,4600,4268,5019172.0,2591061.0,2428111.0,0.5638,0.5651,0.5633,0.5689
2023-05-26 17:15,212,91,121,15207,8833,6374,8570107.0,4971131.0,3598976.0,213,83,130,17236,8420,8816,9743514.0,4741250.0,5002263.0,0.5628,0.5646,0.5631,0.5674
2023-05-26 17:20,96,44,52,8067,5944,2123,4545280.0,3345109.0,1200171.0,89,38,51,7271,5685,1586,4096307.0,3199078.0,897228.0,0.5628,0.5653,0.5627,0.5657
2023-05-26 17:25,157,46,111,7541,4599,2942,4252030.0,2589150.0,1662880.0,144,34,110,7806,4811,2995,4398216.0,2705474.0,1692742.0,0.563,0.5652,0.5624,0.5652
2023-05-26 17:30,362,173,189,30494,21900,8594,17197275.0,12330438.0,4866836.0,349,163,186,30381,21750,8631,17134390.0,12246547.0,4887842.0,0.563,0.5663,0.5631,0.5663
2023-05-26 17:35,364,98,266,18425,8392,10033,10376386.0,4719627.0,5656758.0,350,89,261,18404,8445,9959,10377095.0,4751144.0,5625951.0,0.5624,0.5638,0.5626,0.5649
2023-05-26 17:40,521,46,475,11233,2063,9170,6340569.0,1160881.0,5179688.0,508,36,472,11184,2095,9089,6310946.0,1176229.0,5134717.0,0.5627,0.5649,0.5614,0.5649
2023-05-26 17:45,331,85,246,19358,7761,11597,22745981.0,16239637.0,6506344.0,302,73,229,17677,7208,10469,21829583.0,15923102.0,5906481.0,2.0925,0.561,2.2091,0.5642
2023-05-26 17:50,181,59,122,5453,3082,2371,3067119.0,1729959.0,1337160.0,167,46,121,5437,3049,2388,3057787.0,1711166.0,1346620.0,0.5613,0.564,0.5612,0.5639
2023-05-26 17:55,420,159,261,27418,12033,15385,15429094.0,6758228.0,8670865.0,397,142,255,26994,11911,15083,15191385.0,6688915.0,8502470.0,0.5616,0.5636,0.5616,0.5637
2023-05-26 18:00,136,50,86,5742,2068,3674,3231341.0,1161114.0,2070227.0,120,38,82,5724,1911,3813,3223582.0,1072403.0,2151179.0,0.5615,0.5635,0.5612,0.5642
2023-05-26 18:05,236,159,77,9262,7617,1645,5208820.0,4280289.0,928531.0,221,147,74,8764,7074,1690,4928376.0,3974169.0,954206.0,0.5619,0.5645,0.5618,0.5646
2023-05-26 18:10,347,246,101,18864,16171,2693,10613372.0,9091743.0,1521629.0,336,239,97,18702,16173,2529,10519480.0,9090634.0,1428845.0,0.5622,0.565,0.5621,0.565
2023-05-26 18:15,431,314,117,20160,17276,2884,23224413.0,21591171.0,1633242.0,415,302,113,20150,17297,2853,23216575.0,21601168.0,1615407.0,1.2498,0.5663,1.2488,0.5662
2023-05-26 18:20,135,86,49,6098,4143,1955,3434803.0,2329988.0,1104815.0,136,83,53,6058,3698,2360,3414318.0,2076983.0,1337335.0,0.5624,0.5651,0.5617,0.5667
2023-05-26 18:25,116,44,72,7926,1833,6093,4474550.0,1031973.0,3442576.0,111,41,70,7684,1778,5906,4338726.0,1001013.0,3337712.0,0.563,0.565,0.563,0.5651
2023-05-26 18:30,49,26,23,2214,1384,830,1247968.0,778229.0,469739.0,43,23,20,2337,1448,889,1317573.0,814302.0,503271.0,0.5623,0.566,0.5624,0.5661
2023-05-26 18:35,116,57,59,4602,2058,2544,2592656.0,1156585.0,1436071.0,101,48,53,4099,1937,2162,2310986.0,1088125.0,1222861.0,0.562,0.5645,0.5618,0.5656
2023-05-29 10:00,1298,437,861,186564,27838,158726,136452231.0,46151433.0,90300798.0,1037,312,725,172596,20743,151853,121475953.0,35220592.0,86255361.0,1.6579,0.5689,1.698,0.568
2023-05-29 10:05,2106,357,1749,422627,20161,402466,239829321.0,11321364.0,228507956.0,2024,313,1711,414502,13239,401263,235266830.0,7456384.0,227810446.0,0.5615,0.5678,0.5632,0.5677
2023-05-29 10:10,445,109,336,54838,2909,51929,31252678.0,1641897.0,29610780.0,392,93,299,53539,3277,50262,30496398.0,1845119.0,28651279.0,0.5644,0.5702,0.5631,0.57
2023-05-29 10:15,1328,68,1260,249768,1065,248703,141871512.0,596647.0,141274864.0,1267,21,1246,249152,536,248616,141515116.0,299663.0,141215453.0,0.5602,0.568,0.5591,0.568
2023-05-29 10:20,206,67,139,20071,1085,18986,16362953.0,589889.0,15773063.0,164,43,121,17554,805,16749,9963049.0,445893.0,9517155.0,0.5437,0.8308,0.5539,0.5682
2023-05-29 10:25,152,69,83,4204,2699,1505,2369602.0,1517639.0,851962.0,36,12,24,2892,1333,1559,1636205.0,751265.0,884940.0,0.5623,0.5661,0.5636,0.5676
2023-05-29 10:30,140,69,71,8878,2880,5998,5021806.0,1631109.0,3390697.0,100,38,62,7615,1888,5727,4314715.0,1062640.0,3252075.0,0.5664,0.5653,0.5628,0.5678
2023-05-29 10:35,108,35,73,10574,521,10053,6017299.0,293347.0,5723951.0,93,25,68,10221,553,9668,5803133.0,309686.0,5493447.0,0.563,0.5694,0.56,0.5682
2023-05-29 10:40,74,32,42,4729,754,3975,2679006.0,424812.0,2254194.0,46,11,35,4491,633,3858,2549163.0,355989.0,2193173.0,0.5634,0.5671,0.5624,0.5685
2023-05-29 10:45,98,30,68,7590,1000,6590,16146779.0,12437046.0,3709733.0,61,13,48,7034,1110,5924,11090934.0,7726158.0,3364775.0,12.437,0.5629,6.9605,0.568
2023-05-29 10:50,1076,83,993,198435,2104,196331,147615788.0,36804665.0,110811122.0,1007,30,977,195248,1632,193616,146081657.0,36540617.0,109541040.0,17.4927,0.5644,22.3901,0.5658
2023-05-29 10:55,1292,400,892,196905,35262,161643,158796755.0,67472626.0,91324129.0,1205,338,867,192067,31668,160399,155983300.0,65291119.0,90692181.0,1.9135,0.565,2.0617,0.5654
2023-05-29 11:00,1553,1454,99,239283,236241,3042,134499568.0,132781360.0,1718208.0,1510,1427,83,237590,235661,1929,133497486.0,132407126.0,1090359.0,0.5621,0.5648,0.5619,0.5652
2023-05-29 11:05,1141,1104,37,180390,178045,2345,101379804.0,100053512.0,1326292.0,1122,1096,26,178881,177800,1081,100523695.0,99911587.0,612107.0,0.562,0.5656,0.5619,0.5662
2023-05-29 11:10,356,339,17,47735,46624,1111,38717488.0,38075935.0,641552.0,323,310,13,47036,45458,1578,38310031.0,37418223.0,891808.0,0.8167,0.5775,0.8231,0.5652
2023-05-29 11:15,939,839,100,129976,121749,8227,73161071.0,68506528.0,4654542.0,911,823,88,126872,120043,6829,71322774.0,67454789.0,3867985.0,0.5627,0.5658,0.5619,0.5664
2023-05-29 11:20,653,568,85,71251,64700,6551,51932253.0,48227755.0,3704498.0,616,541,75,69812,63512,6300,51128064.0,47559878.0,3568186.0,0.7454,0.5655,0.7488,0.5664
2023-05-29 11:25,127,76,51,8768,5958,2810,4901209.0,3342481.0,1558727.0,106,65,41,7607,5658,1949,4277839.0,3176499.0,1101339.0,0.561,0.5547,0.5614,0.5651
2023-05-29 11:30,72,35,37,5216,2911,2305,2937116.0,1634265.0,1302850.0,61,24,37,5458,2909,2549,3073683.0,1632771.0,1440911.0,0.5614,0.5652,0.5613,0.5653
2023-05-29 11:35,136,60,76,11026,4492,6534,9706059.0,2511424.0,7194635.0,98,33,65,10582,3641,6941,10998067.0,2035125.0,8962941.0,0.5591,1.1011,0.5589,1.2913
2023-05-29 11:40,105,42,63,7789,2701,5088,4402059.0,1515064.0,2886994.0,91,30,61,8468,3409,5059,4783650.0,1912977.0,2870672.0,0.5609,0.5674,0.5612,0.5674
2023-05-29 11:45,168,99,69,14958,8157,6801,8514447.0,4657615.0,3856832.0,139,76,63,13922,7380,6542,7841517.0,4127741.0,3713776.0,0.571,0.5671,0.5593,0.5677
2023-05-29 11:50,64,41,23,4067,3388,679,2278067.0,1895008.0,383058.0,47,26,21,2679,2010,669,1506682.0,1129231.0,377450.0,0.5593,0.5642,0.5618,0.5642
2023-05-29 11:55,35,21,14,2013,1483,530,1113506.0,833505.0,280001.0,17,8,9,891,577,314,501318.0,324060.0,177258.0,0.562,0.5283,0.5616,0.5645
2023-05-29 12:00,818,124,694,113610,11192,102418,64156571.0,6291905.0,57864666.0,795,112,683,112974,11291,101683,63819331.0,6343826.0,57475504.0,0.5622,0.565,0.5618,0.5652
2023-05-29 12:05,340,30,310,53303,3461,49842,30161990.0,1943795.0,28218194.0,327,19,308,52199,3057,49142,29499440.0,1718337.0,27781102.0,0.5616,0.5662,0.5621,0.5653
2023-05-29 12:10,103,46,57,10801,3866,6935,6097460.0,2178068.0,3919391.0,83,33,50,9775,3361,6414,5515503.0,1887301.0,3628202.0,0.5634,0.5652,0.5615,0.5657
2023-05-29 12:15,144,63,81,13810,5740,8070,7786034.0,3227979.0,4558055.0,134,57,77,13891,5851,8040,7832082.0,3289818.0,4542263.0,0.5624,0.5648,0.5623,0.565
2023-05-29 12:20,128,49,79,14330,4924,9406,8082506.0,2768586.0,5313919.0,116,41,75,14172,4808,9364,7994328.0,2703655.0,5290673.0,0.5623,0.565,0.5623,0.565
2023-05-29 12:25,203,119,84,20874,10071,10803,11773884.0,5662991.0,6110893.0,189,107,82,20086,9547,10539,11318225.0,5360764.0,5957461.0,0.5623,0.5657,0.5615,0.5653
2023-05-29 12:30,221,109,112,23432,9327,14105,13183449.0,5215298.0,7968151.0,214,107,107,23463,9442,14021,13206264.0,5285014.0,7921250.0,0.5592,0.5649,0.5597,0.565
2023-05-29 12:35,180,56,124,19043,5685,13358,10895855.0,3358884.0,7536970.0,155,43,112,16578,3693,12885,9346262.0,2067306.0,7278955.0,0.5908,0.5642,0.5598,0.5649
2023-05-29 12:40,67,44,23,6351,2828,3523,3574625.0,1586127.0,1988498.0,54,35,19,3813,2581,1232,2148250.0,1448405.0,699844.0,0.5609,0.5644,0.5612,0.5681
2023-05-29 12:45,60,32,28,2645,1290,1355,1492075.0,725421.0,766654.0,44,24,20,2410,1334,1076,1357165.0,747022.0,610142.0,0.5623,0.5658,0.56,0.567
2023-05-29 12:50,42,22,20,1616,866,750,908883.0,484628.0,424254.0,18,6,12,3343,495,2848,1882577.0,277858.0,1604719.0,0.5596,0.5657,0.5613,0.5635
2023-05-29 12:55,93,59,34,10089,4018,6071,5675422.0,2257564.0,3417858.0,73,45,28,5397,3061,2336,3040040.0,1717912.0,1322128.0,0.5619,0.563,0.5612,0.566
2023-05-29 13:00,94,66,28,7599,4789,2810,4274298.0,2688676.0,1585622.0,78,55,23,6951,4330,2621,3908075.0,2430532.0,1477542.0,0.5614,0.5643,0.5613,0.5637
2023-05-29 13:05,52,37,15,3165,2418,747,1781503.0,1359506.0,421997.0,35,24,11,2690,2000,690,1514375.0,1122898.0,391476.0,0.5622,0.5649,0.5614,0.5674
2023-05-29 13:10,68,51,17,4594,3862,732,2577643.0,2167893.0,409750.0,49,37,12,4605,3890,715,2588057.0,2183640.0,404417.0,0.5613,0.5598,0.5613,0.5656
2023-05-29 13:15,59,46,13,4884,4166,718,2746660.0,2340090.0,406570.0,47,36,11,4539,4029,510,2548138.0,2260004.0,288134.0,0.5617,0.5663,0.5609,0.565
2023-05-29 13:20,68,44,24,2981,1954,1027,1680531.0,1098172.0,582358.0,38,28,10,2654,1710,944,1493569.0,956434.0,537134.0,0.562,0.567,0.5593,0.569
2023-05-29 13:25,43,27,16,1378,845,533,776210.0,475143.0,301066.0,23,12,11,1121,593,528,632846.0,332822.0,300024.0,0.5623,0.5649,0.5613,0.5682
2023-05-29 13:30,81,49,32,4343,1489,2854,2442367.0,834452.0,1607915.0,64,37,27,3896,1153,2743,2193541.0,647184.0,1546357.0,0.5604,0.5634,0.5613,0.5637
2023-05-29 13:35,50,39,11,752,673,79,421067.0,378528.0,42539.0,38,32,6,658,622,36,369678.0,349372.0,20305.0,0.5624,0.5385,0.5617,0.564
2023-05-29 13:40,86,48,38,7102,5174,1928,3999966.0,2910402.0,1089563.0,68,37,31,5357,3680,1677,3014867.0,2066594.0,948272.0,0.5625,0.5651,0.5616,0.5655
2023-05-29 13:45,61,32,29,2213,899,1314,1243530.0,501639.0,741891.0,44,18,26,2052,606,1446,1157168.0,339447.0,817720.0,0.558,0.5646,0.5601,0.5655
2023-05-29 13:50,74,41,33,4461,1667,2794,2514811.0,938625.0,1576186.0,66,36,30,6588,1814,4774,3707001.0,1016956.0,2690045.0,0.5631,0.5641,0.5606,0.5635
2023-05-29 13:55,92,48,44,7347,1984,5363,4132993.0,1111910.0,3021083.0,80,42,38,6706,1821,4885,3779024.0,1022365.0,2756659.0,0.5604,0.5633,0.5614,0.5643
2023-05-29 14:00,67,38,29,3166,923,2243,1783690.0,518412.0,1265278.0,53,27,26,3146,896,2250,1771708.0,502614.0,1269093.0,0.5617,0.5641,0.561,0.564
2023-05-29 14:05,74,35,39,4289,748,3541,2411022.0,416051.0,1994971.0,56,23,33,3979,712,3267,2237437.0,395823.0,1841613.0,0.5562,0.5634,0.5559,0.5637
2023-05-29 14:10,57,41,16,2132,1234,898,1192543.0,692253.0,500290.0,49,38,11,1770,1124,646,992069.0,628476.0,363592.0,0.561,0.5571,0.5591,0.5628
2023-05-29 14:15,485,225,260,40017,11410,28607,164990304.0,149138153.0,15852151.0,287,84,203,26408,6760,19648,157341047.0,146276818.0,11064229.0,13.0708,0.5541,21.6386,0.5631
2023-05-29 14:20,304,161,143,17954,5700,12254,10030598.0,3175701.0,6854897.0,174,56,118,14192,2666,11526,7957960.0,1476996.0,6480963.0,0.5571,0.5594,0.554,0.5623
2023-05-29 14:25,467,163,304,38326,3220,35106,21491715.0,1806396.0,19685319.0,368,87,281,37483,2755,34728,21025494.0,1534850.0,19490644.0,0.561,0.5607,0.5571,0.5612
2023-05-29 14:30,193,73,120,6428,990,5438,3590826.0,547209.0,3043617.0,137,27,110,5568,525,5043,3115476.0,292465.0,2823011.0,0.5527,0.5597,0.5571,0.5598
2023-05-29 14:35,215,123,92,8555,3953,4602,16660982.0,14082333.0,2578649.0,183,100,83,7893,3372,4521,16288199.0,13755623.0,2532576.0,3.5624,0.5603,4.0794,0.5602
2023-05-29 14:40,129,68,61,3962,1284,2678,2206760.0,715665.0,1491094.0,109,56,53,3770,1282,2488,2107559.0,714687.0,1392872.0,0.5574,0.5568,0.5575,0.5598
2023-05-29 14:45,211,104,107,13482,2298,11184,19446440.0,13156729.0,6289711.0,154,59,95,12511,1623,10888,18920919.0,12781394.0,6139524.0,5.7253,0.5624,7.8752,0.5639
2023-05-29 14:50,374,198,176,26197,8070,18127,38447720.0,28254494.0,10193226.0,348,182,166,25769,7794,17975,38209068.0,28100533.0,10108534.0,3.5012,0.5623,3.6054,0.5624
2023-05-29 14:55,136,41,95,11190,1833,9357,29962004.0,24776409.0,5185594.0,104,16,88,8726,638,8088,28644517.0,24108483.0,4536034.0,13.5169,0.5542,37.7876,0.5608
2023-05-29 15:00,261,94,167,21331,1545,19786,11945270.0,866931.0,11078339.0,208,47,161,20829,1027,19802,11655366.0,568384.0,11086981.0,0.5611,0.5599,0.5534,0.5599
2023-05-29 15:05,173,124,49,10604,6771,3833,17801425.0,15652385.0,2149039.0,154,110,44,9781,5901,3880,17338548.0,15163440.0,2175108.0,2.3117,0.5607,2.5696,0.5606
2023-05-29 15:10,303,248,55,21008,14780,6228,23661957.0,20153129.0,3508828.0,275,226,49,20812,14818,5994,23507569.0,20130082.0,3377486.0,1.3635,0.5634,1.3585,0.5635
2023-05-29 15:15,277,91,186,18872,2056,16816,22451371.0,13008404.0,9442967.0,230,50,180,18419,1803,16616,22215609.0,12881522.0,9334086.0,6.327,0.5615,7.1445,0.5618
2023-05-29 15:20,199,48,151,10775,1096,9679,6036302.0,611847.0,5424455.0,182,33,149,10743,930,9813,6020289.0,518815.0,5501474.0,0.5583,0.5604,0.5579,0.5606
2023-05-29 15:25,252,37,215,17125,1104,16021,9595586.0,614112.0,8981473.0,227,15,212,16526,873,15653,9263537.0,486976.0,8776560.0,0.5563,0.5606,0.5578,0.5607
2023-05-29 15:30,261,46,215,29018,2453,26565,16320339.0,1365930.0,14954408.0,233,23,210,27367,1044,26323,15399840.0,582253.0,14817586.0,0.5568,0.5629,0.5577,0.5629
2023-05-29 15:35,876,32,844,176214,383,175831,99317654.0,218065.0,99099589.0,847,9,838,175634,194,175440,99010900.0,108206.0,98902693.0,0.5694,0.5636,0.5578,0.5637
2023-05-29 15:40,1035,74,961,200090,2015,198075,112598706.0,1128891.0,111469814.0,1025,68,957,199864,1895,197969,112463127.0,1057893.0,111405233.0,0.5602,0.5628,0.5583,0.5627
2023-05-29 15:45,48,29,19,3483,1302,2181,1947013.0,724028.0,1222985.0,37,19,18,2639,491,2148,1483730.0,273664.0,1210066.0,0.5561,0.5607,0.5574,0.5633
2023-05-29 15:50,36,22,14,174,102,72,99259.0,57095.0,42164.0,16,3,13,105,51,54,58645.0,26546.0,32098.0,0.5598,0.5856,0.5205,0.5944
2023-05-29 15:55,132,39,93,12032,1276,10756,54145774.0,48214295.0,5931479.0,96,15,81,10670,1117,9553,53491644.0,48126108.0,5365535.0,37.7855,0.5515,43.0851,0.5617
2023-05-29 16:00,81,27,54,3641,179,3462,2624335.0,99189.0,2525145.0,54,7,47,3505,117,3388,5480846.0,64347.0,5416498.0,0.5541,0.7294,0.55,1.5987
2023-05-29 16:05,59,42,17,937,735,202,12399511.0,12286616.0,112895.0,29,12,17,667,362,305,12248595.0,12077365.0,171229.0,16.7165,0.5589,33.3629,0.5614
2023-05-29 16:10,51,36,15,1027,584,443,568711.0,321976.0,246735.0,24,11,13,507,82,425,283047.0,45620.0,237426.0,0.5513,0.557,0.5564,0.5586
2023-05-29 16:15,70,27,43,3116,110,3006,1742629.0,61704.0,1680924.0,45,10,35,2917,53,2864,1630985.0,29487.0,1601497.0,0.5609,0.5592,0.5564,0.5592
2023-05-29 16:20,40,23,17,1315,154,1161,734947.0,86145.0,648801.0,25,10,15,1140,80,1060,636737.0,44393.0,592344.0,0.5594,0.5588,0.5549,0.5588
2023-05-29 16:25,34,26,8,560,343,217,312101.0,190787.0,121314.0,14,9,5,264,56,208,147425.0,31152.0,116273.0,0.5562,0.5591,0.5563,0.559
2023-05-29 16:30,47,20,27,1022,407,615,567357.0,222632.0,344725.0,35,14,21,806,242,564,449314.0,132052.0,317261.0,0.547,0.5605,0.5457,0.5625
2023-05-29 16:35,36,18,18,839,107,732,476368.0,65407.0,410961.0,12,4,8,485,20,465,272233.0,10672.0,261560.0,0.6113,0.5614,0.5336,0.5625
2023-05-29 16:40,292,34,258,28894,505,28389,16051702.0,278753.0,15772949.0,256,8,248,27695,154,27541,15461640.0,83869.0,15377771.0,0.552,0.5556,0.5446,0.5584
2023-05-29 16:45,123,39,84,8378,783,7595,4718740.0,467262.0,4251478.0,101,23,78,7730,357,7373,4325932.0,198503.0,4127428.0,0.5968,0.5598,0.556,0.5598
2023-05-29 16:50,47,31,16,2017,772,1245,1121625.0,431869.0,689756.0,33,19,14,1499,394,1105,831914.0,211714.0,620200.0,0.5594,0.554,0.5373,0.5613
2023-05-29 16:55,51,25,26,2699,479,2220,1512382.0,266889.0,1245493.0,41,17,24,2634,429,2205,1474480.0,238436.0,1236043.0,0.5572,0.561,0.5558,0.5606
2023-05-29 17:00,79,63,16,2494,1779,715,1390687.0,989743.0,400943.0,62,51,11,2416,1640,776,1347894.0,912401.0,435492.0,0.5563,0.5608,0.5563,0.5612
2023-05-29 17:05,97,36,61,3624,510,3114,2023273.0,284302.0,1738970.0,67,13,54,2858,377,2481,1596812.0,209744.0,1387068.0,0.5575,0.5584,0.5564,0.5591
2023-05-29 17:10,173,28,145,6363,401,5962,3552152.0,225050.0,3327101.0,143,6,137,6336,112,6224,3546981.0,62083.0,3484897.0,0.5612,0.5581,0.5543,0.5599
2023-05-29 17:15,215,57,158,14237,1136,13101,19768320.0,12503217.0,7265103.0,157,16,141,12551,566,11985,18886009.0,12187662.0,6698347.0,11.0064,0.5545,21.533,0.5589
2023-05-29 17:20,112,54,58,4571,1639,2932,14429741.0,12795966.0,1633774.0,72,28,44,4303,1155,3148,14271442.0,12515094.0,1756347.0,7.8072,0.5572,10.8356,0.5579
2023-05-29 17:25,67,39,28,2356,853,1503,13196904.0,12363560.0,833344.0,29,15,14,1727,403,1324,12843683.0,12100292.0,743390.0,14.4942,0.5545,30.0255,0.5615
2023-05-29 17:30,81,48,33,4067,1238,2829,14155485.0,12564441.0,1591044.0,66,35,31,3541,1169,2372,13852662.0,12524970.0,1327692.0,10.149,0.5624,10.7143,0.5597
2023-05-29 17:35,50,25,25,1366,351,1015,762764.0,195190.0,567574.0,33,19,14,771,439,332,429749.0,243960.0,185788.0,0.5561,0.5592,0.5557,0.5596
2023-05-29 17:40,66,56,10,6412,6220,192,3280066.0,3172251.0,107815.0,52,45,7,2014,1104,910,1130145.0,613332.0,516812.0,0.51,0.5615,0.5556,0.5679
2023-05-29 17:45,98,74,24,2714,1538,1176,1511480.0,852870.0,658609.0,92,66,26,3153,1464,1689,1757083.0,811610.0,945472.0,0.5545,0.56,0.5544,0.5598
2023-05-29 17:50,92,67,25,2813,1255,1558,1571939.0,699807.0,872132.0,70,51,19,2129,1188,941,1195326.0,660333.0,534993.0,0.5576,0.5598,0.5558,0.5685
2023-05-29 17:55,82,50,32,1954,698,1256,1083960.0,385785.0,698174.0,50,28,22,1467,479,988,814984.0,263870.0,551114.0,0.5527,0.5559,0.5509,0.5578
2023-05-29 18:00,114,53,61,7390,2686,4704,4117780.0,1530049.0,2587731.0,71,28,43,4774,1259,3515,2658697.0,687162.0,1971535.0,0.5696,0.5501,0.5458,0.5609
2023-05-29 18:05,45,23,22,1049,203,846,589045.0,116857.0,472187.0,24,3,21,958,106,852,534395.0,58862.0,475533.0,0.5757,0.5581,0.5553,0.5581
2023-05-29 18:10,59,32,27,3697,1987,1710,2060159.0,1102396.0,957762.0,31,10,21,2019,377,1642,1126926.0,207299.0,919627.0,0.5548,0.5601,0.5499,0.5601
2023-05-29 18:15,71,31,40,5115,1697,3418,2851891.0,944770.0,1907121.0,42,13,29,2692,213,2479,1502915.0,118177.0,1384737.0,0.5567,0.558,0.5548,0.5586
2023-05-29 18:20,41,22,19,1958,333,1625,1101085.0,185470.0,915615.0,23,10,13,949,468,481,530343.0,258052.0,272291.0,0.557,0.5635,0.5514,0.5661
2023-05-29 18:25,102,50,52,4922,699,4223,2751967.0,392348.0,2359618.0,84,37,47,4755,530,4225,2655758.0,294673.0,2361085.0,0.5613,0.5588,0.556,0.5588
2023-05-29 18:30,57,22,35,2865,409,2456,1599770.0,227712.0,1372058.0,45,11,34,2952,357,2595,1646900.0,197288.0,1449611.0,0.5568,0.5587,0.5526,0.5586
2023-05-29 18:35,101,30,71,8762,3638,5124,4911067.0,2024937.0,2886130.0,85,21,64,7772,2455,5317,4366208.0,1364785.0,3001422.0,0.5566,0.5633,0.5559,0.5645
2023-05-30 10:00,1839,1107,732,118135,63804,54331,101233980.0,71071937.0,30162043.0,1431,863,568,84998,46131,38867,77071245.0,55351488.0,21719757.0,1.1139,0.5552,1.1999,0.5588
2023-05-30 10:05,2664,1044,1620,298945,69724,229221,201990793.0,74093373.0,127897419.0,2516,950,1566,291364,64132,227232,192257421.0,65485913.0,126771508.0,1.0627,0.558,1.0211,0.5579
2023-05-30 10:10,2224,487,1737,243823,12692,231131,136053565.0,7018920.0,129034644.0,2151,437,1714,242568,11710,230858,135355782.0,6473520.0,128882262.0,0.553,0.5583,0.5528,0.5583
2023-05-30 10:15,619,230,389,40652,8956,31696,22693872.0,4980392.0,17713479.0,563,188,375,32538,4311,28227,18153295.0,2379732.0,15773563.0,0.5561,0.5589,0.552,0.5588
2023-05-30 10:20,692,196,496,19549,7099,12450,46499919.0,39556164.0,6943754.0,613,144,469,18678,6302,12376,46019825.0,39118239.0,6901586.0,5.5721,0.5577,6.2073,0.5577
2023-05-30 10:25,369,176,193,8769,4248,4521,4854373.0,2332678.0,2521694.0,258,123,135,7878,3712,4166,4376814.0,2056003.0,2320811.0,0.5491,0.5578,0.5539,0.5571
2023-05-30 10:30,610,249,361,16807,7842,8965,9368030.0,4353899.0,5014131.0,562,217,345,15620,7318,8302,8680078.0,4052636.0,4627442.0,0.5552,0.5593,0.5538,0.5574
2023-05-30 10:35,417,215,202,14022,6335,7687,19644223.0,15386475.0,4257747.0,335,164,171,11078,4554,6524,18047727.0,14401951.0,3645775.0,2.4288,0.5539,3.1625,0.5588
2023-05-30 10:40,471,243,228,19371,9175,10196,22768706.0,17059602.0,5709104.0,406,203,203,16590,7266,9324,21120281.0,15902851.0,5217430.0,1.8594,0.5599,2.1887,0.5596
2023-05-30 10:45,711,440,271,25383,18018,7365,14115367.0,9996162.0,4119205.0,652,404,248,24460,17502,6958,13599772.0,9705991.0,3893781.0,0.5548,0.5593,0.5546,0.5596
2023-05-30 10:50,614,231,383,54468,14064,40404,42305377.0,19692096.0,22613281.0,574,205,369,54206,13769,40437,42153437.0,19520163.0,22633274.0,1.4002,0.5597,1.4177,0.5597
2023-05-30 10:55,643,276,367,28049,12308,15741,39232915.0,30411100.0,8821814.0,593,246,347,22736,8000,14736,36469215.0,28196744.0,8272470.0,2.4708,0.5604,3.5246,0.5614
2023-05-30 11:00,490,378,112,26276,15775,10501,38462946.0,32538050.0,5924895.0,448,352,96,24965,14982,9983,37721613.0,32091993.0,5629619.0,2.0626,0.5642,2.142,0.5639
2023-05-30 11:05,1560,255,1305,188867,5002,183865,117802692.0,14655606.0,103147086.0,1519,231,1288,186728,4656,182072,116624625.0,14462156.0,102162469.0,2.9299,0.561,3.1061,0.5611
2023-05-30 11:10,557,170,387,30811,1914,28897,17254568.0,1063384.0,16191184.0,517,139,378,30285,1544,28741,16959889.0,857991.0,16101898.0,0.5556,0.5603,0.5557,0.5602
2023-05-30 11:15,404,40,364,18912,736,18176,10575355.0,408866.0,10166488.0,383,29,354,18595,643,17952,10398290.0,357294.0,10040996.0,0.5555,0.5593,0.5557,0.5593
2023-05-30 11:20,304,34,270,5897,636,5261,3286179.0,353347.0,2932832.0,292,29,263,5279,589,4690,2941482.0,326163.0,2615318.0,0.5556,0.5575,0.5538,0.5576
2023-05-30 11:25,58,26,32,1929,1160,769,1061325.0,639134.0,422190.0,39,13,26,649,94,555,361589.0,52162.0,309426.0,0.551,0.549,0.5549,0.5575
2023-05-30 11:30,79,30,49,2455,227,2228,1370411.0,129162.0,1241249.0,59,14,45,2349,159,2190,1311528.0,87907.0,1223620.0,0.569,0.5571,0.5529,0.5587
2023-05-30 11:35,107,54,53,2456,916,1540,1811642.0,507909.0,1303732.0,72,34,38,1514,355,1159,843669.0,196776.0,646892.0,0.5545,0.8466,0.5543,0.5581
2023-05-30 11:40,168,85,83,5372,1440,3932,2987767.0,799243.0,2188524.0,141,71,70,5190,1358,3832,2888154.0,752396.0,2135757.0,0.555,0.5566,0.554,0.5573
2023-05-30 11:45,164,91,73,9049,2376,6673,5469377.0,1316809.0,4152568.0,134,67,67,8525,1952,6573,5185035.0,1080144.0,4104890.0,0.5542,0.6223,0.5534,0.6245
2023-05-30 11:50,426,73,353,23435,2479,20956,24984622.0,13274036.0,11710585.0,392,51,341,22429,1839,20590,24402367.0,12894391.0,11507976.0,5.3546,0.5588,7.0116,0.5589
2023-05-30 11:55,677,170,507,84824,2084,82740,47422868.0,1155515.0,46267352.0,655,153,502,84163,1894,82269,47054784.0,1047850.0,46006933.0,0.5545,0.5592,0.5532,0.5592
2023-05-30 12:00,100,45,55,6973,4405,2568,3704755.0,2293367.0,1411388.0,66,18,48,2986,588,2398,1661089.0,325273.0,1335816.0,0.5206,0.5496,0.5532,0.5571
2023-05-30 12:05,99,47,52,4519,1210,3309,2513213.0,667692.0,1845520.0,72,27,45,3583,662,2921,2442080.0,365798.0,2076282.0,0.5518,0.5577,0.5526,0.7108
2023-05-30 12:10,566,497,69,29794,25094,4700,28385534.0,25790765.0,2594768.0,537,481,56,28879,24751,4128,27903406.0,25598857.0,2304549.0,1.0278,0.5521,1.0343,0.5583
2023-05-30 12:15,403,347,56,22672,21734,938,12574825.0,12052385.0,522440.0,375,330,45,22314,21470,844,12372843.0,11902646.0,470196.0,0.5545,0.557,0.5544,0.5571
2023-05-30 12:20,151,128,23,3307,2789,518,1832613.0,1549280.0,283333.0,127,111,16,3237,2548,689,1798848.0,1412057.0,386790.0,0.5555,0.547,0.5542,0.5614
2023-05-30 12:25,315,251,64,23229,22110,1119,12878614.0,12263256.0,615357.0,283,232,51,22286,21599,687,12360472.0,11977454.0,383018.0,0.5546,0.5499,0.5545,0.5575
2023-05-30 12:30,292,58,234,4021,1745,2276,2232993.0,965458.0,1267535.0,261,39,222,3859,1612,2247,2144331.0,893231.0,1251099.0,0.5533,0.5569,0.5541,0.5568
2023-05-30 12:35,72,45,27,2936,2407,529,1629035.0,1334129.0,294905.0,62,36,26,2807,2262,545,1557347.0,1253697.0,303649.0,0.5543,0.5575,0.5542,0.5572
2023-05-30 12:40,119,68,51,4963,2407,2556,2754715.0,1336167.0,1418547.0,83,44,39,4176,1893,2283,2323356.0,1049880.0,1273476.0,0.5551,0.555,0.5546,0.5578
2023-05-30 12:45,48,25,23,2073,678,1395,1151069.0,375937.0,775132.0,34,15,19,2087,737,1350,1161825.0,408739.0,753086.0,0.5545,0.5557,0.5546,0.5578
2023-05-30 12:50,66,37,29,887,383,504,493843.0,213249.0,280593.0,42,21,21,821,344,477,457109.0,190961.0,266147.0,0.5568,0.5567,0.5551,0.558
2023-05-30 12:55,39,17,22,805,220,585,445803.0,121270.0,324532.0,29,13,16,1592,1103,489,880296.0,606886.0,273410.0,0.5512,0.5548,0.5502,0.5591
2023-05-30 13:00,87,58,29,4055,3170,885,2291077.0,1807209.0,483868.0,72,50,22,3362,2548,814,1867609.0,1413805.0,453803.0,0.5701,0.5467,0.5549,0.5575
2023-05-30 13:05,251,171,80,10759,8079,2680,17899944.0,16397238.0,1502706.0,240,163,77,10734,7776,2958,17855845.0,16197965.0,1657880.0,2.0296,0.5607,2.0831,0.5605
2023-05-30 13:10,263,144,119,9850,5463,4387,5488501.0,3038880.0,2449620.0,239,130,109,9187,5371,3816,5124718.0,2987156.0,2137562.0,0.5563,0.5584,0.5562,0.5602
2023-05-30 13:15,104,56,48,4090,2532,1558,2280086.0,1408150.0,871936.0,81,39,42,3476,2174,1302,1937365.0,1208643.0,728722.0,0.5561,0.5597,0.556,0.5597
2023-05-30 13:20,110,80,30,3010,2098,912,1675970.0,1165861.0,510109.0,92,67,25,2961,2129,832,1648269.0,1183925.0,464344.0,0.5557,0.5593,0.5561,0.5581
2023-05-30 13:25,111,53,58,3698,2109,1589,2064051.0,1173261.0,890789.0,92,44,48,2881,1974,907,1604721.0,1097883.0,506838.0,0.5563,0.5606,0.5562,0.5588
2023-05-30 13:30,510,355,155,30629,9817,20812,29144594.0,17415495.0,11729099.0,478,337,141,29670,8969,20701,28541128.0,16875126.0,11666002.0,1.774,0.5636,1.8815,0.5635
2023-05-30 13:35,462,285,177,29256,8460,20796,16462713.0,4771259.0,11691453.0,414,256,158,27199,7194,20005,15297369.0,4013169.0,11284199.0,0.564,0.5622,0.5578,0.5641
2023-05-30 13:40,285,189,96,14322,7852,6470,31779467.0,28142169.0,3637297.0,249,173,76,13129,7174,5955,31118203.0,27753826.0,3364377.0,3.5841,0.5622,3.8687,0.565
2023-05-30 13:45,280,199,81,12551,7839,4712,18895801.0,16252712.0,2643089.0,254,183,71,11448,7351,4097,18291978.0,15978023.0,2313955.0,2.0733,0.5609,2.1736,0.5648
2023-05-30 13:50,115,70,45,4907,2460,2447,2751103.0,1369888.0,1381215.0,77,50,27,4192,1976,2216,2356798.0,1100078.0,1256720.0,0.5569,0.5645,0.5567,0.5671
2023-05-30 13:55,53,37,16,1511,1056,455,845120.0,590185.0,254934.0,41,30,11,1600,1154,446,893547.0,643618.0,249929.0,0.5589,0.5603,0.5577,0.5604
2023-05-30 14:00,41,13,28,953,175,778,541018.0,106768.0,434250.0,22,6,16,850,71,779,479189.0,39457.0,439732.0,0.6101,0.5582,0.5557,0.5645
2023-05-30 14:05,316,269,47,6482,4304,2178,3638773.0,2415375.0,1223398.0,297,266,31,5572,3935,1637,3119746.0,2199923.0,919823.0,0.5612,0.5617,0.5591,0.5619
2023-05-30 14:10,70,32,38,3693,659,3034,2092088.0,368098.0,1723989.0,56,20,36,3711,515,3196,2086969.0,287311.0,1799657.0,0.5586,0.5682,0.5579,0.5631
2023-05-30 14:15,124,59,65,5057,2203,2854,14714624.0,13114460.0,1600164.0,97,44,53,4109,2061,2048,14174989.0,13025343.0,1149646.0,5.953,0.5607,6.3199,0.5614
2023-05-30 14:20,219,133,86,4980,3023,1957,2827161.0,1730576.0,1096584.0,191,118,73,4142,2403,1739,2316439.0,1341204.0,975235.0,0.5725,0.5603,0.5581,0.5608
2023-05-30 14:25,107,83,24,4422,3585,837,2476435.0,2002343.0,474092.0,92,73,19,4170,3418,752,2330651.0,1908057.0,422594.0,0.5585,0.5664,0.5582,0.562
2023-05-30 14:30,88,65,23,2303,2094,209,1282656.0,1170745.0,111910.0,70,54,16,2208,2114,94,1233018.0,1180252.0,52765.0,0.5591,0.5355,0.5583,0.5613
2023-05-30 14:35,23,10,13,2187,169,2018,1228230.0,93626.0,1134603.0,18,7,11,2129,183,1946,1196453.0,102256.0,1094197.0,0.554,0.5622,0.5588,0.5623
2023-05-30 14:40,87,55,32,2701,2420,281,13404351.0,13246564.0,157787.0,68,46,22,2375,2175,200,13202596.0,13090274.0,112322.0,5.4738,0.5615,6.0185,0.5616
2023-05-30 14:45,152,89,63,7559,4502,3057,4234153.0,2521438.0,1712715.0,132,83,49,6699,4174,2525,3747723.0,2328862.0,1418860.0,0.5601,0.5603,0.5579,0.5619
2023-05-30 14:50,1034,347,687,136066,34172,101894,88068622.0,30945493.0,57123128.0,1014,336,678,135102,33801,101301,87534110.0,30738058.0,56796052.0,0.9056,0.5606,0.9094,0.5607
2023-05-30 14:55,70,19,51,5109,559,4550,2868295.0,313984.0,2554311.0,57,12,45,4435,494,3941,2488309.0,275224.0,2213085.0,0.5617,0.5614,0.5571,0.5616
2023-05-30 15:00,193,56,137,9730,1958,7772,5446402.0,1082796.0,4363606.0,192,53,139,9539,1658,7881,5349457.0,924766.0,4424691.0,0.553,0.5615,0.5578,0.5614
2023-05-30 15:05,158,55,103,10156,762,9394,5716389.0,424519.0,5291870.0,149,51,98,9778,714,9064,5501867.0,398201.0,5103666.0,0.5571,0.5633,0.5577,0.5631
2023-05-30 15:10,27,11,16,576,84,492,328553.0,46647.0,281906.0,23,10,13,399,74,325,228173.0,41149.0,187024.0,0.5553,0.573,0.5561,0.5755
2023-05-30 15:15,194,71,123,8601,2190,6411,4815797.0,1224266.0,3591531.0,174,58,116,8108,2373,5735,4550630.0,1319123.0,3231506.0,0.559,0.5602,0.5559,0.5635
2023-05-30 15:20,898,208,690,135168,9325,125843,75734493.0,5209418.0,70525074.0,887,200,687,134980,9059,125921,75621083.0,5047577.0,70573506.0,0.5587,0.5604,0.5572,0.5605
2023-05-30 15:25,236,35,201,36587,738,35849,20498798.0,411072.0,20087726.0,230,31,199,36471,658,35813,20434368.0,366684.0,20067684.0,0.557,0.5603,0.5573,0.5603
2023-05-30 15:30,353,106,247,51637,1837,49800,28934906.0,1024700.0,27910205.0,340,100,240,51703,1823,49880,28971600.0,1015972.0,27955628.0,0.5578,0.5604,0.5573,0.5605
2023-05-30 15:35,725,126,599,116500,2724,113776,77163892.0,13393296.0,63770596.0,717,122,595,116262,2745,113517,77031243.0,13405489.0,63625753.0,4.9168,0.5605,4.8836,0.5605
2023-05-30 15:40,193,72,121,11451,1931,9520,6410597.0,1078485.0,5332111.0,183,67,116,11364,1955,9409,6358097.0,1088056.0,5270041.0,0.5585,0.5601,0.5566,0.5601
2023-05-30 15:45,618,87,531,170247,4777,165470,95431235.0,2659152.0,92772082.0,607,79,528,170142,4694,165448,95372192.0,2611022.0,92761170.0,0.5567,0.5607,0.5562,0.5607
2023-05-30 15:50,687,63,624,174899,954,173945,98062436.0,530551.0,97531885.0,673,52,621,174738,720,174018,97972775.0,401262.0,97571512.0,0.5561,0.5607,0.5573,0.5607
2023-05-30 15:55,1046,88,958,176672,864,175808,99026725.0,498455.0,98528269.0,1036,82,954,176475,558,175917,98901001.0,310809.0,98590191.0,0.5769,0.5604,0.557,0.5604
2023-05-30 16:00,838,24,814,113736,539,113197,63696812.0,301837.0,63394974.0,829,18,811,113945,465,113480,63811921.0,258212.0,63553708.0,0.56,0.56,0.5553,0.56
2023-05-30 16:05,301,87,214,27411,3300,24111,15337976.0,1838187.0,13499789.0,290,78,212,26777,3048,23729,14987188.0,1697240.0,13289947.0,0.557,0.5599,0.5568,0.5601
2023-05-30 16:10,582,378,204,27837,16949,10888,27444973.0,21334318.0,6110655.0,574,372,202,28463,17069,11394,27792213.0,21398460.0,6393753.0,1.2587,0.5612,1.2536,0.5612
2023-05-30 16:15,1036,739,297,79120,11214,67906,44431917.0,6258732.0,38173185.0,1021,732,289,78707,11204,67503,44194493.0,6250620.0,37943872.0,0.5581,0.5621,0.5579,0.5621
2023-05-30 16:20,1816,770,1046,307151,31001,276150,172471748.0,17298576.0,155173171.0,1807,765,1042,306689,30677,276012,172212937.0,17118638.0,155094299.0,0.558,0.5619,0.558,0.5619
2023-05-30 16:25,475,175,300,106289,16154,90135,59634321.0,9008106.0,50626214.0,463,166,297,106284,16248,90036,59632006.0,9060143.0,50571863.0,0.5576,0.5617,0.5576,0.5617
2023-05-30 16:30,2294,432,1862,267089,9332,257757,161367088.0,17070712.0,144296375.0,2265,416,1849,264976,8926,256050,160228227.0,16846803.0,143381424.0,1.8293,0.5598,1.8874,0.56
2023-05-30 16:35,4261,1208,3053,549172,93187,455985,318903006.0,63702880.0,255200125.0,4243,1201,3042,548694,92797,455897,318634235.0,63482444.0,255151790.0,0.6836,0.5597,0.6841,0.5597
2023-05-30 16:40,2344,730,1614,256020,39292,216728,143103663.0,21847953.0,121255709.0,2327,724,1603,255972,39323,216649,143077846.0,21865109.0,121212737.0,0.556,0.5595,0.556,0.5595
2023-05-30 16:45,1236,290,946,144376,26534,117842,80660210.0,14749667.0,65910542.0,1216,277,939,144530,26326,118204,80748231.0,14633350.0,66114881.0,0.5559,0.5593,0.5559,0.5593
2023-05-30 16:50,314,39,275,13554,1793,11761,7574638.0,996316.0,6578322.0,302,30,272,13157,1650,11507,7353666.0,917021.0,6436645.0,0.5557,0.5593,0.5558,0.5594
2023-05-30 16:55,34,19,15,719,463,256,384738.0,256198.0,128540.0,18,5,13,114,37,77,63444.0,20197.0,43246.0,0.5533,0.5021,0.5459,0.5616
2023-05-30 17:00,47,13,34,2150,527,1623,1199710.0,292444.0,907266.0,40,9,31,1991,556,1435,1110608.0,308284.0,802324.0,0.5549,0.559,0.5545,0.5591
2023-05-30 17:05,106,46,60,7644,4364,3280,16128661.0,14299746.0,1828914.0,101,43,58,7361,4549,2812,15974959.0,14403527.0,1571432.0,3.2768,0.5576,3.1663,0.5588
2023-05-30 17:10,534,19,515,16166,480,15686,9024815.0,265270.0,8759545.0,523,12,511,16235,438,15797,9062990.0,240853.0,8822137.0,0.5526,0.5584,0.5499,0.5585
2023-05-30 17:15,360,24,336,11107,316,10791,6194424.0,175474.0,6018949.0,346,14,332,10944,196,10748,6103835.0,108800.0,5995035.0,0.5553,0.5578,0.5551,0.5578
2023-05-30 17:20,194,33,161,11546,1612,9934,6425968.0,893873.0,5532095.0,184,27,157,10064,416,9648,5603966.0,230030.0,5373936.0,0.5545,0.5569,0.553,0.557
2023-05-30 17:25,724,178,546,73938,4330,69608,41371965.0,2477510.0,38894454.0,707,168,539,74265,4233,70032,41481332.0,2346742.0,39134590.0,0.5722,0.5588,0.5544,0.5588
2023-05-30 17:30,3510,462,3048,606569,19026,587543,362580328.0,34317591.0,328262737.0,3475,444,3031,605017,18937,586080,361709467.0,34263703.0,327445764.0,1.8037,0.5587,1.8094,0.5587
2023-05-30 17:35,2926,92,2834,518143,2113,516030,289449029.0,1171188.0,288277841.0,2907,84,2823,517483,2041,515442,289083031.0,1131896.0,287951135.0,0.5543,0.5586,0.5546,0.5586
2023-05-30 17:40,3615,152,3463,567296,4186,563110,316892536.0,2322390.0,314570146.0,3602,143,3459,566930,4163,562767,316690941.0,2309180.0,314381761.0,0.5548,0.5586,0.5547,0.5586
2023-05-30 17:45,1920,133,1787,283900,2558,281342,158408538.0,1418002.0,156990535.0,1900,124,1776,283568,2459,281109,158228633.0,1364077.0,156864556.0,0.5543,0.558,0.5547,0.558
2023-05-30 17:50,997,122,875,163365,2630,160735,91254990.0,1460946.0,89794044.0,987,114,873,163015,2321,160694,91056698.0,1288229.0,89768469.0,0.5555,0.5586,0.555,0.5586
2023-05-30 17:55,1561,253,1308,180650,6688,173962,100806314.0,3714475.0,97091839.0,1550,246,1304,180819,6497,174322,100913079.0,3608230.0,97304848.0,0.5554,0.5581,0.5554,0.5582
2023-05-30 18:00,1297,92,1205,182447,2357,180090,101813208.0,1308804.0,100504404.0,1278,83,1195,182663,2769,179894,101922280.0,1522576.0,100399704.0,0.5553,0.5581,0.5499,0.5581
2023-05-30 18:05,107,58,49,6300,2911,3389,3508841.0,1615934.0,1892907.0,101,54,47,6070,3204,2866,3377411.0,1778727.0,1598684.0,0.5551,0.5585,0.5552,0.5578
2023-05-30 18:10,406,121,285,29923,2417,27506,16720771.0,1341556.0,15379215.0,397,116,281,29818,2501,27317,16662199.0,1388102.0,15274097.0,0.5551,0.5591,0.555,0.5591
2023-05-30 18:15,405,74,331,78198,1233,76965,43688294.0,684757.0,43003537.0,389,67,322,76998,1157,75841,43018537.0,642568.0,42375968.0,0.5554,0.5587,0.5554,0.5587
2023-05-30 18:20,584,91,493,132133,1632,130501,73824003.0,906526.0,72917477.0,576,85,491,131978,1458,130520,73737384.0,809053.0,72928330.0,0.5555,0.5588,0.5549,0.5588
2023-05-30 18:25,1396,99,1297,276323,3024,273299,154190302.0,1677604.0,152512698.0,1386,93,1293,276834,2956,273878,154477864.0,1640151.0,152837712.0,0.5548,0.558,0.5549,0.5581
2023-05-30 18:30,124,33,91,15619,361,15258,8730640.0,201221.0,8529418.0,111,22,89,14796,220,14576,8269816.0,122146.0,8147669.0,0.5574,0.559,0.5552,0.559
2023-05-30 18:35,25,11,14,855,309,546,475534.0,170656.0,304878.0,24,7,17,1412,106,1306,789899.0,58879.0,731019.0,0.5523,0.5584,0.5555,0.5597
2023-05-31 10:00,2057,596,1461,211218,28691,182527,124003271.0,22295942.0,101707328.0,1792,441,1351,194857,16323,178534,113027755.0,13599076.0,99428678.0,0.7771,0.5572,0.8331,0.5569
2023-05-31 10:05,1103,244,859,70588,5404,65184,39104962.0,2885772.0,36219190.0,1020,199,821,67252,2975,64277,37338620.0,1638179.0,35700440.0,0.534,0.5556,0.5506,0.5554
2023-05-31 10:10,1727,427,1300,84430,4781,79649,46899490.0,2634749.0,44264740.0,1595,356,1239,83220,4442,78778,46215705.0,2452801.0,43762903.0,0.5511,0.5557,0.5522,0.5555
2023-05-31 10:15,1451,581,870,89179,47338,41841,85123686.0,61894275.0,23229411.0,1378,529,849,85561,44813,40748,73416422.0,50779732.0,22636689.0,1.3075,0.5552,1.1331,0.5555
2023-05-31 10:20,1263,973,290,91445,79216,12229,74470013.0,67606345.0,6863667.0,1183,942,241,87976,77787,10189,72414536.0,66706077.0,5708459.0,0.8534,0.5613,0.8575,0.5603
2023-05-31 10:25,895,791,104,65923,61735,4188,48433352.0,46068271.0,2365080.0,835,766,69,63874,61147,2727,47279575.0,45756151.0,1523423.0,0.7462,0.5647,0.7483,0.5586
2023-05-31 10:30,143,103,40,5624,4302,1322,3116022.0,2386972.0,729050.0,108,84,24,4799,3883,916,2664859.0,2152746.0,512112.0,0.5549,0.5515,0.5544,0.5591
2023-05-31 10:35,898,657,241,81013,34460,46553,57114253.0,30978976.0,26135276.0,878,648,230,80647,34156,46491,56909986.0,30816103.0,26093883.0,0.899,0.5614,0.9022,0.5613
2023-05-31 10:40,1507,698,809,125715,30366,95349,70051209.0,16828743.0,53222466.0,1474,679,795,125211,30233,94978,69793962.0,16753477.0,53040485.0,0.5542,0.5582,0.5541,0.5585
2023-05-31 10:45,2687,619,2068,419611,65064,354547,246127759.0,47891759.0,198235999.0,2670,607,2063,419021,64757,354264,245796354.0,47725025.0,198071328.0,0.7361,0.5591,0.737,0.5591
2023-05-31 10:50,3091,2774,317,411590,393523,18067,323582176.0,313447334.0,10134841.0,3059,2758,301,409705,392500,17205,322357053.0,312741522.0,9615530.0,0.7965,0.561,0.7968,0.5589
2023-05-31 10:55,3033,2840,193,376113,369996,6117,232321917.0,228900769.0,3421147.0,3001,2823,178,375346,369425,5921,231897144.0,228588857.0,3308287.0,0.6187,0.5593,0.6188,0.5587
2023-05-31 11:00,1127,862,265,116673,110202,6471,88459240.0,84850495.0,3608745.0,1095,841,254,116003,109772,6231,88084807.0,84605120.0,3479686.0,0.77,0.5577,0.7707,0.5584
2023-05-31 11:05,1562,1370,192,140070,135859,4211,77743914.0,75392507.0,2351406.0,1536,1356,180,139459,135427,4032,77392336.0,75139914.0,2252422.0,0.5549,0.5584,0.5548,0.5586
2023-05-31 11:10,387,219,168,17904,13165,4739,9941150.0,7291861.0,2649288.0,362,209,153,15470,12841,2629,8586693.0,7118986.0,1467707.0,0.5539,0.559,0.5544,0.5583
2023-05-31 11:15,1939,1849,90,276747,274672,2075,153139314.0,151981000.0,1158314.0,1923,1837,86,275234,274216,1018,152299066.0,151732499.0,566567.0,0.5533,0.5582,0.5533,0.5565
2023-05-31 11:20,1383,1320,63,205226,204245,981,113560216.0,113016491.0,543725.0,1378,1317,61,205191,204241,950,113544522.0,113015020.0,529502.0,0.5533,0.5543,0.5533,0.5574
2023-05-31 11:25,1852,1820,32,285108,284369,739,157772734.0,157360957.0,411777.0,1848,1817,31,284853,284193,660,157631920.0,157264121.0,367798.0,0.5534,0.5572,0.5534,0.5573
2023-05-31 11:30,899,841,58,128107,126254,1853,70893494.0,69862666.0,1030828.0,892,834,58,128537,126219,2318,71141142.0,69845214.0,1295928.0,0.5534,0.5563,0.5534,0.5591
2023-05-31 11:35,183,170,13,29676,29531,145,16423480.0,16342525.0,80955.0,165,155,10,29824,29690,134,16505022.0,16430071.0,74950.0,0.5534,0.5583,0.5534,0.5593
2023-05-31 11:40,47,29,18,1564,1328,236,12739275.0,12607333.0,131942.0,20,14,6,804,760,44,12320951.0,12296372.0,24578.0,9.4935,0.5591,16.1794,0.5586
2023-05-31 11:45,125,105,20,10536,10074,462,5821095.0,5564028.0,257067.0,100,87,13,5357,5154,203,2968719.0,2855537.0,113181.0,0.5523,0.5564,0.554,0.5575
2023-05-31 11:50,64,50,14,2522,2264,258,1400326.0,1255394.0,144932.0,55,45,10,2083,1977,106,1156140.0,1096796.0,59344.0,0.5545,0.5618,0.5548,0.5598
2023-05-31 11:55,57,34,23,1904,675,1229,1067949.0,382695.0,685254.0,44,27,17,2078,1000,1078,1150854.0,550686.0,600168.0,0.567,0.5576,0.5507,0.5567
2023-05-31 12:00,412,364,48,15463,14176,1287,8588458.0,7870120.0,718338.0,390,355,35,15446,14080,1366,8575415.0,7813782.0,761632.0,0.5552,0.5581,0.555,0.5576
2023-05-31 12:05,109,95,14,8589,8286,303,4761604.0,4589462.0,172142.0,102,89,13,8858,8616,242,4905733.0,4770782.0,134951.0,0.5539,0.5681,0.5537,0.5577
2023-05-31 12:10,894,830,64,108423,106119,2304,72032093.0,70755440.0,1276652.0,867,815,52,106086,104099,1987,70662167.0,69554886.0,1107281.0,0.6668,0.5541,0.6682,0.5573
2023-05-31 12:15,1273,1239,34,183636,181889,1747,101768151.0,100795783.0,972368.0,1260,1230,30,183043,181459,1584,101445571.0,100561073.0,884498.0,0.5542,0.5566,0.5542,0.5584
2023-05-31 12:20,120,74,46,6068,4539,1529,3368794.0,2516454.0,852339.0,107,63,44,5744,4354,1390,3188472.0,2413996.0,774476.0,0.5544,0.5574,0.5544,0.5572
2023-05-31 12:25,780,520,260,98140,94376,3764,54431992.0,52334921.0,2097071.0,767,513,254,97856,94157,3699,54274833.0,52213053.0,2061780.0,0.5545,0.5571,0.5545,0.5574
2023-05-31 12:30,1316,1193,123,252321,250875,1446,139844244.0,139038847.0,805396.0,1298,1182,116,251974,250650,1324,139639433.0,138901438.0,737995.0,0.5542,0.557,0.5542,0.5574
2023-05-31 12:35,1217,1000,217,191021,189016,2005,105872211.0,104754368.0,1117842.0,1211,997,214,191046,189046,2000,105887470.0,104772309.0,1115161.0,0.5542,0.5575,0.5542,0.5576
2023-05-31 12:40,1280,928,352,181277,178330,2947,100505393.0,98865131.0,1640262.0,1278,927,351,181559,178633,2926,100662759.0,99031575.0,1631183.0,0.5544,0.5566,0.5544,0.5575
2023-05-31 12:45,1019,852,167,184844,183896,948,102425370.0,101896722.0,528648.0,1012,846,166,184693,183756,937,102343090.0,101820553.0,522536.0,0.5541,0.5576,0.5541,0.5577
2023-05-31 12:50,265,173,92,27666,26724,942,15341572.0,14815329.0,526242.0,237,153,84,27438,26540,898,15210775.0,14709930.0,500845.0,0.5544,0.5586,0.5543,0.5577
2023-05-31 12:55,1043,941,102,79121,78096,1025,43887206.0,43315043.0,572163.0,1032,932,100,78608,77595,1013,43604850.0,43039519.0,565330.0,0.5546,0.5582,0.5547,0.5581
2023-05-31 13:00,129,96,33,12593,11755,838,6988165.0,6519951.0,468214.0,121,93,28,12297,11868,429,6822612.0,6582567.0,240045.0,0.5547,0.5587,0.5546,0.5595
2023-05-31 13:05,184,143,41,22235,20845,1390,12323634.0,11550042.0,773591.0,177,142,35,21916,21054,862,12146132.0,11664480.0,481652.0,0.5541,0.5565,0.554,0.5588
2023-05-31 13:10,235,214,21,24378,24117,261,13516189.0,13370614.0,145575.0,228,208,20,24177,23926,251,13406138.0,13266132.0,140005.0,0.5544,0.5578,0.5545,0.5578
2023-05-31 13:15,595,346,249,56877,51726,5151,31545292.0,28672358.0,2872934.0,582,340,242,56545,51631,4914,31361648.0,28621518.0,2740129.0,0.5543,0.5577,0.5543,0.5576
2023-05-31 13:20,1620,1199,421,238638,228278,10360,132404843.0,126623962.0,5780880.0,1610,1194,416,237604,227154,10450,131806605.0,125975325.0,5831279.0,0.5547,0.558,0.5546,0.558
2023-05-31 13:25,1077,750,327,158779,148948,9831,88130389.0,82649121.0,5481268.0,1071,745,326,158866,149091,9775,88178990.0,82728229.0,5450761.0,0.5549,0.5575,0.5549,0.5576
2023-05-31 13:30,514,404,110,69289,66271,3018,38485389.0,36802289.0,1683099.0,509,400,109,68950,66048,2902,38296222.0,36677811.0,1618411.0,0.5553,0.5577,0.5553,0.5577
2023-05-31 13:35,1072,808,264,148391,143763,4628,82403960.0,79825085.0,2578874.0,1064,805,259,148378,143781,4597,82395731.0,79833315.0,2562416.0,0.5553,0.5572,0.5552,0.5574
2023-05-31 13:40,1881,1214,667,220335,183627,36708,157933988.0,137509764.0,20424223.0,1857,1204,653,218588,183323,35265,156979803.0,137329717.0,19650086.0,0.7489,0.5564,0.7491,0.5572
2023-05-31 13:45,3262,1921,1341,389513,232225,157288,228426425.0,140730875.0,87695549.0,3251,1917,1334,388819,231674,157145,228024713.0,140408948.0,87615764.0,0.606,0.5575,0.6061,0.5575
2023-05-31 13:50,1076,779,297,127566,102043,25523,70830830.0,56597244.0,14233585.0,1064,773,291,127528,102116,25412,70814086.0,56637542.0,14176544.0,0.5546,0.5577,0.5546,0.5579
2023-05-31 13:55,1866,1459,407,249822,232219,17603,138616143.0,128795172.0,9820970.0,1865,1456,409,249608,231978,17630,138501236.0,128665304.0,9835931.0,0.5546,0.5579,0.5546,0.5579
2023-05-31 14:00,1325,778,547,154783,126683,28100,85944897.0,70268194.0,15676703.0,1321,777,544,155083,127027,28056,86105377.0,70452106.0,15653270.0,0.5547,0.5579,0.5546,0.5579
2023-05-31 14:05,1856,646,1210,188251,88532,99719,116560222.0,60950102.0,55610119.0,1845,643,1202,187796,88536,99260,116306417.0,60953319.0,55353098.0,0.6885,0.5577,0.6885,0.5577
2023-05-31 14:10,1235,673,562,132179,98009,34170,73350604.0,54318398.0,19032205.0,1229,667,562,131961,97939,34022,73229687.0,54279772.0,18949914.0,0.5542,0.557,0.5542,0.557
2023-05-31 14:15,1666,463,1203,129184,53102,76082,71806560.0,29425949.0,42380610.0,1660,462,1198,128781,53162,75619,71567012.0,29458286.0,42108726.0,0.5541,0.557,0.5541,0.5569
2023-05-31 14:20,1332,325,1007,113777,29120,84657,63265589.0,16135283.0,47130305.0,1312,312,1000,113823,29099,84724,63294743.0,16123474.0,47171269.0,0.5541,0.5567,0.5541,0.5568
2023-05-31 14:25,1216,802,414,116198,72784,43414,64516246.0,40334709.0,24181537.0,1205,791,414,116007,72751,43256,64409703.0,40316299.0,24093404.0,0.5542,0.557,0.5542,0.557
2023-05-31 14:30,1065,405,660,69230,32179,37051,38468494.0,17835887.0,20632606.0,1055,397,658,68884,31954,36930,38276724.0,17711424.0,20565299.0,0.5543,0.5569,0.5543,0.5569
2023-05-31 14:35,2374,1230,1144,246165,149965,96200,136677585.0,83109573.0,53568011.0,2366,1228,1138,246031,149864,96167,136604733.0,83054451.0,53550282.0,0.5542,0.5568,0.5542,0.5568
2023-05-31 14:40,2162,672,1490,197934,64215,133719,109997299.0,35563655.0,74433644.0,2152,663,1489,197982,64306,133676,110020304.0,35610814.0,74409490.0,0.5538,0.5566,0.5538,0.5566
2023-05-31 14:45,1376,891,485,166984,118047,48937,92717773.0,65446227.0,27271546.0,1374,887,487,167120,118070,49050,92793154.0,65459026.0,27334128.0,0.5544,0.5573,0.5544,0.5573
2023-05-31 14:50,775,693,82,88074,82947,5127,48891150.0,46032704.0,2858446.0,772,692,80,88079,82960,5119,48894065.0,46040068.0,2853997.0,0.555,0.5575,0.555,0.5575
2023-05-31 14:55,66,36,30,3538,2346,1192,1965054.0,1301580.0,663474.0,59,33,26,3414,2241,1173,1897388.0,1242312.0,655076.0,0.5548,0.5566,0.5544,0.5585
2023-05-31 15:00,904,449,455,69282,49062,20220,38491542.0,27213187.0,11278355.0,896,446,450,69204,48851,20353,38450164.0,27095255.0,11354908.0,0.5547,0.5578,0.5547,0.5579
2023-05-31 15:05,1732,1162,570,175820,129871,45949,97665192.0,72033273.0,25631918.0,1726,1159,567,175588,129862,45726,97533975.0,72028188.0,25505787.0,0.5547,0.5578,0.5547,0.5578
2023-05-31 15:10,2421,1327,1094,272318,167159,105159,163211002.0,104567698.0,58643304.0,2412,1320,1092,272494,167391,105103,163308116.0,104696026.0,58612089.0,0.6256,0.5577,0.6255,0.5577
2023-05-31 15:15,1870,586,1284,237941,80777,157164,132409487.0,44783879.0,87625608.0,1859,580,1279,237795,80742,157053,132327611.0,44764532.0,87563078.0,0.5544,0.5575,0.5544,0.5575
2023-05-31 15:20,1445,481,964,166662,60255,106407,92760479.0,33411124.0,59349354.0,1432,476,956,166353,59897,106456,92586885.0,33209932.0,59376953.0,0.5545,0.5578,0.5545,0.5578
2023-05-31 15:25,285,70,215,26883,4896,21987,14974490.0,2713916.0,12260574.0,265,66,199,26323,4672,21651,14665743.0,2591536.0,12074207.0,0.5543,0.5576,0.5547,0.5577
2023-05-31 15:30,447,157,290,30647,9100,21547,40686782.0,28795262.0,11891519.0,400,141,259,28472,8887,19585,39564498.0,28677745.0,10886752.0,3.1643,0.5519,3.2269,0.5559
2023-05-31 15:35,114,46,68,5221,1268,3953,2906373.0,706886.0,2199486.0,92,28,64,4735,753,3982,2632397.0,415697.0,2216700.0,0.5575,0.5564,0.5521,0.5567
2023-05-31 15:40,368,62,306,11419,2402,9017,6338798.0,1332883.0,5005914.0,360,54,306,11528,3137,8391,6410196.0,1736682.0,4673514.0,0.5549,0.5552,0.5536,0.557
2023-05-31 15:45,477,46,431,86505,629,85876,48140380.0,348452.0,47791928.0,465,43,422,86433,661,85772,48099647.0,366327.0,47733319.0,0.554,0.5565,0.5542,0.5565
2023-05-31 15:50,157,70,87,13359,4280,9079,7485625.0,2419274.0,5066350.0,137,57,80,12634,3427,9207,7037867.0,1898956.0,5138911.0,0.5653,0.558,0.5541,0.5582
2023-05-31 15:55,448,132,316,20535,12563,7972,11387725.0,6952192.0,4435532.0,441,128,313,20202,12266,7936,11206046.0,6787222.0,4418824.0,0.5534,0.5564,0.5533,0.5568
2023-05-31 16:00,536,76,460,10813,6184,4629,6002494.0,3427008.0,2575485.0,532,74,458,11118,6187,4931,6171836.0,3428587.0,2743249.0,0.5542,0.5564,0.5542,0.5563
2023-05-31 16:05,203,77,126,10325,4014,6311,5733860.0,2222451.0,3511408.0,196,72,124,10160,3957,6203,5641656.0,2190761.0,3450894.0,0.5537,0.5564,0.5536,0.5563
2023-05-31 16:10,430,87,343,11161,2633,8528,6203578.0,1459301.0,4744277.0,428,88,340,11188,2818,8370,6217985.0,1561622.0,4656363.0,0.5542,0.5563,0.5542,0.5563
2023-05-31 16:15,124,75,49,6808,5248,1560,3778095.0,2907913.0,870182.0,119,75,44,6785,5167,1618,3764615.0,2863125.0,901489.0,0.5541,0.5578,0.5541,0.5572
2023-05-31 16:20,320,104,216,20094,5644,14450,11179832.0,3152942.0,8026889.0,305,95,210,19284,5129,14155,10714984.0,2842170.0,7872813.0,0.5586,0.5555,0.5541,0.5562
2023-05-31 16:25,1196,1062,134,111872,105115,6757,62097880.0,58336412.0,3761467.0,1187,1057,130,110778,104373,6405,61438477.0,57873072.0,3565405.0,0.555,0.5567,0.5545,0.5567
2023-05-31 16:30,1225,1073,152,110476,106392,4084,61270211.0,58995743.0,2274467.0,1223,1071,152,110627,106230,4397,61354120.0,58905491.0,2448629.0,0.5545,0.5569,0.5545,0.5569
2023-05-31 16:35,640,612,28,51934,50350,1584,52529854.0,51679338.0,850516.0,622,601,21,50955,49633,1322,52023259.0,51281729.0,741530.0,1.0264,0.5369,1.0332,0.5609
2023-05-31 16:40,120,46,74,8425,2652,5773,4685143.0,1470879.0,3214264.0,110,39,71,8221,2482,5739,4569796.0,1374400.0,3195396.0,0.5546,0.5568,0.5537,0.5568
2023-05-31 16:45,397,278,119,31381,27972,3409,17402741.0,15499788.0,1902953.0,389,273,116,30897,27845,3052,17133237.0,15428639.0,1704597.0,0.5541,0.5582,0.5541,0.5585
2023-05-31 16:50,22,10,12,1062,907,155,589633.0,503369.0,86264.0,20,8,12,1354,872,482,751452.0,483194.0,268257.0,0.555,0.5565,0.5541,0.5566
2023-05-31 16:55,144,65,79,12638,5330,7308,7029510.0,2954695.0,4074815.0,131,61,70,11978,5045,6933,6662271.0,2797136.0,3865134.0,0.5544,0.5576,0.5544,0.5575
2023-05-31 17:00,85,46,39,4824,4220,604,2677438.0,2340808.0,336630.0,82,45,37,5270,4347,923,2925349.0,2410051.0,515298.0,0.5547,0.5573,0.5544,0.5583
2023-05-31 17:05,570,470,100,41793,39830,1963,23173853.0,22081151.0,1092702.0,568,464,104,42031,39845,2186,23306500.0,22088505.0,1217995.0,0.5544,0.5566,0.5544,0.5572
2023-05-31 17:10,712,577,135,50232,47463,2769,27850969.0,26306124.0,1544844.0,733,572,161,50421,47477,2944,27959475.0,26313848.0,1645627.0,0.5542,0.5579,0.5542,0.559
2023-05-31 17:15,37,11,26,1305,503,802,726479.0,278635.0,447843.0,33,9,24,1242,414,828,691610.0,229250.0,462359.0,0.5539,0.5584,0.5537,0.5584
2023-05-31 17:20,12,4,8,50,22,28,27854.0,12217.0,15637.0,7,1,6,27,1,26,14984.0,500.0,14484.0,0.5553,0.5585,0.5,0.5571
2023-05-31 17:25,23,8,15,460,53,407,259830.0,30387.0,229442.0,9,1,8,255,11,244,142061.0,6107.0,135954.0,0.5734,0.5637,0.5552,0.5572
2023-05-31 17:30,266,68,198,49099,11118,37981,27315799.0,6162953.0,21152845.0,247,57,190,48622,11036,37586,27067939.0,6115288.0,20952651.0,0.5543,0.5569,0.5541,0.5575
2023-05-31 17:35,471,119,352,61686,14589,47097,34338760.0,8084314.0,26254445.0,454,107,347,61449,14389,47060,34205981.0,7973229.0,26232751.0,0.5541,0.5575,0.5541,0.5574
2023-05-31 17:40,464,409,55,48442,45112,3330,26868834.0,25014139.0,1854694.0,456,402,54,48407,44877,3530,26853192.0,24884798.0,1968394.0,0.5545,0.557,0.5545,0.5576
2023-05-31 17:45,320,260,60,25819,22874,2945,14325378.0,12681086.0,1644292.0,317,257,60,25971,22885,3086,14408875.0,12685801.0,1723074.0,0.5544,0.5583,0.5543,0.5584
2023-05-31 17:50,108,20,88,9771,999,8772,5448230.0,553722.0,4894508.0,103,17,86,9653,979,8674,5383922.0,542706.0,4841216.0,0.5543,0.558,0.5543,0.5581
2023-05-31 17:55,39,16,23,4190,1655,2535,2334100.0,917402.0,1416697.0,35,13,22,4029,1646,2383,2245221.0,912084.0,1333136.0,0.5543,0.5589,0.5541,0.5594
2023-05-31 18:00,865,421,444,91552,32896,58656,50895295.0,18234776.0,32660519.0,863,418,445,92871,33644,59227,51615267.0,18634398.0,32980869.0,0.5543,0.5568,0.5539,0.5569
2023-05-31 18:05,649,572,77,75806,72350,3456,42049734.0,40123115.0,1926618.0,637,566,71,74809,72005,2804,41493304.0,39931110.0,1562193.0,0.5546,0.5575,0.5546,0.5571
2023-05-31 18:10,190,126,64,14035,11461,2574,7789868.0,6355571.0,1434296.0,192,127,65,13231,11505,1726,7341022.0,6379805.0,961217.0,0.5545,0.5572,0.5545,0.5569
2023-05-31 18:15,438,378,60,14758,14060,698,8193317.0,7803430.0,389886.0,416,362,54,14881,13677,1204,8271685.0,7585678.0,686006.0,0.555,0.5586,0.5546,0.5698
2023-05-31 18:20,1065,925,140,80956,77759,3197,44897416.0,43117845.0,1779570.0,1058,921,137,80449,77281,3168,44618705.0,42854936.0,1763769.0,0.5545,0.5566,0.5545,0.5567
2023-05-31 18:25,331,296,35,11357,10731,626,6306118.0,5957767.0,348350.0,320,288,32,11158,10779,379,6188711.0,5977536.0,211175.0,0.5552,0.5565,0.5546,0.5572
2023-05-31 18:30,128,63,65,9361,6214,3147,5206447.0,3445317.0,1761130.0,123,60,63,9448,6548,2900,5248005.0,3623519.0,1624486.0,0.5544,0.5596,0.5534,0.5602
2023-05-31 18:35,84,37,47,5095,2244,2851,2831749.0,1243462.0,1588286.0,76,26,50,5058,1625,3433,2822200.0,900496.0,1921704.0,0.5541,0.5571,0.5542,0.5598
2023-06-01 10:00,1557,479,1078,128908,37651,91257,83345800.0,32220304.0,51125496.0,1321,348,973,114193,26917,87276,66011715.0,17212793.0,48798921.0,0.8558,0.5602,0.6395,0.5591
2023-06-01 10:05,434,135,299,23425,6140,17285,13049844.0,3391737.0,9658107.0,304,69,235,20926,5053,15873,11650392.0,2799207.0,8851185.0,0.5524,0.5588,0.554,0.5576
2023-06-01 10:10,134,44,90,4870,1877,2993,14579108.0,12913529.0,1665579.0,120,32,88,4529,1773,2756,12018791.0,10481935.0,1536855.0,6.8799,0.5565,5.912,0.5576
2023-06-01 10:15,214,118,96,9623,6598,3025,5348126.0,3655647.0,1692479.0,159,83,76,8668,6279,2389,4798464.0,3471204.0,1327260.0,0.5541,0.5595,0.5528,0.5556
2023-06-01 10:20,244,142,102,11406,10267,1139,6297944.0,5660452.0,637491.0,126,91,35,4966,4198,768,2745547.0,2319061.0,426485.0,0.5513,0.5597,0.5524,0.5553
2023-06-01 10:25,181,105,76,5877,3031,2846,3238722.0,1675346.0,1563376.0,135,75,60,5160,2890,2270,2860686.0,1597387.0,1263298.0,0.5527,0.5493,0.5527,0.5565
2023-06-01 10:30,134,86,48,4818,1068,3750,2687014.0,583538.0,2103476.0,87,43,44,2515,714,1801,1394435.0,394418.0,1000017.0,0.5464,0.5609,0.5524,0.5553
2023-06-01 10:35,270,110,160,7155,1887,5268,3962765.0,1044506.0,2918259.0,183,57,126,6009,1492,4517,3330372.0,824792.0,2505580.0,0.5535,0.554,0.5528,0.5547
2023-06-01 10:40,1383,455,928,136305,15617,120688,111273738.0,44293314.0,66980423.0,1290,392,898,130694,13694,117000,108366784.0,43185909.0,65180874.0,2.8362,0.555,3.1536,0.5571
2023-06-01 10:45,1226,591,635,114845,22418,92427,87706172.0,36166397.0,51539775.0,1198,576,622,113807,21951,91856,87107229.0,35888825.0,51218404.0,1.6133,0.5576,1.635,0.5576
2023-06-01 10:50,655,563,92,17331,14433,2898,9729299.0,7980199.0,1749099.0,611,537,74,12889,11885,1004,7140558.0,6581531.0,559027.0,0.5529,0.6036,0.5538,0.5568
2023-06-01 10:55,636,569,67,17976,15549,2427,9974182.0,8622287.0,1351894.0,601,544,57,17275,15218,2057,9573434.0,8427646.0,1145788.0,0.5545,0.557,0.5538,0.557
2023-06-01 11:00,778,539,239,28627,21696,6931,15869396.0,12009408.0,3859988.0,735,511,224,28542,21581,6961,15827177.0,11948793.0,3878384.0,0.5535,0.5569,0.5537,0.5572
2023-06-01 11:05,569,537,32,11948,8447,3501,18562295.0,16560301.0,2001993.0,552,525,27,10896,8373,2523,17928996.0,16519380.0,1409616.0,1.9605,0.5718,1.9729,0.5587
2023-06-01 11:10,185,131,54,13225,7174,6051,7356959.0,3974876.0,3382083.0,164,120,44,12981,6994,5987,7219557.0,3872851.0,3346705.0,0.5541,0.5589,0.5537,0.559
2023-06-01 11:15,135,109,26,6950,5457,1493,3845235.0,3013781.0,831453.0,119,95,24,6753,5086,1667,3747178.0,2818024.0,929153.0,0.5523,0.5569,0.5541,0.5574
2023-06-01 11:20,362,267,95,17138,14275,2863,9508589.0,7913887.0,1594702.0,351,261,90,16890,14112,2778,9368387.0,7820978.0,1547409.0,0.5544,0.557,0.5542,0.557
2023-06-01 11:25,196,110,86,8293,4547,3746,4607821.0,2521003.0,2086818.0,180,98,82,8218,3889,4329,4573483.0,2155354.0,2418128.0,0.5544,0.5571,0.5542,0.5586
2023-06-01 11:30,59,31,28,2292,1390,902,1276092.0,774509.0,501582.0,47,23,24,1749,957,792,972292.0,530945.0,441347.0,0.5572,0.5561,0.5548,0.5573
2023-06-01 11:35,182,103,79,5507,3733,1774,3057253.0,2071481.0,985772.0,143,83,60,5408,4162,1246,3000651.0,2305664.0,694986.0,0.5549,0.5557,0.554,0.5578
2023-06-01 11:40,64,33,31,2444,1454,990,1367362.0,804215.0,563147.0,87,45,42,1891,1241,650,1046577.0,683901.0,362676.0,0.5531,0.5688,0.5511,0.558
2023-06-01 11:45,488,57,431,7590,2639,4951,4213700.0,1456544.0,2757156.0,466,45,421,7934,3112,4822,4402196.0,1716214.0,2685982.0,0.5519,0.5569,0.5515,0.557
2023-06-01 11:50,298,80,218,5827,2458,3369,3235504.0,1359103.0,1876400.0,256,41,215,5165,1843,3322,2871651.0,1021450.0,1850200.0,0.5529,0.557,0.5542,0.557
2023-06-01 11:55,100,74,26,5776,3935,1841,3205979.0,2180068.0,1025911.0,83,62,21,5385,3565,1820,2991101.0,1976839.0,1014262.0,0.554,0.5573,0.5545,0.5573
2023-06-01 12:00,25,14,11,297,88,209,165440.0,48567.0,116872.0,15,9,6,254,61,193,141467.0,33520.0,107947.0,0.5519,0.5592,0.5495,0.5593
2023-06-01 12:05,78,41,37,3681,2822,859,13917902.0,13446288.0,471613.0,62,35,27,3443,2568,875,13788863.0,13300844.0,488019.0,4.7648,0.549,5.1795,0.5577
2023-06-01 12:10,82,50,32,2603,1804,799,1438873.0,997276.0,441597.0,67,38,29,2232,1541,691,1237790.0,853355.0,384435.0,0.5528,0.5527,0.5538,0.5563
2023-06-01 12:15,164,65,99,6416,3255,3161,3566801.0,1807855.0,1758946.0,156,61,95,6309,3367,2942,3506094.0,1865003.0,1641090.0,0.5554,0.5565,0.5539,0.5578
2023-06-01 12:20,332,73,259,10631,3240,7391,5947632.0,1815017.0,4132615.0,317,62,255,13162,2955,10207,7358769.0,1635138.0,5723631.0,0.5602,0.5591,0.5533,0.5608
2023-06-01 12:25,109,31,78,3947,1823,2124,2178020.0,993732.0,1184287.0,100,26,74,2983,1412,1571,1655291.0,781521.0,873770.0,0.5451,0.5576,0.5535,0.5562
2023-06-01 12:30,106,57,49,8163,4231,3932,4544148.0,2345038.0,2199109.0,150,79,71,7172,3001,4171,3999341.0,1660414.0,2338927.0,0.5543,0.5593,0.5533,0.5608
2023-06-01 12:35,60,18,42,1073,344,729,597939.0,190186.0,407752.0,40,12,28,953,225,728,531348.0,124040.0,407308.0,0.5529,0.5593,0.5513,0.5595
2023-06-01 12:40,238,220,18,3305,2561,744,1828939.0,1422263.0,406675.0,231,217,14,2855,2646,209,1585240.0,1468886.0,116354.0,0.5554,0.5466,0.5551,0.5567
2023-06-01 12:45,29,15,14,415,71,344,230502.0,38899.0,191603.0,23,10,13,391,59,332,218255.0,32293.0,185962.0,0.5479,0.557,0.5473,0.5601
2023-06-01 12:50,44,20,24,961,199,762,541597.0,110118.0,431479.0,32,14,18,655,168,487,363515.0,92469.0,271046.0,0.5534,0.5662,0.5504,0.5566
2023-06-01 12:55,22,15,7,564,133,431,313563.0,73850.0,239713.0,12,7,5,420,95,325,233423.0,52600.0,180822.0,0.5553,0.5562,0.5537,0.5564
2023-06-01 13:00,40,20,20,2195,625,1570,1219358.0,346503.0,872854.0,33,17,16,2084,664,1420,1157303.0,367884.0,789419.0,0.5544,0.556,0.554,0.5559
2023-06-01 13:05,92,63,29,6608,3968,2640,3667679.0,2199817.0,1467862.0,74,52,22,6041,4070,1971,3352354.0,2255878.0,1096476.0,0.5544,0.556,0.5543,0.5563
2023-06-01 13:10,72,58,14,3857,2990,867,2136690.0,1653440.0,483250.0,49,38,11,2919,2100,819,1621839.0,1162789.0,459050.0,0.553,0.5574,0.5537,0.5605
2023-06-01 13:15,158,99,59,9090,4642,4448,5029455.0,2572517.0,2456938.0,124,71,53,8777,4478,4299,4876461.0,2481278.0,2395183.0,0.5542,0.5524,0.5541,0.5571
2023-06-01 13:20,148,85,63,6985,2257,4728,3891463.0,1239044.0,2652419.0,126,73,53,6782,2160,4622,3780138.0,1190789.0,2589348.0,0.549,0.561,0.5513,0.5602
2023-06-01 13:25,78,41,37,6927,3565,3362,3855738.0,1975059.0,1880678.0,60,35,25,6138,3543,2595,3413332.0,1962962.0,1450369.0,0.554,0.5594,0.554,0.5589
2023-06-01 13:30,87,52,35,3827,1578,2249,2122536.0,872585.0,1249951.0,79,44,35,3905,1590,2315,2166134.0,879228.0,1286906.0,0.553,0.5558,0.553,0.5559
2023-06-01 13:35,90,65,25,6187,3933,2254,3449047.0,2188842.0,1260205.0,78,55,23,6050,3889,2161,3363268.0,2154606.0,1208661.0,0.5565,0.5591,0.554,0.5593
2023-06-01 13:40,70,57,13,3614,3326,288,2002087.0,1842593.0,159494.0,57,50,7,3518,3269,249,1949456.0,1811072.0,138384.0,0.554,0.5538,0.554,0.5558
2023-06-01 13:45,112,70,42,8878,6218,2660,4922466.0,3445068.0,1477397.0,91,58,33,8306,5844,2462,4608738.0,3236449.0,1372289.0,0.554,0.5554,0.5538,0.5574
2023-06-01 13:50,220,95,125,19229,10345,8884,10677833.0,5728145.0,4949688.0,203,82,121,18578,10092,8486,10317949.0,5587833.0,4730115.0,0.5537,0.5571,0.5537,0.5574
2023-06-01 13:55,115,46,69,9201,3244,5957,5121533.0,1793093.0,3328439.0,99,35,64,8392,3059,5333,4671135.0,1693245.0,2977890.0,0.5527,0.5587,0.5535,0.5584
2023-06-01 14:00,69,44,25,9196,6036,3160,5111903.0,3340110.0,1771793.0,63,40,23,9194,6041,3153,5110768.0,3342677.0,1768090.0,0.5534,0.5607,0.5533,0.5608
2023-06-01 14:05,29,23,6,3563,3549,14,1972170.0,1964325.0,7845.0,22,17,5,4049,3502,547,2246133.0,1938297.0,307835.0,0.5535,0.5604,0.5535,0.5628
2023-06-01 14:10,73,41,32,6256,4089,2167,3473637.0,2261766.0,1211870.0,68,37,31,6334,4280,2054,3516739.0,2367560.0,1149179.0,0.5531,0.5592,0.5532,0.5595
2023-06-01 14:15,97,56,41,6699,2808,3891,3713186.0,1553630.0,2159556.0,85,51,34,6516,2764,3752,3620211.0,1528516.0,2091694.0,0.5533,0.555,0.553,0.5575
2023-06-01 14:20,40,22,18,1982,375,1607,1108052.0,206824.0,901228.0,25,14,11,1776,324,1452,993657.0,178542.0,815115.0,0.5515,0.5608,0.5511,0.5614
2023-06-01 14:25,66,39,27,6028,3752,2276,3345320.0,2076436.0,1268884.0,54,32,22,5244,3572,1672,2905705.0,1976384.0,929321.0,0.5534,0.5575,0.5533,0.5558
2023-06-01 14:30,36,22,14,3023,2116,907,1677108.0,1172927.0,504180.0,33,19,14,3116,2036,1080,1727198.0,1126961.0,600237.0,0.5543,0.5559,0.5535,0.5558
2023-06-01 14:35,67,40,27,4101,2613,1488,2270664.0,1446347.0,824316.0,56,33,23,3672,2302,1370,2035625.0,1274500.0,761125.0,0.5535,0.554,0.5536,0.5556
2023-06-01 14:40,236,221,15,4746,3240,1506,2632845.0,1794800.0,838044.0,230,217,13,4711,3236,1475,2611869.0,1792967.0,818902.0,0.554,0.5565,0.5541,0.5552
2023-06-01 14:45,258,224,34,7450,3985,3465,4132427.0,2207654.0,1924772.0,256,223,33,7100,3746,3354,3938140.0,2075360.0,1862779.0,0.554,0.5555,0.554,0.5554
2023-06-01 14:50,69,58,11,2492,2029,463,1379477.0,1122469.0,257008.0,39,30,9,2493,2069,424,1381066.0,1145462.0,235604.0,0.5532,0.5551,0.5536,0.5557
2023-06-01 14:55,31,22,9,582,413,169,322951.0,228843.0,94107.0,23,15,8,541,367,174,300098.0,203229.0,96868.0,0.5541,0.5569,0.5538,0.5567
2023-06-01 15:00,243,221,22,5397,3042,2355,2995296.0,1686339.0,1308956.0,243,222,21,5375,3053,2322,2982549.0,1692429.0,1290120.0,0.5544,0.5558,0.5543,0.5556
2023-06-01 15:05,13,7,6,46,39,7,25806.0,21721.0,4085.0,5,2,3,8,2,6,4417.0,1077.0,3339.0,0.5569,0.5836,0.5388,0.5566
2023-06-01 15:10,244,225,19,4157,3402,755,2304884.0,1885176.0,419707.0,234,225,9,4350,3531,819,2411170.0,1956055.0,455115.0,0.5541,0.5559,0.554,0.5557
2023-06-01 15:15,238,223,15,3557,2616,941,1974524.0,1450178.0,524346.0,227,218,9,3515,2630,885,1949588.0,1457893.0,491694.0,0.5543,0.5572,0.5543,0.5556
2023-06-01 15:20,60,38,22,1756,756,1000,973638.0,418648.0,554990.0,46,29,17,1512,671,841,839004.0,371569.0,467435.0,0.5538,0.555,0.5538,0.5558
2023-06-01 15:25,42,28,14,1455,839,616,806441.0,464532.0,341909.0,36,26,10,1534,886,648,850284.0,490557.0,359726.0,0.5537,0.555,0.5537,0.5551
2023-06-01 15:30,70,31,39,4032,1173,2859,2236337.0,649064.0,1587273.0,67,29,38,3769,990,2779,2091068.0,548127.0,1542940.0,0.5533,0.5552,0.5537,0.5552
2023-06-01 15:35,89,48,41,7167,3031,4136,3974983.0,1678125.0,2296857.0,72,35,37,7356,2857,4499,4095649.0,1581725.0,2513924.0,0.5537,0.5553,0.5536,0.5588
2023-06-01 15:40,42,22,20,6226,3085,3141,3461233.0,1708853.0,1752380.0,37,17,20,6201,2992,3209,3447221.0,1656976.0,1790244.0,0.5539,0.5579,0.5538,0.5579
2023-06-01 15:45,102,59,43,17371,6113,11258,9691342.0,3386740.0,6304601.0,89,48,41,16748,6059,10689,9342165.0,3355895.0,5986269.0,0.554,0.56,0.5539,0.56
2023-06-01 15:50,110,54,56,13334,2962,10372,7415608.0,1641007.0,5774601.0,103,51,52,13817,2953,10864,7698697.0,1636042.0,6062654.0,0.554,0.5567,0.554,0.558
2023-06-01 15:55,62,24,38,5836,1870,3966,3239313.0,1036620.0,2202693.0,56,20,36,5849,1839,4010,3245581.0,1018348.0,2227233.0,0.5543,0.5554,0.5538,0.5554
2023-06-01 16:00,123,50,73,11116,2176,8940,6191010.0,1204286.0,4986723.0,113,43,70,11472,2842,8630,6389656.0,1571639.0,4818017.0,0.5534,0.5578,0.553,0.5583
2023-06-01 16:05,247,71,176,54145,3420,50725,30078437.0,1892488.0,28185949.0,236,64,172,53720,3398,50322,29844804.0,1880018.0,27964786.0,0.5534,0.5557,0.5533,0.5557
2023-06-01 16:10,208,64,144,24520,1210,23310,13686680.0,669763.0,13016917.0,202,60,142,24523,1031,23492,13691970.0,570548.0,13121421.0,0.5535,0.5584,0.5534,0.5585
2023-06-01 16:15,527,120,407,49206,4039,45167,39183577.0,14106570.0,25077007.0,511,101,410,48382,3659,44723,38729754.0,13897086.0,24832668.0,3.4926,0.5552,3.7981,0.5553
2023-06-01 16:20,522,150,372,35682,7925,27757,19778822.0,4377480.0,15401342.0,509,137,372,35738,8029,27709,19803583.0,4428845.0,15374738.0,0.5524,0.5549,0.5516,0.5549
2023-06-01 16:25,109,66,43,8924,2757,6167,4983383.0,1522576.0,3460807.0,102,62,40,8124,2508,5616,4535523.0,1384494.0,3151029.0,0.5523,0.5612,0.552,0.5611
2023-06-01 16:30,233,144,89,6181,2755,3426,3437237.0,1525796.0,1911440.0,224,141,83,6150,2742,3408,3418941.0,1518020.0,1900920.0,0.5538,0.5579,0.5536,0.5578
2023-06-01 16:35,512,461,51,10975,7152,3823,17966592.0,15842663.0,2123929.0,477,442,35,8462,5840,2622,16571382.0,15114229.0,1457153.0,2.2151,0.5556,2.5881,0.5557
2023-06-01 16:40,69,40,29,1733,551,1182,962189.0,305416.0,656773.0,49,26,23,1663,471,1192,923166.0,260873.0,662292.0,0.5543,0.5556,0.5539,0.5556
2023-06-01 16:45,39,15,24,1953,267,1686,1088068.0,147841.0,940227.0,33,11,22,1907,262,1645,1059141.0,144483.0,914658.0,0.5537,0.5577,0.5515,0.556
2023-06-01 16:50,55,34,21,2107,785,1322,1172366.0,437803.0,734562.0,47,29,18,2240,951,1289,1242389.0,525996.0,716393.0,0.5577,0.5556,0.5531,0.5558
2023-06-01 16:55,105,60,45,4757,2575,2182,2634304.0,1422633.0,1211670.0,88,53,35,4340,2193,2147,2405079.0,1212395.0,1192683.0,0.5525,0.5553,0.5528,0.5555
2023-06-01 17:00,80,42,38,4199,1888,2311,2309108.0,1045276.0,1263832.0,70,35,35,4311,1750,2561,2396318.0,969266.0,1427051.0,0.5536,0.5469,0.5539,0.5572
2023-06-01 17:05,63,38,25,3104,1265,1839,1727031.0,701199.0,1025832.0,46,27,19,2604,1271,1333,1444338.0,703404.0,740933.0,0.5543,0.5578,0.5534,0.5558
2023-06-01 17:10,47,24,23,3245,1800,1445,1802534.0,996652.0,805881.0,41,23,18,3163,1782,1381,1758030.0,986639.0,771391.0,0.5537,0.5577,0.5537,0.5586
2023-06-01 17:15,81,21,60,15724,1630,14094,8793152.0,902432.0,7890719.0,77,17,60,16226,1696,14530,9086266.0,939108.0,8147158.0,0.5536,0.5599,0.5537,0.5607
2023-06-01 17:20,508,228,280,80819,19808,61011,80369370.0,46575760.0,33793609.0,478,205,273,78649,18673,59976,79269177.0,45947619.0,33321557.0,2.3514,0.5539,2.4606,0.5556
2023-06-01 17:25,184,91,93,20753,7472,13281,11515749.0,4134579.0,7381170.0,168,85,83,19265,6579,12686,10684899.0,3633639.0,7051260.0,0.5533,0.5558,0.5523,0.5558
2023-06-01 17:30,173,61,112,30370,4287,26083,28800531.0,14246942.0,14553588.0,165,56,109,29536,4263,25273,28343810.0,14233247.0,14110563.0,3.3233,0.558,3.3388,0.5583
2023-06-01 17:35,403,149,254,121650,18818,102832,67650818.0,10410286.0,57240532.0,393,140,253,122115,18667,103448,67906274.0,10319040.0,57587233.0,0.5532,0.5566,0.5528,0.5567
2023-06-01 17:40,155,66,89,35201,8065,27136,19577491.0,4461653.0,15115838.0,150,62,88,34867,8239,26628,19385622.0,4555925.0,14829696.0,0.5532,0.557,0.553,0.5569
2023-06-01 17:45,113,74,39,7043,4699,2344,3908510.0,2602883.0,1305627.0,97,64,33,6898,4477,2421,3828526.0,2475460.0,1353065.0,0.5539,0.557,0.5529,0.5589
2023-06-01 17:50,203,124,79,8347,4318,4029,16526499.0,14270942.0,2255557.0,196,114,82,8733,4296,4437,16737287.0,14254015.0,2483272.0,3.305,0.5598,3.318,0.5597
2023-06-01 17:55,140,126,14,7615,7122,493,4222760.0,3948279.0,274480.0,141,121,20,7583,7092,491,4204826.0,3931338.0,273487.0,0.5544,0.5568,0.5543,0.557
2023-06-01 18:00,133,79,54,7938,4894,3044,4406231.0,2712865.0,1693366.0,120,71,49,7609,4662,2947,4202912.0,2563778.0,1639134.0,0.5543,0.5563,0.5499,0.5562
2023-06-01 18:05,47,23,24,2315,583,1732,1286483.0,323394.0,963088.0,39,18,21,2323,578,1745,1291012.0,320566.0,970445.0,0.5547,0.5561,0.5546,0.5561
2023-06-01 18:10,51,39,12,2684,2147,537,1489672.0,1191218.0,298453.0,45,36,9,2280,1961,319,1265389.0,1087923.0,177466.0,0.5548,0.5558,0.5548,0.5563
2023-06-01 18:15,292,237,55,9200,8180,1020,5105242.0,4536617.0,568625.0,277,230,47,8998,7906,1092,4992939.0,4384027.0,608912.0,0.5546,0.5575,0.5545,0.5576
2023-06-01 18:20,133,101,32,5717,5231,486,3157202.0,2886550.0,270651.0,142,109,33,5841,5359,482,3233170.0,2964471.0,268699.0,0.5518,0.5569,0.5532,0.5575
2023-06-01 18:25,211,132,79,9566,7279,2287,5302952.0,4033586.0,1269366.0,198,122,76,9193,7004,2189,5098715.0,3880754.0,1217961.0,0.5541,0.555,0.5541,0.5564
2023-06-01 18:30,39,26,13,3217,2715,502,1786118.0,1506309.0,279809.0,41,27,14,3442,2912,530,1899750.0,1604327.0,295423.0,0.5548,0.5574,0.5509,0.5574
2023-06-01 18:35,335,275,60,8893,6804,2089,4933931.0,3774896.0,1159035.0,322,269,53,9171,6796,2375,5095136.0,3768155.0,1326981.0,0.5548,0.5548,0.5545,0.5587
2023-06-02 10:00,1033,471,562,60864,35630,25234,38014067.0,23867262.0,14146804.0,847,386,461,47256,25195,22061,28490409.0,16229552.0,12260856.0,0.6699,0.5606,0.6442,0.5558
2023-06-02 10:05,1145,536,609,68303,45302,23001,45842332.0,33004762.0,12837570.0,1085,536,549,62984,40362,22622,37282254.0,24677041.0,12605213.0,0.7285,0.5581,0.6114,0.5572
2023-06-02 10:10,293,147,146,12507,7001,5506,6927593.0,3859920.0,3067673.0,242,116,126,9937,4834,5103,5520050.0,2678962.0,2841088.0,0.5513,0.5572,0.5542,0.5567
2023-06-02 10:15,461,138,323,10785,2998,7787,17871794.0,13535383.0,4336411.0,330,81,249,9459,2529,6930,13171987.0,9310747.0,3861239.0,4.5148,0.5569,3.6816,0.5572
2023-06-02 10:20,450,76,374,13715,2291,11424,19506176.0,13147553.0,6358623.0,418,57,361,12591,1859,10732,18883611.0,12907372.0,5976238.0,5.7388,0.5566,6.9432,0.5569
2023-06-02 10:25,142,67,75,7471,3747,3724,4155459.0,2077324.0,2078135.0,112,51,61,7151,3779,3372,3971735.0,2094887.0,1876848.0,0.5544,0.558,0.5543,0.5566
2023-06-02 10:30,142,48,94,7145,1950,5195,3942567.0,1078752.0,2863815.0,124,33,91,5353,1674,3679,2973615.0,926195.0,2047419.0,0.5532,0.5513,0.5533,0.5565
2023-06-02 10:35,67,30,37,4240,2108,2132,2356131.0,1166510.0,1189621.0,46,18,28,3967,1818,2149,2202253.0,1007222.0,1195031.0,0.5534,0.558,0.554,0.5561
2023-06-02 10:40,69,28,41,2995,804,2191,1602814.0,445013.0,1157801.0,47,16,31,1195,377,818,663122.0,208587.0,454535.0,0.5535,0.5284,0.5533,0.5557
2023-06-02 10:45,98,52,46,5168,2357,2811,2869149.0,1299646.0,1569502.0,55,22,33,3568,1366,2202,1988892.0,755609.0,1233283.0,0.5514,0.5583,0.5532,0.5601
2023-06-02 10:50,96,59,37,3006,2193,813,1663797.0,1211973.0,451823.0,77,37,40,2676,1984,692,1481748.0,1096805.0,384943.0,0.5527,0.5557,0.5528,0.5563
2023-06-02 10:55,139,62,77,5085,1820,3265,2823378.0,1008695.0,1814683.0,114,51,63,4588,1589,2999,2546272.0,878999.0,1667273.0,0.5542,0.5558,0.5532,0.5559
2023-06-02 11:00,333,35,298,10343,1024,9319,5735139.0,564877.0,5170261.0,311,24,287,10138,929,9209,5622212.0,513040.0,5109172.0,0.5516,0.5548,0.5522,0.5548
2023-06-02 11:05,409,37,372,6992,1279,5713,3873196.0,704436.0,3168760.0,390,22,368,6771,1081,5690,3752094.0,595216.0,3156878.0,0.5508,0.5547,0.5506,0.5548
2023-06-02 11:10,292,50,242,6882,3612,3270,3815014.0,1991146.0,1823867.0,269,42,227,6717,3507,3210,3722040.0,1940206.0,1781834.0,0.5513,0.5578,0.5532,0.5551
2023-06-02 11:15,484,36,448,7639,1482,6157,4239171.0,819760.0,3419411.0,468,23,445,7361,1329,6032,4083008.0,735386.0,3347621.0,0.5531,0.5554,0.5533,0.555
2023-06-02 11:20,92,57,35,2676,1626,1050,1476941.0,893167.0,583774.0,68,38,30,2747,1560,1187,1518952.0,859083.0,659869.0,0.5493,0.556,0.5507,0.5559
2023-06-02 11:25,79,21,58,5632,1037,4595,3127964.0,574191.0,2553773.0,68,14,54,5539,929,4610,3075324.0,514018.0,2561306.0,0.5537,0.5558,0.5533,0.5556
2023-06-02 11:30,39,15,24,3002,491,2511,1667837.0,271793.0,1396044.0,29,8,21,2717,407,2310,1508959.0,225262.0,1283697.0,0.5536,0.556,0.5535,0.5557
2023-06-02 11:35,279,28,251,5718,1806,3912,3170582.0,998346.0,2172236.0,264,19,245,5339,1477,3862,2961929.0,816077.0,2145852.0,0.5528,0.5553,0.5525,0.5556
2023-06-02 11:40,298,41,257,6265,1435,4830,3480451.0,796048.0,2684402.0,273,27,246,6287,1418,4869,3491613.0,785936.0,2705677.0,0.5547,0.5558,0.5543,0.5557
2023-06-02 11:45,128,54,74,9484,2033,7451,5267898.0,1123077.0,4144820.0,120,48,72,9068,1700,7368,5034865.0,936521.0,4098344.0,0.5524,0.5563,0.5509,0.5562
2023-06-02 11:50,132,65,67,9023,3431,5592,5014868.0,1899488.0,3115379.0,116,54,62,7709,2419,5290,4299251.0,1340076.0,2959174.0,0.5536,0.5571,0.554,0.5594
2023-06-02 11:55,244,142,102,10960,6212,4748,17986831.0,15322605.0,2664226.0,214,127,87,7282,4098,3184,15916708.0,14143827.0,1772881.0,2.4666,0.5611,3.4514,0.5568
2023-06-02 12:00,732,410,322,37655,18018,19637,32900810.0,21891352.0,11009458.0,676,376,300,35007,16074,18933,31416011.0,20801911.0,10614100.0,1.215,0.5606,1.2941,0.5606
2023-06-02 12:05,477,172,305,58747,8251,50496,44911676.0,16466513.0,28445162.0,453,169,284,56582,7811,48771,43695906.0,16220792.0,27475113.0,1.9957,0.5633,2.0767,0.5633
2023-06-02 12:10,340,56,284,64435,1591,62844,36190815.0,891892.0,35298922.0,336,46,290,64586,1498,63088,36276683.0,834114.0,35442568.0,0.5606,0.5617,0.5568,0.5618
2023-06-02 12:15,340,217,123,20197,7931,12266,11311590.0,4414330.0,6897260.0,287,199,88,18883,7398,11485,10575014.0,4117958.0,6457056.0,0.5566,0.5623,0.5566,0.5622
2023-06-02 12:20,580,302,278,71136,20036,51100,39925871.0,11140909.0,28784961.0,549,283,266,70116,19292,50824,39362758.0,10729227.0,28633530.0,0.556,0.5633,0.5561,0.5634
2023-06-02 12:25,71,21,50,3059,196,2863,1717179.0,109280.0,1607899.0,57,14,43,2514,147,2367,1407135.0,81949.0,1325186.0,0.5576,0.5616,0.5575,0.5599
2023-06-02 12:30,729,179,550,158312,12676,145636,88607597.0,7016737.0,81590860.0,714,169,545,157326,11279,146047,88069321.0,6237616.0,81831705.0,0.5535,0.5602,0.553,0.5603
2023-06-02 12:35,145,63,82,7318,2837,4481,4096009.0,1583940.0,2512068.0,126,53,73,5798,1674,4124,3243780.0,933704.0,2310076.0,0.5583,0.5606,0.5578,0.5602
2023-06-02 12:40,311,246,65,5967,4840,1127,3342809.0,2710872.0,631936.0,289,237,52,6667,5641,1026,3719063.0,3144358.0,574705.0,0.5601,0.5607,0.5574,0.5601
2023-06-02 12:45,209,106,103,8985,5138,3847,5071422.0,2899097.0,2172324.0,174,93,81,7861,5010,2851,4392157.0,2793366.0,1598790.0,0.5642,0.5647,0.5576,0.5608
2023-06-02 12:50,85,38,47,2444,1752,692,13248143.0,12861973.0,386170.0,72,32,40,1976,1354,622,12979416.0,12630589.0,348827.0,7.3413,0.558,9.3284,0.5608
2023-06-02 12:55,67,18,49,3385,1763,1622,1888668.0,975072.0,913596.0,51,14,37,1348,722,626,751649.0,400845.0,350804.0,0.5531,0.5633,0.5552,0.5604
2023-06-02 13:00,107,44,63,2739,1636,1103,1533055.0,913392.0,619662.0,80,30,50,2529,1665,864,1412077.0,928024.0,484053.0,0.5583,0.5618,0.5574,0.5602
2023-06-02 13:05,60,36,24,4276,3291,985,2383096.0,1832526.0,550570.0,49,29,20,3884,2968,916,2162974.0,1649884.0,513090.0,0.5568,0.559,0.5559,0.5601
2023-06-02 13:10,70,41,29,3663,2921,742,2043119.0,1631631.0,411488.0,53,31,22,3186,2694,492,1779863.0,1502445.0,277418.0,0.5586,0.5546,0.5577,0.5639
2023-06-02 13:15,110,47,63,4886,3436,1450,2756614.0,1943070.0,813544.0,95,50,45,3894,2857,1037,2169968.0,1588674.0,581294.0,0.5655,0.5611,0.5561,0.5606
2023-06-02 13:20,82,26,56,4845,1924,2921,2713934.0,1075252.0,1638682.0,76,22,54,4595,1686,2909,2573698.0,941681.0,1632016.0,0.5589,0.561,0.5585,0.561
2023-06-02 13:25,189,118,71,6585,4926,1659,3703812.0,2768792.0,935019.0,143,96,47,5507,4359,1148,3073108.0,2428598.0,644509.0,0.5621,0.5636,0.5571,0.5614
2023-06-02 13:30,149,90,59,4326,2731,1595,14287401.0,13401207.0,886194.0,119,72,47,4191,2858,1333,14221307.0,13471336.0,749971.0,4.9071,0.5556,4.7136,0.5626
2023-06-02 13:35,95,57,38,4241,2572,1669,14228998.0,13314975.0,914023.0,70,43,27,3416,2191,1225,13789611.0,13101943.0,687667.0,5.1769,0.5476,5.9799,0.5614
2023-06-02 13:40,493,199,294,17797,5283,12514,9999331.0,2948137.0,7051194.0,468,192,276,18347,5954,12393,10305879.0,3319825.0,6986054.0,0.558,0.5635,0.5576,0.5637
2023-06-02 13:45,758,279,479,75987,13102,62885,42571075.0,7311526.0,35259548.0,736,268,468,75278,12705,62573,42191863.0,7090100.0,35101763.0,0.558,0.5607,0.5581,0.561
2023-06-02 13:50,2009,609,1400,174358,18658,155700,97806876.0,10424440.0,87382435.0,2005,602,1403,174975,18753,156222,98151182.0,10475008.0,87676173.0,0.5587,0.5612,0.5586,0.5612
2023-06-02 13:55,501,145,356,65662,5540,60122,36834197.0,3095684.0,33738512.0,481,138,343,65173,5350,59823,36558755.0,2988157.0,33570597.0,0.5588,0.5612,0.5585,0.5612
2023-06-02 14:00,124,68,56,5579,3388,2191,3122675.0,1893473.0,1229201.0,117,67,50,5794,3635,2159,3242581.0,2031110.0,1211470.0,0.5589,0.561,0.5588,0.5611
2023-06-02 14:05,95,48,47,3785,2726,1059,2107384.0,1523268.0,584116.0,87,43,44,3517,2652,865,1966871.0,1481676.0,485194.0,0.5588,0.5516,0.5587,0.5609
2023-06-02 14:10,87,28,59,3892,902,2990,2181594.0,504084.0,1677510.0,66,21,45,3746,781,2965,2100142.0,436488.0,1663653.0,0.5589,0.561,0.5589,0.5611
2023-06-02 14:15,1418,379,1039,180121,17134,162987,100950608.0,9560974.0,91389633.0,1417,372,1045,179858,17019,162839,100800818.0,9495200.0,91305617.0,0.558,0.5607,0.5579,0.5607
2023-06-02 14:20,2673,720,1953,367745,22910,344835,206152848.0,12784062.0,193368786.0,2662,714,1948,366854,22807,344047,205653419.0,12726709.0,192926709.0,0.558,0.5608,0.558,0.5608
2023-06-02 14:25,2150,595,1555,298035,15615,282420,167109908.0,8714745.0,158395162.0,2142,591,1551,298144,15754,282390,167171909.0,8792682.0,158379227.0,0.5581,0.5608,0.5581,0.5609
2023-06-02 14:30,1070,401,669,129054,16829,112225,72330525.0,9384838.0,62945687.0,1065,399,666,129636,16821,112815,72655189.0,9378574.0,63276615.0,0.5577,0.5609,0.5576,0.5609
2023-06-02 14:35,228,71,157,8386,976,7410,4706803.0,544237.0,4162565.0,216,61,155,8338,890,7448,4683326.0,495880.0,4187446.0,0.5576,0.5617,0.5572,0.5622
2023-06-02 14:40,1144,420,724,101997,11756,90241,57195861.0,6560057.0,50635803.0,1126,408,718,101378,11346,90032,56857351.0,6331226.0,50526124.0,0.558,0.5611,0.558,0.5612
2023-06-02 14:45,146,63,83,7377,3544,3833,4131034.0,1980469.0,2150564.0,140,59,81,7609,3643,3966,4260183.0,2034520.0,2225662.0,0.5588,0.5611,0.5585,0.5612
2023-06-02 14:50,54,30,24,3181,1501,1680,1779200.0,836987.0,942213.0,45,22,23,3191,1460,1731,1785086.0,813779.0,971306.0,0.5576,0.5608,0.5574,0.5611
2023-06-02 14:55,45,15,30,1759,349,1410,986859.0,194717.0,792141.0,35,14,21,1330,360,970,746034.0,200689.0,545344.0,0.5579,0.5618,0.5575,0.5622
2023-06-02 15:00,106,60,46,4761,2004,2757,2657743.0,1116602.0,1541140.0,88,50,38,4425,1734,2691,2473653.0,964192.0,1509461.0,0.5572,0.559,0.5561,0.5609
2023-06-02 15:05,99,30,69,4674,1008,3666,2608361.0,561884.0,2046476.0,89,25,64,4417,982,3435,2474288.0,548256.0,1926031.0,0.5574,0.5582,0.5583,0.5607
2023-06-02 15:10,350,96,254,13405,3586,9819,7497460.0,2001570.0,5495890.0,340,92,248,12616,3447,9169,7064150.0,1924212.0,5139937.0,0.5582,0.5597,0.5582,0.5606
2023-06-02 15:15,70,30,40,1790,916,874,999845.0,510906.0,488938.0,64,26,38,1926,1175,751,1077235.0,655494.0,421741.0,0.5578,0.5594,0.5579,0.5616
2023-06-02 15:20,366,91,275,11335,2780,8555,6345296.0,1551649.0,4793647.0,360,88,272,11893,2762,9131,6657274.0,1541204.0,5116070.0,0.5581,0.5603,0.558,0.5603
2023-06-02 15:25,502,420,82,9610,7069,2541,5374863.0,3949177.0,1425686.0,491,416,75,9395,6949,2446,5253174.0,3881584.0,1371589.0,0.5587,0.5611,0.5586,0.5607
2023-06-02 15:30,88,69,19,5972,4022,1950,3338083.0,2246060.0,1092022.0,78,63,15,5736,3720,2016,3207069.0,2077094.0,1129975.0,0.5584,0.56,0.5584,0.5605
2023-06-02 15:35,294,150,144,5890,2578,3312,3305360.0,1448898.0,1856461.0,274,137,137,5324,2160,3164,2981894.0,1206721.0,1775173.0,0.562,0.5605,0.5587,0.5611
2023-06-02 15:40,69,35,34,1427,486,941,799517.0,271483.0,528034.0,57,29,28,1440,510,930,807303.0,284904.0,522399.0,0.5586,0.5611,0.5586,0.5617
2023-06-02 15:45,136,53,83,5749,1099,4650,3224916.0,614391.0,2610524.0,124,48,76,4824,1041,3783,2712467.0,581742.0,2130724.0,0.559,0.5614,0.5588,0.5632
2023-06-02 15:50,41,20,21,3486,1538,1948,1952414.0,859594.0,1092820.0,36,18,18,3515,1463,2052,1968494.0,817349.0,1151144.0,0.5589,0.561,0.5587,0.561
2023-06-02 15:55,445,26,419,5665,1643,4022,3175651.0,921127.0,2254524.0,440,23,417,6081,1460,4621,3414178.0,815191.0,2598986.0,0.5606,0.5605,0.5584,0.5624
2023-06-02 16:00,80,41,39,5405,1841,3564,3028389.0,1029666.0,1998722.0,72,36,36,5358,1928,3430,3001772.0,1078115.0,1923657.0,0.5593,0.5608,0.5592,0.5608
2023-06-02 16:05,77,43,34,4170,1198,2972,2330401.0,670536.0,1659865.0,61,33,28,3897,1160,2737,2183329.0,648407.0,1534921.0,0.5597,0.5585,0.559,0.5608
2023-06-02 16:10,55,37,18,2552,1145,1407,1429682.0,640550.0,789132.0,49,33,16,2601,1129,1472,1456627.0,630951.0,825676.0,0.5594,0.5609,0.5589,0.5609
2023-06-02 16:15,62,33,29,3208,1514,1694,1811495.0,859781.0,951713.0,51,26,25,2904,1277,1627,1628212.0,714093.0,914119.0,0.5679,0.5618,0.5592,0.5618
2023-06-02 16:20,65,27,38,2375,507,1868,1331262.0,286388.0,1044874.0,52,21,31,2118,320,1798,1186255.0,177130.0,1009125.0,0.5649,0.5594,0.5535,0.5612
2023-06-02 16:25,291,130,161,16070,6426,9644,8954664.0,3589601.0,5365063.0,278,123,155,15276,6089,9187,8558752.0,3400609.0,5158143.0,0.5586,0.5563,0.5585,0.5615
2023-06-02 16:30,63,34,29,3624,1612,2012,2046524.0,917734.0,1128790.0,49,27,22,2467,1333,1134,1380793.0,744209.0,636584.0,0.5693,0.561,0.5583,0.5614
2023-06-02 16:35,74,26,48,4730,1121,3609,2601556.0,626741.0,1974814.0,58,20,38,3668,743,2925,2056290.0,415262.0,1641027.0,0.5591,0.5472,0.5589,0.561
2023-06-02 16:40,299,153,146,17195,10606,6589,9627355.0,5931884.0,3695470.0,292,145,147,17402,10469,6933,9742727.0,5855059.0,3887668.0,0.5593,0.5609,0.5593,0.5607
2023-06-02 16:45,143,66,77,6451,3495,2956,3611982.0,1953480.0,1658502.0,132,61,71,6376,3488,2888,3569419.0,1949471.0,1619948.0,0.5589,0.5611,0.5589,0.5609
2023-06-02 16:50,150,71,79,7616,3696,3920,4265442.0,2066550.0,2198891.0,149,70,79,7875,3768,4107,4412673.0,2106088.0,2306585.0,0.5591,0.5609,0.5589,0.5616
2023-06-02 16:55,94,43,51,4016,1777,2239,2247410.0,990825.0,1256584.0,94,41,53,4050,1726,2324,2268165.0,962188.0,1305976.0,0.5576,0.5612,0.5575,0.562
2023-06-02 17:00,282,22,260,5490,1285,4205,3072332.0,717510.0,2354822.0,273,17,256,4614,968,3646,2583574.0,540206.0,2043368.0,0.5584,0.56,0.5581,0.5604
2023-06-02 17:05,58,22,36,1158,252,906,639264.0,140964.0,498300.0,34,8,26,740,76,664,414669.0,42390.0,372279.0,0.5594,0.55,0.5578,0.5607
2023-06-02 17:10,52,22,30,2147,714,1433,1201776.0,398422.0,803353.0,44,15,29,2057,647,1410,1151357.0,360808.0,790548.0,0.558,0.5606,0.5577,0.5607
2023-06-02 17:15,24,9,15,987,53,934,553917.0,29914.0,524003.0,17,5,12,572,47,525,320610.0,26210.0,294399.0,0.5644,0.561,0.5577,0.5608
2023-06-02 17:20,121,42,79,7804,5362,2442,4359042.0,2998623.0,1360418.0,111,39,72,6664,4935,1729,3731106.0,2759672.0,971433.0,0.5592,0.5571,0.5592,0.5618
2023-06-02 17:25,182,56,126,10174,2297,7877,17513693.0,13161803.0,4351889.0,154,39,115,8835,1928,6907,16823337.0,12953038.0,3870299.0,5.73,0.5525,6.7184,0.5603
2023-06-02 17:30,70,26,44,3253,925,2328,1821916.0,517243.0,1304672.0,65,23,42,3201,895,2306,1792397.0,499435.0,1292962.0,0.5592,0.5604,0.558,0.5607
2023-06-02 17:35,76,17,59,3224,324,2900,1779994.0,183342.0,1596652.0,59,9,50,2745,145,2600,1538773.0,80913.0,1457859.0,0.5659,0.5506,0.558,0.5607
2023-06-02 17:40,42,11,31,1870,290,1580,1048599.0,161517.0,887081.0,39,8,31,1824,232,1592,1022896.0,129148.0,893747.0,0.557,0.5614,0.5567,0.5614
2023-06-02 17:45,109,51,58,10219,6584,3635,5697825.0,3664198.0,2033627.0,96,39,57,5479,1235,4244,3066861.0,688211.0,2378650.0,0.5565,0.5595,0.5573,0.5605
2023-06-02 17:50,123,58,65,7656,2480,5176,39923952.0,37021667.0,2902285.0,115,54,61,11611,7234,4377,42109509.0,39655471.0,2454038.0,14.9281,0.5607,5.4818,0.5607
2023-06-02 17:55,49,20,29,2823,356,2467,1581029.0,199031.0,1381998.0,45,18,27,2792,336,2456,1563872.0,187605.0,1376266.0,0.5591,0.5602,0.5583,0.5604
2023-06-02 18:00,85,38,47,1952,959,993,1093065.0,535113.0,557952.0,75,33,42,1909,949,960,1068060.0,528498.0,539562.0,0.558,0.5619,0.5569,0.562
2023-06-02 18:05,123,58,65,5231,931,4300,2935989.0,520079.0,2415909.0,114,54,60,4882,857,4025,2740749.0,478590.0,2262159.0,0.5586,0.5618,0.5584,0.562
2023-06-02 18:10,60,39,21,3311,594,2717,1873543.0,331546.0,1541996.0,51,33,18,3043,473,2570,1724637.0,264257.0,1460379.0,0.5582,0.5675,0.5587,0.5682
2023-06-02 18:15,129,78,51,6361,2148,4213,3570083.0,1198391.0,2371691.0,123,74,49,6416,2142,4274,3603531.0,1194919.0,2408612.0,0.5579,0.5629,0.5579,0.5635
2023-06-02 18:20,87,50,37,4639,850,3789,2599203.0,475266.0,2123937.0,84,46,38,4609,849,3760,2581921.0,473876.0,2108045.0,0.5591,0.5606,0.5582,0.5607
2023-06-02 18:25,89,47,42,2468,1070,1398,1382678.0,597358.0,785319.0,85,45,40,2646,966,1680,1486580.0,539294.0,947286.0,0.5583,0.5617,0.5583,0.5639
2023-06-02 18:30,189,126,63,9833,5976,3857,5526402.0,3365547.0,2160854.0,180,121,59,8506,4814,3692,4754454.0,2685207.0,2069247.0,0.5632,0.5602,0.5578,0.5605
2023-06-02 18:35,86,54,32,2339,1663,676,1306742.0,927224.0,379517.0,80,50,30,2277,1478,799,1273417.0,823148.0,450269.0,0.5576,0.5614,0.5569,0.5635
2023-06-05 10:00,2440,590,1850,363272,39490,323782,212298845.0,29467717.0,182831128.0,2219,473,1746,349266,29358,319908,199327325.0,18761304.0,180566021.0,0.7462,0.5647,0.6391,0.5644
2023-06-05 10:05,2093,351,1742,320271,15599,304672,192657368.0,20567758.0,172089609.0,2026,306,1720,317407,13856,303551,184706036.0,13278213.0,171427823.0,1.3185,0.5648,0.9583,0.5647
2023-06-05 10:10,490,155,335,13858,4340,9518,7785128.0,2420055.0,5365072.0,375,104,271,11889,3892,7997,6692865.0,2180650.0,4512215.0,0.5576,0.5637,0.5603,0.5642
2023-06-05 10:15,331,126,205,14622,5895,8727,20128703.0,15221229.0,4907474.0,281,98,183,13401,4700,8701,19407248.0,14507813.0,4899434.0,2.5821,0.5623,3.0868,0.5631
2023-06-05 10:20,1264,453,811,133528,23537,109991,75150403.0,13175254.0,61975149.0,1228,436,792,132713,22872,109841,74730237.0,12815337.0,61914900.0,0.5598,0.5635,0.5603,0.5637
2023-06-05 10:25,817,208,609,79800,15051,64749,44949469.0,8446815.0,36502654.0,770,187,583,78506,14504,64002,44203666.0,8131959.0,36071706.0,0.5612,0.5638,0.5607,0.5636
2023-06-05 10:30,509,226,283,32703,8231,24472,18401565.0,4619955.0,13781610.0,461,202,259,32211,8012,24199,18117436.0,4489286.0,13628150.0,0.5613,0.5632,0.5603,0.5632
2023-06-05 10:35,184,93,91,10529,2984,7545,5913352.0,1673837.0,4239514.0,135,71,64,9685,2813,6872,5448192.0,1575703.0,3872489.0,0.5609,0.5619,0.5602,0.5635
2023-06-05 10:40,300,155,145,24842,8075,16767,13980714.0,4546966.0,9433748.0,262,130,132,23546,7435,16111,13232446.0,4164469.0,9067977.0,0.5631,0.5626,0.5601,0.5628
2023-06-05 10:45,271,152,119,19973,7383,12590,11213779.0,4127561.0,7086218.0,243,138,105,19851,6999,12852,11161931.0,3923279.0,7238652.0,0.5591,0.5628,0.5605,0.5632
2023-06-05 10:50,165,78,87,12350,3008,9342,6979454.0,1693916.0,5285537.0,151,69,82,11988,2885,9103,6769352.0,1618412.0,5150940.0,0.5631,0.5658,0.561,0.5659
2023-06-05 10:55,140,60,80,9825,3916,5909,5322869.0,2015894.0,3306974.0,108,43,65,6451,1292,5159,3632480.0,724406.0,2908073.0,0.5148,0.5597,0.5607,0.5637
2023-06-05 11:00,124,73,51,5875,3871,2004,3311101.0,2193631.0,1117470.0,89,53,36,4598,3106,1492,2583912.0,1741670.0,842241.0,0.5667,0.5576,0.5607,0.5645
2023-06-05 11:05,209,137,72,10481,6594,3887,5898547.0,3705780.0,2192767.0,179,119,60,9872,6383,3489,5548484.0,3582267.0,1966217.0,0.562,0.5641,0.5612,0.5635
2023-06-05 11:10,574,485,89,14573,8863,5710,8187864.0,4981632.0,3206232.0,544,469,75,13297,8309,4988,7472123.0,4663818.0,2808304.0,0.5621,0.5615,0.5613,0.563
2023-06-05 11:15,172,101,71,7853,4287,3566,4454295.0,2432410.0,2021884.0,141,84,57,6582,4023,2559,3700713.0,2258493.0,1442219.0,0.5674,0.567,0.5614,0.5636
2023-06-05 11:20,169,92,77,5841,3184,2657,3290942.0,1794299.0,1496643.0,139,82,57,5292,3119,2173,2975150.0,1750409.0,1224740.0,0.5635,0.5633,0.5612,0.5636
2023-06-05 11:25,185,111,74,10149,5569,4580,5678417.0,3124736.0,2553681.0,156,91,65,9611,5213,4398,5401279.0,2925069.0,2476209.0,0.5611,0.5576,0.5611,0.563
2023-06-05 11:30,116,70,46,5277,2571,2706,2963700.0,1444310.0,1519390.0,93,56,37,5078,2516,2562,2855034.0,1411429.0,1443604.0,0.5618,0.5615,0.561,0.5635
2023-06-05 11:35,153,108,45,6159,4609,1550,3464318.0,2590080.0,874237.0,131,92,39,5459,3993,1466,3068431.0,2240997.0,827434.0,0.562,0.564,0.5612,0.5644
2023-06-05 11:40,153,92,61,7047,4684,2363,3960450.0,2629304.0,1331145.0,136,79,57,5786,4518,1268,3251237.0,2536061.0,715176.0,0.5613,0.5633,0.5613,0.564
2023-06-05 11:45,157,71,86,7471,2819,4652,4152469.0,1590773.0,2561696.0,126,58,68,5199,2449,2750,2920458.0,1371872.0,1548586.0,0.5643,0.5507,0.5602,0.5631
2023-06-05 11:50,166,95,71,4726,2685,2041,2652843.0,1509295.0,1143548.0,142,81,61,4226,2376,1850,2373638.0,1332099.0,1041538.0,0.5621,0.5603,0.5606,0.563
2023-06-05 11:55,151,69,82,5201,2630,2571,2916661.0,1475288.0,1441372.0,119,57,62,4198,2403,1795,2357314.0,1347327.0,1009987.0,0.5609,0.5606,0.5607,0.5627
2023-06-05 12:00,114,50,64,6679,2177,4502,3766126.0,1229962.0,2536164.0,106,41,65,8966,2178,6788,5047197.0,1220803.0,3826394.0,0.565,0.5633,0.5605,0.5637
2023-06-05 12:05,232,57,175,16605,3830,12775,9326884.0,2147116.0,7179768.0,216,50,166,16568,3575,12993,9321596.0,2004446.0,7317149.0,0.5606,0.562,0.5607,0.5632
2023-06-05 12:10,142,56,86,16803,2776,14027,9443296.0,1556520.0,7886775.0,129,53,76,16870,2820,14050,9492290.0,1579160.0,7913130.0,0.5607,0.5623,0.56,0.5632
2023-06-05 12:15,106,50,56,3546,1643,1903,1990803.0,919511.0,1071292.0,89,43,46,3150,1361,1789,1769826.0,762592.0,1007234.0,0.5597,0.5629,0.5603,0.563
2023-06-05 12:20,135,77,58,6985,3101,3884,3959836.0,1772812.0,2187023.0,101,52,49,5486,2075,3411,3092761.0,1163254.0,1929507.0,0.5717,0.5631,0.5606,0.5657
2023-06-05 12:25,116,54,62,5001,2551,2450,2816255.0,1435117.0,1381137.0,89,43,46,4453,2353,2100,2500437.0,1319265.0,1181172.0,0.5626,0.5637,0.5607,0.5625
2023-06-05 12:30,976,187,789,139281,10347,128934,90048421.0,17653979.0,72394442.0,950,157,793,136885,9886,126999,88753277.0,17398505.0,71354772.0,1.7062,0.5615,1.7599,0.5619
2023-06-05 12:35,3574,725,2849,573692,18184,555508,333691561.0,22000586.0,311690974.0,3525,685,2840,573860,17679,556181,333783851.0,21713781.0,312070070.0,1.2099,0.5611,1.2282,0.5611
2023-06-05 12:40,760,286,474,64146,5330,58816,36004386.0,2971082.0,33033303.0,746,275,471,63947,5141,58806,35892131.0,2865530.0,33026601.0,0.5574,0.5616,0.5574,0.5616
2023-06-05 12:45,528,101,427,69752,1385,68367,51056263.0,12645579.0,38410684.0,510,92,418,69379,1330,68049,50848766.0,12616948.0,38231818.0,9.1304,0.5618,9.4864,0.5618
2023-06-05 12:50,180,92,88,6148,1106,5042,3441261.0,617808.0,2823453.0,157,81,76,5844,975,4869,3279308.0,543640.0,2735667.0,0.5586,0.56,0.5576,0.5619
2023-06-05 12:55,3080,2149,931,348060,294719,53341,424275526.0,393711659.0,30563866.0,2364,1853,511,290252,261613,28639,390310633.0,373836644.0,16473989.0,1.3359,0.573,1.429,0.5752
2023-06-05 13:00,1768,1082,686,123541,68278,55263,118338794.0,86637957.0,31700836.0,1470,974,496,114817,63881,50936,113380148.0,84054739.0,29325408.0,1.2689,0.5736,1.3158,0.5757
2023-06-05 13:05,692,389,303,41220,18769,22451,35650597.0,22722546.0,12928050.0,535,307,228,33622,14946,18676,31179833.0,20409171.0,10770662.0,1.2106,0.5758,1.3655,0.5767
2023-06-05 13:10,547,402,145,20713,14279,6434,12008937.0,8327648.0,3681288.0,457,360,97,16395,11847,4548,9396695.0,6768038.0,2628656.0,0.5832,0.5722,0.5713,0.578
2023-06-05 13:15,813,566,247,27239,14094,13145,18814932.0,8112773.0,10702159.0,740,532,208,21643,12394,9249,12446718.0,7095312.0,5351406.0,0.5756,0.8142,0.5725,0.5786
2023-06-05 13:20,499,299,200,23750,14475,9275,25712633.0,20373706.0,5338927.0,428,260,168,15964,8589,7375,21045182.0,16788756.0,4256425.0,1.4075,0.5756,1.9547,0.5771
2023-06-05 13:25,347,127,220,17954,4607,13347,22006360.0,14502458.0,7503902.0,280,94,186,15664,3684,11980,20861135.0,13978788.0,6882347.0,3.1479,0.5622,3.7945,0.5745
2023-06-05 13:30,1865,516,1349,174684,20499,154185,135462465.0,47306532.0,88155932.0,1751,456,1295,170267,18629,151638,133103535.0,46235893.0,86867641.0,2.3077,0.5718,2.4819,0.5729
2023-06-05 13:35,2838,1640,1198,318817,140344,178473,241677994.0,139424377.0,102253617.0,2772,1595,1177,306317,129326,176991,234601958.0,133120106.0,101481852.0,0.9934,0.5729,1.0293,0.5734
2023-06-05 13:40,1300,984,316,116973,86909,30064,78745417.0,61501696.0,17243721.0,1228,943,285,121055,91796,29259,81019304.0,64231302.0,16788001.0,0.7077,0.5736,0.6997,0.5738
2023-06-05 13:45,812,699,113,58470,51540,6930,57247929.0,53269065.0,3978864.0,734,660,74,54472,49011,5461,54934143.0,51792600.0,3141543.0,1.0335,0.5742,1.0568,0.5753
2023-06-05 13:50,817,720,97,61580,57341,4239,47171115.0,44737567.0,2433548.0,763,698,65,60513,56316,4197,46528246.0,44108119.0,2420126.0,0.7802,0.5741,0.7832,0.5766
2023-06-05 13:55,786,304,482,53969,5364,48605,30846777.0,3062935.0,27783842.0,761,301,460,51697,5349,46348,29637553.0,3042503.0,26595049.0,0.571,0.5716,0.5688,0.5738
2023-06-05 14:00,496,145,351,69807,15361,54446,51897482.0,20660595.0,31236887.0,471,136,335,68058,14725,53333,50879085.0,20273824.0,30605260.0,1.345,0.5737,1.3768,0.5739
2023-06-05 14:05,251,100,151,17481,3927,13554,10010644.0,2235771.0,7774872.0,234,88,146,17791,3618,14173,10188086.0,2055736.0,8132350.0,0.5693,0.5736,0.5682,0.5738
2023-06-05 14:10,145,78,67,10088,4595,5493,5754845.0,2624521.0,3130323.0,118,64,54,9094,4012,5082,5205217.0,2289786.0,2915430.0,0.5712,0.5699,0.5707,0.5737
2023-06-05 14:15,338,147,191,28770,7948,20822,28359121.0,16403650.0,11955470.0,326,152,174,29341,8147,21194,28706152.0,16526914.0,12179237.0,2.0639,0.5742,2.0286,0.5747
2023-06-05 14:20,1236,565,671,100143,13788,86355,69246488.0,19750093.0,49496395.0,1164,536,628,96891,12946,83945,67458466.0,19269598.0,48188868.0,1.4324,0.5732,1.4885,0.5741
2023-06-05 14:25,3037,463,2574,359363,12590,346773,217643382.0,19030877.0,198612504.0,3013,452,2561,360094,14959,345135,218164274.0,20374200.0,197790074.0,1.5116,0.5727,1.362,0.5731
2023-06-05 14:30,1367,432,935,139776,29417,110359,91910419.0,28660068.0,63250350.0,1327,401,926,135179,24800,110379,89250786.0,25987550.0,63263235.0,0.9743,0.5731,1.0479,0.5731
2023-06-05 14:35,561,310,251,48680,12541,36139,27878044.0,7152211.0,20725833.0,531,299,232,47836,12485,35351,27402396.0,7116191.0,20286205.0,0.5703,0.5735,0.57,0.5739
2023-06-05 14:40,586,268,318,52319,18037,34282,29851839.0,10269336.0,19582502.0,561,256,305,51268,17629,33639,29314641.0,10038561.0,19276080.0,0.5693,0.5712,0.5694,0.573
2023-06-05 14:45,804,195,609,117573,19192,98381,67332068.0,10931511.0,56400557.0,790,192,598,117380,19715,97665,67222025.0,11226616.0,55995409.0,0.5696,0.5733,0.5694,0.5733
2023-06-05 14:50,321,251,70,7745,4458,3287,16272221.0,14410667.0,1861554.0,299,243,56,7666,4834,2832,16243537.0,14625182.0,1618355.0,3.2325,0.5663,3.0255,0.5715
2023-06-05 14:55,818,509,309,39861,12346,27515,34511380.0,18876858.0,15634521.0,817,494,323,35651,11721,23930,32209144.0,18523602.0,13685542.0,1.529,0.5682,1.5804,0.5719
2023-06-05 15:00,1157,508,649,63320,12073,51247,47851024.0,18708822.0,29142201.0,1127,491,636,63131,11111,52020,47818757.0,18164313.0,29654443.0,1.5496,0.5687,1.6348,0.5701
2023-06-05 15:05,1169,454,715,85667,14150,71517,48728118.0,7998808.0,40729309.0,1143,441,702,84729,13809,70920,48214692.0,7801290.0,40413401.0,0.5653,0.5695,0.5649,0.5698
2023-06-05 15:10,956,402,554,59272,23209,36063,57641710.0,37101744.0,20539966.0,918,382,536,55892,20088,35804,55542868.0,35133766.0,20409102.0,1.5986,0.5696,1.749,0.57
2023-06-05 15:15,2316,1819,497,219647,193528,26119,172387286.0,157478214.0,14909072.0,2249,1792,457,217265,192936,24329,171071928.0,157134353.0,13937574.0,0.8137,0.5708,0.8144,0.5729
2023-06-05 15:20,1565,1235,330,133018,114253,18765,75643746.0,64898693.0,10745052.0,1536,1222,314,131446,113998,17448,74726749.0,64734220.0,9992529.0,0.568,0.5726,0.5679,0.5727
2023-06-05 15:25,700,470,230,41506,36744,4762,23613698.0,20893237.0,2720461.0,678,457,221,41033,36178,4855,23323880.0,20549791.0,2774089.0,0.5686,0.5713,0.568,0.5714
2023-06-05 15:30,592,345,247,54775,50066,4709,31146835.0,28455869.0,2690965.0,567,338,229,53707,49988,3719,30519860.0,28397171.0,2122689.0,0.5684,0.5715,0.5681,0.5708
2023-06-05 15:35,711,503,208,59209,54538,4671,45556516.0,42882868.0,2673648.0,698,497,201,59043,54463,4580,45451997.0,42836034.0,2615962.0,0.7863,0.5724,0.7865,0.5712
2023-06-05 15:40,630,499,131,40699,39573,1126,35042367.0,34400010.0,642357.0,609,488,121,39231,38499,732,34174615.0,33753707.0,420907.0,0.8693,0.5705,0.8767,0.575
2023-06-05 15:45,1738,1595,143,167519,162583,4936,107390007.0,104591067.0,2798939.0,1696,1579,117,166132,161891,4241,106572232.0,104140585.0,2431647.0,0.6433,0.567,0.6433,0.5734
2023-06-05 15:50,1789,1631,158,214546,210619,3927,170072105.0,167837663.0,2234442.0,1743,1613,130,209947,206783,3164,167435255.0,165615535.0,1819720.0,0.7969,0.569,0.8009,0.5751
2023-06-05 15:55,3638,3547,91,458574,455292,3282,262248569.0,260373450.0,1875118.0,3598,3530,68,456783,454216,2567,261161387.0,259682556.0,1478830.0,0.5719,0.5713,0.5717,0.5761
2023-06-05 16:00,881,829,52,94789,90012,4777,54106647.0,51336527.0,2770120.0,865,824,41,92104,89904,2200,52540188.0,51274634.0,1265554.0,0.5703,0.5799,0.5703,0.5753
2023-06-05 16:05,2088,508,1580,143112,43981,99131,117434358.0,60676464.0,56757894.0,2061,499,1562,140884,43321,97563,116256990.0,60301797.0,55955193.0,1.3796,0.5726,1.392,0.5735
2023-06-05 16:10,814,153,661,44377,4167,40210,25405578.0,2377736.0,23027842.0,798,142,656,45257,4045,41212,25912790.0,2302885.0,23609904.0,0.5706,0.5727,0.5693,0.5729
2023-06-05 16:15,560,108,452,41511,15189,26322,35608359.0,20530558.0,15077800.0,537,96,441,41017,14999,26018,35321779.0,20418718.0,14903060.0,1.3517,0.5728,1.3613,0.5728
2023-06-05 16:20,164,101,63,8335,7064,1271,4755872.0,4026395.0,729476.0,135,86,49,6972,5983,989,3971109.0,3403742.0,567366.0,0.57,0.5739,0.5689,0.5737
2023-06-05 16:25,904,731,173,40816,29620,11196,70916270.0,64476495.0,6439775.0,851,700,151,37870,27283,10587,69215260.0,63126145.0,6089115.0,2.1768,0.5752,2.3138,0.5752
2023-06-05 16:30,741,656,85,46313,41916,4397,38393398.0,35876899.0,2516499.0,679,623,56,41303,39073,2230,35540162.0,34258284.0,1281878.0,0.8559,0.5723,0.8768,0.5748
2023-06-05 16:35,72,42,30,2830,2091,739,1609307.0,1186348.0,422959.0,65,40,25,4007,3299,708,2282896.0,1875006.0,407890.0,0.5674,0.5723,0.5684,0.5761
2023-06-05 16:40,1053,663,390,75331,64552,10779,55191420.0,49005040.0,6186379.0,1022,646,376,71519,61081,10438,52862012.0,46861326.0,6000685.0,0.7592,0.5739,0.7672,0.5749
2023-06-05 16:45,1696,1004,692,141476,81388,60088,93018247.0,58535494.0,34482752.0,1647,988,659,138399,80136,58263,91281928.0,57755288.0,33526640.0,0.7192,0.5739,0.7207,0.5754
2023-06-05 16:50,1678,242,1436,170971,8662,162309,98346189.0,4959999.0,93386189.0,1662,232,1430,170852,8686,162166,98267848.0,4971243.0,93296605.0,0.5726,0.5754,0.5723,0.5753
2023-06-05 16:55,1520,353,1167,149588,17664,131924,97896737.0,21978605.0,75918131.0,1512,349,1163,149787,18042,131745,98004965.0,22189764.0,75815200.0,1.2443,0.5755,1.2299,0.5755
2023-06-05 17:00,367,285,82,15072,11675,3397,8660479.0,6702424.0,1958054.0,354,281,73,13724,11033,2691,7875607.0,6324224.0,1551382.0,0.5741,0.5764,0.5732,0.5765
2023-06-05 17:05,235,171,64,11783,9742,2041,6790426.0,5621519.0,1168906.0,191,146,45,10040,7601,2439,5760724.0,4351902.0,1408821.0,0.577,0.5727,0.5725,0.5776
2023-06-05 17:10,919,465,454,66903,28699,38204,86323616.0,64160707.0,22162908.0,738,403,335,54032,17623,36409,78832735.0,57646622.0,21186112.0,2.2356,0.5801,3.2711,0.5819
2023-06-05 17:15,1091,519,572,101708,20053,81655,70863311.0,23516244.0,47347067.0,992,483,509,105934,25479,80455,73276612.0,26558284.0,46718327.0,1.1727,0.5798,1.0424,0.5807
2023-06-05 17:20,1002,711,291,93420,63877,29543,66056764.0,48848196.0,17208568.0,911,690,221,81611,56380,25231,59156112.0,44463057.0,14693055.0,0.7647,0.5825,0.7886,0.5823
2023-06-05 17:25,3043,1149,1894,258390,59266,199124,232502643.0,117305556.0,115197086.0,2923,1106,1817,263083,65767,197316,235424489.0,121030655.0,114393834.0,1.9793,0.5785,1.8403,0.5797
2023-06-05 17:30,854,362,492,75579,23106,52473,79322297.0,48927760.0,30394537.0,806,344,462,73719,21742,51977,78252371.0,48141444.0,30110927.0,2.1175,0.5792,2.2142,0.5793
2023-06-05 17:35,1551,643,908,135391,28848,106543,101980510.0,40374182.0,61606327.0,1504,623,881,132146,27733,104413,100142408.0,39708796.0,60433611.0,1.3995,0.5782,1.4318,0.5788
2023-06-05 17:40,366,267,99,14891,7918,6973,8578917.0,4552509.0,4026408.0,348,263,85,13572,7236,6336,7829264.0,4158919.0,3670345.0,0.575,0.5774,0.5748,0.5793
2023-06-05 17:45,269,138,131,9443,3739,5704,5444056.0,2153930.0,3290126.0,246,131,115,9258,3762,5496,5330306.0,2156554.0,3173752.0,0.5761,0.5768,0.5732,0.5775
2023-06-05 17:50,259,124,135,13364,4349,9015,7694438.0,2494955.0,5199482.0,220,116,104,10463,3903,6560,6028892.0,2237755.0,3791137.0,0.5737,0.5768,0.5733,0.5779
2023-06-05 17:55,248,130,118,12867,5988,6879,19242945.0,15312945.0,3929999.0,214,116,98,12321,5551,6770,18976593.0,15058172.0,3918421.0,2.5573,0.5713,2.7127,0.5788
2023-06-05 18:00,464,236,228,22809,10762,12047,13104687.0,6164094.0,6940593.0,457,227,230,23253,10689,12564,13346860.0,6099976.0,7246883.0,0.5728,0.5761,0.5707,0.5768
2023-06-05 18:05,474,321,153,17351,9333,8018,9955063.0,5352008.0,4603055.0,450,317,133,17133,9559,7574,9842553.0,5480780.0,4361773.0,0.5734,0.5741,0.5734,0.5759
2023-06-05 18:10,2468,507,1961,292901,12723,280178,239436901.0,78514681.0,160922220.0,2383,458,1925,290200,11947,278253,238060252.0,78070092.0,159990160.0,6.1711,0.5744,6.5347,0.575
2023-06-05 18:15,1086,316,770,88621,10207,78414,62612561.0,17693667.0,44918893.0,1039,288,751,86436,8894,77542,61419989.0,16940117.0,44479871.0,1.7335,0.5728,1.9047,0.5736
2023-06-05 18:20,1322,320,1002,139577,11375,128202,104062796.0,30313620.0,73749175.0,1288,303,985,137942,10447,127495,103089742.0,29725019.0,73364722.0,2.6649,0.5753,2.8453,0.5754
2023-06-05 18:25,2514,475,2039,284312,10622,273690,163529649.0,6077744.0,157451905.0,2489,458,2031,282268,9960,272308,162333798.0,5691447.0,156642350.0,0.5722,0.5753,0.5714,0.5752
2023-06-05 18:30,2897,515,2382,272254,7827,264427,156409143.0,4472323.0,151936820.0,2859,494,2365,271285,7915,263370,155882284.0,4516166.0,151366118.0,0.5714,0.5746,0.5706,0.5747
2023-06-05 18:35,1675,275,1400,205476,10181,195295,141803538.0,29565362.0,112238176.0,1638,254,1384,204489,9764,194725,141282165.0,29317184.0,111964980.0,2.904,0.5747,3.0026,0.575
2023-06-06 10:00,1849,1025,824,136683,61636,75047,226495058.0,183664107.0,42830951.0,1595,885,710,130593,55449,75144,212697590.0,169637498.0,43060092.0,2.9798,0.5707,3.0593,0.573
2023-06-06 10:05,2579,332,2247,340366,20642,319724,335993932.0,153990337.0,182003595.0,2403,212,2191,335240,17635,317605,332036314.0,151227228.0,180809086.0,7.46,0.5693,8.5754,0.5693
2023-06-06 10:10,480,83,397,37035,2336,34699,44637606.0,25057383.0,19580222.0,389,25,364,33917,1082,32835,42950305.0,24355717.0,18594587.0,10.7266,0.5643,22.5099,0.5663
2023-06-06 10:15,1944,275,1669,221064,13933,207131,397138258.0,280897945.0,116240312.0,1770,143,1627,217143,11874,205269,395076595.0,279753683.0,115322911.0,20.1606,0.5612,23.5602,0.5618
2023-06-06 10:20,2290,1285,1005,166935,80670,86265,140748819.0,92324723.0,48424096.0,2148,1200,948,165551,79652,85899,139954397.0,91739376.0,48215021.0,1.1445,0.5613,1.1518,0.5613
2023-06-06 10:25,713,207,506,69069,11867,57202,74304823.0,42217112.0,32087711.0,606,127,479,66619,10093,56526,72955108.0,41214710.0,31740397.0,3.5575,0.561,4.0835,0.5615
2023-06-06 10:30,1639,1023,616,95913,63694,32219,53299045.0,35238760.0,18060284.0,1567,968,599,92668,62217,30451,51469931.0,34418985.0,17050946.0,0.5533,0.5605,0.5532,0.5599
2023-06-06 10:35,350,217,133,26536,15845,10691,26681740.0,20688774.0,5992966.0,299,178,121,25437,15381,10056,26051303.0,20421592.0,5629711.0,1.3057,0.5606,1.3277,0.5598
2023-06-06 10:40,313,224,89,23209,17462,5747,36740196.0,33513264.0,3226932.0,254,177,77,20242,15014,5228,35051964.0,32116379.0,2935584.0,1.9192,0.5615,2.1391,0.5615
2023-06-06 10:45,134,70,64,7644,2383,5261,4311237.0,1337338.0,2973899.0,82,34,48,6308,1668,4640,3554185.0,929153.0,2625032.0,0.5612,0.5653,0.557,0.5657
2023-06-06 10:50,130,63,67,4472,1787,2685,14397337.0,12887288.0,1510049.0,97,36,61,4713,1678,3035,14523717.0,12812817.0,1710899.0,7.2117,0.5624,7.6358,0.5637
2023-06-06 10:55,67,28,39,2480,263,2217,1391583.0,146997.0,1244585.0,71,7,64,2862,231,2631,1628428.0,127353.0,1501075.0,0.5589,0.5614,0.5513,0.5705
2023-06-06 11:00,262,159,103,18600,10713,7887,10409050.0,5980212.0,4428837.0,222,127,95,17390,10035,7355,9739596.0,5601731.0,4137865.0,0.5582,0.5615,0.5582,0.5626
2023-06-06 11:05,285,29,256,33839,632,33207,30958867.0,12227391.0,18731476.0,255,8,247,33348,664,32684,30706356.0,12243741.0,18462615.0,19.3471,0.5641,18.4394,0.5649
2023-06-06 11:10,386,48,338,46483,1864,44619,26225604.0,1041848.0,25183756.0,356,23,333,45991,1387,44604,25945644.0,774132.0,25171511.0,0.5589,0.5644,0.5581,0.5643
2023-06-06 11:15,591,135,456,54083,6692,47391,42371870.0,15624048.0,26747822.0,556,110,446,53167,6313,46854,41855534.0,15409205.0,26446329.0,2.3347,0.5644,2.4409,0.5644
2023-06-06 11:20,832,433,399,80229,32573,47656,57080515.0,30126703.0,26953811.0,798,407,391,79930,32250,47680,56906652.0,29942829.0,26963822.0,0.9249,0.5656,0.9285,0.5655
2023-06-06 11:25,1848,1431,417,131924,102873,29051,74119535.0,57630587.0,16488948.0,1830,1413,417,130130,102921,27209,72996360.0,57654517.0,15341843.0,0.5602,0.5676,0.5602,0.5639
2023-06-06 11:30,761,627,134,56963,46071,10892,43990728.0,37690620.0,6300108.0,727,603,124,52348,44000,8348,41237037.0,36531657.0,4705379.0,0.8181,0.5784,0.8303,0.5637
2023-06-06 11:35,229,159,70,13429,9932,3497,7548640.0,5571151.0,1977489.0,205,142,63,12960,9485,3475,7283685.0,5319117.0,1964568.0,0.5609,0.5655,0.5608,0.5653
2023-06-06 11:40,711,595,116,54464,41778,12686,42487013.0,35310090.0,7176922.0,679,568,111,53904,41666,12238,42168031.0,35244940.0,6923090.0,0.8452,0.5657,0.8459,0.5657
2023-06-06 11:45,1124,841,283,121304,69214,52090,68362618.0,38828170.0,29534448.0,1094,817,277,121357,69018,52339,68389874.0,38710283.0,29679590.0,0.561,0.567,0.5609,0.5671
2023-06-06 11:50,3355,1249,2106,468233,84616,383617,336659684.0,118831190.0,217828493.0,3312,1216,2096,467645,84162,383483,336401236.0,118572627.0,217828609.0,1.4044,0.5678,1.4089,0.568
2023-06-06 11:55,848,283,565,119425,19210,100215,67806291.0,10828802.0,56977488.0,813,259,554,118946,18997,99949,67511547.0,10684866.0,56826681.0,0.5637,0.5686,0.5625,0.5686
2023-06-06 12:00,1005,481,524,100966,36988,63978,68954528.0,32689127.0,36265401.0,969,455,514,99504,36929,62575,68126788.0,32650169.0,35476618.0,0.8838,0.5668,0.8841,0.5669
2023-06-06 12:05,455,320,135,20296,12955,7341,11135191.0,6723731.0,4411459.0,68,43,25,4239,1409,2830,2391555.0,791271.0,1600284.0,0.519,0.6009,0.5616,0.5655
2023-06-06 12:10,86,49,37,5099,2151,2948,2879714.0,1204111.0,1675603.0,47,18,29,4253,1107,3146,2401701.0,620189.0,1781511.0,0.5598,0.5684,0.5602,0.5663
2023-06-06 12:15,182,119,63,9923,4811,5112,17460790.0,14586393.0,2874396.0,133,83,50,9582,4665,4917,17271698.0,14494453.0,2777245.0,3.0319,0.5623,3.1071,0.5648
2023-06-06 12:20,83,58,25,2470,1516,954,1396714.0,858740.0,537973.0,43,25,18,2307,1397,910,1294544.0,781913.0,512631.0,0.5665,0.5639,0.5597,0.5633
2023-06-06 12:25,145,98,47,6802,3976,2826,3826575.0,2231095.0,1595479.0,88,60,28,6495,3874,2621,3648992.0,2170929.0,1478063.0,0.5611,0.5646,0.5604,0.5639
2023-06-06 12:30,145,112,33,8000,5627,2373,4496495.0,3159633.0,1336861.0,106,74,32,6661,5034,1627,3741453.0,2824762.0,916690.0,0.5615,0.5634,0.5611,0.5634
2023-06-06 12:35,114,84,30,6496,4381,2115,3658874.0,2464875.0,1193998.0,81,50,31,6795,3947,2848,3821959.0,2215987.0,1605972.0,0.5626,0.5645,0.5614,0.5639
2023-06-06 12:40,69,53,16,1233,711,522,680308.0,401611.0,278696.0,22,12,10,526,404,122,295923.0,226669.0,69253.0,0.5649,0.5339,0.5611,0.5677
2023-06-06 12:45,75,57,18,1812,909,903,1023955.0,514159.0,509796.0,28,16,12,1133,841,292,636669.0,471880.0,164788.0,0.5656,0.5646,0.5611,0.5643
2023-06-06 12:50,94,75,19,4660,3618,1042,2606622.0,2035541.0,571081.0,51,34,17,4087,3246,841,2298054.0,1823709.0,474344.0,0.5626,0.5481,0.5618,0.564
2023-06-06 12:55,84,48,36,2145,380,1765,1212227.0,216077.0,996150.0,45,13,32,1694,279,1415,956595.0,156439.0,800156.0,0.5686,0.5644,0.5607,0.5655
2023-06-06 13:00,414,357,57,38085,32608,5477,21350247.0,18266123.0,3084124.0,377,325,52,38539,32647,5892,21603148.0,18284114.0,3319034.0,0.5602,0.5631,0.5601,0.5633
2023-06-06 13:05,303,268,35,26244,24122,2122,14701296.0,13508329.0,1192966.0,251,228,23,25938,23942,1996,14528828.0,13405966.0,1122862.0,0.56,0.5622,0.5599,0.5626
2023-06-06 13:10,138,106,32,8547,5620,2927,4798993.0,3151477.0,1647515.0,101,74,27,8276,5490,2786,4644807.0,3075906.0,1568901.0,0.5608,0.5629,0.5603,0.5631
2023-06-06 13:15,380,281,99,32878,25001,7877,18478143.0,14024720.0,4453423.0,334,244,90,33293,24897,8396,18694228.0,13949130.0,4745098.0,0.561,0.5654,0.5603,0.5652
2023-06-06 13:20,165,117,48,9321,8100,1221,5233234.0,4543450.0,689783.0,114,73,41,8948,7794,1154,5017420.0,4365700.0,651720.0,0.5609,0.5649,0.5601,0.5647
2023-06-06 13:25,432,151,281,61679,17054,44625,34848939.0,9568801.0,25280137.0,386,113,273,52729,8580,44149,29817762.0,4806520.0,25011242.0,0.5611,0.5665,0.5602,0.5665
2023-06-06 13:30,553,384,169,28035,13573,14462,27699898.0,19501319.0,8198579.0,513,348,165,27731,13311,14420,27524786.0,19350392.0,8174394.0,1.4368,0.5669,1.4537,0.5669
2023-06-06 13:35,182,142,40,7066,3759,3307,3979624.0,2115447.0,1864177.0,140,105,35,5781,2783,2998,3256925.0,1562705.0,1694219.0,0.5628,0.5637,0.5615,0.5651
2023-06-06 13:40,208,151,57,11425,6492,4933,6437753.0,3650927.0,2786826.0,160,116,44,9144,5713,3431,5152992.0,3210642.0,1942350.0,0.5624,0.5649,0.562,0.5661
2023-06-06 13:45,1911,1294,617,156293,90550,65743,87996509.0,50902214.0,37094295.0,1866,1256,610,154721,90277,64444,87116728.0,50743547.0,36373181.0,0.5621,0.5642,0.5621,0.5644
2023-06-06 13:50,1209,460,749,100989,25884,75105,56943756.0,14554914.0,42388841.0,1161,424,737,100826,25835,74991,56845709.0,14521503.0,42324206.0,0.5623,0.5644,0.5621,0.5644
2023-06-06 13:55,1816,535,1281,150627,35746,114881,84932561.0,20098573.0,64833988.0,1773,505,1268,150439,35832,114607,84822368.0,20143476.0,64678892.0,0.5623,0.5644,0.5622,0.5644
2023-06-06 14:00,1619,1524,95,139208,130436,8772,78264926.0,73309521.0,4955404.0,1580,1487,93,138950,130310,8640,78115514.0,73234562.0,4880952.0,0.562,0.5649,0.562,0.5649
2023-06-06 14:05,1236,791,445,121884,68466,53418,68636526.0,38481154.0,30155371.0,1198,757,441,121513,68232,53281,68431761.0,38346647.0,30085114.0,0.562,0.5645,0.562,0.5646
2023-06-06 14:10,1422,1078,344,134805,84746,50059,76120237.0,47628155.0,28492081.0,1375,1042,333,132733,84320,48413,74849849.0,47384504.0,27465344.0,0.562,0.5692,0.562,0.5673
2023-06-06 14:15,819,777,42,95724,92957,2767,53772226.0,52208470.0,1563756.0,784,745,39,95781,93061,2720,53798819.0,52261365.0,1537453.0,0.5616,0.5651,0.5616,0.5652
2023-06-06 14:20,891,787,104,88657,79167,9490,49830873.0,44468132.0,5362740.0,850,756,94,88595,79034,9561,49791317.0,44388722.0,5402594.0,0.5617,0.5651,0.5616,0.5651
2023-06-06 14:25,1326,1039,287,114663,76048,38615,64531785.0,42722985.0,21808800.0,1277,1005,272,114230,75999,38231,64284663.0,42689864.0,21594799.0,0.5618,0.5648,0.5617,0.5649
2023-06-06 14:30,432,323,109,34847,23386,11461,19608018.0,13139984.0,6468034.0,390,290,100,34695,23243,11452,19527154.0,13055564.0,6471589.0,0.5619,0.5644,0.5617,0.5651
2023-06-06 14:35,487,291,196,51338,27732,23606,28912288.0,15580705.0,13331583.0,441,251,190,51118,27457,23661,28789156.0,15426469.0,13362686.0,0.5618,0.5648,0.5618,0.5648
2023-06-06 14:40,1210,1194,16,134988,133683,1305,75896352.0,75159721.0,736631.0,1176,1161,15,134282,132985,1297,75493264.0,74760437.0,732827.0,0.5622,0.5645,0.5622,0.565
2023-06-06 14:45,1411,1390,21,165304,163911,1393,92977897.0,92188049.0,789848.0,1378,1359,19,166202,163873,2329,93479914.0,92163344.0,1316570.0,0.5624,0.567,0.5624,0.5653
2023-06-06 14:50,1354,1331,23,166866,165753,1113,93845207.0,93216494.0,628712.0,1311,1297,14,166856,165628,1228,93837886.0,93143674.0,694211.0,0.5624,0.5649,0.5624,0.5653
2023-06-06 14:55,1661,1650,11,189464,188497,967,106596139.0,106044184.0,551954.0,1622,1614,8,188666,188205,461,106138650.0,105876663.0,261986.0,0.5626,0.5708,0.5626,0.5683
2023-06-06 15:00,1121,1110,11,127147,126240,907,83483564.0,82964002.0,519561.0,1086,1078,8,126639,126306,333,83187061.0,82996692.0,190368.0,0.6572,0.5728,0.6571,0.5717
2023-06-06 15:05,906,857,49,107125,98834,8291,60409455.0,55653826.0,4755629.0,865,819,46,108430,98689,9741,61256955.0,55568638.0,5688317.0,0.5631,0.5736,0.5631,0.584
2023-06-06 15:10,808,738,70,76774,75432,1342,43242201.0,42480182.0,762019.0,767,701,66,77155,75300,1855,43460946.0,42401633.0,1059313.0,0.5632,0.5678,0.5631,0.5711
2023-06-06 15:15,793,698,95,77006,67388,9618,43394209.0,37946730.0,5447479.0,750,664,86,76995,67445,9550,43374769.0,37969679.0,5405090.0,0.5631,0.5664,0.563,0.566
2023-06-06 15:20,620,516,104,56198,46911,9287,31672727.0,26413520.0,5259207.0,574,475,99,55513,46643,8870,31278995.0,26258970.0,5020025.0,0.5631,0.5663,0.563,0.566
2023-06-06 15:25,1664,1636,28,185702,183740,1962,104546783.0,103431126.0,1115656.0,1639,1607,32,186757,183786,2971,105148357.0,103452946.0,1695410.0,0.5629,0.5686,0.5629,0.5707
2023-06-06 15:30,2086,2021,65,236749,232943,3806,133302436.0,131142554.0,2159882.0,2044,1988,56,235851,232614,3237,132786325.0,130954610.0,1831715.0,0.563,0.5675,0.563,0.5659
2023-06-06 15:35,2314,2279,35,268224,266628,1596,151033446.0,150128769.0,904677.0,2269,2242,27,267849,266338,1511,150816427.0,149961494.0,854933.0,0.5631,0.5668,0.563,0.5658
2023-06-06 15:40,393,386,7,40034,39779,255,22557874.0,22412552.0,145322.0,358,349,9,40730,39945,785,22947979.0,22496644.0,451334.0,0.5634,0.5699,0.5632,0.5749
2023-06-06 15:45,87,72,15,2290,2068,222,1294762.0,1170217.0,124545.0,42,32,10,1565,1424,141,882722.0,802593.0,80128.0,0.5659,0.561,0.5636,0.5683
2023-06-06 15:50,1071,935,136,108712,101106,7606,61249284.0,56938330.0,4310954.0,1031,900,131,108211,101150,7061,60952304.0,56957344.0,3994959.0,0.5632,0.5668,0.5631,0.5658
2023-06-06 15:55,1126,810,316,89121,77392,11729,50286521.0,43646860.0,6639661.0,1078,767,311,88132,76239,11893,49672636.0,42936348.0,6736288.0,0.564,0.5661,0.5632,0.5664
2023-06-06 16:00,1199,675,524,64072,43341,20731,48102311.0,36344867.0,11757444.0,1135,629,506,62463,42287,20176,47187730.0,35744749.0,11442981.0,0.8386,0.5671,0.8453,0.5672
2023-06-06 16:05,555,288,267,12985,6158,6827,7359402.0,3489255.0,3870147.0,498,246,252,12315,5854,6461,6977805.0,3313308.0,3664497.0,0.5666,0.5669,0.566,0.5672
2023-06-06 16:10,363,115,248,8255,2524,5731,16559746.0,13304319.0,3255427.0,309,75,234,7946,2450,5496,16382304.0,13258352.0,3123952.0,5.2711,0.568,5.4116,0.5684
2023-06-06 16:15,212,121,91,8724,5461,3263,4916239.0,3091421.0,1824818.0,165,85,80,7972,5136,2836,4512612.0,2901780.0,1610832.0,0.5661,0.5592,0.565,0.568
2023-06-06 16:20,1470,1099,371,95935,87073,8862,54278053.0,49242081.0,5035971.0,1433,1070,363,95832,87402,8430,54209786.0,49419281.0,4790504.0,0.5655,0.5683,0.5654,0.5683
2023-06-06 16:25,2155,1680,475,139729,131322,8407,79079019.0,74295096.0,4783922.0,2108,1648,460,140132,131730,8402,79301357.0,74520234.0,4781122.0,0.5657,0.569,0.5657,0.569
2023-06-06 16:30,792,160,632,18194,8454,9740,22213692.0,16672000.0,5541692.0,749,125,624,17794,8302,9492,21977356.0,16576438.0,5400918.0,1.9721,0.569,1.9967,0.569
2023-06-06 16:35,378,308,70,25597,23527,2070,14506854.0,13327411.0,1179442.0,326,272,54,27417,23386,4031,15640191.0,13243883.0,2396308.0,0.5665,0.5698,0.5663,0.5945
2023-06-06 16:40,808,595,213,48648,46313,2335,27554244.0,26224991.0,1329253.0,769,563,206,48455,46117,2338,27440282.0,26109212.0,1331070.0,0.5663,0.5693,0.5662,0.5693
2023-06-06 16:45,297,205,92,16289,15063,1226,9231265.0,8534411.0,696854.0,255,174,81,16273,15057,1216,9219842.0,8527138.0,692703.0,0.5666,0.5684,0.5663,0.5697
2023-06-06 16:50,359,87,272,8691,5079,3612,4944879.0,2890211.0,2054667.0,307,62,245,8166,5126,3040,4635001.0,2903609.0,1731392.0,0.5691,0.5688,0.5664,0.5695
2023-06-06 16:55,304,183,121,18664,16443,2221,10585232.0,9316621.0,1268611.0,258,152,106,18617,16395,2222,10556210.0,9286081.0,1270129.0,0.5666,0.5712,0.5664,0.5716
2023-06-06 17:00,1432,767,665,87739,59369,28370,85576649.0,69341651.0,16234997.0,1379,733,646,86694,58510,28184,84958329.0,68829581.0,16128747.0,1.168,0.5723,1.1764,0.5723
2023-06-06 17:05,2592,1865,727,156758,147465,9293,89047410.0,83743749.0,5303660.0,2547,1829,718,156915,147779,9136,89141122.0,83915707.0,5225415.0,0.5679,0.5707,0.5678,0.572
2023-06-06 17:10,1216,615,601,72289,54844,17445,41084316.0,31133681.0,9950634.0,1171,580,591,71779,54511,17268,40814309.0,30942245.0,9872063.0,0.5677,0.5704,0.5676,0.5717
2023-06-06 17:15,361,85,276,9883,4962,4921,5627794.0,2817029.0,2810765.0,331,57,274,17963,13093,4870,10156621.0,7375740.0,2780881.0,0.5677,0.5712,0.5633,0.571
2023-06-06 17:20,616,206,410,24875,15637,9238,14165189.0,8887043.0,5278145.0,571,170,401,24730,15588,9142,14079276.0,8856183.0,5223092.0,0.5683,0.5714,0.5681,0.5713
2023-06-06 17:25,1078,676,402,77932,52961,24971,44350318.0,30067384.0,14282934.0,1042,643,399,77914,52945,24969,44333422.0,30051740.0,14281681.0,0.5677,0.572,0.5676,0.572
2023-06-06 17:30,1753,1066,687,101250,76553,24697,57587539.0,43475303.0,14112236.0,1738,1057,681,100874,76353,24521,57376756.0,43361765.0,14014990.0,0.5679,0.5714,0.5679,0.5716
2023-06-06 17:35,218,118,100,10035,6253,3782,5710315.0,3547549.0,2162766.0,210,113,97,9333,6032,3301,5310863.0,3421844.0,1889019.0,0.5673,0.5719,0.5673,0.5723
2023-06-06 17:40,91,61,30,3009,1651,1358,1713516.0,938188.0,775328.0,65,43,22,1967,1374,593,1120241.0,780896.0,339344.0,0.5683,0.5709,0.5683,0.5723
2023-06-06 17:45,883,629,254,41672,38736,2936,35497912.0,33819780.0,1678131.0,867,626,241,41229,38555,2674,35246094.0,33718078.0,1528016.0,0.8731,0.5716,0.8745,0.5714
2023-06-06 17:50,1946,172,1774,185133,4752,180381,117254837.0,14559466.0,102695371.0,1957,162,1795,186488,4168,182320,118151649.0,14229898.0,103921751.0,3.0639,0.5693,3.4141,0.57
2023-06-06 17:55,1860,61,1799,205193,1023,204170,116781819.0,575348.0,116206471.0,1843,51,1792,205370,1602,203768,116894979.0,898939.0,115996039.0,0.5624,0.5692,0.5611,0.5693
2023-06-06 18:00,2482,117,2365,305473,1414,304059,185513650.0,12673871.0,172839779.0,2459,100,2359,305562,1728,303834,185556082.0,12839384.0,172716697.0,8.9631,0.5684,7.4302,0.5685
2023-06-06 18:05,2418,91,2327,284135,2631,281504,161564886.0,1478583.0,160086302.0,2397,73,2324,283198,1984,281214,161032630.0,1113943.0,159918687.0,0.562,0.5687,0.5615,0.5687
2023-06-06 18:10,3390,331,3059,494381,16078,478303,351537184.0,80227318.0,271309866.0,3306,268,3038,482841,6613,476228,345186206.0,74967107.0,270219099.0,4.9899,0.5672,11.3363,0.5674
2023-06-06 18:15,1538,619,919,107607,2290,105317,60850316.0,1283117.0,59567199.0,1498,594,904,107006,2104,104902,60518979.0,1178040.0,59340938.0,0.5603,0.5656,0.5599,0.5657
2023-06-06 18:20,1521,215,1306,153322,2044,151278,86675097.0,1145011.0,85530085.0,1503,200,1303,152688,1505,151183,86321936.0,844050.0,85477886.0,0.5602,0.5654,0.5608,0.5654
2023-06-06 18:25,1223,206,1017,74822,2053,72769,42298407.0,1181013.0,41117393.0,1190,182,1008,75201,2208,72993,42491082.0,1238121.0,41252960.0,0.5753,0.565,0.5607,0.5652
2023-06-06 18:30,1045,233,812,59242,20052,39190,57216603.0,35026605.0,22189998.0,985,181,804,58587,19446,39141,56840646.0,34680199.0,22160447.0,1.7468,0.5662,1.7834,0.5662
2023-06-06 18:35,1537,563,974,127487,71165,56322,155023306.0,123110436.0,31912870.0,1501,537,964,126064,70926,55138,154211645.0,122964966.0,31246679.0,1.7299,0.5666,1.7337,0.5667
2023-06-07 10:00,1094,404,690,81242,17404,63838,59847909.0,23309931.0,36537978.0,876,295,581,63392,5928,57464,43028837.0,10350178.0,32678659.0,1.3393,0.5724,1.746,0.5687
2023-06-07 10:05,1266,486,780,121989,31068,90921,92562659.0,41093093.0,51469565.0,1178,432,746,112781,22068,90713,86650827.0,35296458.0,51354368.0,1.3227,0.5661,1.5994,0.5661
2023-06-07 10:10,1189,172,1017,137785,11917,125868,77779033.0,6596914.0,71182118.0,1051,95,956,135211,10828,124383,76384524.0,6021974.0,70362550.0,0.5536,0.5655,0.5561,0.5657
2023-06-07 10:15,136,56,80,19966,17336,2630,10940905.0,9472376.0,1468528.0,73,14,59,19768,16939,2829,10921291.0,9323131.0,1598159.0,0.5464,0.5584,0.5504,0.5649
2023-06-07 10:20,113,66,47,4236,1602,2634,14242148.0,12769648.0,1472499.0,61,25,36,2263,965,1298,9172760.0,8442986.0,729773.0,7.9711,0.559,8.7492,0.5622
2023-06-07 10:25,276,95,181,16421,3018,13403,20994848.0,13546537.0,7448310.0,192,34,158,13321,1375,11946,19374588.0,12636178.0,6738410.0,4.4886,0.5557,9.1899,0.5641
2023-06-07 10:30,141,71,70,5119,1631,3488,2874510.0,907554.0,1966955.0,67,19,48,3809,446,3363,2145383.0,247123.0,1898260.0,0.5564,0.5639,0.5541,0.5645
2023-06-07 10:35,87,62,25,2694,1140,1554,1515600.0,638227.0,877372.0,35,20,15,1301,109,1192,730438.0,60784.0,669654.0,0.5598,0.5646,0.5577,0.5618
2023-06-07 10:40,89,45,44,4121,712,3409,14188079.0,12274404.0,1913675.0,57,22,35,3745,515,3230,13975878.0,12163637.0,1812240.0,17.2393,0.5614,23.6187,0.5611
2023-06-07 10:45,907,190,717,131970,7128,124842,97818991.0,27738962.0,70080029.0,879,169,710,131759,6798,124961,97693462.0,27544638.0,70148824.0,3.8915,0.5613,4.0519,0.5614
2023-06-07 10:50,233,141,92,14332,3318,11014,31788587.0,25605392.0,6183194.0,215,131,84,14439,3294,11145,31853675.0,25594398.0,6259277.0,7.7171,0.5614,7.77,0.5616
2023-06-07 10:55,73,46,27,3775,1912,1863,2111149.0,1063852.0,1047296.0,53,32,21,2214,491,1723,1242465.0,273078.0,969387.0,0.5564,0.5622,0.5562,0.5626
2023-06-07 11:00,123,81,42,4055,1528,2527,2295549.0,856207.0,1439342.0,104,72,32,3472,1338,2134,1955273.0,749079.0,1206193.0,0.5603,0.5696,0.5599,0.5652
2023-06-07 11:05,45,29,16,1219,925,294,682202.0,515469.0,166733.0,23,12,11,834,304,530,469722.0,169951.0,299770.0,0.5573,0.5671,0.5591,0.5656
2023-06-07 11:10,91,44,47,4890,1693,3197,2740932.0,929302.0,1811630.0,57,26,31,3465,870,2595,1960071.0,486474.0,1473596.0,0.5489,0.5667,0.5592,0.5679
2023-06-07 11:15,78,47,31,2560,1362,1198,1440754.0,762785.0,677968.0,58,36,22,1930,1094,836,1085050.0,612177.0,472873.0,0.56,0.5659,0.5596,0.5656
2023-06-07 11:20,84,59,25,3868,2350,1518,2203199.0,1311319.0,891880.0,58,45,13,2447,1936,511,1369146.0,1081609.0,287536.0,0.558,0.5875,0.5587,0.5627
2023-06-07 11:25,82,55,27,2346,1223,1123,1318140.0,685549.0,632591.0,67,46,21,2298,1168,1130,1290487.0,653514.0,636972.0,0.5605,0.5633,0.5595,0.5637
2023-06-07 11:30,53,28,25,2390,580,1810,1342320.0,324460.0,1017860.0,37,15,22,2140,387,1753,1202272.0,216437.0,985835.0,0.5594,0.5624,0.5593,0.5624
2023-06-07 11:35,310,206,104,30588,22487,8101,16751158.0,12194165.0,4556993.0,281,184,97,29254,21380,7874,16246300.0,11817142.0,4429157.0,0.5423,0.5625,0.5527,0.5625
2023-06-07 11:40,1784,1720,64,183547,180062,3485,126638108.0,124648634.0,1989473.0,1745,1696,49,181621,178956,2665,125501471.0,123995794.0,1505677.0,0.6923,0.5709,0.6929,0.565
2023-06-07 11:45,1031,923,108,111387,104785,6602,62450562.0,58721941.0,3728620.0,1014,916,98,112074,104880,7194,62862075.0,58775225.0,4086850.0,0.5604,0.5648,0.5604,0.5681
2023-06-07 11:50,2507,2341,166,189220,176949,12271,106269067.0,99270057.0,6999010.0,2485,2329,156,187712,176823,10889,105338750.0,99192351.0,6146399.0,0.561,0.5704,0.561,0.5645
2023-06-07 11:55,403,330,73,25529,20973,4556,26223714.0,23652515.0,2571199.0,385,324,61,23469,19311,4158,25064615.0,22714208.0,2350407.0,1.1278,0.5644,1.1762,0.5653
2023-06-07 12:00,136,54,82,9008,4462,4546,5084677.0,2511616.0,2573060.0,114,53,61,16261,12663,3598,8749079.0,6709338.0,2039740.0,0.5629,0.566,0.5298,0.5669
2023-06-07 12:05,196,100,96,12765,9335,3430,7204308.0,5260489.0,1943819.0,162,94,68,13141,9613,3528,7410160.0,5408208.0,2001951.0,0.5635,0.5667,0.5626,0.5674
2023-06-07 12:10,186,35,151,9353,2829,6524,5281003.0,1588129.0,3692873.0,179,32,147,9017,2556,6461,5092340.0,1435208.0,3657131.0,0.5614,0.566,0.5615,0.566
2023-06-07 12:15,1027,334,693,128262,44322,83940,84346900.0,36751219.0,47595681.0,971,328,643,127136,44338,82798,83707489.0,36761241.0,46946248.0,0.8292,0.567,0.8291,0.567
2023-06-07 12:20,4442,1693,2749,583727,228600,355127,328946828.0,128243934.0,200702894.0,4427,1686,2741,583109,228290,354819,328613685.0,128068421.0,200545264.0,0.561,0.5652,0.561,0.5652
2023-06-07 12:25,2393,385,2008,343217,64531,278686,193672506.0,36176130.0,157496376.0,2383,380,2003,343761,65127,278634,193970936.0,36508882.0,157462053.0,0.5606,0.5651,0.5606,0.5651
2023-06-07 12:30,2153,924,1229,248709,112387,136322,140048421.0,63030209.0,77018212.0,2140,912,1228,248551,112159,136392,139945202.0,62888483.0,77056718.0,0.5608,0.565,0.5607,0.565
2023-06-07 12:35,1573,881,692,161024,91773,69251,90539555.0,51452770.0,39086785.0,1564,875,689,160601,91774,68827,90324967.0,51452990.0,38871976.0,0.5607,0.5644,0.5606,0.5648
2023-06-07 12:40,1811,415,1396,203988,37596,166392,115039481.0,21060081.0,93979400.0,1801,407,1394,203909,37486,166423,114996126.0,20998453.0,93997672.0,0.5602,0.5648,0.5602,0.5648
2023-06-07 12:45,622,234,388,60599,17739,42860,34137741.0,9948752.0,24188989.0,603,221,382,60359,17816,42543,34017616.0,9990795.0,24026821.0,0.5608,0.5644,0.5608,0.5648
2023-06-07 12:50,173,73,100,13530,4115,9415,19423091.0,14185456.0,5237635.0,164,67,97,12252,3773,8479,18774533.0,13994377.0,4780155.0,3.4473,0.5563,3.7091,0.5638
2023-06-07 12:55,568,104,464,80297,7624,72673,57125064.0,16137300.0,40987763.0,548,91,457,78919,6188,72731,56353097.0,15336620.0,41016477.0,2.1166,0.564,2.4784,0.5639
2023-06-07 13:00,360,6,354,48396,142,48254,27329396.0,79661.0,27249734.0,357,4,353,48654,550,48104,27471725.0,304643.0,27167081.0,0.561,0.5647,0.5539,0.5648
2023-06-07 13:05,816,21,795,117076,359,116717,66055958.0,207876.0,65848081.0,804,10,794,116924,138,116786,65963688.0,77202.0,65886485.0,0.579,0.5642,0.5594,0.5642
2023-06-07 13:10,319,19,300,47852,296,47556,27016470.0,172199.0,26844271.0,307,12,295,47438,297,47141,26776280.0,166398.0,26609882.0,0.5818,0.5645,0.5603,0.5645
2023-06-07 13:15,98,12,86,9516,155,9361,5374163.0,92815.0,5281347.0,86,4,82,9322,18,9304,5260504.0,10073.0,5250431.0,0.5988,0.5642,0.5596,0.5643
2023-06-07 13:20,311,29,282,49640,449,49191,28065132.0,251649.0,27813483.0,298,17,281,49351,381,48970,27899756.0,213496.0,27686260.0,0.5605,0.5654,0.5604,0.5654
2023-06-07 13:25,74,30,44,4596,1501,3095,14464961.0,12715746.0,1749214.0,69,29,40,4919,1949,2970,14645468.0,12964985.0,1680483.0,8.4715,0.5652,6.6521,0.5658
2023-06-07 13:30,323,25,298,20001,8594,11407,11210378.0,4772184.0,6438193.0,317,20,297,12266,382,11884,6927228.0,214313.0,6712915.0,0.5553,0.5644,0.561,0.5649
2023-06-07 13:35,78,36,42,3580,710,2870,13903796.0,12275171.0,1628625.0,64,28,36,3553,610,2943,13886538.0,12218226.0,1668311.0,17.289,0.5675,20.0299,0.5669
2023-06-07 13:40,54,17,37,3463,521,2942,13838699.0,12169668.0,1669030.0,46,14,32,3093,387,2706,13629955.0,12094200.0,1535755.0,23.3583,0.5673,31.2512,0.5675
2023-06-07 13:45,416,116,300,9380,2914,6466,17175283.0,13518321.0,3656961.0,398,106,292,9273,2834,6439,17110696.0,13468597.0,3642098.0,4.6391,0.5656,4.7525,0.5656
2023-06-07 13:50,395,148,247,8043,2863,5180,4533220.0,1607219.0,2926001.0,382,144,238,8082,2856,5226,4560870.0,1602736.0,2958133.0,0.5614,0.5649,0.5612,0.566
2023-06-07 13:55,442,171,271,16345,2132,14213,9225790.0,1199840.0,8025950.0,439,169,270,16345,2027,14318,9231515.0,1140743.0,8090772.0,0.5628,0.5647,0.5628,0.5651
2023-06-07 14:00,373,162,211,13141,4642,8499,7406604.0,2611765.0,4794839.0,361,155,206,12924,4557,8367,7285088.0,2563672.0,4721415.0,0.5626,0.5642,0.5626,0.5643
2023-06-07 14:05,118,28,90,12781,2132,10649,7208183.0,1198845.0,6009338.0,113,26,87,12848,2075,10773,7245863.0,1167043.0,6078820.0,0.5623,0.5643,0.5624,0.5643
2023-06-07 14:10,88,37,51,2475,517,1958,1407462.0,303003.0,1104458.0,65,27,38,2110,287,1823,1189292.0,160812.0,1028479.0,0.5861,0.5641,0.5603,0.5642
2023-06-07 14:15,287,58,229,12320,662,11658,18799625.0,12247374.0,6552250.0,276,55,221,11961,700,11261,18621234.0,12269267.0,6351966.0,18.5006,0.562,17.5275,0.5641
2023-06-07 14:20,516,145,371,17516,5299,12217,9883156.0,2978178.0,6904978.0,496,134,362,16578,5034,11544,9346928.0,2828912.0,6518016.0,0.562,0.5652,0.562,0.5646
2023-06-07 14:25,896,248,648,47028,4594,42434,26326965.0,2418311.0,23908653.0,890,243,647,44746,2640,42106,25206349.0,1481798.0,23724550.0,0.5264,0.5634,0.5613,0.5634
2023-06-07 14:30,1299,307,992,90826,4405,86421,51164256.0,2469589.0,48694666.0,1287,298,989,90058,4232,85826,50727029.0,2374532.0,48352497.0,0.5606,0.5635,0.5611,0.5634
2023-06-07 14:35,97,52,45,3118,1361,1757,1757385.0,761663.0,995721.0,93,51,42,3016,1294,1722,1700388.0,724348.0,976040.0,0.5596,0.5667,0.5598,0.5668
2023-06-07 14:40,441,35,406,4169,888,3281,2341788.0,497093.0,1844695.0,438,31,407,4150,883,3267,2337941.0,494342.0,1843599.0,0.5598,0.5622,0.5598,0.5643
2023-06-07 14:45,300,155,145,7666,2061,5605,16229601.0,13030637.0,3198963.0,327,154,173,7083,2036,5047,15878380.0,13017473.0,2860906.0,6.3225,0.5707,6.3937,0.5669
2023-06-07 14:50,57,45,12,3305,1403,1902,1858018.0,775046.0,1082971.0,48,38,10,3011,1111,1900,1717083.0,621725.0,1095357.0,0.5524,0.5694,0.5596,0.5765
2023-06-07 14:55,94,70,24,2019,1477,542,1118728.0,827996.0,290731.0,80,58,22,1595,1210,385,895076.0,678152.0,216923.0,0.5606,0.5364,0.5605,0.5634
2023-06-07 15:00,49,28,21,1521,588,933,856552.0,329631.0,526921.0,47,26,21,2943,586,2357,1668948.0,328380.0,1340567.0,0.5606,0.5648,0.5604,0.5688
2023-06-07 15:05,50,31,19,919,602,317,521265.0,336197.0,185068.0,36,22,14,699,545,154,393342.0,305505.0,87836.0,0.5585,0.5838,0.5606,0.5704
2023-06-07 15:10,53,27,26,2093,554,1539,1181395.0,311232.0,870162.0,45,21,24,2024,390,1634,1142556.0,218591.0,923965.0,0.5618,0.5654,0.5605,0.5655
2023-06-07 15:15,59,20,39,2499,118,2381,1407940.0,66735.0,1341205.0,44,12,32,2143,71,2072,1208004.0,39752.0,1168251.0,0.5656,0.5633,0.5599,0.5638
2023-06-07 15:20,28,18,10,1585,1344,241,888743.0,753031.0,135712.0,18,8,10,588,304,284,330881.0,170160.0,160720.0,0.5603,0.5631,0.5597,0.5659
2023-06-07 15:25,379,151,228,9299,1500,7799,5175079.0,839020.0,4336058.0,367,148,219,9328,2466,6862,5241558.0,1380180.0,3861378.0,0.5593,0.556,0.5597,0.5627
2023-06-07 15:30,375,89,286,15434,10574,4860,8493964.0,5761830.0,2732134.0,348,67,281,13982,9286,4696,7795854.0,5158532.0,2637322.0,0.5449,0.5622,0.5555,0.5616
2023-06-07 15:35,252,29,223,2429,715,1714,1361366.0,398735.0,962630.0,241,25,216,3127,1627,1500,1752686.0,910232.0,842454.0,0.5577,0.5616,0.5595,0.5616
2023-06-07 15:40,322,62,260,23907,1220,22687,25302080.0,12561204.0,12740875.0,290,44,246,23243,843,22400,24951187.0,12346779.0,12604407.0,10.2961,0.5616,14.6462,0.5627
2023-06-07 15:45,646,95,551,23335,1869,21466,13104367.0,1042289.0,12062077.0,626,79,547,22870,1565,21305,12845555.0,864676.0,11980879.0,0.5577,0.5619,0.5525,0.5624
2023-06-07 15:50,475,102,373,32629,2846,29783,30155566.0,13464371.0,16691194.0,441,74,367,31299,2512,28787,29401495.0,13260834.0,16140660.0,4.731,0.5604,5.279,0.5607
2023-06-07 15:55,1464,442,1022,130395,12262,118133,96833380.0,30584377.0,66249003.0,1417,406,1011,127620,10786,116834,95285250.0,29765149.0,65520100.0,2.4942,0.5608,2.7596,0.5608
2023-06-07 16:00,1940,296,1644,267300,16204,251096,149752954.0,9040578.0,140712375.0,1916,282,1634,267514,15978,251536,149876450.0,8914239.0,140962210.0,0.5579,0.5604,0.5579,0.5604
2023-06-07 16:05,897,152,745,99621,3974,95647,79809452.0,26014684.0,53794768.0,841,114,727,98228,3462,94766,78994364.0,25683622.0,53310741.0,6.5462,0.5624,7.4187,0.5626
2023-06-07 16:10,74,38,36,2081,789,1292,13046897.0,12318332.0,728564.0,56,23,33,2016,507,1509,13009323.0,12158669.0,850653.0,15.6126,0.5639,23.9816,0.5637
2023-06-07 16:15,763,226,537,58811,7557,51254,33083214.0,4242812.0,28840401.0,743,211,532,58188,7016,51172,32710511.0,3916661.0,28793849.0,0.5614,0.5627,0.5582,0.5627
2023-06-07 16:20,487,124,363,19895,5862,14033,23038807.0,15155207.0,7883600.0,470,108,362,19932,5533,14399,23054872.0,14962518.0,8092354.0,2.5853,0.5618,2.7042,0.562
2023-06-07 16:25,109,62,47,4115,2528,1587,2311136.0,1417444.0,893692.0,102,60,42,4738,3191,1547,2648575.0,1777800.0,870775.0,0.5607,0.5631,0.5571,0.5629
2023-06-07 16:30,203,89,114,5172,2029,3143,2899326.0,1134965.0,1764360.0,186,75,111,5251,2168,3083,2941569.0,1211563.0,1730006.0,0.5594,0.5614,0.5588,0.5611
2023-06-07 16:35,58,34,24,1461,994,467,818112.0,555835.0,262276.0,50,29,21,1077,633,444,602668.0,353308.0,249360.0,0.5592,0.5616,0.5581,0.5616
2023-06-07 16:40,33,15,18,442,189,253,253531.0,111338.0,142193.0,25,10,15,290,91,199,162590.0,50717.0,111873.0,0.5891,0.562,0.5573,0.5622
2023-06-07 16:45,40,18,22,2060,1041,1019,1157608.0,583584.0,574023.0,34,15,19,1193,442,751,669794.0,246290.0,423504.0,0.5606,0.5633,0.5572,0.5639
2023-06-07 16:50,158,34,124,2626,470,2156,1462304.0,262676.0,1199628.0,144,26,118,2663,495,2168,1496092.0,276962.0,1219130.0,0.5589,0.5564,0.5595,0.5623
2023-06-07 16:55,137,69,68,7778,1921,5857,4353279.0,1074717.0,3278562.0,117,58,59,4162,1478,2684,2332726.0,825845.0,1506880.0,0.5595,0.5598,0.5588,0.5614
2023-06-07 17:00,474,96,378,24258,7605,16653,25438416.0,16116095.0,9322321.0,451,75,376,23536,7257,16279,25050630.0,15923134.0,9127495.0,2.1191,0.5598,2.1942,0.5607
2023-06-07 17:05,964,264,700,82099,10280,71819,81583282.0,41345869.0,40237413.0,858,189,669,80421,8574,71847,80658028.0,40383259.0,40274768.0,4.022,0.5603,4.71,0.5606
2023-06-07 17:10,3110,603,2507,452592,7312,445280,301177432.0,51576718.0,249600714.0,3029,543,2486,451001,6018,444983,300275185.0,50841628.0,249433557.0,7.0537,0.5605,8.4483,0.5605
2023-06-07 17:15,846,102,744,86320,747,85573,48455420.0,416761.0,48038659.0,822,86,736,87353,1547,85806,49028793.0,856379.0,48172413.0,0.5579,0.5614,0.5536,0.5614
2023-06-07 17:20,1348,189,1159,169373,2748,166625,106781045.0,13401992.0,93379053.0,1330,176,1154,168946,2693,166253,106533835.0,13365492.0,93168342.0,4.877,0.5604,4.963,0.5604
2023-06-07 17:25,288,42,246,6775,730,6045,3793944.0,405667.0,3388276.0,280,37,243,6928,722,6206,3880375.0,401006.0,3479369.0,0.5557,0.5605,0.5554,0.5606
2023-06-07 17:30,2213,356,1857,286284,4698,281586,172425161.0,14491901.0,157933259.0,2187,338,1849,285094,4650,280444,171792291.0,14464918.0,157327373.0,3.0847,0.5609,3.1107,0.561
2023-06-07 17:35,1856,65,1791,247834,591,247243,138757611.0,328171.0,138429440.0,1848,58,1790,248351,363,247988,139049936.0,201353.0,138848582.0,0.5553,0.5599,0.5547,0.5599
2023-06-07 17:40,1778,50,1728,284049,544,283505,159282454.0,302931.0,158979523.0,1764,41,1723,282862,237,282625,158625693.0,131151.0,158494542.0,0.5569,0.5608,0.5534,0.5608
2023-06-07 17:45,2256,447,1809,239281,1573,237708,133704824.0,872814.0,132832010.0,2239,435,1804,239244,1523,237721,133689955.0,845219.0,132844736.0,0.5549,0.5588,0.555,0.5588
2023-06-07 17:50,1634,238,1396,202633,762,201871,113211045.0,423339.0,112787705.0,1613,225,1388,202918,725,202193,113377388.0,402751.0,112974637.0,0.5556,0.5587,0.5555,0.5587
2023-06-07 17:55,1158,182,976,106345,1597,104748,59523385.0,888694.0,58634691.0,1140,168,972,105736,1412,104324,59183388.0,785396.0,58397992.0,0.5565,0.5598,0.5562,0.5598
2023-06-07 18:00,1156,163,993,171729,3710,168019,96016832.0,2060423.0,93956409.0,1146,155,991,171911,4094,167817,96100250.0,2263257.0,93836992.0,0.5554,0.5592,0.5528,0.5592
2023-06-07 18:05,188,95,93,12114,2987,9127,18669423.0,13542905.0,5126517.0,180,89,91,11854,2700,9154,18519345.0,13378257.0,5141087.0,4.5339,0.5617,4.9549,0.5616
2023-06-07 18:10,108,26,82,6686,654,6032,3739617.0,364516.0,3375100.0,99,18,81,6471,516,5955,3619270.0,287485.0,3331784.0,0.5574,0.5595,0.5571,0.5595
2023-06-07 18:15,53,11,42,3269,137,3132,1828510.0,76206.0,1752303.0,41,7,34,3247,124,3123,1816433.0,68936.0,1747497.0,0.5563,0.5595,0.5559,0.5596
2023-06-07 18:20,303,57,246,37987,1060,36927,21245582.0,590205.0,20655376.0,287,49,238,37756,885,36871,21130122.0,492745.0,20637377.0,0.5568,0.5594,0.5568,0.5597
2023-06-07 18:25,295,131,164,29158,3309,25849,16298286.0,1845828.0,14452457.0,284,125,159,28582,2987,25595,15974140.0,1663148.0,14310991.0,0.5578,0.5591,0.5568,0.5591
2023-06-07 18:30,337,204,133,17856,5902,11954,21849003.0,15163173.0,6685829.0,315,189,126,17848,5965,11883,21853178.0,15197173.0,6656004.0,2.5692,0.5593,2.5477,0.5601
2023-06-07 18:35,749,484,265,62568,17946,44622,118214160.0,93146969.0,25067190.0,728,464,264,62416,17590,44826,118109644.0,92928610.0,25181033.0,5.1904,0.5618,5.283,0.5618
2023-06-08 10:00,1327,765,562,75074,40017,35057,48726005.0,28722560.0,20003445.0,1092,657,435,55399,26438,28961,35612754.0,19345948.0,16266806.0,0.7178,0.5706,0.7317,0.5617
2023-06-08 10:05,1133,314,819,83754,7264,76490,47005130.0,4043723.0,42961406.0,1084,286,798,81795,6907,74888,45871077.0,3849204.0,42021873.0,0.5567,0.5617,0.5573,0.5611
2023-06-08 10:10,1891,1147,744,233833,153511,80322,441241314.0,395773423.0,45467891.0,1591,972,619,215601,136996,78605,421251344.0,376699789.0,44551555.0,2.5781,0.5661,2.7497,0.5668
2023-06-08 10:15,4145,3118,1027,462886,418947,43939,419224351.0,393955902.0,25268449.0,3689,2963,726,446155,412327,33828,409409969.0,389908713.0,19501255.0,0.9403,0.5751,0.9456,0.5765
2023-06-08 10:20,2759,1089,1670,136823,80885,55938,102041484.0,69919750.0,32121734.0,2594,1015,1579,127484,73538,53946,96565972.0,65558223.0,31007748.0,0.8644,0.5742,0.8915,0.5748
2023-06-08 10:25,1950,1313,637,220087,182417,37670,162001948.0,140230392.0,21771556.0,1816,1278,538,210195,184006,26189,156185927.0,141071337.0,15114590.0,0.7687,0.578,0.7667,0.5771
2023-06-08 10:30,1263,291,972,72114,14093,58021,88494715.0,55502876.0,32991838.0,1147,245,902,70996,13859,57137,88286482.0,55400719.0,32885763.0,3.9383,0.5686,3.9975,0.5756
2023-06-08 10:35,3491,736,2755,389432,19195,370237,270474380.0,58384462.0,212089918.0,3295,639,2656,387600,19272,368328,269453139.0,58397602.0,211055536.0,3.0416,0.5728,3.0302,0.573
2023-06-08 10:40,4138,1489,2649,510514,109316,401198,362727530.0,133413106.0,229314424.0,4015,1422,2593,509812,111153,398659,362294927.0,134274275.0,228020652.0,1.2204,0.5716,1.208,0.572
2023-06-08 10:45,3583,3070,513,417326,407188,10138,296709034.0,290888958.0,5820076.0,3503,3025,478,414053,405103,8950,294825623.0,289693145.0,5132477.0,0.7144,0.5741,0.7151,0.5735
2023-06-08 10:50,3014,2351,663,347814,316103,31711,257623429.0,239520161.0,18103268.0,2956,2327,629,345869,315232,30637,256585717.0,239021076.0,17564641.0,0.7577,0.5709,0.7582,0.5733
2023-06-08 10:55,2614,1647,967,215863,154004,61859,158554829.0,123162457.0,35392372.0,2580,1635,945,215781,155354,60427,158489846.0,123920168.0,34569678.0,0.7997,0.5721,0.7977,0.5721
2023-06-08 11:00,1468,711,757,104499,50989,53510,71090890.0,40576127.0,30514762.0,1429,695,734,95316,42489,52827,66159553.0,35974978.0,30184574.0,0.7958,0.5703,0.8467,0.5714
2023-06-08 11:05,2661,1198,1463,155687,68459,87228,124110939.0,74398016.0,49712922.0,2574,1154,1420,153437,67860,85577,122898937.0,74055783.0,48843154.0,1.0868,0.5699,1.0913,0.5708
2023-06-08 11:10,3286,989,2297,292199,52279,239920,190027234.0,53333037.0,136694197.0,3246,957,2289,290866,51637,239229,189302701.0,52963865.0,136338836.0,1.0202,0.5697,1.0257,0.5699
2023-06-08 11:15,3182,2316,866,219104,136769,82335,160097900.0,113187715.0,46910185.0,3117,2290,827,216993,135282,81711,158879078.0,112311244.0,46567834.0,0.8276,0.5697,0.8302,0.5699
2023-06-08 11:20,1109,982,127,64011,62230,1781,48131593.0,47119812.0,1011781.0,1037,965,72,61686,60268,1418,46837808.0,46028421.0,809386.0,0.7572,0.5681,0.7637,0.5708
2023-06-08 11:25,468,421,47,24054,23043,1011,13644945.0,13068151.0,576793.0,454,419,35,24323,23347,976,13796085.0,13238364.0,557721.0,0.5671,0.5705,0.567,0.5714
2023-06-08 11:30,984,805,179,42325,39497,2828,24059120.0,22401281.0,1657839.0,954,792,162,40104,38290,1814,22753963.0,21716651.0,1037312.0,0.5672,0.5862,0.5672,0.5718
2023-06-08 11:35,949,725,224,34505,31628,2877,19553040.0,17925101.0,1627938.0,926,716,210,34271,31599,2672,19435672.0,17907505.0,1528166.0,0.5667,0.5658,0.5667,0.5719
2023-06-08 11:40,229,99,130,6501,3416,3085,3682309.0,1936465.0,1745843.0,212,89,123,5616,3239,2377,3192236.0,1836271.0,1355965.0,0.5669,0.5659,0.5669,0.5705
2023-06-08 11:45,299,239,60,3611,2843,768,2048810.0,1613362.0,435448.0,280,223,57,3802,2939,863,2158259.0,1665907.0,492351.0,0.5675,0.567,0.5668,0.5705
2023-06-08 11:50,746,572,174,63008,56178,6830,71752058.0,67867458.0,3884600.0,717,557,160,56104,51728,4376,67550267.0,65047477.0,2502790.0,1.2081,0.5688,1.2575,0.5719
2023-06-08 11:55,1419,1311,108,191025,187363,3662,108753558.0,106656431.0,2097127.0,1347,1277,70,189854,186417,3437,108089822.0,106116192.0,1973629.0,0.5693,0.5727,0.5692,0.5742
2023-06-08 12:00,208,128,80,9753,8640,1113,5527269.0,4899232.0,628036.0,180,116,64,8708,7913,795,4951917.0,4484367.0,467550.0,0.567,0.5643,0.5667,0.5881
2023-06-08 12:05,1503,781,722,109126,82708,26418,62040038.0,46999695.0,15040342.0,1458,763,695,107243,82102,25141,61030548.0,46655943.0,14374605.0,0.5683,0.5693,0.5683,0.5718
2023-06-08 12:10,1928,980,948,169194,129812,39382,96283342.0,73732795.0,22550546.0,1898,964,934,170536,130172,40364,97039288.0,73925696.0,23113591.0,0.568,0.5726,0.5679,0.5726
2023-06-08 12:15,585,339,246,37341,27367,9974,21298113.0,15578453.0,5719660.0,560,331,229,36567,26929,9638,20856587.0,15331026.0,5525561.0,0.5692,0.5735,0.5693,0.5733
2023-06-08 12:20,313,254,59,10402,8456,1946,5896810.0,4797323.0,1099487.0,299,246,53,10146,8397,1749,5763782.0,4763416.0,1000365.0,0.5673,0.565,0.5673,0.572
2023-06-08 12:25,732,452,280,72456,66528,5928,41127300.0,37739623.0,3387676.0,709,438,271,72061,66052,6009,40897950.0,37460720.0,3437229.0,0.5673,0.5715,0.5671,0.572
2023-06-08 12:30,809,530,279,82717,77250,5467,47089629.0,43961754.0,3127875.0,797,526,271,82748,77241,5507,47108397.0,43955510.0,3152887.0,0.5691,0.5721,0.5691,0.5725
2023-06-08 12:35,479,233,246,7435,3037,4398,4228805.0,1727039.0,2501766.0,460,224,236,15026,11627,3399,8320925.0,6371985.0,1948939.0,0.5687,0.5688,0.548,0.5734
2023-06-08 12:40,73,32,41,5467,1192,4275,3134334.0,679212.0,2455121.0,64,32,32,6075,1133,4942,3516762.0,645178.0,2871584.0,0.5698,0.5743,0.5694,0.5811
2023-06-08 12:45,273,96,177,19823,4026,15797,11335746.0,2286803.0,9048943.0,264,92,172,19193,3886,15307,10974284.0,2204235.0,8770049.0,0.568,0.5728,0.5672,0.5729
2023-06-08 12:50,691,195,496,66137,8995,57142,37822707.0,5094587.0,32728120.0,677,186,491,65114,9051,56063,37231647.0,5126552.0,32105095.0,0.5664,0.5728,0.5664,0.5727
2023-06-08 12:55,558,274,284,23667,3409,20258,13521175.0,1928855.0,11592320.0,542,270,272,23644,3384,20260,13511946.0,1916370.0,11595576.0,0.5658,0.5722,0.5663,0.5723
2023-06-08 13:00,1159,195,964,80966,8981,71985,69997350.0,28846244.0,41151105.0,1128,178,950,79389,8971,70418,69090375.0,28842827.0,40247547.0,3.2119,0.5717,3.2151,0.5716
2023-06-08 13:05,1442,389,1053,108483,23094,85389,61995946.0,13140172.0,48855773.0,1426,375,1051,108487,22623,85864,61991071.0,12859731.0,49131339.0,0.569,0.5722,0.5684,0.5722
2023-06-08 13:10,1349,601,748,115556,38208,77348,65957343.0,21715639.0,44241704.0,1327,586,741,115288,38087,77201,65803243.0,21645930.0,44157312.0,0.5684,0.572,0.5683,0.572
2023-06-08 13:15,2094,570,1524,261602,39257,222345,149339106.0,22297864.0,127041241.0,2036,550,1486,260359,39085,221274,148660067.0,22196526.0,126463540.0,0.568,0.5714,0.5679,0.5715
2023-06-08 13:20,2447,648,1799,323553,49798,273755,184715504.0,28292562.0,156422942.0,2422,636,1786,322990,49455,273535,184390216.0,28083093.0,156307123.0,0.5681,0.5714,0.5679,0.5714
2023-06-08 13:25,1851,676,1175,219803,39150,180653,125425822.0,22234675.0,103191146.0,1834,664,1170,219768,39396,180372,125405767.0,22374441.0,103031325.0,0.5679,0.5712,0.5679,0.5712
2023-06-08 13:30,1272,417,855,183975,26880,157095,104965021.0,15266215.0,89698806.0,1257,410,847,183748,26618,157130,104838435.0,15116830.0,89721604.0,0.5679,0.571,0.5679,0.571
2023-06-08 13:35,486,206,280,26540,4612,21928,15169081.0,2618882.0,12550199.0,469,198,271,25909,4465,21444,14806125.0,2535018.0,12271107.0,0.5678,0.5723,0.5678,0.5722
2023-06-08 13:40,38,20,18,599,511,88,341573.0,290301.0,51272.0,21,15,6,462,430,32,262948.0,244452.0,18495.0,0.5681,0.5826,0.5685,0.578
2023-06-08 13:45,112,54,58,6906,1201,5705,3949035.0,682400.0,3266635.0,78,36,42,6304,1002,5302,3609579.0,565828.0,3043751.0,0.5682,0.5726,0.5647,0.5741
2023-06-08 13:50,127,38,89,9849,2175,7674,17467119.0,13109743.0,4357375.0,110,30,80,9415,2140,7275,17243719.0,13090753.0,4152966.0,6.0275,0.5678,6.1172,0.5709
2023-06-08 13:55,113,23,90,12526,1544,10982,7151767.0,875872.0,6275894.0,104,18,86,12377,1425,10952,7064733.0,807299.0,6257433.0,0.5673,0.5715,0.5665,0.5714
2023-06-08 14:00,499,60,439,44460,4565,39895,25378563.0,2582183.0,22796379.0,489,52,437,44389,4612,39777,25343954.0,2611280.0,22732674.0,0.5656,0.5714,0.5662,0.5715
2023-06-08 14:05,439,95,344,58634,7424,51210,33450446.0,4211504.0,29238942.0,435,93,342,59194,7713,51481,33768605.0,4373289.0,29395316.0,0.5673,0.571,0.567,0.571
2023-06-08 14:10,196,66,130,16395,1851,14544,9357018.0,1050626.0,8306392.0,185,58,127,15742,1645,14097,8982994.0,933502.0,8049492.0,0.5676,0.5711,0.5675,0.571
2023-06-08 14:15,1121,175,946,164205,3969,160236,93722672.0,2249992.0,91472680.0,1127,165,962,164319,3888,160431,93799173.0,2204002.0,91595171.0,0.5669,0.5709,0.5669,0.5709
2023-06-08 14:20,220,128,92,13173,5278,7895,31257672.0,26761001.0,4496671.0,201,118,83,12309,5298,7011,30761360.0,26752641.0,4008718.0,5.0703,0.5696,5.0496,0.5718
2023-06-08 14:25,356,59,297,11538,4040,7498,6544399.0,2282814.0,4261585.0,341,49,292,11091,3432,7659,6299899.0,1940329.0,4359569.0,0.5651,0.5684,0.5654,0.5692
2023-06-08 14:30,143,59,84,8931,2289,6642,5100290.0,1297032.0,3803258.0,133,50,83,8186,2233,5953,4679508.0,1264516.0,3414992.0,0.5666,0.5726,0.5663,0.5737
2023-06-08 14:35,73,20,53,3417,417,3000,1951624.0,236208.0,1715415.0,65,19,46,3479,295,3184,1988480.0,166988.0,1821492.0,0.5664,0.5718,0.5661,0.5721
2023-06-08 14:40,146,67,79,7798,2305,5493,4445356.0,1306955.0,3138401.0,146,59,87,7307,2366,4941,4170464.0,1341785.0,2828679.0,0.567,0.5713,0.5671,0.5725
2023-06-08 14:45,92,36,56,2924,1913,1011,1647254.0,1084235.0,563018.0,74,25,49,2478,1622,856,1406108.0,919396.0,486711.0,0.5668,0.5569,0.5668,0.5686
2023-06-08 14:50,31,11,20,436,121,315,247893.0,68656.0,179236.0,24,6,18,1769,57,1712,1021844.0,32223.0,989621.0,0.5674,0.569,0.5653,0.578
2023-06-08 14:55,146,92,54,6386,5088,1298,3638231.0,2889756.0,748475.0,132,86,46,5114,4771,343,2904541.0,2708045.0,196496.0,0.568,0.5766,0.5676,0.5729
2023-06-08 15:00,470,152,318,6819,5442,1377,3858717.0,3086749.0,771967.0,461,148,313,6864,5621,1243,3897478.0,3188243.0,709234.0,0.5672,0.5606,0.5672,0.5706
2023-06-08 15:05,59,42,17,3428,3206,222,1945530.0,1819287.0,126242.0,45,33,12,3104,3014,90,1761082.0,1709708.0,51373.0,0.5675,0.5687,0.5673,0.5708
2023-06-08 15:10,242,27,215,4021,1631,2390,2289050.0,925270.0,1363779.0,236,24,212,4119,1595,2524,2345465.0,905002.0,1440462.0,0.5673,0.5706,0.5674,0.5707
2023-06-08 15:15,324,59,265,5060,1925,3135,2870390.0,1089166.0,1781223.0,315,53,262,5090,1934,3156,2887455.0,1094337.0,1793118.0,0.5658,0.5682,0.5658,0.5682
2023-06-08 15:20,46,27,19,2102,1249,853,1190766.0,712395.0,478371.0,35,19,16,1881,1089,792,1068297.0,617502.0,450794.0,0.5704,0.5608,0.567,0.5692
2023-06-08 15:25,255,132,123,7444,5044,2400,4223131.0,2858252.0,1364879.0,261,141,120,7362,5135,2227,4170556.0,2904214.0,1266341.0,0.5667,0.5687,0.5656,0.5686
2023-06-08 15:30,509,283,226,7266,4897,2369,4095608.0,2768646.0,1326962.0,483,263,220,6386,4543,1843,3628679.0,2573316.0,1055363.0,0.5654,0.5601,0.5664,0.5726
2023-06-08 15:35,68,37,31,2382,1090,1292,1358173.0,620362.0,737810.0,61,32,29,2292,1017,1275,1303773.0,575542.0,728230.0,0.5691,0.5711,0.5659,0.5712
2023-06-08 15:40,35,21,14,4692,4096,596,2618271.0,2270925.0,347345.0,29,19,10,1553,816,737,885050.0,462416.0,422634.0,0.5544,0.5828,0.5667,0.5735
2023-06-08 15:45,426,103,323,43989,3239,40750,25118194.0,1834723.0,23283470.0,412,94,318,44731,3203,41528,25551661.0,1812849.0,23738812.0,0.5664,0.5714,0.566,0.5716
2023-06-08 15:50,111,14,97,7587,617,6970,4310289.0,350838.0,3959450.0,104,9,95,7333,575,6758,4164109.0,324711.0,3839398.0,0.5686,0.5681,0.5647,0.5681
2023-06-08 15:55,284,23,261,7031,1833,5198,15854307.0,12913957.0,2940350.0,274,16,258,6895,1814,5081,15789210.0,12903755.0,2885454.0,7.0453,0.5657,7.1134,0.5679
2023-06-08 16:00,100,32,68,8717,1244,7473,4964865.0,701079.0,4263785.0,85,22,63,8403,988,7415,4789797.0,558289.0,4231507.0,0.5636,0.5706,0.5651,0.5707
2023-06-08 16:05,368,210,158,15860,3903,11957,20796842.0,14074524.0,6722317.0,347,196,151,15549,3968,11581,20699373.0,14111529.0,6587844.0,3.6061,0.5622,3.5563,0.5688
2023-06-08 16:10,347,44,303,12368,2440,9928,18896824.0,13256809.0,5640015.0,335,37,298,12019,2247,9772,18697063.0,13145938.0,5551125.0,5.4331,0.5681,5.8504,0.5681
2023-06-08 16:15,246,219,27,2971,1606,1365,1682090.0,906455.0,775634.0,240,212,28,3899,1871,2028,2207078.0,1055062.0,1152015.0,0.5644,0.5682,0.5639,0.5681
2023-06-08 16:20,181,113,68,7298,6006,1292,27940812.0,27202146.0,738666.0,148,90,58,6192,4861,1331,27259235.0,26498532.0,760702.0,4.5292,0.5717,5.4513,0.5715
2023-06-08 16:25,742,308,434,9583,3219,6364,17370565.0,13716272.0,3654292.0,682,287,395,8052,3204,4848,16472488.0,13692515.0,2779972.0,4.261,0.5742,4.2736,0.5734
2023-06-08 16:30,2678,847,1831,297719,11981,285738,194106585.0,30563920.0,163542664.0,2645,828,1817,296763,11325,285438,193560362.0,30191160.0,163369202.0,2.551,0.5724,2.6659,0.5723
2023-06-08 16:35,1086,299,787,132180,3240,128940,87538394.0,13712948.0,73825446.0,1063,293,770,131503,3432,128071,87175977.0,13811987.0,73363990.0,4.2324,0.5726,4.0245,0.5728
2023-06-08 16:40,601,181,420,53156,1887,51269,30364703.0,1068218.0,29296484.0,583,170,413,53165,1866,51299,30369795.0,1056582.0,29313213.0,0.5661,0.5714,0.5662,0.5714
2023-06-08 16:45,1034,304,730,91008,6309,84699,63719542.0,15448168.0,48271374.0,1005,285,720,90508,6108,84400,63445713.0,15330096.0,48115617.0,2.4486,0.5699,2.5098,0.5701
2023-06-08 16:50,2954,507,2447,377542,12636,364906,239044967.0,30890980.0,208153986.0,2933,493,2440,376955,12307,364648,238729992.0,30720232.0,208009760.0,2.4447,0.5704,2.4962,0.5704
2023-06-08 16:55,1710,267,1443,221886,5379,216507,150237764.0,26796568.0,123441195.0,1698,256,1442,221556,5318,216238,150048166.0,26762128.0,123286037.0,4.9817,0.5701,5.0324,0.5701
2023-06-08 17:00,51,22,29,2445,1046,1399,1384162.0,587159.0,797003.0,41,17,24,1977,721,1256,1123533.0,407525.0,716007.0,0.5613,0.5697,0.5652,0.5701
2023-06-08 17:05,873,116,757,64129,11812,52317,60174847.0,30421584.0,29753262.0,874,106,768,63643,11387,52256,59933932.0,30182115.0,29751817.0,2.5755,0.5687,2.6506,0.5693
2023-06-08 17:10,116,61,55,8386,6036,2350,4748070.0,3412056.0,1336013.0,106,53,53,8401,6064,2337,4756726.0,3428208.0,1328518.0,0.5653,0.5685,0.5653,0.5685
2023-06-08 17:15,493,50,443,10934,3518,7416,6195623.0,1990003.0,4205620.0,488,47,441,10719,3446,7273,6085836.0,1948890.0,4136946.0,0.5657,0.5671,0.5656,0.5688
2023-06-08 17:20,214,81,133,12442,7908,4534,7039409.0,4471279.0,2568130.0,201,74,127,12071,7509,4562,6837217.0,4245053.0,2592164.0,0.5654,0.5664,0.5653,0.5682
2023-06-08 17:25,106,78,28,6801,5855,946,3849903.0,3311187.0,538716.0,91,66,25,6495,5770,725,3674792.0,3262794.0,411997.0,0.5655,0.5695,0.5655,0.5683
2023-06-08 17:30,118,54,64,7415,4432,2983,4196582.0,2507621.0,1688960.0,116,53,63,7495,4582,2913,4246530.0,2589852.0,1656678.0,0.5658,0.5662,0.5652,0.5687
2023-06-08 17:35,77,52,25,5407,4217,1190,3061466.0,2384599.0,676866.0,72,49,23,5073,3886,1187,2872200.0,2197162.0,675038.0,0.5655,0.5688,0.5654,0.5687
2023-06-08 17:40,100,57,43,7873,5291,2582,16389194.0,14916148.0,1473045.0,85,47,38,6962,4369,2593,15829219.0,14347210.0,1482008.0,2.8192,0.5705,3.2839,0.5715
2023-06-08 17:45,99,51,48,4526,3582,944,2566276.0,2028622.0,537654.0,86,44,42,4828,3823,1005,2737471.0,2161350.0,576121.0,0.5663,0.5695,0.5654,0.5733
2023-06-08 17:50,190,52,138,7934,5780,2154,4505634.0,3279461.0,1226172.0,183,48,135,6939,5403,1536,3930574.0,3055989.0,874584.0,0.5674,0.5693,0.5656,0.5694
2023-06-08 17:55,128,37,91,7335,3223,4112,16044984.0,13699474.0,2345509.0,111,28,83,7505,3260,4245,16136588.0,13720618.0,2415969.0,4.2505,0.5704,4.2088,0.5691
2023-06-08 18:00,93,32,61,5508,2938,2570,14997102.0,13536514.0,1460588.0,83,24,59,5711,3144,2567,15090583.0,13631694.0,1458888.0,4.6074,0.5683,4.3358,0.5683
2023-06-08 18:05,59,18,41,2799,1175,1624,1587007.0,663779.0,923227.0,54,16,38,2976,1354,1622,1687683.0,765130.0,922552.0,0.5649,0.5685,0.5651,0.5688
2023-06-08 18:10,121,61,60,7180,5480,1700,4065380.0,3100023.0,965356.0,112,57,55,7001,5361,1640,3963787.0,3032604.0,931182.0,0.5657,0.5679,0.5657,0.5678
2023-06-08 18:15,111,91,20,8221,7864,357,4654299.0,4450862.0,203437.0,104,85,19,8112,7670,442,4593575.0,4340420.0,253155.0,0.566,0.5699,0.5659,0.5727
2023-06-08 18:20,62,58,4,5100,5064,36,2887286.0,2866767.0,20518.0,64,58,6,5140,5082,58,2909210.0,2875957.0,33252.0,0.5661,0.57,0.5659,0.5733
2023-06-08 18:25,277,39,238,6083,2490,3593,3448069.0,1409342.0,2038727.0,268,34,234,5389,2117,3272,3056310.0,1197883.0,1858427.0,0.566,0.5674,0.5658,0.568
2023-06-08 18:30,98,54,44,6248,5163,1085,3543454.0,2925323.0,618130.0,90,49,41,6783,4840,1943,3854034.0,2739376.0,1114657.0,0.5666,0.5697,0.566,0.5737
2023-06-08 18:35,497,45,452,9191,3899,5292,5243538.0,2232412.0,3011126.0,496,43,453,9633,3868,5765,5473836.0,2190118.0,3283718.0,0.5726,0.569,0.5662,0.5696
2023-06-09 10:00,2518,1107,1411,182540,96179,86361,115184357.0,65538508.0,49645849.0,2268,976,1292,164670,84762,79908,100628796.0,54973580.0,45655216.0,0.6814,0.5749,0.6486,0.5713
2023-06-09 10:05,1744,1059,685,94644,72383,22261,73412529.0,60718607.0,12693921.0,1705,1046,659,94443,72269,22174,66155100.0,53501822.0,12653277.0,0.8389,0.5702,0.7403,0.5706
2023-06-09 10:10,862,250,612,26799,10981,15818,26939010.0,17936346.0,9002664.0,755,190,565,23339,8278,15061,25122616.0,16556196.0,8566420.0,1.6334,0.5691,2.0,0.5688
2023-06-09 10:15,507,121,386,14422,6158,8264,8178771.0,3479597.0,4699173.0,461,87,374,14375,5274,9101,8159068.0,2981465.0,5177602.0,0.5651,0.5686,0.5653,0.5689
2023-06-09 10:20,383,70,313,14793,4737,10056,8407843.0,2684675.0,5723168.0,356,52,304,14343,4261,10082,8149008.0,2413744.0,5735264.0,0.5667,0.5691,0.5665,0.5689
2023-06-09 10:25,664,303,361,31059,20012,11047,29545556.0,23217677.0,6327879.0,626,288,338,29195,19389,9806,28446522.0,22861638.0,5584884.0,1.1602,0.5728,1.1791,0.5695
2023-06-09 10:30,378,275,103,13296,7506,5790,7539821.0,4255380.0,3284441.0,351,259,92,12516,7488,5028,7116883.0,4245416.0,2871467.0,0.5669,0.5673,0.567,0.5711
2023-06-09 10:35,754,276,478,21489,12482,9007,12224508.0,7071916.0,5152592.0,727,260,467,21069,12219,8850,11975505.0,6924579.0,5050925.0,0.5666,0.5721,0.5667,0.5707
2023-06-09 10:40,502,242,260,14483,9288,5195,8244444.0,5270756.0,2973688.0,485,231,254,13954,9084,4870,7930782.0,5154691.0,2776090.0,0.5675,0.5724,0.5674,0.57
2023-06-09 10:45,650,237,413,18320,7763,10557,10423425.0,4404914.0,6018511.0,632,225,407,17434,7032,10402,9914969.0,3989245.0,5925724.0,0.5674,0.5701,0.5673,0.5697
2023-06-09 10:50,86,18,68,3740,254,3486,2132392.0,147573.0,1984819.0,74,10,64,3500,192,3308,1993308.0,109027.0,1884280.0,0.581,0.5694,0.5679,0.5696
2023-06-09 10:55,389,135,254,11228,5719,5509,18285188.0,15139546.0,3145642.0,356,118,238,10806,5717,5089,18020028.0,15119520.0,2900508.0,2.6472,0.571,2.6447,0.57
2023-06-09 11:00,388,306,82,11785,7392,4393,6709452.0,4201533.0,2507919.0,366,298,68,10937,6946,3991,6226482.0,3946687.0,2279795.0,0.5684,0.5709,0.5682,0.5712
2023-06-09 11:05,407,184,223,10184,3635,6549,5806760.0,2066823.0,3739937.0,396,180,216,9867,3400,6467,5625675.0,1933422.0,3692253.0,0.5686,0.5711,0.5687,0.5709
2023-06-09 11:10,976,677,299,30737,22458,8279,17472974.0,12751743.0,4721231.0,963,669,294,30320,22210,8110,17252082.0,12622190.0,4629891.0,0.5678,0.5703,0.5683,0.5709
2023-06-09 11:15,337,218,119,12688,6673,6015,7224689.0,3791754.0,3432934.0,326,213,113,12259,6469,5790,6979657.0,3674522.0,3305135.0,0.5682,0.5707,0.568,0.5708
2023-06-09 11:20,208,168,40,13362,9493,3869,7617945.0,5387729.0,2230215.0,202,167,35,11817,9475,2342,6717274.0,5377298.0,1339976.0,0.5675,0.5764,0.5675,0.5722
2023-06-09 11:25,426,275,151,9684,6998,2686,5508352.0,3972941.0,1535411.0,419,274,145,9073,6847,2226,5155796.0,3887386.0,1268410.0,0.5677,0.5716,0.5678,0.5698
2023-06-09 11:30,79,46,33,2440,1265,1175,1390629.0,717662.0,672966.0,71,41,30,3025,1184,1841,1728951.0,671412.0,1057539.0,0.5673,0.5727,0.5671,0.5744
2023-06-09 11:35,264,232,32,4888,4190,698,2777120.0,2378457.0,398662.0,255,228,27,5181,4315,866,2942825.0,2448872.0,493953.0,0.5677,0.5711,0.5675,0.5704
2023-06-09 11:40,84,59,25,3596,3178,418,2025660.0,1787543.0,238117.0,81,58,23,3494,3080,414,1984820.0,1748583.0,236237.0,0.5625,0.5697,0.5677,0.5706
2023-06-09 11:45,264,28,236,4505,1751,2754,2565203.0,993887.0,1571315.0,250,22,228,3736,1336,2400,2125582.0,757722.0,1367859.0,0.5676,0.5706,0.5672,0.5699
2023-06-09 11:50,297,137,160,7003,4106,2897,3979033.0,2330096.0,1648937.0,286,132,154,7309,4417,2892,4154391.0,2506876.0,1647514.0,0.5675,0.5692,0.5676,0.5697
2023-06-09 11:55,87,47,40,4815,3387,1428,2730950.0,1917034.0,813916.0,67,31,36,4077,2798,1279,2316163.0,1587092.0,729071.0,0.566,0.57,0.5672,0.57
2023-06-09 12:00,55,17,38,1884,582,1302,1088979.0,341501.0,747478.0,49,13,36,1483,402,1081,844045.0,227898.0,616146.0,0.5868,0.5741,0.5669,0.57
2023-06-09 12:05,78,25,53,1896,318,1578,1068387.0,179237.0,889150.0,61,15,46,1674,255,1419,953800.0,144583.0,809216.0,0.5636,0.5635,0.567,0.5703
2023-06-09 12:10,150,74,76,3715,961,2754,13992422.0,12422317.0,1570104.0,104,38,66,3344,834,2510,13779321.0,12347806.0,1431515.0,12.9264,0.5701,14.8055,0.5703
2023-06-09 12:15,179,50,129,12602,2920,9682,7186870.0,1656869.0,5530001.0,158,32,126,12313,2761,9552,7027576.0,1565512.0,5462064.0,0.5674,0.5712,0.567,0.5718
2023-06-09 12:20,162,37,125,5178,920,4258,2945120.0,524443.0,2420677.0,143,25,118,5076,834,4242,2884024.0,472474.0,2411549.0,0.57,0.5685,0.5665,0.5685
2023-06-09 12:25,91,25,66,3066,207,2859,1742173.0,117347.0,1624825.0,85,23,62,3059,204,2855,1739394.0,115624.0,1623770.0,0.5669,0.5683,0.5668,0.5687
2023-06-09 12:30,389,166,223,7075,2121,4954,4020265.0,1203225.0,2817040.0,374,159,215,7833,2109,5724,4452090.0,1195732.0,3256358.0,0.5673,0.5686,0.567,0.5689
2023-06-09 12:35,72,23,49,2805,1079,1726,1583668.0,597817.0,985850.0,67,18,49,1948,238,1710,1111380.0,134872.0,976507.0,0.554,0.5712,0.5667,0.5711
2023-06-09 12:40,57,29,28,1972,1235,737,1096134.0,675830.0,420304.0,50,26,24,1361,644,717,773869.0,365013.0,408855.0,0.5472,0.5703,0.5668,0.5702
2023-06-09 12:45,495,206,289,11173,3001,8172,6355492.0,1702457.0,4653034.0,484,201,283,11020,2969,8051,6277252.0,1684302.0,4592950.0,0.5673,0.5694,0.5673,0.5705
2023-06-09 12:50,141,49,92,3895,924,2971,2241048.0,527621.0,1713427.0,127,42,85,2412,568,1844,1371272.0,321810.0,1049462.0,0.571,0.5767,0.5666,0.5691
2023-06-09 12:55,32,19,13,924,650,274,513567.0,358935.0,154632.0,24,13,11,353,289,64,199856.0,163401.0,36455.0,0.5522,0.5644,0.5654,0.5696
2023-06-09 13:00,178,57,121,3320,770,2550,1891520.0,440777.0,1450742.0,168,48,120,3332,703,2629,1894052.0,398250.0,1495801.0,0.5724,0.5689,0.5665,0.569
2023-06-09 13:05,136,17,119,3761,133,3628,2140286.0,75386.0,2064900.0,134,17,117,3731,218,3513,2122505.0,121817.0,2000688.0,0.5668,0.5692,0.5588,0.5695
2023-06-09 13:10,146,34,112,2722,273,2449,1545286.0,154538.0,1390747.0,135,29,106,2653,236,2417,1509019.0,133620.0,1375398.0,0.5661,0.5679,0.5662,0.5691
2023-06-09 13:15,94,27,67,1880,327,1553,1059081.0,185044.0,874037.0,90,23,67,1780,316,1464,1011913.0,178827.0,833086.0,0.5659,0.5628,0.5659,0.569
2023-06-09 13:20,93,49,44,1986,999,987,1133160.0,571064.0,562095.0,61,18,43,2068,1067,1001,1175613.0,604601.0,571011.0,0.5716,0.5695,0.5666,0.5704
2023-06-09 13:25,54,25,29,774,198,576,441787.0,113438.0,328349.0,32,12,20,546,131,415,310935.0,74271.0,236663.0,0.5729,0.5701,0.567,0.5703
2023-06-09 13:30,34,11,23,771,317,454,436307.0,177780.0,258527.0,29,7,22,825,180,645,471314.0,101895.0,369418.0,0.5608,0.5694,0.5661,0.5727
2023-06-09 13:35,254,17,237,3368,141,3227,1898765.0,79707.0,1819058.0,243,12,231,2879,89,2790,1635946.0,50193.0,1585752.0,0.5653,0.5637,0.564,0.5684
2023-06-09 13:40,23,11,12,3099,2431,668,1669690.0,1334955.0,334734.0,16,6,10,283,177,106,161419.0,100219.0,61199.0,0.5491,0.5011,0.5662,0.5774
2023-06-09 13:45,67,19,48,1827,292,1535,1032764.0,165562.0,867202.0,53,13,40,1661,242,1419,944242.0,136620.0,807622.0,0.567,0.565,0.5645,0.5691
2023-06-09 13:50,22,11,11,753,229,524,427567.0,129376.0,298190.0,16,6,10,531,53,478,302052.0,30018.0,272034.0,0.565,0.5691,0.5664,0.5691
2023-06-09 13:55,59,19,40,2849,736,2113,1607663.0,415505.0,1192157.0,52,15,37,2660,721,1939,1510348.0,407230.0,1103118.0,0.5645,0.5642,0.5648,0.5689
2023-06-09 14:00,66,29,37,2989,1415,1574,1691691.0,797271.0,894420.0,58,23,35,2910,1292,1618,1648726.0,728943.0,919782.0,0.5634,0.5682,0.5642,0.5685
2023-06-09 14:05,248,20,228,4060,584,3476,2306676.0,330908.0,1975767.0,243,18,225,3960,494,3466,2248650.0,279690.0,1968960.0,0.5666,0.5684,0.5662,0.5681
2023-06-09 14:10,92,50,42,3384,2828,556,1924722.0,1609162.0,315559.0,76,40,36,3019,2507,512,1712956.0,1421592.0,291364.0,0.569,0.5676,0.567,0.5691
2023-06-09 14:15,231,189,42,5364,3809,1555,3038888.0,2157456.0,881431.0,223,184,39,5072,3662,1410,2877530.0,2075027.0,802502.0,0.5664,0.5668,0.5666,0.5692
2023-06-09 14:20,327,76,251,12288,6761,5527,6982749.0,3832176.0,3150572.0,320,71,249,11726,6325,5401,6656586.0,3584597.0,3071988.0,0.5668,0.57,0.5667,0.5688
2023-06-09 14:25,356,101,255,15984,9840,6144,9072663.0,5577841.0,3494822.0,346,98,248,15980,9834,6146,9068986.0,5573659.0,3495327.0,0.5669,0.5688,0.5668,0.5687
2023-06-09 14:30,83,38,45,7037,3926,3111,3995482.0,2225065.0,1770416.0,76,37,39,7008,3917,3091,3978255.0,2219693.0,1758562.0,0.5668,0.5691,0.5667,0.5689
2023-06-09 14:35,68,18,50,3901,1540,2361,2216325.0,872791.0,1343533.0,59,15,44,3844,1533,2311,2183553.0,868647.0,1314906.0,0.5667,0.5691,0.5666,0.569
2023-06-09 14:40,44,8,36,3321,475,2846,1886076.0,266766.0,1619309.0,39,6,33,3498,698,2800,1988685.0,395440.0,1593245.0,0.5616,0.569,0.5665,0.569
2023-06-09 14:45,368,87,281,11609,7218,4391,6574483.0,4093588.0,2480895.0,360,82,278,11138,6866,4272,6319257.0,3890776.0,2428481.0,0.5671,0.565,0.5667,0.5685
2023-06-09 14:50,347,174,173,16348,11803,4545,9219272.0,6686946.0,2532326.0,332,167,165,15560,11705,3855,8822962.0,6631513.0,2191448.0,0.5665,0.5572,0.5666,0.5685
2023-06-09 14:55,37,7,30,2192,9,2183,1245613.0,4783.0,1240829.0,34,5,29,2198,34,2164,1247350.0,17241.0,1230108.0,0.5315,0.5684,0.5071,0.5684
2023-06-09 15:00,283,21,262,5578,441,5137,3169977.0,249868.0,2920108.0,274,14,260,5561,558,5003,3159395.0,314692.0,2844703.0,0.5666,0.5684,0.564,0.5686
2023-06-09 15:05,68,28,40,3833,1574,2259,2178183.0,893145.0,1285038.0,56,21,35,3706,1480,2226,2104645.0,838923.0,1265721.0,0.5674,0.5689,0.5668,0.5686
2023-06-09 15:10,101,30,71,7070,2032,5038,4015130.0,1150294.0,2864835.0,96,28,68,6608,1871,4737,3752744.0,1058964.0,2693779.0,0.5661,0.5686,0.566,0.5687
2023-06-09 15:15,70,20,50,4954,1215,3739,2814194.0,687551.0,2126643.0,66,18,48,5236,1248,3988,2974510.0,706176.0,2268334.0,0.5659,0.5688,0.5658,0.5688
2023-06-09 15:20,116,24,92,5601,1268,4333,3209629.0,742873.0,2466756.0,107,19,88,4417,436,3981,2511973.0,245894.0,2266079.0,0.5859,0.5693,0.564,0.5692
2023-06-09 15:25,46,14,32,1189,104,1085,675781.0,58921.0,616860.0,42,13,29,1328,263,1065,756124.0,149070.0,607053.0,0.5665,0.5685,0.5668,0.57
2023-06-09 15:30,228,106,122,3629,1329,2300,2062994.0,753214.0,1309780.0,225,104,121,3516,1224,2292,1999935.0,694845.0,1305090.0,0.5668,0.5695,0.5677,0.5694
2023-06-09 15:35,91,26,65,4139,580,3559,2350578.0,326235.0,2024343.0,89,23,66,4126,358,3768,2346210.0,202885.0,2143325.0,0.5625,0.5688,0.5667,0.5688
2023-06-09 15:40,21,11,10,681,353,328,386423.0,200206.0,186217.0,14,6,8,575,351,224,326234.0,198882.0,127352.0,0.5672,0.5677,0.5666,0.5685
2023-06-09 15:45,28,10,18,723,159,564,422104.0,94838.0,327266.0,17,6,11,584,95,489,337544.0,53731.0,283812.0,0.5965,0.5803,0.5656,0.5804
2023-06-09 15:50,37,12,25,1776,206,1570,1014525.0,116601.0,897924.0,31,9,22,1266,193,1073,720184.0,109194.0,610989.0,0.566,0.5719,0.5658,0.5694
2023-06-09 15:55,39,11,28,1486,292,1194,844004.0,164477.0,679527.0,34,7,27,1399,267,1132,794227.0,150031.0,644196.0,0.5633,0.5691,0.5619,0.5691
2023-06-09 16:00,152,95,57,8116,6042,2074,16495623.0,15308227.0,1187396.0,131,83,48,6240,4388,1852,15421530.0,14364338.0,1057192.0,2.5336,0.5725,3.2736,0.5708
2023-06-09 16:05,112,53,59,3127,1275,1852,1742571.0,695308.0,1047263.0,100,47,53,2615,859,1756,1487935.0,487466.0,1000469.0,0.5453,0.5655,0.5675,0.5697
2023-06-09 16:10,869,233,636,59238,14661,44577,45557648.0,20185299.0,25372349.0,856,225,631,57652,14192,43460,44746010.0,19919128.0,24826882.0,1.3768,0.5692,1.4035,0.5713
2023-06-09 16:15,1271,741,530,92442,64462,27980,64404118.0,48446520.0,15957597.0,1244,722,522,91007,63491,27516,63600270.0,47893007.0,15707263.0,0.7516,0.5703,0.7543,0.5708
2023-06-09 16:20,817,394,423,45119,33650,11469,25611202.0,19080073.0,6531128.0,814,393,421,45192,33497,11695,25657643.0,18997681.0,6659961.0,0.567,0.5695,0.5671,0.5695
2023-06-09 16:25,342,98,244,19330,4919,14411,10974446.0,2773189.0,8201256.0,334,91,243,18382,4000,14382,10439608.0,2254501.0,8185107.0,0.5638,0.5691,0.5636,0.5691
2023-06-09 16:30,626,274,352,35186,21193,13993,19928562.0,11964074.0,7964488.0,618,270,348,35229,21191,14038,19952607.0,11962748.0,7989858.0,0.5645,0.5692,0.5645,0.5692
2023-06-09 16:35,338,109,229,15982,6801,9181,9075781.0,3852580.0,5223201.0,331,105,226,16323,7249,9074,9266459.0,4102149.0,5164310.0,0.5665,0.5689,0.5659,0.5691
2023-06-09 16:40,98,36,62,9823,7684,2139,5575479.0,4357884.0,1217595.0,97,35,62,9714,7586,2128,5505520.0,4294052.0,1211468.0,0.5671,0.5692,0.566,0.5693
2023-06-09 16:45,119,47,72,9082,5157,3925,5157015.0,2920833.0,2236182.0,115,46,69,8769,4947,3822,4978398.0,2801737.0,2176660.0,0.5664,0.5697,0.5664,0.5695
2023-06-09 16:50,316,30,286,7687,2032,5655,4370694.0,1151668.0,3219026.0,312,28,284,7133,1590,5543,4056245.0,901329.0,3154915.0,0.5668,0.5692,0.5669,0.5692
2023-06-09 16:55,383,205,178,38258,32368,5890,21661267.0,18309406.0,3351860.0,382,207,175,39549,33541,6008,22392114.0,18972862.0,3419251.0,0.5657,0.5691,0.5657,0.5691
2023-06-09 17:00,796,155,641,59882,34365,25517,45797666.0,31301009.0,14496656.0,778,143,635,59340,34269,25071,45503665.0,31241033.0,14262632.0,0.9108,0.5681,0.9116,0.5689
2023-06-09 17:05,601,208,393,67995,46589,21406,38513230.0,26333612.0,12179618.0,596,205,391,67833,46466,21367,38422102.0,26264627.0,12157475.0,0.5652,0.569,0.5652,0.569
2023-06-09 17:10,574,84,490,39867,22230,17637,22582515.0,12550258.0,10032257.0,568,80,488,39636,22212,17424,22452440.0,12540548.0,9911891.0,0.5646,0.5688,0.5646,0.5689
2023-06-09 17:15,412,78,334,34707,18050,16657,19670580.0,10192324.0,9478256.0,406,76,330,34551,17917,16634,19581216.0,10114751.0,9466464.0,0.5647,0.569,0.5645,0.5691
2023-06-09 17:20,365,60,305,25034,12629,12405,14179833.0,7128841.0,7050991.0,350,55,295,24554,12569,11985,13914189.0,7096840.0,6817348.0,0.5645,0.5684,0.5646,0.5688
2023-06-09 17:25,103,26,77,4519,2329,2190,2563786.0,1319224.0,1244561.0,93,18,75,4557,2355,2202,2580375.0,1328984.0,1251391.0,0.5664,0.5683,0.5643,0.5683
2023-06-09 17:30,433,86,347,27537,16053,11484,15572768.0,9066453.0,6506315.0,412,74,338,26843,15906,10937,15190564.0,8975566.0,6214997.0,0.5648,0.5666,0.5643,0.5683
2023-06-09 17:35,143,62,81,15152,11567,3585,8558605.0,6521044.0,2037560.0,140,61,79,15333,11526,3807,8664414.0,6500734.0,2163680.0,0.5638,0.5684,0.564,0.5683
2023-06-09 17:40,754,278,476,89027,64553,24474,50468844.0,36543321.0,13925522.0,752,272,480,89307,64557,24750,50627085.0,36541737.0,14085347.0,0.5661,0.569,0.566,0.5691
2023-06-09 17:45,547,299,248,61105,54073,7032,46472085.0,42465624.0,4006460.0,519,286,233,59917,53647,6270,45772866.0,42200567.0,3572298.0,0.7853,0.5697,0.7866,0.5697
2023-06-09 17:50,152,62,90,13492,10368,3124,7630794.0,5852455.0,1778339.0,125,50,75,12780,10125,2655,7227172.0,5714447.0,1512724.0,0.5645,0.5693,0.5644,0.5698
2023-06-09 17:55,137,35,102,7430,4739,2691,4223866.0,2695180.0,1528686.0,129,32,97,7558,4971,2587,4292217.0,2817601.0,1474616.0,0.5687,0.5681,0.5668,0.57
2023-06-09 18:00,83,44,39,3742,2839,903,2116105.0,1606375.0,509729.0,78,41,37,4135,3371,764,2326096.0,1890352.0,435744.0,0.5658,0.5645,0.5608,0.5703
2023-06-09 18:05,250,36,214,6391,3582,2809,3625343.0,2029216.0,1596127.0,248,35,213,6595,3862,2733,3738663.0,2185359.0,1553304.0,0.5665,0.5682,0.5659,0.5684
2023-06-09 18:10,310,72,238,10599,7063,3536,6015955.0,4003174.0,2012780.0,316,71,245,10901,7120,3781,6187047.0,4034739.0,2152308.0,0.5668,0.5692,0.5667,0.5692
2023-06-09 18:15,457,111,346,22544,16984,5560,12747777.0,9582963.0,3164814.0,439,102,337,21871,16463,5408,12353748.0,9274096.0,3079652.0,0.5642,0.5692,0.5633,0.5695
2023-06-09 18:20,229,131,98,25238,22195,3043,14257005.0,12523488.0,1733516.0,218,126,92,24870,22154,2716,14051272.0,12503381.0,1547890.0,0.5642,0.5697,0.5644,0.5699
2023-06-09 18:25,266,31,235,2545,845,1700,1446685.0,479898.0,966787.0,256,26,230,2298,647,1651,1306245.0,367016.0,939228.0,0.5679,0.5687,0.5673,0.5689
2023-06-09 18:30,280,43,237,6712,1650,5062,3801983.0,934098.0,2867885.0,273,39,234,4918,1572,3346,2792373.0,890222.0,1902151.0,0.5661,0.5666,0.5663,0.5685
2023-06-09 18:35,302,194,108,21792,17077,4715,24204610.0,21526874.0,2677736.0,299,192,107,21962,17355,4607,24295553.0,21677100.0,2618453.0,1.2606,0.5679,1.249,0.5684
2023-06-13 10:00,2761,1740,1021,215624,180817,34807,147475573.0,127289046.0,20186526.0,2540,1630,910,198230,169838,28392,133112426.0,116908675.0,16203751.0,0.704,0.58,0.6884,0.5707
2023-06-13 10:05,1607,1032,575,100231,91461,8770,68540786.0,63517491.0,5023295.0,1533,1002,531,98684,90616,8068,60476185.0,55878214.0,4597971.0,0.6945,0.5728,0.6166,0.5699
2023-06-13 10:10,1128,520,608,51914,41660,10254,41317746.0,35457212.0,5860534.0,1082,504,578,50713,41150,9563,40611239.0,35154130.0,5457108.0,0.8511,0.5715,0.8543,0.5706
2023-06-13 10:15,1028,308,720,34675,20168,14507,19686394.0,11381503.0,8304891.0,976,279,697,32374,19363,13011,18380265.0,10966156.0,7414108.0,0.5643,0.5725,0.5663,0.5698
2023-06-13 10:20,1488,682,806,62988,47085,15903,59476342.0,50441248.0,9035094.0,1396,636,760,61946,46564,15382,58906286.0,50146908.0,8759378.0,1.0713,0.5681,1.0769,0.5695
2023-06-13 10:25,1883,1072,811,118354,78388,39966,90820570.0,67984176.0,22836393.0,1847,1052,795,114721,76242,38479,88907598.0,66921272.0,21986326.0,0.8673,0.5714,0.8777,0.5714
2023-06-13 10:30,860,434,426,50197,35451,14746,28452553.0,20046450.0,8406103.0,838,416,422,49324,34488,14836,27961507.0,19504325.0,8457181.0,0.5655,0.5701,0.5655,0.57
2023-06-13 10:35,495,275,220,23126,15814,7312,13125522.0,8968195.0,4157327.0,452,254,198,23110,15466,7644,13116005.0,8761710.0,4354295.0,0.5671,0.5686,0.5665,0.5696
2023-06-13 10:40,384,238,146,24866,15355,9511,14157394.0,8685401.0,5471993.0,333,212,121,19358,14840,4518,10969043.0,8394799.0,2574244.0,0.5656,0.5753,0.5657,0.5698
2023-06-13 10:45,191,124,67,6323,4004,2319,3583200.0,2258763.0,1324436.0,156,106,50,5536,3759,1777,3138278.0,2123096.0,1015181.0,0.5641,0.5711,0.5648,0.5713
2023-06-13 10:50,534,437,97,51060,47659,3401,28846272.0,26894076.0,1952196.0,505,421,84,47149,45404,1745,26653940.0,25657439.0,996501.0,0.5643,0.574,0.5651,0.5711
2023-06-13 10:55,912,776,136,74173,69370,4803,53917110.0,51169001.0,2748108.0,885,768,117,72742,68681,4061,53093399.0,50769164.0,2324235.0,0.7376,0.5722,0.7392,0.5723
2023-06-13 11:00,1008,544,464,59510,27669,31841,45867995.0,27621986.0,18246008.0,981,536,445,58550,27367,31183,45280721.0,27414917.0,17865803.0,0.9983,0.573,1.0018,0.5729
2023-06-13 11:05,627,357,270,24156,11952,12204,13797577.0,6815025.0,6982552.0,587,338,249,22293,10721,11572,12735302.0,6112900.0,6622402.0,0.5702,0.5722,0.5702,0.5723
2023-06-13 11:10,715,499,216,21787,15288,6499,24383622.0,20653614.0,3730007.0,691,489,202,22308,15466,6842,24640940.0,20708376.0,3932564.0,1.351,0.5739,1.339,0.5748
2023-06-13 11:15,524,353,171,21793,17630,4163,12438833.0,10074287.0,2364545.0,469,328,141,21011,17227,3784,12014627.0,9842808.0,2171818.0,0.5714,0.568,0.5714,0.5739
2023-06-13 11:20,380,203,177,15108,7555,7553,8655752.0,4311440.0,4344312.0,352,190,162,13222,7545,5677,7572493.0,4305941.0,3266552.0,0.5707,0.5752,0.5707,0.5754
2023-06-13 11:25,457,260,197,19163,12833,6330,22719767.0,19140817.0,3578949.0,411,241,170,17257,11593,5664,21738627.0,18488335.0,3250291.0,1.4915,0.5654,1.5948,0.5739
2023-06-13 11:30,322,165,157,12186,7734,4452,30729478.0,28183211.0,2546267.0,293,150,143,11329,7090,4239,30230328.0,27797692.0,2432635.0,3.6441,0.5719,3.9207,0.5739
2023-06-13 11:35,188,94,94,6578,4497,2081,15640962.0,14448499.0,1192463.0,163,83,80,6134,4404,1730,15377504.0,14385060.0,992444.0,3.2129,0.573,3.2664,0.5737
2023-06-13 11:40,177,75,102,6028,2943,3085,3441379.0,1673621.0,1767757.0,158,66,92,6460,2560,3900,3698713.0,1458399.0,2240314.0,0.5687,0.573,0.5697,0.5744
2023-06-13 11:45,192,115,77,5890,3372,2518,3373810.0,1926356.0,1447453.0,179,108,71,5935,3288,2647,3399378.0,1876125.0,1523252.0,0.5713,0.5748,0.5706,0.5755
2023-06-13 11:50,1194,457,737,98975,45359,53616,68229983.0,37603810.0,30626172.0,1166,445,721,97236,44903,52333,67303688.0,37345394.0,29958294.0,0.829,0.5712,0.8317,0.5725
2023-06-13 11:55,312,144,168,20307,6547,13760,11587271.0,3736404.0,7850867.0,285,126,159,18426,5885,12541,10531902.0,3352280.0,7179622.0,0.5707,0.5706,0.5696,0.5725
2023-06-13 12:00,284,164,120,7804,5079,2725,4457025.0,2897461.0,1559563.0,269,151,118,7921,4781,3140,4524258.0,2727681.0,1796576.0,0.5705,0.5723,0.5705,0.5722
2023-06-13 12:05,172,96,76,12950,5216,7734,7399397.0,2982593.0,4416803.0,151,84,67,11474,4669,6805,6558577.0,2662774.0,3895803.0,0.5718,0.5711,0.5703,0.5725
2023-06-13 12:10,98,40,58,2191,1044,1147,1254863.0,600472.0,654390.0,60,35,25,2476,1140,1336,1417606.0,650514.0,767091.0,0.5752,0.5705,0.5706,0.5742
2023-06-13 12:15,342,251,91,11927,7798,4129,6813043.0,4439330.0,2373713.0,302,246,56,9928,6573,3355,5665148.0,3739783.0,1925364.0,0.5693,0.5749,0.569,0.5739
2023-06-13 12:20,720,528,192,59022,49321,9701,33605690.0,28040742.0,5564948.0,672,519,153,58028,48312,9716,33040221.0,27463589.0,5576631.0,0.5685,0.5736,0.5685,0.574
2023-06-13 12:25,101,29,72,4701,1460,3241,2690033.0,834194.0,1855838.0,74,22,52,3822,922,2900,2187189.0,526576.0,1660612.0,0.5714,0.5726,0.5711,0.5726
2023-06-13 12:30,100,51,49,13903,1676,12227,8207522.0,957466.0,7250056.0,86,42,44,4385,1663,2722,2508538.0,947601.0,1560937.0,0.5713,0.593,0.5698,0.5735
2023-06-13 12:35,69,43,26,2845,1849,996,1632219.0,1063598.0,568621.0,60,37,23,3021,1757,1264,1727698.0,1002860.0,724838.0,0.5752,0.5709,0.5708,0.5734
2023-06-13 12:40,37,28,9,1993,1953,40,1137358.0,1114321.0,23036.0,25,21,4,1836,1808,28,1047867.0,1031710.0,16156.0,0.5706,0.5759,0.5706,0.577
2023-06-13 12:45,170,123,47,7443,5806,1637,4252434.0,3313634.0,938800.0,158,115,43,7018,5729,1289,4008826.0,3269738.0,739088.0,0.5707,0.5735,0.5707,0.5734
2023-06-13 12:50,450,386,64,25068,20614,4454,14338035.0,11750274.0,2587761.0,442,381,61,24167,21092,3075,13784787.0,12022437.0,1762350.0,0.57,0.581,0.57,0.5731
2023-06-13 12:55,20,14,6,862,838,24,491991.0,478208.0,13782.0,14,11,3,646,635,11,368653.0,362315.0,6338.0,0.5707,0.5743,0.5706,0.5762
2023-06-13 13:00,319,288,31,13473,12894,579,7673644.0,7343229.0,330415.0,304,283,21,12855,12384,471,7313145.0,7043389.0,269756.0,0.5695,0.5707,0.5687,0.5727
2023-06-13 13:05,143,101,42,9078,7208,1870,5150687.0,4097855.0,1052832.0,127,94,33,8620,6879,1741,4928249.0,3920700.0,1007548.0,0.5685,0.563,0.57,0.5787
2023-06-13 13:10,230,151,79,15710,10962,4748,8951866.0,6248096.0,2703770.0,210,139,71,15307,10472,4835,8743908.0,5967810.0,2776098.0,0.57,0.5695,0.5699,0.5742
2023-06-13 13:15,468,258,210,48400,15790,32610,27643462.0,8978075.0,18665387.0,458,257,201,48131,16192,31939,27490723.0,9207795.0,18282927.0,0.5686,0.5724,0.5687,0.5724
2023-06-13 13:20,290,193,97,17575,9431,8144,10003426.0,5336946.0,4666479.0,276,183,93,17611,9282,8329,10027805.0,5251522.0,4776283.0,0.5659,0.573,0.5658,0.5735
2023-06-13 13:25,192,116,76,17773,5404,12369,10163411.0,3059815.0,7103595.0,182,109,73,17257,5060,12197,9869649.0,2863564.0,7006085.0,0.5662,0.5743,0.5659,0.5744
2023-06-13 13:30,239,142,97,11606,5155,6451,6632398.0,2935570.0,3696827.0,234,141,93,11859,5286,6573,6779788.0,3009602.0,3770186.0,0.5695,0.5731,0.5694,0.5736
2023-06-13 13:35,723,374,349,68227,26075,42152,39010103.0,14836828.0,24173275.0,708,362,346,67166,25594,41572,38383074.0,14542298.0,23840776.0,0.569,0.5735,0.5682,0.5735
2023-06-13 13:40,169,106,63,9497,4207,5290,5431931.0,2400048.0,3031882.0,163,106,57,9426,4278,5148,5389799.0,2439578.0,2950221.0,0.5705,0.5731,0.5703,0.5731
2023-06-13 13:45,492,50,442,13248,2975,10273,7579482.0,1693908.0,5885574.0,484,46,438,12977,2888,10089,7425470.0,1644627.0,5780842.0,0.5694,0.5729,0.5695,0.573
2023-06-13 13:50,251,191,60,13136,10731,2405,7484353.0,6100411.0,1383942.0,243,188,55,13054,10798,2256,7439013.0,6138265.0,1300748.0,0.5685,0.5754,0.5685,0.5766
2023-06-13 13:55,214,134,80,13271,8489,4782,7610733.0,4864817.0,2745916.0,201,125,76,12542,7626,4916,7169072.0,4344171.0,2824900.0,0.5731,0.5742,0.5697,0.5746
2023-06-13 14:00,278,78,200,10075,4883,5192,5760891.0,2787120.0,2973770.0,274,75,199,9652,4643,5009,5519185.0,2649989.0,2869195.0,0.5708,0.5728,0.5707,0.5728
2023-06-13 14:05,479,122,357,25907,6778,19129,14859945.0,3868113.0,10991831.0,470,119,351,25433,6601,18832,14589312.0,3767337.0,10821974.0,0.5707,0.5746,0.5707,0.5747
2023-06-13 14:10,323,217,106,23484,16837,6647,13416829.0,9607103.0,3809725.0,315,216,99,22921,16793,6128,13093665.0,9582041.0,3511624.0,0.5706,0.5731,0.5706,0.573
2023-06-13 14:15,200,99,101,11458,4387,7071,6552155.0,2503116.0,4049039.0,191,95,96,10805,4120,6685,6184828.0,2350468.0,3834360.0,0.5706,0.5726,0.5705,0.5736
2023-06-13 14:20,371,296,75,15928,11435,4493,32853652.0,30278165.0,2575487.0,362,294,68,16082,11781,4301,32931775.0,30465181.0,2466593.0,2.6479,0.5732,2.586,0.5735
2023-06-13 14:25,252,37,215,6395,984,5411,3653443.0,565609.0,3087833.0,232,23,209,5817,531,5286,3328849.0,302780.0,3026068.0,0.5748,0.5707,0.5702,0.5725
2023-06-13 14:30,135,87,48,7133,4266,2867,15948489.0,14303460.0,1645029.0,123,83,40,8009,4664,3345,16445317.0,14525680.0,1919637.0,3.3529,0.5738,3.1144,0.5739
2023-06-13 14:35,86,58,28,4209,2416,1793,2393502.0,1373942.0,1019559.0,73,50,23,2927,1932,995,1671872.0,1099915.0,571957.0,0.5687,0.5686,0.5693,0.5748
2023-06-13 14:40,203,160,43,11837,10730,1107,6761395.0,6127524.0,633870.0,194,157,37,11653,10597,1056,6656349.0,6051729.0,604620.0,0.5711,0.5726,0.5711,0.5726
2023-06-13 14:45,162,123,39,7938,6693,1245,16393892.0,15697438.0,696454.0,150,114,36,7577,6530,1047,16205535.0,15604355.0,601180.0,2.3454,0.5594,2.3896,0.5742
2023-06-13 14:50,99,65,34,4541,2677,1864,2594235.0,1525602.0,1068633.0,87,60,27,5227,2575,2652,2985351.0,1464023.0,1521327.0,0.5699,0.5733,0.5686,0.5737
2023-06-13 14:55,69,40,29,3550,930,2620,2048251.0,531332.0,1516918.0,56,33,23,2031,911,1120,1166411.0,519741.0,646670.0,0.5713,0.579,0.5705,0.5774
2023-06-13 15:00,101,61,40,8937,2735,6202,5122111.0,1560252.0,3561858.0,100,61,39,9039,2849,6190,5178106.0,1624577.0,3553529.0,0.5705,0.5743,0.5702,0.5741
2023-06-13 15:05,114,72,42,9752,4434,5318,5578212.0,2529901.0,3048311.0,109,69,40,9778,4266,5512,5593266.0,2434143.0,3159122.0,0.5706,0.5732,0.5706,0.5731
2023-06-13 15:10,211,112,99,15453,4713,10740,8839088.0,2689032.0,6150056.0,208,111,97,15611,4744,10867,8929365.0,2705132.0,6224233.0,0.5706,0.5726,0.5702,0.5728
2023-06-13 15:15,185,102,83,11035,4383,6652,6293233.0,2497054.0,3796179.0,176,96,80,10307,4064,6243,5891493.0,2314917.0,3576576.0,0.5697,0.5707,0.5696,0.5729
2023-06-13 15:20,278,234,44,9815,8724,1091,5609730.0,4985817.0,623912.0,272,232,40,10268,8804,1464,5861504.0,5022622.0,838881.0,0.5715,0.5719,0.5705,0.573
2023-06-13 15:25,70,40,30,3994,1903,2091,2275085.0,1085139.0,1189946.0,65,36,29,3481,1645,1836,1988997.0,937289.0,1051708.0,0.5702,0.5691,0.5698,0.5728
2023-06-13 15:30,62,43,19,2610,1822,788,1484888.0,1035250.0,449638.0,55,40,15,2813,1922,891,1604158.0,1092213.0,511945.0,0.5682,0.5706,0.5683,0.5746
2023-06-13 15:35,47,24,23,1856,675,1181,1065000.0,388840.0,676159.0,39,19,20,1784,645,1139,1020812.0,368087.0,652725.0,0.5761,0.5725,0.5707,0.5731
2023-06-13 15:40,109,73,36,6664,4565,2099,3815423.0,2605857.0,1209565.0,99,68,31,6099,4298,1801,3492404.0,2455696.0,1036708.0,0.5708,0.5763,0.5714,0.5756
2023-06-13 15:45,180,137,43,8577,6153,2424,4911136.0,3515005.0,1396131.0,171,131,40,8268,6224,2044,4732797.0,3555584.0,1177213.0,0.5713,0.576,0.5713,0.5759
2023-06-13 15:50,2231,404,1827,174584,24017,150567,170746151.0,84907811.0,85838339.0,2199,382,1817,171731,23091,148640,169303830.0,84379173.0,84924657.0,3.5353,0.5701,3.6542,0.5713
2023-06-13 15:55,1989,1007,982,153933,85288,68645,111579414.0,72325507.0,39253906.0,1956,984,972,152831,84362,68469,110913770.0,71760312.0,39153457.0,0.848,0.5718,0.8506,0.5718
2023-06-13 16:00,1532,1023,509,105493,80692,24801,95729250.0,81536107.0,14193143.0,1517,1020,497,104358,80605,23753,95079800.0,81487907.0,13591892.0,1.0105,0.5723,1.011,0.5722
2023-06-13 16:05,1238,958,280,93561,83110,10451,88949254.0,82969802.0,5979452.0,1198,921,277,92463,82238,10225,88325748.0,82473460.0,5852287.0,0.9983,0.5721,1.0029,0.5724
2023-06-13 16:10,1622,1032,590,112333,95150,17183,87761107.0,77933888.0,9827219.0,1643,1071,572,112959,96127,16832,88112610.0,78484373.0,9628236.0,0.8191,0.5719,0.8165,0.572
2023-06-13 16:15,1381,954,427,92698,77508,15190,76576166.0,67886135.0,8690031.0,1380,953,427,92776,77604,15172,76620368.0,67940538.0,8679830.0,0.8759,0.5721,0.8755,0.5721
2023-06-13 16:20,1144,898,246,90844,79890,10954,51756404.0,45489887.0,6266517.0,1143,898,245,90773,79906,10867,51715692.0,45498929.0,6216762.0,0.5694,0.5721,0.5694,0.5721
2023-06-13 16:25,1329,908,421,109522,91268,18254,62388746.0,51947985.0,10440761.0,1318,901,417,109135,91120,18015,62167567.0,51863312.0,10304255.0,0.5692,0.572,0.5692,0.572
2023-06-13 16:30,2152,1750,402,176308,144079,32229,112239307.0,93840833.0,18398474.0,2118,1726,392,175438,143933,31505,111769086.0,93755858.0,18013227.0,0.6513,0.5709,0.6514,0.5718
2023-06-13 16:35,390,348,42,19230,16458,2772,10977107.0,9391441.0,1585665.0,342,308,34,17336,14535,2801,9892393.0,8287646.0,1604747.0,0.5706,0.572,0.5702,0.5729
2023-06-13 16:40,2243,1915,328,239554,226914,12640,136404766.0,129148331.0,7256435.0,2220,1900,320,239273,226577,12696,136222403.0,128934127.0,7288276.0,0.5692,0.5741,0.5691,0.5741
2023-06-13 16:45,785,695,90,75709,72223,3486,43113855.0,41108382.0,2005472.0,778,692,86,75479,72198,3281,42978119.0,41091859.0,1886260.0,0.5692,0.5753,0.5692,0.5749
2023-06-13 16:50,583,484,99,60239,56656,3583,34262052.0,32205741.0,2056311.0,561,475,86,59207,56488,2719,33673629.0,32109395.0,1564234.0,0.5684,0.5739,0.5684,0.5753
2023-06-13 16:55,272,225,47,32966,31190,1776,18681818.0,17666167.0,1015650.0,266,222,44,32922,31201,1721,18658572.0,17672477.0,986094.0,0.5664,0.5719,0.5664,0.573
2023-06-13 17:00,236,187,49,28622,26403,2219,16292752.0,15021834.0,1270917.0,227,178,49,28564,26287,2277,16258707.0,14954357.0,1304349.0,0.5689,0.5727,0.5689,0.5728
2023-06-13 17:05,120,75,45,10957,7304,3653,6252163.0,4148778.0,2103384.0,108,70,38,10727,7444,3283,6116915.0,4226747.0,1890168.0,0.568,0.5758,0.5678,0.5757
2023-06-13 17:10,117,45,72,6992,3589,3403,3994553.0,2044215.0,1950338.0,111,41,70,7296,3596,3700,4171000.0,2048283.0,2122717.0,0.5696,0.5731,0.5696,0.5737
2023-06-13 17:15,351,184,167,29650,22275,7375,28743571.0,24527793.0,4215777.0,332,172,160,27689,21532,6157,27623670.0,24100612.0,3523057.0,1.1011,0.5716,1.1193,0.5722
2023-06-13 17:20,1368,484,884,133402,61776,71626,87944555.0,47003250.0,40941305.0,1368,483,885,134593,61946,72647,88624088.0,47097906.0,41526181.0,0.7609,0.5716,0.7603,0.5716
2023-06-13 17:25,1246,556,690,101050,46018,55032,81367529.0,49912735.0,31454793.0,1234,545,689,101092,45883,55209,81389964.0,49835429.0,31554535.0,1.0846,0.5716,1.0861,0.5715
2023-06-13 17:30,496,281,215,44441,27345,17096,25325325.0,15533909.0,9791416.0,491,277,214,44149,27055,17094,25160652.0,15370265.0,9790387.0,0.5681,0.5727,0.5681,0.5727
2023-06-13 17:35,188,107,81,10679,5536,5143,6106635.0,3152715.0,2953920.0,182,105,77,10733,5388,5345,6139272.0,3068387.0,3070884.0,0.5695,0.5744,0.5695,0.5745
2023-06-13 17:40,141,85,56,11031,8419,2612,6284043.0,4778131.0,1505911.0,130,76,54,10684,8440,2244,6077431.0,4788429.0,1289001.0,0.5675,0.5765,0.5673,0.5744
2023-06-13 17:45,277,202,75,25994,23295,2699,14803947.0,13239658.0,1564288.0,271,198,73,25408,23226,2182,14449228.0,13200270.0,1248958.0,0.5683,0.5796,0.5683,0.5724
2023-06-13 17:50,166,102,64,10278,6262,4016,17744433.0,15441775.0,2302658.0,137,77,60,9488,5614,3874,17292675.0,15072720.0,2219954.0,2.4659,0.5734,2.6848,0.573
2023-06-13 17:55,363,183,180,16694,5094,11600,9576987.0,2907744.0,6669243.0,361,179,182,16620,4887,11733,9537131.0,2789440.0,6747690.0,0.5708,0.5749,0.5708,0.5751
2023-06-13 18:00,171,112,59,10710,5170,5540,6136257.0,2950880.0,3185377.0,170,113,57,11530,5952,5578,6583209.0,3375728.0,3207481.0,0.5708,0.575,0.5672,0.575
2023-06-13 18:05,96,48,48,4612,2798,1814,2681486.0,1645629.0,1035856.0,84,43,41,3548,1921,1627,2024014.0,1091217.0,932797.0,0.5881,0.571,0.568,0.5733
2023-06-13 18:10,314,253,61,8440,5955,2485,4834444.0,3402701.0,1431743.0,309,251,58,8393,5791,2602,4806180.0,3308321.0,1497859.0,0.5714,0.5762,0.5713,0.5757
2023-06-13 18:15,256,121,135,7959,4549,3410,4559338.0,2603959.0,1955379.0,251,116,135,7461,4270,3191,4268131.0,2438360.0,1829771.0,0.5724,0.5734,0.571,0.5734
2023-06-13 18:20,316,167,149,14998,9978,5020,8581433.0,5702364.0,2879069.0,305,160,145,14895,9628,5267,8521037.0,5500272.0,3020764.0,0.5715,0.5735,0.5713,0.5735
2023-06-13 18:25,235,143,92,12399,8295,4104,7095302.0,4738742.0,2356560.0,224,139,85,12230,8212,4018,6998852.0,4691422.0,2307429.0,0.5713,0.5742,0.5713,0.5743
2023-06-13 18:30,627,209,418,20582,10275,10307,11766828.0,5867533.0,5899294.0,642,229,413,21161,10901,10260,12099889.0,6223247.0,5876642.0,0.571,0.5724,0.5709,0.5728
2023-06-13 18:35,161,107,54,11731,8025,3706,6697238.0,4571089.0,2126149.0,160,110,50,12874,8706,4168,7347696.0,4956243.0,2391453.0,0.5696,0.5737,0.5693,0.5738
2023-06-14 10:00,1776,1304,472,101234,81117,20117,59852101.0,48024576.0,11827525.0,1509,1175,334,81976,68637,13339,46863076.0,39183360.0,7679716.0,0.592,0.5879,0.5709,0.5757
2023-06-14 10:05,912,611,301,42153,27525,14628,36152725.0,27707178.0,8445547.0,819,579,240,37432,24286,13146,23830343.0,16242448.0,7587895.0,1.0066,0.5774,0.6688,0.5772
2023-06-14 10:10,598,359,239,46138,23364,22774,50284097.0,37083281.0,13200816.0,538,336,202,41010,21797,19213,47295860.0,36225772.0,11070088.0,1.5872,0.5796,1.662,0.5762
2023-06-14 10:15,829,530,299,46931,33830,13101,38748004.0,31190619.0,7557385.0,733,480,253,46241,33319,12922,38355084.0,30899617.0,7455467.0,0.922,0.5769,0.9274,0.577
2023-06-14 10:20,552,359,193,25055,16659,8396,14328939.0,9504077.0,4824861.0,530,342,188,24307,16285,8022,13917039.0,9287038.0,4630000.0,0.5705,0.5747,0.5703,0.5772
2023-06-14 10:25,541,193,348,15116,5062,10054,8660913.0,2899927.0,5760986.0,512,181,331,14536,4889,9647,8348783.0,2802309.0,5546473.0,0.5729,0.573,0.5732,0.5749
2023-06-14 10:30,732,307,425,23430,10660,12770,13467580.0,6110300.0,7357280.0,707,290,417,23221,10626,12595,13325444.0,6071833.0,7253611.0,0.5732,0.5761,0.5714,0.5759
2023-06-14 10:35,534,269,265,24778,11777,13001,14177301.0,6722081.0,7455219.0,487,243,244,23117,11009,12108,13264076.0,6279320.0,6984756.0,0.5708,0.5734,0.5704,0.5769
2023-06-14 10:40,882,574,308,42333,34276,8057,36180092.0,31536868.0,4643224.0,845,552,293,41109,33340,7769,35469227.0,30989573.0,4479654.0,0.9201,0.5763,0.9295,0.5766
2023-06-14 10:45,500,297,203,18941,13118,5823,10887165.0,7534500.0,3352665.0,466,287,179,17776,12721,5055,10218953.0,7304663.0,2914290.0,0.5744,0.5758,0.5742,0.5765
2023-06-14 10:50,247,195,52,8915,8063,852,5111152.0,4619529.0,491622.0,210,169,41,8612,7736,876,4943876.0,4438592.0,505284.0,0.5729,0.577,0.5738,0.5768
2023-06-14 10:55,367,317,50,9369,7214,2155,5392685.0,4145832.0,1246853.0,353,309,44,8298,6954,1344,4774021.0,3996161.0,777860.0,0.5747,0.5786,0.5747,0.5788
2023-06-14 11:00,217,145,72,7249,5253,1996,4167847.0,3016769.0,1151077.0,204,142,62,6993,5277,1716,4018721.0,3028099.0,990622.0,0.5743,0.5767,0.5738,0.5773
2023-06-14 11:05,177,100,77,6460,2919,3541,3714722.0,1670861.0,2043860.0,151,88,63,5993,2509,3484,3452037.0,1439183.0,2012854.0,0.5724,0.5772,0.5736,0.5777
2023-06-14 11:10,358,105,253,13424,5965,7459,7709015.0,3420864.0,4288150.0,345,99,246,12838,5891,6947,7383316.0,3378716.0,4004599.0,0.5735,0.5749,0.5735,0.5765
2023-06-14 11:15,84,52,32,6237,4571,1666,3580991.0,2622699.0,958291.0,63,43,20,3617,2672,945,2070857.0,1526298.0,544559.0,0.5738,0.5752,0.5712,0.5763
2023-06-14 11:20,224,122,102,5334,3034,2300,3058153.0,1737905.0,1320248.0,207,115,92,4795,2722,2073,2756839.0,1563421.0,1193418.0,0.5728,0.574,0.5744,0.5757
2023-06-14 11:25,315,180,135,11376,7402,3974,6533671.0,4250102.0,2283568.0,310,178,132,10915,7391,3524,6271739.0,4243777.0,2027962.0,0.5742,0.5746,0.5742,0.5755
2023-06-14 11:30,353,170,183,19756,5671,14085,11373210.0,3255897.0,8117312.0,333,164,169,18968,5554,13414,10910432.0,3187899.0,7722533.0,0.5741,0.5763,0.574,0.5757
2023-06-14 11:35,349,250,99,19488,9147,10341,11176391.0,5241246.0,5935144.0,344,246,98,18339,9118,9221,10541640.0,5230007.0,5311633.0,0.573,0.5739,0.5736,0.576
2023-06-14 11:40,439,217,222,31780,9330,22450,30173131.0,17226459.0,12946672.0,425,206,219,30024,8575,21449,29150695.0,16790680.0,12360015.0,1.8464,0.5767,1.9581,0.5763
2023-06-14 11:45,643,270,373,27941,7186,20755,16046371.0,4118620.0,11927751.0,625,260,365,27672,6958,20714,15889799.0,3985001.0,11904797.0,0.5731,0.5747,0.5727,0.5747
2023-06-14 11:50,940,191,749,64617,5589,59028,37098514.0,3200078.0,33898436.0,917,177,740,64266,5445,58821,36915681.0,3117017.0,33798664.0,0.5726,0.5743,0.5725,0.5746
2023-06-14 11:55,1081,354,727,74836,13671,61165,43034842.0,7855923.0,35178919.0,1055,338,717,74380,13164,61216,42746841.0,7538547.0,35208294.0,0.5746,0.5751,0.5727,0.5751
2023-06-14 12:00,617,253,364,36743,8270,28473,21066049.0,4729063.0,16336986.0,611,258,353,35575,8073,27502,20422057.0,4617936.0,15804121.0,0.5718,0.5738,0.572,0.5747
2023-06-14 12:05,1063,352,711,71584,10514,61070,52980859.0,17888140.0,35092718.0,1048,345,703,71868,10972,60896,53138621.0,18144682.0,34993939.0,1.7014,0.5746,1.6537,0.5747
2023-06-14 12:10,44,31,13,1063,734,329,611533.0,420273.0,191259.0,32,23,9,797,503,294,457922.0,286998.0,170924.0,0.5726,0.5813,0.5706,0.5814
2023-06-14 12:15,1532,242,1290,111626,9158,102468,64086173.0,5218257.0,58867916.0,1514,229,1285,109873,7621,102252,63098157.0,4355827.0,58742330.0,0.5698,0.5745,0.5716,0.5745
2023-06-14 12:20,777,432,345,46337,10679,35658,26434866.0,5923366.0,20511500.0,760,420,340,43202,8367,34835,24809519.0,4790597.0,20018921.0,0.5547,0.5752,0.5726,0.5747
2023-06-14 12:25,1266,518,748,75241,10892,64349,43205528.0,6236903.0,36968624.0,1260,515,745,75072,10901,64171,43108311.0,6241013.0,36867298.0,0.5726,0.5745,0.5725,0.5745
2023-06-14 12:30,608,208,400,43212,5694,37518,24813504.0,3258264.0,21555240.0,607,207,400,43170,5669,37501,24790103.0,3244072.0,21546031.0,0.5722,0.5745,0.5722,0.5745
2023-06-14 12:35,1308,331,977,96925,9203,87722,55657983.0,5264489.0,50393494.0,1297,326,971,96502,8877,87625,55417872.0,5081560.0,50336312.0,0.572,0.5745,0.5724,0.5745
2023-06-14 12:40,355,118,237,23891,3317,20574,13735533.0,1903241.0,11832292.0,342,109,233,23817,3327,20490,13690023.0,1905084.0,11784939.0,0.5738,0.5751,0.5726,0.5752
2023-06-14 12:45,575,476,99,19710,11993,7717,11311520.0,6871224.0,4440295.0,572,474,98,19441,11977,7464,11156620.0,6861680.0,4294939.0,0.5729,0.5754,0.5729,0.5754
2023-06-14 12:50,485,296,189,24990,9287,15703,14363243.0,5317564.0,9045679.0,475,289,186,23561,9040,14521,13530862.0,5176346.0,8354516.0,0.5726,0.576,0.5726,0.5753
2023-06-14 12:55,206,83,123,14549,3552,10997,8356743.0,2035601.0,6321141.0,200,78,122,14452,3524,10928,8311302.0,2018098.0,6293204.0,0.5731,0.5748,0.5727,0.5759
2023-06-14 13:00,582,169,413,47230,8720,38510,27143219.0,4990796.0,22152423.0,575,167,408,47027,8691,38336,27028323.0,4974762.0,22053561.0,0.5723,0.5752,0.5724,0.5753
2023-06-14 13:05,704,135,569,48130,7979,40151,27642378.0,4561414.0,23080964.0,692,127,565,47846,7820,40026,27497188.0,4470291.0,23026896.0,0.5717,0.5749,0.5716,0.5753
2023-06-14 13:10,1413,338,1075,84564,8392,76172,48533033.0,4799764.0,43733268.0,1393,324,1069,84388,8472,75916,48431993.0,4840683.0,43591309.0,0.5719,0.5741,0.5714,0.5742
2023-06-14 13:15,859,193,666,67066,7183,59883,38542798.0,4109451.0,34433347.0,848,188,660,66348,6414,59934,38124003.0,3668800.0,34455203.0,0.5721,0.575,0.572,0.5749
2023-06-14 13:20,575,134,441,43832,5745,38087,25199968.0,3285684.0,21914284.0,567,128,439,43345,5703,37642,24922310.0,3262094.0,21660215.0,0.5719,0.5754,0.572,0.5754
2023-06-14 13:25,598,38,560,25453,1473,23980,14626416.0,856034.0,13770381.0,591,32,559,25142,1169,23973,14434777.0,668419.0,13766357.0,0.5812,0.5742,0.5718,0.5742
2023-06-14 13:30,633,221,412,45377,9266,36111,26063751.0,5308166.0,20755585.0,623,215,408,45398,9353,36045,26070581.0,5352098.0,20718482.0,0.5729,0.5748,0.5722,0.5748
2023-06-14 13:35,1183,254,929,98577,11964,86613,56622564.0,6844467.0,49778097.0,1172,246,926,98526,11765,86761,56592292.0,6730677.0,49861615.0,0.5721,0.5747,0.5721,0.5747
2023-06-14 13:40,1093,450,643,76785,13534,63251,44096634.0,7743681.0,36352952.0,1081,448,633,76237,13673,62564,43783378.0,7822932.0,35960446.0,0.5722,0.5747,0.5721,0.5748
2023-06-14 13:45,1259,268,991,118796,15024,103772,68098117.0,8584698.0,59513419.0,1235,249,986,117933,14812,103121,67605489.0,8463843.0,59141645.0,0.5714,0.5735,0.5714,0.5735
2023-06-14 13:50,561,245,316,44813,12537,32276,25662438.0,7148927.0,18513510.0,557,240,317,45166,12274,32892,25864940.0,6998598.0,18866342.0,0.5702,0.5736,0.5702,0.5736
2023-06-14 13:55,315,121,194,27748,6408,21340,15923552.0,3665018.0,12258533.0,307,117,190,28182,6879,21303,16164197.0,3927841.0,12236355.0,0.5719,0.5744,0.571,0.5744
2023-06-14 14:00,878,554,324,91497,47222,44275,64362014.0,38925908.0,25436106.0,870,548,322,90769,46924,43845,63941398.0,38749618.0,25191779.0,0.8243,0.5745,0.8258,0.5746
2023-06-14 14:05,428,367,61,20879,17055,3824,11955356.0,9756180.0,2199175.0,427,367,60,21031,17226,3805,12042106.0,9853995.0,2188110.0,0.572,0.5751,0.572,0.5751
2023-06-14 14:10,583,457,126,30927,18896,12031,17779340.0,10837824.0,6941515.0,571,450,121,30946,18183,12763,17776600.0,10414982.0,7361617.0,0.5736,0.577,0.5728,0.5768
2023-06-14 14:15,231,182,49,14625,11799,2826,8377553.0,6743163.0,1634390.0,229,180,49,14809,12021,2788,8475927.0,6863517.0,1612410.0,0.5715,0.5783,0.571,0.5783
2023-06-14 14:20,150,111,39,4548,3201,1347,2610391.0,1835392.0,774999.0,119,87,32,3913,2864,1049,2246309.0,1642167.0,604141.0,0.5734,0.5754,0.5734,0.5759
2023-06-14 14:25,288,144,144,5533,4860,673,3169617.0,2784676.0,384940.0,276,139,137,5033,4439,594,2886144.0,2544459.0,341685.0,0.573,0.572,0.5732,0.5752
2023-06-14 14:30,98,74,24,7829,6962,867,4495154.0,3988825.0,506328.0,91,70,21,7718,6966,752,4423670.0,3991161.0,432509.0,0.5729,0.584,0.5729,0.5751
2023-06-14 14:35,86,41,45,4703,2459,2244,2671343.0,1406313.0,1265029.0,75,35,40,4217,2240,1977,2423177.0,1283195.0,1139982.0,0.5719,0.5637,0.5729,0.5766
2023-06-14 14:40,157,99,58,9021,6542,2479,5154367.0,3738726.0,1415641.0,145,92,53,8829,6282,2547,5048819.0,3580832.0,1467987.0,0.5715,0.5711,0.57,0.5764
2023-06-14 14:45,261,93,168,16540,5411,11129,21337056.0,14956394.0,6380662.0,255,90,165,16212,5336,10876,21166735.0,14915799.0,6250936.0,2.7641,0.5733,2.7953,0.5747
2023-06-14 14:50,436,92,344,19698,5412,14286,11308724.0,3086930.0,8221793.0,431,88,343,19524,5202,14322,11207503.0,2964956.0,8242547.0,0.5704,0.5755,0.57,0.5755
2023-06-14 14:55,59,25,34,4056,1380,2676,2332694.0,789701.0,1542992.0,53,23,30,3153,1501,1652,1812576.0,858890.0,953686.0,0.5722,0.5766,0.5722,0.5773
2023-06-14 15:00,491,89,402,26717,3779,22938,15323174.0,2161831.0,13161342.0,491,90,401,26391,3659,22732,15146932.0,2092867.0,13054065.0,0.5721,0.5738,0.572,0.5743
2023-06-14 15:05,1640,658,982,102761,40689,62072,58810655.0,23189883.0,35620772.0,1630,652,978,103868,40801,63067,59449412.0,23251486.0,36197926.0,0.5699,0.5739,0.5699,0.574
2023-06-14 15:10,596,260,336,50197,20764,29433,28697980.0,11821831.0,16876149.0,587,255,332,49913,20763,29150,28546738.0,11818455.0,16728282.0,0.5693,0.5734,0.5692,0.5739
2023-06-14 15:15,664,210,454,64906,17488,47418,37201512.0,9965459.0,27236053.0,658,205,453,63673,17098,46575,36495618.0,9743444.0,26752174.0,0.5698,0.5744,0.5699,0.5744
2023-06-14 15:20,661,203,458,56646,9243,47403,44344202.0,17154693.0,27189508.0,653,196,457,56342,9297,47045,44197999.0,17181806.0,27016193.0,1.856,0.5736,1.8481,0.5743
2023-06-14 15:25,450,101,349,51025,6975,44050,29225178.0,3982195.0,25242983.0,435,93,342,50047,6614,43433,28713896.0,3775904.0,24937991.0,0.5709,0.5731,0.5709,0.5742
2023-06-14 15:30,590,92,498,50720,2658,48062,29107742.0,1516447.0,27591294.0,579,88,491,50804,2924,47880,29158656.0,1668438.0,27490218.0,0.5705,0.5741,0.5706,0.5741
2023-06-14 15:35,547,111,436,50381,2163,48218,28897345.0,1236587.0,27660757.0,537,103,434,50211,2001,48210,28797120.0,1142389.0,27654731.0,0.5717,0.5737,0.5709,0.5736
2023-06-14 15:40,691,123,568,42258,9515,32743,24220255.0,5436368.0,18783887.0,686,121,565,42085,9424,32661,24125876.0,5384013.0,18741863.0,0.5713,0.5737,0.5713,0.5738
2023-06-14 15:45,632,257,375,65371,13912,51459,37507140.0,7946604.0,29560535.0,625,254,371,65310,13878,51432,37474349.0,7927183.0,29547165.0,0.5712,0.5744,0.5712,0.5745
2023-06-14 15:50,172,46,126,19074,1812,17262,10947519.0,1033021.0,9914497.0,166,41,125,18975,1706,17269,10893465.0,973766.0,9919699.0,0.5701,0.5744,0.5708,0.5744
2023-06-14 15:55,806,328,478,74202,7690,66512,42573125.0,4394412.0,38178713.0,796,322,474,74387,7533,66854,42681383.0,4304568.0,38376814.0,0.5714,0.574,0.5714,0.574
2023-06-14 16:00,1281,434,847,117178,17474,99704,67171499.0,9984973.0,57186525.0,1272,430,842,116715,17455,99260,66914682.0,9973448.0,56941234.0,0.5714,0.5736,0.5714,0.5737
2023-06-14 16:05,2092,746,1346,201223,33860,167363,115338637.0,19343271.0,95995366.0,2088,742,1346,201002,33634,167368,115212384.0,19214222.0,95998162.0,0.5713,0.5736,0.5713,0.5736
2023-06-14 16:10,1057,363,694,106355,18772,87583,60971601.0,10719072.0,50252529.0,1051,358,693,105956,18652,87304,60741808.0,10649586.0,50092222.0,0.571,0.5738,0.571,0.5738
2023-06-14 16:15,1052,349,703,76019,15900,60119,55475643.0,20954809.0,34520833.0,1045,346,699,75819,15767,60052,55350359.0,20870073.0,34480286.0,1.3179,0.5742,1.3237,0.5742
2023-06-14 16:20,337,234,103,22735,16341,6394,12979215.0,9309096.0,3670119.0,337,234,103,23272,16619,6653,13288612.0,9468132.0,3820479.0,0.5697,0.574,0.5697,0.5742
2023-06-14 16:25,1046,680,366,79619,56092,23527,45462592.0,31969062.0,13493529.0,1040,680,360,79184,55707,23477,45214994.0,31748965.0,13466029.0,0.5699,0.5735,0.5699,0.5736
2023-06-14 16:30,579,277,302,36091,14943,21148,20678390.0,8522999.0,12155391.0,575,276,299,35993,15097,20896,20620440.0,8610890.0,12009550.0,0.5704,0.5748,0.5704,0.5747
2023-06-14 16:35,248,171,77,15881,10363,5518,9095998.0,5918225.0,3177772.0,240,168,72,15309,10226,5083,8764169.0,5839563.0,2924606.0,0.5711,0.5759,0.5711,0.5754
2023-06-14 16:40,302,220,82,22657,16894,5763,12943773.0,9639552.0,3304221.0,292,213,79,22108,16423,5685,12632587.0,9369981.0,3262605.0,0.5706,0.5734,0.5705,0.5739
2023-06-14 16:45,517,258,259,11596,5322,6274,6651513.0,3047789.0,3603724.0,508,253,255,11745,5256,6489,6736684.0,3009653.0,3727031.0,0.5727,0.5744,0.5726,0.5744
2023-06-14 16:50,267,129,138,6177,2568,3609,3541908.0,1470761.0,2071146.0,257,124,133,5854,2668,3186,3352170.0,1523606.0,1828564.0,0.5727,0.5739,0.5711,0.5739
2023-06-14 16:55,87,55,32,4118,1331,2787,2364562.0,763585.0,1600977.0,80,52,28,4077,1345,2732,2338996.0,769446.0,1569549.0,0.5737,0.5744,0.5721,0.5745
2023-06-14 17:00,77,35,42,5607,2128,3479,3214285.0,1217129.0,1997156.0,76,34,42,5802,2132,3670,3326140.0,1219359.0,2106781.0,0.572,0.5741,0.5719,0.5741
2023-06-14 17:05,113,45,68,7533,3238,4295,4312635.0,1846918.0,2465716.0,107,42,65,7412,3128,4284,4246807.0,1787353.0,2459454.0,0.5704,0.5741,0.5714,0.5741
2023-06-14 17:10,69,17,52,4180,514,3666,2400199.0,294072.0,2106127.0,66,16,50,3931,547,3384,2255598.0,312972.0,1942626.0,0.5721,0.5745,0.5722,0.5741
2023-06-14 17:15,91,31,60,6029,2073,3956,3431818.0,1184650.0,2247168.0,82,29,53,3990,1883,2107,2290256.0,1076442.0,1213813.0,0.5715,0.568,0.5717,0.5761
2023-06-14 17:20,215,118,97,13421,10557,2864,7680651.0,6035931.0,1644720.0,212,115,97,13411,10536,2875,7673556.0,6022541.0,1651015.0,0.5717,0.5743,0.5716,0.5743
2023-06-14 17:25,288,147,141,24863,16808,8055,14221872.0,9590951.0,4630920.0,284,146,138,25939,16834,9105,14848706.0,9605890.0,5242815.0,0.5706,0.5749,0.5706,0.5758
2023-06-14 17:30,1028,266,762,64140,30300,33840,36678508.0,17259890.0,19418618.0,1023,261,762,64157,30411,33746,36687581.0,17322787.0,19364793.0,0.5696,0.5738,0.5696,0.5738
2023-06-14 17:35,514,240,274,38186,23989,14197,21795315.0,13649527.0,8145788.0,508,235,273,37443,23727,13716,21369744.0,13497982.0,7871761.0,0.569,0.5738,0.5689,0.5739
2023-06-14 17:40,225,122,103,14256,12349,1907,8121112.0,7027370.0,1093741.0,221,119,102,14237,12349,1888,8109846.0,7026893.0,1082952.0,0.5691,0.5735,0.569,0.5736
2023-06-14 17:45,372,79,293,18935,7705,11230,10832880.0,4389929.0,6442951.0,370,77,293,18873,7679,11194,10797159.0,4374890.0,6422269.0,0.5698,0.5737,0.5697,0.5737
2023-06-14 17:50,93,38,55,5622,4198,1424,3214890.0,2398696.0,816193.0,89,36,53,5563,4198,1365,3183381.0,2398639.0,784741.0,0.5714,0.5732,0.5714,0.5749
2023-06-14 17:55,89,32,57,6617,4251,2366,3775385.0,2417647.0,1357737.0,82,29,53,6282,4046,2236,3583803.0,2300417.0,1283385.0,0.5687,0.5739,0.5686,0.574
2023-06-14 18:00,199,84,115,11536,6585,4951,6603056.0,3760717.0,2842338.0,190,78,112,11918,7033,4885,6806289.0,4001614.0,2804675.0,0.5711,0.5741,0.569,0.5741
2023-06-14 18:05,77,45,32,4123,2856,1267,2353112.0,1625107.0,728005.0,67,42,25,4231,2990,1241,2413396.0,1699821.0,713575.0,0.569,0.5746,0.5685,0.575
2023-06-14 18:10,422,186,236,23743,14137,9606,13572416.0,8050993.0,5521422.0,410,178,232,23147,13755,9392,13233343.0,7834343.0,5398999.0,0.5695,0.5748,0.5696,0.5749
2023-06-14 18:15,371,206,165,22402,15408,6994,12817996.0,8796362.0,4021633.0,359,198,161,21889,15244,6645,12519582.0,8697858.0,3821724.0,0.5709,0.575,0.5706,0.5751
2023-06-14 18:20,296,156,140,16065,10398,5667,9189799.0,5936790.0,3253008.0,297,158,139,15995,10603,5392,9149419.0,6053713.0,3095706.0,0.571,0.574,0.5709,0.5741
2023-06-14 18:25,487,259,228,22266,10232,12034,12760191.0,5842292.0,6917899.0,482,260,222,22245,10307,11938,12751688.0,5884765.0,6866923.0,0.571,0.5749,0.5709,0.5752
2023-06-14 18:30,593,429,164,28174,24451,3723,16052899.0,13912858.0,2140040.0,585,421,164,28076,24134,3942,15983460.0,13716428.0,2267032.0,0.569,0.5748,0.5683,0.5751
2023-06-14 18:35,472,357,115,26242,22661,3581,14958771.0,12898677.0,2060094.0,472,357,115,27130,23025,4105,15465268.0,13102674.0,2362593.0,0.5692,0.5753,0.5691,0.5755
2023-06-15 10:00,4129,1396,2733,368613,87101,281512,249417527.0,87310190.0,162107337.0,3862,1250,2612,349208,75192,274016,231687340.0,74043222.0,157644117.0,1.0024,0.5758,0.9847,0.5753
2023-06-15 10:05,3301,944,2357,228799,32682,196117,131397374.0,18559634.0,112837740.0,3222,891,2331,223583,29808,193775,128363074.0,16977561.0,111385512.0,0.5679,0.5754,0.5696,0.5748
2023-06-15 10:10,723,268,455,22058,2556,19502,12628015.0,1447951.0,11180063.0,584,200,384,20550,2313,18237,11773384.0,1317533.0,10455851.0,0.5665,0.5733,0.5696,0.5733
2023-06-15 10:15,350,95,255,8143,1604,6539,4661854.0,908925.0,3752928.0,310,79,231,7405,1205,6200,4234559.0,684602.0,3549956.0,0.5667,0.5739,0.5681,0.5726
2023-06-15 10:20,579,464,115,20611,6822,13789,11786112.0,3884210.0,7901902.0,556,445,111,19931,6462,13469,11400543.0,3679896.0,7720647.0,0.5694,0.5731,0.5695,0.5732
2023-06-15 10:25,999,496,503,59013,7098,51915,33812600.0,4039635.0,29772964.0,974,483,491,58172,6491,51681,33326959.0,3697072.0,29629887.0,0.5691,0.5735,0.5696,0.5733
2023-06-15 10:30,797,233,564,85476,3407,82069,48985187.0,1938398.0,47046788.0,780,220,560,84646,2707,81939,48507968.0,1541302.0,46966665.0,0.5689,0.5733,0.5694,0.5732
2023-06-15 10:35,251,52,199,29665,1210,28455,16994077.0,683949.0,16310127.0,227,41,186,29672,1212,28460,17002915.0,688109.0,16314806.0,0.5652,0.5732,0.5677,0.5733
2023-06-15 10:40,56,39,17,1935,840,1095,1108692.0,475418.0,633274.0,42,29,13,1054,545,509,601659.0,309444.0,292214.0,0.566,0.5783,0.5678,0.5741
2023-06-15 10:45,247,140,107,11368,4989,6379,6517789.0,2852193.0,3665595.0,223,131,92,11722,4837,6885,6708037.0,2759535.0,3948502.0,0.5717,0.5746,0.5705,0.5735
2023-06-15 10:50,1726,530,1196,108745,14524,94221,62375582.0,8281933.0,54093649.0,1705,517,1188,108139,14127,94012,62030965.0,8058379.0,53972585.0,0.5702,0.5741,0.5704,0.5741
2023-06-15 10:55,529,184,345,28962,5351,23611,16610747.0,3062978.0,13547768.0,508,177,331,28444,5074,23370,16301275.0,2892334.0,13408941.0,0.5724,0.5738,0.57,0.5738
2023-06-15 11:00,932,616,316,42078,26607,15471,35937649.0,27062269.0,8875379.0,918,607,311,41059,25784,15275,30585462.0,21822762.0,8762699.0,1.0171,0.5737,0.8464,0.5737
2023-06-15 11:05,467,194,273,20389,5589,14800,23559208.0,15066303.0,8492905.0,441,180,261,20134,5625,14509,23415001.0,15086699.0,8328301.0,2.6957,0.5738,2.6821,0.574
2023-06-15 11:10,515,218,297,25671,10696,14975,14685733.0,6088645.0,8597088.0,495,206,289,24989,10249,14740,14289020.0,5835097.0,8453922.0,0.5692,0.5741,0.5693,0.5735
2023-06-15 11:15,1113,147,966,41944,3967,37977,24032116.0,2258789.0,21773327.0,1106,143,963,41610,3945,37665,23835761.0,2244514.0,21591246.0,0.5694,0.5733,0.569,0.5732
2023-06-15 11:20,1245,234,1011,44168,10843,33325,25215084.0,6143483.0,19071601.0,1233,229,1004,44015,10869,33146,25136451.0,6157905.0,18978546.0,0.5666,0.5723,0.5666,0.5726
2023-06-15 11:25,1330,437,893,66372,9152,57220,37987819.0,5216892.0,32770926.0,1316,426,890,66220,9121,57099,37900902.0,5198776.0,32702126.0,0.57,0.5727,0.57,0.5727
2023-06-15 11:30,333,135,198,12611,2693,9918,7216585.0,1535660.0,5680924.0,318,127,191,12513,2633,9880,7160947.0,1501454.0,5659493.0,0.5702,0.5728,0.5702,0.5728
2023-06-15 11:35,548,152,396,35453,4010,31443,20297519.0,2282156.0,18015363.0,535,143,392,35285,3898,31387,20216918.0,2218093.0,17998825.0,0.5691,0.573,0.569,0.5734
2023-06-15 11:40,1688,514,1174,104982,17284,87698,60121003.0,9841560.0,50279442.0,1670,502,1168,104364,16968,87396,59770516.0,9660355.0,50110161.0,0.5694,0.5733,0.5693,0.5734
2023-06-15 11:45,1164,490,674,70091,19377,50714,40119229.0,11035929.0,29083299.0,1152,483,669,69999,19245,50754,40069919.0,10961692.0,29108227.0,0.5695,0.5735,0.5696,0.5735
2023-06-15 11:50,1045,350,695,52183,14737,37446,29840940.0,8377519.0,21463421.0,1009,324,685,50826,13401,37425,29080522.0,7625590.0,21454932.0,0.5685,0.5732,0.569,0.5733
2023-06-15 11:55,116,35,81,4820,1625,3195,2749072.0,918149.0,1830923.0,108,31,77,4560,1393,3167,2601471.0,787584.0,1813886.0,0.565,0.5731,0.5654,0.5727
2023-06-15 12:00,633,221,412,19277,4276,15001,11014681.0,2428815.0,8585866.0,616,210,406,18740,4158,14582,10709588.0,2363273.0,8346315.0,0.568,0.5724,0.5684,0.5724
2023-06-15 12:05,144,39,105,5830,1193,4637,3326943.0,674979.0,2651964.0,136,35,101,6004,1186,4818,3428072.0,670183.0,2757889.0,0.5658,0.5719,0.5651,0.5724
2023-06-15 12:10,162,44,118,9671,1015,8656,5534326.0,578594.0,4955732.0,153,42,111,8842,904,7938,5062094.0,515451.0,4546643.0,0.57,0.5725,0.5702,0.5728
2023-06-15 12:15,109,37,72,5219,1011,4208,2981266.0,576382.0,2404884.0,104,34,70,5370,1267,4103,3070132.0,720625.0,2349506.0,0.5701,0.5715,0.5688,0.5726
2023-06-15 12:20,104,51,53,4323,1168,3155,2469636.0,664149.0,1805487.0,86,39,47,3758,842,2916,2148840.0,479859.0,1668981.0,0.5686,0.5723,0.5699,0.5724
2023-06-15 12:25,741,359,382,71014,20964,50050,111673997.0,83130078.0,28543919.0,721,350,371,68551,19675,48876,110286447.0,82403028.0,27883419.0,3.9654,0.5703,4.1882,0.5705
2023-06-15 12:30,1778,713,1065,210500,28366,182134,155686627.0,51733576.0,103953050.0,1727,669,1058,209729,27970,181759,155214524.0,51477699.0,103736824.0,1.8238,0.5708,1.8405,0.5707
2023-06-15 12:35,277,159,118,19621,5438,14183,11186577.0,3086166.0,8100411.0,260,144,116,19571,5197,14374,11158078.0,2948732.0,8209346.0,0.5675,0.5711,0.5674,0.5711
2023-06-15 12:40,1237,469,768,85144,16703,68441,60360051.0,21341935.0,39018115.0,1208,452,756,84527,16571,67956,60019458.0,21266021.0,38753436.0,1.2777,0.5701,1.2833,0.5703
2023-06-15 12:45,1179,405,774,106049,12734,93315,60516410.0,7223471.0,53292939.0,1144,378,766,105581,12387,93194,60239683.0,7020131.0,53219552.0,0.5673,0.5711,0.5667,0.5711
2023-06-15 12:50,94,60,34,3650,1805,1845,2084050.0,1024873.0,1059177.0,88,55,33,3165,1346,1819,1808539.0,763406.0,1045132.0,0.5678,0.5741,0.5672,0.5746
2023-06-15 12:55,427,157,270,14041,2118,11923,8010355.0,1198298.0,6812057.0,422,156,266,13823,2045,11778,7885491.0,1155621.0,6729869.0,0.5658,0.5713,0.5651,0.5714
2023-06-15 13:00,555,195,360,14258,5155,9103,20013072.0,14805554.0,5207518.0,540,188,352,13085,4732,8353,19343020.0,14563538.0,4779481.0,2.8721,0.5721,3.0777,0.5722
2023-06-15 13:05,250,125,125,4915,1386,3529,2810827.0,782872.0,2027955.0,243,120,123,4858,1419,3439,2782082.0,805796.0,1976285.0,0.5648,0.5747,0.5679,0.5747
2023-06-15 13:10,82,49,33,2591,1445,1146,1473218.0,812182.0,661035.0,72,40,32,2250,1123,1127,1286752.0,635347.0,651405.0,0.5621,0.5768,0.5658,0.578
2023-06-15 13:15,310,80,230,6546,3609,2937,3711003.0,2052500.0,1658503.0,300,72,228,5910,3176,2734,3367544.0,1806122.0,1561421.0,0.5687,0.5647,0.5687,0.5711
2023-06-15 13:20,463,239,224,8978,3896,5082,5150636.0,2214529.0,2936107.0,461,237,224,7416,4009,3407,4217265.0,2274182.0,1943083.0,0.5684,0.5777,0.5673,0.5703
2023-06-15 13:25,49,20,29,1692,850,842,954860.0,483149.0,471711.0,43,19,24,1494,823,671,850246.0,467318.0,382928.0,0.5684,0.5602,0.5678,0.5707
2023-06-15 13:30,116,61,55,5677,3602,2075,3231064.0,2046752.0,1184312.0,98,54,44,4736,3304,1432,2695247.0,1877231.0,818016.0,0.5682,0.5708,0.5682,0.5712
2023-06-15 13:35,51,17,34,1539,422,1117,876361.0,238931.0,637430.0,41,13,28,2254,380,1874,1288499.0,214963.0,1073536.0,0.5662,0.5707,0.5657,0.5729
2023-06-15 13:40,1888,385,1503,191756,7347,184409,121235436.0,16040193.0,105195243.0,1862,367,1495,191169,7053,184116,120903931.0,15874727.0,105029203.0,2.1832,0.5704,2.2508,0.5705
2023-06-15 13:45,1546,419,1127,172864,9293,163571,98884212.0,5270322.0,93613889.0,1528,407,1121,172602,8801,163801,98744075.0,4991139.0,93752935.0,0.5671,0.5723,0.5671,0.5724
2023-06-15 13:50,381,88,293,37977,2019,35958,21745202.0,1152183.0,20593019.0,367,76,291,37668,1850,35818,21564478.0,1049290.0,20515187.0,0.5707,0.5727,0.5672,0.5728
2023-06-15 13:55,246,83,163,19705,1338,18367,11270855.0,761792.0,10509062.0,234,74,160,19238,1218,18020,11002189.0,690642.0,10311546.0,0.5694,0.5722,0.567,0.5722
2023-06-15 14:00,136,27,109,8403,768,7635,4800121.0,449281.0,4350840.0,126,17,109,8012,417,7595,4564093.0,236280.0,4327813.0,0.585,0.5699,0.5666,0.5698
2023-06-15 14:05,316,222,94,11509,2623,8886,6569111.0,1490856.0,5078255.0,310,217,93,11459,2749,8710,6538496.0,1560772.0,4977723.0,0.5684,0.5715,0.5678,0.5715
2023-06-15 14:10,505,90,415,23439,3394,20045,13361440.0,1926369.0,11435071.0,492,78,414,23340,3319,20021,13304359.0,1882864.0,11421495.0,0.5676,0.5705,0.5673,0.5705
2023-06-15 14:15,853,286,567,58457,3322,55135,45255044.0,13774709.0,31480335.0,845,280,565,58768,3538,55230,45417689.0,13883132.0,31534557.0,4.1465,0.571,3.924,0.571
2023-06-15 14:20,2105,713,1392,210815,23205,187610,144347729.0,37003894.0,107343835.0,2079,696,1383,209734,22717,187017,143698416.0,36651097.0,107047318.0,1.5947,0.5722,1.6134,0.5724
2023-06-15 14:25,3239,1169,2070,375911,46745,329166,214592154.0,26553145.0,188039008.0,3225,1164,2061,376537,47290,329247,214948262.0,26858071.0,188090190.0,0.568,0.5713,0.5679,0.5713
2023-06-15 14:30,2344,748,1596,220280,25671,194609,125705843.0,14577796.0,111128047.0,2332,741,1591,219823,25546,194277,125448827.0,14507252.0,110941574.0,0.5679,0.571,0.5679,0.571
2023-06-15 14:35,2571,1264,1307,222267,64181,158086,126769341.0,36483178.0,90286162.0,2561,1258,1303,221922,63559,158363,126572168.0,36128148.0,90444020.0,0.5684,0.5711,0.5684,0.5711
2023-06-15 14:40,3090,1728,1362,237702,86921,150781,159526224.0,73189076.0,86337148.0,3079,1722,1357,237504,86936,150568,159411544.0,73196752.0,86214792.0,0.842,0.5726,0.842,0.5726
2023-06-15 14:45,991,580,411,54054,27470,26584,42733078.0,27492959.0,15240118.0,976,570,406,52579,26455,26124,41892035.0,26913993.0,14978042.0,1.0008,0.5733,1.0173,0.5733
2023-06-15 14:50,246,121,125,4318,2339,1979,2464290.0,1332775.0,1131515.0,240,119,121,4212,2270,1942,2403577.0,1293253.0,1110323.0,0.5698,0.5718,0.5697,0.5717
2023-06-15 14:55,88,53,35,2831,1439,1392,1615835.0,819131.0,796704.0,79,47,32,2712,1371,1341,1548105.0,780618.0,767487.0,0.5692,0.5723,0.5694,0.5723
2023-06-15 15:00,379,201,178,10733,5237,5496,6037399.0,2979772.0,3057627.0,365,193,172,9854,5194,4660,5618223.0,2954152.0,2664070.0,0.569,0.5563,0.5688,0.5717
2023-06-15 15:05,740,553,187,23795,17435,6360,13568721.0,9923466.0,3645255.0,725,543,182,23077,17107,5970,13156938.0,9735924.0,3421014.0,0.5692,0.5732,0.5691,0.573
2023-06-15 15:10,565,326,239,19869,13206,6663,11338469.0,7515908.0,3822560.0,552,321,231,19278,12800,6478,11002112.0,7285530.0,3716581.0,0.5691,0.5737,0.5692,0.5737
2023-06-15 15:15,387,322,65,8640,7595,1045,4929114.0,4330327.0,598787.0,387,318,69,9010,7540,1470,5141541.0,4298772.0,842768.0,0.5702,0.573,0.5701,0.5733
2023-06-15 15:20,281,252,29,5774,4778,996,3295809.0,2725169.0,570640.0,265,247,18,5080,4647,433,2897402.0,2649352.0,248050.0,0.5704,0.5729,0.5701,0.5729
2023-06-15 15:25,171,126,45,4854,3412,1442,2767652.0,1941618.0,826034.0,159,120,39,4454,2884,1570,2543194.0,1644138.0,899056.0,0.5691,0.5728,0.5701,0.5726
2023-06-15 15:30,359,263,96,10685,7682,3003,6084029.0,4369902.0,1714127.0,339,251,88,9402,6622,2780,5368451.0,3775822.0,1592629.0,0.5688,0.5708,0.5702,0.5729
2023-06-15 15:35,564,224,340,17370,6638,10732,9927770.0,3782929.0,6144840.0,543,208,335,16715,6316,10399,9559630.0,3599871.0,5959759.0,0.5699,0.5726,0.57,0.5731
2023-06-15 15:40,261,174,87,11356,6864,4492,6486994.0,3929042.0,2557951.0,246,168,78,10984,6746,4238,6265690.0,3841941.0,2423749.0,0.5724,0.5694,0.5695,0.5719
2023-06-15 15:45,234,139,95,10801,5718,5083,6169091.0,3256334.0,2912756.0,231,136,95,10253,4907,5346,5858882.0,2795380.0,3063502.0,0.5695,0.573,0.5697,0.573
2023-06-15 15:50,1165,587,578,42209,21393,20816,24132912.0,12188789.0,11944122.0,1131,555,576,41815,21290,20525,23903887.0,12125419.0,11778468.0,0.5698,0.5738,0.5695,0.5739
2023-06-15 15:55,624,371,253,25629,12080,13549,14662665.0,6882630.0,7780035.0,612,360,252,25881,12049,13832,14804080.0,6863179.0,7940900.0,0.5698,0.5742,0.5696,0.5741
2023-06-15 16:00,478,256,222,14665,6678,7987,8396789.0,3806182.0,4590607.0,460,246,214,14069,6477,7592,8056735.0,3690542.0,4366192.0,0.57,0.5748,0.5698,0.5751
2023-06-15 16:05,1634,580,1054,109940,19349,90591,74714010.0,22887873.0,51826137.0,1606,559,1047,109324,19129,90195,74418889.0,22760177.0,51658711.0,1.1829,0.5721,1.1898,0.5727
2023-06-15 16:10,708,267,441,34179,6587,27592,19543630.0,3750287.0,15793342.0,698,259,439,34453,7153,27300,19689773.0,4060795.0,15628977.0,0.5693,0.5724,0.5677,0.5725
2023-06-15 16:15,1178,275,903,71627,10323,61304,40989438.0,5888723.0,35100715.0,1167,269,898,71079,9958,61121,40665832.0,5665393.0,35000438.0,0.5704,0.5726,0.5689,0.5726
2023-06-15 16:20,482,248,234,37274,14256,23018,21321101.0,8113140.0,13207961.0,475,241,234,36663,13797,22866,20973375.0,7852450.0,13120924.0,0.5691,0.5738,0.5691,0.5738
2023-06-15 16:25,131,39,92,5348,485,4863,3056286.0,276427.0,2779859.0,119,33,86,5461,499,4962,3122607.0,284318.0,2838288.0,0.57,0.5716,0.5698,0.572
2023-06-15 16:30,778,477,301,36800,20764,16036,21013514.0,11820470.0,9193043.0,761,462,299,36976,21039,15937,21120423.0,11975544.0,9144879.0,0.5693,0.5733,0.5692,0.5738
2023-06-15 16:35,276,226,50,13594,11057,2537,7750560.0,6295416.0,1455143.0,266,215,51,13715,10893,2822,7819423.0,6201511.0,1617911.0,0.5694,0.5736,0.5693,0.5733
2023-06-15 16:40,502,323,179,19826,13762,6064,23176359.0,19710511.0,3465848.0,488,317,171,20560,14571,5989,23586970.0,20157374.0,3429595.0,1.4322,0.5715,1.3834,0.5726
2023-06-15 16:45,269,89,180,8005,2754,5251,4586969.0,1578268.0,3008701.0,259,81,178,7458,2573,4885,4264874.0,1466414.0,2798460.0,0.5731,0.573,0.5699,0.5729
2023-06-15 16:50,190,123,67,9739,6136,3603,5556401.0,3494147.0,2062254.0,180,118,62,9660,6109,3551,5511402.0,3478618.0,2032784.0,0.5695,0.5724,0.5694,0.5725
2023-06-15 16:55,522,289,233,10816,6950,3866,6175902.0,3962349.0,2213553.0,514,285,229,10600,6689,3911,6056335.0,3813626.0,2242709.0,0.5701,0.5726,0.5701,0.5734
2023-06-15 17:00,213,159,54,17109,12412,4697,9766813.0,7071257.0,2695555.0,200,156,44,16478,12489,3989,9405127.0,7114537.0,2290589.0,0.5697,0.5739,0.5697,0.5742
2023-06-15 17:05,193,136,57,11447,9983,1464,6525925.0,5688024.0,837901.0,182,128,54,11556,10154,1402,6578552.0,5776199.0,802353.0,0.5698,0.5723,0.5689,0.5723
2023-06-15 17:10,589,146,443,41940,8884,33056,24030387.0,5067893.0,18962494.0,581,141,440,41536,8791,32745,23795659.0,5012575.0,18783084.0,0.5705,0.5736,0.5702,0.5736
2023-06-15 17:15,1383,583,800,138158,46777,91381,79143533.0,26709287.0,52434245.0,1370,578,792,138081,46455,91626,79100633.0,26522087.0,52578545.0,0.571,0.5738,0.5709,0.5738
2023-06-15 17:20,318,210,108,21344,16361,4983,12187925.0,9329588.0,2858337.0,307,201,106,21411,16437,4974,12224375.0,9371158.0,2853217.0,0.5702,0.5736,0.5701,0.5736
2023-06-15 17:25,646,330,316,37502,27598,9904,21434978.0,15753715.0,5681262.0,631,323,308,36994,27563,9431,21143521.0,15733385.0,5410136.0,0.5708,0.5736,0.5708,0.5737
2023-06-15 17:30,32,15,17,734,425,309,418016.0,241107.0,176908.0,28,12,16,979,398,581,560455.0,226860.0,333595.0,0.5673,0.5725,0.57,0.5742
2023-06-15 17:35,81,35,46,6893,2306,4587,3959230.0,1318599.0,2640631.0,73,34,39,5067,2079,2988,2900761.0,1185803.0,1714958.0,0.5718,0.5757,0.5704,0.5739
2023-06-15 17:40,271,212,59,19776,18640,1136,11281843.0,10635385.0,646458.0,263,207,56,20076,18686,1390,11458105.0,10661359.0,796746.0,0.5706,0.5691,0.5706,0.5732
2023-06-15 17:45,659,274,385,36049,25287,10762,20609152.0,14433832.0,6175320.0,649,270,379,35785,25336,10449,20457371.0,14461721.0,5995650.0,0.5708,0.5738,0.5708,0.5738
2023-06-15 17:50,205,117,88,13565,9817,3748,7746367.0,5601828.0,2144539.0,197,111,86,13450,9706,3744,7683508.0,5538389.0,2145119.0,0.5706,0.5722,0.5706,0.5729
2023-06-15 17:55,440,158,282,19325,15239,4086,11043958.0,8703057.0,2340901.0,425,152,273,18897,15020,3877,10794208.0,8573007.0,2221200.0,0.5711,0.5729,0.5708,0.5729
2023-06-15 18:00,666,209,457,24425,18393,6032,13951642.0,10499635.0,3452006.0,655,202,453,24845,18909,5936,14167521.0,10770376.0,3397144.0,0.5708,0.5723,0.5696,0.5723
2023-06-15 18:05,600,238,362,25504,17201,8303,14568984.0,9815314.0,4753669.0,591,235,356,24911,17019,7892,14229762.0,9711403.0,4518359.0,0.5706,0.5725,0.5706,0.5725
2023-06-15 18:10,1346,729,617,70013,35798,34215,40019091.0,20429248.0,19589842.0,1335,724,611,70002,35832,34170,40008681.0,20444623.0,19564058.0,0.5707,0.5726,0.5706,0.5726
2023-06-15 18:15,1526,1056,470,89258,61247,28011,51017250.0,34975176.0,16042074.0,1503,1046,457,88624,60828,27796,50624276.0,34707295.0,15916980.0,0.5711,0.5727,0.5706,0.5726
2023-06-15 18:20,813,657,156,31488,28769,2719,17971849.0,16413758.0,1558091.0,799,649,150,31176,28513,2663,17797937.0,16269803.0,1528133.0,0.5705,0.573,0.5706,0.5738
2023-06-15 18:25,71,37,34,2352,745,1607,1348205.0,425946.0,922259.0,55,24,31,2062,691,1371,1181972.0,394254.0,787718.0,0.5717,0.5739,0.5706,0.5746
2023-06-15 18:30,294,219,75,15726,13370,2356,8981253.0,7627913.0,1353340.0,281,217,64,15488,13498,1990,8844399.0,7700496.0,1143903.0,0.5705,0.5744,0.5705,0.5748
2023-06-15 18:35,472,312,160,20420,16080,4340,11651827.0,9166704.0,2485123.0,468,308,160,21049,16345,4704,12011019.0,9316011.0,2695008.0,0.5701,0.5726,0.57,0.5729
2023-06-16 10:00,1887,1157,730,88701,44312,44389,52929676.0,27013843.0,25915832.0,1591,1015,576,68580,33054,35526,39381893.0,18891885.0,20490008.0,0.6096,0.5838,0.5715,0.5768
2023-06-16 10:05,1785,773,1012,100420,30303,70117,93136877.0,52922764.0,40214113.0,1708,736,972,96613,28814,67799,81393908.0,42491506.0,38902402.0,1.7465,0.5735,1.4747,0.5738
2023-06-16 10:10,665,393,272,11129,6963,4166,18204240.0,15816453.0,2387786.0,619,362,257,10422,6711,3711,17803633.0,15678388.0,2125244.0,2.2715,0.5732,2.3362,0.5727
2023-06-16 10:15,1084,604,480,26938,14698,12240,15364988.0,8345103.0,7019885.0,983,549,434,26302,14024,12278,15013822.0,7969414.0,7044407.0,0.5678,0.5735,0.5683,0.5737
2023-06-16 10:20,823,379,444,28303,5365,22938,16183540.0,3024029.0,13159511.0,788,365,423,26710,4715,21995,15304856.0,2674614.0,12630242.0,0.5637,0.5737,0.5673,0.5742
2023-06-16 10:25,1006,276,730,33608,5788,27820,31029523.0,15147066.0,15882456.0,964,243,721,33585,5825,27760,31063977.0,15168815.0,15895161.0,2.617,0.5709,2.6041,0.5726
2023-06-16 10:30,1070,288,782,34705,7109,27596,19796117.0,4025106.0,15771010.0,1031,257,774,32755,4927,27828,18708775.0,2803327.0,15905448.0,0.5662,0.5715,0.569,0.5716
2023-06-16 10:35,1195,227,968,88741,6743,81998,50701707.0,3831777.0,46869929.0,1145,190,955,88085,6417,81668,50346675.0,3644258.0,46702417.0,0.5683,0.5716,0.5679,0.5719
2023-06-16 10:40,2240,994,1246,158413,39681,118732,102310564.0,34448376.0,67862187.0,2209,976,1233,157171,39131,118040,101567869.0,34101458.0,67466411.0,0.8681,0.5716,0.8715,0.5716
2023-06-16 10:45,1398,501,897,94411,20235,74176,53889571.0,11496310.0,42393261.0,1359,468,891,92820,18723,74097,52999217.0,10649381.0,42349835.0,0.5681,0.5715,0.5688,0.5715
2023-06-16 10:50,360,246,114,17275,8824,8451,9912830.0,5037798.0,4875032.0,327,222,105,17180,8423,8757,9846347.0,4795754.0,5050593.0,0.5709,0.5769,0.5694,0.5767
2023-06-16 10:55,684,310,374,25757,10259,15498,26636019.0,17727300.0,8908718.0,657,295,362,24594,9374,15220,25967897.0,17219707.0,8748189.0,1.728,0.5748,1.837,0.5748
2023-06-16 11:00,1295,650,645,40133,11533,28600,22984141.0,6581040.0,16403100.0,1274,640,634,39327,11474,27853,22524285.0,6545829.0,15978456.0,0.5706,0.5735,0.5705,0.5737
2023-06-16 11:05,1223,439,784,66498,5467,61031,38138754.0,3120363.0,35018391.0,1209,434,775,65755,5333,60422,37709043.0,3042611.0,34666432.0,0.5708,0.5738,0.5705,0.5737
2023-06-16 11:10,2493,726,1767,210429,22245,188184,132367382.0,24538779.0,107828603.0,2468,712,1756,209467,21665,187802,131849435.0,24208634.0,107640800.0,1.1031,0.573,1.1174,0.5732
2023-06-16 11:15,1010,276,734,83988,7728,76260,48117401.0,4399509.0,43717892.0,968,248,720,83753,7530,76223,47987664.0,4287473.0,43700190.0,0.5693,0.5733,0.5694,0.5733
2023-06-16 11:20,620,186,434,57034,2565,54469,32709630.0,1461978.0,31247652.0,606,178,428,56738,2593,54145,32541291.0,1477796.0,31063495.0,0.57,0.5737,0.5699,0.5737
2023-06-16 11:25,847,209,638,57885,3216,54669,33193275.0,1831622.0,31361653.0,830,194,636,57511,3035,54476,32975495.0,1726089.0,31249405.0,0.5695,0.5737,0.5687,0.5736
2023-06-16 11:30,1474,399,1075,153579,6973,146606,87990801.0,3964019.0,84026782.0,1467,393,1074,153304,6753,146551,87842996.0,3835706.0,84007289.0,0.5685,0.5731,0.568,0.5732
2023-06-16 11:35,1569,831,738,69299,23897,45402,39651092.0,13635765.0,26015326.0,1549,819,730,68293,23206,45087,39044936.0,13215650.0,25829285.0,0.5706,0.573,0.5695,0.5729
2023-06-16 11:40,366,197,169,16111,5787,10324,21085724.0,15172402.0,5913321.0,343,183,160,15512,5444,10068,20740262.0,14977571.0,5762691.0,2.6218,0.5728,2.7512,0.5724
2023-06-16 11:45,504,257,247,20784,8310,12474,11902176.0,4753430.0,7148746.0,489,249,240,20440,7895,12545,11690200.0,4500768.0,7189431.0,0.572,0.5731,0.5701,0.5731
2023-06-16 11:50,329,179,150,12109,6661,5448,6921380.0,3796919.0,3124460.0,319,173,146,11376,6118,5258,6500384.0,3485553.0,3014831.0,0.57,0.5735,0.5697,0.5734
2023-06-16 11:55,579,366,213,20540,9609,10931,23515675.0,17241918.0,6273757.0,543,345,198,17869,7399,10470,22111750.0,16100764.0,6010985.0,1.7944,0.5739,2.1761,0.5741
2023-06-16 12:00,490,255,235,36260,6019,30241,20861679.0,3435245.0,17426434.0,461,236,225,35096,5912,29184,20161198.0,3377592.0,16783605.0,0.5707,0.5763,0.5713,0.5751
2023-06-16 12:05,293,180,113,13553,5091,8462,19658041.0,14791169.0,4866872.0,249,161,88,12352,4411,7941,18965968.0,14398112.0,4567856.0,2.9054,0.5751,3.2641,0.5752
2023-06-16 12:10,1013,646,367,67923,23286,44637,50953609.0,25215298.0,25738311.0,956,610,346,65868,21866,44002,49778695.0,24399961.0,25378734.0,1.0829,0.5766,1.1159,0.5768
2023-06-16 12:15,594,473,121,22570,15438,7132,24838934.0,20723623.0,4115310.0,554,473,81,21800,15153,6647,24395229.0,20559972.0,3835257.0,1.3424,0.577,1.3568,0.577
2023-06-16 12:20,508,379,129,23395,10289,13106,13435166.0,5896671.0,7538495.0,485,373,112,22906,10130,12776,13159820.0,5805472.0,7354348.0,0.5731,0.5752,0.5731,0.5756
2023-06-16 12:25,398,160,238,24014,4423,19591,25694642.0,14409251.0,11285390.0,369,141,228,21813,3363,18450,24447839.0,13802481.0,10645358.0,3.2578,0.576,4.1042,0.577
2023-06-16 12:30,154,73,81,10124,2527,7597,5834235.0,1446511.0,4387723.0,138,63,75,8645,1883,6762,4989813.0,1077510.0,3912303.0,0.5724,0.5776,0.5722,0.5786
2023-06-16 12:35,1029,469,560,65882,5606,60276,37882960.0,3212138.0,34670822.0,999,451,548,65305,5481,59824,37559983.0,3134068.0,34425915.0,0.573,0.5752,0.5718,0.5755
2023-06-16 12:40,1592,1292,300,89222,60424,28798,75271901.0,58669864.0,16602037.0,1442,1215,227,76782,53300,23482,67793639.0,54263976.0,13529663.0,0.971,0.5765,1.0181,0.5762
2023-06-16 12:45,602,517,85,19588,15912,3676,23221251.0,21092451.0,2128799.0,510,483,27,15124,13484,1640,20575567.0,19626437.0,949129.0,1.3256,0.5791,1.4555,0.5787
2023-06-16 12:50,612,530,82,29048,24351,4697,16782171.0,14073905.0,2708266.0,544,501,43,25650,22461,3189,14781401.0,12934345.0,1847055.0,0.578,0.5766,0.5759,0.5792
2023-06-16 12:55,237,192,45,14222,11950,2272,8193546.0,6877307.0,1316238.0,198,174,24,11191,9141,2050,6451418.0,5262264.0,1189154.0,0.5755,0.5793,0.5757,0.5801
2023-06-16 13:00,909,680,229,37772,28410,9362,45582365.0,40176298.0,5406066.0,821,642,179,34467,26524,7943,43623797.0,39031011.0,4592785.0,1.4142,0.5774,1.4715,0.5782
2023-06-16 13:05,460,421,39,19893,18028,1865,11483622.0,10395874.0,1087748.0,429,407,22,18222,17586,636,10506561.0,10138436.0,368125.0,0.5767,0.5832,0.5765,0.5788
2023-06-16 13:10,1663,1529,134,101033,94663,6370,58287712.0,54607039.0,3680673.0,1618,1506,112,98444,93756,4688,56742042.0,54027328.0,2714713.0,0.5769,0.5778,0.5763,0.5791
2023-06-16 13:15,507,474,33,26912,25881,1031,15523196.0,14920393.0,602802.0,494,467,27,25955,25585,370,14966278.0,14751134.0,215144.0,0.5765,0.5847,0.5766,0.5815
2023-06-16 13:20,102,84,18,4492,3803,689,2590985.0,2189182.0,401803.0,76,68,8,4028,3625,403,2328037.0,2087795.0,240242.0,0.5756,0.5832,0.5759,0.5961
2023-06-16 13:25,120,89,31,7151,3973,3178,4134348.0,2294729.0,1839619.0,107,82,25,7201,4645,2556,4136691.0,2657173.0,1479517.0,0.5776,0.5789,0.5721,0.5788
2023-06-16 13:30,89,70,19,5806,5319,487,3346410.0,3052206.0,294203.0,69,60,9,4228,4101,127,2435853.0,2360588.0,75265.0,0.5738,0.6041,0.5756,0.5926
2023-06-16 13:35,832,787,45,38227,37641,586,21954916.0,21620402.0,334514.0,802,770,32,36018,35667,351,20743794.0,20539379.0,204415.0,0.5744,0.5708,0.5759,0.5824
2023-06-16 13:40,331,161,170,14312,6208,8104,8270091.0,3577042.0,4693049.0,304,148,156,13745,6135,7610,7927761.0,3528930.0,4398831.0,0.5762,0.5791,0.5752,0.578
2023-06-16 13:45,90,47,43,3150,2120,1030,1815466.0,1218891.0,596574.0,75,41,34,4864,1481,3383,2947874.0,850917.0,2096957.0,0.5749,0.5792,0.5746,0.6199
2023-06-16 13:50,135,109,26,5816,5174,642,3407327.0,3035509.0,371817.0,104,90,14,5150,4567,583,2966896.0,2629224.0,337672.0,0.5867,0.5792,0.5757,0.5792
2023-06-16 13:55,626,582,44,23450,22608,842,13528472.0,13036000.0,492472.0,610,573,37,22955,22228,727,13222321.0,12799986.0,422334.0,0.5766,0.5849,0.5758,0.5809
2023-06-16 14:00,796,494,302,38482,28554,9928,22182680.0,16462937.0,5719742.0,774,482,292,37748,28399,9349,21782879.0,16373162.0,5409716.0,0.5766,0.5761,0.5765,0.5786
2023-06-16 14:05,520,379,141,25791,19331,6460,26820076.0,23072211.0,3747864.0,440,356,84,24002,18167,5835,25739170.0,22353908.0,3385261.0,1.1935,0.5802,1.2305,0.5802
2023-06-16 14:10,330,232,98,17907,15152,2755,22242634.0,20640419.0,1602214.0,265,214,51,16059,14623,1436,21140001.0,20307305.0,832696.0,1.3622,0.5816,1.3887,0.5799
2023-06-16 14:15,488,441,47,23534,21585,1949,25464149.0,24340131.0,1124017.0,470,438,32,23001,21756,1245,25152262.0,24428997.0,723265.0,1.1276,0.5767,1.1229,0.5809
2023-06-16 14:20,702,614,88,34894,32330,2564,20177184.0,18673636.0,1503548.0,674,615,59,33395,31276,2119,19300375.0,18059410.0,1240964.0,0.5776,0.5864,0.5774,0.5856
2023-06-16 14:25,616,580,36,51513,49563,1950,29818943.0,28689417.0,1129526.0,575,563,12,48536,48262,274,28035258.0,27875312.0,159946.0,0.5788,0.5792,0.5776,0.5837
2023-06-16 14:30,451,429,22,53003,46957,6046,30651436.0,27137842.0,3513594.0,431,418,13,51268,45562,5706,29632708.0,26317053.0,3315654.0,0.5779,0.5811,0.5776,0.5811
2023-06-16 14:35,135,127,8,13574,12710,864,7857379.0,7355680.0,501699.0,124,120,4,12686,12637,49,7333774.0,7304286.0,29488.0,0.5787,0.5807,0.578,0.6018
2023-06-16 14:40,135,99,36,6572,5092,1480,3783792.0,2966504.0,817287.0,102,77,25,4783,3809,974,2763203.0,2197230.0,565973.0,0.5826,0.5522,0.5769,0.5811
2023-06-16 14:45,268,239,29,13222,11939,1283,7632025.0,6892789.0,739235.0,247,229,18,12802,12126,676,7394391.0,7000938.0,393452.0,0.5773,0.5762,0.5773,0.582
2023-06-16 14:50,95,66,29,4971,3396,1575,2873442.0,1962356.0,911085.0,81,61,20,4772,3408,1364,2757921.0,1966586.0,791334.0,0.5778,0.5785,0.577,0.5802
2023-06-16 14:55,96,67,29,5572,3712,1860,3222593.0,2143330.0,1079263.0,87,63,24,5357,3718,1639,3097231.0,2146756.0,950475.0,0.5774,0.5802,0.5774,0.5799
2023-06-16 15:00,248,199,49,14973,11088,3885,8633605.0,6386529.0,2247076.0,233,197,36,14536,10882,3654,8386619.0,6267898.0,2118720.0,0.576,0.5784,0.576,0.5798
2023-06-16 15:05,121,99,22,7737,5386,2351,4453112.0,3110137.0,1342974.0,114,99,15,7836,5633,2203,4528092.0,3250807.0,1277285.0,0.5774,0.5712,0.5771,0.5798
2023-06-16 15:10,344,305,39,10616,8844,1772,6130970.0,5110517.0,1020453.0,327,300,27,10094,8453,1641,5836198.0,4883644.0,952554.0,0.5779,0.5759,0.5777,0.5805
2023-06-16 15:15,420,246,174,17318,10430,6888,10013292.0,6023683.0,3989608.0,401,234,167,16980,10229,6751,9817794.0,5907205.0,3910588.0,0.5775,0.5792,0.5775,0.5793
2023-06-16 15:20,157,107,50,7314,5092,2222,4228094.0,2940988.0,1287106.0,150,102,48,7221,5080,2141,4173440.0,2933212.0,1240228.0,0.5776,0.5793,0.5774,0.5793
2023-06-16 15:25,203,132,71,9969,5815,4154,5769227.0,3364066.0,2405161.0,183,117,66,9705,5490,4215,5601844.0,3158923.0,2442920.0,0.5785,0.579,0.5754,0.5796
2023-06-16 15:30,126,72,54,4790,2811,1979,2771234.0,1622494.0,1148739.0,119,70,49,5280,2869,2411,3054188.0,1655592.0,1398595.0,0.5772,0.5805,0.5771,0.5801
2023-06-16 15:35,75,47,28,2988,2106,882,1728015.0,1216117.0,511898.0,66,43,23,2924,2143,781,1691177.0,1237090.0,454087.0,0.5775,0.5804,0.5773,0.5814
2023-06-16 15:40,91,48,43,3803,2214,1589,2200208.0,1281742.0,918466.0,71,39,32,3197,1807,1390,1850004.0,1043578.0,806425.0,0.5789,0.578,0.5775,0.5802
2023-06-16 15:45,301,274,27,11620,10280,1340,6715454.0,5938135.0,777318.0,289,266,23,11564,10311,1253,6682121.0,5955233.0,726887.0,0.5776,0.5801,0.5776,0.5801
2023-06-16 15:50,187,107,80,5929,4097,1832,3423702.0,2365701.0,1058000.0,168,94,74,5221,3582,1639,3019621.0,2068569.0,951052.0,0.5774,0.5775,0.5775,0.5803
2023-06-16 15:55,117,78,39,8695,4883,3812,16896293.0,14693292.0,2203001.0,110,76,34,6916,4878,2038,15872752.0,14690475.0,1182277.0,3.0091,0.5779,3.0116,0.5801
2023-06-16 16:00,140,92,48,5589,3937,1652,3211183.0,2277762.0,933421.0,126,85,41,5368,3824,1544,3099459.0,2205147.0,894312.0,0.5786,0.565,0.5767,0.5792
2023-06-16 16:05,513,220,293,37976,7172,30804,21909662.0,4135110.0,17774551.0,484,204,280,36810,6984,29826,21288170.0,4026447.0,17261723.0,0.5766,0.577,0.5765,0.5787
2023-06-16 16:10,385,183,202,15450,5862,9588,8938922.0,3384341.0,5554581.0,365,175,190,15145,5744,9401,8758439.0,3310941.0,5447498.0,0.5773,0.5793,0.5764,0.5795
2023-06-16 16:15,161,84,77,9666,2301,7365,5570339.0,1315004.0,4255334.0,143,74,69,9486,2160,7326,5474562.0,1234872.0,4239690.0,0.5715,0.5778,0.5717,0.5787
2023-06-16 16:20,103,82,21,2653,2287,366,1525562.0,1313622.0,211940.0,80,64,16,2462,1920,542,1414653.0,1100806.0,313847.0,0.5744,0.5791,0.5733,0.5791
2023-06-16 16:25,69,53,16,5928,2565,3363,3428658.0,1482503.0,1946154.0,61,51,10,4707,2202,2505,2717808.0,1267835.0,1449973.0,0.578,0.5787,0.5758,0.5788
2023-06-16 16:30,85,60,25,6215,2885,3330,3589635.0,1662655.0,1926980.0,77,56,21,6120,2936,3184,3534199.0,1691418.0,1842780.0,0.5763,0.5787,0.5761,0.5788
2023-06-16 16:35,467,200,267,67301,10345,56956,38891936.0,5958992.0,32932943.0,452,192,260,67510,10005,57505,39057039.0,5763086.0,33293953.0,0.576,0.5782,0.576,0.579
2023-06-16 16:40,997,418,579,103473,9423,94050,71513392.0,17297851.0,54215541.0,960,398,562,101070,8782,92288,70262128.0,16929878.0,53332250.0,1.8357,0.5765,1.9278,0.5779
2023-06-16 16:45,150,90,60,6861,2949,3912,15860733.0,13606602.0,2254131.0,118,69,49,5922,2195,3727,15296481.0,13138903.0,2157578.0,4.614,0.5762,5.9858,0.5789
2023-06-16 16:50,220,137,83,9129,3806,5323,5277734.0,2193265.0,3084469.0,223,144,79,8655,3705,4950,4996287.0,2128912.0,2867374.0,0.5763,0.5795,0.5746,0.5793
2023-06-16 16:55,981,428,553,88542,13363,75179,51228967.0,7700711.0,43528256.0,1003,453,550,88629,13558,75071,51264465.0,7799266.0,43465199.0,0.5763,0.579,0.5753,0.579
2023-06-16 17:00,646,510,136,48385,33434,14951,27922817.0,19270130.0,8652687.0,678,532,146,47582,33003,14579,27457750.0,19019766.0,8437983.0,0.5764,0.5787,0.5763,0.5788
2023-06-16 17:05,1437,1118,319,108384,75248,33136,62547798.0,43372762.0,19175036.0,1427,1107,320,108473,74975,33498,62599913.0,43215193.0,19384720.0,0.5764,0.5787,0.5764,0.5787
2023-06-16 17:10,518,357,161,36959,20160,16799,21343317.0,11622190.0,9721126.0,502,352,150,36968,20537,16431,21347659.0,11839830.0,9507828.0,0.5765,0.5787,0.5765,0.5787
2023-06-16 17:15,601,486,115,46816,36629,10187,27022815.0,21126985.0,5895829.0,578,474,104,47326,37047,10279,27296897.0,21344716.0,5952181.0,0.5768,0.5788,0.5762,0.5791
2023-06-16 17:20,833,690,143,70879,48778,22101,40908497.0,28117821.0,12790675.0,832,688,144,69884,48183,21701,40329100.0,27769100.0,12559999.0,0.5764,0.5787,0.5763,0.5788
2023-06-16 17:25,626,65,561,119261,3612,115649,80849980.0,13957792.0,66892188.0,597,54,543,117832,3409,114423,80075830.0,13839839.0,66235990.0,3.8643,0.5784,4.0598,0.5789
2023-06-16 17:30,306,85,221,29553,3837,25716,28925985.0,14078364.0,14847621.0,274,78,196,28598,3060,25538,28389125.0,13634073.0,14755051.0,3.6691,0.5774,4.4556,0.5778
2023-06-16 17:35,108,84,24,5214,2927,2287,3010414.0,1686300.0,1324114.0,91,72,19,5036,3075,1961,2904440.0,1769472.0,1134967.0,0.5761,0.579,0.5754,0.5788
2023-06-16 17:40,285,260,25,7983,5410,2573,4603992.0,3116863.0,1487128.0,281,258,23,7789,5296,2493,4492788.0,3050947.0,1441840.0,0.5761,0.578,0.5761,0.5784
2023-06-16 17:45,105,64,41,5094,2160,2934,2929486.0,1243775.0,1685710.0,85,53,32,4425,2008,2417,2550453.0,1152947.0,1397505.0,0.5758,0.5745,0.5742,0.5782
2023-06-16 17:50,100,63,37,3391,1526,1865,1956874.0,878808.0,1078066.0,97,60,37,3404,1610,1794,1963634.0,926858.0,1036776.0,0.5759,0.5781,0.5757,0.5779
2023-06-16 17:55,136,58,78,8132,1368,6764,4652253.0,786393.0,3865860.0,127,56,71,8050,1351,6699,4654321.0,776564.0,3877757.0,0.5748,0.5715,0.5748,0.5789
2023-06-16 18:00,319,176,143,12925,5105,7820,7479342.0,2963812.0,4515529.0,297,164,133,11755,4489,7266,6771026.0,2567818.0,4203208.0,0.5806,0.5774,0.572,0.5785
2023-06-16 18:05,46,30,16,1574,1228,346,906393.0,707606.0,198787.0,43,29,14,1435,1140,295,827057.0,656401.0,170656.0,0.5762,0.5745,0.5758,0.5785
2023-06-16 18:10,45,23,22,2962,1202,1760,1706634.0,692913.0,1013721.0,38,18,20,2678,953,1725,1547426.0,549333.0,998093.0,0.5765,0.576,0.5764,0.5786
2023-06-16 18:15,111,52,59,8739,2419,6320,5049175.0,1393883.0,3655292.0,106,48,58,8537,2592,5945,4932300.0,1492967.0,3439333.0,0.5762,0.5784,0.576,0.5785
2023-06-16 18:20,68,28,40,2737,623,2114,1581328.0,361345.0,1219982.0,72,31,41,2772,669,2103,1600332.0,384898.0,1215433.0,0.58,0.5771,0.5753,0.578
2023-06-16 18:25,308,158,150,11632,3944,7688,6688714.0,2272947.0,4415766.0,297,145,152,10568,3590,6978,6099423.0,2068595.0,4030828.0,0.5763,0.5744,0.5762,0.5776
2023-06-16 18:30,846,186,660,79067,6474,72593,57402838.0,15597684.0,41805154.0,867,167,700,79212,5973,73239,57618773.0,15309363.0,42309410.0,2.4093,0.5759,2.5631,0.5777
2023-06-16 18:35,619,149,470,65805,3629,62176,37865572.0,2086276.0,35779296.0,588,131,457,63999,2885,61114,36941000.0,1657858.0,35283141.0,0.5749,0.5755,0.5746,0.5773
2023-06-19 10:00,3610,1065,2545,355805,51302,304503,212717610.0,36545801.0,176171809.0,3335,918,2417,339969,39080,300889,198659660.0,24698025.0,173961634.0,0.7124,0.5786,0.632,0.5782
2023-06-19 10:05,3430,1510,1920,330299,83315,246984,190618754.0,47696457.0,142922296.0,3368,1481,1887,326223,80774,245449,188412845.0,46392620.0,142020224.0,0.5725,0.5787,0.5744,0.5786
2023-06-19 10:10,353,216,137,23208,13447,9761,25224378.0,19593558.0,5630820.0,237,154,83,21418,12803,8615,17828002.0,12844239.0,4983763.0,1.4571,0.5769,1.0032,0.5785
2023-06-19 10:15,326,199,127,22194,11153,11041,24656275.0,18274792.0,6381482.0,293,184,109,20836,10561,10275,23886506.0,17943241.0,5943264.0,1.6386,0.578,1.699,0.5784
2023-06-19 10:20,163,102,61,9832,4967,4865,5638916.0,2834110.0,2804806.0,123,81,42,6987,2975,4012,4029870.0,1710289.0,2319581.0,0.5706,0.5765,0.5749,0.5782
2023-06-19 10:25,82,55,27,4722,1667,3055,2727368.0,959287.0,1768081.0,67,42,25,4398,1290,3108,2539970.0,741119.0,1798851.0,0.5755,0.5788,0.5745,0.5788
2023-06-19 10:30,450,309,141,23175,10481,12694,25319782.0,17954970.0,7364811.0,403,282,121,21501,9483,12018,24302692.0,17340628.0,6962064.0,1.7131,0.5802,1.8286,0.5793
2023-06-19 10:35,428,193,235,29984,4721,25263,17339697.0,2725830.0,14613866.0,376,173,203,28902,4294,24608,16715572.0,2474597.0,14240975.0,0.5774,0.5785,0.5763,0.5787
2023-06-19 10:40,499,354,145,25677,13067,12610,26641397.0,19387561.0,7253835.0,455,343,112,21962,12679,9283,24535123.0,19166963.0,5368159.0,1.4837,0.5752,1.5117,0.5783
2023-06-19 10:45,163,95,68,11982,5597,6385,6894466.0,3214612.0,3679854.0,139,75,64,11145,4552,6593,6425443.0,2614215.0,3811228.0,0.5743,0.5763,0.5743,0.5781
2023-06-19 10:50,814,567,247,72058,58852,13206,53111513.0,45512791.0,7598722.0,781,547,234,71242,58536,12706,52655313.0,45337696.0,7317616.0,0.7733,0.5754,0.7745,0.5759
2023-06-19 10:55,3373,1688,1685,291745,101824,189921,192072548.0,82268536.0,109804011.0,3349,1670,1679,293445,101348,192097,193039162.0,81983377.0,111055785.0,0.8079,0.5782,0.8089,0.5781
2023-06-19 11:00,1587,769,818,120635,33108,87527,69648211.0,19052411.0,50595800.0,1560,758,802,120178,33114,87064,69394506.0,19054969.0,50339536.0,0.5755,0.5781,0.5754,0.5782
2023-06-19 11:05,1337,444,893,90101,17243,72858,52036853.0,9914840.0,42122012.0,1325,440,885,89988,17161,72827,51970289.0,9868162.0,42102127.0,0.575,0.5781,0.575,0.5781
2023-06-19 11:10,1805,674,1131,135650,34616,101034,78294672.0,19894168.0,58400504.0,1802,670,1132,135866,34780,101086,78419473.0,19987494.0,58431979.0,0.5747,0.578,0.5747,0.578
2023-06-19 11:15,1982,796,1186,156970,49281,107689,90499177.0,28235216.0,62263960.0,1968,789,1179,156359,48871,107488,90146235.0,28004773.0,62141462.0,0.5729,0.5782,0.573,0.5781
2023-06-19 11:20,1852,725,1127,123658,30230,93428,71402353.0,17369176.0,54033177.0,1832,720,1112,122969,30030,92939,71009547.0,17254155.0,53755392.0,0.5746,0.5783,0.5746,0.5784
2023-06-19 11:25,138,78,60,9201,5513,3688,17132250.0,15002863.0,2129387.0,112,67,45,6560,4020,2540,15650957.0,14183279.0,1467677.0,2.7214,0.5774,3.5282,0.5778
2023-06-19 11:30,314,205,109,22289,18941,3348,12753236.0,10826274.0,1926962.0,275,178,97,21806,18449,3357,12471646.0,10536531.0,1935115.0,0.5716,0.5756,0.5711,0.5764
2023-06-19 11:35,124,62,62,7448,6567,881,4278115.0,3766832.0,511282.0,114,58,56,7320,6559,761,4201320.0,3761784.0,439536.0,0.5736,0.5803,0.5735,0.5776
2023-06-19 11:40,714,585,129,33852,31080,2772,19429711.0,17837920.0,1591791.0,691,577,114,33452,30901,2551,19202671.0,17731082.0,1471589.0,0.5739,0.5742,0.5738,0.5769
2023-06-19 11:45,1191,1079,112,91785,89594,2191,52750142.0,51488751.0,1261391.0,1174,1070,104,91353,89329,2024,52501709.0,51333426.0,1168283.0,0.5747,0.5757,0.5747,0.5772
2023-06-19 11:50,987,534,453,61170,49607,11563,35176642.0,28505472.0,6671170.0,976,526,450,61164,49601,11563,35171494.0,28501858.0,6669635.0,0.5746,0.5769,0.5746,0.5768
2023-06-19 11:55,329,165,164,19834,13381,6453,11421818.0,7695689.0,3726129.0,315,157,158,19356,13127,6229,11146313.0,7549856.0,3596457.0,0.5751,0.5774,0.5751,0.5774
2023-06-19 12:00,294,148,146,25630,16309,9321,14765268.0,9379110.0,5386158.0,301,145,156,26423,16303,10120,15227134.0,9375859.0,5851275.0,0.5751,0.5779,0.5751,0.5782
2023-06-19 12:05,1953,1274,679,161633,99897,61736,105014277.0,69337982.0,35676295.0,1939,1264,675,161463,99958,61505,104909821.0,69365962.0,35543858.0,0.6941,0.5779,0.694,0.5779
2023-06-19 12:10,2322,1354,968,184929,100142,84787,106580586.0,57585368.0,48995217.0,2316,1352,964,185376,100529,84847,106838791.0,57808156.0,49030635.0,0.575,0.5779,0.575,0.5779
2023-06-19 12:15,982,527,455,77532,49378,28154,56507942.0,40262024.0,16245917.0,963,515,448,74532,48625,25907,54793827.0,39830314.0,14963512.0,0.8154,0.577,0.8191,0.5776
2023-06-19 12:20,1419,63,1356,94882,4580,90302,54640327.0,2620804.0,52019523.0,1389,43,1346,93246,3374,89872,53719544.0,1930600.0,51788944.0,0.5722,0.5761,0.5722,0.5763
2023-06-19 12:25,1274,55,1219,91068,3328,87740,64315957.0,13782075.0,50533881.0,1252,38,1214,92042,2838,89204,64878783.0,13503735.0,51375047.0,4.1412,0.576,4.7582,0.5759
2023-06-19 12:30,532,63,469,22871,3358,19513,13147348.0,1923287.0,11224061.0,524,61,463,22414,3140,19274,12889532.0,1799436.0,11090096.0,0.5727,0.5752,0.5731,0.5754
2023-06-19 12:35,522,148,374,21071,2956,18115,12103401.0,1693723.0,10409678.0,503,134,369,20745,3035,17710,11916248.0,1736472.0,10179775.0,0.573,0.5746,0.5721,0.5748
2023-06-19 12:40,688,186,502,29376,4911,24465,16870495.0,2811803.0,14058692.0,670,172,498,29086,4641,24445,16706770.0,2659251.0,14047519.0,0.5726,0.5746,0.573,0.5747
2023-06-19 12:45,947,97,850,83815,4427,79388,59980130.0,14405801.0,45574329.0,908,72,836,82144,4063,78081,59061949.0,14192660.0,44869289.0,3.2541,0.5741,3.4931,0.5747
2023-06-19 12:50,1186,601,585,88590,21017,67573,62702999.0,23874918.0,38828081.0,1166,585,581,88405,20858,67547,62598999.0,23783661.0,38815338.0,1.136,0.5746,1.1403,0.5746
2023-06-19 12:55,754,447,307,41789,11096,30693,24005464.0,6343158.0,17662306.0,736,434,302,40825,10973,29852,23452822.0,6272821.0,17180001.0,0.5717,0.5755,0.5717,0.5755
2023-06-19 13:00,496,237,259,14820,9466,5354,8500184.0,5425081.0,3075103.0,492,234,258,14484,9296,5188,8295456.0,5315874.0,2979581.0,0.5731,0.5744,0.5718,0.5743
2023-06-19 13:05,502,255,247,20039,14050,5989,11488458.0,8039384.0,3449074.0,490,246,244,19453,13452,6001,11150119.0,7694264.0,3455854.0,0.5722,0.5759,0.572,0.5759
2023-06-19 13:10,300,36,264,5427,1216,4211,3139142.0,719210.0,2419932.0,282,25,257,5162,943,4219,2961871.0,537867.0,2424003.0,0.5915,0.5747,0.5704,0.5745
2023-06-19 13:15,36,19,17,1714,1119,595,986151.0,643343.0,342808.0,21,9,12,805,302,503,462456.0,172870.0,289586.0,0.5749,0.5761,0.5724,0.5757
2023-06-19 13:20,445,117,328,26745,7259,19486,27284622.0,16055495.0,11229127.0,433,106,327,26337,6533,19804,27023591.0,15611071.0,11412520.0,2.2118,0.5763,2.3896,0.5763
2023-06-19 13:25,1686,261,1425,169727,13537,156190,97795441.0,7758289.0,90037152.0,1678,259,1419,169660,13619,156041,97757497.0,7805288.0,89952209.0,0.5731,0.5765,0.5731,0.5765
2023-06-19 13:30,1246,446,800,117213,11048,106165,67537887.0,6337632.0,61200254.0,1221,434,787,116763,11015,105748,67273565.0,6314764.0,60958801.0,0.5736,0.5765,0.5733,0.5765
2023-06-19 13:35,251,79,172,7587,3219,4368,4360832.0,1845091.0,2515741.0,243,75,168,7204,2897,4307,4139519.0,1660256.0,2479262.0,0.5732,0.5759,0.5731,0.5756
2023-06-19 13:40,133,32,101,3397,1155,2242,1952356.0,661897.0,1290459.0,119,29,90,3103,1199,1904,1782442.0,686812.0,1095629.0,0.5731,0.5756,0.5728,0.5754
2023-06-19 13:45,106,52,54,4073,2141,1932,2341368.0,1226913.0,1114455.0,88,42,46,3504,1903,1601,2014048.0,1091181.0,922867.0,0.5731,0.5768,0.5734,0.5764
2023-06-19 13:50,129,43,86,11893,909,10984,6858345.0,520334.0,6338010.0,113,32,81,11566,657,10909,6672416.0,376161.0,6296254.0,0.5724,0.577,0.5725,0.5772
2023-06-19 13:55,57,22,35,2935,583,2352,1691844.0,335036.0,1356808.0,51,17,34,2862,543,2319,1649696.0,311122.0,1338574.0,0.5747,0.5769,0.573,0.5772
2023-06-19 14:00,230,26,204,10420,1193,9227,6002424.0,683970.0,5318454.0,224,23,201,10302,1113,9189,5933007.0,637899.0,5295108.0,0.5733,0.5764,0.5731,0.5762
2023-06-19 14:05,121,45,76,10009,2160,7849,5778281.0,1247703.0,4530578.0,109,39,70,9772,2130,7642,5630482.0,1220116.0,4410365.0,0.5776,0.5772,0.5728,0.5771
2023-06-19 14:10,104,31,73,9289,347,8942,5360229.0,199387.0,5160842.0,88,25,63,8853,300,8553,5108740.0,172204.0,4936536.0,0.5746,0.5771,0.574,0.5772
2023-06-19 14:15,68,22,46,2998,842,2156,1748793.0,475167.0,1273626.0,56,14,42,1644,282,1362,947605.0,161789.0,785816.0,0.5643,0.5907,0.5737,0.577
2023-06-19 14:20,204,113,91,11260,7208,4052,6480864.0,4148549.0,2332315.0,183,98,85,10860,6996,3864,6230164.0,4005093.0,2225071.0,0.5755,0.5756,0.5725,0.5758
2023-06-19 14:25,60,23,37,4402,1849,2553,2532376.0,1064271.0,1468104.0,43,15,28,3110,927,2183,1792510.0,531280.0,1261230.0,0.5756,0.5751,0.5731,0.5778
2023-06-19 14:30,58,14,44,4398,564,3834,2534985.0,324371.0,2210614.0,47,11,36,4278,560,3718,2467337.0,321156.0,2146180.0,0.5751,0.5766,0.5735,0.5772
2023-06-19 14:35,24,8,16,887,120,767,493859.0,69187.0,424671.0,13,3,10,644,68,576,372493.0,39043.0,333449.0,0.5766,0.5537,0.5742,0.5789
2023-06-19 14:40,45,11,34,3759,458,3301,2166326.0,262847.0,1903479.0,39,9,30,3464,471,2993,1996469.0,269757.0,1726712.0,0.5739,0.5766,0.5727,0.5769
2023-06-19 14:45,64,30,34,4808,1903,2905,2767386.0,1090386.0,1676999.0,60,27,33,5124,1820,3304,2950713.0,1043365.0,1907348.0,0.573,0.5773,0.5733,0.5773
2023-06-19 14:50,79,33,46,4890,1118,3772,2813482.0,637400.0,2176082.0,61,21,40,4149,946,3203,2389065.0,540884.0,1848180.0,0.5701,0.5769,0.5718,0.577
2023-06-19 14:55,101,17,84,9155,344,8811,5281123.0,196515.0,5084607.0,77,15,62,8703,282,8421,5022064.0,161763.0,4860300.0,0.5713,0.5771,0.5736,0.5772
2023-06-19 15:00,93,37,56,6685,1602,5083,3847755.0,918472.0,2929282.0,85,32,53,6064,1592,4472,3491365.0,912718.0,2578647.0,0.5733,0.5763,0.5733,0.5766
2023-06-19 15:05,185,32,153,22148,2359,19789,12736153.0,1349309.0,11386844.0,179,31,148,21284,2258,19026,12240294.0,1291686.0,10948608.0,0.572,0.5754,0.572,0.5755
2023-06-19 15:10,1249,155,1094,167640,2911,164729,108068468.0,13539460.0,94529008.0,1254,133,1121,167536,2593,164943,108046603.0,13357561.0,94689042.0,4.6511,0.5738,5.1514,0.5741
2023-06-19 15:15,1378,542,836,192968,8344,184624,122672282.0,16650044.0,106022238.0,1369,533,836,193520,8546,184974,122987769.0,16764506.0,106223263.0,1.9955,0.5743,1.9617,0.5743
2023-06-19 15:20,379,116,263,46927,2867,44060,27026416.0,1659708.0,25366707.0,369,110,259,45986,2118,43868,26466645.0,1212269.0,25254376.0,0.5789,0.5757,0.5724,0.5757
2023-06-19 15:25,117,20,97,14068,627,13441,8105589.0,362130.0,7743458.0,108,13,95,14117,741,13376,8130937.0,424390.0,7706547.0,0.5776,0.5761,0.5727,0.5761
2023-06-19 15:30,208,60,148,17202,2250,14952,9898681.0,1287415.0,8611265.0,200,53,147,17404,2002,15402,10016153.0,1145042.0,8871111.0,0.5722,0.5759,0.5719,0.576
2023-06-19 15:35,101,52,49,8175,4305,3870,4695755.0,2462783.0,2232971.0,93,49,44,7739,4256,3483,4443529.0,2434529.0,2008999.0,0.5721,0.577,0.572,0.5768
2023-06-19 15:40,151,51,100,7796,1577,6219,4493072.0,905217.0,3587854.0,93,41,52,7019,1749,5270,4041625.0,1002375.0,3039249.0,0.574,0.5769,0.5731,0.5767
2023-06-19 15:45,126,77,49,8759,1622,7137,5056162.0,936461.0,4119700.0,116,69,47,8776,1481,7295,5059992.0,848720.0,4211271.0,0.5774,0.5772,0.5731,0.5773
2023-06-19 15:50,166,111,55,12436,5838,6598,7164351.0,3356668.0,3807683.0,143,91,52,11878,5328,6550,6834600.0,3054857.0,3779743.0,0.575,0.5771,0.5734,0.5771
2023-06-19 15:55,48,32,16,1789,1342,447,1026040.0,770241.0,255798.0,36,26,10,1956,1321,635,1124174.0,757640.0,366533.0,0.574,0.5723,0.5735,0.5772
2023-06-19 16:00,97,61,36,3754,1796,1958,2160918.0,1030595.0,1130323.0,77,46,31,3316,1766,1550,1907275.0,1012800.0,894474.0,0.5738,0.5773,0.5735,0.5771
2023-06-19 16:05,155,99,56,7868,5526,2342,4519727.0,3167350.0,1352377.0,123,94,29,7242,5506,1736,4153288.0,3153444.0,999843.0,0.5732,0.5774,0.5727,0.5759
2023-06-19 16:10,196,125,71,14774,8060,6714,8489604.0,4621710.0,3867893.0,188,123,65,14490,7751,6739,8334629.0,4445786.0,3888843.0,0.5734,0.5761,0.5736,0.5771
2023-06-19 16:15,124,77,47,11281,7521,3760,6480010.0,4313177.0,2166833.0,116,71,45,10947,7267,3680,6286705.0,4167327.0,2119378.0,0.5735,0.5763,0.5735,0.5759
2023-06-19 16:20,96,55,41,8367,3738,4629,4813360.0,2148732.0,2664628.0,76,40,36,8147,3680,4467,4680221.0,2110180.0,2570041.0,0.5748,0.5756,0.5734,0.5753
2023-06-19 16:25,78,46,32,5864,2891,2973,3371736.0,1658079.0,1713656.0,69,42,27,5563,2891,2672,3197618.0,1657379.0,1540238.0,0.5735,0.5764,0.5733,0.5764
2023-06-19 16:30,327,279,48,13555,7226,6329,7871010.0,4230695.0,3640315.0,317,271,46,12192,6267,5925,7009405.0,3590773.0,3418631.0,0.5855,0.5752,0.573,0.577
2023-06-19 16:35,84,54,30,6208,2414,3794,3569549.0,1382284.0,2187265.0,77,51,26,5880,2233,3647,3382785.0,1278309.0,2104476.0,0.5726,0.5765,0.5725,0.577
2023-06-19 16:40,97,23,74,5415,513,4902,3077781.0,294588.0,2783192.0,61,19,42,4840,417,4423,2786173.0,239197.0,2546975.0,0.5742,0.5678,0.5736,0.5758
2023-06-19 16:45,100,61,39,4640,3688,952,2666011.0,2115989.0,550022.0,70,49,21,3791,2965,826,2177714.0,1700168.0,477546.0,0.5737,0.5778,0.5734,0.5781
2023-06-19 16:50,65,31,34,4739,581,4158,2728322.0,333332.0,2394989.0,62,29,33,4686,795,3891,2699289.0,456056.0,2243233.0,0.5737,0.576,0.5737,0.5765
2023-06-19 16:55,90,51,39,7069,1678,5391,4068450.0,962575.0,3105874.0,83,47,36,6710,1559,5151,3867915.0,894227.0,2973688.0,0.5736,0.5761,0.5736,0.5773
2023-06-19 17:00,43,20,23,3057,1320,1737,1760054.0,759325.0,1000729.0,40,18,22,2681,974,1707,1541119.0,558807.0,982311.0,0.5752,0.5761,0.5737,0.5755
2023-06-19 17:05,80,39,41,6209,3479,2730,15476764.0,13901271.0,1575492.0,64,28,36,5368,2529,2839,14965685.0,13326855.0,1638830.0,3.9958,0.5771,5.2696,0.5773
2023-06-19 17:10,89,66,23,4065,3177,888,2337061.0,1827679.0,509381.0,70,50,20,4392,3189,1203,2523681.0,1829422.0,694259.0,0.5753,0.5736,0.5737,0.5771
2023-06-19 17:15,57,33,24,2518,1270,1248,1455602.0,737362.0,718240.0,45,26,19,2406,1212,1194,1383860.0,695494.0,688366.0,0.5806,0.5755,0.5738,0.5765
2023-06-19 17:20,34,11,23,2564,278,2286,1481275.0,163540.0,1317735.0,29,10,19,2467,229,2238,1421609.0,131538.0,1290071.0,0.5883,0.5764,0.5744,0.5764
2023-06-19 17:25,85,49,36,3208,2081,1127,1853289.0,1202533.0,650755.0,63,39,24,2585,1503,1082,1487015.0,862292.0,624722.0,0.5779,0.5774,0.5737,0.5774
2023-06-19 17:30,103,46,57,4690,1487,3203,2717718.0,870646.0,1847071.0,84,31,53,4601,1189,3412,2648414.0,678657.0,1969756.0,0.5855,0.5767,0.5708,0.5773
2023-06-19 17:35,335,185,150,14552,7897,6655,8325581.0,4540496.0,3785085.0,297,166,131,13527,7815,5712,7782985.0,4490698.0,3292287.0,0.575,0.5688,0.5746,0.5764
2023-06-19 17:40,304,81,223,12583,3502,9081,7238493.0,2012517.0,5225976.0,305,79,226,12295,3384,8911,7077392.0,1944610.0,5132782.0,0.5747,0.5755,0.5746,0.576
2023-06-19 17:45,501,95,406,60240,2793,57447,34662033.0,1611339.0,33050694.0,480,85,395,59538,2435,57103,34290989.0,1397940.0,32893048.0,0.5769,0.5753,0.5741,0.576
2023-06-19 17:50,308,215,93,18402,3994,14408,10591560.0,2291499.0,8300061.0,301,210,91,18247,3842,14405,10502521.0,2204591.0,8297930.0,0.5737,0.5761,0.5738,0.576
2023-06-19 17:55,180,72,108,14899,1752,13147,8582600.0,1006559.0,7576041.0,178,73,105,15279,2398,12881,8798968.0,1376909.0,7422059.0,0.5745,0.5763,0.5742,0.5762
2023-06-19 18:00,160,43,117,12341,1105,11236,7103407.0,635025.0,6468381.0,153,40,113,12558,1390,11168,7215640.0,782778.0,6432862.0,0.5747,0.5757,0.5631,0.576
2023-06-19 18:05,141,33,108,12704,590,12114,7319340.0,339148.0,6980192.0,159,54,105,12675,574,12101,7301981.0,329203.0,6972778.0,0.5748,0.5762,0.5735,0.5762
2023-06-19 18:10,239,78,161,27724,1015,26709,15956928.0,564767.0,15392161.0,224,64,160,27670,916,26754,15930766.0,512458.0,15418308.0,0.5564,0.5763,0.5595,0.5763
2023-06-19 18:15,418,212,206,38276,3473,34803,22056008.0,1996158.0,20059850.0,409,207,202,38144,3416,34728,21981652.0,1962983.0,20018669.0,0.5748,0.5764,0.5746,0.5764
2023-06-19 18:20,176,74,102,12423,1273,11150,7165521.0,738131.0,6427389.0,201,58,143,13221,1080,12141,7623118.0,620488.0,7002630.0,0.5798,0.5764,0.5745,0.5768
2023-06-19 18:25,95,25,70,8894,192,8702,5125764.0,110326.0,5015438.0,102,34,68,9343,466,8877,5379031.0,262597.0,5116433.0,0.5746,0.5764,0.5635,0.5764
2023-06-19 18:30,170,82,88,9872,1712,8160,5694383.0,983440.0,4710942.0,159,77,82,9316,1546,7770,5372366.0,887688.0,4484677.0,0.5744,0.5773,0.5742,0.5772
2023-06-19 18:35,106,41,65,4697,992,3705,2640399.0,575291.0,2065108.0,90,33,57,3581,1115,2466,2056831.0,635627.0,1421203.0,0.5799,0.5574,0.5701,0.5763
2023-06-20 10:00,2402,608,1794,209198,61922,147276,126763834.0,41772158.0,84991675.0,2158,489,1669,194048,50930,143118,113895340.0,31400784.0,82494556.0,0.6746,0.5771,0.6165,0.5764
2023-06-20 10:05,1062,647,415,85983,25191,60792,57403355.0,22324252.0,35079103.0,993,606,387,83504,23556,59948,52791365.0,18201321.0,34590044.0,0.8862,0.577,0.7727,0.577
2023-06-20 10:10,1727,787,940,192526,55202,137324,126534064.0,47273902.0,79260161.0,1610,711,899,188550,52764,135786,124354101.0,46050553.0,78303547.0,0.8564,0.5772,0.8728,0.5767
2023-06-20 10:15,1169,401,768,153348,31740,121608,88281363.0,18178357.0,70103005.0,1133,381,752,152278,31167,121111,87677505.0,17858469.0,69819036.0,0.5727,0.5765,0.573,0.5765
2023-06-20 10:20,1013,281,732,124551,11358,113193,71767939.0,6503675.0,65264264.0,986,264,722,123925,10875,113050,71401120.0,6227532.0,65173588.0,0.5726,0.5766,0.5726,0.5765
2023-06-20 10:25,2950,2006,944,265007,179048,85959,308576176.0,258784550.0,49791625.0,2251,1741,510,222625,155538,67087,279490569.0,240445501.0,39045067.0,1.4453,0.5792,1.5459,0.582
2023-06-20 10:30,1346,1025,321,102896,82795,20101,59872591.0,48102354.0,11770237.0,1156,935,221,89295,75884,13411,51903485.0,44055595.0,7847889.0,0.581,0.5856,0.5806,0.5852
2023-06-20 10:35,869,719,150,74120,61962,12158,55031297.0,48016642.0,7014654.0,726,638,88,61045,54512,6533,47429196.0,43600018.0,3829178.0,0.7749,0.577,0.7998,0.5861
2023-06-20 10:40,710,555,155,74094,68745,5349,55187869.0,51988072.0,3199797.0,549,494,55,65623,64376,1247,50232364.0,49496266.0,736098.0,0.7562,0.5982,0.7689,0.5903
2023-06-20 10:45,3599,2592,1007,364700,296981,67719,564005058.0,520703247.0,43301811.0,2793,2339,454,317128,270424,46704,531878853.0,504052485.0,27826367.0,1.7533,0.6394,1.8639,0.5958
2023-06-20 10:50,3899,2413,1486,373545,229073,144472,517047207.0,432265509.0,84781698.0,3255,2090,1165,341810,215772,126038,498682371.0,424048599.0,74633771.0,1.887,0.5868,1.9653,0.5922
2023-06-20 10:55,3457,2376,1081,313282,184721,128561,290461151.0,215288606.0,75172544.0,3100,2180,920,295094,176032,119062,279972012.0,209954814.0,70017197.0,1.1655,0.5847,1.1927,0.5881
2023-06-20 11:00,2170,1766,404,171761,147432,24329,136169161.0,121951243.0,14217918.0,2053,1707,346,167765,146163,21602,133909691.0,121179974.0,12729717.0,0.8272,0.5844,0.8291,0.5893
2023-06-20 11:05,3653,3320,333,442519,419107,23412,354989312.0,341159536.0,13829775.0,3478,3242,236,431248,412310,18938,347970204.0,336803749.0,11166455.0,0.814,0.5907,0.8169,0.5896
2023-06-20 11:10,3959,2777,1182,299481,252886,46595,223537613.0,196041243.0,27496370.0,3839,2724,1115,294730,250727,44003,220703489.0,194693203.0,26010286.0,0.7752,0.5901,0.7765,0.5911
2023-06-20 11:15,1180,791,389,118031,101539,16492,81101184.0,71325261.0,9775922.0,1093,744,349,116229,101011,15218,80018382.0,71018681.0,8999700.0,0.7024,0.5928,0.7031,0.5914
2023-06-20 11:20,1046,852,194,74880,67017,7863,91449542.0,86812337.0,4637205.0,927,798,129,66115,60548,5567,86327037.0,83032594.0,3294443.0,1.2954,0.5898,1.3714,0.5918
2023-06-20 11:25,1083,881,202,62171,56635,5536,72370085.0,69078524.0,3291561.0,917,809,108,56019,52257,3762,68663056.0,66405608.0,2257447.0,1.2197,0.5946,1.2708,0.6001
2023-06-20 11:30,1937,1489,448,167998,153366,14632,135100714.0,126388750.0,8711963.0,1722,1408,314,160647,151577,9070,130762718.0,125325312.0,5437405.0,0.8241,0.5954,0.8268,0.5995
2023-06-20 11:35,1150,761,389,54819,26222,28597,91262916.0,74848877.0,16414038.0,1034,708,326,44864,23892,20972,85946346.0,73476412.0,12469933.0,2.8544,0.574,3.0754,0.5946
2023-06-20 11:40,1929,1455,474,147896,102666,45230,182221342.0,155465035.0,26756306.0,1729,1360,369,137941,95710,42231,176347347.0,151351140.0,24996206.0,1.5143,0.5916,1.5814,0.5919
2023-06-20 11:45,2852,2198,654,233587,197494,36093,292040718.0,270754563.0,21286155.0,2747,2146,601,228480,195580,32900,289096378.0,269562402.0,19533976.0,1.371,0.5898,1.3783,0.5937
2023-06-20 11:50,1700,1217,483,134414,93157,41257,150234684.0,126223203.0,24011481.0,1583,1152,431,125990,91098,34892,145651196.0,125018119.0,20633076.0,1.355,0.582,1.3723,0.5913
2023-06-20 11:55,1147,582,565,81658,29604,52054,95607275.0,64859120.0,30748155.0,1032,514,518,76004,23826,52178,92355314.0,61503566.0,30851748.0,2.1909,0.5907,2.5814,0.5913
2023-06-20 12:00,3046,2298,748,262917,202586,60331,237124314.0,201775807.0,35348507.0,2971,2270,701,256978,202377,54601,233818210.0,201624220.0,32193990.0,0.996,0.5859,0.9963,0.5896
2023-06-20 12:05,1938,1467,471,181609,169509,12100,118138348.0,111082764.0,7055583.0,1835,1404,431,177452,167046,10406,115750683.0,109617046.0,6133637.0,0.6553,0.5831,0.6562,0.5894
2023-06-20 12:10,1257,610,647,96217,85700,10517,68682889.0,61972555.0,6710334.0,1227,587,640,95651,85006,10645,67809648.0,61552664.0,6256983.0,0.7231,0.638,0.7241,0.5878
2023-06-20 12:15,1235,377,858,56780,30261,26519,36172709.0,17703740.0,18468969.0,1194,353,841,55838,30016,25822,32744465.0,17552286.0,15192179.0,0.585,0.6964,0.5848,0.5883
2023-06-20 12:20,149,85,64,5914,3052,2862,15356986.0,13666808.0,1690177.0,115,56,59,4592,2199,2393,14571873.0,13162665.0,1409207.0,4.478,0.5906,5.9858,0.5889
2023-06-20 12:25,600,458,142,27627,18903,8724,16215513.0,11075270.0,5140243.0,578,449,129,27390,19084,8306,16066967.0,11172769.0,4894197.0,0.5859,0.5892,0.5855,0.5892
2023-06-20 12:30,321,216,105,29838,22742,7096,17492098.0,13329428.0,4162670.0,298,204,94,28892,22234,6658,16948338.0,13024517.0,3923821.0,0.5861,0.5866,0.5858,0.5893
2023-06-20 12:35,572,533,39,17682,16178,1504,10388940.0,9481413.0,907526.0,558,528,30,16497,16141,356,9665891.0,9454411.0,211480.0,0.5861,0.6034,0.5857,0.594
2023-06-20 12:40,898,532,366,82100,60181,21919,71945842.0,59034936.0,12910905.0,847,492,355,81484,59643,21841,71562709.0,58701092.0,12861617.0,0.981,0.589,0.9842,0.5889
2023-06-20 12:45,256,87,169,12392,2550,9842,7266604.0,1492088.0,5774516.0,226,70,156,11948,2588,9360,7023103.0,1510926.0,5512177.0,0.5851,0.5867,0.5838,0.5889
2023-06-20 12:50,371,288,83,9681,5602,4079,5682175.0,3276419.0,2405756.0,326,260,66,8769,4955,3814,5148192.0,2900614.0,2247578.0,0.5849,0.5898,0.5854,0.5893
2023-06-20 12:55,981,711,270,42534,26312,16222,36908427.0,27331089.0,9577338.0,932,687,245,40814,25082,15732,35885458.0,26599371.0,9286087.0,1.0387,0.5904,1.0605,0.5903
2023-06-20 13:00,476,348,128,16161,9796,6365,9523353.0,5757714.0,3765639.0,437,330,107,14281,8401,5880,8405097.0,4928211.0,3476886.0,0.5878,0.5916,0.5866,0.5913
2023-06-20 13:05,455,357,98,14902,9753,5149,20645311.0,17626928.0,3018383.0,404,333,71,11990,8464,3526,18949167.0,16856350.0,2092817.0,1.8073,0.5862,1.9915,0.5935
2023-06-20 13:10,420,295,125,18161,12440,5721,34506301.0,31090438.0,3415863.0,343,240,103,15366,10714,4652,32807644.0,30043767.0,2763877.0,2.4992,0.5971,2.8042,0.5941
2023-06-20 13:15,681,512,169,30858,22168,8690,53782624.0,48698414.0,5084209.0,600,459,141,28450,20872,7578,52420179.0,47930770.0,4489409.0,2.1968,0.5851,2.2964,0.5924
2023-06-20 13:20,840,473,367,38761,21469,17292,58457397.0,48297577.0,10159819.0,744,419,325,37098,21271,15827,57556110.0,48170691.0,9385419.0,2.2496,0.5875,2.2646,0.593
2023-06-20 13:25,1097,414,683,62458,8495,53963,48809459.0,16905977.0,31903482.0,1003,355,648,60951,7703,53248,47902123.0,16408128.0,31493995.0,1.9901,0.5912,2.1301,0.5915
2023-06-20 13:30,391,205,186,14785,6934,7851,9629057.0,4095929.0,5533128.0,315,161,154,13585,6489,7096,8032435.0,3821881.0,4210553.0,0.5907,0.7048,0.589,0.5934
2023-06-20 13:35,191,107,84,9592,4423,5169,5673979.0,2611990.0,3061989.0,131,67,64,6747,1897,4850,3992213.0,1117529.0,2874683.0,0.5905,0.5924,0.5891,0.5927
2023-06-20 13:40,221,122,99,6246,2576,3670,3682882.0,1521213.0,2161668.0,166,86,80,5807,2258,3549,3430590.0,1328154.0,2102436.0,0.5905,0.589,0.5882,0.5924
2023-06-20 13:45,2880,154,2726,357534,8987,348547,305181955.0,100267527.0,204914428.0,2796,100,2696,352250,7338,344912,302264973.0,99300624.0,202964348.0,11.157,0.5879,13.5324,0.5885
2023-06-20 13:50,2544,162,2382,311825,6813,305012,207221203.0,27782369.0,179438834.0,2515,128,2387,309231,5410,303821,205724485.0,26918360.0,178806124.0,4.0778,0.5883,4.9757,0.5885
2023-06-20 13:55,3297,196,3101,425778,8650,417128,274817043.0,28807760.0,246009283.0,3245,157,3088,424912,7933,416979,273777275.0,28386595.0,245390679.0,3.3304,0.5898,3.5783,0.5885
2023-06-20 14:00,1988,137,1851,281304,4860,276444,165467225.0,2839811.0,162627414.0,1971,127,1844,281074,4805,276269,165335161.0,2807696.0,162527465.0,0.5843,0.5883,0.5843,0.5883
2023-06-20 14:05,2064,343,1721,230405,20093,210312,147366863.0,23673850.0,123693013.0,2031,327,1704,228796,18408,210388,146379660.0,22642746.0,123736914.0,1.1782,0.5881,1.23,0.5881
2023-06-20 14:10,2278,1116,1162,148568,84413,64155,87163539.0,49423728.0,37739811.0,2257,1105,1152,147584,83793,63791,86594352.0,49057252.0,37537100.0,0.5855,0.5883,0.5855,0.5884
2023-06-20 14:15,2258,405,1853,169436,16000,153436,111430684.0,21233199.0,90197484.0,2216,381,1835,167978,14891,153087,110576265.0,20578849.0,89997416.0,1.3271,0.5879,1.382,0.5879
2023-06-20 14:20,571,146,425,24357,3779,20578,26191964.0,14094753.0,12097211.0,556,139,417,23833,3414,20419,25887071.0,13873039.0,12014031.0,3.7298,0.5879,4.0636,0.5884
2023-06-20 14:25,2162,266,1896,258973,11568,247405,199458554.0,54277068.0,145181486.0,2132,233,1899,257541,11052,246489,198723792.0,53964394.0,144759397.0,4.692,0.5868,4.8828,0.5873
2023-06-20 14:30,1980,190,1790,209456,8566,200890,146942158.0,28833893.0,118108264.0,1896,163,1733,205993,6264,199729,144845668.0,27401799.0,117443869.0,3.3661,0.5879,4.3745,0.588
2023-06-20 14:35,409,98,311,31119,5923,25196,30249992.0,15357331.0,14892661.0,371,81,290,30307,5546,24761,29779740.0,15119673.0,14660066.0,2.5928,0.5911,2.7262,0.5921
2023-06-20 14:40,932,184,748,78035,14771,63264,81621289.0,44383044.0,37238245.0,884,153,731,74159,11841,62318,79311040.0,42561547.0,36749492.0,3.0047,0.5886,3.5944,0.5897
2023-06-20 14:45,405,265,140,23435,16435,7000,25719266.0,21578511.0,4140754.0,362,253,109,21210,15085,6125,24348906.0,20729788.0,3619117.0,1.313,0.5915,1.3742,0.5909
2023-06-20 14:50,261,223,38,12461,10570,1891,7336286.0,6217975.0,1118311.0,251,219,32,11778,10184,1594,6933432.0,5987469.0,945963.0,0.5883,0.5914,0.5879,0.5935
2023-06-20 14:55,620,152,468,20392,10738,9654,12035170.0,6315959.0,5719211.0,600,143,457,20506,10636,9870,12102126.0,6253850.0,5848275.0,0.5882,0.5924,0.588,0.5925
2023-06-20 15:00,147,107,40,9056,8029,1027,5336144.0,4728420.0,607723.0,150,109,41,8459,7763,696,4975317.0,4562430.0,412887.0,0.5889,0.5917,0.5877,0.5932
2023-06-20 15:05,349,143,206,24521,12155,12366,14474631.0,7146266.0,7328365.0,325,133,192,23535,11785,11750,13898096.0,6929436.0,6968659.0,0.5879,0.5926,0.588,0.5931
2023-06-20 15:10,730,222,508,39189,23153,16036,23081277.0,13609479.0,9471798.0,713,210,503,37814,22026,15788,22282133.0,12946025.0,9336108.0,0.5878,0.5907,0.5878,0.5913
2023-06-20 15:15,951,339,612,49337,30116,19221,40892200.0,29562173.0,11330027.0,925,336,589,49000,29897,19103,40698614.0,29433323.0,11265291.0,0.9816,0.5895,0.9845,0.5897
2023-06-20 15:20,1162,308,854,84629,22628,62001,49850080.0,13300737.0,36549343.0,1129,294,835,82998,21969,61029,48873498.0,12891947.0,35981550.0,0.5878,0.5895,0.5868,0.5896
2023-06-20 15:25,362,203,159,13674,9181,4493,8036140.0,5389814.0,2646325.0,353,198,155,13608,9151,4457,7998666.0,5370531.0,2628135.0,0.5871,0.589,0.5869,0.5897
2023-06-20 15:30,1308,603,705,106483,47606,58877,62686820.0,27967713.0,34719107.0,1277,590,687,105343,46587,58756,61974410.0,27327720.0,34646689.0,0.5875,0.5897,0.5866,0.5897
2023-06-20 15:35,1253,1005,248,90874,81108,9766,89115887.0,83379684.0,5736203.0,1187,984,203,88305,79470,8835,87538035.0,82316199.0,5221835.0,1.028,0.5874,1.0358,0.591
2023-06-20 15:40,2161,2137,24,197965,197254,711,116397893.0,115979089.0,418804.0,2144,2132,12,196319,195944,375,115395617.0,115173812.0,221805.0,0.588,0.589,0.5878,0.5915
2023-06-20 15:45,1520,1501,19,147846,147046,800,86937482.0,86463054.0,474428.0,1500,1492,8,147336,146791,545,86617610.0,86295552.0,322058.0,0.588,0.593,0.5879,0.5909
2023-06-20 15:50,406,341,65,40911,38703,2208,24133102.0,22823145.0,1309957.0,382,333,49,40175,37727,2448,23632905.0,22179973.0,1452931.0,0.5897,0.5933,0.5879,0.5935
2023-06-20 15:55,1520,843,677,134573,54508,80065,138353222.0,91405090.0,46948131.0,1471,819,652,131440,54938,76502,136713145.0,91657290.0,45055855.0,1.6769,0.5864,1.6684,0.589
2023-06-20 16:00,3330,86,3244,412406,3353,409053,253869862.0,13829707.0,240040155.0,3286,73,3213,408398,2423,405975,251767444.0,13285453.0,238481991.0,4.1246,0.5868,5.4831,0.5874
2023-06-20 16:05,2929,94,2835,259647,4603,255044,199870843.0,50220635.0,149650207.0,2862,68,2794,257355,4023,253332,198557599.0,49846919.0,148710680.0,10.9104,0.5868,12.3905,0.587
2023-06-20 16:10,3435,210,3225,437778,9107,428671,292928464.0,40931762.0,251996701.0,3329,143,3186,432069,6522,425547,288773639.0,39413194.0,249360444.0,4.4945,0.5879,6.0431,0.586
2023-06-20 16:15,2328,321,2007,222729,14400,208329,142124458.0,20235077.0,121889381.0,2265,286,1979,220916,14279,206637,141082123.0,20150352.0,120931770.0,1.4052,0.5851,1.4112,0.5852
2023-06-20 16:20,1472,125,1347,69195,5216,63979,52264485.0,14891877.0,37372607.0,1390,75,1315,64540,3995,60545,50555168.0,14186752.0,36368415.0,2.855,0.5841,3.5511,0.6007
2023-06-20 16:25,1725,289,1436,125063,17187,107876,108557576.0,45651823.0,62905753.0,1623,216,1407,121538,12091,109447,106472310.0,42632740.0,63839570.0,2.6562,0.5831,3.526,0.5833
2023-06-20 16:30,1876,1085,791,145174,81210,63964,179800245.0,142279288.0,37520956.0,1773,1026,747,140122,78334,61788,176849452.0,140579547.0,36269905.0,1.752,0.5866,1.7946,0.587
2023-06-20 16:35,778,563,215,47876,32937,14939,28002951.0,19243008.0,8759942.0,715,535,180,45042,32114,12928,26340871.0,18735173.0,7605697.0,0.5842,0.5864,0.5834,0.5883
2023-06-20 16:40,353,271,82,18715,16023,2692,10940589.0,9361301.0,1579288.0,329,260,69,18917,15923,2994,11053962.0,9294410.0,1759552.0,0.5842,0.5867,0.5837,0.5877
2023-06-20 16:45,634,165,469,41097,10120,30977,35873682.0,17780128.0,18093554.0,600,150,450,41220,11364,29856,36011826.0,18495027.0,17516799.0,1.7569,0.5841,1.6275,0.5867
2023-06-20 16:50,126,35,91,6364,1473,4891,3724373.0,858363.0,2866010.0,122,24,98,5994,1001,4993,3510868.0,583094.0,2927773.0,0.5827,0.586,0.5825,0.5864
2023-06-20 16:55,3822,1201,2621,440437,185251,255186,740194222.0,594036582.0,146157639.0,3061,772,2289,337851,129257,208594,682352684.0,561333322.0,121019362.0,3.2067,0.5727,4.3428,0.5802
2023-06-20 17:00,1110,552,558,103670,62978,40692,59911224.0,36327689.0,23583535.0,923,457,466,102689,68329,34360,59162249.0,39211375.0,19950874.0,0.5768,0.5796,0.5739,0.5806
2023-06-20 17:05,858,251,607,89096,17327,71769,86925275.0,45605627.0,41319647.0,735,173,562,79394,12665,66729,81542368.0,42891740.0,38650627.0,2.6321,0.5757,3.3866,0.5792
2023-06-20 17:10,2203,831,1372,221858,37529,184329,175661835.0,69141477.0,106520358.0,2060,761,1299,215673,34730,180943,172198701.0,67496867.0,104701834.0,1.8423,0.5779,1.9435,0.5786
2023-06-20 17:15,3068,575,2493,400537,11370,389167,290562962.0,65925042.0,224637920.0,2937,475,2462,397139,9898,387241,288739196.0,65060039.0,223679157.0,5.7982,0.5772,6.573,0.5776
2023-06-20 17:20,4237,2826,1411,391162,181781,209381,378904722.0,258623287.0,120281435.0,3991,2686,1305,379822,176839,202983,372699217.0,255675361.0,117023856.0,1.4227,0.5745,1.4458,0.5765
2023-06-20 17:25,1924,1519,405,144720,127240,17480,118642206.0,108589641.0,10052565.0,1865,1496,369,146363,129445,16918,119603697.0,109843310.0,9760387.0,0.8534,0.5751,0.8486,0.5769
2023-06-20 17:30,952,594,358,78224,64101,14123,56710269.0,48576210.0,8134059.0,934,574,360,75889,61392,14497,55392019.0,47015048.0,8376971.0,0.7578,0.5759,0.7658,0.5778
2023-06-20 17:35,440,206,234,22589,15782,6807,24984651.0,21047270.0,3937380.0,381,172,209,21177,13397,7780,24075719.0,19572781.0,4502938.0,1.3336,0.5784,1.461,0.5788
2023-06-20 17:40,1638,354,1284,170276,47140,123136,192204600.0,121886599.0,70318000.0,1518,287,1231,156077,43123,112954,184741592.0,119591096.0,65150495.0,2.5856,0.5711,2.7733,0.5768
2023-06-20 17:45,1772,324,1448,147145,15118,132027,108125057.0,32393605.0,75731452.0,1682,259,1423,147370,16716,130654,108225062.0,33276941.0,74948120.0,2.1427,0.5736,1.9907,0.5736
2023-06-20 17:50,906,488,418,38143,22327,15816,33777110.0,24688928.0,9088181.0,843,457,386,35587,19967,15620,32283807.0,23298389.0,8985417.0,1.1058,0.5746,1.1668,0.5753
2023-06-20 17:55,995,511,484,32698,25669,7029,18800338.0,14756140.0,4044198.0,964,495,469,31777,25084,6693,18224921.0,14369411.0,3855510.0,0.5749,0.5754,0.5729,0.5761
2023-06-20 18:00,1312,877,435,60893,50306,10587,46837245.0,40739500.0,6097744.0,1262,844,418,60563,50149,10414,46571432.0,40571321.0,6000111.0,0.8098,0.576,0.809,0.5762
2023-06-20 18:05,676,276,400,24527,11521,13006,49677745.0,42227181.0,7450564.0,632,246,386,22952,10678,12274,48830025.0,41744291.0,7085733.0,3.6652,0.5729,3.9094,0.5773
2023-06-20 18:10,350,85,265,16526,2960,13566,9467698.0,1693536.0,7774162.0,305,53,252,16034,2886,13148,9223763.0,1649694.0,7574068.0,0.5721,0.5731,0.5716,0.5761
2023-06-20 18:15,719,86,633,43480,5587,37893,36824480.0,15067984.0,21756496.0,712,48,664,43473,5102,38371,36872892.0,14789533.0,22083359.0,2.697,0.5742,2.8988,0.5755
2023-06-20 18:20,1194,141,1053,90795,13723,77072,64122236.0,19715564.0,44406672.0,1153,108,1045,89928,13398,76530,63625190.0,19525621.0,44099568.0,1.4367,0.5762,1.4574,0.5762
2023-06-20 18:25,355,116,239,26836,7207,19629,15435610.0,4123271.0,11312338.0,310,79,231,26511,6779,19732,15233565.0,3857731.0,11375834.0,0.5721,0.5763,0.5691,0.5765
2023-06-20 18:30,666,90,576,58837,4369,54468,33910354.0,2521481.0,31388873.0,617,58,559,57130,3191,53939,32952816.0,1825444.0,31127372.0,0.5771,0.5763,0.5721,0.5771
2023-06-20 18:35,780,134,646,47138,13740,33398,50907237.0,31627262.0,19279975.0,743,112,631,44806,11931,32875,49583051.0,30587564.0,18995486.0,2.3018,0.5773,2.5637,0.5778
2023-06-21 10:00,2737,736,2001,202771,50600,152171,133391949.0,44980601.0,88411348.0,2382,592,1790,183316,38222,145094,113207121.0,29012818.0,84194303.0,0.8889,0.581,0.7591,0.5803
2023-06-21 10:05,2256,484,1772,211629,26918,184711,122279540.0,15463035.0,106816504.0,2172,430,1742,208807,25439,183368,120664861.0,14633725.0,106031135.0,0.5744,0.5783,0.5752,0.5782
2023-06-21 10:10,2002,1528,474,169674,99899,69775,112425466.0,69242288.0,43183178.0,1953,1496,457,164882,96486,68396,104660532.0,65046243.0,39614289.0,0.6931,0.6189,0.6742,0.5792
2023-06-21 10:15,2036,1547,489,185832,129776,56056,130902424.0,98463774.0,32438649.0,2014,1533,481,185953,129673,56280,130970269.0,98398964.0,32571305.0,0.7587,0.5787,0.7588,0.5787
2023-06-21 10:20,1882,1500,382,114083,88345,25738,65855170.0,50940130.0,14915040.0,1805,1456,349,113082,87633,25449,65251474.0,50511037.0,14740437.0,0.5766,0.5795,0.5764,0.5792
2023-06-21 10:25,2092,622,1470,240537,41210,199327,245661228.0,130586135.0,115075092.0,2052,585,1467,236212,39869,196343,243303408.0,129807052.0,113496356.0,3.1688,0.5773,3.2558,0.5781
2023-06-21 10:30,2284,227,2057,259971,18255,241716,185496391.0,46097503.0,139398888.0,2147,158,1989,251932,11463,240469,180874070.0,42196152.0,138677917.0,2.5252,0.5767,3.6811,0.5767
2023-06-21 10:35,1125,178,947,110795,13428,97367,75848888.0,19592868.0,56256019.0,1137,177,960,111263,13131,98132,76116723.0,19416858.0,56699865.0,1.4591,0.5778,1.4787,0.5778
2023-06-21 10:40,889,113,776,91778,9317,82461,53080596.0,5365339.0,47715257.0,831,104,727,89617,8144,81473,51823927.0,4684076.0,47139850.0,0.5759,0.5786,0.5752,0.5786
2023-06-21 10:45,1273,378,895,149310,41441,107869,98180796.0,35768874.0,62411922.0,1198,322,876,147223,40461,106762,96967740.0,35200287.0,61767453.0,0.8631,0.5786,0.87,0.5786
2023-06-21 10:50,2885,2105,780,276170,174618,101552,159521798.0,100693159.0,58828638.0,2891,2120,771,280887,179463,101424,162225395.0,103474131.0,58751264.0,0.5766,0.5793,0.5766,0.5793
2023-06-21 10:55,1841,1597,244,142218,126927,15291,105744568.0,96922289.0,8822279.0,1770,1552,218,139838,126116,13722,104406197.0,96458297.0,7947900.0,0.7636,0.577,0.7648,0.5792
2023-06-21 11:00,1365,1061,304,105681,82203,23478,60977970.0,47390693.0,13587277.0,1238,993,245,103980,80672,23308,60007113.0,46514511.0,13492601.0,0.5765,0.5787,0.5766,0.5789
2023-06-21 11:05,1708,1629,79,170466,168488,1978,98209140.0,97067549.0,1141591.0,1682,1616,66,170386,168612,1774,98169272.0,97141240.0,1028032.0,0.5761,0.5771,0.5761,0.5795
2023-06-21 11:10,539,392,147,39191,32475,6716,22694739.0,18701843.0,3992896.0,504,381,123,34537,31718,2819,19898175.0,18262848.0,1635327.0,0.5759,0.5945,0.5758,0.5801
2023-06-21 11:15,237,168,69,25944,24256,1688,14883848.0,13870737.0,1013111.0,198,136,62,22604,21776,828,12970172.0,12490047.0,480125.0,0.5718,0.6002,0.5736,0.5799
2023-06-21 11:20,157,41,116,7697,5761,1936,4383323.0,3266863.0,1116460.0,140,35,105,6341,4546,1795,3658669.0,2620326.0,1038342.0,0.5671,0.5767,0.5764,0.5785
2023-06-21 11:25,209,79,130,9299,6481,2818,5376461.0,3742067.0,1634393.0,223,103,120,9328,6560,2768,5372432.0,3764259.0,1608173.0,0.5774,0.58,0.5738,0.581
2023-06-21 11:30,471,242,229,28142,15983,12159,16252493.0,9223727.0,7028766.0,411,193,218,27608,15500,12108,15945107.0,8932236.0,7012871.0,0.5771,0.5781,0.5763,0.5792
2023-06-21 11:35,115,79,36,9586,8617,969,5525026.0,4960692.0,564334.0,107,77,30,9000,8116,884,5186251.0,4672635.0,513616.0,0.5757,0.5824,0.5757,0.581
2023-06-21 11:40,143,88,55,7230,5714,1516,4182090.0,3300466.0,881624.0,135,84,51,7451,6052,1399,4307281.0,3493471.0,813809.0,0.5776,0.5815,0.5772,0.5817
2023-06-21 11:45,783,637,146,61819,57244,4575,59470935.0,56815612.0,2655323.0,754,623,131,61513,57031,4482,59283565.0,56683240.0,2600325.0,0.9925,0.5804,0.9939,0.5802
2023-06-21 11:50,1056,862,194,104611,97287,7324,72309809.0,68063799.0,4246010.0,1050,865,185,101367,94297,7070,70404710.0,66307165.0,4097544.0,0.6996,0.5797,0.7032,0.5796
2023-06-21 11:55,2026,1420,606,175249,139678,35571,208937846.0,188270245.0,20667600.0,1600,1231,369,152993,129949,23044,195901874.0,182380973.0,13520900.0,1.3479,0.581,1.4035,0.5867
2023-06-21 12:00,1137,883,254,96943,88032,8911,68307046.0,63122422.0,5184624.0,1050,850,200,93874,88849,5025,66516992.0,63562675.0,2954316.0,0.717,0.5818,0.7154,0.5879
2023-06-21 12:05,1713,1344,369,146052,120759,25293,168629377.0,153785388.0,14843988.0,1553,1295,258,142125,117814,24311,166146280.0,151837427.0,14308852.0,1.2735,0.5869,1.2888,0.5886
2023-06-21 12:10,2462,2077,385,223652,213612,10040,178196813.0,172334865.0,5861948.0,2327,2012,315,199779,191532,8247,164248015.0,159387508.0,4860507.0,0.8068,0.5839,0.8322,0.5894
2023-06-21 12:15,3071,2427,644,308978,277399,31579,423981208.0,402029556.0,21951652.0,2329,2039,290,285595,271212,14383,405734396.0,397192162.0,8542234.0,1.4493,0.6951,1.4645,0.5939
2023-06-21 12:20,2476,1582,894,193039,153542,39497,162665426.0,139347442.0,23317984.0,1787,1278,509,156461,131032,25429,140408795.0,125224043.0,15184751.0,0.9076,0.5904,0.9557,0.5971
2023-06-21 12:25,3738,2089,1649,313147,204375,108772,317710130.0,253059437.0,64650693.0,2811,1603,1208,262681,182280,80401,287399792.0,239229555.0,48170236.0,1.2382,0.5944,1.3124,0.5991
2023-06-21 12:30,5194,2228,2966,556703,146462,410241,521046117.0,277452714.0,243593403.0,4280,1705,2575,495091,115215,379876,485243121.0,258303325.0,226939796.0,1.8944,0.5938,2.2419,0.5974
2023-06-21 12:35,1932,1025,907,125408,50413,74995,110463733.0,65707855.0,44755878.0,1556,858,698,107116,42289,64827,99407022.0,60648248.0,38758774.0,1.3034,0.5968,1.4341,0.5979
2023-06-21 12:40,1707,556,1151,140217,26899,113318,124564164.0,51695956.0,72868208.0,1381,364,1017,122376,18632,103744,108657332.0,46679435.0,61977897.0,1.9219,0.643,2.5053,0.5974
2023-06-21 12:45,2509,398,2111,283174,18216,264958,192244695.0,34571561.0,157673134.0,2319,308,2011,271219,12297,258922,185253557.0,31020311.0,154233246.0,1.8979,0.5951,2.5226,0.5957
2023-06-21 12:50,1717,556,1161,141716,22156,119560,85186558.0,13260088.0,71926469.0,1564,486,1078,132588,17180,115408,79137869.0,10195302.0,68942567.0,0.5985,0.6016,0.5934,0.5974
2023-06-21 12:55,876,539,337,40634,15145,25489,23805183.0,9129430.0,14675752.0,690,436,254,28409,10752,17657,16915689.0,6379957.0,10535732.0,0.6028,0.5758,0.5934,0.5967
2023-06-21 13:00,290,148,142,18419,5446,12973,10963854.0,3219577.0,7744277.0,235,121,114,16694,5686,11008,9922939.0,3345666.0,6577273.0,0.5912,0.597,0.5884,0.5975
2023-06-21 13:05,314,161,153,25239,7521,17718,16372545.0,4563361.0,11809184.0,203,110,93,14885,6045,8840,8887164.0,3577878.0,5309286.0,0.6067,0.6665,0.5919,0.6006
2023-06-21 13:10,464,144,320,27345,11225,16120,27903184.0,18574769.0,9328415.0,362,80,282,21172,9220,11952,24442666.0,17317115.0,7125550.0,1.6548,0.5787,1.8782,0.5962
2023-06-21 13:15,1914,802,1112,225212,115824,109388,145532481.0,80598512.0,64933968.0,1788,720,1068,219165,111596,107569,141863000.0,77960879.0,63902121.0,0.6959,0.5936,0.6986,0.5941
2023-06-21 13:20,2433,1944,489,290366,274509,15857,196662402.0,187292473.0,9369929.0,2271,1864,407,280994,264338,16656,190687780.0,180725041.0,9962738.0,0.6823,0.5909,0.6837,0.5981
2023-06-21 13:25,731,572,159,56152,49619,6533,57348703.0,53441415.0,3907287.0,596,512,84,47824,46106,1718,52207345.0,51178112.0,1029232.0,1.077,0.5981,1.11,0.5991
2023-06-21 13:30,949,646,303,40209,27099,13110,35837148.0,27997584.0,7839563.0,843,586,257,36169,24928,11241,33436760.0,26697273.0,6739487.0,1.0332,0.598,1.071,0.5995
2023-06-21 13:35,217,133,84,10198,6247,3951,6574843.0,3700884.0,2873958.0,161,97,64,8179,5276,2903,4868654.0,3127009.0,1741644.0,0.5924,0.7274,0.5927,0.5999
2023-06-21 13:40,430,59,371,14623,3368,11255,8711404.0,2010059.0,6701345.0,392,40,352,15173,4356,10817,9032515.0,2579292.0,6453222.0,0.5968,0.5954,0.5921,0.5966
2023-06-21 13:45,167,89,78,9384,6468,2916,5567991.0,3858513.0,1709477.0,122,64,58,8422,5065,3357,5007662.0,3001941.0,2005721.0,0.5966,0.5862,0.5927,0.5975
2023-06-21 13:50,455,193,262,28110,17742,10368,16605656.0,10568860.0,6036796.0,365,147,218,22294,14784,7510,13267712.0,8782210.0,4485501.0,0.5957,0.5823,0.594,0.5973
2023-06-21 13:55,624,424,200,56402,44157,12245,45453733.0,38141102.0,7312631.0,558,401,157,55078,43281,11797,44645365.0,37599702.0,7045663.0,0.8638,0.5972,0.8687,0.5972
2023-06-21 14:00,1214,313,901,73289,45392,27897,43690977.0,27032909.0,16658068.0,1149,283,866,70043,43799,26244,41721481.0,26046033.0,15675448.0,0.5955,0.5971,0.5947,0.5973
2023-06-21 14:05,433,269,164,28974,20995,7979,17322424.0,12563849.0,4758574.0,389,249,140,27650,20268,7382,16464245.0,12048195.0,4416050.0,0.5984,0.5964,0.5944,0.5982
2023-06-21 14:10,414,259,155,25002,17496,7506,26712356.0,22287750.0,4424605.0,377,247,130,22967,16615,6352,25566489.0,21748202.0,3818286.0,1.2739,0.5895,1.3089,0.6011
2023-06-21 14:15,477,95,382,17954,3607,14347,22446048.0,14010733.0,8435315.0,426,74,352,15733,3338,12395,21245172.0,13849719.0,7395453.0,3.8843,0.5879,4.1491,0.5966
2023-06-21 14:20,440,93,347,17768,3770,13998,22257771.0,14122877.0,8134894.0,399,65,334,15695,3069,12626,21223153.0,13695525.0,7527628.0,3.7461,0.5811,4.4625,0.5962
2023-06-21 14:25,906,349,557,49597,26439,23158,53218493.0,39442890.0,13775602.0,854,322,532,46827,24206,22621,51562856.0,38103472.0,13459383.0,1.4918,0.5949,1.5741,0.595
2023-06-21 14:30,796,370,426,51153,29397,21756,54192989.0,41251828.0,12941160.0,735,340,395,48590,27965,20625,52626271.0,40340894.0,12285376.0,1.4033,0.5948,1.4425,0.5957
2023-06-21 14:35,491,93,398,29565,2367,27198,17594763.0,1398701.0,16196062.0,372,34,338,28450,1544,26906,16939655.0,915357.0,16024298.0,0.5909,0.5955,0.5928,0.5956
2023-06-21 14:40,520,127,393,35773,9006,26767,33166658.0,17231260.0,15935398.0,487,113,374,34625,8536,26089,32481505.0,16927317.0,15554187.0,1.9133,0.5953,1.9831,0.5962
2023-06-21 14:45,188,48,140,12021,2454,9567,7155505.0,1458192.0,5697313.0,156,34,122,10516,2919,7597,6247017.0,1718824.0,4528193.0,0.5942,0.5955,0.5888,0.5961
2023-06-21 14:50,118,68,50,5063,4171,892,14837431.0,14331012.0,506419.0,70,39,31,3273,2350,923,13814484.0,13260856.0,553628.0,3.4359,0.5677,5.6429,0.5998
2023-06-21 14:55,231,127,104,14458,8813,5645,8612244.0,5299067.0,3313177.0,195,103,92,13958,7777,6181,8308465.0,4612910.0,3695555.0,0.6013,0.5869,0.5931,0.5979
2023-06-21 15:00,360,120,240,12145,5513,6632,7216836.0,3270410.0,3946425.0,309,93,216,10432,4509,5923,6201901.0,2674755.0,3527146.0,0.5932,0.5951,0.5932,0.5955
2023-06-21 15:05,187,90,97,7768,3461,4307,6220208.0,2051411.0,4168797.0,149,71,78,7103,3481,3622,4221800.0,2063039.0,2158761.0,0.5927,0.9679,0.5927,0.596
2023-06-21 15:10,186,77,109,10931,2885,8046,6446882.0,1711766.0,4735116.0,134,50,84,8559,2286,6273,5083924.0,1350978.0,3732946.0,0.5933,0.5885,0.591,0.5951
2023-06-21 15:15,126,62,64,5473,2415,3058,3243931.0,1428611.0,1815320.0,91,39,52,4775,1461,3314,2835883.0,864140.0,1971742.0,0.5916,0.5936,0.5915,0.595
2023-06-21 15:20,358,57,301,9723,2568,7155,5772535.0,1520221.0,4252314.0,328,41,287,8977,2091,6886,5336609.0,1236983.0,4099626.0,0.592,0.5943,0.5916,0.5954
2023-06-21 15:25,132,46,86,5240,1511,3729,3103312.0,897049.0,2206263.0,107,33,74,5722,1761,3961,3403526.0,1041727.0,2361798.0,0.5937,0.5917,0.5916,0.5963
2023-06-21 15:30,168,66,102,7061,2583,4478,16003428.0,13407972.0,2595455.0,147,55,92,5746,2062,3684,15292488.0,13095987.0,2196501.0,5.1909,0.5796,6.3511,0.5962
2023-06-21 15:35,180,54,126,9867,1171,8696,5862069.0,693560.0,5168509.0,155,36,119,9380,860,8520,5577085.0,507910.0,5069175.0,0.5923,0.5944,0.5906,0.595
2023-06-21 15:40,240,81,159,10055,1946,8109,5825068.0,1143679.0,4681389.0,193,58,135,8102,1499,6603,4811128.0,882480.0,3928648.0,0.5877,0.5773,0.5887,0.595
2023-06-21 15:45,202,60,142,10073,2055,8018,5983016.0,1219295.0,4763720.0,177,45,132,10565,3171,7394,6262175.0,1870629.0,4391546.0,0.5933,0.5941,0.5899,0.5939
2023-06-21 15:50,112,33,79,6145,3447,2698,3700177.0,2090839.0,1609338.0,82,19,63,3131,1093,2038,1857463.0,644696.0,1212766.0,0.6066,0.5965,0.5898,0.5951
2023-06-21 15:55,67,25,42,2490,599,1891,1474557.0,354102.0,1120455.0,44,12,32,1721,322,1399,1020488.0,188214.0,832273.0,0.5912,0.5925,0.5845,0.5949
2023-06-21 16:00,95,43,52,3051,959,2092,1838685.0,588602.0,1250082.0,65,22,43,3204,1069,2135,1908788.0,630000.0,1278788.0,0.6138,0.5976,0.5893,0.599
2023-06-21 16:05,29,12,17,1109,563,546,659014.0,333922.0,325091.0,18,5,13,587,111,476,349404.0,65696.0,283708.0,0.5931,0.5954,0.5919,0.596
2023-06-21 16:10,517,119,398,19345,2834,16511,11420429.0,1674953.0,9745476.0,488,93,395,19089,2919,16170,11376707.0,1724481.0,9652225.0,0.591,0.5902,0.5908,0.5969
2023-06-21 16:15,502,130,372,27510,10486,17024,28210296.0,18086779.0,10123517.0,482,132,350,25149,9578,15571,26796138.0,17538815.0,9257322.0,1.7249,0.5947,1.8312,0.5945
2023-06-21 16:20,535,422,113,18288,12722,5566,22780107.0,19468680.0,3311426.0,461,370,91,14421,8948,5473,20385732.0,17128425.0,3257307.0,1.5303,0.5949,1.9142,0.5952
2023-06-21 16:25,339,199,140,20074,14115,5959,11898918.0,8400995.0,3497923.0,288,182,106,18103,13413,4690,10764417.0,7960565.0,2803852.0,0.5952,0.587,0.5935,0.5978
2023-06-21 16:30,128,85,43,5293,4139,1154,3150273.0,2469927.0,680346.0,92,69,23,4548,3722,826,2704203.0,2206860.0,497342.0,0.5967,0.5896,0.5929,0.6021
2023-06-21 16:35,71,46,25,2978,2095,883,1755680.0,1240581.0,515099.0,42,31,11,1736,1501,235,1030033.0,886933.0,143099.0,0.5922,0.5834,0.5909,0.6089
2023-06-21 16:40,79,44,35,8053,3000,5053,4794677.0,1780464.0,3014213.0,58,34,24,3463,2553,910,2065454.0,1514038.0,551415.0,0.5935,0.5965,0.593,0.606
2023-06-21 16:45,2046,202,1844,226239,17839,208400,252681526.0,129297202.0,123384324.0,1986,165,1821,224481,17130,207351,252112966.0,128879590.0,123233376.0,7.248,0.5921,7.5236,0.5943
2023-06-21 16:50,1555,669,886,134956,43566,91390,103962063.0,49583862.0,54378201.0,1503,650,853,132767,42521,90246,102614218.0,48922129.0,53692088.0,1.1381,0.595,1.1505,0.595
2023-06-21 16:55,1642,648,994,124229,33270,90959,73737200.0,19669543.0,54067656.0,1631,639,992,123288,32588,90700,73200845.0,19267241.0,53933604.0,0.5912,0.5944,0.5912,0.5946
2023-06-21 17:00,1891,531,1360,160462,29550,130912,96319953.0,17474540.0,78845412.0,1865,519,1346,160019,29477,130542,94993677.0,17420701.0,77572975.0,0.5914,0.6023,0.591,0.5942
2023-06-21 17:05,313,75,238,23930,3663,20267,14216115.0,2163661.0,12052454.0,293,66,227,23006,3463,19543,13653588.0,2042939.0,11610648.0,0.5907,0.5947,0.5899,0.5941
2023-06-21 17:10,887,123,764,86066,5927,80139,62920685.0,15369933.0,47550752.0,869,112,757,86315,6486,79829,63096292.0,15699835.0,47396457.0,2.5932,0.5934,2.4206,0.5937
2023-06-21 17:15,2526,220,2306,300448,8997,291451,225182048.0,52806926.0,172375122.0,2350,119,2231,288035,5877,282158,217933091.0,50940563.0,166992528.0,5.8694,0.5914,8.6678,0.5918
2023-06-21 17:20,1743,156,1587,132753,7602,125151,78316809.0,4460334.0,73856475.0,1758,181,1577,133407,8929,124478,78685947.0,5219218.0,73466729.0,0.5867,0.5901,0.5845,0.5902
2023-06-21 17:25,1076,447,629,56186,21857,34329,33098437.0,12832407.0,20266029.0,972,361,611,52825,18952,33873,31131234.0,11135491.0,19995743.0,0.5871,0.5903,0.5876,0.5903
2023-06-21 17:30,1118,301,817,109654,20449,89205,64549019.0,12014986.0,52534033.0,1091,284,807,108341,20117,88224,63837638.0,11819151.0,52018486.0,0.5876,0.5889,0.5875,0.5896
2023-06-21 17:35,1155,82,1073,93250,1040,92210,55001328.0,612401.0,54388926.0,1134,69,1065,93159,1123,92036,54943240.0,656594.0,54286646.0,0.5888,0.5898,0.5847,0.5898
2023-06-21 17:40,1116,177,939,93890,4308,89582,55372282.0,2533808.0,52838474.0,1104,167,937,93746,4168,89578,55285465.0,2448522.0,52836942.0,0.5882,0.5898,0.5875,0.5898
2023-06-21 17:45,628,140,488,48731,4381,44350,28737417.0,2574567.0,26162850.0,617,133,484,46736,4359,42377,27561333.0,2561414.0,24999919.0,0.5877,0.5899,0.5876,0.5899
2023-06-21 17:50,233,128,105,7586,4847,2739,4427732.0,2833407.0,1594325.0,201,115,86,6799,4415,2384,3987533.0,2580207.0,1407325.0,0.5846,0.5821,0.5844,0.5903
2023-06-21 17:55,206,63,143,9293,2278,7015,5435875.0,1350521.0,4085354.0,173,45,128,7083,1855,5228,4169031.0,1088973.0,3080057.0,0.5929,0.5824,0.587,0.5891
2023-06-21 18:00,462,65,397,23781,2468,21313,13982066.0,1449243.0,12532823.0,443,52,391,25349,3165,22184,14914371.0,1829261.0,13085110.0,0.5872,0.588,0.578,0.5898
2023-06-21 18:05,2401,271,2130,271296,16585,254711,195460673.0,45386420.0,150074252.0,2285,200,2085,269160,14057,255103,194196987.0,43854009.0,150342978.0,2.7366,0.5892,3.1197,0.5893
2023-06-21 18:10,2436,568,1868,231519,40691,190828,195262322.0,83165757.0,112096565.0,2234,453,1781,222624,36564,186060,190225254.0,80762895.0,109462359.0,2.0438,0.5874,2.2088,0.5883
2023-06-21 18:15,637,321,316,54879,14315,40564,44123091.0,20275586.0,23847505.0,592,286,306,51510,12122,39388,42111821.0,18945026.0,23166795.0,1.4164,0.5879,1.5629,0.5882
2023-06-21 18:20,2001,323,1678,191097,16132,174965,147706189.0,45056529.0,102649660.0,1951,296,1655,190594,16028,174566,147501092.0,44985079.0,102516013.0,2.793,0.5867,2.8067,0.5873
2023-06-21 18:25,1741,295,1446,166037,9245,156792,109292403.0,17279759.0,92012643.0,1686,243,1443,165771,8685,157086,109130408.0,16945118.0,92185290.0,1.8691,0.5868,1.9511,0.5868
2023-06-21 18:30,1712,872,840,203821,120252,83569,143525996.0,94328299.0,49197697.0,1664,858,806,199982,117114,82868,141155717.0,92368502.0,48787215.0,0.7844,0.5887,0.7887,0.5887
2023-06-21 18:35,1893,1271,622,192225,177744,14481,160396332.0,151837489.0,8558842.0,1857,1286,571,194167,178747,15420,161448602.0,152327287.0,9121314.0,0.8542,0.591,0.8522,0.5915
2023-06-22 10:00,3492,3093,399,414239,391418,22821,250509017.0,233284598.0,17224418.0,3070,2894,176,383341,373223,10118,227033921.0,220993771.0,6040149.0,0.596,0.7548,0.5921,0.597
2023-06-22 10:05,3110,2245,865,302400,271623,30777,247330590.0,228988829.0,18341761.0,2820,2141,679,272417,247214,25203,219146036.0,204153030.0,14993005.0,0.843,0.596,0.8258,0.5949
2023-06-22 10:10,1282,808,474,78422,52857,25565,46967610.0,31735232.0,15232378.0,800,656,144,72130,60974,11156,43224938.0,36484585.0,6740353.0,0.6004,0.5958,0.5984,0.6042
2023-06-22 10:15,1419,741,678,126795,63522,63273,87674245.0,49707151.0,37967094.0,1186,674,512,112497,53834,58663,79274728.0,43958012.0,35316716.0,0.7825,0.6001,0.8165,0.602
2023-06-22 10:20,1047,417,630,84258,24585,59673,78845985.0,38465560.0,40380424.0,896,358,538,82345,26927,55418,73034012.0,39775110.0,33258902.0,1.5646,0.6767,1.4771,0.6001
2023-06-22 10:25,3325,936,2389,344762,83698,261064,406709137.0,251371642.0,155337495.0,3068,782,2286,327276,76544,250732,396564294.0,247143990.0,149420303.0,3.0033,0.595,3.2288,0.5959
2023-06-22 10:30,1634,172,1462,185315,6325,178990,111913262.0,3738230.0,108175031.0,1532,116,1416,181903,5090,176813,108307246.0,3013471.0,105293774.0,0.591,0.6044,0.592,0.5955
2023-06-22 10:35,558,41,517,21436,2032,19404,12725994.0,1182497.0,11543496.0,505,20,485,19351,651,18700,11501685.0,382844.0,11118841.0,0.5819,0.5949,0.5881,0.5946
2023-06-22 10:40,388,49,339,33541,2265,31276,19861493.0,1288255.0,18573237.0,346,21,325,29946,1231,28715,17830778.0,727721.0,17103056.0,0.5688,0.5938,0.5912,0.5956
2023-06-22 10:45,392,46,346,27767,865,26902,16511995.0,509575.0,16002420.0,348,24,324,26217,659,25558,15594956.0,385868.0,15209087.0,0.5891,0.5948,0.5855,0.5951
2023-06-22 10:50,1021,100,921,105136,5321,99815,74309714.0,15028865.0,59280848.0,965,58,907,102291,3838,98453,72629558.0,14141077.0,58488480.0,2.8244,0.5939,3.6845,0.5941
2023-06-22 10:55,1083,81,1002,98269,2366,95903,58409714.0,1407283.0,57002430.0,1040,59,981,96771,940,95831,57494038.0,555232.0,56938805.0,0.5948,0.5944,0.5907,0.5942
2023-06-22 11:00,550,182,368,41616,8028,33588,36656511.0,16639525.0,20016985.0,487,150,337,37739,7254,30485,34280079.0,16150632.0,18129447.0,2.0727,0.596,2.2264,0.5947
2023-06-22 11:05,458,141,317,23181,8014,15167,25666518.0,16628197.0,9038321.0,436,130,306,22253,6888,15365,25107316.0,15956243.0,9151072.0,2.0749,0.5959,2.3165,0.5956
2023-06-22 11:10,262,134,128,16948,7069,9879,22050039.0,16145122.0,5904916.0,222,122,100,15772,6444,9328,21273414.0,15699318.0,5574095.0,2.2839,0.5977,2.4363,0.5976
2023-06-22 11:15,125,77,48,6020,3634,2386,3569293.0,2159040.0,1410253.0,93,64,29,4900,3214,1686,2918966.0,1905661.0,1013305.0,0.5941,0.5911,0.5929,0.601
2023-06-22 11:20,433,335,98,23288,15203,8085,13927576.0,9104928.0,4822647.0,387,315,72,21544,13845,7699,12827479.0,8217477.0,4610001.0,0.5989,0.5965,0.5935,0.5988
2023-06-22 11:25,228,181,47,10877,7972,2905,6476289.0,4740104.0,1736185.0,210,168,42,9974,7457,2517,5941374.0,4429264.0,1512109.0,0.5946,0.5977,0.594,0.6008
2023-06-22 11:30,348,250,98,16852,8994,7858,10063384.0,5352710.0,4710674.0,310,238,72,16443,8687,7756,9810408.0,5162779.0,4647629.0,0.5951,0.5995,0.5943,0.5992
2023-06-22 11:35,155,97,58,6470,3808,2662,3871346.0,2274208.0,1597137.0,131,94,37,5902,3691,2211,3518845.0,2195610.0,1323234.0,0.5972,0.6,0.5949,0.5985
2023-06-22 11:40,390,290,100,22132,10867,11265,25084515.0,18346729.0,6737786.0,358,270,88,21031,10246,10785,24425220.0,17968108.0,6457112.0,1.6883,0.5981,1.7537,0.5987
2023-06-22 11:45,572,499,73,16858,14719,2139,10106028.0,8810418.0,1295609.0,510,463,47,13973,12386,1587,8318254.0,7364966.0,953288.0,0.5986,0.6057,0.5946,0.6007
2023-06-22 11:50,868,419,449,61925,13544,48381,48853058.0,19935447.0,28917611.0,806,387,419,59329,12571,46758,47308197.0,19351693.0,27956503.0,1.4719,0.5977,1.5394,0.5979
2023-06-22 11:55,749,426,323,45325,15410,29915,50804361.0,32924573.0,17879788.0,697,389,308,44611,14985,29626,50373559.0,32661402.0,17712156.0,2.1366,0.5977,2.1796,0.5979
2023-06-22 12:00,464,431,33,15428,13177,2251,21082519.0,19727236.0,1355282.0,425,402,23,14496,12657,1839,20517161.0,19412671.0,1104489.0,1.4971,0.6021,1.5337,0.6006
2023-06-22 12:05,341,289,52,7651,6613,1038,4571800.0,3950518.0,621282.0,313,277,36,7015,6373,642,4181384.0,3795497.0,385886.0,0.5974,0.5985,0.5956,0.6011
2023-06-22 12:10,212,158,54,8216,6088,2128,4913487.0,3651689.0,1261797.0,193,152,41,6699,5708,991,3997372.0,3398646.0,598725.0,0.5998,0.5929,0.5954,0.6042
2023-06-22 12:15,412,157,255,20404,4865,15539,12177029.0,2901821.0,9275208.0,385,141,244,19693,4364,15329,11756208.0,2597146.0,9159061.0,0.5965,0.5969,0.5951,0.5975
2023-06-22 12:20,533,450,83,17451,12864,4587,10386318.0,7668414.0,2717904.0,501,431,70,16241,12263,3978,9683629.0,7297552.0,2386076.0,0.5961,0.5925,0.5951,0.5998
2023-06-22 12:25,259,212,47,9117,8032,1085,5445316.0,4793709.0,651606.0,236,201,35,7436,6896,540,4433072.0,4109136.0,323936.0,0.5968,0.6006,0.5959,0.5999
2023-06-22 12:30,251,209,42,10683,8754,1929,6373967.0,5196027.0,1177939.0,219,192,27,9005,8236,769,5370656.0,4905903.0,464753.0,0.5936,0.6106,0.5957,0.6044
2023-06-22 12:35,201,174,27,8912,6912,2000,5320471.0,4122821.0,1197650.0,190,169,21,7625,7205,420,4545574.0,4291691.0,253883.0,0.5965,0.5988,0.5957,0.6045
2023-06-22 12:40,475,147,328,20998,7771,13227,36190427.0,28354929.0,7835497.0,406,107,299,16262,6855,9407,33439721.0,27821432.0,5618289.0,3.6488,0.5924,4.0586,0.5972
2023-06-22 12:45,2150,90,2060,220374,4152,216222,154904715.0,26218637.0,128686078.0,2113,60,2053,219570,3250,216320,154503709.0,25676924.0,128826784.0,6.3147,0.5952,7.9006,0.5955
2023-06-22 12:50,2321,679,1642,229945,60018,169927,172419564.0,71199822.0,101219742.0,2287,659,1628,229200,60216,168984,171998239.0,71319648.0,100678590.0,1.1863,0.5957,1.1844,0.5958
2023-06-22 12:55,3281,251,3030,394475,7643,386832,234860686.0,4520117.0,230340569.0,3254,227,3027,393792,6730,387062,234465750.0,3981570.0,230484180.0,0.5914,0.5955,0.5916,0.5955
2023-06-22 13:00,2027,141,1886,233004,1537,231467,138775405.0,910194.0,137865211.0,1998,132,1866,233091,1797,231294,138819819.0,1059089.0,137760730.0,0.5922,0.5956,0.5894,0.5956
2023-06-22 13:05,2344,91,2253,284201,2134,282067,169301738.0,1275554.0,168026184.0,2310,74,2236,283160,1876,281284,168671631.0,1107017.0,167564614.0,0.5977,0.5957,0.5901,0.5957
2023-06-22 13:10,1291,111,1180,165090,2055,163035,98352198.0,1220694.0,97131504.0,1266,97,1169,165112,1938,163174,98372111.0,1149431.0,97222680.0,0.594,0.5958,0.5931,0.5958
2023-06-22 13:15,1087,57,1030,126241,1706,124535,75817775.0,1011649.0,74806126.0,1063,49,1014,125689,1366,124323,75486828.0,809467.0,74677361.0,0.593,0.6007,0.5926,0.6007
2023-06-22 13:20,253,36,217,29119,560,28559,17358782.0,342044.0,17016737.0,200,15,185,28412,236,28176,16931148.0,135320.0,16795828.0,0.6108,0.5958,0.5734,0.5961
2023-06-22 13:25,83,11,72,11988,205,11783,7147004.0,120319.0,7026685.0,77,7,70,11582,169,11413,6905531.0,98342.0,6807189.0,0.5869,0.5963,0.5819,0.5964
2023-06-22 13:30,1229,68,1161,201228,2772,198456,119971458.0,1646104.0,118325354.0,1206,55,1151,200572,2405,198167,119598917.0,1425719.0,118173198.0,0.5938,0.5962,0.5928,0.5963
2023-06-22 13:35,1171,92,1079,177355,4620,172735,105723464.0,2742819.0,102980645.0,1159,86,1073,177456,4690,172766,105793797.0,2782017.0,103011780.0,0.5937,0.5962,0.5932,0.5963
2023-06-22 13:40,506,51,455,70842,6017,64825,41902246.0,3331026.0,38571220.0,482,33,449,65051,980,64071,38760554.0,577068.0,38183485.0,0.5536,0.595,0.5888,0.596
2023-06-22 13:45,1072,47,1025,64017,1351,62666,49846126.0,12669398.0,37176727.0,1057,35,1022,63647,1070,62577,49677140.0,12502223.0,37174917.0,9.3778,0.5933,11.6843,0.5941
2023-06-22 13:50,761,140,621,55823,3839,51984,33156171.0,2269068.0,30887103.0,731,123,608,54772,3022,51750,32528409.0,1782297.0,30746112.0,0.5911,0.5942,0.5898,0.5941
2023-06-22 13:55,693,138,555,54192,3668,50524,32196476.0,2170562.0,30025914.0,678,128,550,53133,3403,49730,31566210.0,2013898.0,29552311.0,0.5918,0.5943,0.5918,0.5943
2023-06-22 14:00,1018,122,896,96013,8163,87850,68910009.0,16693500.0,52216509.0,986,90,896,90375,1741,88634,65574786.0,12891254.0,52683532.0,2.045,0.5944,7.4045,0.5944
2023-06-22 14:05,75,26,49,2709,547,2162,1612685.0,325714.0,1286971.0,54,13,41,2618,223,2395,1558767.0,132117.0,1426649.0,0.5955,0.5953,0.5925,0.5957
2023-06-22 14:10,44,5,39,3622,139,3483,2169626.0,82015.0,2087610.0,40,3,37,3040,176,2864,1808814.0,103307.0,1705506.0,0.59,0.5994,0.587,0.5955
2023-06-22 14:15,1001,17,984,129123,922,128201,76935517.0,546775.0,76388741.0,982,11,971,128273,658,127615,76439615.0,390102.0,76049513.0,0.593,0.5959,0.5929,0.5959
2023-06-22 14:20,1170,40,1130,182431,785,181646,108755106.0,465267.0,108289838.0,1160,36,1124,182352,894,181458,108704411.0,526923.0,108177487.0,0.5927,0.5962,0.5894,0.5962
2023-06-22 14:25,547,38,509,20261,833,19428,12020113.0,495274.0,11524839.0,514,19,495,18347,659,17688,10922310.0,388272.0,10534038.0,0.5946,0.5932,0.5892,0.5955
2023-06-22 14:30,272,20,252,23083,622,22461,25558738.0,12245374.0,13313363.0,257,8,249,23380,362,23018,25782036.0,12089820.0,13692216.0,19.6871,0.5927,33.3973,0.5948
2023-06-22 14:35,53,17,36,3050,543,2507,1814206.0,322126.0,1492079.0,44,11,33,7871,5360,2511,4669567.0,3172060.0,1497506.0,0.5932,0.5952,0.5918,0.5964
2023-06-22 14:40,73,25,48,4995,787,4208,2964252.0,464939.0,2499312.0,66,22,44,4541,759,3782,2700902.0,448371.0,2252531.0,0.5908,0.5939,0.5907,0.5956
2023-06-22 14:45,131,12,119,19212,296,18916,11417684.0,174416.0,11243268.0,124,9,115,19032,279,18753,11320742.0,165112.0,11155630.0,0.5892,0.5944,0.5918,0.5949
2023-06-22 14:50,80,24,56,5824,758,5066,3450860.0,443225.0,3007635.0,74,22,52,5632,454,5178,3344543.0,268504.0,3076039.0,0.5847,0.5937,0.5914,0.5941
2023-06-22 14:55,248,24,224,34112,521,33591,20271203.0,305523.0,19965680.0,244,21,223,33851,404,33447,20120893.0,239142.0,19881751.0,0.5864,0.5944,0.5919,0.5944
2023-06-22 15:00,789,9,780,100698,101,100597,59854419.0,60618.0,59793800.0,779,7,772,100554,89,100465,59763850.0,52431.0,59711418.0,0.6002,0.5944,0.5891,0.5944
2023-06-22 15:05,392,61,331,44155,2428,41727,26244578.0,1438503.0,24806075.0,372,48,324,43189,1536,41653,25669634.0,908359.0,24761275.0,0.5925,0.5945,0.5914,0.5945
2023-06-22 15:10,458,89,369,42305,3391,38914,37030069.0,13887034.0,23143035.0,437,83,354,41489,2773,38716,36539983.0,13519267.0,23020715.0,4.0953,0.5947,4.8753,0.5946
2023-06-22 15:15,1266,293,973,88044,14760,73284,64218283.0,20634173.0,43584110.0,1255,284,971,88768,15205,73563,64635784.0,20881454.0,43754329.0,1.398,0.5947,1.3733,0.5948
2023-06-22 15:20,854,533,321,66774,50013,16761,63361992.0,53391820.0,9970171.0,840,530,310,65123,49243,15880,62383161.0,52933957.0,9449204.0,1.0676,0.5948,1.075,0.595
2023-06-22 15:25,275,43,232,7110,2931,4179,4215360.0,1736939.0,2478420.0,264,36,228,7852,3101,4751,4661663.0,1837413.0,2824250.0,0.5926,0.5931,0.5925,0.5945
2023-06-22 15:30,904,682,222,78472,55759,22713,46591690.0,33076221.0,13515469.0,886,672,214,77837,55273,22564,46183403.0,32757177.0,13426225.0,0.5932,0.5951,0.5926,0.595
2023-06-22 15:35,650,404,246,46865,29493,17372,27831164.0,17485335.0,10345829.0,636,400,236,45605,29230,16375,27079227.0,17328529.0,9750697.0,0.5929,0.5955,0.5928,0.5955
2023-06-22 15:40,49,26,23,2435,1581,854,1445439.0,936414.0,509024.0,42,19,23,2325,1469,856,1380251.0,870422.0,509829.0,0.5923,0.596,0.5925,0.5956
2023-06-22 15:45,160,114,46,14437,13253,1184,8560840.0,7854857.0,705982.0,157,111,46,14119,12611,1508,8372480.0,7473708.0,898771.0,0.5927,0.5963,0.5926,0.596
2023-06-22 15:50,22,11,11,424,101,323,252113.0,61306.0,190807.0,12,7,5,268,77,191,159121.0,45319.0,113801.0,0.607,0.5907,0.5886,0.5958
2023-06-22 15:55,554,145,409,38600,13685,24915,22855479.0,8102176.0,14753302.0,525,128,397,38301,13851,24450,22745795.0,8200804.0,14544990.0,0.592,0.5921,0.5921,0.5949
2023-06-22 16:00,173,58,115,9818,3911,5907,5830925.0,2318055.0,3512870.0,167,53,114,9551,3628,5923,5675058.0,2150496.0,3524562.0,0.5927,0.5947,0.5927,0.5951
2023-06-22 16:05,206,83,123,14801,7488,7313,8799430.0,4438001.0,4361429.0,195,78,117,14160,7419,6741,8413543.0,4396320.0,4017222.0,0.5927,0.5964,0.5926,0.5959
2023-06-22 16:10,85,39,46,8237,4224,4013,4904724.0,2511413.0,2393311.0,79,35,44,8309,4187,4122,4940568.0,2482544.0,2458024.0,0.5946,0.5964,0.5929,0.5963
2023-06-22 16:15,281,137,144,22152,14166,7986,13146283.0,8394388.0,4751894.0,278,138,140,22604,14489,8115,13414499.0,8585205.0,4829293.0,0.5926,0.595,0.5925,0.5951
2023-06-22 16:20,268,112,156,18411,9581,8830,22807023.0,17553195.0,5253828.0,255,102,153,17830,9226,8604,22457599.0,17338473.0,5119125.0,1.8321,0.595,1.8793,0.595
2023-06-22 16:25,462,323,139,21811,9893,11918,12951408.0,5881156.0,7070252.0,417,299,118,19257,8208,11049,11458690.0,4868962.0,6589728.0,0.5945,0.5932,0.5932,0.5964
2023-06-22 16:30,150,66,84,11004,5253,5751,18423682.0,14993076.0,3430606.0,124,54,70,9221,3678,5543,17361953.0,14055372.0,3306580.0,2.8542,0.5965,3.8215,0.5965
2023-06-22 16:35,69,25,44,2842,739,2103,1676650.0,439819.0,1236830.0,49,17,32,2077,550,1527,1237536.0,325847.0,911688.0,0.5952,0.5881,0.5924,0.597
2023-06-22 16:40,323,216,107,15439,2876,12563,9195507.0,1709603.0,7485903.0,313,211,102,15166,2968,12198,9041073.0,1764338.0,7276735.0,0.5944,0.5959,0.5945,0.5966
2023-06-22 16:45,46,17,29,3002,309,2693,1792293.0,183746.0,1608547.0,41,15,26,3125,225,2900,1864749.0,133704.0,1731045.0,0.5946,0.5973,0.5942,0.5969
2023-06-22 16:50,96,43,53,3513,1075,2438,2121740.0,667576.0,1454163.0,78,38,40,3123,808,2315,1858983.0,478092.0,1380891.0,0.621,0.5965,0.5917,0.5965
2023-06-22 16:55,161,99,62,3959,1844,2115,2326241.0,1063795.0,1262445.0,101,61,40,2801,984,1817,1647496.0,561188.0,1086307.0,0.5769,0.5969,0.5703,0.5979
2023-06-22 17:00,97,33,64,2434,648,1786,1450370.0,384735.0,1065635.0,76,22,54,2230,599,1631,1333549.0,355110.0,978439.0,0.5937,0.5967,0.5928,0.5999
2023-06-22 17:05,89,27,62,2397,584,1813,1392269.0,349188.0,1043080.0,60,15,45,1467,420,1047,876176.0,248609.0,627567.0,0.5979,0.5753,0.5919,0.5994
2023-06-22 17:10,71,18,53,2555,441,2114,1521464.0,260821.0,1260643.0,56,10,46,2274,297,1977,1355653.0,175488.0,1180165.0,0.5914,0.5963,0.5909,0.5969
2023-06-22 17:15,81,4,77,1942,132,1810,1156391.0,78059.0,1078331.0,72,1,71,1736,24,1712,1036663.0,14280.0,1022383.0,0.5914,0.5958,0.595,0.5972
2023-06-22 17:20,242,17,225,6248,494,5754,3726888.0,298350.0,3428537.0,229,8,221,4757,227,4530,2835841.0,134405.0,2701436.0,0.6039,0.5959,0.5921,0.5963
2023-06-22 17:25,255,29,226,7886,2873,5013,4693251.0,1706559.0,2986692.0,252,28,224,7495,2612,4883,4460316.0,1551493.0,2908823.0,0.594,0.5958,0.594,0.5957
2023-06-22 17:30,491,42,449,15884,4672,11212,9454192.0,2776196.0,6677996.0,492,43,449,15766,4693,11073,9383504.0,2788596.0,6594907.0,0.5942,0.5956,0.5942,0.5956
2023-06-22 17:35,473,10,463,12950,202,12748,7715305.0,123603.0,7591702.0,477,11,466,13399,196,13203,7981279.0,115723.0,7865556.0,0.6119,0.5955,0.5904,0.5957
2023-06-22 17:40,166,70,96,11837,3102,8735,18888785.0,13716866.0,5171918.0,163,68,95,12017,3373,8644,19032507.0,13876362.0,5156144.0,4.4219,0.5921,4.114,0.5965
2023-06-22 17:45,274,85,189,24736,2833,21903,14742312.0,1681947.0,13060365.0,273,84,189,24687,2826,21861,14711995.0,1676666.0,13035328.0,0.5937,0.5963,0.5933,0.5963
2023-06-22 17:50,138,28,110,12108,593,11515,7216694.0,351678.0,6865016.0,131,23,108,11922,441,11481,7106071.0,260886.0,6845184.0,0.593,0.5962,0.5916,0.5962
2023-06-22 17:55,332,17,315,46738,741,45997,27875698.0,446478.0,27429219.0,327,14,313,46536,587,45949,27751384.0,348546.0,27402837.0,0.6025,0.5963,0.5938,0.5964
2023-06-22 18:00,143,29,114,18167,2274,15893,10828580.0,1349474.0,9479106.0,174,47,127,19507,3278,16229,11603467.0,1921100.0,9682366.0,0.5934,0.5964,0.5861,0.5966
2023-06-22 18:05,67,36,31,2125,1087,1038,1259857.0,653117.0,606740.0,45,32,13,1683,1238,445,990060.0,725148.0,264912.0,0.6008,0.5845,0.5857,0.5953
2023-06-22 18:10,81,16,65,2716,583,2133,1617849.0,354332.0,1263516.0,68,8,60,2060,392,1668,1226453.0,231693.0,994760.0,0.6078,0.5924,0.5911,0.5964
2023-06-22 18:15,76,27,49,5496,2205,3291,3274872.0,1317735.0,1957137.0,57,16,41,3485,676,2809,2078436.0,401119.0,1677316.0,0.5976,0.5947,0.5934,0.5971
2023-06-22 18:20,120,36,84,6530,3124,3406,3889046.0,1867189.0,2021857.0,114,39,75,5777,2878,2899,3433137.0,1702429.0,1730708.0,0.5977,0.5936,0.5915,0.597
2023-06-22 18:25,45,14,31,2657,957,1700,1585483.0,572390.0,1013093.0,81,26,55,1906,494,1412,1134312.0,291475.0,842836.0,0.5981,0.5959,0.59,0.5969
2023-06-22 18:30,77,27,50,2185,735,1450,1317762.0,453859.0,863903.0,88,19,69,2496,376,2120,1488548.0,222203.0,1266345.0,0.6175,0.5958,0.591,0.5973
2023-06-22 18:35,262,100,162,24333,10625,13708,14393410.0,6296838.0,8096572.0,251,100,151,23841,10559,13282,14171844.0,6257158.0,7914686.0,0.5926,0.5906,0.5926,0.5959
2023-06-23 10:00,3255,1985,1270,367413,203716,163697,313232978.0,216721587.0,96511391.0,2802,1719,1083,341966,187837,154129,292889443.0,201902458.0,90986985.0,1.0638,0.5896,1.0749,0.5903
2023-06-23 10:05,2312,1616,696,210047,143356,66691,253641343.0,214460638.0,39180705.0,2142,1502,640,205687,141252,64435,245585665.0,207665244.0,37920421.0,1.496,0.5875,1.4702,0.5885
2023-06-23 10:10,1624,928,696,126411,62157,64254,74149637.0,36360430.0,37789207.0,1430,797,633,123479,60054,63425,72421599.0,35116328.0,37305271.0,0.585,0.5881,0.5847,0.5882
2023-06-23 10:15,1273,823,450,92907,66117,26790,54459326.0,38637079.0,15822246.0,1144,750,394,90919,65134,25785,53294504.0,38049891.0,15244613.0,0.5844,0.5906,0.5842,0.5912
2023-06-23 10:20,929,760,169,90840,58979,31861,104414119.0,82102240.0,22311879.0,807,672,135,86991,56567,30424,99264905.0,80588051.0,18676854.0,1.3921,0.7003,1.4246,0.6139
2023-06-23 10:25,428,351,77,40242,36452,3790,35421631.0,33167908.0,2253723.0,371,315,56,38174,35439,2735,34242523.0,32625909.0,1616614.0,0.9099,0.5946,0.9206,0.5911
2023-06-23 10:30,610,545,65,52817,49747,3070,30958532.0,29141246.0,1817286.0,575,520,55,52001,49326,2675,30467699.0,28891838.0,1575860.0,0.5858,0.592,0.5857,0.5891
2023-06-23 10:35,2059,437,1622,249813,28557,221256,183300802.0,52293269.0,131007532.0,1950,375,1575,245357,27746,217611,180905607.0,51804131.0,129101476.0,1.8312,0.5921,1.8671,0.5933
2023-06-23 10:40,3578,569,3009,391327,24463,366864,264913029.0,49860744.0,215052285.0,3455,484,2971,386591,23523,363068,262239412.0,49309712.0,212929700.0,2.0382,0.5862,2.0962,0.5865
2023-06-23 10:45,1078,684,394,97436,69762,27674,80633172.0,64423632.0,16209539.0,990,618,372,94483,67534,26949,78873519.0,63067369.0,15806149.0,0.9235,0.5857,0.9339,0.5865
2023-06-23 10:50,2054,1598,456,212328,202172,10156,123752309.0,117806659.0,5945650.0,2011,1572,439,211246,201924,9322,123122552.0,117663527.0,5459025.0,0.5827,0.5854,0.5827,0.5856
2023-06-23 10:55,1028,211,817,62902,19125,43777,60512058.0,34860327.0,25651731.0,976,174,802,61959,18416,43543,59971974.0,34445005.0,25526969.0,1.8228,0.586,1.8704,0.5862
2023-06-23 11:00,2497,639,1858,173430,51919,121511,101584828.0,30251715.0,71333113.0,2458,605,1853,172865,51420,121445,101258108.0,29964020.0,71294088.0,0.5827,0.5871,0.5827,0.587
2023-06-23 11:05,3845,774,3071,298375,69183,229192,186680837.0,52187411.0,134493426.0,3812,755,3057,297791,68717,229074,186374829.0,51917827.0,134457002.0,0.7543,0.5868,0.7555,0.587
2023-06-23 11:10,3223,867,2356,228693,68319,160374,169682152.0,75538857.0,94143295.0,3187,845,2342,227152,67234,159918,168764599.0,74891335.0,93873264.0,1.1057,0.587,1.1139,0.587
2023-06-23 11:15,3645,2162,1483,387162,286506,100656,274389655.0,215194057.0,59195598.0,3588,2133,1455,381556,281547,100009,271003031.0,212185537.0,58817493.0,0.7511,0.5881,0.7536,0.5881
2023-06-23 11:20,3213,2311,902,400155,356067,44088,269982682.0,244005994.0,25976687.0,3168,2289,879,399248,355714,43534,269456118.0,243806674.0,25649444.0,0.6853,0.5892,0.6854,0.5892
2023-06-23 11:25,2704,1803,901,316622,294979,21643,185445527.0,172687380.0,12758147.0,2663,1781,882,316304,294828,21476,185256998.0,172598331.0,12658667.0,0.5854,0.5895,0.5854,0.5894
2023-06-23 11:30,2409,984,1425,217668,134645,83023,139633013.0,90743553.0,48889459.0,2377,967,1410,217214,134567,82647,139372029.0,90696732.0,48675297.0,0.6739,0.5889,0.674,0.589
2023-06-23 11:35,2911,1008,1903,230128,129504,100624,158884842.0,99625016.0,59259826.0,2890,990,1900,229978,129445,100533,158799382.0,99589405.0,59209977.0,0.7693,0.5889,0.7694,0.589
2023-06-23 11:40,3109,1345,1764,268939,175867,93072,193527505.0,138688691.0,54838814.0,3098,1341,1757,268565,175605,92960,193295439.0,138524196.0,54771242.0,0.7886,0.5892,0.7888,0.5892
2023-06-23 11:45,3208,1244,1964,261164,160325,100839,153275083.0,93880804.0,59394278.0,3198,1239,1959,261198,160359,100839,153301006.0,93901161.0,59399845.0,0.5856,0.589,0.5856,0.5891
2023-06-23 11:50,4023,1413,2610,367779,218088,149691,215864563.0,127731983.0,88132580.0,4006,1402,2604,367512,218023,149489,215712460.0,127694516.0,88017943.0,0.5857,0.5888,0.5857,0.5888
2023-06-23 11:55,3761,1356,2405,335048,211198,123850,208533049.0,135551392.0,72981657.0,3756,1349,2407,334507,210775,123732,208213134.0,135301181.0,72911953.0,0.6418,0.5893,0.6419,0.5893
2023-06-23 12:00,3621,1773,1848,365281,260348,104933,214387409.0,152478507.0,61908902.0,3608,1768,1840,364474,260126,104348,213904129.0,152364438.0,61539690.0,0.5857,0.59,0.5857,0.5898
2023-06-23 12:05,2823,1165,1658,259288,167134,92154,164082656.0,109766573.0,54316082.0,2821,1164,1657,259767,167488,92279,164364512.0,109974286.0,54390225.0,0.6568,0.5894,0.6566,0.5894
2023-06-23 12:10,2487,607,1880,233123,123485,109638,160668777.0,96132630.0,64536147.0,2466,588,1878,232126,122918,109208,160084269.0,95802033.0,64282235.0,0.7785,0.5886,0.7794,0.5886
2023-06-23 12:15,2882,1028,1854,239665,126598,113067,140876842.0,74235671.0,66641170.0,2859,1018,1841,238849,126056,112793,140372469.0,73885055.0,66487413.0,0.5864,0.5894,0.5861,0.5895
2023-06-23 12:20,2876,1311,1565,220177,138577,81600,129313800.0,81227113.0,48086687.0,2864,1303,1561,214063,138380,75683,125705398.0,81105350.0,44600047.0,0.5862,0.5893,0.5861,0.5893
2023-06-23 12:25,1275,741,534,80410,69993,10417,47164706.0,41026294.0,6138412.0,1264,736,528,80362,70264,10098,47130153.0,41182780.0,5947373.0,0.5861,0.5893,0.5861,0.589
2023-06-23 12:30,831,174,657,40361,22925,17436,23661882.0,13410668.0,10251213.0,824,170,654,40574,23212,17362,23793915.0,13578807.0,10215107.0,0.585,0.5879,0.585,0.5884
2023-06-23 12:35,29,9,20,585,114,471,344388.0,66811.0,277577.0,25,6,19,544,92,452,320222.0,53862.0,266359.0,0.5861,0.5893,0.5855,0.5893
2023-06-23 12:40,253,20,233,5332,568,4764,3134263.0,332350.0,2801913.0,245,17,228,5468,751,4717,3211050.0,432383.0,2778666.0,0.5851,0.5881,0.5757,0.5891
2023-06-23 12:45,476,139,337,35448,7049,28399,20848652.0,4130247.0,16718404.0,462,131,331,35033,6671,28362,20597131.0,3898884.0,16698246.0,0.5859,0.5887,0.5845,0.5888
2023-06-23 12:50,453,86,367,18551,4166,14385,10905751.0,2434637.0,8471113.0,430,72,358,18249,4056,14193,10733517.0,2373899.0,8359618.0,0.5844,0.5889,0.5853,0.589
2023-06-23 12:55,189,87,102,10249,5545,4704,6067869.0,3295953.0,2771915.0,173,79,94,9214,5019,4195,5410119.0,2939466.0,2470653.0,0.5944,0.5893,0.5857,0.589
2023-06-23 13:00,269,174,95,14168,12028,2140,8302306.0,7039629.0,1262677.0,232,152,80,13804,11530,2274,8092384.0,6749831.0,1342553.0,0.5853,0.59,0.5854,0.5904
2023-06-23 13:05,97,23,74,3261,1875,1386,1914342.0,1093789.0,820553.0,99,31,68,2343,1281,1062,1367165.0,741801.0,625364.0,0.5834,0.592,0.5791,0.5889
2023-06-23 13:10,67,18,49,918,310,608,540447.0,181594.0,358853.0,60,13,47,1157,558,599,679178.0,325695.0,353483.0,0.5858,0.5902,0.5837,0.5901
2023-06-23 13:15,470,31,439,9000,2776,6224,29056803.0,25390638.0,3666164.0,464,31,433,8181,2402,5779,28562513.0,25156147.0,3406365.0,9.1465,0.589,10.473,0.5894
2023-06-23 13:20,626,337,289,38447,33826,4621,22553928.0,19865042.0,2688885.0,591,319,272,37427,33156,4271,21955170.0,19437953.0,2517217.0,0.5873,0.5819,0.5863,0.5894
2023-06-23 13:25,1134,839,295,75357,71919,3438,44183316.0,42151825.0,2031491.0,1122,833,289,75230,72090,3140,44102831.0,42251621.0,1851209.0,0.5861,0.5909,0.5861,0.5896
2023-06-23 13:30,1375,1130,245,96324,92212,4112,56491165.0,54048571.0,2442594.0,1367,1128,239,94098,92019,2079,55160558.0,53934795.0,1225762.0,0.5861,0.594,0.5861,0.5896
2023-06-23 13:35,1283,832,451,100925,96762,4163,59191930.0,56741092.0,2450838.0,1265,819,446,100592,96383,4209,58985640.0,56505953.0,2479687.0,0.5864,0.5887,0.5863,0.5891
2023-06-23 13:40,928,432,496,56041,50754,5287,32854439.0,29756601.0,3097837.0,911,421,490,55921,50836,5085,32800681.0,29804596.0,2996085.0,0.5863,0.5859,0.5863,0.5892
2023-06-23 13:45,868,718,150,109079,107153,1926,63987772.0,62851413.0,1136358.0,848,713,135,108801,106918,1883,63806073.0,62695839.0,1110234.0,0.5866,0.59,0.5864,0.5896
2023-06-23 13:50,259,210,49,33040,32155,885,19373854.0,18851826.0,522028.0,255,206,49,33094,32158,936,19406160.0,18853392.0,552768.0,0.5863,0.5899,0.5863,0.5906
2023-06-23 13:55,436,149,287,31529,19205,12324,18458560.0,11253206.0,7205353.0,427,147,280,32444,18944,13500,19057287.0,11102874.0,7954413.0,0.586,0.5847,0.5861,0.5892
2023-06-23 14:00,961,82,879,52759,6200,46559,31001594.0,3631896.0,27369698.0,944,71,873,51815,5968,45847,30459159.0,3495810.0,26963349.0,0.5858,0.5878,0.5858,0.5881
2023-06-23 14:05,820,88,732,45789,3213,42576,26912954.0,1877735.0,25035218.0,814,86,728,45723,3108,42615,26876546.0,1819213.0,25057333.0,0.5844,0.588,0.5853,0.588
2023-06-23 14:10,735,135,600,39705,4272,35433,23326761.0,2497423.0,20829338.0,719,126,593,39349,4199,35150,23122357.0,2459042.0,20663315.0,0.5846,0.5879,0.5856,0.5879
2023-06-23 14:15,554,129,425,37576,5067,32509,22079736.0,2967398.0,19112337.0,551,127,424,37477,4995,32482,22021451.0,2925045.0,19096405.0,0.5856,0.5879,0.5856,0.5879
2023-06-23 14:20,1189,191,998,80643,6864,73779,47401055.0,4014659.0,43386395.0,1223,210,1013,80615,6812,73803,47384363.0,3983717.0,43400646.0,0.5849,0.5881,0.5848,0.5881
2023-06-23 14:25,230,26,204,15887,446,15441,9340525.0,256710.0,9083815.0,223,23,200,16041,527,15514,9430834.0,303761.0,9127072.0,0.5756,0.5883,0.5764,0.5883
2023-06-23 14:30,508,26,482,62639,1123,61516,36845863.0,655607.0,36190256.0,487,21,466,62432,1021,61411,36727586.0,595355.0,36132230.0,0.5838,0.5883,0.5831,0.5884
2023-06-23 14:35,596,66,530,68567,5193,63374,40314314.0,3026032.0,37288282.0,589,62,527,68039,5086,62953,40005294.0,2964872.0,37040422.0,0.5827,0.5884,0.5829,0.5884
2023-06-23 14:40,639,123,516,61985,12354,49631,36402458.0,7208989.0,29193468.0,627,118,509,61733,12155,49578,36257246.0,7087145.0,29170101.0,0.5835,0.5882,0.5831,0.5884
2023-06-23 14:45,62,17,45,3141,582,2559,1847459.0,340644.0,1506814.0,52,12,40,3078,543,2535,1809138.0,317430.0,1491707.0,0.5853,0.5888,0.5846,0.5884
2023-06-23 14:50,47,19,28,1670,967,703,966459.0,566565.0,399893.0,30,13,17,1258,958,300,737936.0,561180.0,176756.0,0.5859,0.5688,0.5858,0.5892
2023-06-23 14:55,74,26,48,2271,959,1312,1331503.0,559908.0,771594.0,65,16,49,1526,231,1295,897220.0,135129.0,762090.0,0.5838,0.5881,0.585,0.5885
2023-06-23 15:00,241,21,220,3961,627,3334,2325414.0,366865.0,1958549.0,234,15,219,3925,600,3325,2304091.0,350950.0,1953140.0,0.5851,0.5874,0.5849,0.5874
2023-06-23 15:05,317,62,255,4784,952,3832,2811197.0,560217.0,2250979.0,284,31,253,4784,904,3880,2809517.0,529357.0,2280160.0,0.5885,0.5874,0.5856,0.5877
2023-06-23 15:10,248,22,226,4203,654,3549,2469539.0,383851.0,2085687.0,242,15,227,3831,391,3440,2250127.0,229033.0,2021094.0,0.5869,0.5877,0.5858,0.5875
2023-06-23 15:15,66,26,40,2217,671,1546,1293979.0,392946.0,901032.0,53,17,36,2187,635,1552,1284228.0,371575.0,912653.0,0.5856,0.5828,0.5852,0.5881
2023-06-23 15:20,25,17,8,407,338,69,238189.0,198501.0,39688.0,21,15,6,360,324,36,210713.0,189489.0,21223.0,0.5873,0.5752,0.5848,0.5895
2023-06-23 15:25,43,35,8,1145,968,177,671277.0,566525.0,104752.0,42,35,7,1179,1007,172,691555.0,589611.0,101944.0,0.5853,0.5918,0.5855,0.5927
2023-06-23 15:30,132,53,79,8576,2134,6442,16893509.0,13116910.0,3776599.0,103,41,62,4997,1614,3383,14797746.0,12810580.0,1987165.0,6.1466,0.5862,7.9372,0.5874
2023-06-23 15:35,34,30,4,374,249,125,208605.0,134763.0,73842.0,10,9,1,221,101,120,126344.0,55352.0,70992.0,0.5412,0.5907,0.548,0.5916
2023-06-23 15:40,18,6,12,1114,719,395,652739.0,420082.0,232656.0,11,2,9,319,116,203,186610.0,66850.0,119759.0,0.5843,0.589,0.5763,0.5899
2023-06-23 15:45,996,416,580,64873,48265,16608,49712400.0,40016374.0,9696026.0,977,401,576,64179,47854,16325,49324865.0,39762499.0,9562366.0,0.8291,0.5838,0.8309,0.5857
2023-06-23 15:50,744,570,174,82319,64167,18152,48241966.0,37409604.0,10832362.0,725,557,168,81708,64160,17548,47888148.0,37405866.0,10482281.0,0.583,0.5968,0.583,0.5973
2023-06-23 15:55,1336,400,936,105573,39218,66355,73382115.0,34729162.0,38652953.0,1311,383,928,105232,38815,66417,73308815.0,34496156.0,38812659.0,0.8855,0.5825,0.8887,0.5844
2023-06-23 16:00,725,207,518,56242,10613,45629,44768817.0,18096402.0,26672415.0,691,184,507,54771,9531,45240,43859389.0,17414285.0,26445104.0,1.7051,0.5845,1.8271,0.5846
2023-06-23 16:05,136,117,19,6551,5936,615,3817645.0,3457388.0,360257.0,127,107,20,6815,5885,930,3974246.0,3427593.0,546653.0,0.5824,0.5858,0.5824,0.5878
2023-06-23 16:10,1067,96,971,50816,6404,44412,41551746.0,15590234.0,25961512.0,1053,88,965,50147,6729,43418,41170009.0,15784797.0,25385212.0,2.4345,0.5846,2.3458,0.5847
2023-06-23 16:15,1430,239,1191,84611,12630,71981,49488026.0,7346509.0,42141517.0,1409,226,1183,70445,11615,58830,41136110.0,6752541.0,34383569.0,0.5817,0.5855,0.5814,0.5845
2023-06-23 16:20,1978,436,1542,135767,34953,100814,79225198.0,20324812.0,58900386.0,1967,427,1540,148077,34647,113430,86501778.0,20145712.0,66356066.0,0.5815,0.5842,0.5815,0.585
2023-06-23 16:25,1532,486,1046,139023,42254,96769,81102620.0,24576193.0,56526427.0,1508,463,1045,138685,41823,96862,80903644.0,24321087.0,56582556.0,0.5816,0.5841,0.5815,0.5842
2023-06-23 16:30,1900,458,1442,177957,59107,118850,103785867.0,34370411.0,69415455.0,1895,454,1441,178167,59363,118804,103926402.0,34519136.0,69407266.0,0.5815,0.5841,0.5815,0.5842
2023-06-23 16:35,714,146,568,60755,6668,54087,35482044.0,3887716.0,31594328.0,703,137,566,60458,6510,53948,35290462.0,3782924.0,31507538.0,0.583,0.5841,0.5811,0.584
2023-06-23 16:40,1194,20,1174,68556,223,68333,40046782.0,129814.0,39916968.0,1185,16,1169,68506,133,68373,40018010.0,77325.0,39940684.0,0.5821,0.5842,0.5814,0.5842
2023-06-23 16:45,720,28,692,60991,869,60122,35622325.0,501105.0,35121220.0,711,20,691,48065,814,47251,28075395.0,468856.0,27606538.0,0.5766,0.5842,0.576,0.5843
2023-06-23 16:50,1552,395,1157,178374,62372,116002,116103037.0,48179336.0,67923700.0,1530,383,1147,177519,62070,115449,115474843.0,48002556.0,67472287.0,0.7725,0.5855,0.7734,0.5844
2023-06-23 16:55,1897,66,1831,124019,7143,116876,84327178.0,16025417.0,68301761.0,1877,50,1827,123806,7007,116799,84202455.0,15945100.0,68257354.0,2.2435,0.5844,2.2756,0.5844
2023-06-23 17:00,1706,27,1679,142357,424,141933,83177272.0,247058.0,82930213.0,1694,20,1674,142398,330,142068,83202620.0,191764.0,83010855.0,0.5827,0.5843,0.5811,0.5843
2023-06-23 17:05,1601,147,1454,145347,6892,138455,108300891.0,27727660.0,80573231.0,1448,51,1397,154126,5451,148675,113814772.0,26885103.0,86929668.0,4.0232,0.5819,4.9321,0.5847
2023-06-23 17:10,185,82,103,5423,1748,3675,3146919.0,1012213.0,2134706.0,103,19,84,3299,640,2659,1909268.0,364575.0,1544693.0,0.5791,0.5809,0.5696,0.5809
2023-06-23 17:15,400,174,226,38153,29911,8242,22090443.0,17310036.0,4780406.0,360,145,215,37027,29220,7807,21434479.0,16900073.0,4534406.0,0.5787,0.58,0.5784,0.5808
2023-06-23 17:20,416,114,302,32397,18158,14239,18772997.0,10509553.0,8263443.0,383,88,295,31776,17749,14027,18399806.0,10258073.0,8141733.0,0.5788,0.5803,0.578,0.5804
2023-06-23 17:25,1299,445,854,111628,64555,47073,64628959.0,37322579.0,27306380.0,1282,434,848,111745,64642,47103,64699283.0,37369043.0,27330240.0,0.5782,0.5801,0.5781,0.5802
2023-06-23 17:30,7676,3423,4253,1255715,951649,304066,773453200.0,597687328.0,175765872.0,7568,3350,4218,1240956,950519,290437,764984802.0,597018239.0,167966562.0,0.6281,0.5781,0.6281,0.5783
2023-06-23 17:35,2845,2090,755,284580,242923,41657,246763473.0,222654224.0,24109249.0,2707,1996,711,293749,240162,53587,251959235.0,220989866.0,30969369.0,0.9166,0.5788,0.9202,0.5779
2023-06-23 17:40,1832,1579,253,227047,200622,26425,154148057.0,138912252.0,15235805.0,1794,1551,243,227668,201601,26067,154511803.0,139468588.0,15043215.0,0.6924,0.5766,0.6918,0.5771
2023-06-23 17:45,1197,415,782,154910,22227,132683,125360052.0,49119672.0,76240379.0,886,179,707,139610,9776,129834,116321935.0,41677552.0,74644383.0,2.2099,0.5746,4.2633,0.5749
2023-06-23 17:50,2530,838,1692,320964,28326,292638,196470907.0,28069986.0,168400921.0,2450,781,1669,318979,25808,293171,195323416.0,26602482.0,168720934.0,0.991,0.5755,1.0308,0.5755
2023-06-23 17:55,2363,1262,1101,194417,49443,144974,123765766.0,40216586.0,83549179.0,2317,1230,1087,193622,48955,144667,123220297.0,39850938.0,83369359.0,0.8134,0.5763,0.814,0.5763
2023-06-23 18:00,869,128,741,100325,6571,93754,81530767.0,27492826.0,54037941.0,834,106,728,104261,5189,99072,84091470.0,26716319.0,57375150.0,4.184,0.5764,5.1486,0.5791
2023-06-23 18:05,222,83,139,15256,3524,11732,8807886.0,2046852.0,6761034.0,168,41,127,13834,1916,11918,7967955.0,1096632.0,6871322.0,0.5808,0.5763,0.5724,0.5765
2023-06-23 18:10,200,80,120,17681,4694,12987,34222909.0,26461788.0,7761120.0,157,54,103,8010,3327,4683,28368464.0,25657326.0,2711137.0,5.6374,0.5976,7.7119,0.5789
2023-06-23 18:15,351,66,285,37266,6381,30885,33428984.0,15548360.0,17880624.0,296,36,260,31654,2476,29178,30190184.0,13296198.0,16893986.0,2.4367,0.5789,5.37,0.579
2023-06-23 18:20,294,46,248,29800,2467,27333,17235997.0,1422036.0,15813961.0,258,27,231,27542,2487,25055,15935981.0,1431669.0,14504311.0,0.5764,0.5786,0.5757,0.5789
2023-06-23 18:25,689,42,647,40478,4476,36002,23432656.0,2584947.0,20847709.0,653,22,631,38513,2803,35710,22291146.0,1614338.0,20676807.0,0.5775,0.5791,0.5759,0.579
2023-06-23 18:30,856,319,537,66191,21832,44359,50139212.0,24466832.0,25672380.0,816,305,511,66923,23469,43454,50581240.0,25396819.0,25184420.0,1.1207,0.5787,1.0821,0.5796
2023-06-23 18:35,606,45,561,38624,1838,36786,22326540.0,1059033.0,21267507.0,593,40,553,39113,2277,36836,22601393.0,1303820.0,21297573.0,0.5762,0.5781,0.5726,0.5782
2023-06-26 10:00,2795,1165,1630,277754,62023,215731,187793003.0,63672974.0,124120028.0,2485,996,1489,259478,49400,210078,172583725.0,51779280.0,120804445.0,1.0266,0.5753,1.0482,0.575
2023-06-26 10:05,3183,584,2599,363408,34132,329276,252150846.0,62936205.0,189214641.0,3047,488,2559,358889,32680,326209,243005857.0,55534745.0,187471112.0,1.8439,0.5746,1.6993,0.5747
2023-06-26 10:10,1474,295,1179,143130,22128,121002,177502118.0,107688202.0,69813915.0,1356,216,1140,132981,19266,113715,171431593.0,106021029.0,65410564.0,4.8666,0.577,5.503,0.5752
2023-06-26 10:15,1129,634,495,82283,20957,61326,58991718.0,23798313.0,35193405.0,990,542,448,73962,18884,55078,54285455.0,22641023.0,31644432.0,1.1356,0.5739,1.199,0.5745
2023-06-26 10:20,2433,1499,934,221080,79363,141717,362013598.0,282171188.0,79842409.0,1830,1090,740,198812,63284,135528,349885619.0,273140079.0,76745539.0,3.5555,0.5634,4.3161,0.5663
2023-06-26 10:25,1165,1000,165,75587,64455,11132,161112456.0,143329834.0,17782622.0,953,846,107,66338,57303,9035,144235996.0,139090424.0,5145571.0,2.2237,1.5974,2.4273,0.5695
2023-06-26 10:30,695,293,402,46341,13994,32347,62333003.0,43494483.0,18838519.0,567,199,368,39954,9751,30203,58283986.0,41114953.0,17169032.0,3.1081,0.5824,4.2165,0.5685
2023-06-26 10:35,636,331,305,22081,13903,8178,13447782.0,7820020.0,5627762.0,451,213,238,20439,13046,7393,12737980.0,7542727.0,5195253.0,0.5625,0.6882,0.5782,0.7027
2023-06-26 10:40,1635,659,976,149382,18275,131107,108316876.0,34004983.0,74311893.0,1543,593,950,145523,16872,128651,106665908.0,33211149.0,73454759.0,1.8607,0.5668,1.9684,0.571
2023-06-26 10:45,1358,537,821,117498,16811,100687,101750736.0,44989140.0,56761596.0,1255,463,792,115858,15663,100195,100923468.0,44414045.0,56509422.0,2.6762,0.5637,2.8356,0.564
2023-06-26 10:50,435,360,75,17550,11221,6329,21772763.0,18186637.0,3586126.0,355,298,57,16154,9836,6318,20977440.0,17396124.0,3581315.0,1.6208,0.5666,1.7686,0.5668
2023-06-26 10:55,206,156,50,8102,6808,1294,4380737.0,3649061.0,731676.0,125,99,26,3716,2993,723,2087659.0,1676959.0,410699.0,0.536,0.5654,0.5603,0.568
2023-06-26 11:00,212,139,73,9427,5135,4292,5534514.0,3092310.0,2442204.0,158,91,67,8778,4953,3825,4933845.0,2768385.0,2165460.0,0.6022,0.569,0.5589,0.5661
2023-06-26 11:05,989,745,244,48604,35285,13319,98739117.0,91167527.0,7571590.0,932,712,220,45730,34087,11643,97087418.0,90468455.0,6618963.0,2.5837,0.5685,2.654,0.5685
2023-06-26 11:10,218,110,108,16233,11486,4747,9151638.0,6448097.0,2703541.0,171,74,97,14685,10013,4672,8252866.0,5592936.0,2659930.0,0.5614,0.5695,0.5586,0.5693
2023-06-26 11:15,332,112,220,16653,6476,10177,21261283.0,15503346.0,5757936.0,279,66,213,12411,3260,9151,18893728.0,13710293.0,5183435.0,2.394,0.5658,4.2056,0.5664
2023-06-26 11:20,816,143,673,60965,9566,51399,46513219.0,17366206.0,29147013.0,749,95,654,58574,10202,48372,44876463.0,17413370.0,27463093.0,1.8154,0.5671,1.7069,0.5677
2023-06-26 11:25,2524,954,1570,233292,65843,167449,144386258.0,49083448.0,95302810.0,2452,907,1545,232481,65909,166572,143905051.0,49100095.0,94804955.0,0.7455,0.5691,0.745,0.5692
2023-06-26 11:30,298,117,181,18423,6683,11740,10453212.0,3778464.0,6674748.0,246,87,159,17760,6164,11596,10088755.0,3479461.0,6609293.0,0.5654,0.5685,0.5645,0.57
2023-06-26 11:35,826,341,485,50860,16389,34471,40759786.0,21173716.0,19586070.0,753,283,470,48983,15813,33170,39654636.0,20804328.0,18850308.0,1.2919,0.5682,1.3156,0.5683
2023-06-26 11:40,1915,297,1618,240296,9306,230990,148078351.0,17112409.0,130965942.0,1867,269,1598,239652,8416,231236,147753903.0,16614351.0,131139552.0,1.8389,0.567,1.9741,0.5671
2023-06-26 11:45,2712,508,2204,327710,17017,310693,233365210.0,57101162.0,176264048.0,2650,474,2176,326335,16152,310183,232589113.0,56604489.0,175984623.0,3.3555,0.5673,3.5045,0.5674
2023-06-26 11:50,574,195,379,57472,15573,41899,68249501.0,44446990.0,23802510.0,543,171,372,56903,14978,41925,67885304.0,44071072.0,23814232.0,2.8541,0.5681,2.9424,0.568
2023-06-26 11:55,1044,801,243,104170,91465,12705,58821366.0,51606898.0,7214468.0,1026,797,229,104426,92755,11671,58892625.0,52269370.0,6623254.0,0.5642,0.5678,0.5635,0.5675
2023-06-26 12:00,670,143,527,39611,20179,19432,22346281.0,11379712.0,10966569.0,645,120,525,37104,18779,18325,20999660.0,10590907.0,10408753.0,0.5639,0.5644,0.564,0.568
2023-06-26 12:05,879,105,774,67696,10813,56883,62157795.0,29856677.0,32301118.0,845,74,771,68217,11122,57095,62447730.0,30026783.0,32420946.0,2.7612,0.5679,2.6998,0.5678
2023-06-26 12:10,2696,2016,680,294506,232181,62325,202467602.0,167029756.0,35437845.0,2649,1987,662,289441,227546,61895,199510668.0,164311426.0,35199242.0,0.7194,0.5686,0.7221,0.5687
2023-06-26 12:15,3134,2895,239,307053,298300,8753,185572863.0,180580376.0,4992487.0,3117,2881,236,306968,298528,8440,185513960.0,180705250.0,4808709.0,0.6054,0.5704,0.6053,0.5698
2023-06-26 12:20,1030,868,162,138743,124426,14317,90376931.0,82167926.0,8209004.0,1008,855,153,138095,123835,14260,90012861.0,81834298.0,8178563.0,0.6604,0.5734,0.6608,0.5735
2023-06-26 12:25,720,470,250,73447,68975,4472,53402957.0,50850560.0,2552396.0,696,451,245,72992,68808,4184,53132552.0,50749090.0,2383462.0,0.7372,0.5708,0.7375,0.5697
2023-06-26 12:30,445,102,343,23748,5222,18526,49186793.0,38631604.0,10555188.0,382,62,320,20538,3304,17234,47341579.0,37498420.0,9843159.0,7.3979,0.5697,11.3494,0.5711
2023-06-26 12:35,2612,1979,633,185434,159097,26337,105506104.0,90465821.0,15040283.0,2577,1957,620,184306,158599,25707,104830227.0,90152778.0,14677449.0,0.5686,0.5711,0.5684,0.571
2023-06-26 12:40,759,520,239,71285,57602,13683,40490819.0,32717543.0,7773275.0,735,507,228,70548,57404,13144,40089081.0,32597013.0,7492067.0,0.568,0.5681,0.5679,0.57
2023-06-26 12:45,200,43,157,9563,1400,8163,5467986.0,797161.0,4670824.0,175,30,145,9056,1233,7823,5167609.0,698666.0,4468943.0,0.5694,0.5722,0.5666,0.5713
2023-06-26 12:50,211,98,113,9189,3258,5931,5261316.0,1881971.0,3379344.0,181,84,97,8436,2925,5511,4809073.0,1660236.0,3148836.0,0.5776,0.5698,0.5676,0.5714
2023-06-26 12:55,308,118,190,13948,3637,10311,7951538.0,2065582.0,5885956.0,292,108,184,13527,3402,10125,7709776.0,1931437.0,5778339.0,0.5679,0.5708,0.5677,0.5707
2023-06-26 13:00,660,542,118,49691,36025,13666,28305657.0,20500857.0,7804799.0,638,528,110,49077,35567,13510,27957127.0,20236524.0,7720602.0,0.5691,0.5711,0.569,0.5715
2023-06-26 13:05,1344,949,395,111839,88958,22881,63624726.0,50633960.0,12990766.0,1303,920,383,109352,88041,21311,62266450.0,50091937.0,12174512.0,0.5692,0.5678,0.569,0.5713
2023-06-26 13:10,513,104,409,28482,6204,22278,16229971.0,3523762.0,12706208.0,473,79,394,28871,6182,22689,16463012.0,3511827.0,12951184.0,0.568,0.5703,0.5681,0.5708
2023-06-26 13:15,1578,1219,359,160885,151561,9324,103451147.0,98122739.0,5328407.0,1555,1203,352,160506,151084,9422,103235253.0,97843717.0,5391536.0,0.6474,0.5715,0.6476,0.5722
2023-06-26 13:20,829,692,137,99150,94169,4981,56503167.0,53652888.0,2850279.0,777,649,128,96350,91463,4887,54853550.0,52056836.0,2796713.0,0.5698,0.5722,0.5692,0.5723
2023-06-26 13:25,817,542,275,56574,49474,7100,44150917.0,40083468.0,4067449.0,794,528,266,56453,49351,7102,44078034.0,40008913.0,4069120.0,0.8102,0.5729,0.8107,0.573
2023-06-26 13:30,612,560,52,83418,79287,4131,47533044.0,45163530.0,2369513.0,591,546,45,82230,79030,3200,46848827.0,45011458.0,1837368.0,0.5696,0.5736,0.5695,0.5742
2023-06-26 13:35,345,289,56,47797,44614,3183,39113487.0,37293949.0,1819537.0,331,283,48,47266,44310,2956,38814098.0,37121350.0,1692747.0,0.8359,0.5716,0.8378,0.5726
2023-06-26 13:40,725,486,239,86843,71737,15106,49559708.0,40905491.0,8654217.0,707,469,238,86405,71323,15082,49303099.0,40662420.0,8640679.0,0.5702,0.5729,0.5701,0.5729
2023-06-26 13:45,2147,1083,1064,193141,89250,103891,110340814.0,50876610.0,59464204.0,2128,1074,1054,191680,89214,102466,109531091.0,50855184.0,58675907.0,0.57,0.5724,0.57,0.5726
2023-06-26 13:50,1773,1001,772,133179,52106,81073,76137225.0,29723717.0,46413508.0,1758,986,772,132898,51572,81326,75995127.0,29424731.0,46570395.0,0.5704,0.5725,0.5706,0.5726
2023-06-26 13:55,1215,186,1029,102820,4352,98468,58861283.0,2478149.0,56383133.0,1193,176,1017,102485,4090,98395,58656784.0,2329940.0,56326844.0,0.5694,0.5726,0.5697,0.5725
2023-06-26 14:00,39,24,15,1060,464,596,605968.0,263179.0,342789.0,26,12,14,910,320,590,520848.0,180917.0,339931.0,0.5672,0.5751,0.5654,0.5762
2023-06-26 14:05,562,205,357,51782,10572,41210,29651784.0,6024814.0,23626970.0,542,194,348,51439,10328,41111,29417903.0,5884555.0,23533348.0,0.5699,0.5733,0.5698,0.5724
2023-06-26 14:10,448,267,181,51129,30787,20342,29192251.0,17534880.0,11657371.0,433,255,178,50974,30797,20177,29098591.0,17537774.0,11560817.0,0.5696,0.5731,0.5695,0.573
2023-06-26 14:15,79,43,36,4248,1681,2567,14329995.0,12857036.0,1472959.0,65,33,32,3575,1315,2260,13921649.0,12625252.0,1296397.0,7.6484,0.5738,9.601,0.5736
2023-06-26 14:20,70,38,32,3821,1677,2144,2189698.0,959390.0,1230307.0,57,31,26,5096,3308,1788,2891625.0,1865334.0,1026291.0,0.5721,0.5738,0.5639,0.574
2023-06-26 14:25,76,37,39,3430,1075,2355,1962408.0,611899.0,1350509.0,59,29,30,2478,1036,1442,1418677.0,591032.0,827645.0,0.5692,0.5735,0.5705,0.574
2023-06-26 14:30,64,20,44,2554,761,1793,1481735.0,454758.0,1026977.0,56,20,36,2642,579,2063,1511912.0,328714.0,1183198.0,0.5976,0.5728,0.5677,0.5735
2023-06-26 14:35,160,98,62,11999,8662,3337,18712725.0,16817174.0,1895550.0,143,92,51,12163,9144,3019,18822595.0,17092783.0,1729811.0,1.9415,0.568,1.8693,0.573
2023-06-26 14:40,71,12,59,4232,123,4109,2423904.0,70115.0,2353789.0,68,12,56,4337,297,4040,2480803.0,166599.0,2314203.0,0.57,0.5728,0.5609,0.5728
2023-06-26 14:45,138,53,85,6670,1474,5196,3821001.0,845121.0,2975880.0,117,33,84,6725,1566,5159,3838507.0,883774.0,2954733.0,0.5734,0.5727,0.5644,0.5727
2023-06-26 14:50,53,33,20,2539,773,1766,1457869.0,441712.0,1016157.0,40,21,19,2091,478,1613,1195056.0,271104.0,923951.0,0.5714,0.5754,0.5672,0.5728
2023-06-26 14:55,144,96,48,10095,7877,2218,5691433.0,4422755.0,1268678.0,125,88,37,11144,8239,2905,6265115.0,4598086.0,1667029.0,0.5615,0.572,0.5581,0.5738
2023-06-26 15:00,1257,754,503,128460,89690,38770,97171490.0,74979762.0,22191727.0,1221,740,481,126128,89317,36811,95854078.0,74760773.0,21093304.0,0.836,0.5724,0.837,0.573
2023-06-26 15:05,689,349,340,57116,39797,17319,32637081.0,22703172.0,9933909.0,681,343,338,56503,39675,16828,32270107.0,22633458.0,9636649.0,0.5705,0.5736,0.5705,0.5727
2023-06-26 15:10,557,144,413,57213,41131,16082,32674554.0,23484094.0,9190460.0,548,142,406,57675,41077,16598,32957721.0,23453292.0,9504429.0,0.571,0.5715,0.571,0.5726
2023-06-26 15:15,138,21,117,7811,2764,5047,4449292.0,1567320.0,2881972.0,120,13,107,6517,2434,4083,3717538.0,1380280.0,2337257.0,0.567,0.571,0.5671,0.5724
2023-06-26 15:20,46,12,34,1048,509,539,596973.0,288914.0,308059.0,37,9,28,979,627,352,552872.0,350351.0,202521.0,0.5676,0.5715,0.5588,0.5753
2023-06-26 15:25,40,9,31,1700,1112,588,966115.0,629172.0,336942.0,34,6,28,1523,947,576,867594.0,537398.0,330195.0,0.5658,0.573,0.5675,0.5733
2023-06-26 15:30,243,6,237,5452,23,5429,3115089.0,12920.0,3102168.0,241,3,238,5469,28,5441,3125366.0,15612.0,3109753.0,0.5618,0.5714,0.5576,0.5715
2023-06-26 15:35,93,10,83,3985,49,3936,2277880.0,27697.0,2250182.0,83,2,81,3744,8,3736,2140239.0,4539.0,2135700.0,0.5653,0.5717,0.5674,0.5717
2023-06-26 15:40,235,40,195,16074,5256,10818,21056470.0,14868827.0,6187643.0,234,38,196,15559,5062,10497,20762262.0,14758525.0,6003736.0,2.8289,0.572,2.9156,0.5719
2023-06-26 15:45,1351,36,1315,95762,2262,93500,54744059.0,1303600.0,53440459.0,1340,27,1313,95983,1933,94050,54856991.0,1098478.0,53758512.0,0.5763,0.5716,0.5683,0.5716
2023-06-26 15:50,1869,116,1753,148435,25543,122892,84781554.0,14546925.0,70234628.0,1854,104,1750,147930,25463,122467,84488872.0,14497825.0,69991047.0,0.5695,0.5715,0.5694,0.5715
2023-06-26 15:55,1516,66,1450,118402,7338,111064,67643652.0,4175729.0,63467922.0,1504,61,1443,118571,7664,110907,67744166.0,4361474.0,63382691.0,0.5691,0.5715,0.5691,0.5715
2023-06-26 16:00,1469,62,1407,119135,9629,109506,68057362.0,5480490.0,62576872.0,1463,55,1408,119176,9383,109793,68081859.0,5340866.0,62740993.0,0.5692,0.5714,0.5692,0.5714
2023-06-26 16:05,1659,26,1633,143838,2191,141647,82232186.0,1247010.0,80985176.0,1650,19,1631,143794,2439,141355,82206096.0,1387732.0,80818364.0,0.5692,0.5717,0.569,0.5717
2023-06-26 16:10,991,20,971,93537,1240,92297,53476783.0,708755.0,52768028.0,981,10,971,93371,1033,92338,53379449.0,588165.0,52791284.0,0.5716,0.5717,0.5694,0.5717
2023-06-26 16:15,673,21,652,56082,1205,54877,32061269.0,684867.0,31376401.0,665,16,649,55778,648,55130,31891500.0,368904.0,31522596.0,0.5684,0.5718,0.5693,0.5718
2023-06-26 16:20,127,35,92,10457,4421,6036,17847048.0,14394040.0,3453008.0,110,24,86,9708,3994,5714,17418967.0,14149030.0,3269937.0,3.2558,0.5721,3.5426,0.5723
2023-06-26 16:25,1816,912,904,187930,74222,113708,227896280.0,161740861.0,66155419.0,1587,814,773,174588,65931,108657,219785010.0,156564527.0,63220483.0,2.1791,0.5818,2.3747,0.5818
2023-06-26 16:30,2739,1799,940,241934,164310,77624,318384220.0,262172258.0,56211962.0,2332,1692,640,226350,155166,71184,309708181.0,256548798.0,53159383.0,1.5956,0.7242,1.6534,0.7468
2023-06-26 16:35,1557,572,985,138971,35981,102990,164903009.0,103771462.0,61131547.0,1287,430,857,128745,32564,96181,157866785.0,101821908.0,56044876.0,2.8841,0.5936,3.1268,0.5827
2023-06-26 16:40,1327,534,793,98427,25774,72653,80593545.0,38579990.0,42013554.0,1201,458,743,96701,23898,72803,79623940.0,37479368.0,42144572.0,1.4969,0.5783,1.5683,0.5789
2023-06-26 16:45,552,385,167,32386,17319,15067,66123921.0,57458342.0,8665579.0,527,383,144,31682,18081,13601,65759126.0,57883447.0,7875679.0,3.3176,0.5751,3.2013,0.5791
2023-06-26 16:50,2248,1213,1035,129291,63173,66118,110110892.0,71914210.0,38196682.0,2217,1196,1021,129954,63897,66057,110513781.0,72326072.0,38187708.0,1.1384,0.5777,1.1319,0.5781
2023-06-26 16:55,2267,1645,622,157754,131787,25967,90720399.0,75699707.0,15020692.0,2245,1642,603,156643,131488,25155,90075051.0,75525443.0,14549607.0,0.5744,0.5785,0.5744,0.5784
2023-06-26 17:00,1212,512,700,96730,36583,60147,67697132.0,32871428.0,34825703.0,1172,488,684,95890,35926,59964,67232748.0,32495005.0,34737743.0,0.8985,0.579,0.9045,0.5793
2023-06-26 17:05,2885,693,2192,270770,46064,224706,191387349.0,62045836.0,129341512.0,2813,643,2170,267647,44900,222747,189728070.0,61373501.0,128354569.0,1.3469,0.5756,1.3669,0.5762
2023-06-26 17:10,1907,314,1593,181131,9614,171517,116294396.0,17381039.0,98913356.0,1881,298,1583,180822,9729,171093,116117100.0,17448210.0,98668890.0,1.8079,0.5767,1.7934,0.5767
2023-06-26 17:15,176,70,106,6369,2587,3782,3653999.0,1480248.0,2173751.0,148,54,94,6845,2333,4512,3935814.0,1334793.0,2601021.0,0.5722,0.5748,0.5721,0.5765
2023-06-26 17:20,196,80,116,9077,2973,6104,5214163.0,1701419.0,3512743.0,184,70,114,8801,2936,5865,5054677.0,1677802.0,3376874.0,0.5723,0.5755,0.5715,0.5758
2023-06-26 17:25,1759,448,1311,227007,33359,193648,130819072.0,19147773.0,111671298.0,1743,434,1309,227399,33052,194347,131023576.0,18921769.0,112101807.0,0.574,0.5767,0.5725,0.5768
2023-06-26 17:30,336,68,268,23587,3232,20355,13621169.0,1847793.0,11773375.0,327,67,260,22703,3098,19605,13083301.0,1773304.0,11309997.0,0.5717,0.5784,0.5724,0.5769
2023-06-26 17:35,58,12,46,4610,106,4504,2658332.0,61275.0,2597057.0,49,6,43,4593,73,4520,2645031.0,41770.0,2603261.0,0.5781,0.5766,0.5722,0.5759
2023-06-26 17:40,76,25,51,5364,403,4961,3098424.0,233866.0,2864558.0,68,21,47,5397,481,4916,3113443.0,274566.0,2838876.0,0.5803,0.5774,0.5708,0.5775
2023-06-26 17:45,114,27,87,6512,1471,5041,3745844.0,841506.0,2904338.0,108,23,85,5771,850,4921,3316173.0,481219.0,2834954.0,0.5721,0.5761,0.5661,0.5761
2023-06-26 17:50,146,28,118,7848,1711,6137,4474338.0,978731.0,3495607.0,121,16,105,6414,1088,5326,3681437.0,619604.0,3061833.0,0.572,0.5696,0.5695,0.5749
2023-06-26 17:55,295,25,270,19906,1161,18745,11447070.0,664627.0,10782443.0,280,16,264,19058,886,18172,10983606.0,506781.0,10476825.0,0.5725,0.5752,0.572,0.5765
2023-06-26 18:00,154,22,132,10711,1849,8862,6159268.0,1055367.0,5103901.0,147,22,125,11126,2266,8860,6385929.0,1279448.0,5106480.0,0.5708,0.5759,0.5646,0.5764
2023-06-26 18:05,297,24,273,8477,1819,6658,4875061.0,1041353.0,3833708.0,290,20,270,8534,1795,6739,4909654.0,1027681.0,3881973.0,0.5725,0.5758,0.5725,0.576
2023-06-26 18:10,135,24,111,9440,364,9076,5447289.0,209016.0,5238272.0,125,15,110,8881,252,8629,5125830.0,143941.0,4981889.0,0.5742,0.5772,0.5712,0.5773
2023-06-26 18:15,61,17,44,3031,218,2813,1743483.0,125111.0,1618372.0,54,10,44,2837,163,2674,1629990.0,91799.0,1538190.0,0.5739,0.5753,0.5632,0.5752
2023-06-26 18:20,336,32,304,18392,1712,16680,10573452.0,980300.0,9593151.0,322,23,299,18225,1679,16546,10500148.0,959725.0,9540422.0,0.5726,0.5751,0.5716,0.5766
2023-06-26 18:25,947,141,806,146595,16800,129795,84525330.0,9608998.0,74916331.0,934,135,799,147008,16747,130261,84758078.0,9573868.0,75184209.0,0.572,0.5772,0.5717,0.5772
2023-06-26 18:30,432,28,404,18753,1173,17580,10805334.0,671587.0,10133746.0,415,18,397,19037,1494,17543,10967323.0,853710.0,10113613.0,0.5725,0.5764,0.5714,0.5765
2023-06-26 18:35,266,72,194,29082,6620,22462,16679185.0,3785160.0,12894024.0,258,63,195,28927,6341,22586,16618408.0,3626915.0,12991492.0,0.5718,0.574,0.572,0.5752
2023-06-27 10:00,2436,1364,1072,283958,207340,76618,237415562.0,193007835.0,44407726.0,2137,1223,914,260773,192058,68715,218952898.0,179386518.0,39566380.0,0.9309,0.5796,0.934,0.5758
2023-06-27 10:05,1701,327,1374,132623,20526,112097,76326059.0,11613588.0,64712470.0,1605,264,1341,128440,18308,110132,73974484.0,10450645.0,63523839.0,0.5658,0.5773,0.5708,0.5768
2023-06-27 10:10,687,100,587,60913,2604,58309,35338486.0,1477713.0,33860772.0,641,74,567,53077,2177,50900,30590831.0,1239630.0,29351201.0,0.5675,0.5807,0.5694,0.5766
2023-06-27 10:15,1301,72,1229,121890,2335,119555,70340078.0,1332169.0,69007909.0,1234,39,1195,118907,923,117984,68604784.0,522738.0,68082046.0,0.5705,0.5772,0.5663,0.577
2023-06-27 10:20,718,20,698,68818,373,68445,51174619.0,211390.0,50963228.0,697,7,690,68226,145,68081,39275866.0,82449.0,39193416.0,0.5667,0.7446,0.5686,0.5757
2023-06-27 10:25,245,63,182,6416,1262,5154,3653060.0,714947.0,2938112.0,141,21,120,5525,1346,4179,3162991.0,764352.0,2398638.0,0.5665,0.5701,0.5679,0.574
2023-06-27 10:30,104,37,67,4044,1697,2347,2314721.0,968606.0,1346115.0,84,23,61,3379,1130,2249,1934486.0,644805.0,1289681.0,0.5708,0.5735,0.5706,0.5734
2023-06-27 10:35,90,48,42,2315,838,1477,1323945.0,477582.0,846362.0,71,37,34,1940,760,1180,1110443.0,433335.0,677108.0,0.5699,0.573,0.5702,0.5738
2023-06-27 10:40,533,100,433,19388,2651,16737,11102780.0,1508863.0,9593917.0,507,83,424,18382,2111,16271,10526116.0,1203979.0,9322136.0,0.5692,0.5732,0.5703,0.5729
2023-06-27 10:45,333,61,272,10557,2629,7928,6028859.0,1488642.0,4540216.0,303,43,260,9309,1976,7333,5330942.0,1127179.0,4203763.0,0.5662,0.5727,0.5704,0.5733
2023-06-27 10:50,353,103,250,18568,10789,7779,10610442.0,6163581.0,4446860.0,297,89,208,18091,10632,7459,10344948.0,6073703.0,4271245.0,0.5713,0.5716,0.5713,0.5726
2023-06-27 10:55,440,27,413,14459,1648,12811,8279501.0,951046.0,7328454.0,398,20,378,13948,1485,12463,7983514.0,848308.0,7135206.0,0.5771,0.572,0.5713,0.5725
2023-06-27 11:00,285,87,198,13375,3614,9761,19518481.0,13931796.0,5586685.0,194,43,151,9763,2066,7697,11086272.0,6678412.0,4407860.0,3.855,0.5723,3.2325,0.5727
2023-06-27 11:05,1074,143,931,42356,5610,36746,24181192.0,3157698.0,21023493.0,943,57,886,37602,1839,35763,21513099.0,1044455.0,20468644.0,0.5629,0.5721,0.5679,0.5723
2023-06-27 11:10,624,48,576,43578,805,42773,24955694.0,457460.0,24498234.0,644,93,551,46321,2260,44061,26507094.0,1273608.0,25233485.0,0.5683,0.5727,0.5635,0.5727
2023-06-27 11:15,1709,119,1590,127352,2398,124954,84793234.0,13223085.0,71570149.0,1579,55,1524,125005,1427,123578,83509677.0,12676943.0,70832734.0,5.5142,0.5728,8.8836,0.5732
2023-06-27 11:20,3287,237,3050,355861,11432,344429,215408209.0,18461305.0,196946904.0,3194,195,2999,352212,8474,343738,213240755.0,16687224.0,196553531.0,1.6149,0.5718,1.9692,0.5718
2023-06-27 11:25,1767,474,1293,126866,29657,97209,120239017.0,64398591.0,55840426.0,1718,466,1252,126584,29777,96807,120066974.0,64450505.0,55616468.0,2.1714,0.5744,2.1644,0.5745
2023-06-27 11:30,833,451,382,42358,27223,15135,59839388.0,51146016.0,8693371.0,776,440,336,42399,27402,14997,59865536.0,51248812.0,8616723.0,1.8788,0.5744,1.8703,0.5746
2023-06-27 11:35,727,248,479,28566,18976,9590,16297278.0,10814189.0,5483089.0,674,232,442,28226,18797,9429,16113526.0,10711112.0,5402413.0,0.5699,0.5718,0.5698,0.573
2023-06-27 11:40,506,38,468,10175,2257,7918,5816840.0,1285781.0,4531058.0,464,25,439,10044,2058,7986,5745054.0,1172794.0,4572260.0,0.5697,0.5722,0.5699,0.5725
2023-06-27 11:45,700,52,648,10209,2406,7803,5832575.0,1370305.0,4462270.0,649,32,617,10098,2339,7759,5773018.0,1332845.0,4440172.0,0.5695,0.5719,0.5698,0.5723
2023-06-27 11:50,372,100,272,11298,4567,6731,6444621.0,2603665.0,3840955.0,309,75,234,10599,4257,6342,6055407.0,2426148.0,3629258.0,0.5701,0.5706,0.5699,0.5723
2023-06-27 11:55,227,50,177,5900,1890,4010,15251821.0,12956323.0,2295498.0,164,31,133,5414,1491,3923,14974296.0,12725766.0,2248530.0,6.8552,0.5724,8.5351,0.5732
2023-06-27 12:00,585,73,512,10809,3735,7074,6271290.0,2131688.0,4139601.0,548,73,475,8529,3729,4800,4914915.0,2127727.0,2787188.0,0.5707,0.5852,0.5706,0.5807
2023-06-27 12:05,1696,195,1501,135058,17492,117566,112728955.0,45573960.0,67154995.0,1523,142,1381,130281,14868,115413,110185118.0,44080840.0,66104278.0,2.6054,0.5712,2.9648,0.5728
2023-06-27 12:10,2486,362,2124,238912,25316,213596,148699466.0,26265038.0,122434427.0,2441,328,2113,238735,26000,212735,148591672.0,26645552.0,121946120.0,1.0375,0.5732,1.0248,0.5732
2023-06-27 12:15,892,108,784,49674,4417,45257,28453615.0,2506605.0,25947010.0,864,88,776,49001,3773,45228,28075938.0,2145248.0,25930689.0,0.5675,0.5733,0.5686,0.5733
2023-06-27 12:20,1694,367,1327,206625,17374,189251,130216009.0,21786072.0,108429936.0,1654,340,1314,204656,16767,187889,129164661.0,21416553.0,107748107.0,1.2539,0.5729,1.2773,0.5735
2023-06-27 12:25,1445,201,1244,192855,14655,178200,146133380.0,43954157.0,102179223.0,1401,177,1224,188674,11975,176699,143836917.0,42436325.0,101400592.0,2.9993,0.5734,3.5437,0.5739
2023-06-27 12:30,2415,138,2277,292584,3471,289113,191046532.0,25723065.0,165323467.0,2362,94,2268,291264,3020,288244,190356339.0,25455780.0,164900558.0,7.4109,0.5718,8.4291,0.5721
2023-06-27 12:35,256,44,212,30302,2150,28152,17340264.0,1219457.0,16120806.0,238,30,208,29584,1358,28226,16930040.0,765558.0,16164482.0,0.5672,0.5726,0.5637,0.5727
2023-06-27 12:40,485,120,365,41112,3152,37960,35446000.0,13667214.0,21778785.0,470,111,359,41111,4167,36944,35403267.0,14243114.0,21160153.0,4.336,0.5737,3.4181,0.5728
2023-06-27 12:45,728,92,636,45665,1737,43928,26108811.0,984916.0,25123894.0,707,81,626,45194,1650,43544,25860980.0,935782.0,24925197.0,0.567,0.5719,0.5671,0.5724
2023-06-27 12:50,316,65,251,14095,940,13155,8049918.0,534753.0,7515164.0,296,50,246,13870,733,13137,7923219.0,416404.0,7506814.0,0.5689,0.5713,0.5681,0.5714
2023-06-27 12:55,165,31,134,8875,2523,6352,5032302.0,1401692.0,3630610.0,154,22,132,6925,554,6371,3956294.0,315003.0,3641290.0,0.5556,0.5716,0.5686,0.5715
2023-06-27 13:00,272,63,209,22463,2272,20191,24748824.0,13169705.0,11579118.0,247,49,198,21213,1402,19811,24035206.0,12672709.0,11362497.0,5.7965,0.5735,9.039,0.5735
2023-06-27 13:05,514,20,494,16849,467,16382,9668874.0,270968.0,9397906.0,499,14,485,16527,352,16175,9483020.0,200549.0,9282471.0,0.5802,0.5737,0.5697,0.5739
2023-06-27 13:10,557,356,201,31620,19221,12399,18084038.0,10955167.0,7128871.0,539,348,191,30958,18754,12204,17703343.0,10686011.0,7017332.0,0.57,0.575,0.5698,0.575
2023-06-27 13:15,1605,975,630,85873,64708,21165,49042763.0,36893586.0,12149177.0,1588,965,623,85476,64585,20891,48804972.0,36819664.0,11985308.0,0.5702,0.574,0.5701,0.5737
2023-06-27 13:20,802,479,323,52664,37404,15260,30165337.0,21342178.0,8823159.0,796,475,321,52617,37505,15112,30106120.0,21384192.0,8721927.0,0.5706,0.5782,0.5702,0.5772
2023-06-27 13:25,481,296,185,34750,25669,9081,20301504.0,14635570.0,5665933.0,475,293,182,28464,25384,3080,16236711.0,14472014.0,1764697.0,0.5702,0.6239,0.5701,0.573
2023-06-27 13:30,924,595,329,77798,69671,8127,44367299.0,39716366.0,4650933.0,899,583,316,77434,69506,7928,44160409.0,39618642.0,4541767.0,0.5701,0.5723,0.57,0.5729
2023-06-27 13:35,429,287,142,38950,34804,4146,22215220.0,19841151.0,2374069.0,424,285,139,38906,34829,4077,22189745.0,19854886.0,2334858.0,0.5701,0.5726,0.5701,0.5727
2023-06-27 13:40,33,16,17,1083,685,398,619859.0,390650.0,229208.0,28,12,16,1355,663,692,775010.0,377918.0,397092.0,0.5703,0.5759,0.57,0.5738
2023-06-27 13:45,81,32,49,3886,2595,1291,14104599.0,13362706.0,741893.0,65,23,42,3688,2503,1185,13983576.0,13304184.0,679391.0,5.1494,0.5747,5.3153,0.5733
2023-06-27 13:50,434,12,422,5362,796,4566,3071289.0,454932.0,2616357.0,426,5,421,5119,494,4625,2932483.0,281928.0,2650555.0,0.5715,0.573,0.5707,0.5731
2023-06-27 13:55,64,37,27,5224,2149,3075,14874991.0,13104027.0,1770963.0,49,26,23,10104,1360,8744,18131728.0,12651106.0,5480622.0,6.0977,0.5759,9.3023,0.6268
2023-06-27 14:00,851,404,447,57898,11372,46526,33401715.0,6528349.0,26873365.0,815,383,432,57701,11320,46381,33269195.0,6478524.0,26790671.0,0.5741,0.5776,0.5723,0.5776
2023-06-27 14:05,787,498,289,25648,16136,9512,14712965.0,9242909.0,5470056.0,780,495,285,26138,16818,9320,14993860.0,9633305.0,5360554.0,0.5728,0.5751,0.5728,0.5752
2023-06-27 14:10,680,234,446,43967,6439,37528,25280946.0,3684014.0,21596931.0,664,223,441,44109,6454,37655,25360450.0,3692112.0,21668338.0,0.5721,0.5755,0.5721,0.5754
2023-06-27 14:15,310,160,150,14845,5523,9322,8522091.0,3162593.0,5359497.0,300,154,146,14315,5238,9077,8216465.0,2997262.0,5219203.0,0.5726,0.5749,0.5722,0.575
2023-06-27 14:20,622,107,515,56540,4175,52365,68095406.0,38010927.0,30084478.0,595,93,502,55365,4050,51315,67481281.0,37941293.0,29539987.0,9.1044,0.5745,9.3682,0.5757
2023-06-27 14:25,1164,58,1106,120849,1495,119354,70037173.0,853318.0,69183854.0,1153,52,1101,120723,1281,119442,69963751.0,729177.0,69234573.0,0.5708,0.5797,0.5692,0.5797
2023-06-27 14:30,650,76,574,55014,4840,50174,55384597.0,26515386.0,28869210.0,633,64,569,54290,4350,49940,54971486.0,26232655.0,28738831.0,5.4784,0.5754,6.0305,0.5755
2023-06-27 14:35,977,242,735,52637,22448,30189,42054608.0,24689196.0,17365411.0,964,234,730,52718,22186,30532,42096789.0,24534230.0,17562559.0,1.0998,0.5752,1.1058,0.5752
2023-06-27 14:40,920,130,790,74084,12194,61890,42589264.0,6961003.0,35628260.0,913,124,789,74011,12089,61922,42546993.0,6901000.0,35645993.0,0.5709,0.5757,0.5708,0.5757
2023-06-27 14:45,1330,22,1308,192485,1790,190695,122650487.0,12897644.0,109752843.0,1320,13,1307,191327,734,190593,121991119.0,12294877.0,109696242.0,7.2054,0.5755,16.7505,0.5756
2023-06-27 14:50,791,46,745,66701,1750,64951,50284056.0,12873936.0,37410120.0,782,41,741,66799,1729,65070,50340371.0,12861631.0,37478739.0,7.3565,0.576,7.4388,0.576
2023-06-27 14:55,847,87,760,53406,8737,44669,30694734.0,4992854.0,25701880.0,842,85,757,53018,8647,44371,30472490.0,4940714.0,25531776.0,0.5715,0.5754,0.5714,0.5754
2023-06-27 15:00,1194,45,1149,132921,3522,129399,76535795.0,2000389.0,74535406.0,1182,35,1147,132901,3681,129220,76525315.0,2092848.0,74432467.0,0.568,0.576,0.5686,0.576
2023-06-27 15:05,723,13,710,58572,667,57905,33713146.0,377775.0,33335371.0,724,13,711,58413,666,57747,33621910.0,376596.0,33245314.0,0.5664,0.5757,0.5655,0.5757
2023-06-27 15:10,192,10,182,17519,439,17080,10076643.0,249475.0,9827168.0,186,6,180,17439,501,16938,10028308.0,282647.0,9745660.0,0.5683,0.5754,0.5642,0.5754
2023-06-27 15:15,35,8,27,1759,163,1596,1006823.0,89190.0,917633.0,30,4,26,1630,38,1592,936424.0,21649.0,914775.0,0.5472,0.575,0.5697,0.5746
2023-06-27 15:20,63,7,56,792,222,570,451721.0,124738.0,326982.0,61,4,57,1127,209,918,644489.0,117305.0,527184.0,0.5619,0.5737,0.5613,0.5743
2023-06-27 15:25,266,13,253,3492,467,3025,2007141.0,266262.0,1740878.0,251,5,246,2734,252,2482,1566930.0,142873.0,1424057.0,0.5702,0.5755,0.567,0.5738
2023-06-27 15:30,794,144,650,32552,7774,24778,18672533.0,4437752.0,14234781.0,788,140,648,32281,7309,24972,18518117.0,4171816.0,14346301.0,0.5708,0.5745,0.5708,0.5745
2023-06-27 15:35,1235,415,820,94715,30961,63754,54407818.0,17681578.0,36726239.0,1231,413,818,95425,31865,63560,54809569.0,18194876.0,36614693.0,0.5711,0.5761,0.571,0.5761
2023-06-27 15:40,1543,402,1141,209009,23461,185548,132311834.0,25284368.0,107027466.0,1531,396,1135,209096,23556,185540,132358121.0,25337258.0,107020863.0,1.0777,0.5768,1.0756,0.5768
2023-06-27 15:45,1250,294,956,146105,9060,137045,84272512.0,5184681.0,79087830.0,1241,291,950,146225,9295,136930,84340041.0,5318777.0,79021263.0,0.5723,0.5771,0.5722,0.5771
2023-06-27 15:50,212,79,133,11159,2482,8677,6424122.0,1428527.0,4995594.0,204,73,131,10748,2311,8437,6179614.0,1321302.0,4858312.0,0.5756,0.5757,0.5717,0.5758
2023-06-27 15:55,48,23,25,2923,2542,381,1667657.0,1446955.0,220702.0,40,19,21,1937,1633,304,1110761.0,934354.0,176406.0,0.5692,0.5793,0.5722,0.5803
2023-06-27 16:00,119,56,63,6392,4462,1930,15542522.0,14429976.0,1112545.0,97,44,53,5888,3997,1891,15254172.0,14164096.0,1090075.0,3.234,0.5764,3.5437,0.5765
2023-06-27 16:05,490,197,293,26220,12927,13293,26934614.0,19276991.0,7657623.0,477,193,284,27928,14799,13129,27872412.0,20308454.0,7563957.0,1.4912,0.5761,1.3723,0.5761
2023-06-27 16:10,2134,269,1865,227531,11464,216067,142730375.0,18422179.0,124308196.0,2107,250,1857,225700,10995,214705,141738422.0,18155264.0,123583157.0,1.607,0.5753,1.6512,0.5756
2023-06-27 16:15,3127,309,2818,381854,10023,371831,219638789.0,5719290.0,213919498.0,3123,309,2814,381704,10023,371681,219551847.0,5719200.0,213832647.0,0.5706,0.5753,0.5706,0.5753
2023-06-27 16:20,2193,281,1912,207414,9158,198256,119274681.0,5225877.0,114048803.0,2183,273,1910,207278,9007,198271,119195067.0,5139893.0,114055174.0,0.5706,0.5753,0.5707,0.5752
2023-06-27 16:25,1658,255,1403,189267,16403,172864,132493316.0,33126058.0,99367257.0,1634,243,1391,188948,16146,172802,132308275.0,32976986.0,99331288.0,2.0195,0.5748,2.0424,0.5748
2023-06-27 16:30,449,137,312,30779,4586,26193,29574776.0,14499499.0,15075276.0,446,136,310,31579,4781,26798,30031317.0,14608032.0,15423285.0,3.1617,0.5755,3.0554,0.5755
2023-06-27 16:35,744,65,679,70183,2082,68101,40411690.0,1188347.0,39223343.0,736,57,679,70005,1937,68068,40309222.0,1105098.0,39204124.0,0.5708,0.576,0.5705,0.576
2023-06-27 16:40,25,15,10,505,293,212,290432.0,167665.0,122767.0,22,12,10,508,293,215,291190.0,166785.0,124404.0,0.5722,0.5791,0.5692,0.5786
2023-06-27 16:45,263,17,246,13621,356,13265,7815807.0,203366.0,7612441.0,253,13,240,13488,357,13131,7743864.0,203865.0,7539998.0,0.5713,0.5739,0.5711,0.5742
2023-06-27 16:50,30,7,23,1945,180,1765,1116693.0,102638.0,1014054.0,26,4,22,1929,107,1822,1107329.0,60758.0,1046570.0,0.5702,0.5745,0.5678,0.5744
2023-06-27 16:55,89,22,67,7233,418,6815,4159033.0,239317.0,3919716.0,75,16,59,6704,481,6223,3842356.0,265354.0,3577002.0,0.5725,0.5752,0.5517,0.5748
2023-06-27 17:00,88,36,52,4249,1743,2506,2439569.0,994079.0,1445490.0,74,29,45,3733,1352,2381,2143618.0,771227.0,1372391.0,0.5703,0.5768,0.5704,0.5764
2023-06-27 17:05,147,51,96,4359,1501,2858,2493714.0,858214.0,1635499.0,136,44,92,4114,1560,2554,2362174.0,891470.0,1470703.0,0.5718,0.5723,0.5715,0.5758
2023-06-27 17:10,111,53,58,4178,2639,1539,2413796.0,1528032.0,885764.0,88,40,48,3515,2211,1304,2014115.0,1264261.0,749854.0,0.579,0.5755,0.5718,0.575
2023-06-27 17:15,89,48,41,4553,2511,2042,14490933.0,13313077.0,1177855.0,82,41,41,4836,2367,2469,14653099.0,13229228.0,1423871.0,5.3019,0.5768,5.589,0.5767
2023-06-27 17:20,132,61,71,5923,3506,2417,3423865.0,2014323.0,1409542.0,122,56,66,5515,3361,2154,3162252.0,1922169.0,1240082.0,0.5745,0.5832,0.5719,0.5757
2023-06-27 17:25,36,22,14,1305,1038,267,749502.0,595218.0,154284.0,33,20,13,1288,966,322,740742.0,553529.0,187213.0,0.5734,0.5778,0.573,0.5814
2023-06-27 17:30,120,32,88,4251,1678,2573,2442830.0,962291.0,1480539.0,116,30,86,4074,1712,2362,2340593.0,981607.0,1358986.0,0.5735,0.5754,0.5734,0.5754
2023-06-27 17:35,69,15,54,4546,1257,3289,2617365.0,720292.0,1897073.0,62,8,54,9833,1088,8745,5930670.0,623708.0,5306962.0,0.573,0.5768,0.5733,0.6069
2023-06-27 17:40,45,14,31,2253,1015,1238,1288355.0,577269.0,711086.0,38,11,27,1945,787,1158,1119923.0,451174.0,668749.0,0.5687,0.5744,0.5733,0.5775
2023-06-27 17:45,612,32,580,144342,2190,142152,83129238.0,1255230.0,81874008.0,609,29,580,143948,2164,141784,82903116.0,1240305.0,81662811.0,0.5732,0.576,0.5732,0.576
2023-06-27 17:50,234,23,211,27846,1553,26293,16049526.0,889635.0,15159891.0,233,21,212,27905,1502,26403,16084182.0,860497.0,15223684.0,0.5728,0.5766,0.5729,0.5766
2023-06-27 17:55,225,81,144,18009,3589,14420,10378224.0,2057947.0,8320276.0,198,64,134,17809,3393,14416,10291277.0,1943742.0,8347534.0,0.5734,0.577,0.5729,0.579
2023-06-27 18:00,112,45,67,9812,2244,7568,5676282.0,1285445.0,4390837.0,99,35,64,10596,3121,7475,6106218.0,1767642.0,4338576.0,0.5728,0.5802,0.5664,0.5804
2023-06-27 18:05,157,63,94,8989,4267,4722,5179575.0,2449775.0,2729800.0,130,52,78,7502,2810,4692,4318485.0,1608530.0,2709955.0,0.5741,0.5781,0.5724,0.5776
2023-06-27 18:10,390,47,343,11586,1745,9841,6672094.0,1002101.0,5669993.0,379,38,341,12027,1666,10361,6926465.0,956121.0,5970344.0,0.5743,0.5762,0.5739,0.5762
2023-06-27 18:15,170,52,118,8711,1494,7217,16913619.0,12742559.0,4171059.0,139,40,99,7837,1410,6427,16400746.0,12685938.0,3714808.0,8.5292,0.5779,8.9971,0.578
2023-06-27 18:20,231,111,120,13755,2951,10804,7937229.0,1693695.0,6243534.0,226,109,117,13823,2963,10860,7975442.0,1699258.0,6276184.0,0.5739,0.5779,0.5735,0.5779
2023-06-27 18:25,286,125,161,19302,3168,16134,11141550.0,1819249.0,9322301.0,277,118,159,19287,3111,16176,11132210.0,1784786.0,9347423.0,0.5743,0.5778,0.5737,0.5779
2023-06-27 18:30,234,129,105,11846,6284,5562,6822558.0,3616679.0,3205879.0,216,120,96,12109,6782,5327,6964639.0,3891530.0,3073108.0,0.5755,0.5764,0.5738,0.5769
2023-06-27 18:35,440,197,243,25226,14420,10806,14501635.0,8276850.0,6224784.0,431,191,240,25577,14506,11071,14703792.0,8320337.0,6383455.0,0.574,0.576,0.5736,0.5766
2023-06-28 10:00,2243,399,1844,163462,31858,131604,105203595.0,29121875.0,76081720.0,1980,272,1708,142581,16314,126267,86649414.0,13907336.0,72742077.0,0.9141,0.5781,0.8525,0.5761
2023-06-28 10:05,1512,908,604,151618,98726,52892,230497062.0,199452096.0,31044966.0,1316,823,493,135945,93205,42740,216310782.0,191420770.0,24890012.0,2.0203,0.587,2.0538,0.5824
2023-06-28 10:10,2878,1627,1251,253467,171968,81499,182926399.0,135372306.0,47554092.0,2623,1485,1138,245854,168008,77846,178472412.0,133060824.0,45411588.0,0.7872,0.5835,0.792,0.5834
2023-06-28 10:15,3258,1204,2054,248595,117312,131283,179956645.0,103501179.0,76455466.0,3159,1157,2002,246292,118201,128091,178621438.0,104017533.0,74603905.0,0.8823,0.5824,0.88,0.5824
2023-06-28 10:20,2787,1015,1772,226487,98075,128412,131436407.0,56681304.0,74755103.0,2658,964,1694,225630,97892,127738,130942658.0,56579226.0,74363431.0,0.5779,0.5822,0.578,0.5822
2023-06-28 10:25,1599,576,1023,94390,30253,64137,66578283.0,29323101.0,37255182.0,1544,544,1000,94813,31749,63064,66829349.0,30185576.0,36643773.0,0.9693,0.5809,0.9508,0.5811
2023-06-28 10:30,3309,793,2516,343562,73360,270202,222817211.0,65997859.0,156819352.0,3221,748,2473,340281,71869,268412,220894306.0,65116699.0,155777607.0,0.8996,0.5804,0.906,0.5804
2023-06-28 10:35,973,354,619,65361,8031,57330,49775557.0,16499366.0,33276191.0,935,332,603,62776,7585,55191,48271304.0,16238527.0,32032777.0,2.0545,0.5804,2.1409,0.5804
2023-06-28 10:40,1630,768,862,151720,58870,92850,99595423.0,45802016.0,53793406.0,1580,737,843,150515,58104,92411,98884518.0,45343812.0,53540706.0,0.778,0.5794,0.7804,0.5794
2023-06-28 10:45,2028,596,1432,179799,53698,126101,115674380.0,42748169.0,72926211.0,1988,571,1417,178816,53594,125222,115156172.0,42689660.0,72466511.0,0.7961,0.5783,0.7965,0.5787
2023-06-28 10:50,301,124,177,13591,8705,4886,7784960.0,5008186.0,2776773.0,261,104,157,12481,8645,3836,7187906.0,4971965.0,2215941.0,0.5753,0.5683,0.5751,0.5777
2023-06-28 10:55,877,262,615,75436,21412,54024,43547671.0,12310243.0,31237427.0,856,248,608,75177,21003,54174,43417858.0,12071079.0,31346778.0,0.5749,0.5782,0.5747,0.5786
2023-06-28 11:00,1771,516,1255,207917,45802,162115,120106801.0,26308442.0,93798359.0,1742,496,1246,206404,44745,161659,119259185.0,25726557.0,93532628.0,0.5744,0.5786,0.575,0.5786
2023-06-28 11:05,982,255,727,70292,17697,52595,40602610.0,10177786.0,30424823.0,968,249,719,70013,17483,52530,40444564.0,10053647.0,30390916.0,0.5751,0.5785,0.5751,0.5785
2023-06-28 11:10,1086,525,561,77932,31687,46245,68720691.0,41984627.0,26736064.0,1042,495,547,77202,31180,46022,68315657.0,41673599.0,26642058.0,1.325,0.5781,1.3365,0.5789
2023-06-28 11:15,1079,521,558,66764,31394,35370,50409122.0,29939002.0,20470120.0,1067,512,555,66452,31410,35042,50220007.0,29940238.0,20279769.0,0.9537,0.5787,0.9532,0.5787
2023-06-28 11:20,1078,756,322,51745,26520,25225,53647909.0,39029064.0,14618844.0,1047,735,312,51118,26119,24999,53282844.0,38793764.0,14489079.0,1.4717,0.5795,1.4853,0.5796
2023-06-28 11:25,946,429,517,60460,22243,38217,34904789.0,12792709.0,22112080.0,934,426,508,60182,22143,38039,34755567.0,12735764.0,22019802.0,0.5751,0.5786,0.5752,0.5789
2023-06-28 11:30,843,326,517,67688,21132,46556,39099408.0,12150183.0,26949225.0,832,323,509,67509,21147,46362,39004759.0,12157569.0,26847190.0,0.575,0.5789,0.5749,0.5791
2023-06-28 11:35,1424,1290,134,89360,75007,14353,51538692.0,43230488.0,8308204.0,1390,1267,123,88422,74235,14187,50948443.0,42740245.0,8208198.0,0.5764,0.5788,0.5757,0.5786
2023-06-28 11:40,203,143,60,12819,7105,5714,7389482.0,4090196.0,3299286.0,191,140,51,12525,7040,5485,7222475.0,4052838.0,3169636.0,0.5757,0.5774,0.5757,0.5779
2023-06-28 11:45,374,92,282,15377,4805,10572,8890996.0,2759655.0,6131341.0,361,85,276,15115,4575,10540,8741421.0,2627540.0,6113880.0,0.5743,0.58,0.5743,0.5801
2023-06-28 11:50,629,163,466,37802,9101,28701,21852040.0,5234381.0,16617659.0,615,161,454,37384,9064,28320,21605105.0,5214095.0,16391010.0,0.5751,0.579,0.5753,0.5788
2023-06-28 11:55,209,92,117,16633,5769,10864,33327926.0,27052015.0,6275911.0,172,69,103,11097,3881,7216,30154689.0,25975467.0,4179222.0,4.6892,0.5777,6.693,0.5792
2023-06-28 12:00,913,430,483,68034,23327,44707,39156057.0,13360072.0,25795984.0,892,412,480,70813,22904,47909,40766778.0,13121189.0,27645588.0,0.5727,0.577,0.5729,0.577
2023-06-28 12:05,2598,1012,1586,216480,79685,136795,148300800.0,69391281.0,78909518.0,2578,1003,1575,216005,79321,136684,148034528.0,69189182.0,78845345.0,0.8708,0.5768,0.8723,0.5768
2023-06-28 12:10,1326,467,859,99247,33703,65544,57121076.0,19298323.0,37822753.0,1313,460,853,98930,33649,65281,56937251.0,19267261.0,37669989.0,0.5726,0.5771,0.5726,0.577
2023-06-28 12:15,627,219,408,59709,16754,42955,34385265.0,9595419.0,24789846.0,621,215,406,59630,16849,42781,34339620.0,9648494.0,24691126.0,0.5727,0.5771,0.5726,0.5772
2023-06-28 12:20,541,75,466,38616,3684,34932,22230437.0,2102770.0,20127667.0,524,59,465,38192,3451,34741,21988337.0,1970119.0,20018218.0,0.5708,0.5762,0.5709,0.5762
2023-06-28 12:25,1087,223,864,171350,24382,146968,98804555.0,13964814.0,84839740.0,1071,212,859,171124,24355,146769,98685724.0,13949194.0,84736530.0,0.5728,0.5773,0.5727,0.5773
2023-06-28 12:30,1027,121,906,153691,11880,141811,88600800.0,6807755.0,81793045.0,1018,115,903,153685,11848,141837,88599560.0,6789050.0,81810510.0,0.573,0.5768,0.573,0.5768
2023-06-28 12:35,814,253,561,99540,20018,79522,57362979.0,11481152.0,45881827.0,807,245,562,99873,19938,79935,57555344.0,11435113.0,46120230.0,0.5735,0.577,0.5735,0.577
2023-06-28 12:40,1850,1707,143,89580,77534,12046,75242038.0,68283994.0,6958044.0,1837,1696,141,89400,77483,11917,75136441.0,68253882.0,6882559.0,0.8807,0.5776,0.8809,0.5775
2023-06-28 12:45,736,657,79,29973,22451,7522,17260409.0,12905476.0,4354933.0,720,653,67,29114,22409,6705,16757487.0,12873052.0,3884435.0,0.5748,0.579,0.5745,0.5793
2023-06-28 12:50,83,71,12,3918,2738,1180,2223821.0,1540096.0,683725.0,63,56,7,3172,2082,1090,1805127.0,1173386.0,631740.0,0.5625,0.5794,0.5636,0.5796
2023-06-28 12:55,300,175,125,16261,4707,11554,9386556.0,2707510.0,6679046.0,279,168,111,16187,4660,11527,9344756.0,2680064.0,6664691.0,0.5752,0.5781,0.5751,0.5782
2023-06-28 13:00,56,31,25,2459,1713,746,1416594.0,985131.0,431463.0,53,30,23,2417,1675,742,1392470.0,963163.0,429306.0,0.5751,0.5784,0.575,0.5786
2023-06-28 13:05,219,146,73,13854,6188,7666,8056893.0,3632224.0,4424669.0,194,137,57,11726,5054,6672,6759223.0,2895495.0,3863728.0,0.587,0.5772,0.5729,0.5791
2023-06-28 13:10,567,237,330,28022,13843,14179,16109629.0,7944389.0,8165239.0,550,232,318,25369,12231,13138,14647285.0,7034925.0,7612359.0,0.5739,0.5759,0.5752,0.5794
2023-06-28 13:15,1033,166,867,120396,15645,104751,69580634.0,8975241.0,60605392.0,1017,160,857,120302,15619,104683,69528204.0,8960478.0,60567726.0,0.5737,0.5786,0.5737,0.5786
2023-06-28 13:20,1087,223,864,132002,16054,115948,88068225.0,21090674.0,66977551.0,1074,214,860,131305,15797,115508,87691999.0,20944979.0,66747020.0,1.3137,0.5777,1.3259,0.5779
2023-06-28 13:25,914,123,791,66656,4537,62119,38498178.0,2603887.0,35894291.0,901,114,787,66450,4476,61974,38380494.0,2566946.0,35813548.0,0.5739,0.5778,0.5735,0.5779
2023-06-28 13:30,1015,422,593,86458,26261,60197,49873980.0,15058343.0,34815637.0,1002,412,590,84289,24046,60243,48629799.0,13784424.0,34845375.0,0.5734,0.5784,0.5733,0.5784
2023-06-28 13:35,2181,793,1388,207515,46183,161332,119621869.0,26526826.0,93095043.0,2179,793,1386,207519,46180,161339,119623641.0,26524828.0,93098813.0,0.5744,0.577,0.5744,0.577
2023-06-28 13:40,2256,891,1365,230211,68712,161499,132670326.0,39477881.0,93192444.0,2234,878,1356,229966,68509,161457,132526594.0,39358751.0,93167843.0,0.5745,0.577,0.5745,0.577
2023-06-28 13:45,1316,891,425,121096,61826,59270,81676934.0,47413207.0,34263727.0,1318,889,429,120821,61757,59064,81517537.0,47372824.0,34144713.0,0.7669,0.5781,0.7671,0.5781
2023-06-28 13:50,521,385,136,33542,12700,20842,19360537.0,7304252.0,12056284.0,514,381,133,33563,12601,20962,19371495.0,7246056.0,12125438.0,0.5751,0.5785,0.575,0.5784
2023-06-28 13:55,619,334,285,38355,8679,29676,22137119.0,4990310.0,17146808.0,610,332,278,37559,7679,29880,21686406.0,4415311.0,17271094.0,0.575,0.5778,0.575,0.578
2023-06-28 14:00,386,130,256,41720,10841,30879,24066112.0,6238225.0,17827887.0,376,123,253,41252,10690,30562,23792574.0,6146397.0,17646176.0,0.5754,0.5773,0.575,0.5774
2023-06-28 14:05,60,42,18,3427,1769,1658,1980118.0,1017092.0,963026.0,55,36,19,3621,1777,1844,2092196.0,1021932.0,1070264.0,0.575,0.5808,0.5751,0.5804
2023-06-28 14:10,441,90,351,16847,4439,12408,9725285.0,2552632.0,7172653.0,436,89,347,17229,5291,11938,9942746.0,3043068.0,6899677.0,0.575,0.5781,0.5751,0.578
2023-06-28 14:15,623,34,589,45630,2033,43597,26377349.0,1169698.0,25207651.0,615,28,587,45419,1925,43494,26257557.0,1107128.0,25150429.0,0.5754,0.5782,0.5751,0.5783
2023-06-28 14:20,147,19,128,21922,1928,19994,12673164.0,1108347.0,11564816.0,139,16,123,18937,916,18021,10949827.0,525961.0,10423865.0,0.5749,0.5784,0.5742,0.5784
2023-06-28 14:25,16,10,6,381,36,345,215943.0,21114.0,194828.0,9,6,3,100,65,35,58617.0,37338.0,21279.0,0.5865,0.5647,0.5744,0.608
2023-06-28 14:30,16,7,9,420,10,410,243691.0,6116.0,237574.0,10,3,7,346,3,343,200533.0,1714.0,198818.0,0.6117,0.5795,0.5715,0.5796
2023-06-28 14:35,12,9,3,156,134,22,89458.0,76605.0,12852.0,8,5,3,43,21,22,24806.0,11996.0,12810.0,0.5717,0.5842,0.5713,0.5823
2023-06-28 14:40,49,20,29,2600,661,1939,1499517.0,379257.0,1120259.0,38,12,26,2096,238,1858,1211540.0,136602.0,1074937.0,0.5738,0.5778,0.574,0.5785
2023-06-28 14:45,34,14,20,2138,319,1819,1230874.0,182881.0,1047993.0,30,14,16,1219,319,900,705086.0,182880.0,522206.0,0.5733,0.5761,0.5733,0.5802
2023-06-28 14:50,182,134,48,18286,11320,6966,10510732.0,6484768.0,4025963.0,174,129,45,19088,11057,8031,10985426.0,6344876.0,4640549.0,0.5729,0.5779,0.5738,0.5778
2023-06-28 14:55,184,142,42,15802,12290,3512,9076674.0,7055812.0,2020862.0,168,132,36,15345,12057,3288,8818564.0,6922010.0,1896553.0,0.5741,0.5754,0.5741,0.5768
2023-06-28 15:00,166,97,69,14881,7904,6977,20453531.0,16416024.0,4037507.0,151,90,61,14615,7709,6906,20300655.0,16303324.0,3997331.0,2.0769,0.5787,2.1148,0.5788
2023-06-28 15:05,259,108,151,29588,7699,21889,17064393.0,4420459.0,12643934.0,260,108,152,31478,7763,23715,18155973.0,4457256.0,13698717.0,0.5742,0.5776,0.5742,0.5776
2023-06-28 15:10,480,121,359,77187,10388,66799,44503586.0,5958031.0,38545555.0,483,123,360,76869,10386,66483,44321404.0,5956585.0,38364819.0,0.5735,0.577,0.5735,0.5771
2023-06-28 15:15,822,159,663,135332,19656,115676,77952587.0,11275480.0,66677106.0,810,156,654,133861,19266,114595,77113685.0,11050580.0,66063104.0,0.5736,0.5764,0.5736,0.5765
2023-06-28 15:20,685,173,512,87160,8895,78265,50235959.0,5107086.0,45128872.0,671,163,508,87218,8701,78517,50267220.0,4993413.0,45273806.0,0.5742,0.5766,0.5739,0.5766
2023-06-28 15:25,713,452,261,43575,9200,34375,25145057.0,5284698.0,19860359.0,705,448,257,43418,9126,34292,25056919.0,5242764.0,19814155.0,0.5744,0.5778,0.5745,0.5778
2023-06-28 15:30,419,228,191,24323,3211,21112,14016900.0,1842706.0,12174194.0,419,229,190,27100,6003,21097,15598613.0,3433250.0,12165362.0,0.5739,0.5766,0.5719,0.5766
2023-06-28 15:35,286,240,46,7659,2658,5001,4410603.0,1526917.0,2883686.0,281,242,39,4804,2805,1999,2764174.0,1611069.0,1153105.0,0.5745,0.5766,0.5744,0.5768
2023-06-28 15:40,240,224,16,4687,2541,2146,2705925.0,1460745.0,1245180.0,233,216,17,7418,2438,4980,4287887.0,1401898.0,2885989.0,0.5749,0.5802,0.575,0.5795
2023-06-28 15:45,93,70,23,5340,3991,1349,3077584.0,2292554.0,785030.0,85,68,17,4869,3923,946,2802444.0,2253018.0,549426.0,0.5744,0.5819,0.5743,0.5808
2023-06-28 15:50,68,43,25,4543,2363,2180,2622192.0,1356704.0,1265487.0,66,40,26,4221,2176,2045,2438771.0,1249748.0,1189023.0,0.5741,0.5805,0.5743,0.5814
2023-06-28 15:55,56,13,43,5802,477,5325,3365190.0,274001.0,3091188.0,48,12,36,3173,434,2739,1832438.0,249271.0,1583166.0,0.5744,0.5805,0.5744,0.578
2023-06-28 16:00,121,29,92,15541,914,14627,8988269.0,524159.0,8464110.0,115,26,89,14214,656,13558,8230471.0,376901.0,7853570.0,0.5735,0.5787,0.5745,0.5793
2023-06-28 16:05,59,20,39,6703,888,5815,3869675.0,506514.0,3363161.0,60,17,43,9366,614,8752,5415827.0,352702.0,5063125.0,0.5704,0.5784,0.5744,0.5785
2023-06-28 16:10,165,68,97,9050,3092,5958,5148029.0,1772241.0,3375788.0,164,73,91,7136,3098,4038,4104289.0,1765840.0,2338449.0,0.5732,0.5666,0.57,0.5791
2023-06-28 16:15,431,15,416,6135,976,5159,3529593.0,557958.0,2971635.0,424,8,416,6915,975,5940,3978649.0,556972.0,3421676.0,0.5717,0.576,0.5713,0.576
2023-06-28 16:20,75,36,39,3541,1967,1574,2040822.0,1127586.0,913236.0,69,35,34,3296,1957,1339,1900418.0,1122048.0,778369.0,0.5733,0.5802,0.5734,0.5813
2023-06-28 16:25,268,162,106,14382,7926,6456,8311488.0,4542065.0,3769422.0,257,156,101,14296,7878,6418,8261918.0,4514231.0,3747686.0,0.5731,0.5839,0.573,0.5839
2023-06-28 16:30,246,148,98,15225,9950,5275,8771651.0,5700846.0,3070804.0,238,144,94,15035,9901,5134,8663097.0,5671839.0,2991258.0,0.5729,0.5821,0.5729,0.5826
2023-06-28 16:35,105,96,9,4378,4029,349,2497946.0,2297073.0,200873.0,87,79,8,4119,3947,172,2357530.0,2258460.0,99070.0,0.5701,0.5756,0.5722,0.576
2023-06-28 16:40,92,70,22,3524,3198,326,2018055.0,1829747.0,188308.0,89,68,21,3308,2986,322,1894484.0,1708466.0,186017.0,0.5722,0.5776,0.5722,0.5777
2023-06-28 16:45,79,68,11,3654,3349,305,2091706.0,1916230.0,175475.0,81,73,8,3843,3550,293,2193643.0,2024313.0,169329.0,0.5722,0.5753,0.5702,0.5779
2023-06-28 16:50,71,48,23,2362,2152,210,1352535.0,1231885.0,120650.0,62,42,20,2233,2025,208,1278562.0,1158964.0,119597.0,0.5724,0.5745,0.5723,0.575
2023-06-28 16:55,19,7,12,311,132,179,179682.0,75624.0,104058.0,13,6,7,237,122,115,137432.0,69797.0,67634.0,0.5729,0.5813,0.5721,0.5881
2023-06-28 17:00,19,4,15,567,16,551,322175.0,9143.0,313032.0,31,5,26,674,40,634,389794.0,22921.0,366873.0,0.5714,0.5681,0.573,0.5787
2023-06-28 17:05,17,10,7,901,161,740,520652.0,92293.0,428358.0,11,5,6,1115,121,994,646302.0,69283.0,577018.0,0.5733,0.5789,0.5726,0.5805
2023-06-28 17:10,14,6,8,755,160,595,434674.0,91576.0,343097.0,15,6,9,1769,354,1415,1022251.0,202564.0,819686.0,0.5724,0.5766,0.5722,0.5793
2023-06-28 17:15,68,34,34,4024,2047,1977,2313322.0,1171921.0,1141400.0,65,32,33,3646,2046,1600,2093249.0,1171607.0,921642.0,0.5725,0.5773,0.5726,0.576
2023-06-28 17:20,73,54,19,4069,2935,1134,14199411.0,13557637.0,641774.0,68,48,20,3879,2716,1163,14106786.0,13433003.0,673783.0,4.6193,0.5659,4.9459,0.5793
2023-06-28 17:25,183,131,52,7587,6436,1151,4326011.0,3684455.0,641556.0,167,119,48,7888,6335,1553,4523148.0,3625689.0,897459.0,0.5725,0.5574,0.5723,0.5779
2023-06-28 17:30,189,126,63,13479,11325,2154,7713342.0,6470893.0,1242449.0,176,115,61,10311,8215,2096,5914623.0,4705019.0,1209604.0,0.5714,0.5768,0.5727,0.5771
2023-06-28 17:35,94,76,18,4436,4183,253,2541482.0,2396913.0,144569.0,88,73,15,4384,4128,256,2512471.0,2365273.0,147197.0,0.573,0.5714,0.573,0.575
2023-06-28 17:40,278,223,55,10567,7661,2906,6100213.0,4427279.0,1672933.0,260,213,47,8954,7267,1687,5128841.0,4157083.0,971757.0,0.5779,0.5757,0.572,0.576
2023-06-28 17:45,84,64,20,3269,2173,1096,1877848.0,1245952.0,631895.0,82,62,20,3260,2166,1094,1872384.0,1241894.0,630489.0,0.5734,0.5765,0.5734,0.5763
2023-06-28 17:50,29,25,4,910,787,123,522548.0,451351.0,71197.0,30,24,6,982,790,192,565325.0,453090.0,112235.0,0.5735,0.5788,0.5735,0.5846
2023-06-28 17:55,282,276,6,9025,8954,71,5174702.0,5132304.0,42398.0,275,271,4,9228,9192,36,5285530.0,5264074.0,21456.0,0.5732,0.5972,0.5727,0.596
2023-06-28 18:00,232,225,7,7006,6944,62,4016610.0,3980922.0,35687.0,232,227,5,7791,7763,28,4448827.0,4432683.0,16144.0,0.5733,0.5756,0.571,0.5766
2023-06-28 18:05,133,106,27,4940,4496,444,2830962.0,2575763.0,255198.0,129,102,27,5175,4361,814,2972111.0,2498397.0,473714.0,0.5729,0.5748,0.5729,0.582
2023-06-28 18:10,300,95,205,19489,3288,16201,11228196.0,1887584.0,9340612.0,286,88,198,18857,2885,15972,10862534.0,1652512.0,9210021.0,0.5741,0.5765,0.5728,0.5766
2023-06-28 18:15,632,186,446,46609,7107,39502,26804678.0,4067739.0,22736939.0,625,179,446,49875,10003,39872,28671958.0,5716814.0,22955144.0,0.5724,0.5756,0.5715,0.5757
2023-06-28 18:20,1068,308,760,114839,12957,101882,66052155.0,7411702.0,58640452.0,1062,302,760,114184,12902,101282,65674252.0,7380170.0,58294081.0,0.572,0.5756,0.572,0.5756
2023-06-28 18:25,285,70,215,31443,1580,29863,18167573.0,904240.0,17263332.0,277,64,213,31508,1571,29937,18204048.0,898718.0,17305330.0,0.5723,0.5781,0.5721,0.5781
2023-06-28 18:30,197,61,136,22319,1643,20676,12848112.0,940297.0,11907814.0,188,57,131,18996,1444,17552,10942085.0,826119.0,10115966.0,0.5723,0.5759,0.5721,0.5763
2023-06-28 18:35,805,197,608,91700,4310,87390,52710893.0,2467429.0,50243464.0,797,193,604,94942,4303,90639,54574621.0,2463017.0,52111604.0,0.5725,0.5749,0.5724,0.5749
2023-06-29 10:00,4522,901,3621,502138,45492,456646,338651927.0,75069398.0,263582529.0,4230,758,3472,484796,35182,449614,319167286.0,60161792.0,259005494.0,1.6502,0.5772,1.71,0.5761
2023-06-29 10:05,2929,362,2567,343957,7549,336408,221604634.0,28004494.0,193600140.0,2742,244,2498,347106,5146,341960,221115062.0,24304541.0,196810521.0,3.7097,0.5755,4.723,0.5755
2023-06-29 10:10,3230,638,2592,438514,14622,423892,276048215.0,31949111.0,244099104.0,3140,583,2557,436575,13088,423487,275064135.0,31204167.0,243859967.0,2.185,0.5759,2.3842,0.5758
2023-06-29 10:15,1705,228,1477,185250,4215,181035,118662337.0,14269258.0,104393079.0,1653,196,1457,182572,3122,179450,117073435.0,13655872.0,103417563.0,3.3854,0.5766,4.3741,0.5763
2023-06-29 10:20,1660,236,1424,208164,8277,199887,155379628.0,40289757.0,115089871.0,1546,155,1391,203567,4146,199421,152804923.0,37975814.0,114829108.0,4.8677,0.5758,9.1596,0.5758
2023-06-29 10:25,973,165,808,132028,7793,124235,111906685.0,40102159.0,71804526.0,895,139,756,124895,4932,119963,107720770.0,38427996.0,69292774.0,5.1459,0.578,7.7916,0.5776
2023-06-29 10:30,633,346,287,16443,8707,7736,21413017.0,16904480.0,4508537.0,549,306,243,12012,6450,5562,18811239.0,15586643.0,3224596.0,1.9415,0.5828,2.4165,0.5798
2023-06-29 10:35,696,557,139,16712,5828,10884,9641882.0,3362401.0,6279480.0,654,537,117,16180,5725,10455,9358367.0,3298243.0,6060124.0,0.5769,0.5769,0.5761,0.5796
2023-06-29 10:40,244,65,179,24355,2088,22267,14110414.0,1205327.0,12905086.0,218,54,164,24762,1885,22877,14348467.0,1088409.0,13260058.0,0.5773,0.5796,0.5774,0.5796
2023-06-29 10:45,1080,646,434,85363,16612,68751,49458908.0,9619038.0,39839870.0,1060,635,425,84520,16002,68518,48945005.0,9244474.0,39700530.0,0.579,0.5795,0.5777,0.5794
2023-06-29 10:50,711,514,197,22444,12612,9832,12969287.0,7274235.0,5695051.0,682,495,187,20867,12318,8549,12064551.0,7112004.0,4952547.0,0.5768,0.5792,0.5774,0.5793
2023-06-29 10:55,403,127,276,37589,4142,33447,33626855.0,14257984.0,19368870.0,367,111,256,34677,3453,31224,31950305.0,13867298.0,18083006.0,3.4423,0.5791,4.016,0.5791
2023-06-29 11:00,223,75,148,16299,2711,13588,21273528.0,13431840.0,7841688.0,191,49,142,10848,1993,8855,18147101.0,13019302.0,5127799.0,4.9546,0.5771,6.5325,0.5791
2023-06-29 11:05,287,250,37,4734,3563,1171,14604943.0,13926551.0,678391.0,272,244,28,4386,3606,780,14402086.0,13950337.0,451749.0,3.9087,0.5793,3.8686,0.5792
2023-06-29 11:10,366,320,46,11787,10553,1234,6779868.0,6077555.0,702313.0,340,305,35,11255,10355,900,6482163.0,5961035.0,521128.0,0.5759,0.5691,0.5757,0.579
2023-06-29 11:15,330,233,97,9814,7950,1864,5641440.0,4573439.0,1068001.0,258,207,51,9654,7786,1868,5560224.0,4481068.0,1079155.0,0.5753,0.573,0.5755,0.5777
2023-06-29 11:20,981,263,718,110140,12080,98060,87213101.0,30697922.0,56515179.0,939,245,694,104805,11538,93267,84148546.0,30386924.0,53761621.0,2.5412,0.5763,2.6336,0.5764
2023-06-29 11:25,1647,128,1519,133394,9781,123613,76819920.0,5612064.0,71207856.0,1619,110,1509,132799,9555,123244,76480526.0,5484261.0,70996264.0,0.5738,0.5761,0.574,0.5761
2023-06-29 11:30,2776,300,2476,442777,6726,436051,266887435.0,15725538.0,251161897.0,2829,288,2541,442360,6418,435942,266652661.0,15550612.0,251102049.0,2.338,0.576,2.423,0.576
2023-06-29 11:35,2114,181,1933,333707,2937,330770,192219864.0,1680291.0,190539572.0,2096,169,1927,332808,2189,330619,191692865.0,1251619.0,190441246.0,0.5721,0.576,0.5718,0.576
2023-06-29 11:40,2841,204,2637,464691,1187,463504,267680337.0,679678.0,267000659.0,2813,188,2625,463542,1026,462516,267000379.0,587218.0,266413160.0,0.5726,0.576,0.5723,0.576
2023-06-29 11:45,2156,79,2077,359027,2171,356856,206740105.0,1241481.0,205498624.0,2144,79,2065,359530,2962,356568,207026228.0,1692058.0,205334170.0,0.5718,0.5759,0.5713,0.5759
2023-06-29 11:50,2358,49,2309,423876,1304,422572,244127208.0,745986.0,243381221.0,2345,37,2308,423109,809,422300,243688231.0,462814.0,243225417.0,0.5721,0.576,0.5721,0.576
2023-06-29 11:55,1239,18,1221,231293,34,231259,133244044.0,19521.0,133224522.0,1223,7,1216,231244,7,231237,133214366.0,3981.0,133210384.0,0.5742,0.5761,0.5687,0.5761
2023-06-29 12:00,796,166,630,117602,1814,115788,67722268.0,1036838.0,66685430.0,782,154,628,117220,1471,115749,67504480.0,842096.0,66662383.0,0.5716,0.5759,0.5725,0.5759
2023-06-29 12:05,1278,84,1194,198783,570,198213,114477185.0,327457.0,114149728.0,1270,78,1192,199675,515,199160,115009458.0,294275.0,114715183.0,0.5745,0.5759,0.5714,0.576
2023-06-29 12:10,1736,85,1651,261157,1582,259575,150350608.0,908475.0,149442133.0,1720,73,1647,260775,1262,259513,150126758.0,721244.0,149405513.0,0.5743,0.5757,0.5715,0.5757
2023-06-29 12:15,2203,29,2174,373416,882,372534,215171289.0,504717.0,214666572.0,2210,39,2171,372570,958,371612,214637969.0,539086.0,214098883.0,0.5722,0.5762,0.5627,0.5761
2023-06-29 12:20,1275,28,1247,215800,1017,214783,124347194.0,582469.0,123764725.0,1259,22,1237,215073,1004,214069,123921256.0,575010.0,123346246.0,0.5727,0.5762,0.5727,0.5762
2023-06-29 12:25,549,24,525,77114,740,76374,44390454.0,418113.0,43972341.0,535,13,522,76248,170,76078,43908137.0,97039.0,43811097.0,0.565,0.5758,0.5708,0.5759
2023-06-29 12:30,1868,62,1806,289363,2244,287119,166680986.0,1283576.0,165397409.0,1861,57,1804,289253,2263,286990,166618538.0,1295728.0,165322810.0,0.572,0.5761,0.5726,0.5761
2023-06-29 12:35,2548,14,2534,434902,454,434448,250572201.0,261366.0,250310834.0,2535,7,2528,434435,57,434378,250303394.0,32618.0,250270775.0,0.5757,0.5762,0.5723,0.5762
2023-06-29 12:40,2162,16,2146,386818,332,386486,222852484.0,190029.0,222662454.0,2158,13,2145,386938,309,386629,222922375.0,177003.0,222745371.0,0.5724,0.5761,0.5728,0.5761
2023-06-29 12:45,1922,108,1814,321361,2571,318790,185099544.0,1473551.0,183625993.0,1915,106,1809,321439,2588,318851,185144995.0,1483163.0,183661832.0,0.5731,0.576,0.5731,0.576
2023-06-29 12:50,2107,75,2032,347564,573,346991,200133082.0,328386.0,199804696.0,2091,65,2026,347331,447,346884,200005892.0,256087.0,199749805.0,0.5731,0.5758,0.5729,0.5758
2023-06-29 12:55,3007,127,2880,470088,2079,468009,270567610.0,1188487.0,269379123.0,3000,120,2880,469708,1815,467893,270354582.0,1038387.0,269316195.0,0.5717,0.5756,0.5721,0.5756
2023-06-29 13:00,2179,79,2100,324432,1650,322782,186663610.0,942950.0,185720660.0,2166,70,2096,324981,1762,323219,186979199.0,1007395.0,185971804.0,0.5715,0.5754,0.5717,0.5754
2023-06-29 13:05,2836,109,2727,464134,4001,460133,267019203.0,2287662.0,264731540.0,2828,107,2721,463688,3955,459733,266764965.0,2261516.0,264503448.0,0.5718,0.5753,0.5718,0.5753
2023-06-29 13:10,1745,107,1638,265374,3715,261659,152637817.0,2124363.0,150513454.0,1735,100,1635,265258,3689,261569,152571083.0,2109427.0,150461655.0,0.5718,0.5752,0.5718,0.5752
2023-06-29 13:15,2320,129,2191,362782,6383,356399,220633138.0,15532461.0,205100677.0,2310,121,2189,359947,3572,356375,219004827.0,13920339.0,205084488.0,2.4334,0.5755,3.8971,0.5755
2023-06-29 13:20,1539,275,1264,176849,15092,161757,101851281.0,8644487.0,93206794.0,1530,270,1260,178321,16652,161669,102694746.0,9538289.0,93156456.0,0.5728,0.5762,0.5728,0.5762
2023-06-29 13:25,490,200,290,58485,20153,38332,33631862.0,11547281.0,22084581.0,485,196,289,57825,19633,38192,33252210.0,11248700.0,22003510.0,0.573,0.5761,0.5729,0.5761
2023-06-29 13:30,1099,902,197,126601,113108,13493,72634725.0,64860747.0,7773978.0,1067,880,187,126870,113789,13081,72754518.0,65218221.0,7536297.0,0.5734,0.5761,0.5732,0.5761
2023-06-29 13:35,421,120,301,46344,14565,31779,38518526.0,20215485.0,18303041.0,418,120,298,46282,14409,31873,38486140.0,20126783.0,18359356.0,1.3879,0.5759,1.3968,0.576
2023-06-29 13:40,1176,85,1091,145118,14672,130446,83549800.0,8400148.0,75149651.0,1165,79,1086,142678,12416,130262,82151672.0,7108350.0,75043321.0,0.5725,0.5761,0.5725,0.5761
2023-06-29 13:45,123,107,16,15263,14566,697,8747733.0,8344588.0,403145.0,117,106,11,17236,16609,627,9877947.0,9515037.0,362910.0,0.5729,0.5784,0.5729,0.5788
2023-06-29 13:50,50,33,17,3362,2224,1138,1937486.0,1273142.0,664343.0,49,33,16,4298,2807,1491,2474048.0,1606193.0,867854.0,0.5725,0.5838,0.5722,0.5821
2023-06-29 13:55,175,165,10,4080,3223,857,14223002.0,13727204.0,495797.0,168,160,8,3143,2764,379,13682903.0,13463571.0,219332.0,4.2591,0.5785,4.871,0.5787
2023-06-29 14:00,65,36,29,4587,2843,1744,2634580.0,1629061.0,1005519.0,55,27,28,4130,2743,1387,2371653.0,1571072.0,800581.0,0.573,0.5766,0.5728,0.5772
2023-06-29 14:05,98,79,19,2482,1114,1368,1432812.0,645029.0,787783.0,93,73,20,2887,1053,1834,1661682.0,605143.0,1056539.0,0.579,0.5759,0.5747,0.5761
2023-06-29 14:10,328,222,106,33831,26581,7250,19413552.0,15236950.0,4176601.0,325,224,101,33611,26810,6801,19286171.0,15368150.0,3918020.0,0.5732,0.5761,0.5732,0.5761
2023-06-29 14:15,306,273,33,48983,47950,1033,28078821.0,27483118.0,595702.0,297,266,31,49044,47582,1462,28112910.0,27270063.0,842847.0,0.5732,0.5767,0.5731,0.5765
2023-06-29 14:20,331,321,10,60063,59329,734,34423355.0,33999624.0,423730.0,325,314,11,58179,57433,746,33343796.0,32913156.0,430639.0,0.5731,0.5773,0.5731,0.5773
2023-06-29 14:25,1008,887,121,175578,170158,5420,100643851.0,97521844.0,3122007.0,1006,887,119,175648,170122,5526,100686712.0,97501144.0,3185567.0,0.5731,0.576,0.5731,0.5765
2023-06-29 14:30,321,264,57,55812,48607,7205,43806166.0,39672371.0,4133795.0,318,264,54,57644,50470,7174,44882905.0,40739728.0,4143177.0,0.8162,0.5737,0.8072,0.5775
2023-06-29 14:35,398,291,107,55427,53192,2235,31651564.0,30369488.0,1282076.0,373,269,104,55513,53146,2367,31702992.0,30341563.0,1361429.0,0.5709,0.5736,0.5709,0.5752
2023-06-29 14:40,406,342,64,59444,55160,4284,34046466.0,31583481.0,2462985.0,379,334,45,58407,54271,4136,33415680.0,31036296.0,2379384.0,0.5726,0.5749,0.5719,0.5753
2023-06-29 14:45,394,281,113,33008,29353,3655,18917160.0,16815454.0,2101706.0,370,269,101,33272,29493,3779,19061071.0,16884523.0,2176548.0,0.5729,0.575,0.5725,0.576
2023-06-29 14:50,128,78,50,13590,11842,1748,7838436.0,6830966.0,1007469.0,111,69,42,12110,10651,1459,6937442.0,6097695.0,839747.0,0.5768,0.5764,0.5725,0.5756
2023-06-29 14:55,50,16,34,3463,803,2660,1988478.0,457366.0,1531112.0,46,14,32,3609,827,2782,2076997.0,473945.0,1603051.0,0.5696,0.5756,0.5731,0.5762
2023-06-29 15:00,108,43,65,9232,4053,5179,5239344.0,2310964.0,2928380.0,92,32,60,8661,4122,4539,4962818.0,2354119.0,2608698.0,0.5702,0.5654,0.5711,0.5747
2023-06-29 15:05,1299,196,1103,139467,18855,120612,80031929.0,10780731.0,69251197.0,1282,184,1098,138672,18641,120031,79610417.0,10658429.0,68951987.0,0.5718,0.5742,0.5718,0.5745
2023-06-29 15:10,803,197,606,100099,18511,81588,57454566.0,10589691.0,46864875.0,790,187,603,99642,18179,81463,57192200.0,10399959.0,46792241.0,0.5721,0.5744,0.5721,0.5744
2023-06-29 15:15,713,65,648,94885,3309,91576,54465999.0,1885636.0,52580363.0,707,64,643,95007,3486,91521,54550205.0,1981704.0,52568500.0,0.5699,0.5742,0.5685,0.5744
2023-06-29 15:20,786,117,669,110791,9271,101520,63563329.0,5266837.0,58296492.0,783,117,666,110262,8895,101367,63262004.0,5053154.0,58208849.0,0.5681,0.5742,0.5681,0.5742
2023-06-29 15:25,459,103,356,44266,6729,37537,25362812.0,3819256.0,21543556.0,445,93,352,44304,6710,37594,25395218.0,3807517.0,21587701.0,0.5676,0.5739,0.5674,0.5742
2023-06-29 15:30,1372,195,1177,117055,14258,102797,67159398.0,8120636.0,59038761.0,1355,186,1169,116342,14105,102237,66762217.0,8032860.0,58729357.0,0.5695,0.5743,0.5695,0.5744
2023-06-29 15:35,1251,367,884,113659,25253,88406,65161990.0,14381283.0,50780706.0,1246,365,881,113738,25511,88227,65204830.0,14527077.0,50677753.0,0.5695,0.5744,0.5694,0.5744
2023-06-29 15:40,1329,322,1007,144987,37945,107042,83143688.0,21644622.0,61499065.0,1323,318,1005,144954,37981,106973,83123523.0,21664904.0,61458619.0,0.5704,0.5745,0.5704,0.5745
2023-06-29 15:45,409,81,328,48963,3462,45501,39982713.0,13852796.0,26129917.0,398,69,329,48030,3108,44922,39454417.0,13652073.0,25802344.0,4.0014,0.5743,4.3926,0.5744
2023-06-29 15:50,197,23,174,16319,1347,14972,9383101.0,782665.0,8600435.0,180,10,170,15182,345,14837,8720613.0,197298.0,8523315.0,0.581,0.5744,0.5719,0.5745
2023-06-29 15:55,53,23,30,2632,149,2483,1514456.0,87190.0,1427266.0,47,17,30,3318,110,3208,1926280.0,62837.0,1863443.0,0.5852,0.5748,0.5713,0.5809
2023-06-29 16:00,379,32,347,35887,794,35093,20648446.0,452988.0,20195458.0,367,22,345,35058,678,34380,20137753.0,387004.0,19750749.0,0.5705,0.5755,0.5708,0.5745
2023-06-29 16:05,1077,39,1038,104507,868,103639,60035930.0,496752.0,59539178.0,1057,22,1035,104471,886,103585,60013417.0,506427.0,59506989.0,0.5723,0.5745,0.5716,0.5745
2023-06-29 16:10,407,14,393,38195,405,37790,21941760.0,231584.0,21710176.0,404,11,393,39214,409,38805,22593005.0,233865.0,22359139.0,0.5718,0.5745,0.5718,0.5762
2023-06-29 16:15,399,121,278,30753,8605,22148,17620443.0,4899575.0,12720867.0,387,112,275,31296,8815,22481,17934293.0,5022283.0,12912009.0,0.5694,0.5744,0.5697,0.5744
2023-06-29 16:20,112,53,59,4990,3936,1054,2852882.0,2248016.0,604866.0,107,48,59,4825,3771,1054,2758543.0,2153690.0,604853.0,0.5711,0.5739,0.5711,0.5739
2023-06-29 16:25,601,107,494,44666,8393,36273,25594970.0,4784039.0,20810930.0,578,92,486,44874,8568,36306,25723898.0,4882293.0,20841604.0,0.57,0.5737,0.5698,0.5741
2023-06-29 16:30,750,200,550,69601,23529,46072,39900580.0,13439365.0,26461215.0,740,192,548,68913,22904,46009,39506775.0,13081850.0,26424924.0,0.5712,0.5743,0.5712,0.5743
2023-06-29 16:35,1285,53,1232,140239,6363,133876,80519537.0,3629658.0,76889878.0,1273,43,1230,140320,6690,133630,80569145.0,3820628.0,76748516.0,0.5704,0.5743,0.5711,0.5743
2023-06-29 16:40,864,107,757,87450,9620,77830,50151628.0,5452160.0,44699468.0,857,102,755,87121,9169,77952,49966192.0,5196046.0,44770146.0,0.5668,0.5743,0.5667,0.5743
2023-06-29 16:45,186,11,175,14801,544,14257,8497976.0,309821.0,8188154.0,195,21,174,14835,596,14239,8516427.0,338396.0,8178030.0,0.5695,0.5743,0.5678,0.5743
2023-06-29 16:50,1821,264,1557,159650,8317,151333,91698985.0,4758342.0,86940643.0,1828,262,1566,159146,8118,151028,91400207.0,4636981.0,86763226.0,0.5721,0.5745,0.5712,0.5745
2023-06-29 16:55,1955,266,1689,242778,11691,231087,139349324.0,6686629.0,132662694.0,1945,259,1686,241924,11643,230281,138917803.0,6658702.0,132259101.0,0.5719,0.5741,0.5719,0.5743
2023-06-29 17:00,2668,1571,1097,275618,98901,176717,169899870.0,68448987.0,101450883.0,2644,1556,1088,273237,96659,176578,168492952.0,67122165.0,101370787.0,0.6921,0.5741,0.6944,0.5741
2023-06-29 17:05,2427,1670,757,300471,162242,138229,184052304.0,104645828.0,79406476.0,2416,1666,750,300043,162386,137657,183809744.0,104730450.0,79079294.0,0.645,0.5745,0.6449,0.5745
2023-06-29 17:10,1872,1009,863,242888,93838,149050,139247714.0,53632287.0,85615426.0,1871,1007,864,243469,93723,149746,139584235.0,53565847.0,86018387.0,0.5715,0.5744,0.5715,0.5744
2023-06-29 17:15,157,111,46,9436,3835,5601,5411335.0,2192395.0,3218940.0,147,108,39,8829,3710,5119,5063285.0,2120566.0,2942718.0,0.5717,0.5747,0.5716,0.5749
2023-06-29 17:20,1046,435,611,142495,45679,96816,81697781.0,26090513.0,55607268.0,1047,435,612,143030,45791,97239,82006358.0,26152939.0,55853419.0,0.5712,0.5744,0.5711,0.5744
2023-06-29 17:25,76,26,50,7496,1260,6236,4302151.0,720150.0,3582000.0,71,24,47,7432,1259,6173,4267339.0,719575.0,3547763.0,0.5715,0.5744,0.5715,0.5747
2023-06-29 17:30,517,145,372,57590,5489,52101,33055104.0,3133858.0,29921245.0,504,142,362,56493,5581,50912,32425896.0,3186662.0,29239234.0,0.5709,0.5743,0.571,0.5743
2023-06-29 17:35,225,64,161,19999,3183,16816,11460551.0,1813262.0,9647289.0,219,56,163,20893,3386,17507,11983456.0,1928959.0,10054497.0,0.5697,0.5737,0.5697,0.5743
2023-06-29 17:40,1581,121,1460,196967,5906,191061,113037677.0,3320002.0,109717674.0,1555,105,1450,194551,4440,190111,111706488.0,2533486.0,109173002.0,0.5621,0.5743,0.5706,0.5743
2023-06-29 17:45,1312,29,1283,148969,929,148040,85555825.0,529532.0,85026293.0,1303,23,1280,149323,1385,147938,85709437.0,738581.0,84970855.0,0.57,0.5743,0.5333,0.5744
2023-06-29 17:50,1185,47,1138,159072,1818,157254,91371632.0,1043461.0,90328171.0,1174,36,1138,159081,1394,157687,91373536.0,795575.0,90577961.0,0.574,0.5744,0.5707,0.5744
2023-06-29 17:55,1137,16,1121,202272,498,201774,116174051.0,284375.0,115889676.0,1126,10,1116,201853,409,201444,115932514.0,233597.0,115698916.0,0.571,0.5744,0.5711,0.5743
2023-06-29 18:00,1025,71,954,145020,2261,142759,83255439.0,1290587.0,81964852.0,1015,67,948,145517,3067,142450,83520255.0,1733357.0,81786897.0,0.5708,0.5741,0.5652,0.5741
2023-06-29 18:05,1503,26,1477,174343,1022,173321,100157850.0,581182.0,99576668.0,1499,20,1479,174275,971,173304,100119864.0,552057.0,99567807.0,0.5687,0.5745,0.5685,0.5745
2023-06-29 18:10,1902,15,1887,281816,183,281633,161812643.0,105832.0,161706810.0,1892,9,1883,281565,131,281434,161670262.0,74742.0,161595520.0,0.5783,0.5742,0.5706,0.5742
2023-06-29 18:15,736,44,692,92204,1094,91110,52944085.0,626611.0,52317474.0,737,42,695,92444,1035,91409,53079260.0,590494.0,52488766.0,0.5728,0.5742,0.5705,0.5742
2023-06-29 18:20,1768,63,1705,204965,2836,202129,117703703.0,1619332.0,116084370.0,1758,57,1701,204088,2336,201752,117228311.0,1333462.0,115894849.0,0.571,0.5743,0.5708,0.5744
2023-06-29 18:25,1509,49,1460,222556,884,221672,127746138.0,504234.0,127241903.0,1507,45,1462,222903,1257,221646,127940440.0,713126.0,127227314.0,0.5704,0.574,0.5673,0.574
2023-06-29 18:30,1980,56,1924,283844,1509,282335,162992639.0,863593.0,162129046.0,1974,51,1923,283610,1430,282180,162856297.0,816376.0,162039920.0,0.5723,0.5742,0.5709,0.5742
2023-06-29 18:35,1948,65,1883,221386,2994,218392,127162053.0,1710156.0,125451896.0,1947,64,1883,221458,2874,218584,127203830.0,1641227.0,125562603.0,0.5712,0.5744,0.5711,0.5744
2023-06-30 10:00,2719,1248,1471,297423,69385,228038,226961156.0,96195407.0,130765749.0,2256,981,1275,266832,47963,218869,202852212.0,77460564.0,125391648.0,1.3864,0.5734,1.615,0.5729
2023-06-30 10:05,705,466,239,31642,16941,14701,57497524.0,49058560.0,8438963.0,509,333,176,26788,15004,11784,53959523.0,47209550.0,6749972.0,2.8958,0.574,3.1465,0.5728
2023-06-30 10:10,1324,978,346,84604,38935,45669,56008300.0,29965784.0,26042516.0,1221,914,307,77673,36333,41340,52057667.0,28500191.0,23557475.0,0.7696,0.5702,0.7844,0.5698
2023-06-30 10:15,1214,623,591,87609,19870,67739,49878020.0,11282862.0,38595158.0,1132,570,562,86697,19513,67184,49333266.0,11060676.0,38272590.0,0.5678,0.5698,0.5668,0.5697
2023-06-30 10:20,1319,620,699,115230,28307,86923,73403860.0,23848349.0,49555510.0,1267,588,679,112667,26293,86374,72058884.0,22817748.0,49241135.0,0.8425,0.5701,0.8678,0.5701
2023-06-30 10:25,633,240,393,72262,6692,65570,56931947.0,19607429.0,37324518.0,589,208,381,70771,6114,64657,56162117.0,19278571.0,36883545.0,2.93,0.5692,3.1532,0.5704
2023-06-30 10:30,700,258,442,51990,2825,49165,29594700.0,1597805.0,27996895.0,591,203,388,51560,2608,48952,29363052.0,1477035.0,27886016.0,0.5656,0.5694,0.5663,0.5697
2023-06-30 10:35,1514,236,1278,225864,2719,223145,136353815.0,9443117.0,126910697.0,1466,198,1268,224267,1994,222273,135485485.0,9033252.0,126452233.0,3.473,0.5687,4.5302,0.5689
2023-06-30 10:40,1959,245,1714,249438,5309,244129,141893858.0,3007533.0,138886325.0,1925,221,1704,248898,4459,244439,141582396.0,2521012.0,139061384.0,0.5665,0.5689,0.5654,0.5689
2023-06-30 10:45,2525,421,2104,333750,9877,323873,189836754.0,5594475.0,184242279.0,2500,401,2099,333050,9770,323280,189434654.0,5533503.0,183901151.0,0.5664,0.5689,0.5664,0.5689
2023-06-30 10:50,242,102,140,17641,2246,15395,21912392.0,13148915.0,8763476.0,224,91,133,16999,1738,15261,17572132.0,8887421.0,8684711.0,5.8544,0.5692,5.1136,0.5691
2023-06-30 10:55,327,72,255,10801,2020,8781,6153199.0,1145613.0,5007586.0,304,54,250,10195,1380,8815,5811470.0,783012.0,5028458.0,0.5671,0.5703,0.5674,0.5704
2023-06-30 11:00,106,49,57,8586,1473,7113,4893304.0,826687.0,4066617.0,84,34,50,6420,1122,5298,3663089.0,636588.0,3026501.0,0.5612,0.5717,0.5674,0.5713
2023-06-30 11:05,37,14,23,2976,231,2745,1708551.0,135410.0,1573140.0,22,7,15,1919,381,1538,1092144.0,214482.0,877662.0,0.5862,0.5731,0.5629,0.5707
2023-06-30 11:10,230,48,182,19776,1003,18773,11277888.0,604530.0,10673358.0,183,18,165,18610,333,18277,10607081.0,188925.0,10418155.0,0.6027,0.5685,0.5673,0.57
2023-06-30 11:15,123,32,91,6404,1046,5358,3644670.0,590631.0,3054039.0,110,24,86,5644,660,4984,3213270.0,374355.0,2838915.0,0.5647,0.57,0.5672,0.5696
2023-06-30 11:20,205,42,163,9861,827,9034,5611158.0,468842.0,5142316.0,182,29,153,10014,1247,8767,5690200.0,700505.0,4989695.0,0.5669,0.5692,0.5618,0.5691
2023-06-30 11:25,96,26,70,3326,611,2715,1892473.0,346753.0,1545720.0,85,17,68,3083,510,2573,1753781.0,289259.0,1464521.0,0.5675,0.5693,0.5672,0.5692
2023-06-30 11:30,101,38,63,6534,991,5543,3719535.0,562032.0,3157503.0,90,29,61,8548,750,7798,4882389.0,425371.0,4457018.0,0.5671,0.5696,0.5672,0.5716
2023-06-30 11:35,78,29,49,4699,866,3833,2675657.0,491082.0,2184575.0,72,28,44,4681,905,3776,2664504.0,513423.0,2151081.0,0.5671,0.5699,0.5673,0.5697
2023-06-30 11:40,147,74,73,9768,2201,7567,5579514.0,1248989.0,4330525.0,131,60,71,5913,1503,4410,3372936.0,852342.0,2520594.0,0.5675,0.5723,0.5671,0.5716
2023-06-30 11:45,665,91,574,132658,1993,130665,75678805.0,1132870.0,74545934.0,649,78,571,132852,2246,130606,75772893.0,1257664.0,74515228.0,0.5684,0.5705,0.56,0.5705
2023-06-30 11:50,126,25,101,21909,1353,20556,12525411.0,758300.0,11767110.0,113,20,93,24045,1104,22941,13751252.0,620790.0,13130462.0,0.5605,0.5724,0.5623,0.5724
2023-06-30 11:55,83,49,34,6407,1530,4877,3650857.0,865242.0,2785615.0,76,43,33,6503,1398,5105,3711758.0,793974.0,2917784.0,0.5655,0.5712,0.5679,0.5716
2023-06-30 12:00,50,29,21,2169,1116,1053,1233724.0,632926.0,600798.0,34,19,15,2433,1247,1186,1384713.0,707532.0,677181.0,0.5671,0.5706,0.5674,0.571
2023-06-30 12:05,33,15,18,1787,89,1698,1056068.0,50765.0,1005303.0,14,5,9,507,48,459,289277.0,27181.0,262096.0,0.5704,0.5921,0.5663,0.571
2023-06-30 12:10,17,10,7,556,472,84,306472.0,258396.0,48075.0,10,4,6,161,81,80,91644.0,45975.0,45668.0,0.5474,0.5723,0.5676,0.5709
2023-06-30 12:15,27,9,18,865,165,700,501851.0,94677.0,407173.0,16,4,12,948,35,913,542879.0,19804.0,523074.0,0.5738,0.5817,0.5658,0.5729
2023-06-30 12:20,41,23,18,2026,735,1291,1152906.0,417773.0,735133.0,32,18,14,1906,724,1182,1087357.0,411092.0,676265.0,0.5684,0.5694,0.5678,0.5721
2023-06-30 12:25,329,7,322,72740,267,72473,41496987.0,151804.0,41345183.0,320,3,317,72483,235,72248,41349202.0,132640.0,41216562.0,0.5686,0.5705,0.5644,0.5705
2023-06-30 12:30,40,13,27,4069,109,3960,2317451.0,61855.0,2255596.0,28,2,26,4309,44,4265,2458933.0,24853.0,2434079.0,0.5675,0.5696,0.5649,0.5707
2023-06-30 12:35,13,7,6,617,170,447,352717.0,96752.0,255965.0,4,2,2,47,30,17,26824.0,16964.0,9860.0,0.5691,0.5726,0.5655,0.58
2023-06-30 12:40,30,14,16,2068,586,1482,1193056.0,331157.0,861898.0,15,5,10,1156,336,820,659627.0,190461.0,469165.0,0.5651,0.5816,0.5668,0.5722
2023-06-30 12:45,44,24,20,2522,714,1808,1477880.0,430972.0,1046907.0,35,17,18,1856,304,1552,1060204.0,172713.0,887491.0,0.6036,0.579,0.5681,0.5718
2023-06-30 12:50,159,62,97,15985,2343,13642,20999262.0,13217734.0,7781528.0,148,54,94,15836,2288,13548,20903350.0,13175615.0,7727734.0,5.6414,0.5704,5.7586,0.5704
2023-06-30 12:55,330,131,199,32325,2917,29408,18446702.0,1663148.0,16783553.0,320,124,196,32407,2720,29687,18488576.0,1546832.0,16941744.0,0.5702,0.5707,0.5687,0.5707
2023-06-30 13:00,262,82,180,33787,1627,32160,19282697.0,927386.0,18355311.0,249,72,177,33392,1459,31933,19054839.0,829131.0,18225707.0,0.57,0.5707,0.5683,0.5707
2023-06-30 13:05,36,30,6,1461,1031,430,831972.0,586369.0,245603.0,31,26,5,1738,1120,618,989262.0,636495.0,352766.0,0.5687,0.5712,0.5683,0.5708
2023-06-30 13:10,181,128,53,12871,6566,6305,7328668.0,3732330.0,3596337.0,174,122,52,12589,6399,6190,7169236.0,3637584.0,3531651.0,0.5684,0.5704,0.5685,0.5705
2023-06-30 13:15,341,270,71,14240,6991,7249,8111125.0,3975783.0,4135342.0,332,265,67,14321,6994,7327,8157162.0,3977048.0,4180114.0,0.5687,0.5705,0.5686,0.5705
2023-06-30 13:20,71,26,45,4096,472,3624,2330968.0,263669.0,2067299.0,67,23,44,3927,417,3510,2238762.0,235787.0,2002975.0,0.5586,0.5704,0.5654,0.5706
2023-06-30 13:25,1074,133,941,142296,10261,132035,81148601.0,5832036.0,75316565.0,1057,121,936,141011,9929,131082,80418032.0,5642844.0,74775187.0,0.5684,0.5704,0.5683,0.5704
2023-06-30 13:30,3172,681,2491,390819,27150,363669,223029779.0,15431246.0,207598533.0,3157,671,2486,390941,27116,363825,223097818.0,15410712.0,207687105.0,0.5684,0.5708,0.5683,0.5708
2023-06-30 13:35,3869,938,2931,483062,49225,433837,275573556.0,27996613.0,247576942.0,3855,927,2928,483262,49142,434120,275670187.0,27931326.0,247738861.0,0.5687,0.5707,0.5684,0.5707
2023-06-30 13:40,3893,1662,2231,463123,72270,390853,264227746.0,41074658.0,223153087.0,3887,1659,2228,467684,77255,390429,266474539.0,43561038.0,222913501.0,0.5684,0.5709,0.5639,0.5709
2023-06-30 13:45,1388,773,615,145031,51918,93113,106439559.0,53265532.0,53174027.0,1370,762,608,143907,50971,92936,105808849.0,52725318.0,53083531.0,1.026,0.5711,1.0344,0.5712
2023-06-30 13:50,643,476,167,50462,39679,10783,28723570.0,22556064.0,6167506.0,637,470,167,50629,39744,10885,28813480.0,22592429.0,6221051.0,0.5685,0.572,0.5684,0.5715
2023-06-30 13:55,1309,1010,299,114954,87079,27875,65449816.0,49504695.0,15945120.0,1283,997,286,114463,86948,27515,65169565.0,49430638.0,15738927.0,0.5685,0.572,0.5685,0.572
2023-06-30 14:00,776,493,283,71667,24799,46868,40927001.0,14098387.0,26828614.0,752,476,276,71330,24705,46625,40727509.0,14043206.0,26684303.0,0.5685,0.5724,0.5684,0.5723
2023-06-30 14:05,96,46,50,6876,1445,5431,3935127.0,827275.0,3107851.0,86,38,48,7042,1304,5738,4025521.0,741659.0,3283861.0,0.5725,0.5722,0.5688,0.5723
2023-06-30 14:10,39,16,23,2888,596,2292,13524712.0,12215550.0,1309162.0,23,6,17,3025,536,2489,13614242.0,12180978.0,1433263.0,20.4959,0.5712,22.7257,0.5758
2023-06-30 14:15,488,374,114,24693,8997,15696,14099758.0,5120353.0,8979404.0,473,369,104,24682,9163,15519,14093134.0,5214297.0,8878837.0,0.5691,0.5721,0.5691,0.5721
2023-06-30 14:20,156,105,51,6891,4820,2071,3925895.0,2742681.0,1183213.0,154,105,49,6459,4703,1756,3678058.0,2676005.0,1002053.0,0.569,0.5713,0.569,0.5706
2023-06-30 14:25,413,393,20,12728,12110,618,7247493.0,6893158.0,354335.0,405,385,20,12788,12256,532,7280594.0,6975365.0,305228.0,0.5692,0.5734,0.5691,0.5737
2023-06-30 14:30,201,112,89,13412,4491,8921,7643875.0,2552802.0,5091073.0,190,102,88,13406,4187,9219,7648982.0,2379866.0,5269115.0,0.5684,0.5707,0.5684,0.5715
2023-06-30 14:35,254,237,17,14263,12617,1646,8121709.0,7177362.0,944346.0,247,235,12,13052,12641,411,7425108.0,7190459.0,234649.0,0.5689,0.5737,0.5688,0.5709
2023-06-30 14:40,635,626,9,30368,30111,257,17276629.0,17133474.0,143155.0,628,621,7,30276,30091,185,17228101.0,17121913.0,106188.0,0.569,0.557,0.569,0.574
2023-06-30 14:45,541,514,27,26693,25811,882,15178108.0,14678536.0,499572.0,536,512,24,26420,25615,805,15028195.0,14566822.0,461373.0,0.5687,0.5664,0.5687,0.5731
2023-06-30 14:50,53,37,16,3835,2891,944,2182556.0,1643872.0,538684.0,42,33,9,3551,2651,900,2020792.0,1506947.0,513844.0,0.5686,0.5706,0.5684,0.5709
2023-06-30 14:55,86,46,40,3659,1828,1831,2086457.0,1039493.0,1046964.0,71,36,35,3640,1770,1870,2075925.0,1006145.0,1069779.0,0.5687,0.5718,0.5684,0.5721
2023-06-30 15:00,519,342,177,35895,27519,8376,20427613.0,15640088.0,4787525.0,518,339,179,36209,27463,8746,20607130.0,15608520.0,4998609.0,0.5683,0.5716,0.5683,0.5715
2023-06-30 15:05,110,29,81,7753,946,6807,4432090.0,536787.0,3895303.0,100,26,74,7331,894,6437,4192982.0,508507.0,3684474.0,0.5674,0.5722,0.5688,0.5724
2023-06-30 15:10,187,138,49,19550,14301,5249,11129628.0,8126279.0,3003348.0,179,132,47,19708,14564,5144,11218462.0,8275661.0,2942800.0,0.5682,0.5722,0.5682,0.5721
2023-06-30 15:15,27,8,19,1884,648,1236,1077024.0,366609.0,710414.0,15,3,12,1176,450,726,671707.0,255540.0,416167.0,0.5658,0.5748,0.5679,0.5732
2023-06-30 15:20,10,7,3,39,27,12,22307.0,15468.0,6839.0,3,1,2,30,20,10,17082.0,11380.0,5702.0,0.5729,0.5699,0.569,0.5702
2023-06-30 15:25,57,18,39,3272,1008,2264,1865643.0,571682.0,1293960.0,51,16,35,3340,1079,2261,1906602.0,612265.0,1294337.0,0.5671,0.5715,0.5674,0.5725
2023-06-30 15:30,29,12,17,1637,514,1123,12810302.0,12167531.0,642771.0,19,4,15,1390,377,1013,12670880.0,12090871.0,580008.0,23.6722,0.5724,32.0713,0.5726
2023-06-30 15:35,57,24,33,2132,1010,1122,1216274.0,574635.0,641639.0,59,21,38,2071,972,1099,1181298.0,552064.0,629234.0,0.5689,0.5719,0.568,0.5726
2023-06-30 15:40,111,32,79,8806,1867,6939,5027359.0,1058942.0,3968417.0,104,29,75,8742,1819,6923,4994680.0,1031862.0,3962817.0,0.5672,0.5719,0.5673,0.5724
2023-06-30 15:45,96,76,20,9126,7517,1609,5182568.0,4263462.0,919105.0,91,75,16,9195,7553,1642,5221552.0,4283720.0,937831.0,0.5672,0.5712,0.5672,0.5712
2023-06-30 15:50,525,478,47,46975,45821,1154,26644114.0,25988335.0,655779.0,514,471,43,46819,45741,1078,26557403.0,25942666.0,614736.0,0.5672,0.5683,0.5672,0.5703
2023-06-30 15:55,294,60,234,6948,3833,3115,3948908.0,2175418.0,1773489.0,293,59,234,6847,3703,3144,3893338.0,2101678.0,1791660.0,0.5675,0.5693,0.5676,0.5699
2023-06-30 16:00,81,53,28,4910,3074,1836,2795460.0,1743341.0,1052119.0,69,46,23,4400,3003,1397,2504654.0,1702895.0,801758.0,0.5671,0.573,0.5671,0.5739
2023-06-30 16:05,63,30,33,2986,1526,1460,1697482.0,864541.0,832941.0,52,22,30,2938,1568,1370,1670767.0,888829.0,781938.0,0.5665,0.5705,0.5669,0.5708
2023-06-30 16:10,12,5,7,160,87,73,92220.0,49854.0,42365.0,10,3,7,138,78,60,79214.0,44185.0,35028.0,0.573,0.5804,0.5665,0.5838
2023-06-30 16:15,287,25,262,5891,841,5050,3353111.0,477217.0,2875894.0,283,24,259,5618,780,4838,3197909.0,442509.0,2755400.0,0.5674,0.5695,0.5673,0.5695
2023-06-30 16:20,92,40,52,4753,2786,1967,2697134.0,1577340.0,1119794.0,91,40,51,4850,2812,2038,2751778.0,1591643.0,1160135.0,0.5662,0.5693,0.566,0.5693
2023-06-30 16:25,178,51,127,12873,2942,9931,7302423.0,1668789.0,5633634.0,167,44,123,11840,2894,8946,6743029.0,1641344.0,5101684.0,0.5672,0.5673,0.5672,0.5703
2023-06-30 16:30,997,119,878,121635,2195,119440,92678146.0,24989308.0,67688837.0,962,94,868,119817,2073,117744,91837213.0,24920704.0,66916508.0,11.3847,0.5667,12.0216,0.5683
2023-06-30 16:35,2324,439,1885,285832,5006,280826,162369486.0,2822171.0,159547315.0,2285,406,1879,284983,4665,280318,161924444.0,2627347.0,159297097.0,0.5638,0.5681,0.5632,0.5683
2023-06-30 16:40,3776,574,3202,538370,7023,531347,341285272.0,39586962.0,301698310.0,3678,503,3175,535331,5865,529466,339724829.0,38933792.0,300791037.0,5.6368,0.5678,6.6383,0.5681
2023-06-30 16:45,1503,621,882,154455,6597,147858,111416089.0,27470588.0,83945501.0,1481,604,877,154355,6316,148039,111356914.0,27311832.0,84045082.0,4.1641,0.5677,4.3242,0.5677
2023-06-30 16:50,1112,330,782,125655,5286,120369,95317221.0,26743374.0,68573847.0,1100,317,783,124485,4111,120374,94657107.0,26078042.0,68579065.0,5.0593,0.5697,6.3435,0.5697
2023-06-30 16:55,143,43,100,8182,656,7526,16508677.0,12246054.0,4262623.0,119,21,98,7229,450,6779,15994849.0,12129611.0,3865238.0,18.6678,0.5664,26.9547,0.5702
2023-06-30 17:00,469,86,383,38726,2776,35950,33954519.0,13517861.0,20436658.0,426,60,366,36678,1613,35065,32737807.0,12787651.0,19950156.0,4.8695,0.5685,7.9279,0.5689
2023-06-30 17:05,2461,140,2321,284300,5047,279253,161571562.0,2848335.0,158723227.0,2438,124,2314,283847,4728,279119,161314559.0,2667529.0,158647030.0,0.5644,0.5684,0.5642,0.5684
2023-06-30 17:10,2044,252,1792,252974,15091,237883,143816752.0,8526030.0,135290722.0,2031,244,1787,252816,15074,237742,143726287.0,8516218.0,135210068.0,0.565,0.5687,0.565,0.5687
2023-06-30 17:15,1308,188,1120,153372,13316,140056,87245070.0,7530820.0,79714250.0,1278,161,1117,153234,13269,139965,87163612.0,7502382.0,79661230.0,0.5655,0.5692,0.5654,0.5692
2023-06-30 17:20,1984,284,1700,218613,24450,194163,124296124.0,13839648.0,110456476.0,1955,272,1683,218405,24322,194083,124168596.0,13754368.0,110414228.0,0.566,0.5689,0.5655,0.5689
2023-06-30 17:25,1856,306,1550,214327,24279,190048,121983791.0,13736979.0,108246811.0,1839,293,1546,214587,24114,190473,122133198.0,13643360.0,108489837.0,0.5658,0.5696,0.5658,0.5696
2023-06-30 17:30,902,113,789,94685,12569,82116,65706301.0,18988000.0,46718300.0,882,107,775,93660,12112,81548,65120390.0,18726815.0,46393575.0,1.5107,0.5689,1.5461,0.5689
2023-06-30 17:35,159,72,87,14635,4769,9866,8350819.0,2701579.0,5649240.0,150,67,83,14908,4918,9990,8505734.0,2785976.0,5719757.0,0.5665,0.5726,0.5665,0.5725
2023-06-30 17:40,342,88,254,23770,5370,18400,13520882.0,3040773.0,10480109.0,315,72,243,23336,4978,18358,13289865.0,2818126.0,10471738.0,0.5663,0.5696,0.5661,0.5704
2023-06-30 17:45,542,113,429,40360,7031,33329,22954561.0,3983043.0,18971517.0,529,104,425,39997,6951,33046,22749572.0,3936545.0,18813026.0,0.5665,0.5692,0.5663,0.5693
2023-06-30 17:50,333,65,268,25019,3473,21546,14248519.0,1968408.0,12280111.0,319,56,263,24398,3297,21101,13891678.0,1866987.0,12024691.0,0.5668,0.5699,0.5663,0.5699
2023-06-30 17:55,52,18,34,3088,580,2508,1760909.0,328411.0,1432498.0,47,12,35,3039,564,2475,1733682.0,319192.0,1414489.0,0.5662,0.5712,0.5659,0.5715
2023-06-30 18:00,82,28,54,5624,1855,3769,3197845.0,1052132.0,2145712.0,67,16,51,6309,2495,3814,3566719.0,1394825.0,2171894.0,0.5672,0.5693,0.559,0.5695
2023-06-30 18:05,158,43,115,17513,3140,14373,9997116.0,1788396.0,8208719.0,154,35,119,17702,3058,14644,10094926.0,1733737.0,8361188.0,0.5696,0.5711,0.567,0.571
2023-06-30 18:10,280,80,200,31718,5841,25877,18081870.0,3308458.0,14773411.0,277,78,199,31441,5488,25953,17930399.0,3110971.0,14819428.0,0.5664,0.5709,0.5669,0.571
2023-06-30 18:15,106,28,78,5972,1192,4780,3402157.0,676040.0,2726117.0,93,21,72,5354,1145,4209,3049962.0,649201.0,2400761.0,0.5671,0.5703,0.567,0.5704
2023-06-30 18:20,102,36,66,7934,971,6963,4525096.0,551097.0,3973999.0,82,18,64,7636,854,6782,4356646.0,483442.0,3873204.0,0.5676,0.5707,0.5661,0.5711
2023-06-30 18:25,91,15,76,7913,521,7392,4508900.0,295746.0,4213154.0,77,6,71,7398,304,7094,4216451.0,172248.0,4044203.0,0.5677,0.57,0.5666,0.5701
2023-06-30 18:30,278,43,235,23014,1605,21409,13104541.0,909829.0,12194711.0,266,33,233,23111,1520,21591,13161189.0,860979.0,12300210.0,0.5669,0.5696,0.5664,0.5697
2023-06-30 18:35,729,223,506,82326,19825,62501,46802306.0,11247838.0,35554468.0,721,215,506,82493,19923,62570,46874726.0,11278240.0,35596485.0,0.5674,0.5689,0.5661,0.5689
2023-07-03 10:00,1259,485,774,89985,20705,69280,53590703.0,13892892.0,39697811.0,959,347,612,76915,12562,64353,43832484.0,7124955.0,36707528.0,0.671,0.573,0.5672,0.5704
2023-07-03 10:05,265,140,125,19148,5270,13878,11042263.0,2990500.0,8051763.0,201,105,96,16231,4813,11418,9236882.0,2732547.0,6504335.0,0.5675,0.5802,0.5677,0.5697
2023-07-03 10:10,667,306,361,59670,14175,45495,33862323.0,7904735.0,25957587.0,590,263,327,55624,10938,44686,31702960.0,6209941.0,25493019.0,0.5577,0.5706,0.5677,0.5705
2023-07-03 10:15,215,107,108,31542,14525,17017,17937118.0,8223840.0,9713277.0,140,66,74,10554,3456,7098,6022242.0,1961109.0,4061133.0,0.5662,0.5708,0.5675,0.5722
2023-07-03 10:20,1538,603,935,188222,47657,140565,142147939.0,62455093.0,79692846.0,1420,512,908,181899,44661,137238,129251579.0,51202759.0,78048820.0,1.3105,0.5669,1.1465,0.5687
2023-07-03 10:25,2319,569,1750,299812,28753,271059,170393753.0,16192456.0,154201297.0,2146,512,1634,297652,28604,269048,169158919.0,16101327.0,153057592.0,0.5632,0.5689,0.5629,0.5689
2023-07-03 10:30,456,200,256,50763,17832,32931,40775995.0,21957765.0,18818230.0,401,170,231,49973,17075,32898,40287937.0,21506137.0,18781799.0,1.2314,0.5714,1.2595,0.5709
2023-07-03 10:35,1639,489,1150,195319,66224,129095,110996402.0,37418246.0,73578156.0,1610,473,1137,195062,66010,129052,110851497.0,37294917.0,73556580.0,0.565,0.57,0.565,0.57
2023-07-03 10:40,2225,715,1510,198020,71819,126201,124255329.0,52422009.0,71833320.0,2170,685,1485,195753,70609,125144,122976287.0,51750141.0,71226146.0,0.7299,0.5692,0.7329,0.5692
2023-07-03 10:45,152,123,29,15662,14448,1214,8838439.0,8145099.0,693339.0,126,112,14,14175,13409,766,7996491.0,7559479.0,437012.0,0.5638,0.5711,0.5638,0.5705
2023-07-03 10:50,108,87,21,9537,7791,1746,5404566.0,4395645.0,1008920.0,92,76,16,9087,7784,1303,5132759.0,4391063.0,741695.0,0.5642,0.5778,0.5641,0.5692
2023-07-03 10:55,1784,820,964,159575,86640,72935,90867139.0,49143344.0,41723795.0,1764,804,960,159542,86288,73254,90855108.0,48943718.0,41911390.0,0.5672,0.5721,0.5672,0.5721
2023-07-03 11:00,2830,1762,1068,233718,160234,73484,132926577.0,90908270.0,42018307.0,2795,1737,1058,232266,159380,72886,132089428.0,90414481.0,41674947.0,0.5673,0.5718,0.5673,0.5718
2023-07-03 11:05,2637,1896,741,202374,151971,50403,114994459.0,86228561.0,28765898.0,2598,1878,720,202235,151660,50575,114922980.0,86053342.0,28869638.0,0.5674,0.5707,0.5674,0.5708
2023-07-03 11:10,4251,2865,1386,361033,231135,129898,276756639.0,202594127.0,74162512.0,4173,2807,1366,357701,229009,128692,274774733.0,201306449.0,73468284.0,0.8765,0.5709,0.879,0.5709
2023-07-03 11:15,2706,1323,1383,233223,100452,132771,144676048.0,68920595.0,75755452.0,2670,1304,1366,231063,98684,132379,143439410.0,67911681.0,75527728.0,0.6861,0.5706,0.6882,0.5705
2023-07-03 11:20,1077,757,320,82589,54678,27911,58918444.0,42963949.0,15954495.0,1031,740,291,81042,53753,27289,58031098.0,42426511.0,15604587.0,0.7858,0.5716,0.7893,0.5718
2023-07-03 11:25,414,330,84,17050,9521,7529,9764797.0,5420279.0,4344518.0,404,329,75,17496,10052,7444,9988157.0,5722224.0,4265932.0,0.5693,0.577,0.5693,0.5731
2023-07-03 11:30,729,587,142,33860,26091,7769,19314609.0,14869124.0,4445484.0,687,563,124,31682,24938,6744,18078352.0,14213451.0,3864900.0,0.5699,0.5722,0.57,0.5731
2023-07-03 11:35,440,237,203,36893,14359,22534,21076191.0,8184044.0,12892147.0,419,219,200,35646,13218,22428,20361184.0,7528541.0,12832643.0,0.57,0.5721,0.5696,0.5722
2023-07-03 11:40,331,243,88,25503,17186,8317,14557715.0,9793795.0,4763919.0,310,230,80,24428,16672,7756,13955041.0,9511680.0,4443361.0,0.5699,0.5728,0.5705,0.5729
2023-07-03 11:45,73,22,51,2250,527,1723,1287535.0,301066.0,986469.0,62,15,47,2028,289,1739,1160721.0,164548.0,996172.0,0.5713,0.5725,0.5694,0.5728
2023-07-03 11:50,402,261,141,32659,17047,15612,18661116.0,9721088.0,8940028.0,388,252,136,31425,16135,15290,17953695.0,9203331.0,8750364.0,0.5703,0.5726,0.5704,0.5723
2023-07-03 11:55,2414,1839,575,182703,132338,50365,116349779.0,87478621.0,28871158.0,2372,1822,550,181197,131646,49551,115472280.0,87067179.0,28405101.0,0.661,0.5732,0.6614,0.5732
2023-07-03 12:00,4630,3594,1036,325525,281784,43741,186114889.0,160998035.0,25116853.0,4592,3572,1020,324349,281160,43189,185437060.0,160649560.0,24787500.0,0.5714,0.5742,0.5714,0.5739
2023-07-03 12:05,3136,2429,707,254254,190117,64137,145425475.0,108603179.0,36822296.0,3126,2427,699,253649,190091,63558,145081534.0,108588635.0,36492899.0,0.5712,0.5741,0.5712,0.5742
2023-07-03 12:10,3716,2730,986,285794,231821,53973,163310248.0,132349800.0,30960448.0,3703,2721,982,284728,230787,53941,162767525.0,131828104.0,30939421.0,0.5709,0.5736,0.5712,0.5736
2023-07-03 12:15,2870,1879,991,257018,167679,89339,158804906.0,107595223.0,51209683.0,2860,1878,982,257022,167815,89207,158824322.0,107673650.0,51150672.0,0.6417,0.5732,0.6416,0.5734
2023-07-03 12:20,2808,1189,1619,303500,112091,191409,173634285.0,63912761.0,109721523.0,2831,1212,1619,303626,112618,191008,173701121.0,64208540.0,109492581.0,0.5702,0.5732,0.5701,0.5732
2023-07-03 12:25,520,219,301,44573,14775,29798,25475397.0,8394211.0,17081185.0,496,208,288,44120,14516,29604,25233592.0,8262382.0,16971210.0,0.5681,0.5732,0.5692,0.5733
2023-07-03 12:30,129,64,65,5565,4435,1130,3172434.0,2525230.0,647204.0,126,56,70,6008,4452,1556,3429086.0,2534121.0,894965.0,0.5694,0.5727,0.5692,0.5752
2023-07-03 12:35,120,58,62,5421,3319,2102,3099641.0,1898036.0,1201605.0,94,39,55,5082,3048,2034,2901004.0,1734004.0,1167000.0,0.5719,0.5716,0.5689,0.5737
2023-07-03 12:40,157,73,84,5883,1562,4321,3374813.0,891295.0,2483517.0,150,69,81,5598,1620,3978,3205155.0,923975.0,2281180.0,0.5706,0.5748,0.5704,0.5734
2023-07-03 12:45,308,145,163,17127,7648,9479,9790882.0,4357419.0,5433462.0,283,129,154,16161,7448,8713,9232752.0,4243137.0,4989614.0,0.5697,0.5732,0.5697,0.5727
2023-07-03 12:50,244,117,127,15754,6212,9542,9006471.0,3539825.0,5466645.0,235,111,124,15477,5928,9549,8850239.0,3379365.0,5470874.0,0.5698,0.5729,0.5701,0.5729
2023-07-03 12:55,574,481,93,40095,31303,8792,22876866.0,17839759.0,5037106.0,555,467,88,38888,30999,7889,22174000.0,17655494.0,4518506.0,0.5699,0.5729,0.5696,0.5728
2023-07-03 13:00,1543,331,1212,175354,24171,151183,100307048.0,13739536.0,86567512.0,1531,331,1200,174743,24071,150672,99960930.0,13682715.0,86278214.0,0.5684,0.5726,0.5684,0.5726
2023-07-03 13:05,956,228,728,94168,13790,80378,53893001.0,7847239.0,46045762.0,937,215,722,94848,13829,81019,54284184.0,7868354.0,46415829.0,0.5691,0.5729,0.569,0.5729
2023-07-03 13:10,160,41,119,12957,1577,11380,7416793.0,898026.0,6518766.0,159,38,121,13150,1631,11519,7526168.0,928183.0,6597984.0,0.5695,0.5728,0.5691,0.5728
2023-07-03 13:15,116,55,61,9687,2885,6802,5536523.0,1639135.0,3897388.0,109,51,58,9656,2866,6790,5518055.0,1627625.0,3890429.0,0.5682,0.573,0.5679,0.573
2023-07-03 13:20,47,25,22,2993,1277,1716,1726684.0,742723.0,983961.0,41,20,21,2266,842,1424,1296408.0,480163.0,816244.0,0.5816,0.5734,0.5703,0.5732
2023-07-03 13:25,250,208,42,18320,16444,1876,10453926.0,9380081.0,1073844.0,248,207,41,18347,16418,1929,10469398.0,9365467.0,1103930.0,0.5704,0.5724,0.5704,0.5723
2023-07-03 13:30,70,26,44,4122,756,3366,2359232.0,431043.0,1928189.0,63,21,42,4093,712,3381,2342647.0,405897.0,1936750.0,0.5702,0.5728,0.5701,0.5728
2023-07-03 13:35,78,19,59,6073,976,5097,3475069.0,555894.0,2919174.0,74,16,58,5838,924,4914,3340349.0,526095.0,2814253.0,0.5696,0.5727,0.5694,0.5727
2023-07-03 13:40,238,166,72,26058,23069,2989,14868805.0,13158435.0,1710370.0,234,163,71,26183,23200,2983,14940144.0,13233113.0,1707031.0,0.5704,0.5722,0.5704,0.5723
2023-07-03 13:45,217,123,94,14682,7508,7174,8395034.0,4285314.0,4109720.0,217,123,94,14865,7511,7354,8495722.0,4282867.0,4212855.0,0.5708,0.5729,0.5702,0.5729
2023-07-03 13:50,625,217,408,54188,9648,44540,31026418.0,5501458.0,25524959.0,622,218,404,54230,9748,44482,31049895.0,5558198.0,25491697.0,0.5702,0.5731,0.5702,0.5731
2023-07-03 13:55,249,40,209,23253,3054,20199,13313436.0,1741511.0,11571924.0,241,39,202,23241,3038,20203,13305824.0,1731537.0,11574287.0,0.5702,0.5729,0.57,0.5729
2023-07-03 14:00,1747,782,965,197155,65677,131478,112793955.0,37467315.0,75326639.0,1735,770,965,197275,65025,132250,112830331.0,37060291.0,75770039.0,0.5705,0.5729,0.5699,0.5729
2023-07-03 14:05,3693,1677,2016,401684,120955,280729,229700619.0,68991914.0,160708705.0,3675,1656,2019,399312,120323,278989,228385218.0,68609020.0,159776198.0,0.5704,0.5725,0.5702,0.5727
2023-07-03 14:10,4401,1647,2754,447176,77983,369193,255928871.0,44479075.0,211449795.0,4389,1643,2746,447195,77809,369386,255941575.0,44379386.0,211562188.0,0.5704,0.5727,0.5704,0.5727
2023-07-03 14:15,1746,517,1229,169174,29509,139665,96789663.0,16844885.0,79944778.0,1731,511,1220,168169,28949,139220,96187699.0,16493984.0,79693715.0,0.5708,0.5724,0.5698,0.5724
2023-07-03 14:20,3123,1113,2010,275995,64139,211856,157829956.0,36575129.0,121254826.0,3118,1111,2007,275726,64160,211566,157685150.0,36586926.0,121098223.0,0.5702,0.5723,0.5702,0.5724
2023-07-03 14:25,2025,460,1565,193369,27192,166177,110623289.0,15490951.0,95132338.0,2019,455,1564,193141,26957,166184,110493640.0,15357360.0,95136279.0,0.5697,0.5725,0.5697,0.5725
2023-07-03 14:30,1835,669,1166,181582,57991,123591,103701342.0,32935365.0,70765977.0,1829,665,1164,181791,58263,123528,103818753.0,33088879.0,70729874.0,0.5679,0.5726,0.5679,0.5726
2023-07-03 14:35,1324,320,1004,146096,17070,129026,83635479.0,9698300.0,73937179.0,1319,315,1004,145178,16120,129058,83111779.0,9156413.0,73955366.0,0.5681,0.573,0.568,0.573
2023-07-03 14:40,309,51,258,28819,1370,27449,16506766.0,779781.0,15726984.0,301,47,254,28538,1126,27412,16348602.0,642473.0,15706128.0,0.5692,0.573,0.5706,0.573
2023-07-03 14:45,3766,1208,2558,378394,92113,286281,216471108.0,52501823.0,163969285.0,3748,1199,2549,376639,91810,284829,215462452.0,52318538.0,163143913.0,0.57,0.5728,0.5699,0.5728
2023-07-03 14:50,462,114,348,49652,8515,41137,28422978.0,4852321.0,23570657.0,458,112,346,48162,7892,40270,27570193.0,4498474.0,23071718.0,0.5699,0.573,0.57,0.5729
2023-07-03 14:55,720,227,493,69916,4121,65795,40051640.0,2351885.0,37699754.0,711,223,488,70585,4642,65943,40429047.0,2645265.0,37783781.0,0.5707,0.573,0.5699,0.573
2023-07-03 15:00,115,46,69,5248,1323,3925,3014442.0,764563.0,2249879.0,99,36,63,4743,1001,3742,2721307.0,570753.0,2150553.0,0.5779,0.5732,0.5702,0.5747
2023-07-03 15:05,38,11,27,2075,547,1528,1186041.0,311265.0,874776.0,31,7,24,1490,423,1067,852329.0,240497.0,611831.0,0.569,0.5725,0.5686,0.5734
2023-07-03 15:10,125,71,54,10556,8190,2366,6011220.0,4654263.0,1356957.0,117,67,50,10571,8303,2268,6017483.0,4718271.0,1299211.0,0.5683,0.5735,0.5683,0.5728
2023-07-03 15:15,78,30,48,6533,2701,3832,3735123.0,1538066.0,2197057.0,69,25,44,6688,2671,4017,3825135.0,1520877.0,2304258.0,0.5694,0.5733,0.5694,0.5736
2023-07-03 15:20,287,100,187,28719,12967,15752,16378507.0,7344447.0,9034059.0,282,97,185,28582,12954,15628,16300099.0,7336833.0,8963266.0,0.5664,0.5735,0.5664,0.5735
2023-07-03 15:25,153,52,101,13960,5710,8250,7961031.0,3233306.0,4727724.0,149,50,99,14032,5558,8474,8003892.0,3146941.0,4856950.0,0.5663,0.5731,0.5662,0.5732
2023-07-03 15:30,715,58,657,59081,1409,57672,33805093.0,801862.0,33003231.0,706,54,652,59137,1286,57851,33841922.0,731635.0,33110286.0,0.5691,0.5723,0.5689,0.5723
2023-07-03 15:35,243,54,189,29647,7107,22540,16942261.0,4038306.0,12903954.0,235,52,183,29409,7243,22166,16805973.0,4115892.0,12690081.0,0.5682,0.5725,0.5683,0.5725
2023-07-03 15:40,237,19,218,28820,1635,27185,16502274.0,935237.0,15567037.0,231,11,220,28990,1379,27611,16594953.0,783171.0,15811782.0,0.572,0.5726,0.5679,0.5727
2023-07-03 15:45,511,30,481,61987,3136,58851,35454849.0,1781064.0,33673785.0,506,27,479,61695,2988,58707,35288660.0,1697244.0,33591415.0,0.5679,0.5722,0.568,0.5722
2023-07-03 15:50,566,25,541,61884,740,61144,35403531.0,415244.0,34988286.0,548,12,536,61383,445,60938,35121343.0,251062.0,34870281.0,0.5611,0.5722,0.5642,0.5722
2023-07-03 15:55,1041,89,952,107970,9173,98797,61704803.0,5191978.0,56512825.0,1031,84,947,107845,9152,98693,61632608.0,5178181.0,56454427.0,0.566,0.572,0.5658,0.572
2023-07-03 16:00,972,103,869,108097,11432,96665,61786880.0,6470990.0,55315890.0,966,97,869,108116,11466,96650,61798462.0,6490009.0,55308453.0,0.566,0.5722,0.566,0.5723
2023-07-03 16:05,393,71,322,42721,6646,36075,24407071.0,3764387.0,20642683.0,389,68,321,42559,6543,36016,24314768.0,3705130.0,20609637.0,0.5664,0.5722,0.5663,0.5722
2023-07-03 16:10,1227,59,1168,148681,5626,143055,85087986.0,3194774.0,81893212.0,1225,59,1166,148766,5737,143029,85135873.0,3257702.0,81878171.0,0.5679,0.5725,0.5678,0.5725
2023-07-03 16:15,940,128,812,99223,11840,87383,56723956.0,6725544.0,49998411.0,939,126,813,99503,11892,87611,56883715.0,6754514.0,50129201.0,0.568,0.5722,0.568,0.5722
2023-07-03 16:20,875,38,837,101666,1856,99810,58176770.0,1055902.0,57120868.0,866,32,834,101273,1632,99641,57950555.0,926423.0,57024131.0,0.5689,0.5723,0.5677,0.5723
2023-07-03 16:25,981,59,922,100627,4080,96547,57562719.0,2315274.0,55247445.0,977,57,920,99076,4069,95007,56671469.0,2309004.0,54362464.0,0.5675,0.5722,0.5675,0.5722
2023-07-03 16:30,1701,404,1297,168396,38447,129949,96081473.0,21758055.0,74323418.0,1690,402,1288,168280,38396,129884,96014950.0,21725342.0,74289608.0,0.5659,0.5719,0.5658,0.572
2023-07-03 16:35,774,102,672,71288,9036,62252,40727846.0,5119838.0,35608008.0,771,100,671,71284,9014,62270,40724788.0,5106415.0,35618372.0,0.5666,0.572,0.5665,0.572
2023-07-03 16:40,106,20,86,8351,1554,6797,4759583.0,879790.0,3879792.0,103,18,85,8232,1551,6681,4696430.0,878192.0,3818237.0,0.5661,0.5708,0.5662,0.5715
2023-07-03 16:45,133,29,104,12324,2677,9647,7006618.0,1516193.0,5490424.0,131,28,103,11647,2486,9161,6656859.0,1407492.0,5249367.0,0.5664,0.5691,0.5662,0.573
2023-07-03 16:50,173,18,155,15471,455,15016,8844319.0,258723.0,8585596.0,161,11,150,15010,428,14582,8583155.0,242454.0,8340700.0,0.5686,0.5718,0.5665,0.572
2023-07-03 16:55,52,6,46,4129,342,3787,2360327.0,193817.0,2166510.0,54,7,47,4162,299,3863,2379851.0,169341.0,2210510.0,0.5667,0.5721,0.5664,0.5722
2023-07-03 17:00,472,107,365,41172,12492,28680,23473467.0,7080990.0,16392477.0,461,98,363,41051,12424,28627,23411786.0,7042699.0,16369086.0,0.5668,0.5716,0.5669,0.5718
2023-07-03 17:05,173,103,70,21338,16340,4998,12132496.0,9276095.0,2856401.0,171,101,70,21317,16415,4902,12115044.0,9313557.0,2801486.0,0.5677,0.5715,0.5674,0.5715
2023-07-03 17:10,154,109,45,23874,18957,4917,13585729.0,10769831.0,2815898.0,148,105,43,22488,18769,3719,12778764.0,10649906.0,2128857.0,0.5681,0.5727,0.5674,0.5724
2023-07-03 17:15,684,174,510,64611,17950,46661,36850126.0,10187927.0,26662198.0,680,170,510,64417,17764,46653,36739941.0,10082050.0,26657891.0,0.5676,0.5714,0.5676,0.5714
2023-07-03 17:20,447,34,413,38808,995,37813,22187419.0,565337.0,21622082.0,445,34,411,38766,995,37771,22162499.0,565269.0,21597230.0,0.5682,0.5718,0.5681,0.5718
2023-07-03 17:25,399,61,338,35390,5293,30097,20205114.0,3004516.0,17200598.0,390,57,333,34884,4892,29992,19918504.0,2775330.0,17143174.0,0.5676,0.5715,0.5673,0.5716
2023-07-03 17:30,29,13,16,1188,301,887,679010.0,171337.0,507673.0,16,4,12,1063,257,806,606144.0,144954.0,461190.0,0.5692,0.5723,0.564,0.5722
2023-07-03 17:35,199,105,94,14910,8368,6542,8482422.0,4736360.0,3746062.0,193,102,91,15003,8404,6599,8535724.0,4756667.0,3779057.0,0.566,0.5726,0.566,0.5727
2023-07-03 17:40,185,73,112,13723,6392,7331,7823080.0,3629685.0,4193394.0,166,64,102,13312,6113,7199,7589720.0,3471045.0,4118675.0,0.5678,0.572,0.5678,0.5721
2023-07-03 17:45,52,4,48,6612,23,6589,3778359.0,13058.0,3765301.0,48,2,46,6668,2,6666,3810658.0,1128.0,3809530.0,0.5677,0.5715,0.5642,0.5715
2023-07-03 17:50,21,6,15,777,127,650,443693.0,71919.0,371774.0,21,5,16,785,125,660,448475.0,70782.0,377693.0,0.5663,0.572,0.5663,0.5723
2023-07-03 17:55,38,17,21,2615,958,1657,1491356.0,544813.0,946543.0,25,9,16,2231,780,1451,1272263.0,443167.0,829096.0,0.5687,0.5712,0.5682,0.5714
2023-07-03 18:00,122,24,98,10538,2765,7773,6013230.0,1569439.0,4443791.0,118,24,94,10831,3320,7511,6165386.0,1867921.0,4297464.0,0.5676,0.5717,0.5626,0.5722
2023-07-03 18:05,1378,415,963,150325,67514,82811,97343661.0,50168295.0,47175366.0,1365,410,955,149639,67568,82071,97023694.0,50198726.0,46824967.0,0.7431,0.5697,0.7429,0.5705
2023-07-03 18:10,432,72,360,46980,6262,40718,26795442.0,3550003.0,23245438.0,424,68,356,46617,6126,40491,26593890.0,3472791.0,23121099.0,0.5669,0.5709,0.5669,0.571
2023-07-03 18:15,1386,234,1152,170235,19533,150702,97128740.0,11094927.0,86033812.0,1381,231,1150,169908,19530,150378,96942013.0,11093143.0,85848870.0,0.568,0.5709,0.568,0.5709
2023-07-03 18:20,1740,369,1371,206857,20966,185891,118018020.0,11904478.0,106113541.0,1732,364,1368,206447,20972,185475,117784636.0,11908009.0,105876626.0,0.5678,0.5708,0.5678,0.5708
2023-07-03 18:25,490,413,77,52985,40510,12475,30122636.0,23007662.0,7114974.0,479,405,74,52657,40463,12194,29935560.0,22979089.0,6956470.0,0.568,0.5703,0.5679,0.5705
2023-07-03 18:30,1206,515,691,126138,31723,94415,71875842.0,17994115.0,53881726.0,1191,503,688,125215,30982,94233,71353631.0,17573851.0,53779780.0,0.5672,0.5707,0.5672,0.5707
2023-07-03 18:35,2319,405,1914,283392,17641,265751,161416162.0,9971785.0,151444376.0,2291,379,1912,284364,17597,266767,161980096.0,9953856.0,152026240.0,0.5653,0.5699,0.5657,0.5699
2023-07-04 10:00,2751,1134,1617,243613,100007,143606,146131916.0,64194856.0,81937060.0,2499,1028,1471,228953,90870,138083,132283640.0,53664242.0,78619398.0,0.6419,0.5706,0.5906,0.5694
2023-07-04 10:05,667,518,149,46531,34671,11860,38373750.0,31540103.0,6833647.0,589,505,84,43595,34545,9050,30281314.0,25089925.0,5191389.0,0.9097,0.5762,0.7263,0.5736
2023-07-04 10:10,2526,2199,327,236558,230657,5901,146016445.0,142627623.0,3388821.0,2477,2176,301,235178,230243,4935,145217882.0,142392841.0,2825040.0,0.6184,0.5743,0.6184,0.5724
2023-07-04 10:15,1374,1252,122,108255,100478,7777,61372619.0,56884533.0,4488086.0,1320,1213,107,106736,99832,6904,60508972.0,56559091.0,3949881.0,0.5661,0.5771,0.5665,0.5721
2023-07-04 10:20,4153,2714,1439,381032,279426,101606,228219330.0,170236306.0,57983023.0,4109,2684,1425,379563,278506,101057,227433388.0,169719145.0,57714242.0,0.6092,0.5707,0.6094,0.5711
2023-07-04 10:25,6988,1979,5009,974202,180073,794129,755535124.0,303720714.0,451814410.0,6837,1898,4939,969400,178119,791281,752903698.0,302618219.0,450285479.0,1.6867,0.5689,1.699,0.5691
2023-07-04 10:30,1766,512,1254,133717,15105,118612,99768139.0,32312916.0,67455222.0,1722,489,1233,133688,14888,118800,99728532.0,32170658.0,67557874.0,2.1392,0.5687,2.1608,0.5687
2023-07-04 10:35,294,117,177,20858,3200,17658,23769944.0,13695608.0,10074336.0,264,97,167,14932,2024,12908,20384837.0,13021815.0,7363021.0,4.2799,0.5705,6.4337,0.5704
2023-07-04 10:40,933,230,703,78532,11430,67102,44731626.0,6477985.0,38253640.0,908,213,695,80505,9475,71030,45864899.0,5371380.0,40493519.0,0.5668,0.5701,0.5669,0.5701
2023-07-04 10:45,3250,556,2694,337118,24045,313073,192030721.0,13638856.0,178391865.0,3230,545,2685,336842,23949,312893,191879971.0,13585247.0,178294724.0,0.5672,0.5698,0.5673,0.5698
2023-07-04 10:50,2592,1369,1223,202105,82533,119572,126899759.0,58747995.0,68151764.0,2567,1356,1211,195560,76389,119171,123204575.0,55280952.0,67923622.0,0.7118,0.57,0.7237,0.57
2023-07-04 10:55,3193,2624,569,381050,321762,59288,288539328.0,254539043.0,34000285.0,3131,2596,535,383114,324840,58274,289570183.0,256148510.0,33421672.0,0.7911,0.5735,0.7885,0.5735
2023-07-04 11:00,2326,1445,881,197433,140855,56578,112629385.0,80217973.0,32411412.0,2276,1413,863,194783,139669,55114,111115685.0,79554200.0,31561484.0,0.5695,0.5729,0.5696,0.5727
2023-07-04 11:05,533,284,249,52797,33014,19783,30123961.0,18787701.0,11336259.0,519,279,240,52079,32840,19239,29712892.0,18688761.0,11024130.0,0.5691,0.573,0.5691,0.573
2023-07-04 11:10,961,238,723,60248,10679,49569,34404113.0,6048632.0,28355481.0,938,219,719,59896,10900,48996,34225212.0,6198821.0,28026390.0,0.5664,0.572,0.5687,0.572
2023-07-04 11:15,4248,2437,1811,571504,434931,136573,325325475.0,247215665.0,78109810.0,4226,2425,1801,567120,434528,132592,322808794.0,246987511.0,75821282.0,0.5684,0.5719,0.5684,0.5718
2023-07-04 11:20,3194,2045,1149,402735,315272,87463,241129676.0,191105194.0,50024482.0,3178,2035,1143,406845,315000,91845,243501909.0,190954435.0,52547474.0,0.6062,0.572,0.6062,0.5721
2023-07-04 11:25,2367,1139,1228,248500,151195,97305,141580832.0,85920815.0,55660016.0,2332,1115,1217,247290,150254,97036,140891119.0,85384262.0,55506857.0,0.5683,0.572,0.5683,0.572
2023-07-04 11:30,2245,784,1461,210126,65086,145040,119969514.0,37008600.0,82960914.0,2223,771,1452,209530,65212,144318,119590428.0,37079813.0,82510614.0,0.5686,0.572,0.5686,0.5717
2023-07-04 11:35,3066,1544,1522,367940,199039,168901,209691591.0,113156625.0,96534965.0,3051,1530,1521,367299,198743,168556,209331287.0,112994787.0,96336500.0,0.5685,0.5715,0.5685,0.5715
2023-07-04 11:40,1689,702,987,153385,78367,75018,87401697.0,44537830.0,42863866.0,1686,700,986,153240,78395,74845,87321155.0,44553773.0,42767382.0,0.5683,0.5714,0.5683,0.5714
2023-07-04 11:45,839,319,520,52137,13618,38519,29716323.0,7730980.0,21985343.0,830,315,515,52277,14122,38155,29794814.0,8017310.0,21777503.0,0.5677,0.5708,0.5677,0.5708
2023-07-04 11:50,3596,1381,2215,354593,85829,268764,202280911.0,48760325.0,153520586.0,3580,1371,2209,353728,85299,268429,201805169.0,48458659.0,153346510.0,0.5681,0.5712,0.5681,0.5713
2023-07-04 11:55,3143,1518,1625,346036,102243,243793,197444245.0,58069117.0,139375128.0,3130,1505,1625,345515,101812,243703,197176058.0,57852404.0,139323654.0,0.568,0.5717,0.5682,0.5717
2023-07-04 12:00,2658,952,1706,299361,58599,240762,170974466.0,33327273.0,137647192.0,2645,943,1702,299459,58858,240601,171030159.0,33474691.0,137555467.0,0.5687,0.5717,0.5687,0.5717
2023-07-04 12:05,3990,1736,2254,466788,184347,282441,266369701.0,104871172.0,161498528.0,3977,1731,2246,465599,183296,282303,265692716.0,104270417.0,161422299.0,0.5689,0.5718,0.5689,0.5718
2023-07-04 12:10,436,157,279,21997,5775,16222,12573843.0,3286607.0,9287236.0,417,151,266,21186,5678,15508,12104769.0,3229623.0,8875146.0,0.5691,0.5725,0.5688,0.5723
2023-07-04 12:15,409,203,206,11542,5692,5850,18446700.0,15120274.0,3326425.0,394,195,199,10323,4584,5739,17770576.0,14487225.0,3283351.0,2.6564,0.5686,3.1604,0.5721
2023-07-04 12:20,594,328,266,33096,17099,15997,18919104.0,9747704.0,9171399.0,574,310,264,32728,17073,15655,18711847.0,9736411.0,8975436.0,0.5701,0.5733,0.5703,0.5733
2023-07-04 12:25,850,499,351,53071,31326,21745,30338484.0,17877183.0,12461301.0,830,489,341,53016,31326,21690,30313533.0,17878564.0,12434968.0,0.5707,0.5731,0.5707,0.5733
2023-07-04 12:30,1920,1027,893,139544,75411,64133,79804064.0,43039657.0,36764407.0,1907,1022,885,139236,75260,63976,79624855.0,42952358.0,36672497.0,0.5707,0.5733,0.5707,0.5732
2023-07-04 12:35,2903,1572,1331,368464,279702,88762,222344883.0,171489391.0,50855492.0,2878,1563,1315,367708,279933,87775,221949094.0,171619569.0,50329524.0,0.6131,0.5729,0.6131,0.5734
2023-07-04 12:40,4183,1878,2305,563941,291867,272074,345989703.0,190211257.0,155778445.0,4144,1860,2284,561000,291339,269661,344383782.0,189911730.0,154472052.0,0.6517,0.5726,0.6519,0.5728
2023-07-04 12:45,5137,716,4421,812750,11399,801351,465220545.0,6483350.0,458737195.0,5124,711,4413,812120,11295,800825,464862645.0,6424981.0,458437664.0,0.5688,0.5725,0.5688,0.5725
2023-07-04 12:50,5519,776,4743,837886,17805,820081,479655712.0,10128341.0,469527371.0,5496,754,4742,837556,17473,820083,479481154.0,9948996.0,469532157.0,0.5688,0.5725,0.5694,0.5725
2023-07-04 12:55,5315,513,4802,784921,7470,777451,449453451.0,4265860.0,445187591.0,5302,506,4796,785006,7294,777712,449487742.0,4153186.0,445334556.0,0.5711,0.5726,0.5694,0.5726
2023-07-04 13:00,4713,466,4247,707254,8702,698552,405019400.0,4961468.0,400057931.0,4711,463,4248,707771,8688,699083,405313985.0,4951797.0,400362188.0,0.5702,0.5727,0.57,0.5727
2023-07-04 13:05,3400,293,3107,540122,9022,531100,309334685.0,5140663.0,304194022.0,3388,290,3098,539497,9109,530388,308985931.0,5190153.0,303795777.0,0.5698,0.5728,0.5698,0.5728
2023-07-04 13:10,3759,813,2946,469598,36823,432775,268771902.0,20956882.0,247815020.0,3748,803,2945,468339,35889,432450,268061891.0,20432368.0,247629522.0,0.5691,0.5726,0.5693,0.5726
2023-07-04 13:15,2641,852,1789,264660,59048,205612,151241355.0,33609832.0,117631523.0,2631,847,1784,264913,59063,205850,151385495.0,33617407.0,117768088.0,0.5692,0.5721,0.5692,0.5721
2023-07-04 13:20,4708,1465,3243,473139,74250,398889,270425951.0,42253232.0,228172718.0,4680,1440,3240,472387,73601,398786,269988181.0,41871688.0,228116493.0,0.5691,0.572,0.5689,0.572
2023-07-04 13:25,2921,1023,1898,287862,28038,259824,164702342.0,15971473.0,148730869.0,2910,1014,1896,285039,25788,259251,163090202.0,14686556.0,148403646.0,0.5696,0.5724,0.5695,0.5724
2023-07-04 13:30,121,38,83,12220,1358,10862,6983360.0,760769.0,6222590.0,113,32,81,13371,2353,11018,7652258.0,1339341.0,6312916.0,0.5602,0.5729,0.5692,0.573
2023-07-04 13:35,611,257,354,26317,4756,21561,15057950.0,2717413.0,12340537.0,601,251,350,25569,4605,20964,14628764.0,2627484.0,12001279.0,0.5714,0.5724,0.5706,0.5725
2023-07-04 13:40,126,92,34,9916,6709,3207,5652709.0,3815241.0,1837468.0,123,90,33,9731,6708,3023,5546846.0,3814064.0,1732782.0,0.5687,0.573,0.5686,0.5732
2023-07-04 13:45,345,201,144,24272,10755,13517,13855621.0,6120290.0,7735331.0,339,196,143,23274,10308,12966,13287489.0,5866753.0,7420736.0,0.5691,0.5723,0.5691,0.5723
2023-07-04 13:50,732,415,317,55036,25243,29793,31419361.0,14372548.0,17046813.0,725,413,312,55142,25478,29664,31479918.0,14505105.0,16974812.0,0.5694,0.5722,0.5693,0.5722
2023-07-04 13:55,1144,827,317,79557,55975,23582,45347685.0,31864992.0,13482692.0,1118,814,304,78309,55361,22948,44637094.0,31516107.0,13120987.0,0.5693,0.5717,0.5693,0.5718
2023-07-04 14:00,1611,1126,485,145773,95290,50483,83143040.0,54271523.0,28871516.0,1594,1114,480,145512,94974,50538,82992704.0,54090888.0,28901816.0,0.5695,0.5719,0.5695,0.5719
2023-07-04 14:05,1020,622,398,110785,52758,58027,63258845.0,30070015.0,33188830.0,1013,615,398,110897,52713,58184,63318891.0,30040228.0,33278663.0,0.57,0.572,0.5699,0.572
2023-07-04 14:10,1230,461,769,125414,27424,97990,71679535.0,15634174.0,56045361.0,1227,460,767,125377,27364,98013,71661279.0,15599648.0,56061631.0,0.5701,0.5719,0.5701,0.572
2023-07-04 14:15,2582,1468,1114,207142,98906,108236,118286273.0,56379452.0,61906821.0,2569,1463,1106,206445,98806,107639,117887217.0,56322696.0,61564521.0,0.57,0.572,0.57,0.572
2023-07-04 14:20,207,158,49,15873,12253,3620,9052582.0,6982178.0,2070404.0,196,152,44,15888,12304,3584,9060039.0,7010187.0,2049852.0,0.5698,0.5719,0.5697,0.5719
2023-07-04 14:25,1386,697,689,111210,50716,60494,63487096.0,28891914.0,34595182.0,1395,702,693,111672,50965,60707,63749460.0,29031957.0,34717503.0,0.5697,0.5719,0.5696,0.5719
2023-07-04 14:30,452,203,249,25766,8027,17739,14710347.0,4569264.0,10141083.0,440,196,244,25073,7689,17384,14315482.0,4377403.0,9938079.0,0.5692,0.5717,0.5693,0.5717
2023-07-04 14:35,682,300,382,48101,16413,31688,27463925.0,9345193.0,18118731.0,678,297,381,48022,16237,31785,27417989.0,9244075.0,18173913.0,0.5694,0.5718,0.5693,0.5718
2023-07-04 14:40,404,227,177,23926,12221,11705,13654393.0,6960428.0,6693965.0,399,224,175,24018,12337,11681,13707626.0,7026807.0,6680818.0,0.5695,0.5719,0.5696,0.5719
2023-07-04 14:45,252,136,116,5534,3441,2093,3156995.0,1960766.0,1196229.0,243,132,111,5459,3379,2080,3114354.0,1925578.0,1188776.0,0.5698,0.5715,0.5699,0.5715
2023-07-04 14:50,1146,493,653,114247,40079,74168,65242655.0,22823672.0,42418983.0,1144,494,650,114372,40267,74105,65313718.0,22930702.0,42383015.0,0.5695,0.5719,0.5695,0.5719
2023-07-04 14:55,1931,784,1147,237227,90059,147168,135430919.0,51267349.0,84163570.0,1925,781,1144,234402,87234,147168,133820041.0,49656860.0,84163181.0,0.5693,0.5719,0.5692,0.5719
2023-07-04 15:00,481,142,339,29704,7299,22405,17359155.0,4156762.0,13202393.0,472,136,336,28837,6661,22176,16475317.0,3793062.0,12682255.0,0.5695,0.5893,0.5694,0.5719
2023-07-04 15:05,87,28,59,9311,1362,7949,5323708.0,776909.0,4546798.0,79,22,57,9225,1287,7938,5274094.0,734207.0,4539886.0,0.5704,0.572,0.5705,0.5719
2023-07-04 15:10,85,33,52,8368,1760,6608,4785126.0,1004892.0,3780233.0,76,25,51,10493,3838,6655,5993968.0,2186570.0,3807398.0,0.571,0.5721,0.5697,0.5721
2023-07-04 15:15,27,13,14,2932,737,2195,1676012.0,420756.0,1255256.0,33,21,12,2956,906,2050,1678265.0,506219.0,1172046.0,0.5709,0.5719,0.5587,0.5717
2023-07-04 15:20,372,152,220,24616,6620,17996,14104615.0,3812124.0,10292490.0,364,147,217,24280,6171,18109,13873154.0,3514435.0,10358718.0,0.5758,0.5719,0.5695,0.572
2023-07-04 15:25,568,326,242,34081,21119,12962,19465909.0,12047557.0,7418352.0,559,320,239,33439,20530,12909,19099405.0,11709779.0,7389626.0,0.5705,0.5723,0.5704,0.5724
2023-07-04 15:30,856,358,498,70576,32735,37841,64079834.0,42434397.0,21645437.0,821,339,482,68523,32032,36491,62896833.0,42020241.0,20876592.0,1.2963,0.572,1.3118,0.5721
2023-07-04 15:35,2618,821,1797,283747,72753,210994,162020401.0,41389097.0,120631303.0,2598,812,1786,281162,71906,209256,160550454.0,40906980.0,119643473.0,0.5689,0.5717,0.5689,0.5718
2023-07-04 15:40,928,273,655,101819,8493,93326,58145061.0,4830257.0,53314804.0,902,250,652,100965,7642,93323,57660755.0,4348316.0,53312438.0,0.5687,0.5713,0.569,0.5713
2023-07-04 15:45,2518,463,2055,341897,40057,301840,206993102.0,34654721.0,172338381.0,2499,446,2053,339511,39154,300357,205685988.0,34143220.0,171542768.0,0.8651,0.571,0.872,0.5711
2023-07-04 15:50,5505,1077,4428,838326,42887,795439,478762669.0,24385233.0,454377436.0,5484,1064,4420,837362,42832,794530,478213132.0,24351877.0,453861255.0,0.5686,0.5712,0.5685,0.5712
2023-07-04 15:55,5726,956,4770,851505,28947,822558,509931807.0,40189730.0,469742077.0,5683,925,4758,849415,27859,821556,508748185.0,39570444.0,469177741.0,1.3884,0.5711,1.4204,0.5711
2023-07-04 16:00,4832,923,3909,689098,33747,655351,464643947.0,90409013.0,374234933.0,4811,906,3905,687188,32695,654493,463555388.0,89809463.0,373745924.0,2.679,0.571,2.7469,0.571
2023-07-04 16:05,2871,613,2258,431807,23450,408357,246544898.0,13319772.0,233225126.0,2851,599,2252,430817,23242,407575,245982281.0,13201435.0,232780846.0,0.568,0.5711,0.568,0.5711
2023-07-04 16:10,6007,1790,4217,831450,67724,763726,474478745.0,38440525.0,436038219.0,5995,1782,4213,831573,67593,763980,474548496.0,38366078.0,436182417.0,0.5676,0.5709,0.5676,0.5709
2023-07-04 16:15,6470,2094,4376,871770,76120,795650,497451188.0,43228023.0,454223164.0,6464,2091,4373,871531,76030,795501,497316275.0,43177004.0,454139270.0,0.5679,0.5709,0.5679,0.5709
2023-07-04 16:20,5156,1684,3472,721307,60769,660538,411673616.0,34503538.0,377170077.0,5147,1679,3468,720976,60666,660310,411490977.0,34450405.0,377040571.0,0.5678,0.571,0.5679,0.571
2023-07-04 16:25,4917,1418,3499,730779,59079,671700,417014653.0,33561797.0,383452856.0,4914,1416,3498,730562,58801,671761,416890770.0,33403763.0,383487007.0,0.5681,0.5709,0.5681,0.5709
2023-07-04 16:30,6143,1714,4429,871569,66616,804953,497298177.0,37835245.0,459462932.0,6126,1705,4421,871095,66544,804551,497043116.0,37794137.0,459248979.0,0.568,0.5708,0.568,0.5708
2023-07-04 16:35,1124,382,742,142371,17422,124949,81197166.0,9893341.0,71303824.0,1123,381,742,142437,17426,125011,81235748.0,9895668.0,71340080.0,0.5679,0.5707,0.5679,0.5707
2023-07-04 16:40,3072,791,2281,464881,48302,416579,347837014.0,110483688.0,237353325.0,3035,761,2274,458066,46804,411262,343995746.0,109639104.0,234356642.0,2.2874,0.5698,2.3425,0.5698
2023-07-04 16:45,3178,273,2905,545280,6560,538720,322578735.0,15589859.0,306988876.0,3142,257,2885,544012,5606,538406,321854994.0,15049093.0,306805901.0,2.3765,0.5698,2.6845,0.5698
2023-07-04 16:50,699,104,595,90038,2919,87119,51224557.0,1652594.0,49571962.0,691,99,592,89572,2738,86834,50961151.0,1549692.0,49411459.0,0.5662,0.569,0.566,0.569
2023-07-04 16:55,114,33,81,10856,1459,9397,18043936.0,12701119.0,5342817.0,98,23,75,10480,1273,9207,17832093.0,12594539.0,5237554.0,8.7054,0.5686,9.8936,0.5689
2023-07-04 17:00,344,13,331,37036,569,36467,21065572.0,322199.0,20743373.0,330,6,324,36576,310,36266,20803977.0,174979.0,20628997.0,0.5663,0.5688,0.5645,0.5688
2023-07-04 17:05,506,19,487,54765,504,54261,31149076.0,282495.0,30866581.0,511,13,498,55482,387,55095,31561027.0,218782.0,31342244.0,0.5605,0.5689,0.5653,0.5689
2023-07-04 17:10,408,48,360,62352,4010,58342,35497316.0,2265821.0,33231495.0,393,43,350,61986,4407,57579,35288481.0,2491247.0,32797233.0,0.565,0.5696,0.5653,0.5696
2023-07-04 17:15,407,278,129,56407,43493,12914,31959381.0,24613016.0,7346364.0,404,277,127,56493,43703,12790,32007686.0,24732013.0,7275673.0,0.5659,0.5689,0.5659,0.5689
2023-07-04 17:20,1414,243,1171,202590,19891,182699,115263454.0,11250304.0,104013150.0,1407,238,1169,202272,19663,182609,115073453.0,11112141.0,103961311.0,0.5656,0.5693,0.5651,0.5693
2023-07-04 17:25,1114,186,928,111799,15426,96373,63620890.0,8751315.0,54869575.0,1103,179,924,111540,14920,96620,63451980.0,8441082.0,55010897.0,0.5673,0.5693,0.5658,0.5694
2023-07-04 17:30,1615,418,1197,160539,42261,118278,91180954.0,23854315.0,67326639.0,1607,414,1193,160479,42361,118118,91145734.0,23909657.0,67236077.0,0.5645,0.5692,0.5644,0.5692
2023-07-04 17:35,1638,208,1430,177031,9198,167833,112566170.0,17081397.0,95484773.0,1623,198,1425,175959,8901,167058,111960508.0,16913581.0,95046926.0,1.8571,0.5689,1.9002,0.5689
2023-07-04 17:40,4766,2595,2171,491993,246020,245973,302773223.0,162870101.0,139903121.0,4734,2573,2161,490677,244753,245924,301962503.0,162086615.0,139875887.0,0.662,0.5688,0.6622,0.5688
2023-07-04 17:45,3835,1222,2613,276643,62582,214061,157035092.0,35355852.0,121679239.0,3802,1203,2599,274400,61614,212786,155761215.0,34803426.0,120957788.0,0.565,0.5684,0.5649,0.5684
2023-07-04 17:50,3152,989,2163,269620,80244,189376,176652919.0,69046560.0,107606358.0,3123,969,2154,267976,80065,187911,175727438.0,68945057.0,106782380.0,0.8605,0.5682,0.8611,0.5683
2023-07-04 17:55,1231,278,953,127386,15552,111834,107610120.0,44364088.0,63246032.0,993,129,864,117410,10497,106913,102079061.0,41503739.0,60575322.0,2.8526,0.5655,3.9539,0.5666
2023-07-04 18:00,873,273,600,48997,6200,42797,27601208.0,3487062.0,24114146.0,758,194,564,46728,5759,40969,26356359.0,3216476.0,23139882.0,0.5624,0.5635,0.5585,0.5648
2023-07-04 18:05,1090,142,948,138356,2521,135835,78168161.0,1417747.0,76750413.0,1032,87,945,137478,1502,135976,77672974.0,843045.0,76829928.0,0.5624,0.565,0.5613,0.565
2023-07-04 18:10,599,103,496,85775,5934,79841,60408991.0,15233770.0,45175220.0,548,78,470,80819,1596,79223,57598928.0,12772753.0,44826175.0,2.5672,0.5658,8.003,0.5658
2023-07-04 18:15,1822,219,1603,249964,6998,242966,153427642.0,15820362.0,137607279.0,1783,193,1590,248864,6096,242768,152801589.0,15308408.0,137493181.0,2.2607,0.5664,2.5112,0.5664
2023-07-04 18:20,1810,237,1573,261164,4479,256685,147895113.0,2520430.0,145374683.0,1788,217,1571,260329,3871,256458,147430261.0,2180825.0,145249435.0,0.5627,0.5664,0.5634,0.5664
2023-07-04 18:25,2054,284,1770,258805,5602,253203,146576194.0,3155974.0,143420219.0,2034,269,1765,257504,4076,253428,145850314.0,2295724.0,143554589.0,0.5634,0.5664,0.5632,0.5665
2023-07-04 18:30,1825,369,1456,190107,7962,182145,107633333.0,4491030.0,103142303.0,1810,364,1446,190144,8718,181426,107670344.0,4909108.0,102761236.0,0.5641,0.5663,0.5631,0.5664
2023-07-04 18:35,1580,141,1439,217878,3178,214700,123425463.0,1792529.0,121632934.0,1565,126,1439,218136,2955,215181,123569784.0,1665741.0,121904042.0,0.564,0.5665,0.5637,0.5665
2023-07-05 10:00,3671,1693,1978,491800,191205,300595,321970361.0,150573384.0,171396977.0,3390,1582,1808,481887,188825,293062,309367310.0,142443518.0,166923791.0,0.7875,0.5702,0.7544,0.5696
2023-07-05 10:05,2275,1720,555,289727,263097,26630,192578127.0,177191976.0,15386151.0,2114,1655,459,281718,259029,22689,183086918.0,170098900.0,12988018.0,0.6735,0.5778,0.6567,0.5724
2023-07-05 10:10,2504,1528,976,213843,173257,40586,121906180.0,98674283.0,23231897.0,2374,1462,912,208594,170813,37781,118884196.0,97244137.0,21640059.0,0.5695,0.5724,0.5693,0.5728
2023-07-05 10:15,2915,1280,1635,238841,131108,107733,136226324.0,74534837.0,61691486.0,2855,1242,1613,236799,129601,107198,135075125.0,73689112.0,61386013.0,0.5685,0.5726,0.5686,0.5726
2023-07-05 10:20,3602,1533,2069,331788,183398,148390,189468213.0,104443450.0,85024763.0,3522,1470,2052,331140,183133,148007,189095817.0,104288523.0,84807294.0,0.5695,0.573,0.5695,0.573
2023-07-05 10:25,2726,1485,1241,242358,162685,79673,138264588.0,92651964.0,45612624.0,2690,1479,1211,241526,162968,78558,137784890.0,92811734.0,44973156.0,0.5695,0.5725,0.5695,0.5725
2023-07-05 10:30,3408,2287,1121,396716,342598,54118,238169991.0,207154609.0,31015382.0,3280,2245,1035,393252,340898,52354,236148323.0,206187145.0,29961178.0,0.6047,0.5731,0.6048,0.5723
2023-07-05 10:35,4745,3728,1017,645498,618152,27346,513346743.0,497468629.0,15878114.0,4268,3546,722,610469,595510,14959,492457603.0,483802521.0,8655081.0,0.8048,0.5806,0.8124,0.5786
2023-07-05 10:40,3341,2372,969,315215,269293,45922,303851361.0,276018885.0,27832476.0,2650,2060,590,285335,255573,29762,286093227.0,267482607.0,18610619.0,1.025,0.6061,1.0466,0.6253
2023-07-05 10:45,4130,1786,2344,387397,168371,219026,356955787.0,229274382.0,127681404.0,3704,1611,2093,361782,153916,207866,341674472.0,220329536.0,121344936.0,1.3617,0.583,1.4315,0.5838
2023-07-05 10:50,2013,681,1332,132318,32186,100132,124689392.0,66272663.0,58416729.0,1757,576,1181,115332,27966,87366,114893534.0,63771317.0,51122216.0,2.0591,0.5834,2.2803,0.5852
2023-07-05 10:55,2559,1348,1211,194524,89777,104747,172626563.0,111498555.0,61128008.0,2320,1198,1122,173412,76611,96801,160321533.0,103783185.0,56538347.0,1.242,0.5836,1.3547,0.5841
2023-07-05 11:00,1042,569,473,50553,31829,18724,41303964.0,30361064.0,10942900.0,918,537,381,51815,36529,15286,41936131.0,33025028.0,8911103.0,0.9539,0.5844,0.9041,0.583
2023-07-05 11:05,966,432,534,74359,24255,50104,78750393.0,49657656.0,29092736.0,837,387,450,66440,25266,41174,74132443.0,50198989.0,23933453.0,2.0473,0.5806,1.9868,0.5813
2023-07-05 11:10,1547,550,997,161820,22190,139630,105633032.0,24690417.0,80942615.0,1453,477,976,167410,18733,148677,109162176.0,22688186.0,86473990.0,1.1127,0.5797,1.2111,0.5816
2023-07-05 11:15,496,232,264,26401,9145,17256,27187117.0,17171721.0,10015396.0,446,207,239,22443,6376,16067,24900881.0,15553445.0,9347435.0,1.8777,0.5804,2.4394,0.5818
2023-07-05 11:20,2068,1093,975,218274,83579,134695,138546181.0,60263659.0,78282522.0,2005,1053,952,218077,84920,133157,138471546.0,61031707.0,77439838.0,0.721,0.5812,0.7187,0.5816
2023-07-05 11:25,2411,890,1521,267479,41752,225727,155190510.0,24179576.0,131010933.0,2329,841,1488,262717,40049,222668,152487848.0,23160481.0,129327367.0,0.5791,0.5804,0.5783,0.5808
2023-07-05 11:30,1200,452,748,109602,16567,93035,63584455.0,9596928.0,53987527.0,1162,428,734,107956,15151,92805,62625096.0,8745770.0,53879326.0,0.5793,0.5803,0.5772,0.5806
2023-07-05 11:35,889,540,349,57073,33104,23969,33069363.0,19163739.0,13905624.0,851,516,335,56457,32776,23681,32695734.0,18948504.0,13747230.0,0.5789,0.5802,0.5781,0.5805
2023-07-05 11:40,1952,856,1096,200269,61905,138364,151006121.0,71397557.0,79608564.0,1872,798,1074,192411,59420,132991,146985147.0,69968578.0,77016568.0,1.1533,0.5754,1.1775,0.5791
2023-07-05 11:45,985,305,680,83295,27486,55809,48183536.0,15867130.0,32316406.0,947,277,670,81945,26852,55093,47384919.0,15476594.0,31908325.0,0.5773,0.5791,0.5764,0.5792
2023-07-05 11:50,1122,480,642,99033,48332,50701,69148433.0,39780596.0,29367836.0,1062,432,630,97281,46348,50933,68111618.0,38599766.0,29511851.0,0.8231,0.5792,0.8328,0.5794
2023-07-05 11:55,2144,776,1368,173180,80196,92984,100101379.0,46257377.0,53844002.0,2127,765,1362,172830,80100,92730,99895340.0,46202475.0,53692864.0,0.5768,0.5791,0.5768,0.579
2023-07-05 12:00,1415,406,1009,100290,15490,84800,58064672.0,8948172.0,49116500.0,1388,389,999,98538,14743,83795,57042902.0,8509030.0,48533872.0,0.5777,0.5792,0.5772,0.5792
2023-07-05 12:05,2238,972,1266,225856,126743,99113,130587320.0,73187365.0,57399955.0,2231,966,1265,225809,126808,99001,130578328.0,73236984.0,57341344.0,0.5774,0.5791,0.5775,0.5792
2023-07-05 12:10,2556,707,1849,219735,78484,141251,127124283.0,45320842.0,81803440.0,2531,694,1837,218623,77643,140980,126474054.0,44819474.0,81654580.0,0.5775,0.5791,0.5773,0.5792
2023-07-05 12:15,1031,271,760,66382,8283,58099,38440142.0,4778877.0,33661265.0,1016,266,750,66475,8563,57912,38492607.0,4941839.0,33550767.0,0.577,0.5794,0.5771,0.5793
2023-07-05 12:20,1384,382,1002,138851,21467,117384,104111456.0,36135630.0,67975825.0,1344,363,981,136657,21222,115435,102844324.0,35991888.0,66852435.0,1.6833,0.5791,1.696,0.5791
2023-07-05 12:25,3701,911,2790,446744,37589,409155,270391678.0,33541459.0,236850219.0,3670,889,2781,443617,34965,408652,268590016.0,32028415.0,236561601.0,0.8923,0.5789,0.916,0.5789
2023-07-05 12:30,1443,223,1220,197928,5042,192886,114566049.0,2905784.0,111660265.0,1436,213,1223,196600,4032,192568,113798790.0,2323716.0,111475074.0,0.5763,0.5789,0.5763,0.5789
2023-07-05 12:35,1210,165,1045,159369,4750,154619,92269406.0,2738500.0,89530905.0,1188,154,1034,159130,4814,154316,92131263.0,2774231.0,89357032.0,0.5765,0.579,0.5763,0.5791
2023-07-05 12:40,615,102,513,61869,4748,57121,35829805.0,2731427.0,33098378.0,608,96,512,60555,3886,56669,35064537.0,2239384.0,32825153.0,0.5753,0.5794,0.5763,0.5792
2023-07-05 12:45,572,55,517,65131,1946,63185,37723829.0,1131970.0,36591859.0,558,46,512,65051,1827,63224,37664521.0,1050571.0,36613949.0,0.5817,0.5791,0.575,0.5791
2023-07-05 12:50,2006,791,1215,222699,39591,183108,140844548.0,34766134.0,106078414.0,1981,782,1199,221953,39439,182514,140360147.0,34624636.0,105735510.0,0.8781,0.5793,0.8779,0.5793
2023-07-05 12:55,1492,577,915,115191,23011,92180,66697066.0,13272867.0,53424199.0,1483,572,911,114748,22772,91976,66441683.0,13135015.0,53306667.0,0.5768,0.5796,0.5768,0.5796
2023-07-05 13:00,688,258,430,74541,14897,59644,55068232.0,20476256.0,34591975.0,656,234,422,73900,13950,59950,54702094.0,19926966.0,34775127.0,1.3745,0.58,1.4285,0.5801
2023-07-05 13:05,2007,434,1573,276053,16340,259713,171686365.0,21303758.0,150382607.0,1988,425,1563,275027,16325,258702,171139703.0,21285029.0,149854674.0,1.3038,0.579,1.3038,0.5793
2023-07-05 13:10,708,206,502,124245,12538,111707,71982433.0,7232465.0,64749967.0,700,203,497,124034,12483,111551,71856856.0,7193511.0,64663345.0,0.5768,0.5796,0.5763,0.5797
2023-07-05 13:15,591,222,369,83203,13729,69474,48168395.0,7915911.0,40252484.0,583,217,366,82849,13446,69403,47962408.0,7752814.0,40209594.0,0.5766,0.5794,0.5766,0.5794
2023-07-05 13:20,2301,1179,1122,211014,127088,83926,133961414.0,85348487.0,48612927.0,2267,1156,1111,209736,125959,83777,133150624.0,84623126.0,48527498.0,0.6716,0.5792,0.6718,0.5792
2023-07-05 13:25,466,127,339,24640,5683,18957,14264679.0,3282128.0,10982550.0,442,110,332,23931,5249,18682,13854129.0,3030234.0,10823894.0,0.5775,0.5793,0.5773,0.5794
2023-07-05 13:30,312,154,158,14484,6821,7663,8391695.0,3951183.0,4440512.0,296,143,153,13422,6397,7025,7760868.0,3689394.0,4071474.0,0.5793,0.5795,0.5767,0.5796
2023-07-05 13:35,1523,1225,298,141920,129398,12522,82087708.0,74848926.0,7238782.0,1496,1212,284,140362,128252,12110,81139955.0,74116760.0,7023195.0,0.5784,0.5781,0.5779,0.58
2023-07-05 13:40,3039,2427,612,309645,272948,36697,191045150.0,169659077.0,21386073.0,3073,2476,597,302115,273868,28247,186567183.0,170176324.0,16390858.0,0.6216,0.5828,0.6214,0.5803
2023-07-05 13:45,3995,3232,763,576354,542667,33687,357439599.0,337858350.0,19581249.0,3939,3229,710,573044,539811,33233,355405262.0,336083434.0,19321827.0,0.6226,0.5813,0.6226,0.5814
2023-07-05 13:50,3012,1915,1097,397643,293572,104071,242316478.0,181761027.0,60555451.0,2955,1892,1063,394945,293535,101410,240754899.0,181732953.0,59021946.0,0.6191,0.5819,0.6191,0.582
2023-07-05 13:55,1528,729,799,154572,65711,88861,89709960.0,37987594.0,51722366.0,1521,724,797,155545,65724,89821,90275062.0,37992906.0,52282156.0,0.5781,0.5821,0.5781,0.5821
2023-07-05 14:00,1026,519,507,77848,38358,39490,45150854.0,22164317.0,22986537.0,1014,511,503,77748,38500,39248,45088230.0,22244014.0,22844215.0,0.5778,0.5821,0.5778,0.582
2023-07-05 14:05,2724,1192,1532,271353,67246,204107,180761874.0,62590987.0,118170887.0,2691,1174,1517,266858,66287,200571,178393503.0,62035801.0,116357702.0,0.9308,0.579,0.9359,0.5801
2023-07-05 14:10,1346,783,563,120780,52081,68699,69920716.0,30072576.0,39848140.0,1343,783,560,120563,51969,68594,69794548.0,30008743.0,39785805.0,0.5774,0.58,0.5774,0.58
2023-07-05 14:15,2309,1369,940,242383,118835,123548,140249328.0,68605495.0,71643832.0,2297,1361,936,242250,118428,123822,140185319.0,68369418.0,71815901.0,0.5773,0.5799,0.5773,0.58
2023-07-05 14:20,1241,999,242,112570,98471,14099,65029947.0,56859354.0,8170592.0,1224,986,238,112541,98030,14511,65016425.0,56601729.0,8414695.0,0.5774,0.5795,0.5774,0.5799
2023-07-05 14:25,485,315,170,41457,23454,18003,23980489.0,13557457.0,10423032.0,477,314,163,41421,23679,17742,23973333.0,13687017.0,10286315.0,0.578,0.579,0.578,0.5798
2023-07-05 14:30,870,400,470,80815,31463,49352,58762801.0,30118793.0,28644007.0,859,393,466,79956,30474,49482,58222026.0,29494854.0,28727172.0,0.9573,0.5804,0.9679,0.5806
2023-07-05 14:35,3707,2099,1608,454762,275824,178938,263412938.0,159414629.0,103998308.0,3676,2078,1598,453273,275188,178085,262546460.0,159043579.0,103502880.0,0.578,0.5812,0.5779,0.5812
2023-07-05 14:40,1655,973,682,209049,150153,58896,120982211.0,86781068.0,34201143.0,1664,979,685,210057,150881,59176,121565212.0,87201428.0,34363784.0,0.578,0.5807,0.5779,0.5807
2023-07-05 14:45,3806,2189,1617,433754,296807,136947,251171606.0,171613113.0,79558493.0,3792,2183,1609,433535,296685,136850,251052231.0,171536249.0,79515982.0,0.5782,0.5809,0.5782,0.581
2023-07-05 14:50,3112,2094,1018,369175,292728,76447,213601488.0,169213541.0,44387947.0,3102,2089,1013,368951,292630,76321,213486023.0,169158959.0,44327064.0,0.5781,0.5806,0.5781,0.5808
2023-07-05 14:55,1623,940,683,164922,110400,54522,95463572.0,63802877.0,31660695.0,1616,934,682,164252,110201,54051,95069883.0,63681145.0,31388738.0,0.5779,0.5807,0.5779,0.5807
2023-07-05 15:00,496,271,225,31389,13928,17461,30056745.0,19917476.0,10139268.0,484,264,220,30259,13522,16737,29405089.0,19685612.0,9719477.0,1.43,0.5807,1.4558,0.5807
2023-07-05 15:05,4048,1199,2849,513398,67750,445648,297323158.0,39105504.0,258217654.0,4038,1191,2847,512566,67111,445455,296892399.0,38734464.0,258157934.0,0.5772,0.5794,0.5772,0.5795
2023-07-05 15:10,1897,833,1064,190319,40187,150132,110263768.0,23209422.0,87054346.0,1879,822,1057,190188,40031,150157,110172404.0,23101991.0,87070412.0,0.5775,0.5799,0.5771,0.5799
2023-07-05 15:15,2540,635,1905,334222,30736,303486,205313870.0,29611177.0,175702693.0,2511,618,1893,332443,30551,301892,204308683.0,29500259.0,174808423.0,0.9634,0.5789,0.9656,0.579
2023-07-05 15:20,257,126,131,14340,3762,10578,8258123.0,2158539.0,6099584.0,237,120,117,13878,4106,9772,8015069.0,2359219.0,5655850.0,0.5738,0.5766,0.5746,0.5788
2023-07-05 15:25,323,94,229,25583,4338,21245,14799758.0,2492806.0,12306951.0,311,82,229,25278,3735,21543,14636706.0,2150128.0,12486577.0,0.5746,0.5793,0.5757,0.5796
2023-07-05 15:30,977,192,785,108403,10172,98231,62785784.0,5859354.0,56926430.0,971,186,785,108293,9880,98413,62723128.0,5687564.0,57035563.0,0.576,0.5795,0.5757,0.5796
2023-07-05 15:35,629,189,440,57032,8720,48312,33015322.0,5020020.0,27995302.0,617,181,436,56807,8810,47997,32885120.0,5071802.0,27813317.0,0.5757,0.5795,0.5757,0.5795
2023-07-05 15:40,492,196,296,20742,7095,13647,11976796.0,4085704.0,7891092.0,484,192,292,20423,7160,13263,11792171.0,4122935.0,7669236.0,0.5759,0.5782,0.5758,0.5782
2023-07-05 15:45,206,110,96,18187,7576,10611,10513588.0,4364950.0,6148638.0,210,114,96,18032,7044,10988,10426227.0,4056950.0,6369277.0,0.5762,0.5795,0.5759,0.5797
2023-07-05 15:50,784,143,641,81762,6431,75331,47361698.0,3708573.0,43653124.0,780,136,644,81762,6308,75454,47358317.0,3633441.0,43724875.0,0.5767,0.5795,0.576,0.5795
2023-07-05 15:55,1215,240,975,167527,13567,153960,96946056.0,7816479.0,89129576.0,1198,234,964,166468,13337,153131,96395878.0,7683880.0,88711998.0,0.5761,0.5789,0.5761,0.5793
2023-07-05 16:00,2798,471,2327,389969,15795,374174,225714276.0,9114132.0,216600143.0,2789,463,2326,389783,15576,374207,225595008.0,8971634.0,216623374.0,0.577,0.5789,0.576,0.5789
2023-07-05 16:05,4496,692,3804,674951,24279,650672,390586400.0,13982186.0,376604213.0,4493,689,3804,674834,24325,650509,390516554.0,14008225.0,376508328.0,0.5759,0.5788,0.5759,0.5788
2023-07-05 16:10,4890,1049,3841,717593,38449,679144,415596325.0,22164588.0,393431736.0,4873,1040,3833,717109,38056,679053,415310034.0,21929917.0,393380117.0,0.5765,0.5793,0.5763,0.5793
2023-07-05 16:15,3434,1288,2146,443784,209339,234445,268562845.0,132703645.0,135859199.0,3422,1284,2138,441794,207827,233967,267424666.0,131828953.0,135595713.0,0.6339,0.5795,0.6343,0.5796
2023-07-05 16:20,2506,1176,1330,328564,224590,103974,189903522.0,129670218.0,60233304.0,2504,1175,1329,328594,224557,104037,189921432.0,129651368.0,60270064.0,0.5774,0.5793,0.5774,0.5793
2023-07-05 16:25,3721,2568,1153,526316,427423,98893,316168826.0,258832453.0,57336372.0,3712,2566,1146,524523,425852,98671,315052618.0,257843113.0,57209505.0,0.6056,0.5798,0.6055,0.5798
2023-07-05 16:30,5851,4564,1287,830068,738093,91975,479669301.0,426340902.0,53328398.0,5833,4555,1278,829832,738026,91806,479532539.0,426301267.0,53231272.0,0.5776,0.5798,0.5776,0.5798
2023-07-05 16:35,4914,3739,1175,651444,595651,55793,376419231.0,344063658.0,32355573.0,4894,3728,1166,650937,595840,55097,376116161.0,344170560.0,31945600.0,0.5776,0.5799,0.5776,0.5798
2023-07-05 16:40,124,98,26,11101,10151,950,6422028.0,5869407.0,552620.0,121,96,25,10667,9728,939,6172305.0,5624205.0,548100.0,0.5782,0.5817,0.5781,0.5837
2023-07-05 16:45,128,59,69,9054,6784,2270,5241416.0,3921597.0,1319819.0,122,56,66,9672,6641,3031,5623427.0,3838516.0,1784910.0,0.5781,0.5814,0.578,0.5889
2023-07-05 16:50,1303,814,489,109958,102064,7894,63558295.0,58981025.0,4577270.0,1301,813,488,110492,102078,8414,63872734.0,58988727.0,4884007.0,0.5779,0.5798,0.5779,0.5805
2023-07-05 16:55,1337,979,358,197760,189929,7831,114259030.0,109723028.0,4536002.0,1326,978,348,196414,189924,6490,113478417.0,109718034.0,3760382.0,0.5777,0.5792,0.5777,0.5794
2023-07-05 17:00,2386,1159,1227,325478,272347,53131,199641248.0,168933957.0,30707291.0,2366,1152,1214,324907,272744,52163,199364783.0,169161050.0,30203733.0,0.6203,0.578,0.6202,0.579
2023-07-05 17:05,1634,549,1085,198354,120218,78136,114451019.0,69316294.0,45134724.0,1612,533,1079,196965,119389,77576,113754413.0,68837819.0,44916593.0,0.5766,0.5776,0.5766,0.579
2023-07-05 17:10,2314,75,2239,388123,6993,381130,224928565.0,4031412.0,220897153.0,2318,70,2248,388725,7098,381627,225278333.0,4091060.0,221187272.0,0.5765,0.5796,0.5764,0.5796
2023-07-05 17:15,2518,167,2351,406091,13974,392117,235280395.0,8062370.0,227218024.0,2488,156,2332,404746,12918,391828,234497659.0,7446758.0,227050901.0,0.577,0.5795,0.5765,0.5795
2023-07-05 17:20,2234,825,1409,208336,79238,129098,132391444.0,57609271.0,74782173.0,2205,817,1388,207827,79222,128605,132089276.0,57594125.0,74495151.0,0.727,0.5793,0.727,0.5793
2023-07-05 17:25,1429,607,822,126783,58392,68391,73339458.0,33713720.0,39625738.0,1421,605,816,126849,58578,68271,73378495.0,33820966.0,39557528.0,0.5774,0.5794,0.5774,0.5794
2023-07-05 17:30,3518,1698,1820,342975,179231,163744,210205558.0,115321348.0,94884210.0,3497,1687,1810,341880,178682,163198,209577088.0,115004737.0,94572351.0,0.6434,0.5795,0.6436,0.5795
2023-07-05 17:35,2027,186,1841,278629,9335,269294,161023333.0,5384518.0,155638815.0,2004,172,1832,276659,9056,267603,159929372.0,5215372.0,154713999.0,0.5768,0.578,0.5759,0.5781
2023-07-05 17:40,137,28,109,12277,1156,11121,7097825.0,667152.0,6430673.0,136,25,111,12275,1124,11151,7095843.0,647546.0,6448297.0,0.5771,0.5782,0.5761,0.5783
2023-07-05 17:45,1422,308,1114,181520,14622,166898,104849340.0,8420897.0,96428442.0,1439,303,1136,180900,14035,166865,104532566.0,8084219.0,96448347.0,0.5759,0.5778,0.576,0.578
2023-07-05 17:50,3128,378,2750,514384,18103,496281,297687366.0,10434664.0,287252701.0,3121,372,2749,513915,17658,496257,297418812.0,10178372.0,287240439.0,0.5764,0.5788,0.5764,0.5788
2023-07-05 17:55,3209,334,2875,542494,6797,535697,313709510.0,3911269.0,309798240.0,3193,319,2874,542471,6331,536140,313700312.0,3642956.0,310057356.0,0.5754,0.5783,0.5754,0.5783
2023-07-05 18:00,2576,271,2305,352164,3794,348370,215568269.0,14055165.0,201513104.0,2557,261,2296,351995,4716,347279,215456276.0,14566907.0,200889368.0,3.7046,0.5784,3.0888,0.5785
2023-07-05 18:05,3987,689,3298,526020,10176,515844,303878786.0,5850232.0,298028553.0,3952,670,3282,524450,9682,514768,303000696.0,5565533.0,297435163.0,0.5749,0.5777,0.5748,0.5778
2023-07-05 18:10,3184,645,2539,409370,12109,397261,236612046.0,6963807.0,229648239.0,3170,634,2536,409213,11988,397225,236524752.0,6893770.0,229630982.0,0.5751,0.5781,0.5751,0.5781
2023-07-05 18:15,2982,763,2219,320411,16390,304021,185212576.0,9432225.0,175780351.0,2973,756,2217,320476,16469,304007,185243522.0,9473577.0,175769945.0,0.5755,0.5782,0.5752,0.5782
2023-07-05 18:20,1494,561,933,121909,10250,111659,70392716.0,5898041.0,64494675.0,1483,556,927,121283,10100,111183,70042248.0,5810879.0,64231369.0,0.5754,0.5776,0.5753,0.5777
2023-07-05 18:25,712,217,495,70221,7026,63195,40516952.0,4041113.0,36475839.0,691,205,486,67726,6421,61305,39165545.0,3692586.0,35472959.0,0.5752,0.5772,0.5751,0.5786
2023-07-05 18:30,3218,631,2587,468062,26189,441873,270571313.0,15068566.0,255502747.0,3189,615,2574,466174,25135,441039,269484583.0,14465121.0,255019461.0,0.5754,0.5782,0.5755,0.5782
2023-07-05 18:35,3103,635,2468,425380,52813,372567,269682870.0,54153145.0,215529725.0,3094,629,2465,425624,52774,372850,269834935.0,54126208.0,215708727.0,1.0254,0.5785,1.0256,0.5785
2023-07-06 10:00,4370,1630,2740,485175,134861,350314,294783121.0,91484349.0,203298772.0,4055,1457,2598,469432,128190,341242,279455255.0,81491737.0,197963518.0,0.6784,0.5803,0.6357,0.5801
2023-07-06 10:05,2940,624,2316,362971,33246,329725,210484054.0,19100702.0,191383351.0,2882,591,2291,361589,32320,329269,209699468.0,18573832.0,191125636.0,0.5745,0.5804,0.5747,0.5805
2023-07-06 10:10,1713,402,1311,118983,17796,101187,80690284.0,22111468.0,58578816.0,1666,382,1284,117562,17024,100538,74281141.0,16089640.0,58191501.0,1.2425,0.5789,0.9451,0.5788
2023-07-06 10:15,3965,1872,2093,361996,144190,217806,269349507.0,142605339.0,126744168.0,3809,1799,2010,353882,142055,211827,264558173.0,141346453.0,123211719.0,0.989,0.5819,0.995,0.5817
2023-07-06 10:20,2375,1787,588,202682,152219,50463,117138753.0,87723707.0,29415046.0,2325,1758,567,199110,149089,50021,115260529.0,86107881.0,29152648.0,0.5763,0.5829,0.5776,0.5828
2023-07-06 10:25,391,293,98,53367,37821,15546,30954028.0,21874876.0,9079151.0,369,283,86,52826,37424,15402,30632968.0,21637575.0,8995393.0,0.5784,0.584,0.5782,0.584
2023-07-06 10:30,1785,1222,563,213420,153111,60309,135743522.0,100361539.0,35381982.0,1775,1220,555,211485,153019,58466,134417895.0,100306072.0,34111823.0,0.6555,0.5867,0.6555,0.5834
2023-07-06 10:35,4054,2792,1262,496476,349075,147401,311735973.0,225804344.0,85931629.0,3978,2766,1212,493799,347403,146396,310091211.0,224741448.0,85349763.0,0.6469,0.583,0.6469,0.583
2023-07-06 10:40,3108,1615,1493,356284,298371,57913,217361835.0,183658218.0,33703616.0,3071,1596,1475,352555,297936,54619,215223921.0,183420312.0,31803609.0,0.6155,0.582,0.6156,0.5823
2023-07-06 10:45,4493,2801,1692,576389,481125,95264,332628419.0,277250311.0,55378108.0,4440,2761,1679,573616,479811,93805,331002242.0,276479528.0,54522714.0,0.5763,0.5813,0.5762,0.5812
2023-07-06 10:50,1881,711,1170,179845,114895,64950,104052095.0,66276644.0,37775450.0,1859,700,1159,179438,114935,64503,103793793.0,66284681.0,37509112.0,0.5768,0.5816,0.5767,0.5815
2023-07-06 10:55,2557,1087,1470,275801,197925,77876,171542805.0,126236211.0,45306593.0,2515,1063,1452,274772,197480,77292,170915090.0,125959766.0,44955324.0,0.6378,0.5818,0.6378,0.5816
2023-07-06 11:00,1675,849,826,180444,142463,37981,104498257.0,82233045.0,22265212.0,1662,841,821,178352,142305,36047,103134172.0,82141024.0,20993148.0,0.5772,0.5862,0.5772,0.5824
2023-07-06 11:05,2364,737,1627,171540,93928,77612,99401711.0,54229414.0,45172297.0,2336,725,1611,170753,94591,76162,98929531.0,54603834.0,44325697.0,0.5774,0.582,0.5773,0.582
2023-07-06 11:10,2209,975,1234,208567,150102,58465,144564671.0,110241743.0,34322928.0,2160,954,1206,203994,149091,54903,142015776.0,109663383.0,32352393.0,0.7344,0.5871,0.7355,0.5893
2023-07-06 11:15,2592,964,1628,212759,134062,78697,122672787.0,77073863.0,45598924.0,2563,951,1612,212192,133909,78283,122334484.0,76983345.0,45351139.0,0.5749,0.5794,0.5749,0.5793
2023-07-06 11:20,3000,1640,1360,246588,168878,77710,142192973.0,97155006.0,45037966.0,2979,1626,1353,246035,168439,77596,141870518.0,96899635.0,44970882.0,0.5753,0.5796,0.5753,0.5796
2023-07-06 11:25,1428,449,979,100848,16537,84311,58268672.0,9528461.0,48740211.0,1412,439,973,100985,16276,84709,58436959.0,9383109.0,49053849.0,0.5762,0.5781,0.5765,0.5791
2023-07-06 11:30,1351,439,912,141831,45347,96484,93679447.0,37876226.0,55803220.0,1331,427,904,141502,45150,96352,93525822.0,37766459.0,55759363.0,0.8353,0.5784,0.8365,0.5787
2023-07-06 11:35,1733,465,1268,117541,13612,103929,67983210.0,7836445.0,60146764.0,1715,459,1256,115292,13597,101695,66672455.0,7827645.0,58844810.0,0.5757,0.5787,0.5757,0.5786
2023-07-06 11:40,1752,628,1124,125729,28285,97444,72625254.0,16245458.0,56379796.0,1737,618,1119,124007,27212,96795,71644275.0,15638074.0,56006200.0,0.5743,0.5786,0.5747,0.5786
2023-07-06 11:45,2901,818,2083,241280,68419,172861,139111392.0,39289848.0,99821543.0,2860,795,2065,239676,68041,171635,138307761.0,39070486.0,99237275.0,0.5743,0.5775,0.5742,0.5782
2023-07-06 11:50,3125,769,2356,191827,10737,181090,110821469.0,6169065.0,104652404.0,3127,767,2360,192360,10679,181681,111136397.0,6135356.0,105001041.0,0.5746,0.5779,0.5745,0.5779
2023-07-06 11:55,1975,268,1707,146547,6515,140032,84635414.0,3750630.0,80884784.0,1970,265,1705,146509,6435,140074,84613700.0,3705137.0,80908563.0,0.5757,0.5776,0.5758,0.5776
2023-07-06 12:00,2571,555,2016,167962,5056,162906,97019831.0,2910867.0,94108963.0,2567,552,2015,167810,5019,162791,96924989.0,2889569.0,94035419.0,0.5757,0.5777,0.5757,0.5776
2023-07-06 12:05,2865,960,1905,166158,13368,152790,95918273.0,7692863.0,88225410.0,2859,957,1902,165923,13339,152584,95783309.0,7676507.0,88106802.0,0.5755,0.5774,0.5755,0.5774
2023-07-06 12:10,2633,596,2037,153126,9157,143969,88419349.0,5270153.0,83149195.0,2622,589,2033,153071,9001,144070,88388966.0,5181191.0,83207774.0,0.5755,0.5775,0.5756,0.5776
2023-07-06 12:15,1820,422,1398,91076,5369,85707,52564626.0,3086813.0,49477813.0,1802,413,1389,90198,4811,85387,52071783.0,2764281.0,49307502.0,0.5749,0.5773,0.5746,0.5775
2023-07-06 12:20,873,243,630,56012,3542,52470,32330036.0,2035228.0,30294808.0,855,233,622,54527,2754,51773,31473534.0,1581907.0,29891627.0,0.5746,0.5774,0.5744,0.5774
2023-07-06 12:25,1009,304,705,76209,6154,70055,44018083.0,3540197.0,40477885.0,985,289,696,75657,5877,69780,43693150.0,3374902.0,40318248.0,0.5753,0.5778,0.5743,0.5778
2023-07-06 12:30,1215,160,1055,119034,3178,115856,68721740.0,1823572.0,66898168.0,1218,165,1053,119347,3720,115627,68897562.0,2130538.0,66767024.0,0.5738,0.5774,0.5727,0.5774
2023-07-06 12:35,2608,494,2114,202558,19712,182846,116846740.0,11284869.0,105561870.0,2596,483,2113,202472,19672,182800,116794181.0,11258838.0,105535342.0,0.5725,0.5773,0.5723,0.5773
2023-07-06 12:40,3585,888,2697,303561,79205,224356,174804469.0,45271471.0,129532997.0,3569,874,2695,302967,78712,224255,174457502.0,44982538.0,129474964.0,0.5716,0.5774,0.5715,0.5774
2023-07-06 12:45,3804,975,2829,363190,118989,244201,208918812.0,67993617.0,140925195.0,3790,966,2824,363244,119150,244094,208986586.0,68087755.0,140898831.0,0.5714,0.5771,0.5714,0.5772
2023-07-06 12:50,2881,286,2595,213739,9262,204477,123280355.0,5310685.0,117969670.0,2881,290,2591,213578,9161,204417,123181903.0,5246646.0,117935256.0,0.5734,0.5769,0.5727,0.5769
2023-07-06 12:55,1655,412,1243,116123,26534,89589,66908286.0,15224955.0,51683331.0,1648,403,1245,116877,26577,90300,67327216.0,15223320.0,52103895.0,0.5738,0.5769,0.5728,0.577
2023-07-06 13:00,632,228,404,41883,11775,30108,24128950.0,6747052.0,17381898.0,607,216,391,40704,11339,29365,23451112.0,6498967.0,16952144.0,0.573,0.5773,0.5732,0.5773
2023-07-06 13:05,811,403,408,74194,44309,29885,42614933.0,25364112.0,17250821.0,804,400,404,74061,44517,29544,42532731.0,25479143.0,17053587.0,0.5724,0.5772,0.5723,0.5772
2023-07-06 13:10,293,122,171,17895,6654,11241,10305752.0,3815324.0,6490427.0,283,118,165,17492,6308,11184,10071208.0,3614525.0,6456683.0,0.5734,0.5774,0.573,0.5773
2023-07-06 13:15,98,38,60,7315,2623,4692,4229459.0,1503037.0,2726422.0,86,33,53,5840,2655,3185,3360416.0,1521086.0,1839330.0,0.573,0.5811,0.5729,0.5775
2023-07-06 13:20,739,282,457,48925,11571,37354,28200358.0,6648507.0,21551850.0,710,261,449,48603,11375,37228,28014891.0,6533470.0,21481420.0,0.5746,0.577,0.5744,0.577
2023-07-06 13:25,1575,634,941,148820,80459,68361,97360363.0,57938407.0,39421956.0,1505,579,926,144823,79632,65191,95024183.0,57455852.0,37568331.0,0.7201,0.5767,0.7215,0.5763
2023-07-06 13:30,3380,1276,2104,379231,162641,216590,217974074.0,93213010.0,124761064.0,3359,1258,2101,377316,161221,216095,216914014.0,92396941.0,124517072.0,0.5731,0.576,0.5731,0.5762
2023-07-06 13:35,2059,858,1201,247336,128613,118723,142158838.0,73745927.0,68412910.0,2050,854,1196,247264,128408,118856,142118742.0,73629418.0,68489323.0,0.5734,0.5762,0.5734,0.5762
2023-07-06 13:40,1454,860,594,186271,132120,54151,106939942.0,75750820.0,31189122.0,1432,851,581,186111,132161,53950,106858741.0,75772749.0,31085991.0,0.5733,0.576,0.5733,0.5762
2023-07-06 13:45,944,596,348,121426,85574,35852,69598444.0,48934654.0,20663790.0,923,579,344,121125,85410,35715,69425614.0,48841063.0,20584550.0,0.5718,0.5764,0.5718,0.5764
2023-07-06 13:50,1507,663,844,144252,74171,70081,82824695.0,42456262.0,40368432.0,1496,654,842,144949,73971,70978,83221251.0,42335823.0,40885427.0,0.5724,0.576,0.5723,0.576
2023-07-06 13:55,164,78,86,11614,5056,6558,6666036.0,2886666.0,3779370.0,150,67,83,10723,4784,5939,6160264.0,2737185.0,3423079.0,0.5709,0.5763,0.5722,0.5764
2023-07-06 14:00,798,172,626,52941,5258,47683,30468393.0,3011329.0,27457064.0,777,153,624,52604,5005,47599,30277725.0,2868867.0,27408858.0,0.5727,0.5758,0.5732,0.5758
2023-07-06 14:05,216,52,164,24050,6611,17439,13827080.0,3774820.0,10052259.0,218,51,167,24386,6881,17505,14016641.0,3929681.0,10086960.0,0.571,0.5764,0.5711,0.5762
2023-07-06 14:10,1141,285,856,81068,4178,76890,46674063.0,2421376.0,44252686.0,1020,172,848,80329,3964,76365,46226260.0,2277199.0,43949061.0,0.5796,0.5755,0.5745,0.5755
2023-07-06 14:15,514,237,277,45083,33605,11478,25913158.0,19300500.0,6612657.0,479,218,261,42744,31628,11116,24517684.0,18113753.0,6403930.0,0.5743,0.5761,0.5727,0.5761
2023-07-06 14:20,279,161,118,22631,16276,6355,12999923.0,9340492.0,3659430.0,267,157,110,22053,16323,5730,12668363.0,9367926.0,3300436.0,0.5739,0.5758,0.5739,0.576
2023-07-06 14:25,238,143,95,19726,13638,6088,11366710.0,7860194.0,3506516.0,202,110,92,19326,13280,6046,11114544.0,7631226.0,3483317.0,0.5763,0.576,0.5746,0.5761
2023-07-06 14:30,142,71,71,7582,2728,4854,4363854.0,1565966.0,2797888.0,134,66,68,7003,2457,4546,4031388.0,1411157.0,2620231.0,0.574,0.5764,0.5743,0.5764
2023-07-06 14:35,67,46,21,4240,2617,1623,2439263.0,1503705.0,935558.0,61,42,19,4413,2880,1533,2537408.0,1653589.0,883818.0,0.5746,0.5764,0.5742,0.5765
2023-07-06 14:40,224,167,57,23144,17414,5730,13292170.0,9990570.0,3301600.0,220,162,58,23003,17175,5828,13211762.0,9852906.0,3358855.0,0.5737,0.5762,0.5737,0.5763
2023-07-06 14:45,97,47,50,5772,2761,3011,3316033.0,1583281.0,1732751.0,92,43,49,5371,2524,2847,3088365.0,1448563.0,1639802.0,0.5734,0.5755,0.5739,0.576
2023-07-06 14:50,148,69,79,14849,11074,3775,8519902.0,6345844.0,2174057.0,143,66,77,15010,11190,3820,8607611.0,6407773.0,2199837.0,0.573,0.5759,0.5726,0.5759
2023-07-06 14:55,26,15,11,463,205,258,266292.0,117682.0,148609.0,21,10,11,457,199,258,263138.0,114240.0,148898.0,0.5741,0.576,0.5741,0.5771
2023-07-06 15:00,654,393,261,70266,57086,13180,40358634.0,32769349.0,7589285.0,627,374,253,70052,56976,13076,40237246.0,32704443.0,7532803.0,0.574,0.5758,0.574,0.5761
2023-07-06 15:05,138,73,65,15686,10635,5051,9000476.0,6091924.0,2908551.0,131,64,67,16180,10555,5625,9296975.0,6052841.0,3244133.0,0.5728,0.5758,0.5735,0.5767
2023-07-06 15:10,66,29,37,5043,2260,2783,2896076.0,1298652.0,1597424.0,51,23,28,3618,2092,1526,2081680.0,1201728.0,879952.0,0.5746,0.574,0.5744,0.5766
2023-07-06 15:15,160,74,86,11501,5300,6201,6616560.0,3046798.0,3569762.0,145,63,82,11214,5245,5969,6442464.0,3005940.0,3436524.0,0.5749,0.5757,0.5731,0.5757
2023-07-06 15:20,163,80,83,11995,8023,3972,6876632.0,4590273.0,2286359.0,149,68,81,12201,8112,4089,6995429.0,4641631.0,2353797.0,0.5721,0.5756,0.5722,0.5756
2023-07-06 15:25,113,46,67,8297,2541,5756,4774316.0,1458327.0,3315988.0,105,40,65,7807,2235,5572,4492208.0,1282325.0,3209882.0,0.5739,0.5761,0.5737,0.5761
2023-07-06 15:30,44,29,15,2741,2008,733,1574963.0,1153585.0,421378.0,43,29,14,3003,2080,923,1726101.0,1194653.0,531447.0,0.5745,0.5749,0.5744,0.5758
2023-07-06 15:35,261,103,158,17309,6064,11245,9943908.0,3491947.0,6451960.0,248,94,154,17656,6698,10958,10149264.0,3840771.0,6308492.0,0.5758,0.5738,0.5734,0.5757
2023-07-06 15:40,76,22,54,5195,874,4321,2999498.0,511156.0,2488342.0,72,18,54,4947,713,4234,2847689.0,409337.0,2438352.0,0.5848,0.5759,0.5741,0.5759
2023-07-06 15:45,63,14,49,5359,1014,4345,3084502.0,583347.0,2501155.0,59,11,48,5468,982,4486,3147736.0,563697.0,2584038.0,0.5753,0.5756,0.574,0.576
2023-07-06 15:50,77,20,57,2691,800,1891,1551682.0,459185.0,1092496.0,72,17,55,3887,645,3242,2261706.0,370393.0,1891313.0,0.574,0.5777,0.5743,0.5834
2023-07-06 15:55,1545,913,632,172522,107789,64733,110935009.0,73683791.0,37251217.0,1491,872,619,170063,107308,62755,109503505.0,73388362.0,36115143.0,0.6836,0.5755,0.6839,0.5755
2023-07-06 16:00,503,319,184,43815,26310,17505,48782284.0,38845790.0,9936494.0,433,261,172,37729,23349,14380,45361158.0,37082255.0,8278903.0,1.4765,0.5676,1.5882,0.5757
2023-07-06 16:05,1273,658,615,97411,66367,31044,91405364.0,73576153.0,17829210.0,1265,653,612,99755,66539,33216,92742869.0,73670860.0,19072008.0,1.1086,0.5743,1.1072,0.5742
2023-07-06 16:10,3628,2376,1252,401068,343448,57620,229330277.0,196275052.0,33055225.0,3619,2369,1250,400484,343002,57482,228998606.0,196019179.0,32979427.0,0.5715,0.5737,0.5715,0.5737
2023-07-06 16:15,3460,1882,1578,348767,253112,95655,199610209.0,144740995.0,54869213.0,3439,1869,1570,347997,252534,95463,199173305.0,144413783.0,54759522.0,0.5718,0.5736,0.5719,0.5736
2023-07-06 16:20,1528,807,721,171201,132649,38552,97956615.0,75842753.0,22113862.0,1521,803,718,171048,132613,38435,97866793.0,75820782.0,22046010.0,0.5718,0.5736,0.5717,0.5736
2023-07-06 16:25,798,337,461,77048,46943,30105,44101688.0,26838205.0,17263483.0,788,328,460,77254,46773,30481,44227000.0,26742170.0,17484829.0,0.5717,0.5734,0.5717,0.5736
2023-07-06 16:30,328,188,140,48588,38160,10428,27754411.0,21773887.0,5980523.0,318,180,138,48344,38070,10274,27615053.0,21722768.0,5892285.0,0.5706,0.5735,0.5706,0.5735
2023-07-06 16:35,35,20,15,646,293,353,370840.0,170915.0,199925.0,27,15,12,558,241,317,320322.0,137533.0,182788.0,0.5833,0.5664,0.5707,0.5766
2023-07-06 16:40,290,95,195,18570,7833,10737,10637139.0,4479915.0,6157224.0,283,92,191,18335,7800,10535,10503816.0,4460583.0,6043233.0,0.5719,0.5735,0.5719,0.5736
2023-07-06 16:45,1029,173,856,105208,3387,101821,60287310.0,1934275.0,58353035.0,1018,168,850,104484,3510,100974,59911995.0,2004709.0,57907285.0,0.5711,0.5731,0.5711,0.5735
2023-07-06 16:50,621,182,439,53684,4979,48705,30787862.0,2840574.0,27947287.0,610,173,437,53719,4796,48923,30805562.0,2735987.0,28069575.0,0.5705,0.5738,0.5705,0.5738
2023-07-06 16:55,679,155,524,78322,10558,67764,56783713.0,17895709.0,38888004.0,665,146,519,77908,10392,67516,56551289.0,17802852.0,38748437.0,1.695,0.5739,1.7131,0.5739
2023-07-06 17:00,786,132,654,83915,8584,75331,48022036.0,4892795.0,43129241.0,717,86,631,79061,6373,72688,45259580.0,3631664.0,41627916.0,0.57,0.5725,0.5699,0.5727
2023-07-06 17:05,421,50,371,54777,1668,53109,43173722.0,12825874.0,30347847.0,402,36,366,53996,1446,52550,42745336.0,12698394.0,30046942.0,7.6894,0.5714,8.7817,0.5718
2023-07-06 17:10,674,29,645,16975,585,16390,9682923.0,331566.0,9351356.0,655,11,644,16840,289,16551,9611094.0,164318.0,9446775.0,0.5668,0.5706,0.5686,0.5708
2023-07-06 17:15,71,16,55,3686,467,3219,2102943.0,264891.0,1838052.0,54,6,48,3168,260,2908,1808537.0,147951.0,1660585.0,0.5672,0.571,0.569,0.571
2023-07-06 17:20,334,60,274,41902,3057,38845,23929301.0,1725752.0,22203549.0,321,49,272,42944,2410,40534,24537305.0,1370082.0,23167223.0,0.5645,0.5716,0.5685,0.5716
2023-07-06 17:25,2217,121,2096,402029,3162,398867,229699658.0,1798599.0,227901059.0,2196,107,2089,400886,2757,398129,229094307.0,1566982.0,227527325.0,0.5688,0.5714,0.5684,0.5715
2023-07-06 17:30,4272,661,3611,701692,14472,687220,400848798.0,8228270.0,392620528.0,4259,651,3608,701235,14363,686872,400586020.0,8164076.0,392421944.0,0.5686,0.5713,0.5684,0.5713
2023-07-06 17:35,4256,1117,3139,576874,20072,556802,329563151.0,11413038.0,318150113.0,4237,1102,3135,576773,19867,556906,329503120.0,11292308.0,318210812.0,0.5686,0.5714,0.5684,0.5714
2023-07-06 17:40,5352,1086,4266,779028,17091,761937,445089815.0,9717336.0,435372478.0,5342,1077,4265,779244,17207,762037,445219511.0,9784290.0,435435221.0,0.5686,0.5714,0.5686,0.5714
2023-07-06 17:45,3492,537,2955,533762,6675,527087,305041458.0,3797227.0,301244231.0,3478,525,2953,533639,6502,527137,304970358.0,3698701.0,301271657.0,0.5689,0.5715,0.5689,0.5715
2023-07-06 17:50,3471,415,3056,512450,11380,501070,292874835.0,6456353.0,286418481.0,3459,407,3052,508822,8255,500567,290831919.0,4695070.0,286136848.0,0.5673,0.5716,0.5688,0.5716
2023-07-06 17:55,2639,621,2018,346783,21726,325057,198161214.0,12368529.0,185792685.0,2617,609,2008,346736,21757,324979,198122370.0,12373829.0,185748540.0,0.5693,0.5716,0.5687,0.5716
2023-07-06 18:00,3158,287,2871,529931,9609,520322,302923588.0,5468131.0,297455456.0,3146,276,2870,530095,9815,520280,303008459.0,5574663.0,297433796.0,0.5691,0.5717,0.568,0.5717
2023-07-06 18:05,2539,182,2357,465147,2425,462722,265867083.0,1380950.0,264486132.0,2542,179,2363,467287,2430,464857,267116167.0,1383696.0,265732470.0,0.5695,0.5716,0.5694,0.5716
2023-07-06 18:10,2934,501,2433,442819,9806,433013,265090050.0,17462934.0,247627115.0,2915,489,2426,442853,9421,433432,265107968.0,17240328.0,247867640.0,1.7808,0.5719,1.83,0.5719
2023-07-06 18:15,2255,569,1686,272159,10198,261961,155678487.0,5810635.0,149867852.0,2242,564,1678,271819,10095,261724,155483046.0,5751741.0,149731305.0,0.5698,0.5721,0.5698,0.5721
2023-07-06 18:20,1968,395,1573,289071,5211,283860,165340285.0,2970950.0,162369335.0,1964,392,1572,289178,5036,284142,165403541.0,2870905.0,162532636.0,0.5701,0.572,0.5701,0.572
2023-07-06 18:25,2256,762,1494,249511,15783,233728,142733656.0,8992118.0,133741537.0,2251,758,1493,248961,15521,233440,142420031.0,8842272.0,133577758.0,0.5697,0.5722,0.5697,0.5722
2023-07-06 18:30,2008,441,1567,277355,11782,265573,158682328.0,6709705.0,151972622.0,1999,436,1563,277189,11719,265470,158597587.0,6674257.0,151923329.0,0.5695,0.5722,0.5695,0.5723
2023-07-06 18:35,2216,296,1920,359498,6398,353100,205649173.0,3649563.0,201999609.0,2207,296,1911,359926,6831,353095,205886761.0,3889424.0,201997336.0,0.5704,0.5721,0.5694,0.5721
2023-07-07 10:00,3812,1184,2628,428782,52698,376084,247439575.0,32099607.0,215339968.0,3589,1091,2498,421171,49114,372057,240692952.0,27876071.0,212816881.0,0.6091,0.5726,0.5676,0.572
2023-07-07 10:05,1080,207,873,131715,7363,124352,75434714.0,4069143.0,71365570.0,976,156,820,123738,4967,118771,70701906.0,2811312.0,67890594.0,0.5526,0.5739,0.566,0.5716
2023-07-07 10:10,4189,700,3489,569098,29633,539465,336942607.0,28701001.0,308241605.0,4100,651,3449,564589,26914,537675,324888813.0,17596421.0,307292392.0,0.9685,0.5714,0.6538,0.5715
2023-07-07 10:15,3145,753,2392,411217,15062,396155,234760325.0,8532640.0,226227684.0,2952,624,2328,409023,13355,395668,233515592.0,7582323.0,225933268.0,0.5665,0.5711,0.5678,0.571
2023-07-07 10:20,2928,699,2229,330884,24890,305994,188748194.0,14065962.0,174682232.0,2864,649,2215,326113,20616,305497,186128000.0,11700036.0,174427964.0,0.5651,0.5709,0.5675,0.571
2023-07-07 10:25,3177,722,2455,401524,24502,377022,229064277.0,13837999.0,215226278.0,3111,673,2438,397631,21106,376525,226885305.0,11946828.0,214938477.0,0.5648,0.5709,0.566,0.5708
2023-07-07 10:30,1551,398,1153,182903,13396,169507,116305622.0,19490979.0,96814643.0,1507,368,1139,179737,11873,167864,114474118.0,18614056.0,95860061.0,1.455,0.5712,1.5678,0.5711
2023-07-07 10:35,711,162,549,93248,8726,84522,53321579.0,4952147.0,48369432.0,754,189,565,93502,10291,83211,53446718.0,5835945.0,47610772.0,0.5675,0.5723,0.5671,0.5722
2023-07-07 10:40,424,218,206,22916,16122,6794,13032447.0,9153288.0,3879159.0,410,209,201,22813,16188,6625,12972673.0,9190726.0,3781947.0,0.5678,0.571,0.5677,0.5709
2023-07-07 10:45,776,565,211,61134,53734,7400,34703171.0,30490335.0,4212835.0,725,517,208,59731,52365,7366,33913343.0,29720484.0,4192859.0,0.5674,0.5693,0.5676,0.5692
2023-07-07 10:50,427,304,123,41563,34769,6794,23610907.0,19724372.0,3886535.0,405,290,115,40553,34155,6398,23040952.0,19385275.0,3655676.0,0.5673,0.5721,0.5676,0.5714
2023-07-07 10:55,1720,1195,525,244570,219304,25266,138984213.0,124588146.0,14396066.0,1694,1174,520,242706,217459,25247,137841085.0,123457421.0,14383663.0,0.5681,0.5698,0.5677,0.5697
2023-07-07 11:00,919,720,199,145469,128206,17263,82634977.0,72797123.0,9837854.0,893,703,190,145083,127944,17139,82417385.0,72648653.0,9768732.0,0.5678,0.5699,0.5678,0.57
2023-07-07 11:05,740,417,323,46986,33656,13330,26681389.0,19088691.0,7592698.0,716,398,318,46396,33264,13132,26372093.0,18892375.0,7479718.0,0.5672,0.5696,0.568,0.5696
2023-07-07 11:10,1904,973,931,153344,69040,84304,99120402.0,51077923.0,48042479.0,1860,940,920,150579,68170,82409,97596561.0,50571411.0,47025149.0,0.7398,0.5699,0.7418,0.5706
2023-07-07 11:15,2026,974,1052,146020,65578,80442,95036880.0,49110525.0,45926355.0,2012,962,1050,145371,64832,80539,94667343.0,48687165.0,45980178.0,0.7489,0.5709,0.751,0.5709
2023-07-07 11:20,2116,669,1447,208676,36384,172292,131248834.0,32563343.0,98685491.0,2081,650,1431,204656,33013,171643,128937154.0,30632887.0,98304267.0,0.895,0.5728,0.9279,0.5727
2023-07-07 11:25,683,156,527,74066,6656,67410,42489538.0,3788892.0,38700645.0,668,150,518,72718,5690,67028,41705511.0,3232983.0,38472528.0,0.5692,0.5741,0.5682,0.574
2023-07-07 11:30,3464,822,2642,389968,20144,369824,223330905.0,11497638.0,211833266.0,3454,820,2634,389447,20011,369436,223023451.0,11409960.0,211613491.0,0.5708,0.5728,0.5702,0.5728
2023-07-07 11:35,2829,349,2480,329812,7275,322537,188726594.0,4164707.0,184561887.0,2806,333,2473,329543,6999,322544,188559702.0,3988443.0,184571258.0,0.5725,0.5722,0.5699,0.5722
2023-07-07 11:40,267,106,161,9288,3872,5416,5286950.0,2198287.0,3088662.0,241,92,149,7936,3329,4607,4530312.0,1895516.0,2634796.0,0.5677,0.5703,0.5694,0.5719
2023-07-07 11:45,91,39,52,2979,1751,1228,1710416.0,1008198.0,702218.0,76,30,46,3653,2356,1297,2083355.0,1341710.0,741644.0,0.5758,0.5718,0.5695,0.5718
2023-07-07 11:50,302,162,140,13000,6927,6073,19300672.0,15824271.0,3476401.0,291,159,132,12535,6799,5736,19040164.0,15751564.0,3288599.0,2.2844,0.5724,2.3167,0.5733
2023-07-07 11:55,332,143,189,19155,9678,9477,10947243.0,5517016.0,5430227.0,330,143,187,18889,9549,9340,10787033.0,5443376.0,5343656.0,0.5701,0.573,0.57,0.5721
2023-07-07 12:00,391,200,191,24586,15342,9244,14040111.0,8748703.0,5291408.0,391,201,190,25340,16055,9285,14470776.0,9154186.0,5316590.0,0.5702,0.5724,0.5702,0.5726
2023-07-07 12:05,601,359,242,54278,39791,14487,30976571.0,22682249.0,8294321.0,601,356,245,54283,39461,14822,30978664.0,22493971.0,8484693.0,0.57,0.5725,0.57,0.5724
2023-07-07 12:10,170,106,64,17302,13191,4111,9879098.0,7521555.0,2357542.0,155,100,55,16434,12830,3604,9383256.0,7314886.0,2068370.0,0.5702,0.5735,0.5701,0.5739
2023-07-07 12:15,758,194,564,62519,20989,41530,35753539.0,11961372.0,23792167.0,752,191,561,62507,21079,41428,35744498.0,12013050.0,23731448.0,0.5699,0.5729,0.5699,0.5728
2023-07-07 12:20,1226,355,871,89225,15064,74161,51058479.0,8583984.0,42474495.0,1227,352,875,89410,15188,74222,51171805.0,8654024.0,42517781.0,0.5698,0.5727,0.5698,0.5728
2023-07-07 12:25,479,193,286,33474,13787,19687,19141685.0,7865523.0,11276162.0,472,188,284,33583,13710,19873,19200221.0,7814177.0,11386044.0,0.5705,0.5728,0.57,0.5729
2023-07-07 12:30,333,74,259,28552,4987,23565,16321706.0,2814271.0,13507434.0,313,65,248,26645,4656,21989,15220705.0,2627095.0,12593610.0,0.5643,0.5732,0.5642,0.5727
2023-07-07 12:35,2249,508,1741,197965,33959,164006,113146510.0,19304635.0,93841874.0,2239,503,1736,198108,34265,163843,113228896.0,19478327.0,93750568.0,0.5685,0.5722,0.5685,0.5722
2023-07-07 12:40,1026,58,968,113602,4878,108724,65020751.0,2777071.0,62243680.0,1022,53,969,113512,4605,108907,64970582.0,2622029.0,62348552.0,0.5693,0.5725,0.5694,0.5725
2023-07-07 12:45,2064,554,1510,177552,27823,149729,101471447.0,15829036.0,85642410.0,2060,552,1508,177999,28415,149584,101718182.0,16158431.0,85559751.0,0.5689,0.572,0.5687,0.572
2023-07-07 12:50,2637,557,2080,247411,22445,224966,141454858.0,12775969.0,128678889.0,2612,552,2060,247159,22277,224882,141314890.0,12681342.0,128633548.0,0.5692,0.572,0.5693,0.572
2023-07-07 12:55,1738,191,1547,182754,6687,176067,104525005.0,3811737.0,100713268.0,1720,180,1540,183004,6477,176527,104669261.0,3693206.0,100976055.0,0.57,0.572,0.5702,0.572
2023-07-07 13:00,2347,280,2067,235827,10684,225143,134955085.0,6097959.0,128857125.0,2340,273,2067,235958,10867,225091,135023074.0,6195979.0,128827095.0,0.5708,0.5723,0.5702,0.5723
2023-07-07 13:05,1782,342,1440,160565,13540,147025,91931212.0,7725258.0,84205953.0,1773,335,1438,160574,13503,147071,91935390.0,7703197.0,84232192.0,0.5706,0.5727,0.5705,0.5727
2023-07-07 13:10,551,30,521,47896,1178,46718,27432399.0,677541.0,26754857.0,541,21,520,47888,1035,46853,27422621.0,590143.0,26832477.0,0.5752,0.5727,0.5702,0.5727
2023-07-07 13:15,437,67,370,35101,7577,27524,20102479.0,4324732.0,15777747.0,422,59,363,34273,7554,26719,19626378.0,4311441.0,15314937.0,0.5708,0.5732,0.5707,0.5732
2023-07-07 13:20,33,11,22,1368,262,1106,782487.0,149409.0,633078.0,25,9,16,981,144,837,563786.0,82102.0,481684.0,0.5703,0.5724,0.5702,0.5755
2023-07-07 13:25,54,30,24,3841,2650,1191,2195508.0,1512488.0,683020.0,47,24,23,4026,2720,1306,2298666.0,1551669.0,746996.0,0.5708,0.5735,0.5705,0.572
2023-07-07 13:30,160,77,83,12548,7248,5300,7168774.0,4132336.0,3036438.0,138,70,68,12134,7136,4998,6933056.0,4067917.0,2865138.0,0.5701,0.5729,0.5701,0.5733
2023-07-07 13:35,266,25,241,15642,1003,14639,8941124.0,571577.0,8369546.0,262,23,239,15773,997,14776,9017046.0,568090.0,8448955.0,0.5699,0.5717,0.5698,0.5718
2023-07-07 13:40,91,64,27,10996,9308,1688,6255949.0,5290708.0,965241.0,85,59,26,11408,9701,1707,6492497.0,5514824.0,977672.0,0.5684,0.5718,0.5685,0.5727
2023-07-07 13:45,197,22,175,12510,1839,10671,7146773.0,1045465.0,6101308.0,191,17,174,12345,1688,10657,7053328.0,959981.0,6093347.0,0.5685,0.5718,0.5687,0.5718
2023-07-07 13:50,629,23,606,40657,3471,37186,23233637.0,1975565.0,21258072.0,627,20,607,40587,3406,37181,23194818.0,1939709.0,21255108.0,0.5692,0.5717,0.5695,0.5717
2023-07-07 13:55,210,24,186,9307,1599,7708,5320829.0,911419.0,4409409.0,204,20,184,9287,1578,7709,5309226.0,899183.0,4410042.0,0.57,0.5721,0.5698,0.5721
2023-07-07 14:00,83,29,54,3380,1144,2236,1932603.0,652050.0,1280553.0,80,28,52,3454,1114,2340,1974573.0,634142.0,1340430.0,0.57,0.5727,0.5692,0.5728
2023-07-07 14:05,69,45,24,8289,6992,1297,4723388.0,3982787.0,740601.0,65,43,22,8232,6986,1246,4691985.0,3979389.0,712596.0,0.5696,0.571,0.5696,0.5719
2023-07-07 14:10,310,40,270,19390,5546,13844,11071545.0,3160910.0,7910634.0,302,37,265,19223,5472,13751,10975118.0,3117863.0,7857254.0,0.5699,0.5714,0.5698,0.5714
2023-07-07 14:15,453,43,410,26793,2531,24262,15307166.0,1444046.0,13863119.0,446,38,408,27121,2775,24346,15492514.0,1581317.0,13911197.0,0.5705,0.5714,0.5698,0.5714
2023-07-07 14:20,114,23,91,3746,876,2870,2141395.0,499875.0,1641520.0,108,22,86,3711,941,2770,2120984.0,536341.0,1584643.0,0.5706,0.572,0.57,0.5721
2023-07-07 14:25,149,25,124,12309,3267,9042,7029984.0,1860363.0,5169621.0,139,20,119,12445,3152,9293,7112021.0,1794685.0,5317336.0,0.5694,0.5717,0.5694,0.5722
2023-07-07 14:30,239,32,207,16367,3655,12712,9319783.0,2053010.0,7266773.0,227,30,197,15719,2961,12758,8979271.0,1684691.0,7294579.0,0.5617,0.5716,0.569,0.5718
2023-07-07 14:35,35,9,26,634,50,584,362863.0,28643.0,334219.0,31,6,25,634,36,598,362551.0,20113.0,342437.0,0.5729,0.5723,0.5587,0.5726
2023-07-07 14:40,86,34,52,5159,2723,2436,2948143.0,1554347.0,1393795.0,78,29,49,5350,2911,2439,3057159.0,1660968.0,1396191.0,0.5708,0.5722,0.5706,0.5724
2023-07-07 14:45,66,21,45,2890,931,1959,1650633.0,528079.0,1122553.0,54,13,41,3096,1116,1980,1725761.0,592118.0,1133643.0,0.5672,0.573,0.5306,0.5725
2023-07-07 14:50,54,14,40,2828,832,1996,1620968.0,473914.0,1147054.0,41,13,28,2506,608,1898,1448241.0,346808.0,1101433.0,0.5696,0.5747,0.5704,0.5803
2023-07-07 14:55,37,19,18,1727,1366,361,976115.0,774608.0,201507.0,30,17,13,1552,1201,351,884256.0,680707.0,203549.0,0.5671,0.5582,0.5668,0.5799
2023-07-07 15:00,296,99,197,20201,2118,18083,11527608.0,1205569.0,10322039.0,284,92,192,20248,2198,18050,11585238.0,1250298.0,10334939.0,0.5692,0.5708,0.5688,0.5726
2023-07-07 15:05,1411,401,1010,110635,10576,100059,63269627.0,6015537.0,57254089.0,1406,398,1008,109532,9669,99863,62648073.0,5505801.0,57142272.0,0.5688,0.5722,0.5694,0.5722
2023-07-07 15:10,1019,213,806,89418,6783,82635,51131562.0,3844439.0,47287123.0,1009,205,804,88882,6294,82588,50837263.0,3577979.0,47259284.0,0.5668,0.5722,0.5685,0.5722
2023-07-07 15:15,355,73,282,32799,5144,27655,30639906.0,14803182.0,15836724.0,334,65,269,33126,5550,27576,30822446.0,15021531.0,15800915.0,2.8778,0.5727,2.7066,0.573
2023-07-07 15:20,45,20,25,2716,1591,1125,1549027.0,905601.0,643425.0,37,16,21,2570,1374,1196,1466550.0,782485.0,684065.0,0.5692,0.5719,0.5695,0.572
2023-07-07 15:25,58,18,40,4983,1322,3661,2847586.0,754497.0,2093089.0,34,14,20,4964,1624,3340,2835626.0,921049.0,1914577.0,0.5707,0.5717,0.5671,0.5732
2023-07-07 15:30,264,140,124,28912,18274,10638,16452992.0,10380830.0,6072162.0,252,132,120,27041,18078,8963,15389584.0,10269595.0,5119989.0,0.5681,0.5708,0.5681,0.5712
2023-07-07 15:35,599,306,293,45690,27142,18548,26021471.0,15439281.0,10582189.0,590,296,294,45948,27109,18839,26169301.0,15419379.0,10749921.0,0.5688,0.5705,0.5688,0.5706
2023-07-07 15:40,240,87,153,21318,8024,13294,12144298.0,4560718.0,7583580.0,231,80,151,20719,7907,12812,11802692.0,4492878.0,7309813.0,0.5684,0.5705,0.5682,0.5705
2023-07-07 15:45,804,439,365,81123,51370,29753,46186708.0,29208772.0,16977936.0,793,431,362,77768,48312,29456,44272384.0,27466730.0,16805654.0,0.5686,0.5706,0.5685,0.5705
2023-07-07 15:50,677,50,627,60758,977,59781,34789892.0,556965.0,34232926.0,671,44,627,60865,1115,59750,34848686.0,633431.0,34215254.0,0.5701,0.5726,0.5681,0.5726
2023-07-07 15:55,245,50,195,24380,5115,19265,13912093.0,2887349.0,11024744.0,230,39,191,24170,4832,19338,13791852.0,2725315.0,11066537.0,0.5645,0.5723,0.564,0.5723
2023-07-07 16:00,85,21,64,4773,699,4074,2730328.0,400997.0,2329330.0,76,15,61,4619,657,3962,2639421.0,374734.0,2264686.0,0.5737,0.5718,0.5704,0.5716
2023-07-07 16:05,143,55,88,7643,3303,4340,16243439.0,13762065.0,2481374.0,130,48,82,7969,3403,4566,16427811.0,13814443.0,2613367.0,4.1665,0.5717,4.0595,0.5724
2023-07-07 16:10,35,11,24,1652,188,1464,971975.0,106968.0,865006.0,23,8,15,536,140,396,307351.0,79504.0,227846.0,0.569,0.5909,0.5679,0.5754
2023-07-07 16:15,446,248,198,28664,20825,7839,16357468.0,11872701.0,4484767.0,438,245,193,28985,21158,7827,16537863.0,12058518.0,4479344.0,0.5701,0.5721,0.5699,0.5723
2023-07-07 16:20,62,20,42,2030,284,1746,1162275.0,163521.0,998753.0,62,19,43,2053,306,1747,1171215.0,171834.0,999380.0,0.5758,0.572,0.5616,0.5721
2023-07-07 16:25,80,30,50,3294,942,2352,1884079.0,536726.0,1347353.0,70,22,48,3154,618,2536,1802041.0,350808.0,1451233.0,0.5698,0.5729,0.5677,0.5723
2023-07-07 16:30,54,3,51,1214,4,1210,694818.0,2268.0,692550.0,56,5,51,1592,51,1541,912360.0,28524.0,883835.0,0.5672,0.5724,0.5593,0.5735
2023-07-07 16:35,604,287,317,35640,19919,15721,20377143.0,11361975.0,9015167.0,627,316,311,36646,20997,15649,20941701.0,11967658.0,8974042.0,0.5704,0.5734,0.57,0.5735
2023-07-07 16:40,400,235,165,27357,20500,6857,15628005.0,11693952.0,3934052.0,373,231,142,25741,19183,6558,14708898.0,10944435.0,3764463.0,0.5704,0.5737,0.5705,0.574
2023-07-07 16:45,1112,847,265,104460,82315,22145,83681596.0,70959356.0,12722239.0,1082,829,253,103986,82864,21122,83400408.0,71265722.0,12134686.0,0.862,0.5745,0.86,0.5745
2023-07-07 16:50,4598,2529,2069,434918,261020,173898,249113239.0,149225898.0,99887340.0,4586,2524,2062,434860,261060,173800,249079381.0,149248735.0,99830645.0,0.5717,0.5744,0.5717,0.5744
2023-07-07 16:55,5181,2721,2460,465732,289089,176643,266682973.0,165247633.0,101435339.0,5154,2701,2453,465647,288813,176834,266656128.0,165079752.0,101576375.0,0.5716,0.5742,0.5716,0.5744
2023-07-07 17:00,4239,1370,2869,376895,179986,196909,216062389.0,102978498.0,113083891.0,4202,1352,2850,373330,179148,194182,214014968.0,102499502.0,111515466.0,0.5721,0.5743,0.5721,0.5743
2023-07-07 17:05,3023,1799,1224,293918,259636,34282,168269936.0,148564124.0,19705812.0,3016,1797,1219,295637,259482,36155,169257841.0,148474886.0,20782954.0,0.5722,0.5748,0.5722,0.5748
2023-07-07 17:10,3114,1762,1352,323219,279420,43799,185022098.0,159928405.0,25093693.0,3080,1743,1337,322105,278928,43177,184451725.0,159642342.0,24809383.0,0.5724,0.5729,0.5723,0.5746
2023-07-07 17:15,3703,2212,1491,424547,367051,57496,243037935.0,210010573.0,33027361.0,3698,2211,1487,424348,366815,57533,242924589.0,209876005.0,33048584.0,0.5722,0.5744,0.5722,0.5744
2023-07-07 17:20,4596,2506,2090,504196,416715,87481,288678125.0,238422955.0,50255170.0,4585,2502,2083,503188,416699,86489,288090113.0,238413536.0,49676576.0,0.5721,0.5745,0.5721,0.5744
2023-07-07 17:25,1854,1028,826,187188,151935,35253,107184864.0,86939350.0,20245513.0,1853,1017,836,186427,151046,35381,106753896.0,86432783.0,20321112.0,0.5722,0.5743,0.5722,0.5744
2023-07-07 17:30,3775,2163,1612,431335,349301,82034,246943686.0,199831337.0,47112349.0,3755,2155,1600,430467,348595,81872,246448417.0,199429623.0,47018794.0,0.5721,0.5743,0.5721,0.5743
2023-07-07 17:35,2563,1591,972,305284,254821,50463,174710205.0,145743470.0,28966734.0,2560,1588,972,304066,253740,50326,174023034.0,145135144.0,28887890.0,0.5719,0.574,0.572,0.574
2023-07-07 17:40,2748,1261,1487,236227,180132,56095,135253521.0,103073937.0,32179584.0,2742,1258,1484,236510,180614,55896,135436250.0,103344398.0,32091851.0,0.5722,0.5737,0.5722,0.5741
2023-07-07 17:45,2574,1257,1317,213332,167785,45547,122113338.0,95971046.0,26142292.0,2571,1254,1317,212838,167349,45489,121833501.0,95725104.0,26108397.0,0.572,0.574,0.572,0.5739
2023-07-07 17:50,717,241,476,55987,44033,11954,32093252.0,25233724.0,6859528.0,699,233,466,55385,43579,11806,31712257.0,24938399.0,6773858.0,0.5731,0.5738,0.5723,0.5738
2023-07-07 17:55,1004,378,626,72804,45708,27096,41701132.0,26154140.0,15546991.0,890,373,517,72248,45526,26722,41383714.0,26050778.0,15332935.0,0.5722,0.5738,0.5722,0.5738
2023-07-07 18:00,1822,293,1529,80594,11101,69493,46189556.0,6345731.0,39843824.0,1730,291,1439,80965,11566,69399,46386305.0,6595771.0,39790533.0,0.5716,0.5734,0.5703,0.5734
2023-07-07 18:05,2118,539,1579,109890,34178,75712,62935397.0,19526416.0,43408981.0,2073,537,1536,109700,33982,75718,62826858.0,19414402.0,43412456.0,0.5713,0.5733,0.5713,0.5733
2023-07-07 18:10,1584,461,1123,106819,51995,54824,61162545.0,29719046.0,31443498.0,1584,461,1123,106873,52140,54733,61192116.0,29800948.0,31391168.0,0.5716,0.5735,0.5716,0.5735
2023-07-07 18:15,1155,593,562,146914,117854,29060,84027356.0,67354099.0,16673257.0,1153,590,563,146934,117431,29503,84043305.0,67112650.0,16930655.0,0.5715,0.5738,0.5715,0.5739
2023-07-07 18:20,1047,395,652,84314,42997,41317,48279579.0,24583271.0,23696308.0,1048,395,653,84105,42606,41499,48161695.0,24360715.0,23800980.0,0.5717,0.5735,0.5718,0.5735
2023-07-07 18:25,2154,1382,772,252063,213250,38813,144279297.0,121999141.0,22280155.0,2152,1380,772,252599,213851,38748,144573634.0,122331844.0,22241790.0,0.5721,0.574,0.572,0.574
2023-07-07 18:30,3279,2517,762,504803,469888,34915,288965535.0,268907072.0,20058462.0,3262,2513,749,504484,469957,34527,288780050.0,268941500.0,19838549.0,0.5723,0.5745,0.5723,0.5746
2023-07-07 18:35,1423,1042,381,206527,195308,11219,130154854.0,123701612.0,6453242.0,1413,1034,379,206801,195486,11315,130306162.0,123798390.0,6507771.0,0.6334,0.5752,0.6333,0.5751
2023-07-10 10:00,1139,526,613,69547,51039,18508,63750272.0,52777083.0,10973189.0,911,463,448,57590,44311,13279,50279777.0,42594056.0,7685720.0,1.0341,0.5929,0.9613,0.5788
2023-07-10 10:05,2013,982,1031,163622,93653,69969,102324945.0,61549759.0,40775185.0,1846,889,957,153767,94001,59766,94733522.0,60172844.0,34560677.0,0.6572,0.5828,0.6401,0.5783
2023-07-10 10:10,2818,1711,1107,231910,148194,83716,157107993.0,108748947.0,48359046.0,2716,1667,1049,227212,145694,81518,150438000.0,103343921.0,47094079.0,0.7338,0.5777,0.7093,0.5777
2023-07-10 10:15,2964,1002,1962,316513,68655,247858,194512176.0,51316912.0,143195263.0,2888,961,1927,313876,67319,246557,192949047.0,50502859.0,142446188.0,0.7475,0.5777,0.7502,0.5777
2023-07-10 10:20,2571,1495,1076,293970,242914,51056,168966255.0,139466960.0,29499294.0,2518,1474,1044,292111,242084,50027,167891495.0,138979998.0,28911497.0,0.5741,0.5778,0.5741,0.5779
2023-07-10 10:25,3630,1916,1714,351126,276967,74159,201709096.0,158902820.0,42806275.0,3593,1889,1704,350436,276133,74303,201323698.0,158432168.0,42891530.0,0.5737,0.5772,0.5738,0.5773
2023-07-10 10:30,2776,1499,1277,325492,241091,84401,187194837.0,138416805.0,48778032.0,2754,1486,1268,325217,240977,84240,187047388.0,138353334.0,48694053.0,0.5741,0.5779,0.5741,0.578
2023-07-10 10:35,473,289,184,28338,24200,4138,16276676.0,13890911.0,2385765.0,452,282,170,27711,23745,3966,15917292.0,13628317.0,2288975.0,0.574,0.5766,0.5739,0.5771
2023-07-10 10:40,490,332,158,24973,21460,3513,14258663.0,12239629.0,2019034.0,457,312,145,22864,20324,2540,13146218.0,11681886.0,1464332.0,0.5703,0.5747,0.5748,0.5765
2023-07-10 10:45,3930,2052,1878,444967,338456,106511,267363796.0,205915111.0,61448685.0,3817,1997,1820,444370,338185,106185,267040703.0,205763319.0,61277383.0,0.6084,0.5769,0.6084,0.5771
2023-07-10 10:50,5072,2134,2938,484115,304460,179655,278413265.0,174832211.0,103581053.0,5028,2116,2912,483281,304201,179080,277920530.0,174672778.0,103247752.0,0.5742,0.5766,0.5742,0.5765
2023-07-10 10:55,5431,2161,3270,532498,275041,257457,306278351.0,157892869.0,148385482.0,5403,2146,3257,531539,274681,256858,305758052.0,157684375.0,148073677.0,0.5741,0.5764,0.5741,0.5765
2023-07-10 11:00,5173,2636,2537,520626,321348,199278,299228331.0,184389799.0,114838531.0,5139,2626,2513,519611,321242,198369,298640244.0,184328080.0,114312164.0,0.5738,0.5763,0.5738,0.5763
2023-07-10 11:05,4366,1974,2392,460779,206233,254546,264871337.0,118335944.0,146535393.0,4341,1951,2390,460363,205975,254388,264689624.0,118188903.0,146500721.0,0.5738,0.5757,0.5738,0.5759
2023-07-10 11:10,5652,2143,3509,686728,167759,518969,395269252.0,96218217.0,299051035.0,5650,2143,3507,686365,167752,518613,395067006.0,96214231.0,298852775.0,0.5736,0.5762,0.5736,0.5763
2023-07-10 11:15,3851,1362,2489,461772,116165,345607,265787144.0,66624297.0,199162846.0,3822,1350,2472,460917,115671,345246,265283675.0,66331567.0,198952108.0,0.5735,0.5763,0.5735,0.5763
2023-07-10 11:20,2964,1925,1039,241193,155021,86172,138517823.0,88877455.0,49640368.0,2944,1910,1034,240698,154384,86314,138233522.0,88509652.0,49723870.0,0.5733,0.5761,0.5733,0.5761
2023-07-10 11:25,3636,663,2973,331174,20035,311139,190701439.0,11490420.0,179211018.0,3623,656,2967,330664,19850,310814,190412328.0,11385966.0,179026361.0,0.5735,0.576,0.5736,0.576
2023-07-10 11:30,3892,736,3156,356089,19510,336579,204975351.0,11183395.0,193791956.0,3872,723,3149,355804,19379,336425,204815160.0,11109453.0,193705707.0,0.5732,0.5758,0.5733,0.5758
2023-07-10 11:35,4605,1239,3366,449573,54793,394780,258554400.0,31352313.0,227202086.0,4600,1234,3366,449581,54833,394748,258571862.0,31373716.0,227198145.0,0.5722,0.5755,0.5722,0.5756
2023-07-10 11:40,3406,836,2570,332652,30656,301996,191348198.0,17537733.0,173810465.0,3387,825,2562,331609,30073,301536,190759387.0,17205412.0,173553975.0,0.5721,0.5755,0.5721,0.5756
2023-07-10 11:45,3026,550,2476,306504,14319,292185,176422685.0,8219390.0,168203294.0,3006,533,2473,304784,12759,292025,175421051.0,7312889.0,168108162.0,0.574,0.5757,0.5732,0.5757
2023-07-10 11:50,4770,739,4031,534039,22951,511088,307580279.0,13125301.0,294454977.0,4738,717,4021,532471,22753,509718,306659283.0,13038357.0,293620926.0,0.5719,0.5761,0.573,0.576
2023-07-10 11:55,4252,724,3528,532473,21023,511450,306619823.0,12056505.0,294563318.0,4238,712,3526,532222,20830,511392,306481250.0,11945144.0,294536105.0,0.5735,0.5759,0.5735,0.5759
2023-07-10 12:00,3560,709,2851,438446,21423,417023,252522611.0,12266660.0,240255950.0,3540,693,2847,436003,19260,416743,251120525.0,11036347.0,240084177.0,0.5726,0.5761,0.573,0.5761
2023-07-10 12:05,3279,692,2587,370490,23769,346721,213343219.0,13586776.0,199756443.0,3253,677,2576,369906,23560,346346,213009799.0,13471543.0,199538256.0,0.5716,0.5761,0.5718,0.5761
2023-07-10 12:10,4067,883,3184,559664,49445,510219,322153397.0,28242281.0,293911116.0,4061,879,3182,559607,49433,510174,322120790.0,28235150.0,293885640.0,0.5712,0.576,0.5712,0.576
2023-07-10 12:15,2308,507,1801,316300,25206,291094,182112014.0,14415054.0,167696960.0,2293,500,1793,315473,25014,290459,181631863.0,14297966.0,167333896.0,0.5719,0.5761,0.5716,0.5761
2023-07-10 12:20,962,229,733,75954,6455,69499,43707115.0,3698502.0,40008612.0,942,216,726,74964,6116,68848,43141736.0,3504100.0,39637635.0,0.573,0.5757,0.5729,0.5757
2023-07-10 12:25,2566,453,2113,282057,17584,264473,162279736.0,10073965.0,152205770.0,2543,432,2111,281859,17223,264636,162167198.0,9866461.0,152300737.0,0.5729,0.5755,0.5729,0.5755
2023-07-10 12:30,1673,320,1353,204141,12999,191142,117513600.0,7444914.0,110068686.0,1651,314,1337,203408,12370,191038,117084971.0,7080605.0,110004365.0,0.5727,0.5758,0.5724,0.5758
2023-07-10 12:35,541,174,367,49095,7085,42010,40087919.0,15935072.0,24152846.0,519,160,359,47288,6788,40500,39092942.0,15765663.0,23327279.0,2.2491,0.5749,2.3226,0.576
2023-07-10 12:40,532,115,417,39642,5271,34371,22766551.0,3013100.0,19753451.0,516,104,412,39221,5175,34046,22543299.0,2958419.0,19584880.0,0.5716,0.5747,0.5717,0.5752
2023-07-10 12:45,369,132,237,22367,5288,17079,12837269.0,3016229.0,9821039.0,329,101,228,21609,4926,16683,12413400.0,2817534.0,9595865.0,0.5704,0.575,0.572,0.5752
2023-07-10 12:50,258,73,185,16040,7349,8691,9215919.0,4220472.0,4995447.0,245,65,180,15811,7178,8633,9066344.0,4103901.0,4962443.0,0.5743,0.5748,0.5717,0.5748
2023-07-10 12:55,358,110,248,32219,8409,23810,18505647.0,4802937.0,13702710.0,330,90,240,31421,8240,23181,18073191.0,4709474.0,13363717.0,0.5712,0.5755,0.5715,0.5765
2023-07-10 13:00,773,285,488,52127,18683,33444,29902722.0,10674970.0,19227752.0,751,268,483,52034,18569,33465,29854176.0,10613579.0,19240596.0,0.5714,0.5749,0.5716,0.5749
2023-07-10 13:05,114,37,77,3122,1123,1999,1791752.0,639604.0,1152148.0,100,27,73,3101,1079,2022,1778727.0,612659.0,1166068.0,0.5695,0.5764,0.5678,0.5767
2023-07-10 13:10,282,104,178,22756,8596,14160,13083000.0,4921821.0,8161179.0,268,93,175,22519,8419,14100,12946200.0,4819212.0,8126988.0,0.5726,0.5764,0.5724,0.5764
2023-07-10 13:15,576,202,374,46642,11155,35487,26871184.0,6386092.0,20485092.0,559,189,370,44622,10758,33864,25668835.0,6156034.0,19512800.0,0.5725,0.5773,0.5722,0.5762
2023-07-10 13:20,1757,812,945,198855,61214,137641,126317339.0,46979373.0,79337966.0,1699,770,929,183485,46496,136989,117487038.0,38525895.0,78961143.0,0.7675,0.5764,0.8286,0.5764
2023-07-10 13:25,3277,2608,669,447408,410067,37341,316997390.0,295390413.0,21606977.0,3197,2569,628,455540,420094,35446,321418181.0,300956129.0,20462051.0,0.7203,0.5786,0.7164,0.5773
2023-07-10 13:30,3175,2425,750,375154,362935,12219,216103944.0,209033957.0,7069986.0,3141,2408,733,371574,360206,11368,214038304.0,207464000.0,6574303.0,0.576,0.5786,0.576,0.5783
2023-07-10 13:35,164,65,99,5666,3937,1729,3262341.0,2261806.0,1000534.0,147,59,88,5048,3684,1364,2907799.0,2119271.0,788528.0,0.5745,0.5787,0.5753,0.5781
2023-07-10 13:40,1040,650,390,85450,77888,7562,49193781.0,44838445.0,4355336.0,1032,647,385,85592,77795,7797,49298444.0,44785206.0,4513238.0,0.5757,0.576,0.5757,0.5788
2023-07-10 13:45,613,390,223,56732,51364,5368,32671158.0,29567548.0,3103609.0,661,405,256,57020,52481,4539,32830599.0,30203146.0,2627452.0,0.5756,0.5782,0.5755,0.5789
2023-07-10 13:50,331,178,153,28581,22258,6323,16568220.0,12809902.0,3758318.0,269,170,99,26228,21779,4449,15107168.0,12533792.0,2573376.0,0.5755,0.5944,0.5755,0.5784
2023-07-10 13:55,486,315,171,43219,35494,7725,24879507.0,20417790.0,4461717.0,463,295,168,42365,35053,7312,24399557.0,20175776.0,4223781.0,0.5752,0.5776,0.5756,0.5777
2023-07-10 14:00,2547,1743,804,308164,288450,19714,184847050.0,173464651.0,11382399.0,2544,1743,801,308571,288397,20174,177682904.0,166034545.0,11648359.0,0.6014,0.5774,0.5757,0.5774
2023-07-10 14:05,576,431,145,72875,70854,2021,41948774.0,40784899.0,1163875.0,554,423,131,72416,70867,1549,41688428.0,40793124.0,895303.0,0.5756,0.5759,0.5756,0.578
2023-07-10 14:10,551,476,75,61260,59735,1525,35343537.0,34460053.0,883484.0,540,472,68,60614,59243,1371,34936518.0,34142429.0,794089.0,0.5769,0.5793,0.5763,0.5792
2023-07-10 14:15,3142,2524,618,427489,417652,9837,282828383.0,277145184.0,5683199.0,3069,2501,568,413869,404666,9203,281672768.0,276343153.0,5329615.0,0.6636,0.5777,0.6829,0.5791
2023-07-10 14:20,927,596,331,65289,56317,8972,61670090.0,56431585.0,5238505.0,829,572,257,60793,55235,5558,59030444.0,55788757.0,3241687.0,1.002,0.5839,1.01,0.5832
2023-07-10 14:25,491,263,228,25468,10429,15039,14884477.0,6093412.0,8791065.0,475,271,204,25125,9507,15618,14631267.0,5501754.0,9129512.0,0.5843,0.5846,0.5787,0.5846
2023-07-10 14:30,1031,670,361,49812,36144,13668,52762780.0,44780346.0,7982433.0,867,564,303,44264,32807,11457,49499649.0,42799503.0,6700145.0,1.2389,0.584,1.3046,0.5848
2023-07-10 14:35,1131,682,449,91990,75557,16433,77538096.0,67906147.0,9631949.0,944,638,306,84774,73276,11498,73170758.0,66425982.0,6744775.0,0.8987,0.5861,0.9065,0.5866
2023-07-10 14:40,3132,1048,2084,304583,93739,210844,236938737.0,114059337.0,122879400.0,2940,948,1992,292624,89339,203285,230529702.0,111464862.0,119064840.0,1.2168,0.5828,1.2477,0.5857
2023-07-10 14:45,2711,1674,1037,295522,216621,78901,243711778.0,197695661.0,46016116.0,2579,1610,969,291871,215622,76249,241485773.0,196860440.0,44625333.0,0.9126,0.5832,0.913,0.5853
2023-07-10 14:50,1552,1071,481,132525,117427,15098,89161366.0,80301590.0,8859776.0,1367,1050,317,128033,116138,11895,86530319.0,79535451.0,6994867.0,0.6838,0.5868,0.6848,0.5881
2023-07-10 14:55,1576,871,705,134422,48232,86190,78615633.0,28144982.0,50470650.0,1521,843,678,131871,47574,84297,77198131.0,27757003.0,49441128.0,0.5835,0.5856,0.5834,0.5865
2023-07-10 15:00,2759,1004,1755,350237,55476,294761,205003088.0,32309000.0,172694088.0,2730,985,1745,348171,53410,294761,203779694.0,31112565.0,172667129.0,0.5824,0.5859,0.5825,0.5858
2023-07-10 15:05,4967,2413,2554,527676,116209,411467,320583313.0,79607358.0,240975954.0,4933,2395,2538,526432,116341,410091,319878693.0,79661376.0,240217316.0,0.685,0.5857,0.6847,0.5858
2023-07-10 15:10,3437,1724,1713,410778,76052,334726,240289562.0,44244581.0,196044980.0,3404,1718,1686,410384,75888,334496,240058651.0,44148245.0,195910406.0,0.5818,0.5857,0.5818,0.5857
2023-07-10 15:15,2787,722,2065,403746,33898,369848,236173206.0,19701840.0,216471366.0,2746,706,2040,399814,33500,366314,233845080.0,19460797.0,214384283.0,0.5812,0.5853,0.5809,0.5852
2023-07-10 15:20,2299,1038,1261,241235,59619,181616,141007944.0,34717515.0,106290429.0,2266,1017,1249,239860,58680,181180,140194246.0,34137069.0,106057177.0,0.5823,0.5852,0.5817,0.5854
2023-07-10 15:25,916,599,317,67455,29887,37568,39392163.0,17418440.0,21973722.0,883,576,307,67286,29031,38255,39301951.0,16899141.0,22402810.0,0.5828,0.5849,0.5821,0.5856
2023-07-10 15:30,1971,1165,806,182190,68016,114174,106449902.0,39617249.0,66832652.0,1936,1146,790,180121,66920,113201,105238713.0,38967131.0,66271582.0,0.5825,0.5854,0.5823,0.5854
2023-07-10 15:35,1306,741,565,115408,53776,61632,67400573.0,31328283.0,36072290.0,1291,741,550,115168,53728,61440,67262354.0,31298551.0,35963802.0,0.5826,0.5853,0.5825,0.5853
2023-07-10 15:40,2324,1526,798,169522,109821,59701,98851690.0,63984196.0,34867493.0,2284,1510,774,168821,109640,59181,98495449.0,63877868.0,34617581.0,0.5826,0.584,0.5826,0.5849
2023-07-10 15:45,2365,943,1422,246697,52407,194290,144168543.0,30493178.0,113675365.0,2342,936,1406,246350,52310,194040,143965750.0,30435363.0,113530386.0,0.5819,0.5851,0.5818,0.5851
2023-07-10 15:50,2677,658,2019,293147,45878,247269,171205713.0,26689177.0,144516535.0,2658,652,2006,292818,45538,247280,171020383.0,26491154.0,144529228.0,0.5817,0.5845,0.5817,0.5845
2023-07-10 15:55,3301,963,2338,319854,54136,265718,198665196.0,43374756.0,155290440.0,3261,945,2316,319222,54302,264920,198272425.0,43445799.0,154826626.0,0.8012,0.5844,0.8001,0.5844
2023-07-10 16:00,4197,1832,2365,480396,143256,337140,280199245.0,83154973.0,197044271.0,4182,1819,2363,480564,143322,337242,280294955.0,83189665.0,197105290.0,0.5805,0.5845,0.5804,0.5845
2023-07-10 16:05,3032,1180,1852,288792,79256,209536,168463313.0,46021270.0,122442042.0,3032,1178,1854,288882,79266,209616,168518317.0,46026638.0,122491679.0,0.5807,0.5843,0.5807,0.5844
2023-07-10 16:10,1890,536,1354,247887,42487,205400,144711323.0,24666424.0,120044899.0,1878,531,1347,246963,42523,204440,144167375.0,24678111.0,119489264.0,0.5806,0.5844,0.5803,0.5845
2023-07-10 16:15,2582,705,1877,322395,44936,277459,200057138.0,37958809.0,162098329.0,2577,700,1877,322858,44907,277951,200350349.0,37939879.0,162410469.0,0.8447,0.5842,0.8449,0.5843
2023-07-10 16:20,286,64,222,42296,1433,40863,24732346.0,832032.0,23900313.0,258,50,208,42265,1331,40934,24715458.0,772103.0,23943355.0,0.5806,0.5849,0.5801,0.5849
2023-07-10 16:25,250,84,166,9895,3066,6829,5763046.0,1782464.0,3980582.0,224,69,155,9280,2855,6425,5400045.0,1652917.0,3747127.0,0.5814,0.5829,0.579,0.5832
2023-07-10 16:30,284,102,182,17733,5757,11976,10338256.0,3354341.0,6983914.0,242,84,158,16516,5307,11209,9619736.0,3071777.0,6547959.0,0.5827,0.5832,0.5788,0.5842
2023-07-10 16:35,670,235,435,48546,13112,35434,28278236.0,7603487.0,20674748.0,637,228,409,47675,12813,34862,27765677.0,7428267.0,20337410.0,0.5799,0.5835,0.5797,0.5834
2023-07-10 16:40,1477,492,985,160309,37977,122332,93404803.0,22025041.0,71379761.0,1466,486,980,160135,37965,122170,93308494.0,22018264.0,71290230.0,0.58,0.5835,0.58,0.5835
2023-07-10 16:45,1004,364,640,84790,19074,65716,49370484.0,11050684.0,38319800.0,1005,362,643,84942,19163,65779,49458165.0,11100476.0,38357689.0,0.5794,0.5831,0.5793,0.5831
2023-07-10 16:50,1118,177,941,148060,8582,139478,86323941.0,4972682.0,81351258.0,1084,160,924,144733,6154,138579,84419858.0,3563280.0,80856578.0,0.5794,0.5833,0.579,0.5835
2023-07-10 16:55,597,105,492,66648,7851,58797,50761101.0,16421884.0,34339217.0,536,86,450,63745,6869,56876,49061349.0,15845704.0,33215644.0,2.0917,0.584,2.3068,0.584
2023-07-10 17:00,521,78,443,61414,4373,57041,35867679.0,2540561.0,33327118.0,506,90,416,61545,5065,56480,35925924.0,2916967.0,33008956.0,0.581,0.5843,0.5759,0.5844
2023-07-10 17:05,1060,102,958,144270,10118,134152,84185166.0,5850158.0,78335008.0,1026,84,942,143363,9607,133756,83674490.0,5552271.0,78122219.0,0.5782,0.5839,0.5779,0.5841
2023-07-10 17:10,1437,57,1380,230329,6529,223800,134505778.0,3793293.0,130712485.0,1396,43,1353,229557,6178,223379,134059227.0,3579334.0,130479892.0,0.581,0.5841,0.5794,0.5841
2023-07-10 17:15,1170,128,1042,131810,13710,118100,76836751.0,7950800.0,68885950.0,1155,122,1033,132364,15534,116830,77238769.0,9008262.0,68230506.0,0.5799,0.5833,0.5799,0.584
2023-07-10 17:20,238,54,184,37547,6523,31024,21898657.0,3787432.0,18111225.0,248,56,192,39998,6989,33009,23336500.0,4057919.0,19278581.0,0.5806,0.5838,0.5806,0.584
2023-07-10 17:25,627,84,543,108180,8771,99409,63151973.0,5097653.0,58054319.0,601,68,533,107242,8009,99233,62608937.0,4654348.0,57954589.0,0.5812,0.584,0.5811,0.584
2023-07-10 17:30,3096,925,2171,454716,140189,314527,265033161.0,81419525.0,183613636.0,3071,918,2153,454262,140013,314249,264758781.0,81315024.0,183443756.0,0.5808,0.5838,0.5808,0.5838
2023-07-10 17:35,975,314,661,142497,43084,99413,83061510.0,25017294.0,58044215.0,976,316,660,143560,43658,99902,83680622.0,25349466.0,58331156.0,0.5807,0.5839,0.5806,0.5839
2023-07-10 17:40,219,75,144,26303,8069,18234,15317195.0,4670372.0,10646822.0,194,71,123,25575,7454,18121,14901142.0,4316172.0,10584970.0,0.5788,0.5839,0.579,0.5841
2023-07-10 17:45,582,197,385,46760,8280,38480,27291322.0,4809843.0,22481479.0,550,184,366,44767,6833,37934,26126600.0,3966334.0,22160266.0,0.5809,0.5842,0.5805,0.5842
2023-07-10 17:50,843,170,673,100167,10500,89667,58489522.0,6109286.0,52380236.0,802,153,649,99518,10169,89349,58107033.0,5911600.0,52195433.0,0.5818,0.5842,0.5813,0.5842
2023-07-10 17:55,450,87,363,44116,7190,36926,25750346.0,4191153.0,21559193.0,422,76,346,42873,6546,36327,25015126.0,3805220.0,21209905.0,0.5829,0.5838,0.5813,0.5839
2023-07-10 18:00,1171,598,573,114869,75333,39536,66816258.0,43755598.0,23060659.0,1129,590,539,115304,76606,38698,67041116.0,44459158.0,22581958.0,0.5808,0.5833,0.5804,0.5835
2023-07-10 18:05,1575,1079,496,152893,143148,9745,88801691.0,83123341.0,5678350.0,1569,1075,494,152403,142720,9683,88521528.0,82874534.0,5646994.0,0.5807,0.5827,0.5807,0.5832
2023-07-10 18:10,294,126,168,25302,11523,13779,14776758.0,6722242.0,8054516.0,273,121,152,22639,11289,11350,13187692.0,6555425.0,6632267.0,0.5834,0.5846,0.5807,0.5843
2023-07-10 18:15,986,566,420,121796,75454,46342,70921141.0,43797356.0,27123784.0,957,556,401,121062,74697,46365,70486176.0,43345752.0,27140424.0,0.5805,0.5853,0.5803,0.5854
2023-07-10 18:20,260,128,132,7013,3401,3612,4085165.0,1974304.0,2110861.0,258,126,132,6979,3610,3369,4063747.0,2096021.0,1967725.0,0.5805,0.5844,0.5806,0.5841
2023-07-10 18:25,1105,626,479,71061,52387,18674,41295934.0,30429380.0,10866554.0,1088,620,468,70760,52416,18344,41145560.0,30443568.0,10701992.0,0.5809,0.5819,0.5808,0.5834
2023-07-10 18:30,2082,1306,776,154676,104794,49882,89959374.0,60882919.0,29076455.0,2058,1298,760,154441,104877,49564,89800391.0,60907978.0,28892412.0,0.581,0.5829,0.5808,0.5829
2023-07-10 18:35,2736,1780,956,230369,158248,72121,133959268.0,91905453.0,42053815.0,2730,1775,955,231198,158667,72531,134446969.0,92145918.0,42301051.0,0.5808,0.5831,0.5808,0.5832
2023-07-11 10:00,4136,2727,1409,445666,354155,91511,295515822.0,241657359.0,53858462.0,3759,2554,1205,419147,342108,77039,270391271.0,225256566.0,45134705.0,0.6823,0.5885,0.6584,0.5859
2023-07-11 10:05,2458,677,1781,159300,29127,130173,92890127.0,16844815.0,76045311.0,2355,621,1734,157774,28458,129316,91984067.0,16447151.0,75536916.0,0.5783,0.5842,0.5779,0.5841
2023-07-11 10:10,4591,1799,2792,392000,170995,221005,264039677.0,134930742.0,129108935.0,4510,1761,2749,391033,169473,221560,261082451.0,131650139.0,129432311.0,0.7891,0.5842,0.7768,0.5842
2023-07-11 10:15,2606,1674,932,199918,163905,36013,116355468.0,95281690.0,21073777.0,2333,1464,869,197990,163332,34658,115191359.0,94924713.0,20266646.0,0.5813,0.5852,0.5812,0.5848
2023-07-11 10:20,1586,954,632,117026,87516,29510,92114523.0,74601440.0,17513083.0,1540,931,609,108622,84609,24013,86977080.0,72936202.0,14040877.0,0.8524,0.5935,0.862,0.5847
2023-07-11 10:25,638,275,363,32282,7687,24595,18856510.0,4467074.0,14389436.0,581,250,331,32117,8388,23729,18736468.0,4870389.0,13866078.0,0.5811,0.5851,0.5806,0.5844
2023-07-11 10:30,881,433,448,54324,33656,20668,31530332.0,19482934.0,12047398.0,779,388,391,49919,31371,18548,29011401.0,18184574.0,10826827.0,0.5789,0.5829,0.5797,0.5837
2023-07-11 10:35,3636,1786,1850,325896,208286,117610,201289678.0,132710214.0,68579464.0,3570,1749,1821,323797,206360,117437,200106499.0,131597485.0,68509014.0,0.6372,0.5831,0.6377,0.5834
2023-07-11 10:40,2804,1617,1187,263430,184585,78845,152973074.0,106998636.0,45974438.0,2765,1591,1174,262967,184265,78702,152693635.0,106805688.0,45887946.0,0.5797,0.5831,0.5796,0.5831
2023-07-11 10:45,1765,1195,570,126298,100963,25335,73297148.0,58539504.0,14757643.0,1738,1174,564,125477,100587,24890,72835763.0,58322060.0,14513703.0,0.5798,0.5825,0.5798,0.5831
2023-07-11 10:50,3821,955,2866,233106,34761,198345,171148266.0,55772462.0,115375804.0,3752,908,2844,230673,33352,197321,169864097.0,54961729.0,114902367.0,1.6045,0.5817,1.6479,0.5823
2023-07-11 10:55,3641,598,3043,247491,10643,236848,144094226.0,6212164.0,137882062.0,3589,578,3011,245858,9724,236134,143095262.0,5630212.0,137465050.0,0.5837,0.5822,0.579,0.5821
2023-07-11 11:00,4832,2001,2831,428754,237558,191196,272299544.0,161094749.0,111204795.0,4553,1744,2809,427826,236203,191623,271788187.0,160306560.0,111481626.0,0.6781,0.5816,0.6787,0.5818
2023-07-11 11:05,6397,2505,3892,522743,323773,198970,303085502.0,187326641.0,115758861.0,6328,2490,3838,521110,323317,197793,302135294.0,187059428.0,115075865.0,0.5786,0.5818,0.5786,0.5818
2023-07-11 11:10,4577,1710,2867,403002,230224,172778,233839154.0,133280173.0,100558981.0,4531,1690,2841,401760,229614,172146,233130340.0,132913198.0,100217142.0,0.5789,0.582,0.5789,0.5822
2023-07-11 11:15,4837,2125,2712,464021,285901,178120,269352176.0,165629070.0,103723105.0,4834,2119,2715,463271,285361,177910,268910411.0,165306744.0,103603666.0,0.5793,0.5823,0.5793,0.5823
2023-07-11 11:20,2729,1248,1481,242611,178904,63707,140766295.0,103673804.0,37092491.0,2685,1228,1457,241940,178376,63564,140358889.0,103342482.0,37016407.0,0.5795,0.5822,0.5794,0.5823
2023-07-11 11:25,703,185,518,27196,5531,21665,27704049.0,15088673.0,12615376.0,676,171,505,26794,5472,21322,27469808.0,15048012.0,12421795.0,2.728,0.5823,2.75,0.5826
2023-07-11 11:30,176,67,109,9609,4982,4627,5580433.0,2886882.0,2693550.0,163,60,103,9125,4631,4494,5301996.0,2684853.0,2617142.0,0.5795,0.5821,0.5798,0.5824
2023-07-11 11:35,168,61,107,7692,2063,5629,4472917.0,1194511.0,3278405.0,155,55,100,7638,2040,5598,4441017.0,1181089.0,3259928.0,0.579,0.5824,0.579,0.5823
2023-07-11 11:40,412,175,237,11520,4675,6845,6690063.0,2694629.0,3995434.0,390,165,225,9922,4096,5826,5762904.0,2373288.0,3389616.0,0.5764,0.5837,0.5794,0.5818
2023-07-11 11:45,1034,662,372,75025,62080,12945,43482303.0,35939113.0,7543189.0,1020,655,365,74591,61990,12601,43218382.0,35886902.0,7331479.0,0.5789,0.5827,0.5789,0.5818
2023-07-11 11:50,727,475,252,60690,48217,12473,35171706.0,27916984.0,7254722.0,693,454,239,60303,48068,12235,34943920.0,27830430.0,7113489.0,0.579,0.5816,0.579,0.5814
2023-07-11 11:55,740,408,332,37434,21733,15701,21736176.0,12596924.0,9139252.0,715,386,329,37713,21490,16223,21905298.0,12454501.0,9450797.0,0.5796,0.5821,0.5795,0.5826
2023-07-11 12:00,150,73,77,3508,2174,1334,2037102.0,1261052.0,776050.0,131,68,63,3364,2069,1295,1953953.0,1200092.0,753861.0,0.5801,0.5817,0.58,0.5821
2023-07-11 12:05,995,482,513,71151,36805,34346,41366708.0,21356024.0,20010684.0,988,479,509,70932,36808,34124,41232287.0,21353662.0,19878625.0,0.5802,0.5826,0.5801,0.5825
2023-07-11 12:10,1432,649,783,93401,45033,48368,54300884.0,26131596.0,28169288.0,1413,643,770,93251,45081,48170,54209674.0,26155465.0,28054209.0,0.5803,0.5824,0.5802,0.5824
2023-07-11 12:15,1271,330,941,84399,9751,74648,49137076.0,5659395.0,43477680.0,1265,326,939,84211,9743,74468,49029401.0,5654789.0,43374612.0,0.5804,0.5824,0.5804,0.5825
2023-07-11 12:20,809,364,445,50582,19651,30931,29384929.0,11383283.0,18001645.0,787,353,434,50057,19279,30778,29091954.0,11171697.0,17920257.0,0.5793,0.582,0.5795,0.5822
2023-07-11 12:25,548,316,232,37884,26199,11685,21988858.0,15181722.0,6807136.0,531,310,221,37784,26016,11768,21917412.0,15062371.0,6855040.0,0.5795,0.5826,0.579,0.5825
2023-07-11 12:30,906,188,718,47812,3563,44249,27788056.0,2066128.0,25721928.0,880,180,700,46674,3431,43243,27177313.0,1988378.0,25188934.0,0.5799,0.5813,0.5795,0.5825
2023-07-11 12:35,1311,432,879,77815,5790,72025,57179006.0,15225249.0,41953757.0,1306,428,878,76948,5779,71169,56691985.0,15219720.0,41472264.0,2.6296,0.5825,2.6336,0.5827
2023-07-11 12:40,300,165,135,5980,3171,2809,3449387.0,1818129.0,1631258.0,257,140,117,5583,3127,2456,3226231.0,1800102.0,1426128.0,0.5734,0.5807,0.5757,0.5807
2023-07-11 12:45,723,190,533,57132,5574,51558,45077767.0,15097337.0,29980429.0,702,175,527,57631,5415,52216,45376596.0,15005390.0,30371206.0,2.7085,0.5815,2.7711,0.5816
2023-07-11 12:50,121,18,103,5644,394,5250,3276895.0,227491.0,3049404.0,114,14,100,5600,398,5202,3249809.0,229781.0,3020027.0,0.5774,0.5808,0.5773,0.5806
2023-07-11 12:55,1681,98,1583,95014,1561,93453,67001853.0,12779301.0,54222551.0,1670,87,1583,95368,1556,93812,67208434.0,12776426.0,54432007.0,8.1866,0.5802,8.2111,0.5802
2023-07-11 13:00,385,34,351,19233,733,18500,11169817.0,423690.0,10746126.0,372,29,343,18593,650,17943,10790212.0,375794.0,10414417.0,0.578,0.5809,0.5781,0.5804
2023-07-11 13:05,1374,154,1220,62719,3080,59639,36346359.0,1768768.0,34577591.0,1343,138,1205,62579,2889,59690,36273515.0,1664969.0,34608546.0,0.5743,0.5798,0.5763,0.5798
2023-07-11 13:10,766,160,606,39233,5113,34120,22756177.0,2957240.0,19798936.0,757,150,607,39141,4955,34186,22703210.0,2865805.0,19837405.0,0.5784,0.5803,0.5784,0.5803
2023-07-11 13:15,543,216,327,34755,9149,25606,20136544.0,5287136.0,14849408.0,528,209,319,33805,8636,25169,19604349.0,4989457.0,14614892.0,0.5779,0.5799,0.5778,0.5807
2023-07-11 13:20,127,48,79,4993,536,4457,2887138.0,309911.0,2577226.0,116,42,74,4776,564,4212,2770201.0,326116.0,2444084.0,0.5782,0.5782,0.5782,0.5803
2023-07-11 13:25,374,252,122,11760,5389,6371,6829936.0,3120652.0,3709283.0,204,95,109,10241,4447,5794,5951683.0,2572702.0,3378981.0,0.5791,0.5822,0.5785,0.5832
2023-07-11 13:30,492,205,287,26931,13171,13760,15621773.0,7618710.0,8003062.0,481,202,279,26853,13140,13713,15579042.0,7607420.0,7971622.0,0.5784,0.5816,0.579,0.5813
2023-07-11 13:35,620,223,397,38887,11637,27250,22604731.0,6743348.0,15861382.0,595,221,374,39174,11836,27338,22764323.0,6852458.0,15911865.0,0.5795,0.5821,0.579,0.582
2023-07-11 13:40,1215,297,918,95234,17866,77368,55399314.0,10340069.0,45059245.0,1206,288,918,94528,17454,77074,55007019.0,10101471.0,44905548.0,0.5788,0.5824,0.5787,0.5826
2023-07-11 13:45,919,156,763,75626,5944,69682,44044478.0,3439100.0,40605377.0,912,153,759,75517,5864,69653,43981461.0,3392908.0,40588553.0,0.5786,0.5827,0.5786,0.5827
2023-07-11 13:50,266,106,160,15970,6857,9113,9268239.0,3967099.0,5301140.0,260,102,158,15710,6728,8982,9119164.0,3893971.0,5225193.0,0.5785,0.5817,0.5788,0.5817
2023-07-11 13:55,827,301,526,54544,36398,18146,31608228.0,21072135.0,10536092.0,811,289,522,54222,36272,17950,31420043.0,20996494.0,10423549.0,0.5789,0.5806,0.5789,0.5807
2023-07-11 14:00,73,39,34,3256,1999,1257,1874780.0,1161432.0,713348.0,78,40,38,3184,2053,1131,1838016.0,1179945.0,658071.0,0.581,0.5675,0.5747,0.5818
2023-07-11 14:05,3864,2816,1048,325209,237994,87215,235860101.0,185106378.0,50753722.0,3629,2609,1020,321087,235833,85254,233468465.0,183844501.0,49623963.0,0.7778,0.5819,0.7796,0.5821
2023-07-11 14:10,2266,1484,782,168895,127915,40980,97733428.0,73949233.0,23784195.0,2251,1478,773,168726,128019,40707,97653414.0,74008879.0,23644534.0,0.5781,0.5804,0.5781,0.5808
2023-07-11 14:15,1797,911,886,109652,68724,40928,75413114.0,51625847.0,23787266.0,1823,949,874,110227,69483,40744,75715780.0,52043385.0,23672395.0,0.7512,0.5812,0.749,0.581
2023-07-11 14:20,1681,1014,667,160416,135032,25384,92925011.0,78153315.0,14771695.0,1556,958,598,156999,133178,23821,90887385.0,77032054.0,13855330.0,0.5788,0.5819,0.5784,0.5816
2023-07-11 14:25,1109,926,183,115413,110836,4577,66773169.0,64113536.0,2659633.0,1099,919,180,115429,110803,4626,66786907.0,64095685.0,2691222.0,0.5785,0.5811,0.5785,0.5818
2023-07-11 14:30,1868,1284,584,133850,115985,17865,77508234.0,67124491.0,10383742.0,1660,1095,565,132473,115253,17220,76707717.0,66698317.0,10009399.0,0.5787,0.5812,0.5787,0.5813
2023-07-11 14:35,2310,1670,640,189063,147492,41571,109625316.0,85394014.0,24231301.0,2279,1665,614,188500,147106,41394,109307909.0,85169001.0,24138907.0,0.579,0.5829,0.579,0.5831
2023-07-11 14:40,3119,2082,1037,336024,196806,139218,195133245.0,113930948.0,81202297.0,3103,2077,1026,335819,197033,138786,195019656.0,114063795.0,80955861.0,0.5789,0.5833,0.5789,0.5833
2023-07-11 14:45,1659,1246,413,141966,118212,23754,82201820.0,68382332.0,13819487.0,1657,1245,412,141669,117993,23676,82029813.0,68255620.0,13774192.0,0.5785,0.5818,0.5785,0.5818
2023-07-11 14:50,1555,944,611,128602,90815,37787,74512814.0,52507917.0,22004896.0,1346,748,598,127776,90108,37668,74039651.0,52106093.0,21933557.0,0.5782,0.5823,0.5783,0.5823
2023-07-11 14:55,1889,1446,443,184843,176533,8310,106945853.0,102112213.0,4833639.0,1879,1443,436,184890,176438,8452,106974301.0,102056962.0,4917338.0,0.5784,0.5817,0.5784,0.5818
2023-07-11 15:00,3391,2423,968,325016,289559,35457,188279853.0,167607029.0,20672824.0,3221,2265,956,324519,289127,35392,187990125.0,167354745.0,20635379.0,0.5788,0.583,0.5788,0.5831
2023-07-11 15:05,3564,1961,1603,392214,235408,156806,239152334.0,148000457.0,91151876.0,3552,1955,1597,391128,235495,155633,238570632.0,148050238.0,90520393.0,0.6287,0.5813,0.6287,0.5816
2023-07-11 15:10,4637,2149,2488,519108,183307,335801,301322432.0,106024530.0,195297901.0,4630,2145,2485,519063,183298,335765,301293592.0,106018431.0,195275161.0,0.5784,0.5816,0.5784,0.5816
2023-07-11 15:15,4622,2043,2579,542784,192226,350558,315102491.0,111202344.0,203900146.0,4616,2038,2578,542786,192104,350682,315106078.0,111131536.0,203974542.0,0.5785,0.5816,0.5785,0.5817
2023-07-11 15:20,1249,404,845,151483,28680,122803,88012994.0,16586426.0,71426568.0,1243,399,844,151191,28486,122705,87843729.0,16474079.0,71369649.0,0.5783,0.5816,0.5783,0.5816
2023-07-11 15:25,1335,531,804,141417,28034,113383,94134471.0,28099399.0,66035072.0,1333,532,801,141742,28370,113372,94323476.0,28293239.0,66030236.0,1.0023,0.5824,0.9973,0.5824
2023-07-11 15:30,855,456,399,82606,32308,50298,47988002.0,18694050.0,29293952.0,850,451,399,82445,31909,50536,47895298.0,18462567.0,29432731.0,0.5786,0.5824,0.5786,0.5824
2023-07-11 15:35,2554,1443,1111,232441,100225,132216,134926257.0,57980558.0,76945699.0,2564,1441,1123,232014,100110,131904,134679036.0,57914161.0,76764874.0,0.5785,0.582,0.5785,0.582
2023-07-11 15:40,1586,818,768,166693,66248,100445,96815564.0,38341763.0,58473800.0,1578,814,764,166464,66332,100132,96684334.0,38390332.0,58294001.0,0.5788,0.5821,0.5788,0.5822
2023-07-11 15:45,5886,3168,2718,624968,215307,409661,363212682.0,124653913.0,238558768.0,5676,2971,2705,624506,214819,409687,362937980.0,124363485.0,238574494.0,0.579,0.5823,0.5789,0.5823
2023-07-11 15:50,4586,2466,2120,435653,175539,260114,253169192.0,101666466.0,151502725.0,4569,2460,2109,435509,175567,259942,253082347.0,101681015.0,151401331.0,0.5792,0.5824,0.5792,0.5824
2023-07-11 15:55,2840,1449,1391,259639,101234,158405,150913422.0,58642541.0,92270880.0,2843,1449,1394,259566,101072,158494,150874210.0,58548753.0,92325457.0,0.5793,0.5825,0.5793,0.5825
2023-07-11 16:00,2184,1016,1168,216243,59606,156637,125779168.0,34522994.0,91256174.0,2171,1012,1159,215798,59293,156505,125529832.0,34339816.0,91190016.0,0.5792,0.5826,0.5792,0.5827
2023-07-11 16:05,47,24,23,3918,1365,2553,2273561.0,789473.0,1484088.0,33,16,17,2364,1149,1215,1369331.0,663423.0,705907.0,0.5784,0.5813,0.5774,0.581
2023-07-11 16:10,200,141,59,14636,12765,1871,8463471.0,7388337.0,1075134.0,202,140,62,15473,13065,2408,8955701.0,7557091.0,1398610.0,0.5788,0.5746,0.5784,0.5808
2023-07-11 16:15,399,151,248,45858,9528,36330,26653151.0,5511128.0,21142022.0,388,146,242,46117,9139,36978,26803674.0,5286326.0,21517347.0,0.5784,0.5819,0.5784,0.5819
2023-07-11 16:20,3228,757,2471,442160,46757,395403,268669707.0,38894532.0,229775174.0,3215,746,2469,441334,46542,394792,268193307.0,38768318.0,229424989.0,0.8318,0.5811,0.833,0.5811
2023-07-11 16:25,5714,1207,4507,821907,80741,741166,477029480.0,46620178.0,430409301.0,5710,1204,4506,821307,80715,740592,476685711.0,46605319.0,430080391.0,0.5774,0.5807,0.5774,0.5807
2023-07-11 16:30,3341,1041,2300,398468,59285,339183,231312279.0,34250222.0,197062057.0,3126,847,2279,396871,58606,338265,230387798.0,33855741.0,196532057.0,0.5777,0.581,0.5777,0.581
2023-07-11 16:35,2495,734,1761,299156,62106,237050,173588175.0,35881693.0,137706481.0,2490,731,1759,299066,61965,237101,173539553.0,35804227.0,137735326.0,0.5777,0.5809,0.5778,0.5809
2023-07-11 16:40,69,24,45,3511,1012,2499,2034843.0,585331.0,1449512.0,76,33,43,3522,1111,2411,2031189.0,632752.0,1398437.0,0.5784,0.58,0.5695,0.58
2023-07-11 16:45,1861,253,1608,213950,17013,196937,124260023.0,9831643.0,114428380.0,1872,264,1608,216060,17323,198737,125566147.0,10001941.0,115564206.0,0.5779,0.581,0.5774,0.5815
2023-07-11 16:50,3375,607,2768,435127,44250,390877,252591410.0,25556513.0,227034896.0,3407,625,2782,435286,44426,390860,252674951.0,25648888.0,227026063.0,0.5775,0.5808,0.5773,0.5808
2023-07-11 16:55,3316,624,2692,479898,40196,439702,278741421.0,23219454.0,255521967.0,3310,618,2692,480391,40150,440241,279031334.0,23192808.0,255838525.0,0.5777,0.5811,0.5777,0.5811
2023-07-11 17:00,3305,756,2549,445161,62719,382442,258395054.0,36238330.0,222156723.0,3137,601,2536,443167,61558,381609,257291139.0,35565520.0,221725619.0,0.5778,0.5809,0.5778,0.581
2023-07-11 17:05,2988,1810,1178,303890,240698,63192,175843303.0,139122241.0,36721062.0,2775,1614,1161,302302,239621,62681,174925176.0,138493989.0,36431186.0,0.578,0.5811,0.578,0.5812
2023-07-11 17:10,2910,1324,1586,313978,210908,103070,181855852.0,121909486.0,59946366.0,2909,1324,1585,314126,210910,103216,181941511.0,121910597.0,60030913.0,0.578,0.5816,0.578,0.5816
2023-07-11 17:15,3103,1471,1632,363783,202861,160922,210804036.0,117268431.0,93535605.0,3096,1464,1632,364059,202825,161234,210957963.0,117230663.0,93727299.0,0.5781,0.5812,0.578,0.5813
2023-07-11 17:20,2168,761,1407,307514,93802,213712,178346733.0,54218250.0,124128483.0,2159,755,1404,307956,94362,213594,178595589.0,54535773.0,124059816.0,0.578,0.5808,0.5779,0.5808
2023-07-11 17:25,1308,541,767,107820,26853,80967,62567323.0,15517606.0,47049716.0,1298,535,763,107493,26691,80802,62382420.0,15423884.0,46958535.0,0.5779,0.5811,0.5779,0.5812
2023-07-11 17:30,1104,429,675,117090,36803,80287,67963742.0,21272883.0,46690858.0,1095,422,673,115903,35832,80071,67275383.0,20710791.0,46564592.0,0.578,0.5815,0.578,0.5815
2023-07-11 17:35,1330,807,523,57477,38681,18796,45212243.0,34281111.0,10931132.0,946,457,489,55411,37157,18254,44015405.0,33393546.0,10621859.0,0.8863,0.5816,0.8987,0.5819
2023-07-11 17:40,386,374,12,49259,48918,341,28521964.0,28323014.0,198949.0,378,370,8,49146,48857,289,28456559.0,28287683.0,168875.0,0.579,0.5834,0.579,0.5843
2023-07-11 17:45,547,401,146,50801,44483,6318,29436966.0,25756476.0,3680490.0,526,397,129,50791,44514,6277,29426973.0,25772158.0,3654814.0,0.579,0.5825,0.579,0.5823
2023-07-11 17:50,3735,2801,934,429359,401616,27743,272732184.0,256568188.0,16163995.0,3182,2276,906,427262,400020,27242,271497347.0,255632470.0,15864877.0,0.6388,0.5826,0.639,0.5824
2023-07-11 17:55,4282,2938,1344,528727,503668,25059,306405730.0,291797462.0,14608267.0,4269,2926,1343,528609,503604,25005,306338870.0,291759404.0,14579466.0,0.5793,0.583,0.5793,0.5831
2023-07-11 18:00,4611,2854,1757,508297,473808,34489,318485725.0,298408209.0,20077516.0,4597,2846,1751,508728,474325,34403,318729715.0,298693497.0,20036218.0,0.6298,0.5821,0.6297,0.5824
2023-07-11 18:05,3444,2634,810,405813,381238,24575,235467819.0,221147597.0,14320221.0,3426,2629,797,405493,381046,24447,235265506.0,221019325.0,14246180.0,0.5801,0.5827,0.58,0.5827
2023-07-11 18:10,4778,3372,1406,542392,490514,51878,338501601.0,308277591.0,30224009.0,4762,3370,1392,542211,490768,51443,338394933.0,308423205.0,29971727.0,0.6285,0.5826,0.6285,0.5826
2023-07-11 18:15,3305,1747,1558,299052,225225,73827,173439790.0,130470060.0,42969729.0,3310,1752,1558,299359,225552,73807,173616393.0,130657411.0,42958982.0,0.5793,0.582,0.5793,0.582
2023-07-11 18:20,4163,2596,1567,457883,380814,77069,265515091.0,220667208.0,44847883.0,4155,2590,1565,457687,380628,77059,265396954.0,220554603.0,44842350.0,0.5795,0.5819,0.5794,0.5819
2023-07-11 18:25,2948,1927,1021,324919,276954,47965,188387865.0,160473398.0,27914467.0,2947,1927,1020,323879,276655,47224,187782017.0,160303708.0,27478308.0,0.5794,0.582,0.5794,0.5819
2023-07-11 18:30,3260,2220,1040,358917,308072,50845,208066272.0,178485196.0,29581075.0,3255,2220,1035,359370,308404,50966,208364210.0,178677482.0,29686728.0,0.5794,0.5818,0.5794,0.5825
2023-07-11 18:35,3669,2626,1043,380488,330766,49722,220524763.0,191588587.0,28936176.0,3665,2624,1041,380963,331042,49921,220799834.0,191747045.0,29052789.0,0.5792,0.582,0.5792,0.582
2023-07-12 10:00,2952,1894,1058,247462,204578,42884,145787906.0,120662251.0,25125654.0,2710,1791,919,240888,200579,40309,139698507.0,116175626.0,23522881.0,0.5898,0.5859,0.5792,0.5836
2023-07-12 10:05,256,106,150,15865,5060,10805,9553368.0,2933327.0,6620040.0,256,131,125,11255,5607,5648,6542005.0,3239393.0,3302612.0,0.5797,0.6127,0.5777,0.5847
2023-07-12 10:10,563,267,296,25534,14023,11511,26753611.0,19842813.0,6910798.0,445,193,252,12608,7711,4897,9640727.0,6778969.0,2861758.0,1.415,0.6004,0.8791,0.5844
2023-07-12 10:15,5461,4127,1334,639207,602822,36385,455133220.0,433867247.0,21265972.0,5382,4097,1285,635282,600599,34683,452751723.0,432490184.0,20261538.0,0.7197,0.5845,0.7201,0.5842
2023-07-12 10:20,4556,3830,726,566238,550799,15439,329527538.0,320516687.0,9010851.0,4488,3817,671,565849,550751,15098,329339732.0,320499229.0,8840502.0,0.5819,0.5836,0.5819,0.5855
2023-07-12 10:25,3631,2701,930,408338,383892,24446,284988644.0,270728210.0,14260433.0,3587,2680,907,407292,383323,23969,284402082.0,270396583.0,14005499.0,0.7052,0.5833,0.7054,0.5843
2023-07-12 10:30,3958,2729,1229,399956,348797,51159,232436509.0,202562536.0,29873973.0,3834,2686,1148,399316,349380,49936,232070680.0,202904587.0,29166092.0,0.5807,0.5839,0.5808,0.5841
2023-07-12 10:35,1912,846,1066,114041,37093,76948,66460557.0,21543976.0,44916580.0,1846,789,1057,111731,34780,76951,65132951.0,20212918.0,44920033.0,0.5808,0.5837,0.5812,0.5837
2023-07-12 10:40,1435,767,668,66822,25400,41422,38961713.0,14783112.0,24178600.0,1415,761,654,66802,25536,41266,38948795.0,14860838.0,24087956.0,0.582,0.5837,0.582,0.5837
2023-07-12 10:45,2842,1865,977,272550,186909,85641,170711293.0,120696450.0,50014843.0,2820,1858,962,270897,185610,85287,169650341.0,119841861.0,49808479.0,0.6457,0.584,0.6457,0.584
2023-07-12 10:50,2157,1121,1036,169883,134874,35009,98808938.0,78349474.0,20459463.0,1946,1111,835,168742,134428,34314,98166757.0,78107862.0,20058895.0,0.5809,0.5844,0.581,0.5846
2023-07-12 10:55,3324,1671,1653,271275,187642,83633,181849485.0,132953073.0,48896411.0,3119,1654,1465,266923,186044,80879,179307409.0,132020727.0,47286682.0,0.7085,0.5847,0.7096,0.5847
2023-07-12 11:00,1462,926,536,113676,83134,30542,66279740.0,48408947.0,17870793.0,1433,916,517,112000,81957,30043,65298477.0,47722193.0,17576283.0,0.5823,0.5851,0.5823,0.585
2023-07-12 11:05,257,154,103,14432,11991,2441,8402624.0,6974529.0,1428095.0,236,146,90,16812,12249,4563,9793273.0,7122262.0,2671011.0,0.5816,0.585,0.5815,0.5854
2023-07-12 11:10,462,251,211,36954,24608,12346,21528031.0,14300107.0,7227923.0,446,243,203,36386,24521,11865,21195286.0,14249294.0,6945991.0,0.5811,0.5854,0.5811,0.5854
2023-07-12 11:15,1091,361,730,95985,43752,52233,56034418.0,25453037.0,30581380.0,1075,355,720,96854,44552,52302,56539364.0,25920537.0,30618826.0,0.5818,0.5855,0.5818,0.5854
2023-07-12 11:20,832,341,491,65418,31541,33877,38183900.0,18348405.0,19835494.0,809,332,477,64853,31332,33521,37849423.0,18225064.0,19624358.0,0.5817,0.5855,0.5817,0.5854
2023-07-12 11:25,3235,1527,1708,321913,199820,122093,187732702.0,116248445.0,71484256.0,3220,1518,1702,321839,199725,122114,187679472.0,116191477.0,71487994.0,0.5818,0.5855,0.5818,0.5854
2023-07-12 11:30,1240,619,621,97989,67924,30065,57105927.0,39506000.0,17599927.0,1221,612,609,97431,67964,29467,56775090.0,39529669.0,17245420.0,0.5816,0.5854,0.5816,0.5852
2023-07-12 11:35,799,558,241,81210,71489,9721,59430189.0,53704634.0,5725555.0,763,543,220,77979,69453,8526,57385322.0,52391321.0,4994001.0,0.7512,0.589,0.7543,0.5857
2023-07-12 11:40,2606,1624,982,240225,206476,33749,152094123.0,132354643.0,19739480.0,2400,1602,798,239005,206779,32226,151382726.0,132523248.0,18859478.0,0.641,0.5849,0.6409,0.5852
2023-07-12 11:45,1830,1152,678,141161,110876,30285,82301910.0,64572036.0,17729873.0,1808,1144,664,138111,109939,28172,80522614.0,64041516.0,16481097.0,0.5824,0.5854,0.5825,0.585
2023-07-12 11:50,829,429,400,47032,27926,19106,27436002.0,16262265.0,11173737.0,808,416,392,46924,27888,19036,27375524.0,16241844.0,11133679.0,0.5823,0.5848,0.5824,0.5849
2023-07-12 11:55,813,330,483,49079,18168,30911,28605580.0,10573879.0,18031701.0,798,323,475,48330,17697,30633,28208129.0,10301459.0,17906669.0,0.582,0.5833,0.5821,0.5846
2023-07-12 12:00,3450,1440,2010,260280,134745,125535,163560795.0,90227060.0,73333734.0,3267,1435,1832,260346,134594,125752,163594765.0,90133549.0,73461215.0,0.6696,0.5842,0.6697,0.5842
2023-07-12 12:05,1976,948,1028,163952,95365,68587,95516687.0,55429670.0,40087017.0,1969,946,1023,163921,95367,68554,95496686.0,55431776.0,40064909.0,0.5812,0.5845,0.5812,0.5844
2023-07-12 12:10,696,217,479,40556,11522,29034,23655577.0,6697636.0,16957941.0,686,213,473,40539,11915,28624,23648390.0,6923258.0,16725132.0,0.5813,0.5841,0.5811,0.5843
2023-07-12 12:15,1322,516,806,100432,33721,66711,58551681.0,19605014.0,38946666.0,1309,509,800,100058,33512,66546,58333393.0,19481442.0,38851950.0,0.5814,0.5838,0.5813,0.5838
2023-07-12 12:20,656,396,260,58561,44281,14280,34083214.0,25750638.0,8332575.0,654,397,257,58373,44214,14159,33972983.0,25711188.0,8261795.0,0.5815,0.5835,0.5815,0.5835
2023-07-12 12:25,299,142,157,19546,11793,7753,11370465.0,6855617.0,4514847.0,296,147,149,19692,12155,7537,11464758.0,7066767.0,4397991.0,0.5813,0.5823,0.5814,0.5835
2023-07-12 12:30,1873,694,1179,177692,74969,102723,103474896.0,43557734.0,59917161.0,1684,680,1004,175955,74206,101749,102469624.0,43117464.0,59352159.0,0.581,0.5833,0.5811,0.5833
2023-07-12 12:35,4903,1466,3437,586790,89507,497283,353909911.0,63871343.0,290038567.0,4668,1441,3227,585317,88795,496522,353056318.0,63458471.0,289597847.0,0.7136,0.5832,0.7147,0.5833
2023-07-12 12:40,4333,896,3437,644781,68214,576567,375707157.0,39581805.0,336125352.0,4170,889,3281,644230,67980,576250,375390663.0,39445071.0,335945592.0,0.5803,0.583,0.5802,0.583
2023-07-12 12:45,4140,1539,2601,596754,217650,379104,359329759.0,138309725.0,221020034.0,4077,1516,2561,591954,213901,378053,356488111.0,136084038.0,220404073.0,0.6355,0.583,0.6362,0.583
2023-07-12 12:50,4581,2335,2246,564083,343725,220358,339958116.0,211341274.0,128616842.0,4579,2332,2247,564245,343981,220264,340052672.0,211490249.0,128562422.0,0.6149,0.5837,0.6148,0.5837
2023-07-12 12:55,5402,2140,3262,572155,311124,261031,332845794.0,180474236.0,152371558.0,5200,2132,3068,570899,310514,260385,332126784.0,180124420.0,152002364.0,0.5801,0.5837,0.5801,0.5838
2023-07-12 13:00,4699,1440,3259,417761,169389,248372,243154922.0,98275439.0,144879483.0,4678,1428,3250,417147,169220,247927,242796636.0,98177357.0,144619279.0,0.5802,0.5833,0.5802,0.5833
2023-07-12 13:05,1639,588,1051,183908,76781,107127,106974004.0,44438956.0,62535048.0,1620,579,1041,183550,76533,107017,106767792.0,44296272.0,62471519.0,0.5788,0.5837,0.5788,0.5838
2023-07-12 13:10,962,151,811,93852,16103,77749,54728020.0,9331013.0,45397006.0,955,148,807,93619,16190,77429,54590039.0,9381021.0,45209018.0,0.5795,0.5839,0.5794,0.5839
2023-07-12 13:15,1181,310,871,79860,12011,67849,46545629.0,6947196.0,39598433.0,963,288,675,78907,11940,66967,45993073.0,6903571.0,39089502.0,0.5784,0.5836,0.5782,0.5837
2023-07-12 13:20,835,256,579,72792,15731,57061,42379472.0,9097800.0,33281672.0,822,246,576,72965,15561,57404,42476605.0,8992208.0,33484397.0,0.5783,0.5833,0.5779,0.5833
2023-07-12 13:25,1194,141,1053,128404,6921,121483,86802187.0,15889894.0,70912292.0,1016,128,888,126260,6368,119892,85566976.0,15569256.0,69997720.0,2.2959,0.5837,2.4449,0.5838
2023-07-12 13:30,51,20,31,5233,552,4681,3052561.0,319562.0,2732999.0,41,16,25,4618,582,4036,2692729.0,336914.0,2355814.0,0.5789,0.5838,0.5789,0.5837
2023-07-12 13:35,61,25,36,4883,632,4251,2850793.0,372263.0,2478530.0,51,17,34,4782,440,4342,2786200.0,254272.0,2531927.0,0.589,0.583,0.5779,0.5831
2023-07-12 13:40,212,38,174,17177,1776,15401,9991095.0,1028072.0,8963023.0,279,80,199,17997,2584,15413,10468569.0,1489717.0,8978852.0,0.5789,0.582,0.5765,0.5826
2023-07-12 13:45,208,99,109,13559,4269,9290,7891254.0,2470114.0,5421139.0,120,54,66,11134,3544,7590,6475304.0,2051438.0,4423866.0,0.5786,0.5835,0.5788,0.5829
2023-07-12 13:50,737,166,571,96079,9382,86697,55935560.0,5435046.0,50500513.0,717,155,562,96626,9166,87460,56256851.0,5312618.0,50944232.0,0.5793,0.5825,0.5796,0.5825
2023-07-12 13:55,1747,442,1305,247944,14911,233033,144189218.0,8625807.0,135563410.0,1689,409,1280,245958,13289,232669,143046612.0,7686908.0,135359703.0,0.5785,0.5817,0.5784,0.5818
2023-07-12 14:00,1176,931,245,99328,58654,40674,57681808.0,33993241.0,23688567.0,1160,918,242,98976,58590,40386,57476883.0,33955776.0,23521106.0,0.5796,0.5824,0.5795,0.5824
2023-07-12 14:05,3017,685,2332,381478,24589,356889,221983681.0,14259066.0,207724615.0,2977,668,2309,380589,23997,356592,221487257.0,13894248.0,207593009.0,0.5799,0.582,0.579,0.5822
2023-07-12 14:10,2735,677,2058,341387,35314,306073,198712419.0,20471783.0,178240636.0,2730,665,2065,341156,35152,306004,198578040.0,20377324.0,178200716.0,0.5797,0.5823,0.5797,0.5823
2023-07-12 14:15,2791,546,2245,329672,31056,298616,191856389.0,18002388.0,173854000.0,2770,535,2235,329529,30829,298700,191779507.0,17869636.0,173909870.0,0.5797,0.5822,0.5796,0.5822
2023-07-12 14:20,1791,309,1482,225798,18296,207502,131418515.0,10601314.0,120817201.0,1781,298,1483,225985,18396,207589,131527123.0,10659704.0,120867419.0,0.5794,0.5822,0.5795,0.5822
2023-07-12 14:25,2686,758,1928,301128,16613,284515,175175439.0,9622152.0,165553287.0,2467,734,1733,299781,16003,283778,174389556.0,9263941.0,165125614.0,0.5792,0.5819,0.5789,0.5819
2023-07-12 14:30,5001,1480,3521,641381,39021,602360,373635134.0,22632097.0,351003037.0,5038,1482,3556,641989,38299,603690,373976954.0,22183265.0,351793689.0,0.58,0.5827,0.5792,0.5827
2023-07-12 14:35,5336,1145,4191,700030,27257,672773,407838826.0,15811891.0,392026935.0,5298,1136,4162,695460,24036,671424,405230730.0,13932204.0,391298525.0,0.5801,0.5827,0.5796,0.5828
2023-07-12 14:40,4116,619,3497,632670,10255,622415,368654664.0,5947764.0,362706900.0,4107,606,3501,632153,10093,622060,368357464.0,5853404.0,362504060.0,0.58,0.5827,0.5799,0.5827
2023-07-12 14:45,3927,815,3112,572434,21605,550829,333635207.0,12542665.0,321092542.0,3882,789,3093,571374,20476,550898,333008694.0,11881765.0,321126929.0,0.5805,0.5829,0.5803,0.5829
2023-07-12 14:50,4365,1258,3107,590934,52656,538278,356441056.0,42450080.0,313990976.0,4335,1241,3094,590307,52376,537931,356075919.0,42286787.0,313789131.0,0.8062,0.5833,0.8074,0.5833
2023-07-12 14:55,4697,678,4019,666707,17922,648785,412325444.0,34162242.0,378163202.0,4671,664,4007,665230,19857,645373,411470621.0,35272531.0,376198089.0,1.9062,0.5829,1.7763,0.5829
2023-07-12 15:00,964,634,330,57509,39731,17778,33433442.0,23060456.0,10372986.0,952,628,324,58305,40742,17563,33887612.0,23642399.0,10245213.0,0.5804,0.5835,0.5803,0.5833
2023-07-12 15:05,1268,981,287,102613,94907,7706,59589116.0,55094368.0,4494747.0,1264,977,287,102601,94905,7696,59581591.0,55093056.0,4488534.0,0.5805,0.5833,0.5805,0.5832
2023-07-12 15:10,2061,1028,1033,244171,98357,145814,142165459.0,57102573.0,85062886.0,2056,1024,1032,244312,98201,146111,142251005.0,57011597.0,85239408.0,0.5806,0.5834,0.5806,0.5834
2023-07-12 15:15,4320,1182,3138,644351,80314,564037,375524410.0,46632942.0,328891467.0,4294,1166,3128,644071,80097,563974,375367687.0,46507388.0,328860298.0,0.5806,0.5831,0.5806,0.5831
2023-07-12 15:20,3155,537,2618,476543,22953,453590,289779974.0,25201579.0,264578395.0,2950,524,2426,476105,23178,452927,289526979.0,25331570.0,264195409.0,1.098,0.5833,1.0929,0.5833
2023-07-12 15:25,3590,671,2919,493482,10917,482565,287470188.0,6332978.0,281137209.0,3556,648,2908,492753,10686,482067,287073111.0,6197916.0,280875195.0,0.5801,0.5826,0.58,0.5826
2023-07-12 15:30,1887,365,1522,210568,5930,204638,122560727.0,3437678.0,119123049.0,1864,347,1517,210237,5763,204474,122371055.0,3340843.0,119030212.0,0.5797,0.5821,0.5797,0.5821
2023-07-12 15:35,364,95,269,26518,1534,24984,15411742.0,889572.0,14522170.0,349,88,261,25965,1239,24726,15109884.0,718259.0,14391625.0,0.5799,0.5813,0.5797,0.582
2023-07-12 15:40,69,47,22,3638,2947,691,2111652.0,1707310.0,404342.0,55,38,17,3278,2751,527,1903796.0,1593726.0,310069.0,0.5793,0.5852,0.5793,0.5884
2023-07-12 15:45,190,112,78,4584,1925,2659,2665149.0,1116904.0,1548244.0,179,102,77,4465,1754,2711,2595444.0,1016484.0,1578959.0,0.5802,0.5823,0.5795,0.5824
2023-07-12 15:50,225,115,110,10732,3877,6855,6239962.0,2255957.0,3984005.0,203,103,100,10513,3879,6634,6105567.0,2248428.0,3857139.0,0.5819,0.5812,0.5796,0.5814
2023-07-12 15:55,482,215,267,21522,8860,12662,12524926.0,5151195.0,7373730.0,457,200,257,19629,7490,12139,11413760.0,4344922.0,7068838.0,0.5814,0.5824,0.5801,0.5823
2023-07-12 16:00,306,229,77,15483,11441,4042,8998731.0,6641760.0,2356970.0,282,212,70,13799,9887,3912,8020385.0,5739177.0,2281208.0,0.5805,0.5831,0.5805,0.5831
2023-07-12 16:05,456,140,316,42014,8929,33085,36361813.0,17062971.0,19298842.0,445,135,310,40802,7629,33173,35665632.0,16307762.0,19357870.0,1.911,0.5833,2.1376,0.5835
2023-07-12 16:10,818,336,482,66391,17660,48731,38669750.0,10257262.0,28412488.0,794,319,475,66126,17666,48460,38523773.0,10260054.0,28263718.0,0.5808,0.583,0.5808,0.5832
2023-07-12 16:15,1979,543,1436,187241,35098,152143,109141785.0,20374721.0,88767064.0,1965,534,1431,184570,32421,152149,107605367.0,18835299.0,88770068.0,0.5805,0.5834,0.581,0.5834
2023-07-12 16:20,296,123,173,19971,3566,16405,11647878.0,2072795.0,9575083.0,280,109,171,19729,3471,16258,11498487.0,2017043.0,9481444.0,0.5813,0.5837,0.5811,0.5832
2023-07-12 16:25,759,239,520,84661,8579,76082,49360205.0,4986848.0,44373357.0,729,227,502,83606,8210,75396,48768788.0,4771468.0,43997320.0,0.5813,0.5832,0.5812,0.5835
2023-07-12 16:30,4267,398,3869,731788,9168,722620,426540970.0,5321932.0,421219037.0,4066,371,3695,730775,8959,721816,425953133.0,5200013.0,420753119.0,0.5805,0.5829,0.5804,0.5829
2023-07-12 16:35,4330,707,3623,725175,6784,718391,422740826.0,3938548.0,418802278.0,4303,691,3612,724722,6544,718178,422475333.0,3798064.0,418677268.0,0.5806,0.583,0.5804,0.583
2023-07-12 16:40,5297,929,4368,869945,7999,861946,518788101.0,16514203.0,502273897.0,5290,920,4370,869518,7927,861591,518576458.0,16472503.0,502103954.0,2.0645,0.5827,2.078,0.5828
2023-07-12 16:45,1100,256,844,168432,2725,165707,98146184.0,1580641.0,96565542.0,1081,246,835,168238,2603,165635,98033305.0,1509379.0,96523926.0,0.5801,0.5827,0.5799,0.5828
2023-07-12 16:50,1086,255,831,153905,2876,151029,89701233.0,1668493.0,88032740.0,1079,252,827,153772,2533,151239,89624756.0,1469339.0,88155416.0,0.5801,0.5829,0.5801,0.5829
2023-07-12 16:55,1449,319,1130,203405,4240,199165,118591957.0,2460188.0,116131768.0,1441,312,1129,203335,4167,199168,118550210.0,2418014.0,116132196.0,0.5802,0.5831,0.5803,0.5831
2023-07-12 17:00,282,122,160,32699,3504,29195,19082548.0,2032321.0,17050227.0,271,118,153,32217,3264,28953,18807645.0,1894030.0,16913615.0,0.58,0.584,0.5803,0.5842
2023-07-12 17:05,504,60,444,42928,1966,40962,25003148.0,1140533.0,23862615.0,506,62,444,43092,2142,40950,25098519.0,1242636.0,23855883.0,0.5801,0.5826,0.5801,0.5826
2023-07-12 17:10,961,127,834,123467,2711,120756,71884222.0,1572340.0,70311882.0,956,123,833,122811,2636,120175,71527888.0,1528703.0,69999184.0,0.58,0.5823,0.5799,0.5825
2023-07-12 17:15,1815,81,1734,191945,2124,189821,111722373.0,1232145.0,110490228.0,1255,66,1189,188855,1258,187597,109958260.0,728498.0,109229761.0,0.5801,0.5821,0.5791,0.5823
2023-07-12 17:20,439,96,343,45011,5663,39348,26236618.0,3368803.0,22867814.0,400,80,320,41223,3230,37993,23994203.0,1873856.0,22120347.0,0.5949,0.5812,0.5801,0.5822
2023-07-12 17:25,33,18,15,1466,580,886,854178.0,337080.0,517098.0,24,11,13,1456,464,992,850161.0,269151.0,581010.0,0.5812,0.5836,0.5801,0.5857
2023-07-12 17:30,337,152,185,35012,8197,26815,20331842.0,4757599.0,15574243.0,316,137,179,33113,6962,26151,19269009.0,4040741.0,15228268.0,0.5804,0.5808,0.5804,0.5823
2023-07-12 17:35,105,35,70,9950,934,9016,5789823.0,537989.0,5251834.0,88,30,58,9019,796,8223,5249180.0,461652.0,4787528.0,0.576,0.5825,0.58,0.5822
2023-07-12 17:40,800,324,476,73851,5059,68792,42987885.0,2939469.0,40048416.0,784,312,472,74046,4913,69133,43097658.0,2850373.0,40247285.0,0.581,0.5822,0.5802,0.5822
2023-07-12 17:45,554,204,350,61060,5181,55879,35534510.0,3007037.0,32527473.0,533,192,341,60826,5100,55726,35397108.0,2958641.0,32438466.0,0.5804,0.5821,0.5801,0.5821
2023-07-12 17:50,82,31,51,8893,811,8082,5174656.0,470441.0,4704215.0,77,29,48,8994,654,8340,5237865.0,379459.0,4858405.0,0.5801,0.5821,0.5802,0.5825
2023-07-12 17:55,136,50,86,8979,1316,7663,5233426.0,773759.0,4459667.0,123,44,79,8619,1138,7481,5017419.0,660081.0,4357337.0,0.588,0.582,0.58,0.5825
2023-07-12 18:00,1309,689,620,144487,71200,73287,96174695.0,53476350.0,42698344.0,1244,670,574,140028,67921,72107,93344836.0,51332102.0,42012734.0,0.7511,0.5826,0.7558,0.5826
2023-07-12 18:05,2442,721,1721,206590,37895,168695,132351465.0,33876786.0,98474679.0,2401,692,1709,205145,37607,167538,131507551.0,33702028.0,97805523.0,0.894,0.5837,0.8962,0.5838
2023-07-12 18:10,2347,363,1984,323812,10145,313667,188919958.0,5892231.0,183027727.0,2318,341,1977,322318,8662,313656,188048167.0,5030136.0,183018031.0,0.5808,0.5835,0.5807,0.5835
2023-07-12 18:15,3247,745,2502,407228,27984,379244,249378371.0,28132468.0,221245903.0,3229,734,2495,408244,28791,379453,249969380.0,28601227.0,221368153.0,1.0053,0.5834,0.9934,0.5834
2023-07-12 18:20,2894,551,2343,383456,14404,369052,223655320.0,8370250.0,215285069.0,2872,545,2327,382973,14425,368548,223370904.0,8380255.0,214990648.0,0.5811,0.5833,0.581,0.5833
2023-07-12 18:25,1194,312,882,126967,15360,111607,74075929.0,8942635.0,65133294.0,1173,305,868,125783,14940,110843,73366610.0,8679134.0,64687476.0,0.5822,0.5836,0.5809,0.5836
2023-07-12 18:30,3601,1681,1920,442946,208688,234258,257891605.0,121207270.0,136684334.0,3587,1674,1913,442166,208134,234032,257440999.0,120884750.0,136556248.0,0.5808,0.5835,0.5808,0.5835
2023-07-12 18:35,3003,1646,1357,389872,214826,175046,226897629.0,124768260.0,102129368.0,2999,1648,1351,390268,215288,174980,227129206.0,125035997.0,102093209.0,0.5808,0.5834,0.5808,0.5835
2023-07-13 10:00,2939,1842,1097,329109,264646,64463,193996324.0,155724844.0,38271480.0,2699,1736,963,309903,259265,50638,180124786.0,150531479.0,29593307.0,0.5884,0.5937,0.5806,0.5844
2023-07-13 10:05,1925,1275,650,162355,143180,19175,94415484.0,83206206.0,11209278.0,1873,1258,615,161854,140601,21253,94191215.0,81733088.0,12458127.0,0.5811,0.5846,0.5813,0.5862
2023-07-13 10:10,2719,1803,916,211476,151488,59988,170512240.0,135529406.0,34982834.0,2625,1756,869,203779,146924,56855,156477683.0,123286696.0,33190987.0,0.8947,0.5832,0.8391,0.5838
2023-07-13 10:15,2867,2003,864,188669,134975,53694,121768737.0,90409903.0,31358833.0,2715,1921,794,185818,134097,51721,120062363.0,89848104.0,30214259.0,0.6698,0.584,0.67,0.5842
2023-07-13 10:20,536,302,234,24771,12385,12386,26305475.0,19070100.0,7235375.0,481,289,192,23650,12030,11620,25657081.0,18867192.0,6789889.0,1.5398,0.5842,1.5683,0.5843
2023-07-13 10:25,1870,956,914,222741,77701,145040,129891467.0,45143322.0,84748144.0,1836,942,894,222202,77186,145016,129561010.0,44845320.0,84715689.0,0.581,0.5843,0.581,0.5842
2023-07-13 10:30,1842,1018,824,141900,59577,82323,82755506.0,34622554.0,48132952.0,1807,999,808,141236,59201,82035,82401292.0,34407310.0,47993982.0,0.5811,0.5847,0.5812,0.585
2023-07-13 10:35,420,226,194,25275,12212,13063,14695439.0,7082338.0,7613101.0,395,217,178,23932,11893,12039,13943051.0,6902624.0,7040426.0,0.5799,0.5828,0.5804,0.5848
2023-07-13 10:40,1399,569,830,90972,24871,66101,64947776.0,26320702.0,38627073.0,1368,554,814,89484,23898,65586,64067762.0,25736543.0,38331219.0,1.0583,0.5844,1.0769,0.5844
2023-07-13 10:45,1870,679,1191,239544,47031,192513,151083441.0,39121600.0,111961841.0,1831,665,1166,237913,47416,190497,150170026.0,39346590.0,110823436.0,0.8318,0.5816,0.8298,0.5818
2023-07-13 10:50,2969,770,2199,396510,40955,355555,230431516.0,23712207.0,206719308.0,2938,748,2190,395445,40691,354754,229863566.0,23558846.0,206304720.0,0.579,0.5814,0.579,0.5815
2023-07-13 10:55,1372,331,1041,211625,15181,196444,122969447.0,8801719.0,114167727.0,1340,317,1023,212311,15101,197210,123366072.0,8740373.0,114625698.0,0.5798,0.5812,0.5788,0.5812
2023-07-13 11:00,1174,107,1067,175171,3933,171238,101816718.0,2264054.0,99552663.0,1140,83,1057,173189,3072,170117,100684413.0,1775706.0,98908707.0,0.5757,0.5814,0.578,0.5814
2023-07-13 11:05,3338,511,2827,520029,11952,508077,302175935.0,6910127.0,295265808.0,3320,492,2828,519427,11342,508085,301830710.0,6559693.0,295271017.0,0.5782,0.5811,0.5784,0.5811
2023-07-13 11:10,1283,160,1123,187306,3805,183501,108883223.0,2196693.0,106686530.0,1269,154,1115,183760,3600,180160,106822362.0,2082033.0,104740328.0,0.5773,0.5814,0.5783,0.5814
2023-07-13 11:15,1371,347,1024,165507,6837,158670,96093633.0,3954662.0,92138971.0,1356,341,1015,166128,6807,159321,96454725.0,3932224.0,92522500.0,0.5784,0.5807,0.5777,0.5807
2023-07-13 11:20,2758,494,2264,397699,16341,381358,242668396.0,21304046.0,221364350.0,2724,470,2254,395568,15227,380341,241508702.0,20678345.0,220830357.0,1.3037,0.5805,1.358,0.5806
2023-07-13 11:25,2323,480,1843,332117,16109,316008,204722555.0,21193168.0,183529387.0,2294,461,1833,331064,15441,315623,204112552.0,20803900.0,183308651.0,1.3156,0.5808,1.3473,0.5808
2023-07-13 11:30,2579,182,2397,343491,5859,337632,199538956.0,3383377.0,196155579.0,2559,170,2389,343451,5819,337632,199540174.0,3362821.0,196177352.0,0.5775,0.581,0.5779,0.581
2023-07-13 11:35,3486,527,2959,495265,14686,480579,287810335.0,8501112.0,279309223.0,3464,523,2941,492894,13893,479001,286432508.0,8038808.0,278393699.0,0.5789,0.5812,0.5786,0.5812
2023-07-13 11:40,3520,545,2975,457911,9522,448389,266036733.0,5537261.0,260499471.0,3476,533,2943,457313,8825,448488,265654693.0,5102058.0,260552634.0,0.5815,0.581,0.5781,0.581
2023-07-13 11:45,2916,609,2307,270520,11590,258930,157202107.0,6711849.0,150490258.0,2906,600,2306,270232,11319,258913,157037715.0,6556949.0,150480766.0,0.5791,0.5812,0.5793,0.5812
2023-07-13 11:50,2774,371,2403,267226,12259,254967,155281463.0,7091824.0,148189639.0,2753,362,2391,267175,12291,254884,155251171.0,7108621.0,148142550.0,0.5785,0.5812,0.5784,0.5812
2023-07-13 11:55,2260,394,1866,198797,10869,187928,115503751.0,6294462.0,109209289.0,2241,385,1856,198602,10692,187910,115384828.0,6187613.0,109197214.0,0.5791,0.5811,0.5787,0.5811
2023-07-13 12:00,2627,571,2056,215737,9991,205746,125430268.0,5799562.0,119630706.0,2607,567,2040,215309,9823,205486,125174992.0,5693711.0,119481280.0,0.5805,0.5814,0.5796,0.5815
2023-07-13 12:05,2186,340,1846,193434,5973,187461,112395260.0,3460273.0,108934987.0,2175,335,1840,193462,6075,187387,112412241.0,3519126.0,108893115.0,0.5793,0.5811,0.5793,0.5811
2023-07-13 12:10,3454,411,3043,353097,13394,339703,205281180.0,7763972.0,197517207.0,3448,401,3047,352734,13306,339428,205065247.0,7709600.0,197355646.0,0.5797,0.5814,0.5794,0.5814
2023-07-13 12:15,3426,348,3078,333842,4385,329457,194131911.0,2527340.0,191604571.0,3411,338,3073,333059,4120,328939,193662545.0,2386530.0,191276015.0,0.5764,0.5816,0.5793,0.5815
2023-07-13 12:20,3483,704,2779,410178,19808,390370,238419044.0,11474268.0,226944776.0,3460,695,2765,409513,19521,389992,238046361.0,11310088.0,226736272.0,0.5793,0.5814,0.5794,0.5814
2023-07-13 12:25,2693,177,2516,357307,3061,354246,207771541.0,1772944.0,205998597.0,2684,168,2516,357099,3008,354091,207644430.0,1742426.0,205902004.0,0.5792,0.5815,0.5793,0.5815
2023-07-13 12:30,3736,376,3360,435878,3229,432649,253377429.0,1870122.0,251507306.0,3731,373,3358,436025,3308,432717,253470366.0,1916062.0,251554303.0,0.5792,0.5813,0.5792,0.5813
2023-07-13 12:35,2873,532,2341,371845,8661,363184,216053068.0,5009524.0,211043544.0,2853,520,2333,369558,8283,361275,214728887.0,4790981.0,209937905.0,0.5784,0.5811,0.5784,0.5811
2023-07-13 12:40,5266,726,4540,723133,19696,703437,431808978.0,23227583.0,408581395.0,5256,713,4543,721820,19215,702605,431059487.0,22948108.0,408111378.0,1.1793,0.5808,1.1943,0.5809
2023-07-13 12:45,3274,498,2776,434081,16951,417130,251950542.0,9749956.0,242200586.0,3264,492,2772,433972,16908,417064,251885704.0,9725199.0,242160504.0,0.5752,0.5806,0.5752,0.5806
2023-07-13 12:50,4599,732,3867,589524,30603,558921,342200139.0,17612172.0,324587966.0,4577,717,3860,589253,30414,558839,342053823.0,17499504.0,324554318.0,0.5755,0.5807,0.5754,0.5808
2023-07-13 12:55,4823,787,4036,621701,41620,580081,360781997.0,23932757.0,336849240.0,4809,780,4029,620971,41528,579443,360368509.0,23879365.0,336489144.0,0.575,0.5807,0.575,0.5807
2023-07-13 13:00,3086,534,2552,345491,15712,329779,212475108.0,20918329.0,191556778.0,3061,521,2540,343583,14523,329060,211359616.0,20226555.0,191133061.0,1.3314,0.5809,1.3927,0.5808
2023-07-13 13:05,109,43,66,10518,1237,9281,6147044.0,713542.0,5433501.0,101,38,63,7790,1024,6766,4522474.0,590356.0,3932118.0,0.5768,0.5854,0.5765,0.5812
2023-07-13 13:10,212,60,152,21801,2611,19190,12672701.0,1508182.0,11164519.0,205,57,148,21797,2679,19118,12670737.0,1547682.0,11123055.0,0.5776,0.5818,0.5777,0.5818
2023-07-13 13:15,157,57,100,15186,2992,12194,20617380.0,13590995.0,7026385.0,144,50,94,13086,2742,10344,19464868.0,13449086.0,6015781.0,4.5424,0.5762,4.9048,0.5816
2023-07-13 13:20,165,70,95,15650,1988,13662,9084912.0,1152853.0,7932058.0,99,32,67,13353,1378,11975,7752749.0,790000.0,6962749.0,0.5799,0.5806,0.5733,0.5814
2023-07-13 13:25,956,407,549,73650,16137,57513,77866868.0,44889694.0,32977174.0,826,321,505,68469,12772,55697,75031769.0,42948973.0,32082796.0,2.7818,0.5734,3.3627,0.576
2023-07-13 13:30,516,389,127,25251,14481,10770,14517260.0,8324092.0,6193167.0,481,368,113,25086,15641,9445,14428637.0,8974213.0,5454423.0,0.5748,0.575,0.5738,0.5775
2023-07-13 13:35,2194,774,1420,268270,19268,249002,178313692.0,34799705.0,143513987.0,2118,718,1400,266315,18370,247945,177247581.0,34281328.0,142966252.0,1.8061,0.5764,1.8662,0.5766
2023-07-13 13:40,2035,723,1312,216927,19195,197732,125073883.0,11007697.0,114066185.0,2012,704,1308,214547,16616,197931,123711217.0,9525355.0,114185861.0,0.5735,0.5769,0.5733,0.5769
2023-07-13 13:45,2018,809,1209,271059,24782,246277,156660585.0,14238233.0,142422352.0,2001,795,1206,271616,24532,247084,156982512.0,14094059.0,142888453.0,0.5745,0.5783,0.5745,0.5783
2023-07-13 13:50,2247,792,1455,271680,20255,251425,168938133.0,23519756.0,145418377.0,2232,778,1454,271348,20092,251256,168742284.0,23425930.0,145316354.0,1.1612,0.5784,1.1659,0.5784
2023-07-13 13:55,2426,819,1607,340759,26904,313855,197073183.0,15463529.0,181609654.0,2412,810,1602,340467,26768,313699,196906233.0,15382233.0,181524000.0,0.5748,0.5786,0.5747,0.5787
2023-07-13 14:00,509,193,316,78539,7762,70777,45437072.0,4466597.0,40970475.0,491,180,311,78215,7313,70902,45245885.0,4202666.0,41043218.0,0.5754,0.5789,0.5747,0.5789
2023-07-13 14:05,496,216,280,44820,6968,37852,25862230.0,4007220.0,21855010.0,485,206,279,44467,6639,37828,25658741.0,3817994.0,21840747.0,0.5751,0.5774,0.5751,0.5774
2023-07-13 14:10,1389,481,908,168282,17588,150694,97130433.0,10113901.0,87016532.0,1374,479,895,168486,17649,150837,97249037.0,10149017.0,87100020.0,0.575,0.5774,0.575,0.5774
2023-07-13 14:15,125,70,55,4037,1314,2723,2327960.0,755582.0,1572377.0,115,62,53,3857,1235,2622,2224324.0,710222.0,1514102.0,0.575,0.5774,0.5751,0.5775
2023-07-13 14:20,602,241,361,51703,8396,43307,29838478.0,4831543.0,25006935.0,589,236,353,51059,8011,43048,29467912.0,4609662.0,24858250.0,0.5755,0.5774,0.5754,0.5775
2023-07-13 14:25,34,22,12,1138,719,419,656495.0,413757.0,242737.0,26,15,11,1021,613,408,588763.0,352334.0,236429.0,0.5755,0.5793,0.5748,0.5795
2023-07-13 14:30,160,52,108,13424,1277,12147,7749641.0,727797.0,7021844.0,138,41,97,11600,941,10659,6701530.0,539541.0,6161988.0,0.5699,0.5781,0.5734,0.5781
2023-07-13 14:35,2433,656,1777,219495,16102,203393,138481177.0,21121336.0,117359841.0,2419,647,1772,220053,15991,204062,138812934.0,21057636.0,117755297.0,1.3117,0.577,1.3168,0.5771
2023-07-13 14:40,3345,595,2750,338598,18100,320498,219091829.0,34146477.0,184945351.0,3326,586,2740,338206,17659,320547,218870124.0,33889085.0,184981038.0,1.8865,0.5771,1.9191,0.5771
2023-07-13 14:45,2065,484,1581,185990,13442,172548,107278366.0,7719491.0,99558874.0,2047,472,1575,185466,13169,172297,106974542.0,7561483.0,99413058.0,0.5743,0.577,0.5742,0.577
2023-07-13 14:50,1842,526,1316,122088,13962,108126,70332315.0,8017778.0,62314537.0,1828,513,1315,122196,13992,108204,70394376.0,8034375.0,62360001.0,0.5743,0.5763,0.5742,0.5763
2023-07-13 14:55,1542,578,964,107277,15915,91362,73799301.0,21022396.0,52776905.0,1517,562,955,107060,16028,91032,73669984.0,21086171.0,52583812.0,1.3209,0.5777,1.3156,0.5776
2023-07-13 15:00,1374,451,923,153827,13956,139871,88845490.0,8022293.0,80823197.0,1359,438,921,153125,13303,139822,88444122.0,7646964.0,80797157.0,0.5748,0.5778,0.5748,0.5779
2023-07-13 15:05,1045,354,691,113870,10085,103785,65827691.0,5857483.0,59970208.0,1029,340,689,112716,9398,103318,65104225.0,5402165.0,59702059.0,0.5808,0.5778,0.5748,0.5778
2023-07-13 15:10,1209,155,1054,157568,2901,154667,90883377.0,1676546.0,89206831.0,1190,144,1046,156136,2599,153537,90066022.0,1490357.0,88575664.0,0.5779,0.5768,0.5734,0.5769
2023-07-13 15:15,1300,231,1069,158702,3488,155214,91493405.0,2003634.0,89489770.0,1285,220,1065,158213,3308,154905,91209049.0,1899854.0,89309194.0,0.5744,0.5766,0.5743,0.5765
2023-07-13 15:20,1109,139,970,167198,3478,163720,108411831.0,13875157.0,94536674.0,1096,126,970,167394,3401,163993,108528283.0,13830653.0,94697630.0,3.9894,0.5774,4.0666,0.5774
2023-07-13 15:25,671,154,517,65621,3683,61938,37815472.0,2113086.0,35702386.0,643,135,508,62647,1808,60839,36105451.0,1037765.0,35067686.0,0.5737,0.5764,0.574,0.5764
2023-07-13 15:30,176,59,117,14832,1777,13055,8564746.0,1024680.0,7540065.0,167,53,114,13735,938,12797,7930090.0,539162.0,7390928.0,0.5766,0.5776,0.5748,0.5776
2023-07-13 15:35,74,34,40,4757,2155,2602,14630490.0,13128601.0,1501889.0,60,21,39,3296,691,2605,13775275.0,12271947.0,1503327.0,6.0922,0.5772,17.7597,0.5771
2023-07-13 15:40,106,17,89,12354,388,11966,7144662.0,226459.0,6918203.0,97,8,89,12219,289,11930,7063702.0,166415.0,6897287.0,0.5837,0.5782,0.5758,0.5781
2023-07-13 15:45,98,22,76,14121,481,13640,8175916.0,276859.0,7899057.0,89,13,76,15126,429,14697,8756556.0,246889.0,8509667.0,0.5756,0.5791,0.5755,0.579
2023-07-13 15:50,57,10,47,8041,475,7566,4649844.0,273390.0,4376454.0,53,7,46,7926,138,7788,4586168.0,79367.0,4506801.0,0.5756,0.5784,0.5751,0.5787
2023-07-13 15:55,641,134,507,85112,2898,82214,49278710.0,1669479.0,47609231.0,631,127,504,85488,3545,81943,49492891.0,2041796.0,47451095.0,0.5761,0.5791,0.576,0.5791
2023-07-13 16:00,56,10,46,9916,1232,8684,5726655.0,708864.0,5017791.0,50,7,43,8442,278,8164,4884565.0,159230.0,4725335.0,0.5754,0.5778,0.5728,0.5788
2023-07-13 16:05,102,25,77,11477,377,11100,6644977.0,219045.0,6425931.0,100,18,82,12500,520,11980,7230392.0,291160.0,6939232.0,0.581,0.5789,0.5599,0.5792
2023-07-13 16:10,528,82,446,74165,1591,72574,42883924.0,917173.0,41966751.0,519,77,442,73815,1560,72255,42715896.0,898129.0,41817766.0,0.5765,0.5783,0.5757,0.5788
2023-07-13 16:15,215,19,196,32823,522,32301,19001353.0,301135.0,18700218.0,210,16,194,32221,505,31716,18650087.0,290064.0,18360022.0,0.5769,0.5789,0.5744,0.5789
2023-07-13 16:20,321,48,273,22780,1204,21576,13186338.0,693848.0,12492489.0,301,30,271,22677,1177,21500,13125379.0,676698.0,12448681.0,0.5763,0.579,0.5749,0.579
2023-07-13 16:25,30,24,6,768,445,323,443956.0,256843.0,187113.0,15,10,5,620,345,275,358002.0,198539.0,159462.0,0.5772,0.5793,0.5755,0.5799
2023-07-13 16:30,40,29,11,1840,1056,784,1062721.0,609747.0,452974.0,32,22,10,1770,1031,739,1019979.0,593387.0,426592.0,0.5774,0.5778,0.5755,0.5773
2023-07-13 16:35,13,7,6,831,134,697,480178.0,77084.0,403094.0,5,1,4,867,10,857,501640.0,5756.0,495884.0,0.5753,0.5783,0.5756,0.5786
2023-07-13 16:40,58,30,28,2302,807,1495,1328124.0,465033.0,863090.0,49,22,27,2074,547,1527,1196040.0,314453.0,881586.0,0.5763,0.5773,0.5749,0.5773
2023-07-13 16:45,309,143,166,18568,3803,14765,10736630.0,2204004.0,8532625.0,296,133,163,17928,3323,14605,10354483.0,1914611.0,8439872.0,0.5795,0.5779,0.5762,0.5779
2023-07-13 16:50,94,21,73,13275,1511,11764,7672615.0,856829.0,6815785.0,89,16,73,12265,502,11763,7104511.0,289304.0,6815207.0,0.5671,0.5794,0.5763,0.5794
2023-07-13 16:55,793,109,684,110183,3966,106217,63743952.0,2285421.0,61458531.0,781,100,681,108994,3665,105329,63062217.0,2110755.0,60951461.0,0.5763,0.5786,0.5759,0.5787
2023-07-13 17:00,1985,86,1899,330834,3113,327721,191257332.0,1790134.0,189467198.0,1982,82,1900,330915,3096,327819,191301532.0,1779805.0,189521727.0,0.5751,0.5781,0.5749,0.5781
2023-07-13 17:05,536,41,495,81944,3086,78858,59322405.0,13656156.0,45666249.0,519,30,489,80421,1935,78486,58438686.0,12988910.0,45449776.0,4.4252,0.5791,6.7126,0.5791
2023-07-13 17:10,66,11,55,3902,479,3423,2260388.0,276251.0,1984136.0,59,7,52,4005,699,3306,2318038.0,401512.0,1916525.0,0.5767,0.5796,0.5744,0.5797
2023-07-13 17:15,53,5,48,3514,91,3423,2037181.0,52719.0,1984461.0,46,1,45,3549,13,3536,2057027.0,7467.0,2049560.0,0.5793,0.5797,0.5744,0.5796
2023-07-13 17:20,364,12,352,44928,1132,43796,25991361.0,649776.0,25341584.0,359,8,351,44754,956,43798,25895029.0,550362.0,25344667.0,0.574,0.5786,0.5757,0.5787
2023-07-13 17:25,33,14,19,2604,1529,1075,1502862.0,881285.0,621577.0,27,10,17,2632,1588,1044,1520168.0,915220.0,604948.0,0.5764,0.5782,0.5763,0.5795
2023-07-13 17:30,419,94,325,47163,10866,36297,27270472.0,6262595.0,21007877.0,411,90,321,46888,10686,36202,27110604.0,6159540.0,20951064.0,0.5763,0.5788,0.5764,0.5787
2023-07-13 17:35,549,86,463,51837,6775,45062,29986166.0,3904202.0,26081963.0,540,79,461,52465,7416,45049,30348682.0,4272640.0,26076042.0,0.5763,0.5788,0.5761,0.5788
2023-07-13 17:40,45,26,19,3215,1528,1687,1859386.0,880402.0,978984.0,38,20,18,3224,1538,1686,1864036.0,885730.0,978306.0,0.5762,0.5803,0.5759,0.5803
2023-07-13 17:45,21,7,14,1324,490,834,762612.0,279434.0,483178.0,21,7,14,1412,670,742,812704.0,382695.0,430009.0,0.5703,0.5794,0.5712,0.5795
2023-07-13 17:50,14,10,4,371,235,136,214104.0,135356.0,78747.0,7,4,3,316,182,134,182448.0,104871.0,77576.0,0.576,0.579,0.5762,0.5789
2023-07-13 17:55,112,30,82,9680,922,8758,5610354.0,535639.0,5074715.0,102,23,79,9143,703,8440,5297361.0,405512.0,4891848.0,0.581,0.5794,0.5768,0.5796
2023-07-13 18:00,592,82,510,69277,2286,66991,40133045.0,1318444.0,38814601.0,588,78,510,69901,2808,67093,40481696.0,1606180.0,38875516.0,0.5767,0.5794,0.572,0.5794
2023-07-13 18:05,209,55,154,19423,1180,18243,11243580.0,705321.0,10538258.0,192,45,147,18448,834,17614,10675943.0,481166.0,10194777.0,0.5977,0.5777,0.5769,0.5788
2023-07-13 18:10,755,272,483,49467,5790,43677,28615229.0,3340795.0,25274434.0,745,265,480,49331,5666,43665,28534809.0,3268469.0,25266339.0,0.577,0.5787,0.5769,0.5786
2023-07-13 18:15,127,47,80,8228,1123,7105,4773371.0,648903.0,4124468.0,120,42,78,8268,977,7291,4795693.0,563507.0,4232185.0,0.5778,0.5805,0.5768,0.5805
2023-07-13 18:20,65,17,48,2843,525,2318,1647054.0,303684.0,1343370.0,58,12,46,2643,357,2286,1531158.0,205944.0,1325214.0,0.5784,0.5795,0.5769,0.5797
2023-07-13 18:25,12,6,6,396,369,27,227261.0,210926.0,16334.0,5,2,3,18,2,16,11065.0,1111.0,9954.0,0.5716,0.605,0.5556,0.6222
2023-07-13 18:30,245,105,140,11822,3336,8486,6848686.0,1926736.0,4921950.0,239,102,137,11804,3288,8516,6840432.0,1898658.0,4941774.0,0.5776,0.58,0.5775,0.5803
2023-07-13 18:35,138,49,89,10642,2671,7971,6151157.0,1539781.0,4611375.0,136,46,90,10902,2655,8247,6307374.0,1531030.0,4776343.0,0.5765,0.5785,0.5767,0.5792
2023-07-14 10:00,5019,1588,3431,571567,98237,473330,333123532.0,58765779.0,274357752.0,4819,1499,3320,558898,93823,465075,323394366.0,54052262.0,269342104.0,0.5982,0.5796,0.5761,0.5791
2023-07-14 10:05,1702,671,1031,185857,36595,149262,107438878.0,21021838.0,86417040.0,1639,645,994,183150,34161,148989,105921759.0,19676647.0,86245111.0,0.5744,0.579,0.576,0.5789
2023-07-14 10:10,257,151,106,15179,8625,6554,8764990.0,4956095.0,3808895.0,213,128,85,13983,8151,5832,8079906.0,4691192.0,3388713.0,0.5746,0.5812,0.5755,0.5811
2023-07-14 10:15,738,388,350,55316,24977,30339,31974538.0,14367345.0,17607192.0,616,314,302,54684,24689,29995,31609724.0,14212474.0,17397249.0,0.5752,0.5803,0.5757,0.58
2023-07-14 10:20,528,292,236,21521,16053,5468,12414955.0,9247623.0,3167331.0,501,278,223,21153,15750,5403,12191434.0,9068197.0,3123237.0,0.5761,0.5792,0.5758,0.5781
2023-07-14 10:25,82,46,36,6069,2954,3115,3505602.0,1696499.0,1809102.0,68,39,29,5382,2653,2729,3107116.0,1528175.0,1578941.0,0.5743,0.5808,0.576,0.5786
2023-07-14 10:30,552,341,211,18704,11570,7134,10816875.0,6681316.0,4135558.0,532,330,202,18520,11220,7300,10696589.0,6463768.0,4232821.0,0.5775,0.5797,0.5761,0.5798
2023-07-14 10:35,425,291,134,13348,11283,2065,7696550.0,6501876.0,1194674.0,408,279,129,13303,11258,2045,7669374.0,6487110.0,1182263.0,0.5763,0.5785,0.5762,0.5781
2023-07-14 10:40,304,182,122,12619,8847,3772,7272102.0,5098210.0,2173891.0,290,176,114,12523,8928,3595,7221248.0,5144433.0,2076814.0,0.5763,0.5763,0.5762,0.5777
2023-07-14 10:45,439,253,186,18652,13785,4867,10702433.0,7890985.0,2811448.0,423,246,177,17672,13097,4575,10188289.0,7545409.0,2642879.0,0.5724,0.5777,0.5761,0.5777
2023-07-14 10:50,144,83,61,9507,6367,3140,5480970.0,3667659.0,1813310.0,125,81,44,9159,6346,2813,5279828.0,3655551.0,1624276.0,0.576,0.5775,0.576,0.5774
2023-07-14 10:55,50,13,37,482,233,249,279399.0,134540.0,144859.0,17,9,8,592,366,226,342163.0,210694.0,131469.0,0.5774,0.5818,0.5757,0.5817
2023-07-14 11:00,98,74,24,6840,4738,2102,3944355.0,2729717.0,1214638.0,92,68,24,6797,4676,2121,3916960.0,2691368.0,1225591.0,0.5761,0.5778,0.5756,0.5778
2023-07-14 11:05,336,249,87,23978,19400,4578,13824398.0,11176125.0,2648273.0,325,240,85,22772,19118,3654,13127129.0,11013613.0,2113516.0,0.5761,0.5785,0.5761,0.5784
2023-07-14 11:10,135,97,38,4827,4197,630,2788722.0,2423495.0,365226.0,111,81,30,4151,3615,536,2392058.0,2082398.0,309659.0,0.5774,0.5797,0.576,0.5777
2023-07-14 11:15,167,107,60,11113,5701,5412,6410061.0,3270565.0,3139496.0,146,94,52,10512,5277,5235,6079451.0,3040279.0,3039171.0,0.5737,0.5801,0.5761,0.5805
2023-07-14 11:20,119,61,58,7026,2573,4453,4051291.0,1484176.0,2567114.0,109,54,55,7187,2678,4509,4171421.0,1542726.0,2628695.0,0.5768,0.5765,0.5761,0.583
2023-07-14 11:25,435,225,210,25362,11046,14316,14669469.0,6353743.0,8315725.0,412,211,201,24007,10081,13926,13896116.0,5807839.0,8088276.0,0.5752,0.5809,0.5761,0.5808
2023-07-14 11:30,1194,819,375,67376,56392,10984,38905742.0,32507910.0,6397832.0,1177,809,368,65004,54790,10214,37498013.0,31582347.0,5915666.0,0.5765,0.5825,0.5764,0.5792
2023-07-14 11:35,121,96,25,4836,3880,956,2796766.0,2238193.0,558573.0,99,79,20,4532,3681,851,2615702.0,2122166.0,493536.0,0.5769,0.5843,0.5765,0.5799
2023-07-14 11:40,245,116,129,6684,3707,2977,3799841.0,2069570.0,1730271.0,232,106,126,5628,2823,2805,3247652.0,1623891.0,1623761.0,0.5583,0.5812,0.5752,0.5789
2023-07-14 11:45,58,16,42,1244,425,819,721291.0,245812.0,475479.0,48,11,37,1087,306,781,629234.0,176461.0,452773.0,0.5784,0.5806,0.5767,0.5797
2023-07-14 11:50,24,9,15,1255,84,1171,732820.0,54266.0,678554.0,15,2,13,1127,2,1125,652981.0,1146.0,651834.0,0.646,0.5795,0.5732,0.5794
2023-07-14 11:55,127,67,60,11063,5075,5988,6410722.0,2940152.0,3470569.0,119,63,56,10672,4857,5815,6172957.0,2804425.0,3368532.0,0.5793,0.5796,0.5774,0.5793
2023-07-14 12:00,299,109,190,19892,7106,12786,11508784.0,4102980.0,7405803.0,288,102,186,19834,7079,12755,11475366.0,4087005.0,7388360.0,0.5774,0.5792,0.5773,0.5793
2023-07-14 12:05,504,194,310,20893,9467,11426,12078274.0,5457613.0,6620660.0,495,189,306,20440,8892,11548,11821609.0,5133902.0,6687706.0,0.5765,0.5794,0.5774,0.5791
2023-07-14 12:10,515,377,138,15090,10711,4379,8722002.0,6186173.0,2535828.0,506,371,135,14931,10631,4300,8629014.0,6139235.0,2489779.0,0.5776,0.5791,0.5775,0.579
2023-07-14 12:15,70,36,34,3606,1355,2251,2089213.0,786837.0,1302376.0,64,33,31,3674,1498,2176,2127668.0,864806.0,1262861.0,0.5807,0.5786,0.5773,0.5804
2023-07-14 12:20,94,55,39,5732,3410,2322,15193866.0,13848575.0,1345291.0,86,46,40,5018,2830,2188,5206675.0,3939198.0,1267476.0,4.0612,0.5794,1.3919,0.5793
2023-07-14 12:25,92,69,23,3969,3401,568,2296384.0,1965311.0,331072.0,86,64,22,3913,3345,568,2263462.0,1932479.0,330983.0,0.5779,0.5829,0.5777,0.5827
2023-07-14 12:30,403,275,128,27209,22365,4844,15761994.0,12941148.0,2820846.0,385,268,117,26902,22489,4413,15546243.0,12982810.0,2563433.0,0.5786,0.5823,0.5773,0.5809
2023-07-14 12:35,226,164,62,12205,10817,1388,7051484.0,6245544.0,805940.0,217,158,59,11853,10636,1217,6847675.0,6140595.0,707080.0,0.5774,0.5806,0.5773,0.581
2023-07-14 12:40,659,538,121,35799,33361,2438,20687032.0,19273230.0,1413801.0,656,535,121,35730,33301,2429,20647844.0,19238510.0,1409333.0,0.5777,0.5799,0.5777,0.5802
2023-07-14 12:45,931,615,316,41959,34610,7349,24275216.0,20008512.0,4266704.0,924,614,310,41846,34583,7263,24205980.0,19992677.0,4213302.0,0.5781,0.5806,0.5781,0.5801
2023-07-14 12:50,745,400,345,29077,20700,8377,16822603.0,11961864.0,4860739.0,726,395,331,28310,20397,7913,16385388.0,11785704.0,4599684.0,0.5779,0.5802,0.5778,0.5813
2023-07-14 12:55,562,312,250,33829,17376,16453,31513890.0,21939070.0,9574820.0,556,305,251,33507,16975,16532,31317035.0,21701260.0,9615775.0,1.2626,0.5819,1.2784,0.5816
2023-07-14 13:00,1661,516,1145,146223,20888,125335,85056769.0,12086680.0,72970089.0,1646,509,1137,145567,20782,124785,84708813.0,12026329.0,72682484.0,0.5786,0.5822,0.5787,0.5825
2023-07-14 13:05,665,216,449,54235,9942,44293,31553679.0,5751105.0,25802573.0,658,213,445,53501,9751,43750,31129314.0,5640426.0,25488887.0,0.5785,0.5825,0.5784,0.5826
2023-07-14 13:10,260,87,173,21077,4575,16502,12239431.0,2646784.0,9592647.0,240,77,163,20843,4498,16345,12102205.0,2601724.0,9500481.0,0.5785,0.5813,0.5784,0.5812
2023-07-14 13:15,101,54,47,5114,2129,2985,2962501.0,1231033.0,1731467.0,94,48,46,4862,1888,2974,2820679.0,1091636.0,1729043.0,0.5782,0.5801,0.5782,0.5814
2023-07-14 13:20,813,378,435,44358,20118,24240,37573728.0,23510701.0,14063027.0,785,354,431,43838,19734,24104,37273089.0,23289412.0,13983676.0,1.1686,0.5802,1.1802,0.5801
2023-07-14 13:25,450,305,145,31550,20720,10830,18291451.0,12001929.0,6289522.0,431,292,139,29690,20077,9613,17195097.0,11611104.0,5583993.0,0.5792,0.5807,0.5783,0.5809
2023-07-14 13:30,614,421,193,30664,22477,8187,17760851.0,13001192.0,4759658.0,595,404,191,30539,22052,8487,17685990.0,12753195.0,4932795.0,0.5784,0.5814,0.5783,0.5812
2023-07-14 13:35,850,385,465,75223,26686,48537,55575566.0,27311141.0,28264425.0,823,366,457,75266,26430,48836,55600422.0,27160620.0,28439801.0,1.0234,0.5823,1.0276,0.5824
2023-07-14 13:40,946,307,639,61549,24601,36948,35674225.0,14208887.0,21465338.0,927,295,632,61167,24437,36730,35452886.0,14113142.0,21339744.0,0.5776,0.581,0.5775,0.581
2023-07-14 13:45,1057,429,628,72607,15382,57225,42277916.0,8903434.0,33374481.0,1040,428,612,71553,15583,55970,41657671.0,9019384.0,32638286.0,0.5788,0.5832,0.5788,0.5831
2023-07-14 13:50,2258,576,1682,271382,34943,236439,157918840.0,20208564.0,137710275.0,2235,562,1673,270774,34728,236046,157565635.0,20081480.0,137484155.0,0.5783,0.5824,0.5783,0.5824
2023-07-14 13:55,1969,379,1590,242013,13019,228994,140940440.0,7535500.0,133404940.0,1936,360,1576,240097,11745,228352,139842713.0,6797346.0,133045367.0,0.5788,0.5826,0.5787,0.5826
2023-07-14 14:00,1366,167,1199,219122,9374,209748,127679995.0,5424186.0,122255808.0,1352,158,1194,218877,9249,209628,127534710.0,5351043.0,122183666.0,0.5786,0.5829,0.5786,0.5829
2023-07-14 14:05,2393,847,1546,229148,59188,169960,145139610.0,46174636.0,98964973.0,2371,834,1537,228995,59014,169981,145051719.0,46070431.0,98981288.0,0.7801,0.5823,0.7807,0.5823
2023-07-14 14:10,1523,651,872,133674,43429,90245,77738595.0,25180662.0,52557932.0,1501,638,863,133296,43175,90121,77507689.0,25023251.0,52484437.0,0.5798,0.5824,0.5796,0.5824
2023-07-14 14:15,685,445,240,35633,24085,11548,20693710.0,13964475.0,6729235.0,669,431,238,35592,24034,11558,20673618.0,13934589.0,6739028.0,0.5798,0.5827,0.5798,0.5831
2023-07-14 14:20,635,319,316,42031,16209,25822,24454340.0,9403373.0,15050967.0,612,304,308,41938,16051,25887,24397630.0,9307815.0,15089814.0,0.5801,0.5829,0.5799,0.5829
2023-07-14 14:25,565,195,370,38726,13190,25536,34359981.0,19523037.0,14836944.0,552,186,366,37949,13071,24878,33953203.0,19453743.0,14499460.0,1.4801,0.581,1.4883,0.5828
2023-07-14 14:30,943,195,748,61327,3840,57487,35674443.0,2216965.0,33457477.0,936,194,742,60895,4127,56768,35423253.0,2384312.0,33038941.0,0.5773,0.582,0.5777,0.582
2023-07-14 14:35,219,50,169,15461,1210,14251,9000921.0,696994.0,8303927.0,206,44,162,14679,855,13824,8545336.0,494864.0,8050472.0,0.576,0.5827,0.5788,0.5824
2023-07-14 14:40,72,21,51,4004,542,3462,2332192.0,313899.0,2018293.0,65,16,49,3853,362,3491,2247005.0,209488.0,2037516.0,0.5792,0.583,0.5787,0.5836
2023-07-14 14:45,160,60,100,8870,1703,7167,5159185.0,990752.0,4168432.0,150,51,99,8508,1530,6978,4949604.0,885522.0,4064082.0,0.5818,0.5816,0.5788,0.5824
2023-07-14 14:50,117,54,63,6736,2185,4551,3921139.0,1263764.0,2657375.0,102,46,56,5555,2079,3476,3223092.0,1197881.0,2025211.0,0.5784,0.5839,0.5762,0.5826
2023-07-14 14:55,368,154,214,16947,4980,11967,9843875.0,2882211.0,6961663.0,360,151,209,16913,4901,12012,9830821.0,2836348.0,6994472.0,0.5788,0.5817,0.5787,0.5823
2023-07-14 15:00,153,79,74,11609,6268,5341,6730603.0,3620193.0,3110410.0,148,74,74,11715,5864,5851,6794498.0,3390156.0,3404342.0,0.5776,0.5824,0.5781,0.5818
2023-07-14 15:05,103,46,57,3173,1476,1697,1851797.0,862863.0,988933.0,83,36,47,2480,1206,1274,1438860.0,696997.0,741862.0,0.5846,0.5828,0.5779,0.5823
2023-07-14 15:10,69,22,47,2936,975,1961,1705703.0,563764.0,1141939.0,66,22,44,2794,920,1874,1626785.0,532071.0,1094714.0,0.5782,0.5823,0.5783,0.5842
2023-07-14 15:15,143,81,62,9561,8383,1178,5538403.0,4851668.0,686734.0,134,76,58,9369,8312,1057,5420292.0,4805956.0,614336.0,0.5788,0.583,0.5782,0.5812
2023-07-14 15:20,170,84,86,11213,5966,5247,6503987.0,3451052.0,3052935.0,162,81,81,11215,6110,5105,6506130.0,3534517.0,2971612.0,0.5785,0.5818,0.5785,0.5821
2023-07-14 15:25,132,58,74,10617,3643,6974,6167107.0,2109386.0,4057721.0,129,54,75,9437,3799,5638,5477047.0,2195084.0,3281963.0,0.579,0.5818,0.5778,0.5821
2023-07-14 15:30,338,180,158,13880,7138,6742,8058565.0,4131843.0,3926721.0,332,177,155,13953,7407,6546,8098625.0,4286867.0,3811758.0,0.5789,0.5824,0.5788,0.5823
2023-07-14 15:35,933,470,463,96054,54005,42049,102961771.0,78673916.0,24287854.0,905,449,456,93734,52683,41051,101723456.0,77912924.0,23810532.0,1.4568,0.5776,1.4789,0.58
2023-07-14 15:40,2789,1677,1112,278175,181177,96998,160871491.0,104626200.0,56245290.0,2779,1672,1107,277975,180595,97380,160732673.0,104265676.0,56466997.0,0.5775,0.5799,0.5773,0.5799
2023-07-14 15:45,215,140,75,10941,6315,4626,6323629.0,3644312.0,2679317.0,205,135,70,9981,5949,4032,5771608.0,3432405.0,2339203.0,0.5771,0.5792,0.577,0.5802
2023-07-14 15:50,262,187,75,13707,9450,4257,7924487.0,5454627.0,2469859.0,250,177,73,13582,9376,4206,7851814.0,5411481.0,2440333.0,0.5772,0.5802,0.5772,0.5802
2023-07-14 15:55,1380,897,483,149763,76548,73215,86625990.0,44197004.0,42428986.0,1376,895,481,149762,76783,72979,86633027.0,44332873.0,42300154.0,0.5774,0.5795,0.5774,0.5796
2023-07-14 16:00,1671,929,742,165366,78000,87366,95685007.0,45013366.0,50671641.0,1662,927,735,165476,78218,87258,95752297.0,45139413.0,50612884.0,0.5771,0.58,0.5771,0.58
2023-07-14 16:05,1933,1126,807,195910,91412,104498,113282047.0,52759648.0,60522398.0,1916,1113,803,195805,90996,104809,113258270.0,52527296.0,60730974.0,0.5772,0.5792,0.5772,0.5794
2023-07-14 16:10,1816,1168,648,138289,89695,48594,79980231.0,51819693.0,28160538.0,1803,1158,645,138256,89398,48858,79950640.0,51637248.0,28313391.0,0.5777,0.5795,0.5776,0.5795
2023-07-14 16:15,517,317,200,42753,28770,13983,24728158.0,16624029.0,8104128.0,513,312,201,42251,28061,14190,24438519.0,16214499.0,8224019.0,0.5778,0.5796,0.5778,0.5796
2023-07-14 16:20,708,310,398,44983,19602,25381,37917411.0,23197664.0,14719746.0,703,308,395,45323,20192,25131,38112848.0,23538293.0,14574555.0,1.1834,0.58,1.1657,0.5799
2023-07-14 16:25,338,173,165,23709,8194,15515,13727188.0,4732159.0,8995028.0,332,170,162,23533,7977,15556,13625585.0,4606517.0,9019067.0,0.5775,0.5798,0.5775,0.5798
2023-07-14 16:30,440,250,190,24864,14458,10406,14377798.0,8349334.0,6028463.0,429,242,187,24886,14424,10462,14388129.0,8326043.0,6062086.0,0.5775,0.5793,0.5772,0.5794
2023-07-14 16:35,128,27,101,11337,1829,9508,6569604.0,1060866.0,5508737.0,124,23,101,11201,1668,9533,6485579.0,962006.0,5523572.0,0.58,0.5794,0.5767,0.5794
2023-07-14 16:40,318,70,248,28768,3618,25150,16665039.0,2089508.0,14575531.0,312,68,244,28356,3554,24802,16428178.0,2052115.0,14376063.0,0.5775,0.5795,0.5774,0.5796
2023-07-14 16:45,574,328,246,39594,20993,18601,34763148.0,23983743.0,10779405.0,561,317,244,38568,20722,17846,34170252.0,23826554.0,10343698.0,1.1425,0.5795,1.1498,0.5796
2023-07-14 16:50,960,403,557,95177,29723,65454,55049882.0,17141990.0,37907891.0,957,401,556,95445,29814,65631,55206573.0,17196103.0,38010470.0,0.5767,0.5792,0.5768,0.5792
2023-07-14 16:55,766,285,481,78227,18976,59251,45272758.0,10949735.0,34323022.0,753,279,474,78403,19090,59313,45374021.0,11014383.0,34359638.0,0.577,0.5793,0.577,0.5793
2023-07-14 17:00,1429,351,1078,178127,25855,152272,103138456.0,14919564.0,88218891.0,1418,340,1078,178065,25919,152146,103105965.0,14956028.0,88149936.0,0.577,0.5794,0.577,0.5794
2023-07-14 17:05,1054,277,777,109407,16311,93096,63351852.0,9408590.0,53943261.0,1050,270,780,110222,16178,94044,63831148.0,9331801.0,54499346.0,0.5768,0.5794,0.5768,0.5795
2023-07-14 17:10,701,220,481,68757,10665,58092,39862133.0,6151872.0,33710261.0,683,206,477,68769,10604,58165,39875789.0,6116491.0,33759298.0,0.5768,0.5803,0.5768,0.5804
2023-07-14 17:15,1488,276,1212,219161,40212,178949,198203916.0,94413599.0,103790317.0,1451,247,1204,219634,39335,180299,198486949.0,93907322.0,104579627.0,2.3479,0.58,2.3874,0.58
2023-07-14 17:20,1476,399,1077,171642,43024,128618,99449618.0,24781501.0,74668117.0,1465,391,1074,171224,42553,128671,99196607.0,24498828.0,74697778.0,0.576,0.5805,0.5757,0.5805
2023-07-14 17:25,424,73,351,44875,1534,43341,37938738.0,12761726.0,25177012.0,409,61,348,44387,1430,42957,37656399.0,12699774.0,24956625.0,8.3192,0.5809,8.881,0.581
2023-07-14 17:30,413,68,345,13643,2068,11575,7894302.0,1203097.0,6691205.0,401,57,344,13047,1862,11185,7547403.0,1072020.0,6475382.0,0.5818,0.5781,0.5757,0.5789
2023-07-14 17:35,536,70,466,27223,1987,25236,15754329.0,1147140.0,14607189.0,526,62,464,27222,1823,25399,15755710.0,1052308.0,14703402.0,0.5773,0.5788,0.5772,0.5789
2023-07-14 17:40,582,290,292,42025,13986,28039,24309697.0,8073033.0,16236664.0,570,278,292,41207,12962,28245,23837076.0,7481120.0,16355956.0,0.5772,0.5791,0.5772,0.5791
2023-07-14 17:45,451,272,179,26649,14276,12373,15405043.0,8238004.0,7167039.0,441,265,176,25923,14058,11865,14984868.0,8112221.0,6872647.0,0.5771,0.5792,0.5771,0.5792
2023-07-14 17:50,298,196,102,15181,12662,2519,8802391.0,7341952.0,1460439.0,285,186,99,14856,12380,2476,8578942.0,7144281.0,1434661.0,0.5798,0.5798,0.5771,0.5794
2023-07-14 17:55,188,152,36,8617,6414,2203,4983317.0,3706108.0,1277208.0,174,144,30,8311,6389,1922,4805841.0,3691422.0,1114419.0,0.5778,0.5798,0.5778,0.5798
2023-07-14 18:00,332,226,106,15305,9337,5968,20735697.0,17274801.0,3460896.0,317,216,101,15213,9398,5815,20665531.0,17292973.0,3372558.0,1.8501,0.5799,1.8401,0.58
2023-07-14 18:05,273,197,76,10825,6688,4137,6267702.0,3863903.0,2403799.0,262,195,67,9843,6878,2965,5696034.0,3975623.0,1720410.0,0.5777,0.581,0.578,0.5802
2023-07-14 18:10,309,170,139,14362,4837,9525,8316466.0,2795626.0,5520839.0,293,155,138,14116,4768,9348,8178420.0,2755965.0,5422455.0,0.578,0.5796,0.578,0.5801
2023-07-14 18:15,128,65,63,5619,1138,4481,3258172.0,658022.0,2600150.0,120,59,61,5233,635,4598,3034892.0,367088.0,2667803.0,0.5782,0.5803,0.5781,0.5802
2023-07-14 18:20,57,31,26,2210,943,1267,1271570.0,545373.0,726196.0,50,26,24,1591,659,932,921491.0,380334.0,541156.0,0.5783,0.5732,0.5771,0.5806
2023-07-14 18:25,244,123,121,9470,373,9097,5492964.0,217664.0,5275299.0,238,117,121,3404,283,3121,1976921.0,163383.0,1813537.0,0.5836,0.5799,0.5773,0.5811
2023-07-14 18:30,293,142,151,8329,2986,5343,4827638.0,1725763.0,3101875.0,282,135,147,14386,2971,11415,8336687.0,1716736.0,6619950.0,0.578,0.5805,0.5778,0.5799
2023-07-14 18:35,333,148,185,11231,3169,8062,6503670.0,1831432.0,4672237.0,331,144,187,12021,3633,8388,6962415.0,2096997.0,4865418.0,0.5779,0.5795,0.5772,0.58
2023-07-17 10:00,2502,776,1726,203747,36903,166844,126608199.0,29670180.0,96938018.0,2262,649,1613,193457,32546,160911,114341909.0,21009427.0,93332482.0,0.804,0.581,0.6455,0.58
2023-07-17 10:05,2593,1571,1022,267425,157119,110306,194370091.0,130042872.0,64327219.0,2538,1543,995,260000,154994,105006,184172786.0,123237678.0,60935107.0,0.8277,0.5832,0.7951,0.5803
2023-07-17 10:10,4751,2977,1774,562046,397299,164747,371909415.0,276390987.0,95518428.0,4684,2956,1728,559436,396682,162754,370383665.0,276031400.0,94352264.0,0.6957,0.5798,0.6959,0.5797
2023-07-17 10:15,1326,914,412,126814,103473,23341,96855074.0,83347974.0,13507100.0,1161,820,341,125707,102582,23125,96246107.0,82840619.0,13405488.0,0.8055,0.5787,0.8076,0.5797
2023-07-17 10:20,641,420,221,29930,22699,7231,17303813.0,13105836.0,4197976.0,594,396,198,28187,21930,6257,16284294.0,12655164.0,3629129.0,0.5774,0.5806,0.5771,0.58
2023-07-17 10:25,870,528,342,55596,43809,11787,32130824.0,25293968.0,6836856.0,832,503,329,53913,42725,11188,31170738.0,24675976.0,6494762.0,0.5774,0.58,0.5776,0.5805
2023-07-17 10:30,1153,779,374,74764,58907,15857,67040132.0,57811225.0,9228906.0,1124,760,364,73404,58242,15162,66207428.0,57401893.0,8805535.0,0.9814,0.582,0.9856,0.5808
2023-07-17 10:35,1023,812,211,138581,133450,5131,91894367.0,88915871.0,2978495.0,991,800,191,138539,133509,5030,91867358.0,88946493.0,2920865.0,0.6663,0.5805,0.6662,0.5807
2023-07-17 10:40,372,245,127,27451,22104,5347,15885747.0,12766511.0,3119236.0,349,231,118,25780,21731,4049,14901854.0,12549985.0,2351869.0,0.5776,0.5834,0.5775,0.5809
2023-07-17 10:45,168,74,94,8407,4252,4155,4846428.0,2434061.0,2412367.0,137,55,82,6785,3249,3536,3932189.0,1878275.0,2053913.0,0.5725,0.5806,0.5781,0.5809
2023-07-17 10:50,292,168,124,22463,17478,4985,12972839.0,10093126.0,2879712.0,270,157,113,21891,17259,4632,12654429.0,9966658.0,2687770.0,0.5775,0.5777,0.5775,0.5803
2023-07-17 10:55,51,25,26,2404,1699,705,1384742.0,977553.0,407189.0,38,21,17,2018,1625,393,1165815.0,937081.0,228733.0,0.5754,0.5776,0.5767,0.582
2023-07-17 11:00,138,81,57,8230,6515,1715,4765735.0,3767516.0,998219.0,112,61,51,7444,5723,1721,4304769.0,3303159.0,1001610.0,0.5783,0.5821,0.5772,0.582
2023-07-17 11:05,180,138,42,14993,12693,2300,8675585.0,7326064.0,1349521.0,180,131,49,14291,11467,2824,8292593.0,6630622.0,1661970.0,0.5772,0.5867,0.5782,0.5885
2023-07-17 11:10,277,198,79,17102,14508,2594,9940139.0,8423203.0,1516936.0,256,178,78,17571,14025,3546,10183636.0,8116258.0,2067377.0,0.5806,0.5848,0.5787,0.583
2023-07-17 11:15,246,131,115,18461,6961,11500,10708044.0,4024944.0,6683100.0,226,121,105,17801,7041,10760,10324410.0,4071053.0,6253356.0,0.5782,0.5811,0.5782,0.5812
2023-07-17 11:20,78,43,35,4368,1663,2705,2530693.0,960701.0,1569991.0,64,36,28,3899,1530,2369,2259705.0,884761.0,1374944.0,0.5777,0.5804,0.5783,0.5804
2023-07-17 11:25,285,141,144,11832,4354,7478,6850160.0,2516795.0,4333365.0,265,125,140,10892,3945,6947,6308701.0,2281223.0,4027477.0,0.578,0.5795,0.5783,0.5797
2023-07-17 11:30,91,36,55,5144,1786,3358,14886058.0,12908121.0,1977937.0,70,30,40,4221,1764,2457,14320459.0,12895407.0,1425051.0,7.2274,0.589,7.3103,0.58
2023-07-17 11:35,126,45,81,6050,1361,4689,3497839.0,786662.0,2711176.0,104,36,68,5052,1184,3868,2924699.0,683822.0,2240877.0,0.578,0.5782,0.5776,0.5793
2023-07-17 11:40,564,242,322,27996,7758,20238,16236584.0,4477339.0,11759244.0,552,233,319,28149,7744,20405,16322034.0,4467200.0,11854834.0,0.5771,0.581,0.5769,0.581
2023-07-17 11:45,297,125,172,16835,5170,11665,9769912.0,2992996.0,6776916.0,280,114,166,15370,3964,11406,8918679.0,2292218.0,6626460.0,0.5789,0.581,0.5783,0.581
2023-07-17 11:50,453,340,113,21024,15511,5513,24053721.0,20848528.0,3205193.0,439,335,104,20549,15086,5463,23775839.0,20600616.0,3175223.0,1.3441,0.5814,1.3655,0.5812
2023-07-17 11:55,891,650,241,35710,30150,5560,20709381.0,17475466.0,3233915.0,865,636,229,34960,29593,5367,20263973.0,17141620.0,3122352.0,0.5796,0.5816,0.5792,0.5818
2023-07-17 12:00,739,396,343,45424,11942,33482,26440943.0,6911844.0,19529099.0,718,386,332,44882,11735,33147,26132249.0,6790897.0,19341351.0,0.5788,0.5833,0.5787,0.5835
2023-07-17 12:05,139,91,48,5782,2897,2885,3355870.0,1675708.0,1680161.0,125,81,44,5603,2913,2690,3252079.0,1684620.0,1567459.0,0.5784,0.5824,0.5783,0.5827
2023-07-17 12:10,120,71,49,4056,2268,1788,2351219.0,1311956.0,1039262.0,109,65,44,4306,2159,2147,2498485.0,1249851.0,1248634.0,0.5785,0.5812,0.5789,0.5816
2023-07-17 12:15,1992,1502,490,195383,172276,23107,137438877.0,123951500.0,13487377.0,1890,1465,425,188164,167472,20692,133092498.0,121017523.0,12074975.0,0.7195,0.5837,0.7226,0.5836
2023-07-17 12:20,2371,1008,1363,224367,106582,117785,130752894.0,62012191.0,68740703.0,2323,1000,1323,221682,106626,115056,129188747.0,62035048.0,67153699.0,0.5818,0.5836,0.5818,0.5837
2023-07-17 12:25,913,467,446,65992,40386,25606,38443007.0,23494741.0,14948266.0,882,445,437,65086,39966,25120,37908582.0,23244517.0,14664065.0,0.5818,0.5838,0.5816,0.5838
2023-07-17 12:30,2495,1758,737,252534,208008,44526,194666064.0,168676627.0,25989437.0,2454,1737,717,249751,206294,43457,192991791.0,167603945.0,25387845.0,0.8109,0.5837,0.8125,0.5842
2023-07-17 12:35,1002,626,376,66569,56504,10065,38798722.0,32905238.0,5893483.0,976,617,359,65044,55972,9072,37895272.0,32593921.0,5301350.0,0.5824,0.5855,0.5823,0.5844
2023-07-17 12:40,1184,687,497,75838,60447,15391,56052178.0,47069730.0,8982448.0,1160,682,478,75575,60466,15109,55907394.0,47078823.0,8828571.0,0.7787,0.5836,0.7786,0.5843
2023-07-17 12:45,498,300,198,36307,29246,7061,21163701.0,17037977.0,4125724.0,472,284,188,35635,28878,6757,20757700.0,16810106.0,3947594.0,0.5826,0.5843,0.5821,0.5842
2023-07-17 12:50,1266,857,409,121533,106984,14549,70768145.0,62277790.0,8490354.0,1215,839,376,119498,105932,13566,69583988.0,61659649.0,7924339.0,0.5821,0.5836,0.5821,0.5841
2023-07-17 12:55,310,170,140,11908,7930,3978,6912661.0,4613674.0,2298987.0,262,155,107,10903,7696,3207,6350572.0,4475321.0,1875251.0,0.5818,0.5779,0.5815,0.5847
2023-07-17 13:00,170,96,74,6521,3634,2887,3804101.0,2117578.0,1686522.0,163,94,69,6592,3745,2847,3839478.0,2176618.0,1662859.0,0.5827,0.5842,0.5812,0.5841
2023-07-17 13:05,91,34,57,8085,2145,5940,4723398.0,1249448.0,3473950.0,77,26,51,7681,1771,5910,4484105.0,1029626.0,3454478.0,0.5825,0.5848,0.5814,0.5845
2023-07-17 13:10,159,78,81,12882,3836,9046,7494217.0,2227251.0,5266965.0,144,74,70,11625,3464,8161,6784609.0,2014487.0,4770121.0,0.5806,0.5822,0.5815,0.5845
2023-07-17 13:15,461,247,214,23402,10292,13110,25419680.0,17852367.0,7567312.0,442,237,205,22375,10030,12345,24902795.0,17701035.0,7201760.0,1.7346,0.5772,1.7648,0.5834
2023-07-17 13:20,626,266,360,35002,9592,25410,20351212.0,5570064.0,14781147.0,606,250,356,33682,9032,24650,19607864.0,5244712.0,14363152.0,0.5807,0.5817,0.5807,0.5827
2023-07-17 13:25,723,303,420,73052,18168,54884,42544163.0,10551793.0,31992370.0,702,295,407,73232,18982,54250,42643934.0,11021494.0,31622439.0,0.5808,0.5829,0.5806,0.5829
2023-07-17 13:30,1424,648,776,116578,33711,82867,67855861.0,19570677.0,48285183.0,1407,637,770,115712,32822,82890,67352291.0,19054438.0,48297853.0,0.5805,0.5827,0.5805,0.5827
2023-07-17 13:35,2238,1754,484,223108,209213,13895,189770770.0,181646216.0,8124554.0,2070,1694,376,213756,201526,12230,184109350.0,176951595.0,7157755.0,0.8682,0.5847,0.8781,0.5853
2023-07-17 13:40,1850,1226,624,164404,138436,25968,108289176.0,92970685.0,15318490.0,1713,1186,527,156906,137309,19597,103849226.0,92295247.0,11553979.0,0.6716,0.5899,0.6722,0.5896
2023-07-17 13:45,4501,2722,1779,533636,352606,181030,506754374.0,399415123.0,107339250.0,3175,2016,1159,385959,266985,118974,418128194.0,347390301.0,70737893.0,1.1328,0.5929,1.3012,0.5946
2023-07-17 13:50,1758,922,836,152573,67182,85391,102582433.0,51846261.0,50736171.0,1433,696,737,153260,69831,83429,102798266.0,53136534.0,49661732.0,0.7717,0.5942,0.7609,0.5953
2023-07-17 13:55,735,429,306,62952,28302,34650,37508933.0,16953897.0,20555036.0,542,312,230,53750,21195,32555,31911461.0,12535342.0,19376119.0,0.599,0.5932,0.5914,0.5952
2023-07-17 14:00,989,588,401,68242,47866,20376,64197855.0,52196856.0,12000999.0,761,485,276,53198,38733,14465,55385109.0,46751315.0,8633793.0,1.0905,0.589,1.207,0.5969
2023-07-17 14:05,874,455,419,63380,30101,33279,61523388.0,41743974.0,19779413.0,739,374,365,55742,25401,30341,56843014.0,38805112.0,18037902.0,1.3868,0.5944,1.5277,0.5945
2023-07-17 14:10,921,613,308,76830,57470,19360,69456182.0,58109118.0,11347064.0,772,515,257,69618,54194,15424,65137921.0,55928333.0,9209587.0,1.0111,0.5861,1.032,0.5971
2023-07-17 14:15,1663,820,843,148953,49706,99247,112220772.0,53255776.0,58964996.0,1544,737,807,143114,47060,96054,108822900.0,51637900.0,57185000.0,1.0714,0.5941,1.0973,0.5953
2023-07-17 14:20,1540,583,957,158651,29304,129347,129514609.0,52995323.0,76519286.0,1354,472,882,148348,23060,125288,123627115.0,49271551.0,74355564.0,1.8085,0.5916,2.1367,0.5935
2023-07-17 14:25,797,380,417,74918,44463,30455,44480559.0,26359098.0,18121461.0,692,331,361,69669,41298,28371,41313503.0,24407503.0,16906000.0,0.5928,0.595,0.591,0.5959
2023-07-17 14:30,501,204,297,42395,18031,24364,25113254.0,10694234.0,14419019.0,429,160,269,36524,17230,19294,21645898.0,10183902.0,11461996.0,0.5931,0.5918,0.5911,0.5941
2023-07-17 14:35,592,305,287,48885,25283,23602,40943082.0,26909106.0,14033975.0,505,255,250,45743,23729,22014,39002386.0,25917440.0,13084945.0,1.0643,0.5946,1.0922,0.5944
2023-07-17 14:40,927,539,388,73914,47292,26622,67797183.0,51938515.0,15858667.0,697,453,244,56872,37489,19383,57572729.0,46000457.0,11572271.0,1.0983,0.5957,1.227,0.597
2023-07-17 14:45,1001,463,538,72054,37318,34736,54904185.0,34196686.0,20707499.0,828,397,431,66197,34398,31799,51313302.0,32295425.0,19017877.0,0.9164,0.5961,0.9389,0.5981
2023-07-17 14:50,719,309,410,45621,16238,29383,27280019.0,9702704.0,17577315.0,617,269,348,40364,12997,27367,24129297.0,7737259.0,16392038.0,0.5975,0.5982,0.5953,0.599
2023-07-17 14:55,1134,450,684,98222,24905,73317,94040040.0,50500808.0,43539231.0,989,374,615,86712,21472,65240,87404456.0,48388639.0,39015817.0,2.0277,0.5938,2.2536,0.598
2023-07-17 15:00,1123,293,830,101419,12455,88964,60616289.0,7476088.0,53140201.0,1046,241,805,96569,9135,87434,57657145.0,5428963.0,52228181.0,0.6002,0.5973,0.5943,0.5973
2023-07-17 15:05,390,126,264,36668,5416,31252,33624248.0,15106596.0,18517651.0,341,101,240,33220,4611,28609,31676063.0,14609009.0,17067053.0,2.7893,0.5925,3.1683,0.5966
2023-07-17 15:10,964,359,605,102913,30944,71969,72668892.0,30223303.0,42445589.0,834,264,570,81583,15018,66565,60310968.0,20752862.0,39558105.0,0.9767,0.5898,1.3819,0.5943
2023-07-17 15:15,849,404,445,60225,20433,39792,59588004.0,35910226.0,23677778.0,776,378,398,55891,19477,36414,56941531.0,35282730.0,21658800.0,1.7575,0.595,1.8115,0.5948
2023-07-17 15:20,717,474,243,59153,42651,16502,46990887.0,37186515.0,9804371.0,685,464,221,66932,51192,15740,51550683.0,42184200.0,9366483.0,0.8719,0.5941,0.824,0.5951
2023-07-17 15:25,562,315,247,30323,19088,11235,17981539.0,11309059.0,6672479.0,538,301,237,29289,18393,10896,17370416.0,10894047.0,6476369.0,0.5925,0.5939,0.5923,0.5944
2023-07-17 15:30,1579,491,1088,166304,17970,148334,158339992.0,70101125.0,88238867.0,1446,401,1045,146858,11395,135463,146444966.0,66105098.0,80339867.0,3.901,0.5949,5.8012,0.5931
2023-07-17 15:35,878,290,588,70267,10244,60023,77200665.0,41668215.0,35532450.0,809,229,580,68954,7497,61457,76466097.0,40045893.0,36420204.0,4.0676,0.592,5.3416,0.5926
2023-07-17 15:40,815,375,440,70192,16078,54114,41549647.0,9495252.0,32054394.0,748,340,408,64809,13400,51409,38374743.0,7903480.0,30471263.0,0.5906,0.5923,0.5898,0.5927
2023-07-17 15:45,1329,699,630,118374,46015,72359,82042765.0,39117253.0,42925512.0,1281,674,607,114033,44286,69747,79409228.0,38038601.0,41370627.0,0.8501,0.5932,0.8589,0.5932
2023-07-17 15:50,611,300,311,53875,17817,36058,31918826.0,10532943.0,21385882.0,576,287,289,52637,17694,34943,31184500.0,10457422.0,20727077.0,0.5912,0.5931,0.591,0.5932
2023-07-17 15:55,601,321,280,45547,17321,28226,26977453.0,10234498.0,16742954.0,590,315,275,46032,18038,27994,27261824.0,10652974.0,16608849.0,0.5909,0.5932,0.5906,0.5933
2023-07-17 16:00,654,429,225,53721,38992,14729,31799119.0,23058720.0,8740399.0,628,421,207,52960,37953,15007,31336477.0,22427697.0,8908780.0,0.5914,0.5934,0.5909,0.5936
2023-07-17 16:05,469,316,153,36869,28123,8746,21840696.0,16631371.0,5209324.0,449,311,138,37033,28592,8441,21923420.0,16896615.0,5026804.0,0.5914,0.5956,0.591,0.5955
2023-07-17 16:10,510,377,133,60790,49645,11145,35963939.0,29340352.0,6623586.0,487,364,123,59508,49202,10306,35219984.0,29096770.0,6123214.0,0.591,0.5943,0.5914,0.5941
2023-07-17 16:15,207,146,61,24445,19772,4673,14456107.0,11687382.0,2768724.0,183,131,52,23297,19228,4069,13778377.0,11360472.0,2417905.0,0.5911,0.5925,0.5908,0.5942
2023-07-17 16:20,686,499,187,66106,48498,17608,51188586.0,40726906.0,10461679.0,647,479,168,60565,44048,16517,47758198.0,37941798.0,9816399.0,0.8398,0.5941,0.8614,0.5943
2023-07-17 16:25,426,281,145,38854,23317,15537,23009604.0,13835594.0,9174010.0,401,268,133,37071,23143,13928,21970592.0,13688630.0,8281961.0,0.5934,0.5905,0.5915,0.5946
2023-07-17 16:30,573,242,331,78172,22344,55828,46361437.0,13218609.0,33142827.0,556,229,327,77078,21358,55720,45721370.0,12633718.0,33087652.0,0.5916,0.5937,0.5915,0.5938
2023-07-17 16:35,700,221,479,87811,13554,74257,52111411.0,8017135.0,44094275.0,688,214,474,87308,13327,73981,51816048.0,7882120.0,43933927.0,0.5915,0.5938,0.5914,0.5939
2023-07-17 16:40,552,255,297,64016,19598,44418,49805251.0,23493864.0,26311386.0,533,240,293,63976,19225,44751,49797495.0,23243242.0,26554253.0,1.1988,0.5924,1.209,0.5934
2023-07-17 16:45,607,313,294,45183,23303,21880,38678821.0,25692260.0,12986561.0,579,291,288,43566,21899,21667,37693417.0,24831508.0,12861909.0,1.1025,0.5935,1.1339,0.5936
2023-07-17 16:50,420,244,176,36357,17374,18983,21528330.0,10277300.0,11251029.0,395,232,163,36345,17902,18443,21535650.0,10583982.0,10951668.0,0.5915,0.5927,0.5912,0.5938
2023-07-17 16:55,238,117,121,20202,6019,14183,11975247.0,3560394.0,8414852.0,223,111,112,20097,6017,14080,11912893.0,3558739.0,8354154.0,0.5915,0.5933,0.5914,0.5933
2023-07-17 17:00,651,344,307,71306,27242,44064,42252375.0,16109977.0,26142397.0,634,332,302,71087,27035,44052,42132622.0,15987600.0,26145021.0,0.5914,0.5933,0.5914,0.5935
2023-07-17 17:05,1052,350,702,147067,23669,123398,99071067.0,25913469.0,73157597.0,1023,332,691,144446,22028,122418,97520720.0,24901083.0,72619636.0,1.0948,0.5929,1.1304,0.5932
2023-07-17 17:10,461,161,300,59404,11325,48079,35215646.0,6695258.0,28520388.0,445,152,293,58832,11064,47768,34875488.0,6541660.0,28333828.0,0.5912,0.5932,0.5913,0.5932
2023-07-17 17:15,556,214,342,63281,16699,46582,37499731.0,9873383.0,27626348.0,541,206,335,63260,16373,46887,37493212.0,9680306.0,27812906.0,0.5913,0.5931,0.5912,0.5932
2023-07-17 17:20,1010,324,686,131855,18911,112944,78145940.0,11174929.0,66971010.0,996,319,677,131661,18923,112738,78040341.0,11178443.0,66861897.0,0.5909,0.593,0.5907,0.5931
2023-07-17 17:25,438,69,369,63726,2401,61325,37807284.0,1422622.0,36384661.0,420,62,358,63168,2236,60932,37475163.0,1321879.0,36153283.0,0.5925,0.5933,0.5912,0.5933
2023-07-17 17:30,666,95,571,72199,3896,68303,54490647.0,14187506.0,40303141.0,616,68,548,69075,3901,65174,52773078.0,14172122.0,38600956.0,3.6416,0.5901,3.6329,0.5923
2023-07-17 17:35,890,70,820,97962,1598,96364,57931017.0,955088.0,56975928.0,840,36,804,95281,1003,94278,56356427.0,585751.0,55770676.0,0.5977,0.5913,0.584,0.5916
2023-07-17 17:40,974,146,828,126898,4506,122392,75007117.0,2652422.0,72354695.0,941,125,816,125134,3485,121649,73992447.0,2050964.0,71941483.0,0.5886,0.5912,0.5885,0.5914
2023-07-17 17:45,1311,216,1095,134871,5968,128903,79738736.0,3519562.0,76219173.0,1286,202,1084,133669,5192,128477,79035887.0,3058280.0,75977606.0,0.5897,0.5913,0.589,0.5914
2023-07-17 17:50,706,183,523,79264,8901,70363,58757932.0,17135427.0,41622504.0,673,162,511,74807,5512,69295,56111400.0,15124305.0,40987095.0,1.9251,0.5915,2.7439,0.5915
2023-07-17 17:55,169,69,100,11959,2778,9181,7081302.0,1670968.0,5410333.0,141,49,92,10381,1354,9027,6146311.0,798624.0,5347687.0,0.6015,0.5893,0.5898,0.5924
2023-07-17 18:00,321,139,182,11380,1977,9403,18631927.0,13044063.0,5587864.0,307,134,173,10764,1997,8767,18249749.0,13032128.0,5217621.0,6.5979,0.5943,6.5259,0.5951
2023-07-17 18:05,357,109,248,21845,3775,18070,12951323.0,2236942.0,10714381.0,341,97,244,22820,4108,18712,13527650.0,2425499.0,11102151.0,0.5926,0.5929,0.5904,0.5933
2023-07-17 18:10,703,333,370,37468,16441,21027,22096856.0,9707273.0,12389583.0,677,318,359,35611,15793,19818,21065814.0,9322828.0,11742986.0,0.5904,0.5892,0.5903,0.5925
2023-07-17 18:15,445,212,233,23251,11039,12212,13754289.0,6520245.0,7234044.0,425,202,223,22060,10688,11372,13047519.0,6312686.0,6734833.0,0.5907,0.5924,0.5906,0.5922
2023-07-17 18:20,358,106,252,25740,6779,18961,15223554.0,3996330.0,11227224.0,349,104,245,24147,6236,17911,14278631.0,3673825.0,10604805.0,0.5895,0.5921,0.5891,0.5921
2023-07-17 18:25,93,46,47,7762,3551,4211,4593579.0,2096148.0,2497431.0,85,41,44,7630,3926,3704,4510241.0,2315127.0,2195114.0,0.5903,0.5931,0.5897,0.5926
2023-07-17 18:30,257,138,119,16067,8421,7646,9479409.0,4967415.0,4511994.0,232,121,111,14496,7090,7406,8564556.0,4181463.0,4383093.0,0.5899,0.5901,0.5898,0.5918
2023-07-17 18:35,420,211,209,21715,8412,13303,24600569.0,16840540.0,7760029.0,402,196,206,20363,7917,12446,23931212.0,16547410.0,7383801.0,2.002,0.5833,2.0901,0.5933
2023-07-18 10:00,944,487,457,48898,24673,24225,31616467.0,16701281.0,14915186.0,664,344,320,27904,15306,12598,16506529.0,9019915.0,7486614.0,0.6769,0.6157,0.5893,0.5943
2023-07-18 10:05,324,148,176,16967,6990,9977,21990151.0,16017475.0,5972676.0,234,108,126,14091,5348,8743,10655076.0,5459845.0,5195231.0,2.2915,0.5986,1.0209,0.5942
2023-07-18 10:10,977,351,626,42431,12003,30428,25048853.0,6891345.0,18157507.0,826,288,538,33502,5870,27632,19884324.0,3467913.0,16416410.0,0.5741,0.5967,0.5908,0.5941
2023-07-18 10:15,308,124,184,10948,4455,6493,6520409.0,2648069.0,3872339.0,198,73,125,6516,1854,4662,3873123.0,1094913.0,2778209.0,0.5944,0.5964,0.5906,0.5959
2023-07-18 10:20,703,163,540,95841,4587,91254,56948502.0,2713828.0,54234673.0,560,82,478,91901,4201,87700,54629267.0,2483145.0,52146122.0,0.5916,0.5943,0.5911,0.5946
2023-07-18 10:25,422,150,272,53105,7272,45833,31465954.0,4318768.0,27147186.0,369,117,252,49332,6148,43184,29243380.0,3633423.0,25609956.0,0.5939,0.5923,0.591,0.593
2023-07-18 10:30,235,124,111,11359,6312,5047,6718541.0,3723081.0,2995459.0,163,82,81,7038,4177,2861,4169122.0,2463756.0,1705366.0,0.5898,0.5935,0.5898,0.5961
2023-07-18 10:35,277,129,148,15623,8376,7247,9248929.0,4951406.0,4297523.0,221,104,117,10647,5112,5535,6302007.0,3014899.0,3287107.0,0.5911,0.593,0.5898,0.5939
2023-07-18 10:40,431,73,358,31936,4167,27769,18929859.0,2462227.0,16467632.0,376,39,337,30424,3152,27272,18030126.0,1858385.0,16171740.0,0.5909,0.593,0.5896,0.593
2023-07-18 10:45,599,71,528,45529,4738,40791,38772956.0,14686100.0,24086856.0,546,52,494,42185,4085,38100,36882965.0,14286623.0,22596342.0,3.0996,0.5905,3.4973,0.5931
2023-07-18 10:50,437,193,244,40362,11092,29270,23914851.0,6575425.0,17339426.0,374,155,219,38915,9940,28975,23024497.0,5853403.0,17171094.0,0.5928,0.5924,0.5889,0.5926
2023-07-18 10:55,396,116,280,21450,8007,13443,24627768.0,16655518.0,7972249.0,338,95,243,18057,6410,11647,22566904.0,15659768.0,6907135.0,2.0801,0.593,2.443,0.593
2023-07-18 11:00,646,219,427,45488,25902,19586,38785645.0,27211353.0,11574291.0,585,187,398,41954,24831,17123,36700125.0,26546819.0,10153306.0,1.0506,0.5909,1.0691,0.593
2023-07-18 11:05,325,138,187,22431,9027,13404,13302927.0,5372930.0,7929997.0,250,100,150,17115,6478,10637,10115519.0,3818767.0,6296752.0,0.5952,0.5916,0.5895,0.592
2023-07-18 11:10,265,92,173,25035,6048,18987,14827558.0,3587603.0,11239955.0,231,79,152,26723,5894,20829,15864972.0,3469090.0,12395882.0,0.5932,0.592,0.5886,0.5951
2023-07-18 11:15,941,296,645,69090,8602,60488,40891842.0,5075678.0,35816163.0,898,274,624,68230,7000,61230,40406413.0,4131013.0,36275399.0,0.5901,0.5921,0.5901,0.5924
2023-07-18 11:20,404,112,292,35739,7556,28183,21146174.0,4471050.0,16675124.0,346,95,251,32266,5240,27026,19104330.0,3089353.0,16014976.0,0.5917,0.5917,0.5896,0.5926
2023-07-18 11:25,387,169,218,28020,17494,10526,28557575.0,22321575.0,6235999.0,344,147,197,19646,8968,10678,23528028.0,17176594.0,6351433.0,1.276,0.5924,1.9153,0.5948
2023-07-18 11:30,392,162,230,23269,8527,14742,13796897.0,5044794.0,8752103.0,338,142,196,26694,14917,11777,15830843.0,8823803.0,7007039.0,0.5916,0.5937,0.5915,0.595
2023-07-18 11:35,455,239,216,22584,13129,9455,13413627.0,7801286.0,5612340.0,422,220,202,21713,12395,9318,12855268.0,7327475.0,5527793.0,0.5942,0.5936,0.5912,0.5932
2023-07-18 11:40,814,446,368,46318,33825,12493,27385510.0,20003332.0,7382178.0,783,429,354,46279,33770,12509,27388658.0,19958640.0,7430018.0,0.5914,0.5909,0.591,0.594
2023-07-18 11:45,264,148,116,21959,14578,7381,24841418.0,20485285.0,4356133.0,213,123,90,17612,14089,3523,22289479.0,20195913.0,2093565.0,1.4052,0.5902,1.4335,0.5943
2023-07-18 11:50,121,54,67,4579,2062,2517,2705541.0,1214296.0,1491245.0,86,34,52,2709,749,1960,1600923.0,440493.0,1160430.0,0.5889,0.5925,0.5881,0.5921
2023-07-18 11:55,64,26,38,2739,720,2019,1611377.0,424437.0,1186940.0,47,17,30,3834,2312,1522,2266033.0,1361977.0,904055.0,0.5895,0.5879,0.5891,0.594
2023-07-18 12:00,336,152,184,9972,2348,7624,5876367.0,1375440.0,4500927.0,309,135,174,8863,1374,7489,5244376.0,810279.0,4434097.0,0.5858,0.5904,0.5897,0.5921
2023-07-18 12:05,227,76,151,14187,4395,9792,8314835.0,2591668.0,5723166.0,186,51,135,10093,1526,8567,5969803.0,897189.0,5072614.0,0.5897,0.5845,0.5879,0.5921
2023-07-18 12:10,238,65,173,23553,1218,22335,13893772.0,716228.0,13177544.0,186,37,149,20886,988,19898,12354642.0,579416.0,11775226.0,0.588,0.59,0.5865,0.5918
2023-07-18 12:15,145,55,90,9160,895,8265,5424286.0,529008.0,4895278.0,115,43,72,8669,953,7716,5130543.0,558891.0,4571652.0,0.5911,0.5923,0.5865,0.5925
2023-07-18 12:20,380,137,243,33267,9874,23393,19655064.0,5827432.0,13827631.0,316,109,207,28402,6271,22131,16794350.0,3694849.0,13099501.0,0.5902,0.5911,0.5892,0.5919
2023-07-18 12:25,297,169,128,19606,11336,8270,11608590.0,6717745.0,4890845.0,245,136,109,18375,10962,7413,10860244.0,6465957.0,4394287.0,0.5926,0.5914,0.5899,0.5928
2023-07-18 12:30,248,155,93,19865,12851,7014,11764190.0,7589857.0,4174333.0,225,144,81,18313,12470,5843,10828373.0,7364343.0,3464030.0,0.5906,0.5951,0.5906,0.5929
2023-07-18 12:35,192,88,104,17589,5820,11769,10386185.0,3421127.0,6965057.0,178,82,96,15303,5640,9663,9033309.0,3316817.0,5716491.0,0.5878,0.5918,0.5881,0.5916
2023-07-18 12:40,466,173,293,46612,9479,37133,27494464.0,5592232.0,21902232.0,437,159,278,45075,9399,35676,26638302.0,5543086.0,21095215.0,0.59,0.5898,0.5898,0.5913
2023-07-18 12:45,226,88,138,24252,4396,19856,14335993.0,2592945.0,11743048.0,211,78,133,23638,4223,19415,13972318.0,2490445.0,11481873.0,0.5898,0.5914,0.5897,0.5914
2023-07-18 12:50,436,174,262,40919,10789,30130,24120554.0,6362516.0,17758037.0,406,159,247,39283,10123,29160,23214018.0,5969398.0,17244620.0,0.5897,0.5894,0.5897,0.5914
2023-07-18 12:55,1229,198,1031,159560,8392,151168,106060685.0,16816097.0,89244588.0,1172,162,1010,157540,7842,149698,104952562.0,16492145.0,88460416.0,2.0038,0.5904,2.1031,0.5909
2023-07-18 13:00,1656,217,1439,207165,4113,203052,134074664.0,14290391.0,119784273.0,1563,148,1415,205051,3757,201294,132974259.0,14076767.0,118897491.0,3.4744,0.5899,3.7468,0.5907
2023-07-18 13:05,2229,372,1857,281027,11078,269949,177620676.0,18410523.0,159210153.0,2129,297,1832,276893,9047,267846,175288552.0,17188071.0,158100481.0,1.6619,0.5898,1.8999,0.5903
2023-07-18 13:10,2955,958,1997,301555,19637,281918,177569270.0,11526132.0,166043138.0,2831,873,1958,297326,16936,280390,175178501.0,9920951.0,165257549.0,0.587,0.589,0.5858,0.5894
2023-07-18 13:15,1025,305,720,85880,8891,76989,74016930.0,28953270.0,45063660.0,921,241,680,81129,6919,74210,71433858.0,27799147.0,43634711.0,3.2565,0.5853,4.0178,0.588
2023-07-18 13:20,337,161,176,28447,15734,12713,28657070.0,21172063.0,7485007.0,297,137,160,19604,7481,12123,23405480.0,16258902.0,7146577.0,1.3456,0.5888,2.1734,0.5895
2023-07-18 13:25,1087,548,539,81079,55885,25194,47638973.0,32809266.0,14829707.0,1047,520,527,85059,60415,24644,49990325.0,35465127.0,14525198.0,0.5871,0.5886,0.587,0.5894
2023-07-18 13:30,518,218,300,36534,19596,16938,33360665.0,23380509.0,9980156.0,460,187,273,34037,18978,15059,31871535.0,22974305.0,8897230.0,1.1931,0.5892,1.2106,0.5908
2023-07-18 13:35,166,77,89,9764,4292,5472,5730770.0,2520195.0,3210574.0,134,58,76,9133,4118,5015,5382517.0,2417996.0,2964521.0,0.5872,0.5867,0.5872,0.5911
2023-07-18 13:40,92,42,50,4543,2028,2515,2619261.0,1191259.0,1428002.0,60,27,33,3183,1660,1523,1871200.0,972670.0,898529.0,0.5874,0.5678,0.5859,0.59
2023-07-18 13:45,362,167,195,22229,10771,11458,24882265.0,18199306.0,6682958.0,335,153,182,21317,10515,10802,24413831.0,18047875.0,6365956.0,1.6897,0.5833,1.7164,0.5893
2023-07-18 13:50,988,375,613,94660,26109,68551,55699892.0,15342724.0,40357168.0,938,342,596,93224,25738,67486,54843902.0,15105558.0,39738343.0,0.5876,0.5887,0.5869,0.5888
2023-07-18 13:55,3221,808,2413,410423,36310,374113,300340284.0,80664905.0,219675379.0,3070,709,2361,400712,32715,367997,294879374.0,78516603.0,216362771.0,2.2216,0.5872,2.4,0.5879
2023-07-18 14:00,2268,627,1641,241196,40167,201029,153462173.0,35468874.0,117993298.0,2146,544,1602,237219,36981,200238,151052117.0,33511764.0,117540353.0,0.883,0.5869,0.9062,0.587
2023-07-18 14:05,1032,753,279,103537,92452,11085,60686591.0,54172143.0,6514447.0,974,708,266,101856,90717,11139,59683658.0,53130767.0,6552891.0,0.5859,0.5877,0.5857,0.5883
2023-07-18 14:10,1261,683,578,133888,72224,61664,90419636.0,54180971.0,36238664.0,1212,645,567,129204,70886,58318,87685527.0,53401536.0,34283990.0,0.7502,0.5877,0.7533,0.5879
2023-07-18 14:15,723,209,514,47436,3851,43585,39735041.0,14129942.0,25605099.0,665,160,505,46147,2955,43192,38987693.0,13605848.0,25381845.0,3.6692,0.5875,4.6043,0.5877
2023-07-18 14:20,403,163,240,23759,2106,21653,25859370.0,13137100.0,12722270.0,363,132,231,24571,2206,22365,26309320.0,13166529.0,13142791.0,6.2379,0.5876,5.9685,0.5876
2023-07-18 14:25,262,102,160,14285,4011,10274,20264102.0,14223434.0,6040667.0,230,78,152,11982,1928,10054,18921665.0,13004835.0,5916830.0,3.5461,0.588,6.7452,0.5885
2023-07-18 14:30,386,140,246,22406,4660,17746,13169823.0,2721600.0,10448223.0,348,117,231,20456,2973,17483,12032925.0,1739850.0,10293075.0,0.584,0.5888,0.5852,0.5887
2023-07-18 14:35,170,67,103,6542,2045,4497,3843074.0,1205168.0,2637906.0,138,47,91,6146,2033,4113,3613707.0,1191473.0,2422234.0,0.5893,0.5866,0.5861,0.5889
2023-07-18 14:40,635,255,380,49509,10427,39082,41158837.0,18100828.0,23058009.0,581,233,348,47060,9029,38031,39619573.0,17174034.0,22445539.0,1.736,0.59,1.9021,0.5902
2023-07-18 14:45,2201,648,1553,252791,20890,231901,149223776.0,12273810.0,136949966.0,2173,625,1548,251938,20401,231537,148726126.0,11985028.0,136741097.0,0.5875,0.5906,0.5875,0.5906
2023-07-18 14:50,1687,520,1167,183008,21222,161786,107960699.0,12458863.0,95501835.0,1677,516,1161,183140,21472,161668,108044143.0,12605441.0,95438702.0,0.5871,0.5903,0.5871,0.5903
2023-07-18 14:55,2031,616,1415,240663,26367,214296,153807828.0,27346906.0,126460922.0,2002,596,1406,240381,26212,214169,153653436.0,27260742.0,126392693.0,1.0372,0.5901,1.04,0.5902
2023-07-18 15:00,2294,806,1488,236291,40790,195501,163062768.0,47697933.0,115364835.0,2274,792,1482,236410,41210,195200,163128628.0,47939929.0,115188699.0,1.1694,0.5901,1.1633,0.5901
2023-07-18 15:05,1228,497,731,124233,23594,100639,73186630.0,13853884.0,59332746.0,1211,485,726,123212,22527,100685,72585588.0,13222226.0,59363361.0,0.5872,0.5896,0.587,0.5896
2023-07-18 15:10,1514,535,979,183410,18126,165284,108244854.0,10648804.0,97596050.0,1494,518,976,183287,18160,165127,108170064.0,10666783.0,97503281.0,0.5875,0.5905,0.5874,0.5905
2023-07-18 15:15,1323,572,751,125006,20968,104038,73661282.0,12321769.0,61339512.0,1299,556,743,124779,20850,103929,73517139.0,12241343.0,61275796.0,0.5876,0.5896,0.5871,0.5896
2023-07-18 15:20,822,454,368,58370,18209,40161,46277063.0,22589081.0,23687981.0,806,443,363,57871,17787,40084,45972144.0,22329915.0,23642228.0,1.2405,0.5898,1.2554,0.5898
2023-07-18 15:25,1684,579,1105,159270,24443,134827,93914604.0,14366730.0,79547874.0,1667,573,1094,158797,24362,134435,93639095.0,14318650.0,79320445.0,0.5878,0.59,0.5877,0.59
2023-07-18 15:30,1985,758,1227,159892,35391,124501,94220255.0,20789116.0,73431139.0,1952,741,1211,158663,34665,123998,93521539.0,20376527.0,73145011.0,0.5874,0.5898,0.5878,0.5899
2023-07-18 15:35,349,164,185,21273,6222,15051,12544890.0,3660073.0,8884816.0,319,151,168,19995,5994,14001,11786577.0,3524780.0,8261796.0,0.5882,0.5903,0.5881,0.5901
2023-07-18 15:40,1254,572,682,110670,57438,53232,65256805.0,33813476.0,31443328.0,1214,554,660,107544,56182,51362,63340193.0,33015672.0,30324520.0,0.5887,0.5907,0.5877,0.5904
2023-07-18 15:45,325,171,154,18713,10602,8111,11016092.0,6239334.0,4776758.0,302,158,144,17936,10502,7434,10559163.0,6170332.0,4388831.0,0.5885,0.5889,0.5875,0.5904
2023-07-18 15:50,769,449,320,72876,52301,20575,42875809.0,30741256.0,12134553.0,758,440,318,72523,51983,20540,42670265.0,30554095.0,12116169.0,0.5878,0.5898,0.5878,0.5899
2023-07-18 15:55,1107,687,420,130986,105096,25890,77041041.0,61759752.0,15281289.0,1084,676,408,131200,106572,24628,77147082.0,62618074.0,14529007.0,0.5877,0.5902,0.5876,0.5899
2023-07-18 16:00,271,128,143,13379,8627,4752,7878156.0,5073198.0,2804958.0,198,112,86,12808,8612,4196,7541327.0,5061025.0,2480302.0,0.5881,0.5903,0.5877,0.5911
2023-07-18 16:05,131,83,48,8015,6014,2001,4723535.0,3542646.0,1180889.0,119,76,43,7783,5859,1924,4578291.0,3443688.0,1134602.0,0.5891,0.5901,0.5878,0.5897
2023-07-18 16:10,373,188,185,19165,11114,8051,11276705.0,6558038.0,4718667.0,362,180,182,18550,10855,7695,10926035.0,6384362.0,4541673.0,0.5901,0.5861,0.5881,0.5902
2023-07-18 16:15,190,115,75,12765,7456,5309,7520080.0,4386683.0,3133396.0,185,109,76,13849,7590,6259,8166692.0,4464823.0,3701869.0,0.5883,0.5902,0.5883,0.5914
2023-07-18 16:20,260,140,120,16290,8147,8143,9579793.0,4800917.0,4778876.0,234,125,109,14925,7268,7657,8795521.0,4273916.0,4521604.0,0.5893,0.5869,0.588,0.5905
2023-07-18 16:25,356,159,197,19869,6096,13773,11721721.0,3589151.0,8132569.0,352,159,193,19919,6273,13646,11749026.0,3689536.0,8059490.0,0.5888,0.5905,0.5882,0.5906
2023-07-18 16:30,264,121,143,20908,6109,14799,12328434.0,3591410.0,8737024.0,232,112,120,20176,5929,14247,11903510.0,3486220.0,8417289.0,0.5879,0.5904,0.588,0.5908
2023-07-18 16:35,257,128,129,20038,6602,13436,11798520.0,3884269.0,7914250.0,230,119,111,18839,6452,12387,11106664.0,3791414.0,7315249.0,0.5883,0.589,0.5876,0.5906
2023-07-18 16:40,604,285,319,51464,11600,39864,30307751.0,6816609.0,23491142.0,588,277,311,51479,11509,39970,30325344.0,6762721.0,23562622.0,0.5876,0.5893,0.5876,0.5895
2023-07-18 16:45,246,123,123,11026,4679,6347,6501298.0,2756677.0,3744620.0,229,118,111,10838,5074,5764,6370763.0,2970517.0,3400246.0,0.5892,0.59,0.5854,0.5899
2023-07-18 16:50,166,74,92,11380,3797,7583,6795463.0,2332469.0,4462993.0,167,59,108,10904,2372,8532,6430122.0,1394293.0,5035828.0,0.6143,0.5886,0.5878,0.5902
2023-07-18 16:55,1329,646,683,126554,43254,83300,74678398.0,25458371.0,49220027.0,1305,638,667,125489,42407,83082,74049969.0,24955071.0,49094898.0,0.5886,0.5909,0.5885,0.5909
2023-07-18 17:00,808,277,531,77603,20753,56850,45791873.0,12207602.0,33584271.0,787,268,519,76948,20391,56557,45408670.0,11994332.0,33414338.0,0.5882,0.5908,0.5882,0.5908
2023-07-18 17:05,843,248,595,87007,16478,70529,51359074.0,9697909.0,41661165.0,824,242,582,86508,16466,70042,51061695.0,9689310.0,41372384.0,0.5885,0.5907,0.5884,0.5907
2023-07-18 17:10,996,188,808,89640,14620,75020,52901746.0,8600876.0,44300870.0,975,173,802,88609,14099,74510,52303071.0,8291534.0,44011536.0,0.5883,0.5905,0.5881,0.5907
2023-07-18 17:15,1385,279,1106,146032,20629,125403,86187517.0,12127771.0,74059745.0,1367,265,1102,145448,20335,125113,85850774.0,11960564.0,73890209.0,0.5879,0.5906,0.5882,0.5906
2023-07-18 17:20,860,271,589,98097,17204,80893,57862742.0,10116901.0,47745840.0,842,265,577,96647,17245,79402,57009299.0,10138283.0,46871016.0,0.5881,0.5902,0.5879,0.5903
2023-07-18 17:25,700,452,248,56843,39745,17098,33525002.0,23427709.0,10097292.0,674,435,239,55418,38422,16996,32651846.0,22615216.0,10036630.0,0.5895,0.5906,0.5886,0.5905
2023-07-18 17:30,1840,1321,519,185417,165752,19665,145403865.0,133441680.0,11962185.0,1716,1249,467,177118,160351,16767,139994564.0,130058636.0,9935927.0,0.8051,0.6083,0.8111,0.5926
2023-07-18 17:35,1309,769,540,106160,68007,38153,86494914.0,63977556.0,22517357.0,1248,742,506,101868,67068,34800,83957018.0,63330437.0,20626580.0,0.9407,0.5902,0.9443,0.5927
2023-07-18 17:40,2579,1597,982,285352,209014,76338,261559582.0,207694958.0,53864623.0,2085,1306,779,230499,169973,60526,227733592.0,183903714.0,43829877.0,0.9937,0.7056,1.082,0.7241
2023-07-18 17:45,2427,960,1467,257432,97608,159824,194809127.0,94847520.0,99961606.0,2192,829,1363,243574,97172,146402,184134783.0,94319097.0,89815686.0,0.9717,0.6254,0.9706,0.6135
2023-07-18 17:50,1338,545,793,126336,34334,92002,88510215.0,32227408.0,56282807.0,1192,448,744,117952,26107,91845,83034530.0,27320866.0,55713663.0,0.9386,0.6118,1.0465,0.6066
2023-07-18 17:55,1053,339,714,106497,22233,84264,87909995.0,36918633.0,50991361.0,978,305,673,95262,13537,81725,80254799.0,31745713.0,48509086.0,1.6605,0.6051,2.3451,0.5936
2023-07-18 18:00,1033,244,789,117897,23660,94237,82579199.0,25850574.0,56728625.0,952,193,759,118044,26593,91451,81622231.0,27505985.0,54116246.0,1.0926,0.602,1.0343,0.5918
2023-07-18 18:05,1526,434,1092,137587,29151,108436,107750344.0,40931635.0,66818708.0,1448,372,1076,133723,26301,107422,103748637.0,39221908.0,64526729.0,1.4041,0.6162,1.4913,0.6007
2023-07-18 18:10,611,302,309,45680,17814,27866,26957312.0,10476221.0,16481090.0,584,281,303,44990,16134,28856,26567626.0,9493605.0,17074020.0,0.5881,0.5914,0.5884,0.5917
2023-07-18 18:15,837,440,397,62240,21093,41147,36741524.0,12424685.0,24316839.0,778,390,388,61702,21223,40479,36404477.0,12482429.0,23922048.0,0.589,0.591,0.5882,0.591
2023-07-18 18:20,586,274,312,51752,14698,37054,30527067.0,8645318.0,21881749.0,556,263,293,49155,14052,35103,28986288.0,8264078.0,20722210.0,0.5882,0.5905,0.5881,0.5903
2023-07-18 18:25,155,64,91,10674,4768,5906,7425370.0,2817013.0,4608357.0,134,46,88,8795,2972,5823,5185971.0,1747242.0,3438729.0,0.5908,0.7803,0.5879,0.5905
2023-07-18 18:30,130,61,69,7590,3281,4309,4466087.0,1928145.0,2537942.0,98,34,64,5983,1715,4268,3529251.0,1008577.0,2520674.0,0.5877,0.589,0.5881,0.5906
2023-07-18 18:35,427,200,227,27611,10681,16930,17387159.0,6321256.0,11065902.0,400,180,220,25873,8636,17237,16876087.0,5088225.0,11787862.0,0.5918,0.6536,0.5892,0.6839
2023-07-19 10:00,3289,1343,1946,299982,156339,143643,204476524.0,119293893.0,85182631.0,2968,1178,1790,277795,146245,131550,180656976.0,102918762.0,77738213.0,0.763,0.593,0.7037,0.5909
2023-07-19 10:05,1141,438,703,73338,22980,50358,43333680.0,13532432.0,29801247.0,1060,393,667,67511,19765,47746,39843793.0,11627006.0,28216786.0,0.5889,0.5918,0.5883,0.591
2023-07-19 10:10,1751,806,945,169364,42783,126581,112843889.0,37205993.0,75637896.0,1649,745,904,148585,36996,111589,98582877.0,32526873.0,66056003.0,0.8696,0.5975,0.8792,0.592
2023-07-19 10:15,1160,588,572,80443,32725,47718,47715744.0,19447495.0,28268249.0,1044,513,531,74664,29343,45321,44209728.0,17345098.0,26864629.0,0.5943,0.5924,0.5911,0.5928
2023-07-19 10:20,908,470,438,72856,30402,42454,43096207.0,17988130.0,25108077.0,744,363,381,69231,28121,41110,40974786.0,16609669.0,24365117.0,0.5917,0.5914,0.5907,0.5927
2023-07-19 10:25,888,593,295,64480,36383,28097,38080266.0,21527018.0,16553247.0,827,557,270,60026,35020,25006,35506142.0,20693860.0,14812281.0,0.5917,0.5891,0.5909,0.5923
2023-07-19 10:30,1574,948,626,169209,111565,57644,135864346.0,101697281.0,34167064.0,1464,881,583,160653,105001,55652,130675644.0,97691826.0,32983818.0,0.9116,0.5927,0.9304,0.5927
2023-07-19 10:35,1744,1117,627,201983,145915,56068,131362892.0,98188829.0,33174063.0,1636,1034,602,197982,145616,52366,129064685.0,97987351.0,31077334.0,0.6729,0.5917,0.6729,0.5935
2023-07-19 10:40,1572,830,742,157118,67853,89265,93038583.0,40155772.0,52882810.0,1358,659,699,148682,61839,86843,88062493.0,36563671.0,51498821.0,0.5918,0.5924,0.5913,0.593
2023-07-19 10:45,1743,878,865,247080,34963,212117,146399660.0,20722728.0,125676932.0,1616,772,844,243913,33955,209958,144568298.0,20092910.0,124475387.0,0.5927,0.5925,0.5918,0.5929
2023-07-19 10:50,1151,667,484,131006,78720,52286,89698874.0,58635307.0,31063566.0,1042,586,456,125378,75153,50225,86259350.0,56413076.0,29846274.0,0.7449,0.5941,0.7506,0.5943
2023-07-19 10:55,846,383,463,91352,23487,67865,54263440.0,13946625.0,40316815.0,718,294,424,83073,19247,63826,49350867.0,11409885.0,37940982.0,0.5938,0.5941,0.5928,0.5944
2023-07-19 11:00,1684,988,696,148729,54231,94498,100566717.0,44153583.0,56413133.0,1414,775,639,153035,50203,102832,103538853.0,41633281.0,61905572.0,0.8142,0.597,0.8293,0.602
2023-07-19 11:05,2264,1001,1263,209917,67401,142516,136555659.0,51851730.0,84703929.0,2024,809,1215,204284,65433,138851,133226553.0,50659786.0,82566767.0,0.7693,0.5943,0.7742,0.5946
2023-07-19 11:10,1278,668,610,102192,42308,59884,60540534.0,25072396.0,35468137.0,1210,617,593,97411,40237,57174,57831364.0,23842397.0,33988966.0,0.5926,0.5923,0.5925,0.5945
2023-07-19 11:15,1259,480,779,136781,37169,99612,92879837.0,33847949.0,59031887.0,1152,423,729,128920,33905,95015,88277315.0,31909036.0,56368279.0,0.9106,0.5926,0.9411,0.5933
2023-07-19 11:20,510,205,305,63155,15928,47227,37441975.0,9525657.0,27916318.0,458,185,273,55645,12776,42869,33125555.0,7533545.0,25592009.0,0.598,0.5911,0.5897,0.597
2023-07-19 11:25,661,470,191,78318,36329,41989,46690553.0,21478586.0,25211967.0,609,438,171,73208,33415,39793,43690824.0,19729360.0,23961464.0,0.5912,0.6004,0.5904,0.6022
2023-07-19 11:30,468,329,139,56306,26010,30296,33295314.0,15345702.0,17949612.0,424,303,121,50490,21906,28584,29870964.0,12935962.0,16935002.0,0.59,0.5925,0.5905,0.5925
2023-07-19 11:35,456,326,130,54031,46388,7643,44040261.0,39335346.0,4704915.0,380,298,82,49061,44250,4811,40921144.0,38059826.0,2861318.0,0.848,0.6156,0.8601,0.5947
2023-07-19 11:40,1349,1077,272,205880,201805,4075,121938421.0,119514692.0,2423729.0,1325,1065,260,205243,201394,3849,121515234.0,119224949.0,2290284.0,0.5922,0.5948,0.592,0.595
2023-07-19 11:45,1298,1072,226,235552,217811,17741,139503648.0,128920241.0,10583406.0,1257,1052,205,231060,215820,15240,136777397.0,127724585.0,9052812.0,0.5919,0.5966,0.5918,0.594
2023-07-19 11:50,957,661,296,117392,92534,24858,69626015.0,54773264.0,14852751.0,939,647,292,115674,92140,23534,68520443.0,54537295.0,13983147.0,0.5919,0.5975,0.5919,0.5942
2023-07-19 11:55,1018,730,288,145942,112774,33168,98364355.0,78694476.0,19669879.0,977,709,268,139845,108207,31638,94781224.0,75977646.0,18803578.0,0.6978,0.593,0.7022,0.5943
2023-07-19 12:00,380,157,223,37372,13919,23453,22182304.0,8248017.0,13934286.0,347,139,208,38739,15846,22893,22991064.0,9381236.0,13609828.0,0.5926,0.5941,0.592,0.5945
2023-07-19 12:05,649,327,322,71962,27688,44274,66406615.0,40126393.0,26280221.0,611,304,307,68360,26817,41543,64283694.0,39616750.0,24666944.0,1.4492,0.5936,1.4773,0.5938
2023-07-19 12:10,433,169,264,56916,14491,42425,33687024.0,8550217.0,25136807.0,408,154,254,54957,13749,41208,32532604.0,8112828.0,24419776.0,0.59,0.5925,0.5901,0.5926
2023-07-19 12:15,398,161,237,39862,11524,28338,23589254.0,6775010.0,16814244.0,367,142,225,38047,10373,27674,22511443.0,6112322.0,16399121.0,0.5879,0.5933,0.5893,0.5926
2023-07-19 12:20,483,375,108,45067,34261,10806,38581327.0,32163507.0,6417820.0,424,344,80,41940,31843,10097,36695671.0,30703830.0,5991840.0,0.9388,0.5939,0.9642,0.5934
2023-07-19 12:25,947,840,107,101813,94612,7201,60255610.0,55976249.0,4279360.0,922,825,97,101599,94132,7467,60150030.0,55695137.0,4454893.0,0.5916,0.5943,0.5917,0.5966
2023-07-19 12:30,2021,1899,122,339486,333133,6353,200937137.0,197156067.0,3781070.0,1986,1883,103,337083,331597,5486,199491023.0,196226748.0,3264274.0,0.5918,0.5952,0.5918,0.595
2023-07-19 12:35,647,582,65,96289,90235,6054,57029906.0,53430988.0,3598917.0,634,574,60,95744,90343,5401,56685605.0,53476103.0,3209502.0,0.5921,0.5945,0.5919,0.5942
2023-07-19 12:40,894,783,111,131726,122598,9128,78064789.0,72642860.0,5421929.0,871,768,103,129055,120042,9013,76402978.0,71041266.0,5361711.0,0.5925,0.594,0.5918,0.5949
2023-07-19 12:45,525,434,91,81961,72141,9820,60443212.0,54608322.0,5834889.0,494,419,75,80526,71745,8781,59592271.0,54370308.0,5221963.0,0.757,0.5942,0.7578,0.5947
2023-07-19 12:50,263,175,88,28612,22934,5678,16959981.0,13582922.0,3377059.0,248,165,83,26461,20929,5532,15686610.0,12396133.0,3290477.0,0.5923,0.5948,0.5923,0.5948
2023-07-19 12:55,474,353,121,61653,52178,9475,36545037.0,30914646.0,5630391.0,460,344,116,61024,51738,9286,36165647.0,30643932.0,5521715.0,0.5925,0.5942,0.5923,0.5946
2023-07-19 13:00,939,710,229,160134,141391,18743,94919971.0,83773765.0,11146205.0,920,698,222,159766,141081,18685,94702873.0,83592020.0,11110853.0,0.5925,0.5947,0.5925,0.5946
2023-07-19 13:05,493,266,227,39871,30233,9638,23695186.0,17955561.0,5739624.0,459,252,207,36851,28077,8774,21879941.0,16655175.0,5224766.0,0.5939,0.5955,0.5932,0.5955
2023-07-19 13:10,642,332,310,43956,32231,11725,38008924.0,31050896.0,6958027.0,610,317,293,41138,30571,10567,36327125.0,30031549.0,6295575.0,0.9634,0.5934,0.9824,0.5958
2023-07-19 13:15,389,192,197,27672,17221,10451,16463298.0,10230025.0,6233272.0,380,186,194,25345,16608,8737,15069911.0,9863239.0,5206671.0,0.594,0.5964,0.5939,0.5959
2023-07-19 13:20,686,383,303,62113,35853,26260,48822342.0,33199049.0,15623292.0,632,336,296,55710,30769,24941,44997076.0,30144801.0,14852275.0,0.926,0.5949,0.9797,0.5955
2023-07-19 13:25,1027,482,545,85878,38394,47484,51030940.0,22798216.0,28232724.0,993,454,539,88811,40920,47891,52779116.0,24282350.0,28496766.0,0.5938,0.5946,0.5934,0.595
2023-07-19 13:30,697,345,352,65431,29161,36270,38866472.0,17303633.0,21562838.0,652,313,339,64250,28856,35394,38177952.0,17118322.0,21059630.0,0.5934,0.5945,0.5932,0.595
2023-07-19 13:35,580,296,284,58833,21927,36906,36545402.0,12988329.0,23557073.0,548,271,277,55851,21234,34617,34128298.0,12568561.0,21559736.0,0.5923,0.6383,0.5919,0.6228
2023-07-19 13:40,745,388,357,83162,30730,52432,61884316.0,30059409.0,31824907.0,670,323,347,81104,29474,51630,60750914.0,29314168.0,31436746.0,0.9782,0.607,0.9946,0.6089
2023-07-19 13:45,996,330,666,128243,25779,102464,100186777.0,38970785.0,61215992.0,946,289,657,125859,24306,101553,99027245.0,38094547.0,60932698.0,1.5117,0.5974,1.5673,0.6
2023-07-19 13:50,1426,796,630,145603,51574,94029,86271217.0,30492412.0,55778805.0,1385,763,622,145573,51238,94335,86252367.0,30293484.0,55958883.0,0.5912,0.5932,0.5912,0.5932
2023-07-19 13:55,1139,580,559,126974,49881,77093,75203446.0,29539511.0,45663935.0,1096,545,551,124084,48400,75684,73441491.0,28592326.0,44849165.0,0.5922,0.5923,0.5908,0.5926
2023-07-19 14:00,592,302,290,60978,25259,35719,36116068.0,14937308.0,21178759.0,561,282,279,59780,23909,35871,35399695.0,14134010.0,21265685.0,0.5914,0.5929,0.5912,0.5928
2023-07-19 14:05,830,518,312,72447,48359,24088,54832602.0,40531244.0,14301358.0,762,475,287,69311,46759,22552,52956953.0,39558986.0,13397967.0,0.8381,0.5937,0.846,0.5941
2023-07-19 14:10,1284,898,386,151464,121404,30060,89721077.0,71957834.0,17763243.0,1239,881,358,146268,120563,25705,86668583.0,71394994.0,15273588.0,0.5927,0.5909,0.5922,0.5942
2023-07-19 14:15,875,414,461,67404,25657,41747,39910850.0,15176184.0,24734666.0,832,375,457,66414,24890,41524,39348585.0,14721251.0,24627333.0,0.5915,0.5925,0.5915,0.5931
2023-07-19 14:20,487,141,346,44321,12313,32008,27383531.0,7287006.0,20096524.0,464,128,336,43335,11815,31520,25681679.0,6989003.0,18692676.0,0.5918,0.6279,0.5915,0.593
2023-07-19 14:25,240,61,179,20764,6462,14302,12333893.0,3849062.0,8484830.0,224,48,176,19057,4944,14113,11297732.0,2923502.0,8374229.0,0.5956,0.5933,0.5913,0.5934
2023-07-19 14:30,198,110,88,10458,3722,6736,9511211.0,3866069.0,5645142.0,162,80,82,9187,3039,6148,7108322.0,3461208.0,3647113.0,1.0387,0.8381,1.1389,0.5932
2023-07-19 14:35,398,200,198,26172,10322,15850,15512522.0,6118399.0,9394123.0,384,195,189,25586,9936,15650,15157845.0,5880408.0,9277436.0,0.5928,0.5927,0.5918,0.5928
2023-07-19 14:40,518,264,254,35846,15818,20028,21341574.0,9447508.0,11894066.0,482,245,237,34131,14504,19627,20234475.0,8586544.0,11647931.0,0.5973,0.5939,0.592,0.5935
2023-07-19 14:45,434,252,182,23890,11660,12230,14181846.0,6910613.0,7271232.0,401,230,171,23131,11206,11925,13721330.0,6640456.0,7080874.0,0.5927,0.5945,0.5926,0.5938
2023-07-19 14:50,899,551,348,69914,45497,24417,41475634.0,26966267.0,14509367.0,864,523,341,70062,44483,25579,41565399.0,26358321.0,15207078.0,0.5927,0.5942,0.5925,0.5945
2023-07-19 14:55,602,365,237,52344,28538,23806,30997441.0,16898254.0,14099186.0,574,342,232,51076,28102,22974,30291393.0,16639113.0,13652279.0,0.5921,0.5923,0.5921,0.5942
2023-07-19 15:00,1274,861,413,115128,84003,31125,68236731.0,49747000.0,18489731.0,1252,845,407,113853,83689,30164,67472839.0,49560199.0,17912640.0,0.5922,0.594,0.5922,0.5938
2023-07-19 15:05,503,312,191,36840,23478,13362,21854271.0,13917784.0,7936487.0,482,297,185,36485,23133,13352,21633086.0,13703950.0,7929136.0,0.5928,0.594,0.5924,0.5939
2023-07-19 15:10,303,216,87,23906,17228,6678,14173853.0,10206613.0,3967239.0,280,199,81,23552,16489,7063,14053860.0,9766582.0,4287277.0,0.5924,0.5941,0.5923,0.607
2023-07-19 15:15,803,441,362,67229,41397,25832,39893927.0,24539686.0,15354241.0,778,420,358,66727,40880,25847,39593951.0,24230209.0,15363741.0,0.5928,0.5944,0.5927,0.5944
2023-07-19 15:20,343,235,108,21304,14862,6442,12637346.0,8807448.0,3829898.0,346,241,105,21065,14739,6326,12495709.0,8734987.0,3760722.0,0.5926,0.5945,0.5926,0.5945
2023-07-19 15:25,987,782,205,85581,70556,15025,50752035.0,41832950.0,8919084.0,958,762,196,84682,69599,15083,50212100.0,41243835.0,8968264.0,0.5929,0.5936,0.5926,0.5946
2023-07-19 15:30,589,379,210,54716,41971,12745,32449937.0,24875617.0,7574319.0,580,371,209,54284,41761,12523,32202160.0,24750478.0,7451681.0,0.5927,0.5943,0.5927,0.595
2023-07-19 15:35,572,354,218,58970,41811,17159,34988752.0,24790227.0,10198524.0,555,346,209,57584,41345,16239,34156552.0,24504597.0,9651955.0,0.5929,0.5944,0.5927,0.5944
2023-07-19 15:40,75,40,35,7623,5043,2580,4526988.0,2990378.0,1536609.0,66,34,32,8553,5203,3350,5077192.0,3081731.0,1995460.0,0.593,0.5956,0.5923,0.5957
2023-07-19 15:45,137,71,66,12285,4460,7825,7296436.0,2644782.0,4651654.0,120,60,60,9778,4328,5450,5801985.0,2563373.0,3238611.0,0.593,0.5945,0.5923,0.5942
2023-07-19 15:50,447,218,229,41665,21670,19995,24718063.0,12842924.0,11875139.0,425,204,221,41065,21459,19606,24340426.0,12705254.0,11635172.0,0.5927,0.5939,0.5921,0.5934
2023-07-19 15:55,228,108,120,25041,13182,11859,14846902.0,7813044.0,7033858.0,225,103,122,25154,13115,12039,14919839.0,7768993.0,7150845.0,0.5927,0.5931,0.5924,0.594
2023-07-19 16:00,326,154,172,29757,17083,12674,17608789.0,10108088.0,7500701.0,308,143,165,29163,16512,12651,17276586.0,9770468.0,7506118.0,0.5917,0.5918,0.5917,0.5933
2023-07-19 16:05,419,201,218,27926,14397,13529,16555448.0,8522666.0,8032781.0,398,189,209,27470,14111,13359,16279263.0,8351732.0,7927531.0,0.592,0.5937,0.5919,0.5934
2023-07-19 16:10,251,109,142,23056,11977,11079,13681344.0,7111171.0,6570173.0,230,93,137,21750,11903,9847,12903565.0,7051210.0,5852355.0,0.5937,0.593,0.5924,0.5943
2023-07-19 16:15,422,169,253,49952,11697,38255,29626841.0,6920430.0,22706410.0,402,155,247,49030,11656,37374,29078910.0,6894481.0,22184429.0,0.5916,0.5936,0.5915,0.5936
2023-07-19 16:20,358,191,167,46055,16691,29364,40013264.0,21751326.0,18261938.0,326,167,159,36642,16268,20374,33599050.0,21499096.0,12099953.0,1.3032,0.6219,1.3216,0.5939
2023-07-19 16:25,1283,514,769,108746,34483,74263,91712927.0,44043033.0,47669894.0,1193,439,754,100825,29512,71313,86917608.0,41115090.0,45802518.0,1.2772,0.6419,1.3932,0.6423
2023-07-19 16:30,363,108,255,24564,4452,20112,15524138.0,2619270.0,12904868.0,325,84,241,23584,3725,19859,14929795.0,2187907.0,12741887.0,0.5883,0.6417,0.5874,0.6416
2023-07-19 16:35,520,281,239,49611,26023,23588,37304364.0,15319102.0,21985262.0,472,246,226,46393,23928,22465,35213800.0,14074693.0,21139107.0,0.5887,0.9321,0.5882,0.941
2023-07-19 16:40,594,294,300,63007,34151,28856,48092927.0,20096484.0,27996443.0,563,269,294,64953,36295,28658,49285053.0,21310347.0,27974705.0,0.5885,0.9702,0.5871,0.9762
2023-07-19 16:45,2556,1561,995,370321,257770,112551,240524098.0,164113208.0,76410890.0,2427,1468,959,357548,247303,110245,232915857.0,157470385.0,75445472.0,0.6367,0.6789,0.6368,0.6843
2023-07-19 16:50,2504,1734,770,325302,249203,76099,203663406.0,158622522.0,45040884.0,2441,1673,768,323325,248075,75250,202494257.0,157948579.0,44545678.0,0.6365,0.5919,0.6367,0.592
2023-07-19 16:55,785,372,413,81735,19276,62459,60261773.0,23242770.0,37019002.0,740,341,399,80607,18442,62165,59589536.0,22747084.0,36842451.0,1.2058,0.5927,1.2334,0.5927
2023-07-19 17:00,1450,286,1164,186938,13618,173320,134451472.0,31768894.0,102682578.0,1412,255,1157,185101,13064,172037,133375357.0,31443169.0,101932188.0,2.3329,0.5924,2.4069,0.5925
2023-07-19 17:05,1093,335,758,93523,15201,78322,55309825.0,8953104.0,46356721.0,1067,316,751,91564,14295,77269,54142416.0,8411377.0,45731038.0,0.589,0.5919,0.5884,0.5918
2023-07-19 17:10,203,90,113,12962,3221,9741,7668507.0,1902432.0,5766074.0,184,80,104,14479,4915,9564,8530725.0,2867545.0,5663180.0,0.5906,0.5919,0.5834,0.5921
2023-07-19 17:15,794,239,555,83853,5235,78618,49575507.0,3086337.0,46489170.0,771,223,548,82828,5060,77768,49007588.0,2980400.0,46027187.0,0.5896,0.5913,0.589,0.5919
2023-07-19 17:20,802,225,577,93067,5531,87536,55135418.0,3295399.0,51840018.0,786,207,579,92965,5024,87941,55048932.0,2961853.0,52087079.0,0.5958,0.5922,0.5895,0.5923
2023-07-19 17:25,485,212,273,59175,19815,39360,35007515.0,11696449.0,23311066.0,453,196,257,54317,16359,37958,32128669.0,9642255.0,22486414.0,0.5903,0.5923,0.5894,0.5924
2023-07-19 17:30,1237,519,718,126948,83743,43205,86920560.0,61323020.0,25597540.0,1195,500,695,122900,81936,40964,84517095.0,60248478.0,24268617.0,0.7323,0.5925,0.7353,0.5924
2023-07-19 17:35,877,510,367,101275,82574,18701,60963382.0,48754375.0,12209006.0,865,503,362,101182,82136,19046,59778020.0,48484571.0,11293449.0,0.5904,0.6529,0.5903,0.593
2023-07-19 17:40,625,468,157,91776,80987,10789,54248139.0,47864170.0,6383969.0,610,460,150,91173,80606,10567,53885525.0,47621014.0,6264511.0,0.591,0.5917,0.5908,0.5928
2023-07-19 17:45,422,249,173,50771,34447,16324,30010883.0,20345060.0,9665823.0,401,235,166,50176,34008,16168,29665217.0,20088448.0,9576769.0,0.5906,0.5921,0.5907,0.5923
2023-07-19 17:50,432,334,98,54357,42717,11640,32132004.0,25236333.0,6895670.0,421,324,97,53554,42629,10925,31658071.0,25184553.0,6473518.0,0.5908,0.5924,0.5908,0.5925
2023-07-19 17:55,258,123,135,24984,8108,16876,14792244.0,4788776.0,10003468.0,241,118,123,24604,8048,16556,14565441.0,4751186.0,9814254.0,0.5906,0.5928,0.5904,0.5928
2023-07-19 18:00,364,79,285,30901,5992,24909,18289983.0,3541929.0,14748053.0,353,71,282,31501,6325,25176,18621564.0,3713554.0,14908010.0,0.5911,0.5921,0.5871,0.5922
2023-07-19 18:05,280,186,94,24449,15256,9193,14448010.0,9005080.0,5442930.0,272,180,92,24998,16812,8186,14752022.0,9904195.0,4847826.0,0.5903,0.5921,0.5891,0.5922
2023-07-19 18:10,739,201,538,116889,14291,102598,69190418.0,8448877.0,60741541.0,721,193,528,116354,14117,102237,68873582.0,8330631.0,60542951.0,0.5912,0.592,0.5901,0.5922
2023-07-19 18:15,177,107,70,20251,10187,10064,11971791.0,6011519.0,5960272.0,168,97,71,17081,6946,10135,10100534.0,4097276.0,6003258.0,0.5901,0.5922,0.5899,0.5923
2023-07-19 18:20,382,203,179,22749,6580,16169,13465326.0,3891593.0,9573732.0,376,198,178,22637,6447,16190,13393279.0,3805655.0,9587623.0,0.5914,0.5921,0.5903,0.5922
2023-07-19 18:25,557,375,182,43838,24722,19116,25917412.0,14600219.0,11317192.0,554,373,181,44897,25987,18910,26539786.0,15341321.0,11198465.0,0.5906,0.592,0.5903,0.5922
2023-07-19 18:30,553,265,288,47683,19052,28631,28243594.0,11293124.0,16950470.0,531,254,277,45940,18323,27617,27170488.0,10820377.0,16350111.0,0.5928,0.592,0.5905,0.592
2023-07-19 18:35,460,226,234,40917,18513,22404,24227687.0,10961749.0,13265937.0,443,220,223,40600,18044,22556,24003048.0,10646359.0,13356689.0,0.5921,0.5921,0.59,0.5922
2023-07-20 10:00,2238,1124,1114,198028,104033,93995,127055289.0,70745893.0,56309395.0,1953,986,967,174682,95346,79336,105652970.0,58535083.0,47117887.0,0.68,0.5991,0.6139,0.5939
2023-07-20 10:05,2410,1095,1315,214554,80725,133829,146749429.0,67303406.0,79446023.0,2331,1068,1263,206618,79763,126855,137262900.0,61997564.0,75265335.0,0.8337,0.5936,0.7773,0.5933
2023-07-20 10:10,2422,683,1739,223426,26358,197068,155968378.0,39281205.0,116687172.0,2318,632,1686,217458,22848,194610,152469531.0,37213226.0,115256304.0,1.4903,0.5921,1.6287,0.5922
2023-07-20 10:15,1363,325,1038,131786,16550,115236,90848629.0,21582954.0,69265674.0,1276,284,992,128757,15173,113584,88059426.0,20809050.0,67250375.0,1.3041,0.6011,1.3715,0.5921
2023-07-20 10:20,2387,742,1645,263508,39484,224024,179498093.0,46978593.0,132519500.0,2207,629,1578,260564,37257,223307,177770087.0,45666947.0,132103139.0,1.1898,0.5915,1.2257,0.5916
2023-07-20 10:25,1884,732,1152,238359,33541,204818,141588041.0,19771015.0,121817026.0,1829,698,1131,236620,31073,205547,139988881.0,18302191.0,121686690.0,0.5895,0.5948,0.589,0.592
2023-07-20 10:30,246,131,115,13867,7648,6219,20625509.0,16408116.0,4217392.0,203,117,86,15228,10165,5063,20866175.0,17864077.0,3002098.0,2.1454,0.6781,1.7574,0.5929
2023-07-20 10:35,704,519,185,42201,31977,10224,36874363.0,30754848.0,6119514.0,655,483,172,38737,29565,9172,34729976.0,29295602.0,5434374.0,0.9618,0.5985,0.9909,0.5925
2023-07-20 10:40,1831,950,881,189235,79920,109315,148731114.0,82803139.0,65927974.0,1694,883,811,170120,67601,102519,137443011.0,75532790.0,61910221.0,1.0361,0.6031,1.1173,0.6039
2023-07-20 10:45,3285,1141,2144,299980,67667,232313,201425245.0,63729984.0,137695260.0,3220,1117,2103,296595,67203,229392,199407000.0,63418541.0,135988459.0,0.9418,0.5927,0.9437,0.5928
2023-07-20 10:50,1174,264,910,137765,12588,125177,93226016.0,19280444.0,73945572.0,1133,239,894,136085,11985,124100,92436871.0,18929939.0,73506931.0,1.5317,0.5907,1.5795,0.5923
2023-07-20 10:55,2358,560,1798,292767,31252,261515,173023778.0,18396627.0,154627151.0,2318,543,1775,291423,30783,260640,172244940.0,18117610.0,154127330.0,0.5887,0.5913,0.5886,0.5913
2023-07-20 11:00,594,238,356,50240,15660,34580,29652633.0,9216883.0,20435750.0,562,222,340,49662,15386,34276,29305676.0,9054984.0,20250692.0,0.5886,0.591,0.5885,0.5908
2023-07-20 11:05,1015,258,757,120056,14488,105568,70887410.0,8505818.0,62381591.0,993,243,750,119050,14003,105047,70318732.0,8233449.0,62085282.0,0.5871,0.5909,0.588,0.591
2023-07-20 11:10,560,162,398,65806,9863,55943,38861855.0,5795929.0,33065926.0,521,146,375,65077,9879,55198,38434393.0,5800441.0,32633951.0,0.5876,0.5911,0.5871,0.5912
2023-07-20 11:15,1377,624,753,155034,39160,115874,104414183.0,34899954.0,69514229.0,1337,593,744,152783,37428,115355,103130763.0,33867003.0,69263760.0,0.8912,0.5999,0.9049,0.6004
2023-07-20 11:20,1501,658,843,127201,38466,88735,145342778.0,93720908.0,51621870.0,1197,473,724,110526,32201,78325,135906787.0,90035607.0,45871180.0,2.4365,0.5818,2.7961,0.5857
2023-07-20 11:25,730,406,324,49749,17493,32256,40856632.0,22037873.0,18818759.0,501,244,257,42536,12351,30185,36711839.0,19051538.0,17660301.0,1.2598,0.5834,1.5425,0.5851
2023-07-20 11:30,1853,570,1283,225647,24762,200885,143392968.0,26224296.0,117168672.0,1778,499,1279,224227,24370,199857,142607306.0,26001541.0,116605765.0,1.0591,0.5833,1.0669,0.5834
2023-07-20 11:35,1569,489,1080,169898,20818,149080,99094762.0,12124897.0,86969864.0,1488,435,1053,166046,18865,147181,96824137.0,10958247.0,85865889.0,0.5824,0.5834,0.5809,0.5834
2023-07-20 11:40,836,270,566,107640,11768,95872,77612703.0,18729213.0,58883489.0,796,247,549,104789,10282,94507,73106639.0,17855809.0,55250830.0,1.5915,0.6142,1.7366,0.5846
2023-07-20 11:45,1536,469,1067,165982,16896,149086,108539652.0,21686540.0,86853111.0,1444,405,1039,161132,13781,147351,105843280.0,19875461.0,85967818.0,1.2835,0.5826,1.4422,0.5834
2023-07-20 11:50,952,448,504,59843,16298,43545,46604323.0,21321650.0,25282672.0,742,280,462,49968,12520,37448,40914395.0,19119629.0,21794766.0,1.3082,0.5806,1.5271,0.582
2023-07-20 11:55,277,169,108,15907,6227,9680,9280615.0,3649532.0,5631083.0,185,94,91,12697,4046,8651,7387200.0,2338051.0,5049149.0,0.5861,0.5817,0.5779,0.5836
2023-07-20 12:00,150,70,80,11607,3934,7673,6787091.0,2321922.0,4465169.0,113,43,70,9812,2569,7243,5701761.0,1482811.0,4218949.0,0.5902,0.5819,0.5772,0.5825
2023-07-20 12:05,506,234,272,33284,15140,18144,19239340.0,8721043.0,10518297.0,471,207,264,34297,14102,20195,20943041.0,8138769.0,12804272.0,0.576,0.5797,0.5771,0.634
2023-07-20 12:10,1524,732,792,108749,33595,75154,110273416.0,66856158.0,43417258.0,1300,572,728,100639,28951,71688,105649698.0,64150664.0,41499033.0,1.9901,0.5777,2.2158,0.5789
2023-07-20 12:15,958,718,240,52774,41911,10863,31289906.0,24185911.0,7103995.0,866,662,204,49428,40185,9243,28546311.0,23174834.0,5371477.0,0.5771,0.654,0.5767,0.5811
2023-07-20 12:20,1637,1247,390,170980,152458,18522,110742318.0,99980183.0,10762135.0,1515,1151,364,165074,148193,16881,107178177.0,97364130.0,9814047.0,0.6558,0.581,0.657,0.5814
2023-07-20 12:25,388,212,176,24005,13428,10577,25833879.0,19662933.0,6170946.0,319,167,152,20098,10844,9254,23562604.0,18162328.0,5400275.0,1.4643,0.5834,1.6749,0.5836
2023-07-20 12:30,486,353,133,33450,23244,10206,19452743.0,13490975.0,5961768.0,447,328,119,32155,21994,10161,18706439.0,12762909.0,5943530.0,0.5804,0.5841,0.5803,0.5849
2023-07-20 12:35,713,441,272,59092,42985,16107,47049381.0,36818970.0,10230410.0,670,414,256,56770,41613,15157,45678471.0,36004972.0,9673498.0,0.8566,0.6352,0.8652,0.6382
2023-07-20 12:40,1464,689,775,112553,38633,73920,77422212.0,34274803.0,43147409.0,1420,659,761,108023,37228,70795,74857947.0,33493491.0,41364455.0,0.8872,0.5837,0.8997,0.5843
2023-07-20 12:45,2303,852,1451,217879,45761,172118,127019780.0,26569104.0,100450675.0,2266,829,1437,218845,45144,173701,127559508.0,26189252.0,101370255.0,0.5806,0.5836,0.5801,0.5836
2023-07-20 12:50,1257,739,518,73042,39132,33910,54405393.0,34616761.0,19788632.0,1231,717,514,72276,38666,33610,53949301.0,34338514.0,19610787.0,0.8846,0.5836,0.8881,0.5835
2023-07-20 12:55,1606,985,621,87455,55001,32454,62839086.0,43878533.0,18960552.0,1565,957,608,86485,54155,32330,62262940.0,43369019.0,18893920.0,0.7978,0.5842,0.8008,0.5844
2023-07-20 13:00,1050,667,383,63949,37972,25977,49168702.0,33975027.0,15193675.0,1040,664,376,63494,37646,25848,48898672.0,33780002.0,15118669.0,0.8947,0.5849,0.8973,0.5849
2023-07-20 13:05,864,505,359,43924,26129,17795,25610243.0,15201594.0,10408649.0,849,497,352,43357,25898,17459,25273432.0,15067558.0,10205874.0,0.5818,0.5849,0.5818,0.5846
2023-07-20 13:10,357,199,158,22320,12594,9726,13013866.0,7329130.0,5684736.0,345,191,154,22293,12567,9726,12996136.0,7311447.0,5684689.0,0.582,0.5845,0.5818,0.5845
2023-07-20 13:15,168,115,53,8612,6393,2219,5024399.0,3721204.0,1303194.0,154,109,45,8246,6407,1839,4806300.0,3724999.0,1081301.0,0.5821,0.5873,0.5814,0.588
2023-07-20 13:20,511,291,220,21651,12746,8905,12619945.0,7417155.0,5202789.0,488,275,213,21300,12672,8628,12412118.0,7371848.0,5040269.0,0.5819,0.5843,0.5817,0.5842
2023-07-20 13:25,415,199,216,19492,8156,11336,11368603.0,4746095.0,6622508.0,397,184,213,19270,8011,11259,11237953.0,4659766.0,6578187.0,0.5819,0.5842,0.5817,0.5843
2023-07-20 13:30,1442,598,844,153439,29230,124209,89639270.0,17000899.0,72638370.0,1354,566,788,151344,28840,122504,88408899.0,16775188.0,71633710.0,0.5816,0.5848,0.5817,0.5847
2023-07-20 13:35,570,156,414,63097,6659,56438,36887525.0,3874875.0,33012650.0,562,148,414,63176,6608,56568,36932306.0,3843419.0,33088886.0,0.5819,0.5849,0.5816,0.5849
2023-07-20 13:40,204,80,124,12557,3449,9108,7330541.0,2008924.0,5321617.0,192,67,125,12435,3058,9377,7261249.0,1778673.0,5482575.0,0.5825,0.5843,0.5816,0.5847
2023-07-20 13:45,1181,505,676,91498,22444,69054,65191351.0,24908355.0,40282996.0,1143,477,666,89943,22106,67837,64290741.0,24711032.0,39579708.0,1.1098,0.5834,1.1178,0.5835
2023-07-20 13:50,2195,324,1871,297250,9470,287780,173178205.0,5494079.0,167684126.0,2154,292,1862,296302,9092,287210,172627570.0,5269854.0,167357716.0,0.5802,0.5827,0.5796,0.5827
2023-07-20 13:55,2220,652,1568,226210,21234,204976,155562084.0,36109825.0,119452258.0,2161,612,1549,224122,19685,204437,154326517.0,35162087.0,119164429.0,1.7006,0.5828,1.7862,0.5829
2023-07-20 14:00,825,276,549,80102,9767,70335,46720320.0,5690755.0,41029564.0,795,264,531,79125,9358,69767,46131058.0,5434423.0,40696635.0,0.5827,0.5833,0.5807,0.5833
2023-07-20 14:05,143,68,75,8180,2880,5300,5570519.0,1662902.0,3907616.0,136,58,78,7718,2369,5349,5315322.0,1374156.0,3941165.0,0.5774,0.7373,0.5801,0.7368
2023-07-20 14:10,446,170,276,30534,5468,25066,17810367.0,3185862.0,14624504.0,425,160,265,30077,5257,24820,17519667.0,3041451.0,14478216.0,0.5826,0.5834,0.5786,0.5833
2023-07-20 14:15,1310,276,1034,177416,10408,167008,115503206.0,17928724.0,97574481.0,1291,261,1030,177067,10141,166926,115296277.0,17772397.0,97523879.0,1.7226,0.5843,1.7525,0.5842
2023-07-20 14:20,1280,251,1029,163531,14728,148803,95357697.0,8414427.0,86943270.0,1269,244,1025,161228,12444,148784,94980780.0,7232341.0,87748439.0,0.5713,0.5843,0.5812,0.5898
2023-07-20 14:25,2117,424,1693,255248,18749,236499,148992079.0,10896615.0,138095464.0,2097,412,1685,254159,18435,235724,148309014.0,10638946.0,137670068.0,0.5812,0.5839,0.5771,0.584
2023-07-20 14:30,1901,448,1453,186519,11377,175142,108794967.0,6607274.0,102187692.0,1881,431,1450,185688,10871,174817,108315001.0,6312261.0,102002740.0,0.5808,0.5835,0.5807,0.5835
2023-07-20 14:35,832,153,679,107703,3440,104263,62836073.0,1998446.0,60837626.0,818,144,674,107478,3326,104152,62702532.0,1931644.0,60770888.0,0.5809,0.5835,0.5808,0.5835
2023-07-20 14:40,1413,354,1059,144827,9308,135519,84506948.0,5416086.0,79090862.0,1392,338,1054,143922,8784,135138,83972480.0,5103090.0,78869390.0,0.5819,0.5836,0.581,0.5836
2023-07-20 14:45,1971,559,1412,221421,33359,188062,165359758.0,55424284.0,109935473.0,1902,522,1380,215053,28750,186303,161262131.0,52355687.0,108906443.0,1.6614,0.5846,1.8211,0.5846
2023-07-20 14:50,2192,1018,1174,177611,90037,87574,139536239.0,88153601.0,51382638.0,2144,991,1153,176852,89388,87464,139088218.0,87769122.0,51319095.0,0.9791,0.5867,0.9819,0.5867
2023-07-20 14:55,3518,2064,1454,347367,281711,65656,214636294.0,176104946.0,38531348.0,3496,2047,1449,347247,281835,65412,214546990.0,176157727.0,38389262.0,0.6251,0.5869,0.625,0.5869
2023-07-20 15:00,2738,1503,1235,266068,194144,71924,155475406.0,113279764.0,42195642.0,2715,1489,1226,266204,193951,72253,155557815.0,113167132.0,42390683.0,0.5835,0.5867,0.5835,0.5867
2023-07-20 15:05,1203,584,619,88316,57557,30759,51639290.0,33589192.0,18050097.0,1196,578,618,88278,57490,30788,51615156.0,33548191.0,18066964.0,0.5836,0.5868,0.5835,0.5868
2023-07-20 15:10,2221,1371,850,177503,136405,41098,103721816.0,79602710.0,24119105.0,2213,1363,850,177209,136129,41080,103550311.0,79441614.0,24108696.0,0.5836,0.5869,0.5836,0.5869
2023-07-20 15:15,1331,719,612,83533,53785,29748,48864379.0,31404962.0,17459416.0,1315,707,608,83167,53638,29529,48648498.0,31316413.0,17332085.0,0.5839,0.5869,0.5838,0.587
2023-07-20 15:20,674,366,308,47832,32255,15577,27976570.0,18838306.0,9138263.0,652,358,294,47619,32099,15520,27857836.0,18746590.0,9111246.0,0.584,0.5867,0.584,0.5871
2023-07-20 15:25,765,411,354,32847,19892,12955,19257273.0,11658570.0,7598702.0,734,395,339,31960,19343,12617,18708890.0,11302053.0,7406836.0,0.5861,0.5865,0.5843,0.5871
2023-07-20 15:30,181,115,66,10215,7407,2808,5958903.0,4312142.0,1646760.0,170,107,63,9889,7190,2699,5771901.0,4186217.0,1585683.0,0.5822,0.5865,0.5822,0.5875
2023-07-20 15:35,443,232,211,20823,9868,10955,12201304.0,5765389.0,6435914.0,420,220,200,20304,9984,10320,11897577.0,5833510.0,6064067.0,0.5843,0.5875,0.5843,0.5876
2023-07-20 15:40,869,383,486,32882,15739,17143,31186735.0,21130231.0,10056503.0,838,367,471,31270,14869,16401,30202176.0,20568723.0,9633452.0,1.3425,0.5866,1.3833,0.5874
2023-07-20 15:45,610,198,412,23524,9534,13990,13780825.0,5572697.0,8208127.0,590,190,400,22889,9276,13613,13422110.0,5421569.0,8000541.0,0.5845,0.5867,0.5845,0.5877
2023-07-20 15:50,282,104,178,16282,5219,11063,21418953.0,14921901.0,6497052.0,275,99,176,16702,5438,11264,21664931.0,15048988.0,6615943.0,2.8591,0.5873,2.7674,0.5874
2023-07-20 15:55,332,191,141,13859,6414,7445,8113237.0,3741756.0,4371480.0,312,177,135,12966,5911,7055,7591148.0,3448835.0,4142312.0,0.5834,0.5872,0.5835,0.5871
2023-07-20 16:00,354,172,182,20152,8339,11813,11811609.0,4873245.0,6938363.0,354,170,184,19973,8113,11860,11709081.0,4742947.0,6966134.0,0.5844,0.5873,0.5846,0.5874
2023-07-20 16:05,159,103,56,7682,4906,2776,4501181.0,2870434.0,1630746.0,148,97,51,7553,4680,2873,4419844.0,2732201.0,1687643.0,0.5851,0.5874,0.5838,0.5874
2023-07-20 16:10,379,180,199,19778,8933,10845,11595626.0,5223711.0,6371915.0,367,168,199,19355,8563,10792,11346227.0,5005272.0,6340954.0,0.5848,0.5875,0.5845,0.5876
2023-07-20 16:15,102,87,15,4057,3738,319,2363975.0,2182937.0,181038.0,96,86,10,4011,3817,194,2344401.0,2230388.0,114013.0,0.584,0.5675,0.5843,0.5877
2023-07-20 16:20,431,236,195,20125,9728,10397,23691571.0,17584621.0,6106949.0,409,223,186,20393,9434,10959,23833188.0,17389833.0,6443354.0,1.8076,0.5874,1.8433,0.588
2023-07-20 16:25,1037,578,459,97878,54574,43304,57416905.0,31946120.0,25470785.0,1005,566,439,95583,53157,42426,56069738.0,31109195.0,24960542.0,0.5854,0.5882,0.5852,0.5883
2023-07-20 16:30,2803,1395,1408,220902,126816,94086,129594835.0,74244454.0,55350381.0,2771,1382,1389,220521,126604,93917,129368895.0,74116758.0,55252136.0,0.5855,0.5883,0.5854,0.5883
2023-07-20 16:35,1174,641,533,84095,54965,29130,49319779.0,32177864.0,17141914.0,1158,635,523,82373,54382,27991,48305481.0,31835462.0,16470018.0,0.5854,0.5885,0.5854,0.5884
2023-07-20 16:40,1511,481,1030,107634,18743,88891,63252945.0,10974340.0,52278605.0,1496,475,1021,106386,18710,87676,62521090.0,10955612.0,51565477.0,0.5855,0.5881,0.5855,0.5881
2023-07-20 16:45,625,218,407,36777,6868,29909,21607262.0,4031678.0,17575584.0,604,205,399,36159,6509,29650,21237760.0,3806229.0,17431531.0,0.587,0.5876,0.5848,0.5879
2023-07-20 16:50,855,478,377,39665,24183,15482,23303278.0,14202988.0,9100289.0,833,467,366,38523,23633,14890,22604798.0,13843820.0,8760977.0,0.5873,0.5878,0.5858,0.5884
2023-07-20 16:55,391,226,165,14804,9185,5619,8766581.0,5378181.0,3388399.0,367,216,151,14557,9095,5462,8606492.0,5325506.0,3280986.0,0.5855,0.603,0.5855,0.6007
2023-07-20 17:00,557,146,411,53352,12812,40540,43142467.0,19356769.0,23785698.0,525,132,393,51635,12123,39512,42165957.0,18952784.0,23213172.0,1.5108,0.5867,1.5634,0.5875
2023-07-20 17:05,481,200,281,40359,14872,25487,24431891.0,8711406.0,15720485.0,438,176,262,39421,14381,25040,23094092.0,8394997.0,14699094.0,0.5858,0.6168,0.5838,0.587
2023-07-20 17:10,1382,151,1231,222491,13071,209420,130515074.0,7631631.0,122883443.0,1356,134,1222,221923,12627,209296,130211020.0,7371568.0,122839451.0,0.5839,0.5868,0.5838,0.5869
2023-07-20 17:15,2197,503,1694,272671,50315,222356,159760433.0,29354787.0,130405645.0,2160,488,1672,270834,49399,221435,158703120.0,28816741.0,129886379.0,0.5834,0.5865,0.5833,0.5866
2023-07-20 17:20,1548,461,1087,160068,21737,138331,93835041.0,12691363.0,81143678.0,1536,453,1083,160074,21777,138297,93833259.0,12709001.0,81124257.0,0.5839,0.5866,0.5836,0.5866
2023-07-20 17:25,1175,371,804,136758,19348,117410,92000327.0,23166784.0,68833542.0,1145,358,787,134716,19343,115373,90827638.0,23162626.0,67665012.0,1.1974,0.5863,1.1975,0.5865
2023-07-20 17:30,2487,382,2105,300562,12030,288532,175932290.0,7001466.0,168930824.0,2477,377,2100,300310,12084,288226,175785153.0,7032516.0,168752636.0,0.582,0.5855,0.582,0.5855
2023-07-20 17:35,1559,595,964,128869,22837,106032,75335303.0,13311071.0,62024232.0,1542,583,959,128142,22029,106113,74892097.0,12820352.0,62071745.0,0.5829,0.585,0.582,0.585
2023-07-20 17:40,2669,853,1816,295572,28908,266664,184604727.0,28674199.0,155930527.0,2649,847,1802,295335,29061,266274,184477360.0,28765800.0,155711560.0,0.9919,0.5847,0.9898,0.5848
2023-07-20 17:45,1787,557,1230,189175,14187,174988,110429248.0,8236580.0,102192667.0,1727,526,1201,186934,13956,172978,109151785.0,8099006.0,101052779.0,0.5806,0.584,0.5803,0.5842
2023-07-20 17:50,1574,716,858,107581,18130,89451,62678240.0,10525230.0,52153010.0,1578,714,864,108315,18682,89633,63122090.0,10830322.0,52291768.0,0.5805,0.583,0.5797,0.5834
2023-07-20 17:55,1072,490,582,75265,12816,62449,43844218.0,7435063.0,36409154.0,1025,449,576,72788,11446,61342,42406325.0,6644447.0,35761877.0,0.5801,0.583,0.5805,0.583
2023-07-20 18:00,320,153,167,22701,5425,17276,13274088.0,3186581.0,10087506.0,295,140,155,21460,4764,16696,12515284.0,2756240.0,9759043.0,0.5874,0.5839,0.5786,0.5845
2023-07-20 18:05,318,156,162,14357,7605,6752,8365555.0,4415621.0,3949933.0,262,152,110,14609,7940,6669,8502228.0,4601443.0,3900784.0,0.5806,0.585,0.5795,0.5849
2023-07-20 18:10,315,106,209,20106,6041,14065,11659608.0,3501298.0,8158310.0,269,74,195,17943,4741,13202,10452854.0,2746978.0,7705876.0,0.5796,0.58,0.5794,0.5837
2023-07-20 18:15,1423,475,948,92837,27374,65463,65927066.0,27765082.0,38161984.0,1403,458,945,91970,26985,64985,65437350.0,27540566.0,37896783.0,1.0143,0.583,1.0206,0.5832
2023-07-20 18:20,1587,351,1236,166677,11625,155052,156005717.0,66120158.0,89885559.0,1475,279,1196,160952,10123,150829,152861456.0,65218464.0,87642992.0,5.6878,0.5797,6.4426,0.5811
2023-07-20 18:25,2090,609,1481,180515,14802,165713,152165337.0,56042505.0,96122832.0,1981,515,1466,178315,13605,164710,150965498.0,55347185.0,95618313.0,3.7861,0.5801,4.0682,0.5805
2023-07-20 18:30,1803,663,1140,151987,21232,130755,87903666.0,12239707.0,75663958.0,1691,582,1109,147799,18316,129483,85498634.0,10550037.0,74948597.0,0.5765,0.5787,0.576,0.5788
2023-07-20 18:35,1923,667,1256,164071,29613,134458,95041858.0,17102905.0,77938953.0,1946,693,1253,161800,27946,133854,93718434.0,16102218.0,77616216.0,0.5775,0.5797,0.5762,0.5799
2023-07-21 10:00,2927,1271,1656,223188,73583,149605,131053860.0,44449648.0,86604212.0,2563,1074,1489,210902,67157,143745,121712884.0,38574215.0,83138669.0,0.6041,0.5789,0.5744,0.5784
2023-07-21 10:05,2331,1154,1177,189305,86293,103012,129050633.0,69346322.0,59704310.0,2230,1088,1142,181447,80348,101099,115169191.0,56536802.0,58632388.0,0.8036,0.5796,0.7036,0.58
2023-07-21 10:10,2565,1296,1269,177232,108483,68749,173752834.0,133880956.0,39871877.0,2436,1222,1214,173117,106403,66714,171408219.0,132684979.0,38723240.0,1.2341,0.58,1.247,0.5804
2023-07-21 10:15,2745,1111,1634,223751,61255,162496,153165126.0,59009527.0,94155599.0,2547,984,1563,217286,57153,160133,149543725.0,56734620.0,92809105.0,0.9633,0.5794,0.9927,0.5796
2023-07-21 10:20,3026,739,2287,341577,36034,305543,209589289.0,32632977.0,176956312.0,2949,680,2269,337968,33677,304291,207517420.0,31284739.0,176232681.0,0.9056,0.5792,0.929,0.5792
2023-07-21 10:25,1672,520,1152,159482,17886,141596,116219063.0,33976188.0,82242874.0,1635,491,1144,155122,13608,141514,113806940.0,31610562.0,82196377.0,1.8996,0.5808,2.3229,0.5808
2023-07-21 10:30,524,240,284,23835,7370,16465,25694124.0,16138031.0,9556092.0,485,221,264,20999,7088,13911,24056992.0,15972745.0,8084246.0,2.1897,0.5804,2.2535,0.5811
2023-07-21 10:35,433,238,195,20757,8795,11962,23781032.0,16949647.0,6831384.0,369,197,172,16586,6845,9741,21454689.0,15820170.0,5634518.0,1.9272,0.5711,2.3112,0.5784
2023-07-21 10:40,355,122,233,28392,3909,24483,16381509.0,2248613.0,14132896.0,303,79,224,28662,2765,25897,16565696.0,1582746.0,14982950.0,0.5752,0.5773,0.5724,0.5786
2023-07-21 10:45,1058,222,836,120628,6138,114490,81773291.0,15443394.0,66329897.0,1014,195,819,120165,5975,114190,81472467.0,15319392.0,66153075.0,2.516,0.5794,2.5639,0.5793
2023-07-21 10:50,1026,449,577,67320,19631,47689,50750394.0,23194812.0,27555582.0,947,399,548,63609,18161,45448,48719869.0,22351593.0,26368275.0,1.1815,0.5778,1.2307,0.5802
2023-07-21 10:55,660,227,433,47946,7490,40456,39621631.0,16201057.0,23420574.0,642,207,435,47186,7169,40017,39173929.0,16009698.0,23164231.0,2.163,0.5789,2.2332,0.5789
2023-07-21 11:00,1295,445,850,160464,19830,140634,93063341.0,11480329.0,81583012.0,1251,421,830,155509,17490,138019,90164837.0,10091968.0,80072869.0,0.5789,0.5801,0.577,0.5802
2023-07-21 11:05,339,206,133,15526,11064,4462,8980118.0,6397419.0,2582699.0,323,191,132,15343,10821,4522,8858828.0,6239873.0,2618955.0,0.5782,0.5788,0.5766,0.5792
2023-07-21 11:10,758,496,262,39636,30274,9362,22854367.0,17465898.0,5388468.0,724,475,249,38487,29730,8757,22221880.0,17150670.0,5071209.0,0.5769,0.5756,0.5769,0.5791
2023-07-21 11:15,990,782,208,73708,61465,12243,42648967.0,35543661.0,7105305.0,966,765,201,71868,60739,11129,41515970.0,35067777.0,6448193.0,0.5783,0.5804,0.5774,0.5794
2023-07-21 11:20,992,730,262,67953,55923,12030,39255156.0,32302674.0,6952481.0,972,719,253,67593,55678,11915,39050345.0,32144200.0,6906144.0,0.5776,0.5779,0.5773,0.5796
2023-07-21 11:25,349,241,108,29098,24534,4564,16806724.0,14155093.0,2651630.0,331,231,100,29036,24504,4532,16762253.0,14132018.0,2630235.0,0.577,0.581,0.5767,0.5804
2023-07-21 11:30,564,242,322,31871,20402,11469,30241505.0,23590172.0,6651333.0,507,196,311,28685,17320,11365,28466764.0,21876506.0,6590257.0,1.1563,0.5799,1.2631,0.5799
2023-07-21 11:35,361,219,142,21612,15190,6422,12628193.0,8891117.0,3737075.0,362,242,120,21395,16324,5071,12366119.0,9413250.0,2952869.0,0.5853,0.5819,0.5767,0.5823
2023-07-21 11:40,511,391,120,47328,40537,6791,27417445.0,23475168.0,3942277.0,435,323,112,43791,37550,6241,25339638.0,21714550.0,3625088.0,0.5791,0.5805,0.5783,0.5809
2023-07-21 11:45,1924,1395,529,215756,175680,40076,136878297.0,113542017.0,23336279.0,1903,1380,523,214770,174746,40024,136276104.0,113000830.0,23275274.0,0.6463,0.5823,0.6467,0.5815
2023-07-21 11:50,1957,1596,361,236161,215796,20365,136877955.0,124956778.0,11921177.0,1934,1592,342,235713,216147,19566,136599559.0,125138062.0,11461497.0,0.5791,0.5854,0.5789,0.5858
2023-07-21 11:55,1325,565,760,110877,32591,78286,76169918.0,30734685.0,45435233.0,1275,537,738,108718,31669,77049,74940033.0,30202488.0,44737544.0,0.943,0.5804,0.9537,0.5806
2023-07-21 12:00,196,121,75,12480,6432,6048,7337893.0,3818839.0,3519053.0,174,108,66,10487,5638,4849,6081239.0,3259279.0,2821960.0,0.5937,0.5819,0.5781,0.582
2023-07-21 12:05,891,527,364,59785,28538,31247,34711808.0,16556209.0,18155599.0,874,518,356,58925,27924,31001,34180480.0,16169942.0,18010538.0,0.5801,0.581,0.5791,0.581
2023-07-21 12:10,1915,497,1418,224717,41697,183020,153719709.0,47814784.0,105904924.0,1861,472,1389,218852,39431,179421,150625774.0,46513009.0,104112764.0,1.1467,0.5787,1.1796,0.5803
2023-07-21 12:15,3811,733,3078,516040,56423,459617,298848082.0,32535760.0,266312321.0,3784,718,3066,515606,56292,459314,298609127.0,32470553.0,266138574.0,0.5766,0.5794,0.5768,0.5794
2023-07-21 12:20,840,308,532,85073,15947,69126,61259530.0,21084883.0,40174646.0,812,292,520,84574,16021,68553,60974754.0,21130770.0,39843984.0,1.3222,0.5812,1.3189,0.5812
2023-07-21 12:25,1032,341,691,122660,21537,101123,71360863.0,12449212.0,58911651.0,1014,327,687,120819,20809,100010,70262841.0,12026646.0,58236194.0,0.578,0.5826,0.578,0.5823
2023-07-21 12:30,257,128,129,16921,9691,7230,9816193.0,5619666.0,4196527.0,234,112,122,16499,9120,7379,9550386.0,5270891.0,4279494.0,0.5799,0.5804,0.5779,0.58
2023-07-21 12:35,1043,754,289,94472,81096,13376,54741551.0,46963847.0,7777704.0,1020,739,281,93022,79721,13301,53853149.0,46117242.0,7735907.0,0.5791,0.5815,0.5785,0.5816
2023-07-21 12:40,600,379,221,65173,50646,14527,37729391.0,29287028.0,8442362.0,594,376,218,64941,50524,14417,37573824.0,29197027.0,8376797.0,0.5783,0.5811,0.5779,0.581
2023-07-21 12:45,1040,750,290,126036,109276,16760,72962508.0,63227433.0,9735075.0,1022,740,282,124566,108913,15653,72109413.0,63016387.0,9093026.0,0.5786,0.5809,0.5786,0.5809
2023-07-21 12:50,388,289,99,41704,35966,5738,24126410.0,20801689.0,3324720.0,364,273,91,38033,33758,4275,22007607.0,19524789.0,2482818.0,0.5784,0.5794,0.5784,0.5808
2023-07-21 12:55,312,267,45,37675,35241,2434,21815911.0,20397342.0,1418569.0,300,257,43,37079,34950,2129,21462505.0,20225057.0,1237447.0,0.5788,0.5828,0.5787,0.5812
2023-07-21 13:00,650,372,278,46081,35367,10714,26674348.0,20460291.0,6214056.0,645,369,276,45951,35325,10626,26602579.0,20436780.0,6165799.0,0.5785,0.58,0.5785,0.5803
2023-07-21 13:05,65,28,37,4669,1907,2762,2719470.0,1102437.0,1617033.0,55,20,35,4241,1818,2423,2458652.0,1050842.0,1407810.0,0.5781,0.5855,0.578,0.581
2023-07-21 13:10,291,190,101,27350,23761,3589,15825001.0,13741837.0,2083164.0,275,177,98,27226,23672,3554,15753627.0,13691051.0,2062576.0,0.5783,0.5804,0.5784,0.5804
2023-07-21 13:15,673,512,161,60785,54683,6102,35156591.0,31635056.0,3521535.0,657,499,158,61154,55190,5964,35387880.0,31924752.0,3463128.0,0.5785,0.5771,0.5785,0.5807
2023-07-21 13:20,138,69,69,5587,2783,2804,3214547.0,1608729.0,1605818.0,127,64,63,4848,2559,2289,2808273.0,1479015.0,1329257.0,0.5781,0.5727,0.578,0.5807
2023-07-21 13:25,414,190,224,28088,7692,20396,16235534.0,4445485.0,11790048.0,391,170,221,27398,7461,19937,15868138.0,4309096.0,11559042.0,0.5779,0.5781,0.5775,0.5798
2023-07-21 13:30,962,449,513,81682,24272,57410,59039446.0,25892835.0,33146611.0,915,429,486,79876,23711,56165,58084702.0,25553030.0,32531671.0,1.0668,0.5774,1.0777,0.5792
2023-07-21 13:35,2038,469,1569,193021,21838,171183,123332192.0,24472609.0,98859583.0,1957,422,1535,187135,20098,167037,120042282.0,23449768.0,96592513.0,1.1206,0.5775,1.1668,0.5783
2023-07-21 13:40,3038,311,2727,364328,17390,346938,210417450.0,9854684.0,200562766.0,2983,275,2708,360597,14238,346359,208499278.0,8189809.0,200309469.0,0.5667,0.5781,0.5752,0.5783
2023-07-21 13:45,2515,1490,1025,302477,186377,116100,257520370.0,190519561.0,67000809.0,2427,1456,971,298157,184790,113367,255108650.0,189579199.0,65529451.0,1.0222,0.5771,1.0259,0.578
2023-07-21 13:50,3832,3034,798,550732,473721,77011,507477001.0,463103623.0,44373378.0,3747,3000,747,542331,469733,72598,502808581.0,460785565.0,42023016.0,0.9776,0.5762,0.981,0.5788
2023-07-21 13:55,1350,298,1052,143544,20777,122767,94904361.0,23848411.0,71055950.0,1323,279,1044,140761,18750,122011,93313229.0,22681382.0,70631847.0,1.1478,0.5788,1.2097,0.5789
2023-07-21 14:00,1022,182,840,98146,13721,84425,56699827.0,7899614.0,48800213.0,988,159,829,95960,11791,84169,55505342.0,6792805.0,48712536.0,0.5757,0.578,0.5761,0.5787
2023-07-21 14:05,2291,428,1863,210240,13748,196492,121581235.0,7922479.0,113658755.0,2267,408,1859,208506,12637,195869,120612158.0,7279853.0,113332305.0,0.5763,0.5784,0.5761,0.5786
2023-07-21 14:10,1104,214,890,126842,4605,122237,73348140.0,2652747.0,70695392.0,1076,193,883,125084,4475,120609,72359497.0,2575795.0,69783701.0,0.5761,0.5783,0.5756,0.5786
2023-07-21 14:15,426,104,322,56162,2226,53936,32449660.0,1285564.0,31164096.0,388,77,311,55688,1747,53941,32181135.0,1004069.0,31177065.0,0.5775,0.5778,0.5747,0.578
2023-07-21 14:20,837,149,688,89234,4909,84325,51560362.0,2853215.0,48707146.0,822,121,701,86962,3846,83116,50265562.0,2213936.0,48051626.0,0.5812,0.5776,0.5756,0.5781
2023-07-21 14:25,296,50,246,35813,955,34858,20800365.0,550895.0,20249470.0,307,34,273,36392,943,35449,21133074.0,542211.0,20590863.0,0.5769,0.5809,0.575,0.5809
2023-07-21 14:30,598,302,296,42237,14229,28008,24451532.0,8209499.0,16242032.0,573,282,291,41579,13804,27775,24072931.0,7959531.0,16113400.0,0.577,0.5799,0.5766,0.5801
2023-07-21 14:35,1223,434,789,116802,35332,81470,79421076.0,32251341.0,47169735.0,1202,416,786,114997,33537,81460,78384026.0,31215087.0,47168938.0,0.9128,0.579,0.9308,0.579
2023-07-21 14:40,2052,1320,732,230556,185374,45182,133151351.0,106966706.0,26184644.0,2022,1299,723,229492,184524,44968,132492334.0,106431191.0,26061142.0,0.577,0.5795,0.5768,0.5795
2023-07-21 14:45,1519,1008,511,147491,121070,26421,85222353.0,69903753.0,15318600.0,1503,1000,503,147207,120947,26260,85061570.0,69829265.0,15232304.0,0.5774,0.5798,0.5774,0.5801
2023-07-21 14:50,488,229,259,29133,14966,14167,28762219.0,20541581.0,8220638.0,465,214,251,28419,14468,13951,28332541.0,20233634.0,8098906.0,1.3725,0.5803,1.3985,0.5805
2023-07-21 14:55,144,80,64,12488,7896,4592,7227867.0,4565269.0,2662598.0,130,68,62,12141,7812,4329,7030462.0,4515729.0,2514733.0,0.5782,0.5798,0.5781,0.5809
2023-07-21 15:00,987,660,327,81410,67060,14350,47104190.0,38775142.0,8329047.0,973,646,327,82592,68167,14425,47775764.0,39403775.0,8371989.0,0.5782,0.5804,0.578,0.5804
2023-07-21 15:05,815,505,310,62688,46768,15920,36283389.0,27043668.0,9239721.0,804,497,307,62339,46398,15941,36079561.0,26828299.0,9251261.0,0.5783,0.5804,0.5782,0.5803
2023-07-21 15:10,1126,729,397,98957,71033,27924,57277282.0,41067060.0,16210222.0,1110,717,393,98692,70790,27902,57123256.0,40926241.0,16197014.0,0.5781,0.5805,0.5781,0.5805
2023-07-21 15:15,1622,1143,479,148825,119338,29487,86117615.0,68998549.0,17119065.0,1602,1133,469,148468,119065,29403,85909659.0,68839511.0,17070148.0,0.5782,0.5806,0.5782,0.5806
2023-07-21 15:20,545,359,186,34099,25446,8653,19754949.0,14720593.0,5034356.0,531,346,185,32614,24337,8277,18888453.0,14078601.0,4809852.0,0.5785,0.5818,0.5785,0.5811
2023-07-21 15:25,438,247,191,36241,26360,9881,21030129.0,15283623.0,5746506.0,411,233,178,35904,26354,9550,20812540.0,15254131.0,5558409.0,0.5798,0.5816,0.5788,0.582
2023-07-21 15:30,711,434,277,70298,52497,17801,52629273.0,42276678.0,10352594.0,698,426,272,70231,52436,17795,52590103.0,42240259.0,10349843.0,0.8053,0.5816,0.8056,0.5816
2023-07-21 15:35,199,116,83,18991,14212,4779,11005003.0,8227460.0,2777543.0,216,136,80,20193,15388,4805,11694032.0,8899457.0,2794574.0,0.5789,0.5812,0.5783,0.5816
2023-07-21 15:40,456,262,194,28941,19373,9568,16765367.0,11207082.0,5558284.0,454,269,185,29183,19895,9288,16902574.0,11506361.0,5396213.0,0.5785,0.5809,0.5784,0.581
2023-07-21 15:45,205,122,83,11228,7527,3701,6506258.0,4355947.0,2150311.0,191,112,79,11122,7259,3863,6444439.0,4200271.0,2244167.0,0.5787,0.581,0.5786,0.5809
2023-07-21 15:50,849,378,471,60870,32054,28816,58928729.0,42285746.0,16642983.0,824,365,459,58995,31635,27360,57936001.0,42046822.0,15889178.0,1.3192,0.5776,1.3291,0.5807
2023-07-21 15:55,1324,514,810,95852,40515,55337,67405710.0,35299716.0,32105994.0,1310,502,808,95064,39998,55066,66963556.0,34999038.0,31964518.0,0.8713,0.5802,0.875,0.5805
2023-07-21 16:00,941,526,415,59242,33151,26091,34283255.0,19171564.0,15111691.0,922,514,408,58899,33094,25805,34110106.0,19136857.0,14973248.0,0.5783,0.5792,0.5783,0.5802
2023-07-21 16:05,620,353,267,43895,24411,19484,25433765.0,14120669.0,11313096.0,615,350,265,43648,24289,19359,25286844.0,14048296.0,11238547.0,0.5785,0.5806,0.5784,0.5805
2023-07-21 16:10,815,435,380,64462,43525,20937,49220412.0,37075620.0,12144792.0,801,424,377,64180,43345,20835,49042229.0,36942315.0,12099914.0,0.8518,0.5801,0.8523,0.5807
2023-07-21 16:15,1871,1210,661,188302,159401,28901,120893301.0,104113269.0,16780031.0,1855,1197,658,187764,158713,29051,120566730.0,103694692.0,16872038.0,0.6532,0.5806,0.6533,0.5808
2023-07-21 16:20,1837,1328,509,252380,216306,36074,146166398.0,125189955.0,20976442.0,1825,1320,505,252421,216312,36109,146169395.0,125175112.0,20994282.0,0.5788,0.5815,0.5787,0.5814
2023-07-21 16:25,1421,959,462,175772,150098,25674,101808342.0,86885128.0,14923214.0,1414,951,463,174459,150009,24450,101050239.0,86833537.0,14216701.0,0.5789,0.5813,0.5789,0.5815
2023-07-21 16:30,278,26,252,9114,609,8505,5313970.0,371840.0,4942130.0,260,16,244,8354,276,8078,4852302.0,159277.0,4693024.0,0.6106,0.5811,0.5771,0.581
2023-07-21 16:35,878,636,242,94104,83974,10130,54471606.0,48598135.0,5873470.0,862,621,241,93763,83660,10103,54283516.0,48414627.0,5868889.0,0.5787,0.5798,0.5787,0.5809
2023-07-21 16:40,1065,750,315,119228,101992,17236,69031841.0,59023607.0,10008234.0,1057,743,314,119011,101764,17247,68903718.0,58887925.0,10015793.0,0.5787,0.5807,0.5787,0.5807
2023-07-21 16:45,1243,784,459,139328,107241,32087,80704844.0,62073528.0,18631316.0,1234,776,458,139002,106954,32048,80497958.0,61888847.0,18609111.0,0.5788,0.5806,0.5786,0.5807
2023-07-21 16:50,1044,760,284,136978,117371,19607,79296546.0,67912394.0,11384151.0,1030,752,278,136203,117271,18932,78847660.0,67854382.0,10993278.0,0.5786,0.5806,0.5786,0.5807
2023-07-21 16:55,1176,764,412,151071,118768,32303,87457115.0,68706166.0,18750948.0,1166,754,412,151011,118459,32552,87423860.0,68527132.0,18896727.0,0.5785,0.5805,0.5785,0.5805
2023-07-21 17:00,1471,831,640,200036,151497,48539,115795710.0,87604026.0,28191684.0,1458,824,634,199282,151114,48168,115358295.0,87382109.0,27976186.0,0.5783,0.5808,0.5783,0.5808
2023-07-21 17:05,654,439,215,89060,72074,16986,51554894.0,41686800.0,9868093.0,641,428,213,88578,71810,16768,51268715.0,41527412.0,9741302.0,0.5784,0.581,0.5783,0.5809
2023-07-21 17:10,1204,679,525,144962,105941,39021,83927197.0,61267460.0,22659737.0,1195,673,522,145109,106010,39099,84014105.0,61308131.0,22705974.0,0.5783,0.5807,0.5783,0.5807
2023-07-21 17:15,1697,934,763,215230,159956,55274,124567730.0,92473332.0,32094398.0,1681,927,754,214944,159847,55097,124390568.0,92396589.0,31993979.0,0.5781,0.5806,0.578,0.5807
2023-07-21 17:20,429,273,156,55774,43906,11868,32290173.0,25394958.0,6895215.0,413,263,150,55001,43135,11866,31843684.0,24949601.0,6894082.0,0.5784,0.581,0.5784,0.581
2023-07-21 17:25,319,187,132,48245,39835,8410,27895552.0,23018129.0,4877423.0,305,175,130,47655,39471,8184,27568683.0,22807067.0,4761616.0,0.5778,0.58,0.5778,0.5818
2023-07-21 17:30,67,14,53,4504,285,4219,2618644.0,166610.0,2452034.0,59,9,50,4468,259,4209,2595843.0,149402.0,2446440.0,0.5846,0.5812,0.5768,0.5812
2023-07-21 17:35,193,130,63,23446,16344,7102,13538441.0,9444698.0,4093742.0,179,120,59,22713,16430,6283,13144287.0,9493635.0,3650651.0,0.5779,0.5764,0.5778,0.581
2023-07-21 17:40,374,229,145,47750,32948,14802,27628177.0,19041103.0,8587074.0,364,224,140,44259,29857,14402,25624873.0,17260736.0,8364137.0,0.5779,0.5801,0.5781,0.5808
2023-07-21 17:45,2204,1624,580,325945,285646,40299,188684565.0,165249289.0,23435276.0,2168,1596,572,322522,282766,39756,186712565.0,163594525.0,23118040.0,0.5785,0.5815,0.5786,0.5815
2023-07-21 17:50,1721,1352,369,297274,270556,26718,171940444.0,156446595.0,15493848.0,1697,1335,362,296443,270476,25967,171487073.0,156401080.0,15085993.0,0.5782,0.5799,0.5782,0.581
2023-07-21 17:55,1217,810,407,162507,133507,29000,94026083.0,77198133.0,16827950.0,1211,805,406,163001,133957,29044,94313258.0,77458403.0,16854855.0,0.5782,0.5803,0.5782,0.5803
2023-07-21 18:00,1195,711,484,153206,118606,34600,88712117.0,68630474.0,20081643.0,1183,704,479,153480,119068,34412,88852194.0,68880061.0,19972132.0,0.5786,0.5804,0.5785,0.5804
2023-07-21 18:05,1096,697,399,124637,96687,27950,72142026.0,55923695.0,16218331.0,1084,688,396,124015,96473,27542,71784383.0,55802814.0,15981569.0,0.5784,0.5803,0.5784,0.5803
2023-07-21 18:10,1040,775,265,107674,95063,12611,62274850.0,54959616.0,7315233.0,1033,773,260,107069,94898,12171,61907519.0,54847865.0,7059654.0,0.5781,0.5801,0.578,0.58
2023-07-21 18:15,1368,1053,315,165387,151261,14126,95694574.0,87491257.0,8203316.0,1349,1034,315,165234,151074,14160,95594859.0,87370625.0,8224234.0,0.5784,0.5807,0.5783,0.5808
2023-07-21 18:20,556,480,76,79219,74080,5139,45824680.0,42838727.0,2985952.0,547,473,74,78689,73722,4967,45510785.0,42622730.0,2888055.0,0.5783,0.581,0.5782,0.5814
2023-07-21 18:25,243,176,67,25747,22902,2845,14887233.0,13236693.0,1650540.0,229,167,62,25588,22889,2699,14795304.0,13228407.0,1566897.0,0.578,0.5802,0.5779,0.5805
2023-07-21 18:30,408,298,110,46798,42365,4433,38931413.0,36360181.0,2571231.0,381,283,98,45960,42061,3899,38449053.0,36185988.0,2263064.0,0.8583,0.58,0.8603,0.5804
2023-07-21 18:35,191,115,76,16122,8775,7347,9357145.0,5092211.0,4264934.0,187,112,75,14694,8982,5712,8508511.0,5191290.0,3317220.0,0.5803,0.5805,0.578,0.5807
2023-07-24 10:00,2232,1104,1128,267903,113081,154822,163458361.0,73097945.0,90360416.0,1878,910,968,244868,102513,142355,144342135.0,61615934.0,82726201.0,0.6464,0.5836,0.6011,0.5811
2023-07-24 10:05,1004,504,500,80439,25948,54491,62515141.0,30839384.0,31675757.0,931,455,476,77351,23233,54118,58315526.0,26854292.0,31461234.0,1.1885,0.5813,1.1559,0.5813
2023-07-24 10:10,384,238,146,20898,13790,7108,23990779.0,19837349.0,4153429.0,322,195,127,18072,11768,6304,18377549.0,14707948.0,3669601.0,1.4385,0.5843,1.2498,0.5821
2023-07-24 10:15,1386,780,606,67196,33453,33743,51194367.0,31503246.0,19691120.0,1200,674,526,62962,30373,32589,48502815.0,29485367.0,19017447.0,0.9417,0.5836,0.9708,0.5836
2023-07-24 10:20,1049,342,707,85435,14534,70901,61606167.0,20324371.0,41281796.0,925,255,670,75257,10062,65195,55677495.0,17700747.0,37976748.0,1.3984,0.5822,1.7592,0.5825
2023-07-24 10:25,390,146,244,28064,4828,23236,16338187.0,2816173.0,13522013.0,321,97,224,25924,3030,22894,15065002.0,1752815.0,13312187.0,0.5833,0.5819,0.5785,0.5815
2023-07-24 10:30,1955,1115,840,248931,142074,106857,216623579.0,154158777.0,62464802.0,1814,1055,759,233686,133961,99725,207434446.0,149126633.0,58307813.0,1.0851,0.5846,1.1132,0.5847
2023-07-24 10:35,1529,439,1090,137123,22092,115031,80223122.0,12900891.0,67322230.0,1395,384,1011,130989,19130,111859,76584047.0,11134323.0,65449724.0,0.584,0.5853,0.582,0.5851
2023-07-24 10:40,721,290,431,55216,11677,43539,32268101.0,6837578.0,25430523.0,654,252,402,52359,11409,40950,30595590.0,6643211.0,23952378.0,0.5856,0.5841,0.5823,0.5849
2023-07-24 10:45,1911,864,1047,187925,96310,91615,121606253.0,68022009.0,53584244.0,1834,812,1022,183576,93445,90131,119082352.0,66337389.0,52744962.0,0.7063,0.5849,0.7099,0.5852
2023-07-24 10:50,980,481,499,61885,22009,39876,36183801.0,12829196.0,23354604.0,943,456,487,56893,19926,36967,33257094.0,11613950.0,21643144.0,0.5829,0.5857,0.5829,0.5855
2023-07-24 10:55,987,497,490,82769,30525,52244,48364395.0,17797508.0,30566887.0,891,471,420,77737,29192,48545,45407994.0,17016315.0,28391679.0,0.583,0.5851,0.5829,0.5849
2023-07-24 11:00,496,259,237,41813,18686,23127,36217349.0,22755390.0,13461958.0,435,231,204,40516,18083,22433,35497561.0,22399070.0,13098490.0,1.2178,0.5821,1.2387,0.5839
2023-07-24 11:05,1312,888,424,129968,90900,39068,147323840.0,124429136.0,22894703.0,1203,827,376,121336,86533,34803,142114507.0,121734812.0,20379695.0,1.3689,0.586,1.4068,0.5856
2023-07-24 11:10,1274,1014,260,140832,124271,16561,94324372.0,84615317.0,9709055.0,1173,964,209,135584,120846,14738,91139580.0,82490666.0,8648913.0,0.6809,0.5863,0.6826,0.5868
2023-07-24 11:15,1291,975,316,130507,111881,18626,123995530.0,113040130.0,10955399.0,1215,945,270,126878,110538,16340,121838113.0,112223607.0,9614506.0,1.0104,0.5882,1.0152,0.5884
2023-07-24 11:20,821,472,349,60927,34884,26043,59414600.0,44174658.0,15239942.0,778,469,309,55328,32562,22766,56141042.0,42775668.0,13365374.0,1.2663,0.5852,1.3137,0.5871
2023-07-24 11:25,892,381,511,89275,26977,62298,64137162.0,27621745.0,36515416.0,816,330,486,85669,24915,60754,62071131.0,26423295.0,35647836.0,1.0239,0.5861,1.0605,0.5868
2023-07-24 11:30,1646,900,746,159581,63080,96501,93497995.0,36835860.0,56662134.0,1601,878,723,157525,62421,95104,92284266.0,36467302.0,55816963.0,0.584,0.5872,0.5842,0.5869
2023-07-24 11:35,682,355,327,62229,19288,42941,36501050.0,11273756.0,25227293.0,646,335,311,58577,18989,39588,34330949.0,11090163.0,23240785.0,0.5845,0.5875,0.584,0.5871
2023-07-24 11:40,807,495,312,70040,36820,33220,40928825.0,21523391.0,19405433.0,775,470,305,68410,35586,32824,40009155.0,20773731.0,19235423.0,0.5846,0.5841,0.5838,0.586
2023-07-24 11:45,1876,552,1324,220339,37909,182430,129033904.0,22169710.0,106864194.0,1852,538,1314,218680,37558,181122,128059639.0,21915303.0,106144336.0,0.5848,0.5858,0.5835,0.586
2023-07-24 11:50,429,155,274,49674,8155,41519,29087056.0,4764492.0,24322564.0,402,135,267,49153,7626,41527,28775547.0,4449117.0,24326429.0,0.5842,0.5858,0.5834,0.5858
2023-07-24 11:55,1371,313,1058,183169,18655,164514,119070075.0,22800246.0,96269829.0,1341,295,1046,180303,17859,162444,117449010.0,22285760.0,95163250.0,1.2222,0.5852,1.2479,0.5858
2023-07-24 12:00,1124,212,912,153843,11517,142326,90086449.0,6712833.0,83373615.0,1098,201,897,153835,11260,142575,90079667.0,6563346.0,83516321.0,0.5829,0.5858,0.5829,0.5858
2023-07-24 12:05,620,209,411,54179,10257,43922,31685337.0,5978897.0,25706440.0,596,194,402,53791,10046,43745,31458603.0,5856106.0,25602497.0,0.5829,0.5853,0.5829,0.5853
2023-07-24 12:10,1674,849,825,182744,81698,101046,118748283.0,59569407.0,59178876.0,1650,831,819,181665,80388,101277,118100161.0,58782614.0,59317547.0,0.7291,0.5857,0.7312,0.5857
2023-07-24 12:15,1209,848,361,124032,93073,30959,72486216.0,54352684.0,18133532.0,1169,825,344,122068,91380,30688,71317708.0,53338837.0,17978870.0,0.584,0.5857,0.5837,0.5859
2023-07-24 12:20,1467,1196,271,156742,123857,32885,115294860.0,96046000.0,19248859.0,1442,1179,263,154978,123241,31737,114270317.0,95677455.0,18592862.0,0.7755,0.5853,0.7763,0.5858
2023-07-24 12:25,806,600,206,71180,45835,25345,41597770.0,26761343.0,14836426.0,789,586,203,71160,45672,25488,41578615.0,26654279.0,14924336.0,0.5839,0.5854,0.5836,0.5855
2023-07-24 12:30,1934,1283,651,236330,168171,68159,257517515.0,217403656.0,40113858.0,1665,1146,519,204617,147757,56860,238676927.0,205193070.0,33483856.0,1.2928,0.5885,1.3887,0.5889
2023-07-24 12:35,3052,1896,1156,453792,248831,204961,339327816.0,218104529.0,121223287.0,2406,1438,968,424170,233492,190678,321511362.0,208727622.0,112783740.0,0.8765,0.5914,0.8939,0.5915
2023-07-24 12:40,1844,1206,638,322456,219284,103172,202714509.0,141387066.0,61327442.0,1555,1036,519,291357,206382,84975,183963642.0,133594270.0,50369371.0,0.6448,0.5944,0.6473,0.5928
2023-07-24 12:45,3832,2083,1749,575293,208235,367058,422374410.0,205724431.0,216649978.0,3210,1559,1651,540703,189597,351106,401936467.0,194681031.0,207255435.0,0.9879,0.5902,1.0268,0.5903
2023-07-24 12:50,1628,975,653,247014,140366,106648,169655817.0,106460618.0,63195199.0,1417,854,563,227633,134048,93585,157960933.0,102666344.0,55294588.0,0.7585,0.5926,0.7659,0.5908
2023-07-24 12:55,1199,667,532,167030,97296,69734,110698287.0,69325431.0,41372856.0,1086,611,475,155156,93339,61817,103451217.0,66881906.0,36569310.0,0.7125,0.5933,0.7165,0.5916
2023-07-24 13:00,995,514,481,128248,66292,61956,87350343.0,51002840.0,36347503.0,895,456,439,121724,63552,58172,83640795.0,49301077.0,34339718.0,0.7694,0.5867,0.7758,0.5903
2023-07-24 13:05,1111,509,602,140489,56358,84131,82961689.0,33345649.0,49616040.0,1045,466,579,135819,53571,82248,80036219.0,31514129.0,48522089.0,0.5917,0.5897,0.5883,0.5899
2023-07-24 13:10,368,178,190,40353,12058,28295,23788750.0,7086635.0,16702114.0,319,141,178,39537,11733,27804,23299253.0,6882681.0,16416571.0,0.5877,0.5903,0.5866,0.5904
2023-07-24 13:15,2011,1676,335,305946,275735,30211,192552326.0,174683890.0,17868435.0,1955,1658,297,300733,271525,29208,189204033.0,171923034.0,17280998.0,0.6335,0.5915,0.6332,0.5917
2023-07-24 13:20,1102,786,316,138911,112758,26153,82006617.0,66581172.0,15425445.0,1029,748,281,132540,109695,22845,78198618.0,64682615.0,13516003.0,0.5905,0.5898,0.5897,0.5916
2023-07-24 13:25,535,361,174,69607,50215,19392,52823161.0,41483798.0,11339362.0,488,336,152,66465,49483,16982,51068504.0,41024557.0,10043947.0,0.8261,0.5847,0.8291,0.5914
2023-07-24 13:30,360,139,221,28170,12444,15726,28531164.0,19211217.0,9319947.0,301,98,203,23877,8062,15815,25966703.0,16614396.0,9352307.0,1.5438,0.5926,2.0608,0.5914
2023-07-24 13:35,657,78,579,47934,4854,43080,28304458.0,2852605.0,25451852.0,611,53,558,43535,3989,39546,25843043.0,2345576.0,23497467.0,0.5877,0.5908,0.588,0.5942
2023-07-24 13:40,807,261,546,97478,21646,75832,105340716.0,60227799.0,45112917.0,741,216,525,91964,17928,74036,102317862.0,58035691.0,44282171.0,2.7824,0.5949,3.2372,0.5981
2023-07-24 13:45,74,41,33,4230,1438,2792,2493476.0,841288.0,1652188.0,63,30,33,5060,1272,3788,2984923.0,740576.0,2244346.0,0.585,0.5918,0.5822,0.5925
2023-07-24 13:50,280,148,132,23223,6014,17209,13685238.0,3555722.0,10129516.0,236,121,115,21302,5308,15994,12559196.0,3120539.0,9438657.0,0.5912,0.5886,0.5879,0.5901
2023-07-24 13:55,391,184,207,25434,6740,18694,15022845.0,3975824.0,11047021.0,365,165,200,24830,6321,18509,14653130.0,3716989.0,10936140.0,0.5899,0.5909,0.588,0.5909
2023-07-24 14:00,724,207,517,90265,11026,79239,53431567.0,6510965.0,46920602.0,708,195,513,87756,10580,77176,51835906.0,6225538.0,45610367.0,0.5905,0.5921,0.5884,0.591
2023-07-24 14:05,694,338,356,66476,22248,44228,39239613.0,13121274.0,26118338.0,670,324,346,66092,21943,44149,39005345.0,12916629.0,26088716.0,0.5898,0.5905,0.5886,0.5909
2023-07-24 14:10,568,139,429,78578,9225,69353,46407872.0,5425639.0,40982232.0,532,114,418,76921,8497,68424,45432938.0,4997607.0,40435331.0,0.5881,0.5909,0.5882,0.591
2023-07-24 14:15,704,186,518,65762,3872,61890,38736845.0,2283063.0,36453782.0,673,166,507,63742,3462,60280,37619921.0,2035015.0,35584906.0,0.5896,0.589,0.5878,0.5903
2023-07-24 14:20,688,349,339,60097,25157,34940,35404850.0,14813092.0,20591757.0,650,333,317,56295,22726,33569,33177510.0,13363861.0,19813649.0,0.5888,0.5893,0.588,0.5902
2023-07-24 14:25,519,189,330,38900,8662,30238,22901484.0,5098274.0,17803210.0,496,173,323,37857,7957,29900,22311605.0,4680708.0,17630897.0,0.5886,0.5888,0.5883,0.5897
2023-07-24 14:30,208,103,105,14932,5864,9068,8785041.0,3450992.0,5334048.0,193,93,100,14081,5672,8409,8304279.0,3336732.0,4967546.0,0.5885,0.5882,0.5883,0.5907
2023-07-24 14:35,364,90,274,45783,3929,41854,27077433.0,2346196.0,24731237.0,345,76,269,45155,3323,41832,26806168.0,1951082.0,24855085.0,0.5971,0.5909,0.5871,0.5942
2023-07-24 14:40,647,349,298,57986,25715,32271,34329304.0,15324868.0,19004435.0,612,332,280,54101,22789,31312,31875625.0,13403661.0,18471963.0,0.596,0.5889,0.5882,0.5899
2023-07-24 14:45,455,210,245,53729,16954,36775,31657283.0,9980929.0,21676354.0,420,187,233,56103,15765,40338,33072548.0,9272407.0,23800140.0,0.5887,0.5894,0.5882,0.59
2023-07-24 14:50,534,158,376,72683,11302,61381,66391227.0,30467896.0,35923331.0,471,113,358,66769,8514,58255,63063416.0,28744992.0,34318423.0,2.6958,0.5853,3.3762,0.5891
2023-07-24 14:55,165,67,98,16138,2312,13826,9360103.0,1370726.0,7989377.0,118,28,90,13263,994,12269,7804889.0,579025.0,7225863.0,0.5929,0.5779,0.5825,0.589
2023-07-24 15:00,469,132,337,50301,5369,44932,29599518.0,3148916.0,26450602.0,444,117,327,49924,4646,45278,29374209.0,2721369.0,26652840.0,0.5865,0.5887,0.5857,0.5886
2023-07-24 15:05,212,49,163,19290,2905,16385,11333526.0,1704061.0,9629465.0,197,39,158,18793,2661,16132,11055990.0,1557125.0,9498865.0,0.5866,0.5877,0.5852,0.5888
2023-07-24 15:10,452,68,384,53382,3281,50101,31336337.0,1926675.0,29409661.0,420,49,371,50425,1813,48612,29671388.0,1046629.0,28624758.0,0.5872,0.587,0.5773,0.5888
2023-07-24 15:15,955,81,874,137897,3087,134810,81220941.0,1798803.0,79422138.0,926,64,862,137166,2485,134681,80802277.0,1456528.0,79345748.0,0.5827,0.5891,0.5861,0.5891
2023-07-24 15:20,108,34,74,10166,1676,8490,17864415.0,12861054.0,5003361.0,89,22,67,9228,1002,8226,17311104.0,12464090.0,4847014.0,7.6737,0.5893,12.4392,0.5892
2023-07-24 15:25,192,64,128,19296,2374,16922,11364616.0,1396506.0,9968109.0,171,47,124,18711,1807,16904,11027985.0,1060577.0,9967407.0,0.5883,0.5891,0.5869,0.5896
2023-07-24 15:30,699,130,569,90826,2623,88203,53514829.0,1549530.0,51965298.0,665,102,563,90589,2085,88504,53369715.0,1223497.0,52146217.0,0.5907,0.5892,0.5868,0.5892
2023-07-24 15:35,1015,643,372,102267,73377,28890,72237784.0,55195713.0,17042071.0,968,617,351,97854,70041,27813,69463622.0,53054043.0,16409579.0,0.7522,0.5899,0.7575,0.59
2023-07-24 15:40,1899,1367,532,187699,152515,35184,122274134.0,101558919.0,20715215.0,1887,1361,526,187041,152373,34668,121908289.0,101469803.0,20438486.0,0.6659,0.5888,0.6659,0.5895
2023-07-24 15:45,1146,767,379,122624,84955,37669,84490250.0,62232693.0,22257557.0,1076,733,343,113692,79930,33762,78875454.0,58929647.0,19945807.0,0.7325,0.5909,0.7373,0.5908
2023-07-24 15:50,524,461,63,65605,59651,5954,38635161.0,35115437.0,3519724.0,494,442,52,65113,59265,5848,38340283.0,34884598.0,3455684.0,0.5887,0.5912,0.5886,0.5909
2023-07-24 15:55,580,382,198,61379,37456,23923,36130669.0,22064951.0,14065718.0,548,358,190,59912,37386,22526,35327421.0,22018512.0,13308908.0,0.5891,0.588,0.589,0.5908
2023-07-24 16:00,1323,897,426,129326,82628,46698,76120726.0,48659594.0,27461132.0,1273,855,418,125847,80251,45596,74144838.0,47227790.0,26917048.0,0.5889,0.5881,0.5885,0.5903
2023-07-24 16:05,822,269,553,108805,32717,76088,64270135.0,19298701.0,44971433.0,783,246,537,107027,31385,75642,63190115.0,18482879.0,44707236.0,0.5899,0.591,0.5889,0.591
2023-07-24 16:10,294,137,157,36785,22220,14565,21704146.0,13098055.0,8606090.0,281,127,154,36934,21843,15091,21799271.0,12871087.0,8928184.0,0.5895,0.5909,0.5893,0.5916
2023-07-24 16:15,614,321,293,71838,47977,23861,54287147.0,40178289.0,14108857.0,597,308,289,71860,47953,23907,54275128.0,40139568.0,14135560.0,0.8374,0.5913,0.8371,0.5913
2023-07-24 16:20,564,321,243,78194,56394,21800,46117398.0,33245584.0,12871814.0,537,306,231,77399,57308,20091,45663920.0,33783593.0,11880327.0,0.5895,0.5905,0.5895,0.5913
2023-07-24 16:25,168,97,71,14271,8542,5729,20283586.0,16899358.0,3384227.0,142,78,64,12984,7567,5417,19528159.0,16325869.0,3202290.0,1.9784,0.5907,2.1575,0.5912
2023-07-24 16:30,484,203,281,41214,17942,23272,24326153.0,10586252.0,13739901.0,459,189,270,40182,17087,23095,23690467.0,10051250.0,13639217.0,0.59,0.5904,0.5882,0.5906
2023-07-24 16:35,104,59,45,6192,3305,2887,3669752.0,1965906.0,1703846.0,79,41,38,5719,2887,2832,3370661.0,1698584.0,1672076.0,0.5948,0.5902,0.5884,0.5904
2023-07-24 16:40,1141,481,660,130691,23660,107031,88575302.0,25761318.0,62813983.0,1076,437,639,125448,22188,103260,85719099.0,24892758.0,60826341.0,1.0888,0.5869,1.1219,0.5891
2023-07-24 16:45,1978,807,1171,223286,45925,177361,202666801.0,98206963.0,104459838.0,1783,682,1101,207423,38097,169326,193223739.0,93533509.0,99690229.0,2.1384,0.589,2.4551,0.5887
2023-07-24 16:50,1281,738,543,109873,49740,60133,64447007.0,29121751.0,35325255.0,1214,696,518,105457,48580,56877,61825423.0,28410549.0,33414874.0,0.5855,0.5875,0.5848,0.5875
2023-07-24 16:55,596,256,340,62839,11232,51607,36859752.0,6567858.0,30291894.0,576,248,328,59328,9965,49363,34781645.0,5804306.0,28977339.0,0.5847,0.587,0.5825,0.587
2023-07-24 17:00,126,54,72,11639,2632,9007,6814252.0,1534972.0,5279279.0,99,35,64,11596,2194,9402,6798577.0,1277644.0,5520932.0,0.5832,0.5861,0.5823,0.5872
2023-07-24 17:05,194,72,122,22712,4127,18585,13332475.0,2413751.0,10918724.0,176,59,117,22155,4490,17665,13000406.0,2619317.0,10381089.0,0.5849,0.5875,0.5834,0.5877
2023-07-24 17:10,158,73,85,15919,4252,11667,9372090.0,2526446.0,6845644.0,170,81,89,17106,5292,11814,10028640.0,3080459.0,6948181.0,0.5942,0.5868,0.5821,0.5881
2023-07-24 17:15,245,57,188,22308,3232,19076,13099126.0,1890723.0,11208403.0,218,41,177,21687,2417,19270,12734741.0,1412875.0,11321866.0,0.585,0.5876,0.5846,0.5875
2023-07-24 17:20,251,105,146,21746,5934,15812,12774288.0,3491715.0,9282573.0,235,92,143,21064,5384,15680,12362447.0,3151959.0,9210488.0,0.5884,0.5871,0.5854,0.5874
2023-07-24 17:25,311,130,181,31454,9776,21678,30381407.0,17634262.0,12747145.0,289,117,172,29729,8540,21189,29334266.0,16876213.0,12458053.0,1.8038,0.588,1.9761,0.5879
2023-07-24 17:30,545,248,297,62941,18974,43967,37042594.0,11141623.0,25900971.0,502,220,282,61811,18155,43656,36365586.0,10646626.0,25718959.0,0.5872,0.5891,0.5864,0.5891
2023-07-24 17:35,918,468,450,105235,30810,74425,61892248.0,18071086.0,43821161.0,903,459,444,105030,30625,74405,61771595.0,17961912.0,43809683.0,0.5865,0.5888,0.5865,0.5888
2023-07-24 17:40,676,325,351,99563,27365,72198,58562355.0,16048554.0,42513800.0,657,308,349,98897,26889,72008,58175475.0,15769497.0,42405978.0,0.5865,0.5889,0.5865,0.5889
2023-07-24 17:45,994,444,550,151491,38587,112904,89135094.0,22640798.0,66494296.0,974,428,546,150870,38411,112459,88769500.0,22536749.0,66232751.0,0.5867,0.5889,0.5867,0.589
2023-07-24 17:50,1202,710,492,138793,92806,45987,93455039.0,66361264.0,27093775.0,1159,686,473,133613,89176,44437,90387476.0,64208174.0,26179302.0,0.7151,0.5892,0.72,0.5891
2023-07-24 17:55,1218,861,357,135081,109813,25268,91402422.0,76480299.0,14922123.0,1159,837,322,133481,109444,24037,90438245.0,76243342.0,14194903.0,0.6965,0.5906,0.6966,0.5905
2023-07-24 18:00,2326,1732,594,252518,218083,34435,160546095.0,140236317.0,20309778.0,2279,1711,568,250571,216927,33644,159389526.0,139520937.0,19868589.0,0.643,0.5898,0.6432,0.5906
2023-07-24 18:05,1265,786,479,110641,78979,31662,65123625.0,46492617.0,18631008.0,1229,761,468,99469,78012,21457,58582970.0,45915634.0,12667335.0,0.5887,0.5884,0.5886,0.5904
2023-07-24 18:10,235,123,112,17072,7930,9142,10048444.0,4663449.0,5384995.0,220,116,104,25666,9514,16152,15122688.0,5590526.0,9532161.0,0.5881,0.589,0.5876,0.5902
2023-07-24 18:15,452,266,186,29736,14900,14836,17512266.0,8768314.0,8743951.0,427,245,182,29360,14644,14716,17289426.0,8612461.0,8676965.0,0.5885,0.5894,0.5881,0.5896
2023-07-24 18:20,755,350,405,70518,15247,55271,41588656.0,8999006.0,32589649.0,729,336,393,69573,14805,54768,41008284.0,8709807.0,32298477.0,0.5902,0.5896,0.5883,0.5897
2023-07-24 18:25,406,290,116,43162,31391,11771,25434078.0,18489109.0,6944968.0,383,273,110,42119,30345,11774,24791047.0,17839539.0,6951508.0,0.589,0.59,0.5879,0.5904
2023-07-24 18:30,497,253,244,41219,23935,17284,24189268.0,14040204.0,10149064.0,493,250,243,40917,24509,16408,24028170.0,14359174.0,9668995.0,0.5866,0.5872,0.5859,0.5893
2023-07-24 18:35,456,277,179,35196,21857,13339,20650659.0,12807615.0,7843043.0,441,267,174,34860,20678,14182,20492413.0,12132666.0,8359746.0,0.586,0.588,0.5867,0.5895
2023-07-25 10:00,1323,801,522,86446,48887,37559,55619761.0,33300182.0,22319578.0,1031,676,355,73060,41454,31606,45410902.0,26711372.0,18699529.0,0.6812,0.5943,0.6444,0.5916
2023-07-25 10:05,2255,1678,577,234480,181531,52949,150348308.0,118708619.0,31639689.0,2104,1626,478,213623,178382,35241,128042840.0,107177784.0,20865056.0,0.6539,0.5976,0.6008,0.5921
2023-07-25 10:10,1187,652,535,95243,53210,42033,79783971.0,54970490.0,24813481.0,1102,603,499,100683,51599,49084,83024866.0,54045690.0,28979176.0,1.0331,0.5903,1.0474,0.5904
2023-07-25 10:15,640,334,306,22022,11752,10270,12946170.0,6887209.0,6058961.0,483,240,243,21971,11178,10793,13006902.0,6558786.0,6448116.0,0.586,0.59,0.5868,0.5974
2023-07-25 10:20,2546,1014,1532,222615,50638,171977,142887328.0,41580006.0,101307322.0,2484,978,1506,219877,49238,170639,141293640.0,40768240.0,100525400.0,0.8211,0.5891,0.828,0.5891
2023-07-25 10:25,2055,844,1211,161036,39280,121756,94765864.0,23032967.0,71732897.0,1988,805,1183,158534,38560,119974,93288028.0,22615396.0,70672631.0,0.5864,0.5892,0.5865,0.5891
2023-07-25 10:30,1113,332,781,95322,12890,82432,68114977.0,19504210.0,48610766.0,1052,291,761,91413,10275,81138,65749569.0,17909015.0,47840553.0,1.5131,0.5897,1.743,0.5896
2023-07-25 10:35,2682,1110,1572,287178,74360,212818,192928624.0,67452737.0,125475886.0,2598,1059,1539,282075,71371,210704,189922597.0,65675338.0,124247259.0,0.9071,0.5896,0.9202,0.5897
2023-07-25 10:40,575,349,226,32586,23027,9559,19196204.0,13553810.0,5642394.0,514,317,197,28552,21189,7363,16815741.0,12464184.0,4351557.0,0.5886,0.5903,0.5882,0.591
2023-07-25 10:45,1040,539,501,97232,49148,48084,69364133.0,41021677.0,28342455.0,940,475,465,78672,36572,42100,58249137.0,33384221.0,24864915.0,0.8347,0.5894,0.9128,0.5906
2023-07-25 10:50,2318,1142,1176,243905,131130,112775,264011237.0,197089524.0,66921713.0,1616,857,759,172580,95044,77536,220936274.0,174845895.0,46090378.0,1.503,0.5934,1.8396,0.5944
2023-07-25 10:55,3744,1743,2001,384755,159871,224884,265169238.0,131451199.0,133718039.0,2652,1146,1506,288779,106526,182253,207396406.0,98757126.0,108639280.0,0.8222,0.5946,0.9271,0.5961
2023-07-25 11:00,1886,866,1020,195084,75816,119268,163394688.0,92549988.0,70844700.0,1394,591,803,143292,54319,88973,132573111.0,79642033.0,52931077.0,1.2207,0.594,1.4662,0.5949
2023-07-25 11:05,1964,1019,945,180723,67960,112763,119566787.0,52662615.0,66904172.0,1381,594,787,141165,46748,94417,95722460.0,39553562.0,56168898.0,0.7749,0.5933,0.8461,0.5949
2023-07-25 11:10,1731,714,1017,219437,75850,143587,141592360.0,56761037.0,84831323.0,1248,425,823,159560,48740,110820,106303091.0,40600912.0,65702179.0,0.7483,0.5908,0.833,0.5929
2023-07-25 11:15,655,339,316,75783,39011,36772,56257270.0,34915212.0,21342057.0,465,211,254,70838,42415,28423,53676008.0,36835747.0,16840261.0,0.895,0.5804,0.8685,0.5925
2023-07-25 11:20,917,306,611,91625,19075,72550,66046524.0,23236952.0,42809572.0,655,110,545,75166,8450,66716,56342359.0,16852847.0,39489511.0,1.2182,0.5901,1.9944,0.5919
2023-07-25 11:25,1244,429,815,163279,43056,120223,155684579.0,84684500.0,71000079.0,1114,350,764,143690,33595,110095,144207971.0,79121703.0,65086268.0,1.9668,0.5906,2.3552,0.5912
2023-07-25 11:30,631,374,257,70555,48323,22232,41583325.0,28465238.0,13118087.0,475,301,174,64865,47218,17647,38201311.0,27763051.0,10438259.0,0.5891,0.5901,0.588,0.5915
2023-07-25 11:35,668,340,328,58569,29831,28738,34502997.0,17661032.0,16841965.0,517,253,264,43524,20329,23195,25672100.0,11969521.0,13702579.0,0.592,0.5861,0.5888,0.5908
2023-07-25 11:40,833,373,460,91867,48830,43037,78145067.0,52618444.0,25526622.0,689,316,373,78276,45866,32410,69885261.0,50732932.0,19152328.0,1.0776,0.5931,1.1061,0.5909
2023-07-25 11:45,307,138,169,26289,10346,15943,15480414.0,6202936.0,9277478.0,235,101,134,20008,7284,12724,11805572.0,4287076.0,7518496.0,0.5995,0.5819,0.5886,0.5909
2023-07-25 11:50,599,263,336,64067,18313,45754,37792738.0,10765599.0,27027139.0,515,186,329,63867,16877,46990,37663834.0,9923033.0,27740801.0,0.5879,0.5907,0.588,0.5904
2023-07-25 11:55,286,137,149,24779,9102,15677,14691116.0,5392483.0,9298633.0,210,96,114,20654,7137,13517,12182767.0,4196099.0,7986667.0,0.5925,0.5931,0.5879,0.5909
2023-07-25 12:00,577,291,286,56213,28162,28051,33182990.0,16636750.0,16546240.0,468,238,230,41678,19806,21872,24578938.0,11657559.0,12921379.0,0.5908,0.5899,0.5886,0.5908
2023-07-25 12:05,608,293,315,48582,21010,27572,28644977.0,12387041.0,16257935.0,537,251,286,46223,20346,25877,27272023.0,11972971.0,15299051.0,0.5896,0.5897,0.5885,0.5912
2023-07-25 12:10,248,171,77,19809,12078,7731,11713297.0,7105812.0,4607485.0,216,149,67,17814,11317,6497,10499349.0,6656963.0,3842386.0,0.5883,0.596,0.5882,0.5914
2023-07-25 12:15,335,186,149,29809,12333,17476,17591311.0,7284126.0,10307185.0,291,162,129,24795,10633,14162,14635896.0,6255808.0,8380087.0,0.5906,0.5898,0.5883,0.5917
2023-07-25 12:20,387,217,170,31626,15966,15660,18647180.0,9403126.0,9244054.0,348,184,164,29807,14611,15196,17575328.0,8598048.0,8977279.0,0.5889,0.5903,0.5885,0.5908
2023-07-25 12:25,473,242,231,52553,24350,28203,31043054.0,14385323.0,16657731.0,395,203,192,35721,15134,20587,21081476.0,8903307.0,12178169.0,0.5908,0.5906,0.5883,0.5915
2023-07-25 12:30,322,170,152,38852,23791,15061,22834130.0,13974887.0,8859243.0,266,129,137,34995,20776,14219,20637497.0,12200857.0,8436640.0,0.5874,0.5882,0.5873,0.5933
2023-07-25 12:35,259,137,122,31687,9796,21891,18700530.0,5771516.0,12929013.0,202,97,105,26965,6867,20098,15924228.0,4040600.0,11883627.0,0.5892,0.5906,0.5884,0.5913
2023-07-25 12:40,616,327,289,58131,18826,39305,33534162.0,11170968.0,22363194.0,521,275,246,52111,16754,35357,29944900.0,9863667.0,20081232.0,0.5934,0.569,0.5887,0.568
2023-07-25 12:45,583,297,286,78951,34322,44629,45691428.0,20297055.0,25394373.0,482,235,247,68225,29585,38640,39284569.0,17401770.0,21882798.0,0.5914,0.569,0.5882,0.5663
2023-07-25 12:50,486,217,269,47841,16307,31534,28248072.0,9605609.0,18642463.0,429,195,234,43643,14566,29077,25764339.0,8577319.0,17187020.0,0.589,0.5912,0.5889,0.5911
2023-07-25 12:55,140,56,84,7229,2192,5037,4264451.0,1299458.0,2964993.0,105,30,75,6442,1837,4605,3804031.0,1081439.0,2722591.0,0.5928,0.5886,0.5887,0.5912
2023-07-25 13:00,201,69,132,14038,4087,9951,8293592.0,2418306.0,5875286.0,168,51,117,10534,2138,8396,6225271.0,1258548.0,4966722.0,0.5917,0.5904,0.5887,0.5916
2023-07-25 13:05,403,219,184,32202,14365,17837,18874254.0,8449281.0,10424973.0,353,173,180,30381,13563,16818,17910276.0,7980862.0,9929414.0,0.5882,0.5845,0.5884,0.5904
2023-07-25 13:10,548,258,290,51133,18391,32742,30184456.0,10841577.0,19342879.0,503,235,268,46963,16425,30538,27711151.0,9672929.0,18038221.0,0.5895,0.5908,0.5889,0.5907
2023-07-25 13:15,443,199,244,50878,12951,37927,30005264.0,7624158.0,22381106.0,405,171,234,50205,12191,38014,29637427.0,7175212.0,22462215.0,0.5887,0.5901,0.5886,0.5909
2023-07-25 13:20,318,168,150,34543,12024,22519,20347395.0,7095070.0,13252325.0,268,133,135,30092,10178,19914,17754042.0,5990598.0,11763444.0,0.5901,0.5885,0.5886,0.5907
2023-07-25 13:25,206,113,93,14510,7400,7110,8503335.0,4363785.0,4139550.0,176,90,86,11806,5978,5828,6957608.0,3517630.0,3439977.0,0.5897,0.5822,0.5884,0.5903
2023-07-25 13:30,577,318,259,46504,23523,22981,27424085.0,13855576.0,13568509.0,536,288,248,46393,22953,23440,27355074.0,13514716.0,13840357.0,0.589,0.5904,0.5888,0.5905
2023-07-25 13:35,291,166,125,26606,12839,13767,15709838.0,7568619.0,8141218.0,245,138,107,24628,12264,12364,14526002.0,7216652.0,7309350.0,0.5895,0.5914,0.5884,0.5912
2023-07-25 13:40,198,96,102,16795,7322,9473,9921048.0,4340966.0,5580081.0,163,71,92,15234,6810,8424,8987598.0,4009054.0,4978543.0,0.5929,0.5891,0.5887,0.591
2023-07-25 13:45,236,130,106,21411,8517,12894,12565679.0,5004621.0,7561058.0,191,97,94,19249,7280,11969,11348045.0,4283557.0,7064487.0,0.5876,0.5864,0.5884,0.5902
2023-07-25 13:50,223,103,120,16303,5386,10917,9598025.0,3186112.0,6411912.0,167,70,97,15422,5578,9844,9080078.0,3271322.0,5808756.0,0.5916,0.5873,0.5865,0.5901
2023-07-25 13:55,107,46,61,8175,3062,5113,4776063.0,1794920.0,2981142.0,85,27,58,5975,1535,4440,3528235.0,902938.0,2625297.0,0.5862,0.5831,0.5882,0.5913
2023-07-25 14:00,321,133,188,27454,12030,15424,16222417.0,7108738.0,9113679.0,274,110,164,23784,10146,13638,14017380.0,5961697.0,8055683.0,0.5909,0.5909,0.5876,0.5907
2023-07-25 14:05,167,62,105,14932,6178,8754,8804671.0,3643849.0,5160822.0,147,56,91,13794,6190,7604,8134560.0,3641641.0,4492919.0,0.5898,0.5895,0.5883,0.5909
2023-07-25 14:10,219,104,115,20303,9151,11152,23862786.0,17296033.0,6566753.0,174,75,99,17155,7870,9285,21977090.0,16502390.0,5474700.0,1.8901,0.5888,2.0969,0.5896
2023-07-25 14:15,179,101,78,11581,5524,6057,6829036.0,3251873.0,3577163.0,157,82,75,10713,4377,6336,6311323.0,2571222.0,3740101.0,0.5887,0.5906,0.5874,0.5903
2023-07-25 14:20,114,58,56,8431,3925,4506,4969796.0,2308859.0,2660937.0,91,40,51,7889,3881,4008,4648729.0,2282048.0,2366681.0,0.5882,0.5905,0.588,0.5905
2023-07-25 14:25,130,64,66,8282,2722,5560,4888609.0,1606243.0,3282366.0,106,47,59,8022,2625,5397,4731388.0,1542167.0,3189220.0,0.5901,0.5904,0.5875,0.5909
2023-07-25 14:30,176,72,104,12922,3130,9792,7653635.0,1859008.0,5794627.0,148,52,96,12252,2718,9534,7230196.0,1599686.0,5630510.0,0.5939,0.5918,0.5886,0.5906
2023-07-25 14:35,151,46,105,16081,1990,14091,9531641.0,1200994.0,8330647.0,118,23,95,16100,1236,14864,9523430.0,727110.0,8796319.0,0.6035,0.5912,0.5883,0.5918
2023-07-25 14:40,245,110,135,21748,7043,14705,12799140.0,4156515.0,8642625.0,206,92,114,17520,5290,12230,10326467.0,3111179.0,7215287.0,0.5902,0.5877,0.5881,0.59
2023-07-25 14:45,457,127,330,60207,8458,51749,35283312.0,4973547.0,30309764.0,406,94,312,54981,6387,48594,32379880.0,3748371.0,28631509.0,0.588,0.5857,0.5869,0.5892
2023-07-25 14:50,306,89,217,41181,4221,36960,24264384.0,2481845.0,21782539.0,269,60,209,40403,3625,36778,23802724.0,2129563.0,21673161.0,0.588,0.5894,0.5875,0.5893
2023-07-25 14:55,192,85,107,14590,6079,8511,8600051.0,3578813.0,5021238.0,160,67,93,12864,4724,8140,7574964.0,2771921.0,4803043.0,0.5887,0.59,0.5868,0.5901
2023-07-25 15:00,243,100,143,20727,6818,13909,12232646.0,4032372.0,8200274.0,208,83,125,19741,7205,12536,11620742.0,4223008.0,7397734.0,0.5914,0.5896,0.5861,0.5901
2023-07-25 15:05,315,122,193,28695,6462,22233,16921400.0,3816819.0,13104581.0,286,100,186,28482,6299,22183,16794078.0,3705476.0,13088602.0,0.5907,0.5894,0.5883,0.59
2023-07-25 15:10,570,229,341,47907,13888,34019,28272200.0,8178048.0,20094152.0,533,202,331,47526,13925,33601,28041379.0,8195088.0,19846291.0,0.5889,0.5907,0.5885,0.5906
2023-07-25 15:15,1054,824,230,66035,51775,14260,50762399.0,42354285.0,8408114.0,857,668,189,64279,50845,13434,49727266.0,41801521.0,7925745.0,0.818,0.5896,0.8221,0.59
2023-07-25 15:20,756,386,370,64779,17275,47504,38239385.0,10182524.0,28056861.0,596,238,358,64085,16808,47277,37825875.0,9891579.0,27934296.0,0.5894,0.5906,0.5885,0.5909
2023-07-25 15:25,2155,377,1778,348702,21248,327454,228856811.0,36213136.0,192643675.0,2083,338,1745,338136,18717,319419,222941301.0,34736425.0,188204876.0,1.7043,0.5883,1.8559,0.5892
2023-07-25 15:30,1402,483,919,131647,24345,107302,77297168.0,14241457.0,63055710.0,1275,397,878,125129,19312,105817,73515937.0,11313487.0,62202450.0,0.585,0.5876,0.5858,0.5878
2023-07-25 15:35,1716,630,1086,170475,27490,142985,100085246.0,16108198.0,83977048.0,1631,586,1045,167085,26307,140778,98168696.0,15410679.0,82758016.0,0.586,0.5873,0.5858,0.5879
2023-07-25 15:40,2137,483,1654,260467,16451,244016,153074629.0,9635479.0,143439149.0,2086,447,1639,258591,15164,243427,151967760.0,8871051.0,143096709.0,0.5857,0.5878,0.585,0.5878
2023-07-25 15:45,1546,356,1190,167922,9004,158918,98747642.0,5277992.0,93469649.0,1501,324,1177,166387,7839,158548,97843308.0,4591105.0,93252202.0,0.5862,0.5882,0.5857,0.5882
2023-07-25 15:50,753,269,484,64392,9744,54648,37853629.0,5716244.0,32137385.0,792,268,524,64615,10186,54429,38010675.0,5970462.0,32040213.0,0.5866,0.5881,0.5861,0.5887
2023-07-25 15:55,699,206,493,72202,9061,63141,42447124.0,5308579.0,37138545.0,666,183,483,69799,7103,62696,41048062.0,4161472.0,36886590.0,0.5859,0.5882,0.5859,0.5883
2023-07-25 16:00,701,197,504,80558,6795,73763,59264155.0,15857062.0,43407092.0,683,182,501,81929,8234,73695,60049337.0,16683493.0,43365844.0,2.3336,0.5885,2.0262,0.5885
2023-07-25 16:05,1558,434,1124,182302,13240,169062,107225875.0,7765367.0,99460508.0,1527,408,1119,180826,12025,168801,106372508.0,7054987.0,99317520.0,0.5865,0.5883,0.5867,0.5884
2023-07-25 16:10,789,237,552,81221,15330,65891,47793013.0,9010145.0,38782868.0,741,202,539,78664,14149,64515,46295664.0,8317692.0,37977972.0,0.5877,0.5886,0.5879,0.5887
2023-07-25 16:15,535,236,299,49833,19123,30710,29338766.0,11232189.0,18106577.0,492,215,277,45344,17459,27885,26682887.0,10251154.0,16431733.0,0.5874,0.5896,0.5872,0.5893
2023-07-25 16:20,714,274,440,61083,21194,39889,35958004.0,12458267.0,23499737.0,681,263,418,58771,20681,38090,34595444.0,12143507.0,22451937.0,0.5878,0.5891,0.5872,0.5894
2023-07-25 16:25,484,226,258,44586,15704,28882,26231019.0,9241289.0,16989729.0,457,208,249,43368,15020,28348,25522986.0,8819400.0,16703586.0,0.5885,0.5882,0.5872,0.5892
2023-07-25 16:30,372,219,153,41967,16518,25449,24696284.0,9706825.0,14989459.0,340,197,143,37335,16235,21100,21966188.0,9533530.0,12432658.0,0.5877,0.589,0.5872,0.5892
2023-07-25 16:35,1287,508,779,138830,26309,112521,116977554.0,51081550.0,65896004.0,1145,413,732,133716,22951,110765,114248899.0,49069233.0,65179665.0,1.9416,0.5856,2.138,0.5885
2023-07-25 16:40,751,239,512,110944,13020,97924,65250552.0,7635137.0,57615414.0,721,221,500,103966,13301,90665,61125095.0,7785054.0,53340041.0,0.5864,0.5884,0.5853,0.5883
2023-07-25 16:45,669,247,422,73370,10157,63213,55074085.0,17828555.0,37245530.0,642,233,409,77294,9574,67720,57406599.0,17488119.0,39918479.0,1.7553,0.5892,1.8266,0.5895
2023-07-25 16:50,479,223,256,40943,11593,29350,24047939.0,6796152.0,17251787.0,435,197,238,39449,10800,28649,23179247.0,6327737.0,16851509.0,0.5862,0.5878,0.5859,0.5882
2023-07-25 16:55,468,300,168,39129,27555,11574,24232357.0,17423590.0,6808766.0,403,278,125,33586,25411,8175,19713205.0,14901091.0,4812113.0,0.6323,0.5883,0.5864,0.5886
2023-07-25 17:00,227,146,81,11231,7238,3993,6598767.0,4248268.0,2350499.0,124,59,65,11217,7303,3914,6593786.0,4285876.0,2307910.0,0.5869,0.5887,0.5869,0.5897
2023-07-25 17:05,194,93,101,24033,11795,12238,14131988.0,6911049.0,7220939.0,192,81,111,19362,11910,7452,11365048.0,6976731.0,4388317.0,0.5859,0.59,0.5858,0.5889
2023-07-25 17:10,478,130,348,87583,12849,74734,122427376.0,78801153.0,43626223.0,377,72,305,80284,9797,70487,118550362.0,76985164.0,41565198.0,6.1329,0.5838,7.858,0.5897
2023-07-25 17:15,748,283,465,79996,14415,65581,94473309.0,55946995.0,38526314.0,636,195,441,78210,11018,67192,93426363.0,53935275.0,39491087.0,3.8812,0.5875,4.8952,0.5877
2023-07-25 17:20,614,184,430,89722,8762,80960,52722608.0,5140613.0,47581995.0,575,160,415,87714,9148,78566,51521795.0,5349242.0,46172552.0,0.5867,0.5877,0.5847,0.5877
2023-07-25 17:25,915,105,810,159820,5801,154019,117521175.0,27143079.0,90378096.0,863,67,796,157265,4490,152775,116125719.0,26377301.0,89748418.0,4.679,0.5868,5.8747,0.5875
2023-07-25 17:30,2487,205,2282,415675,3762,411913,244089321.0,2191246.0,241898074.0,2439,168,2271,417715,3423,414292,245322989.0,1992648.0,243330340.0,0.5825,0.5873,0.5821,0.5873
2023-07-25 17:35,1092,42,1050,180091,2875,177216,117698047.0,13558353.0,104139694.0,1059,17,1042,178132,1122,177010,116546896.0,12529269.0,104017626.0,4.7159,0.5876,11.1669,0.5876
2023-07-25 17:40,625,151,474,87559,5331,82228,51483348.0,3146049.0,48337299.0,592,124,468,86939,4729,82210,51097851.0,2769146.0,48328705.0,0.5901,0.5878,0.5856,0.5879
2023-07-25 17:45,297,117,180,33222,5238,27984,31425324.0,14951977.0,16473347.0,271,99,172,35011,4672,30339,32476900.0,14607861.0,17869039.0,2.8545,0.5887,3.1267,0.589
2023-07-25 17:50,166,75,91,14322,3102,11220,8416926.0,1818596.0,6598330.0,154,68,86,14310,3153,11157,8413977.0,1847858.0,6566119.0,0.5863,0.5881,0.5861,0.5885
2023-07-25 17:55,302,103,199,29227,4530,24697,17188642.0,2664202.0,14524440.0,269,78,191,27911,3654,24257,16410368.0,2141958.0,14268409.0,0.5881,0.5881,0.5862,0.5882
2023-07-25 18:00,181,82,99,15856,6124,9732,9350252.0,3616056.0,5734195.0,138,53,85,13551,5786,7765,7941946.0,3373758.0,4568188.0,0.5905,0.5892,0.5831,0.5883
2023-07-25 18:05,133,68,65,8846,2769,6077,5194063.0,1623050.0,3571013.0,117,55,62,7675,2862,4813,4516933.0,1674964.0,2841968.0,0.5862,0.5876,0.5852,0.5905
2023-07-25 18:10,406,269,137,16896,6414,10482,9917218.0,3754424.0,6162793.0,399,254,145,15453,4820,10633,9077089.0,2817713.0,6259375.0,0.5853,0.5879,0.5846,0.5887
2023-07-25 18:15,401,125,276,29707,11112,18595,17471645.0,6533691.0,10937953.0,362,108,254,27822,10249,17573,16348289.0,6003095.0,10345193.0,0.588,0.5882,0.5857,0.5887
2023-07-25 18:20,962,380,582,96787,9878,86909,56911695.0,5790809.0,51120886.0,939,369,570,95347,9689,85658,56086382.0,5678742.0,50407640.0,0.5862,0.5882,0.5861,0.5885
2023-07-25 18:25,1034,293,741,158562,14220,144342,93298280.0,8358138.0,84940142.0,997,266,731,157853,13973,143880,92863139.0,8190948.0,84672191.0,0.5878,0.5885,0.5862,0.5885
2023-07-25 18:30,227,113,114,25129,10095,15034,14812170.0,5968921.0,8843248.0,179,90,89,20225,7398,12827,11908949.0,4337242.0,7571706.0,0.5913,0.5882,0.5863,0.5903
2023-07-25 18:35,446,278,168,32788,5215,27573,19335740.0,3080373.0,16255366.0,435,274,161,32185,4731,27454,18968205.0,2776632.0,16191572.0,0.5907,0.5895,0.5869,0.5898
2023-07-26 10:00,1817,1238,579,191310,147410,43900,122702762.0,96224222.0,26478540.0,1451,1097,354,160207,134271,25936,101213951.0,85872612.0,15341339.0,0.6528,0.6032,0.6395,0.5915
2023-07-26 10:05,2410,1125,1285,225886,121302,104584,156431615.0,94909497.0,61522118.0,2256,1065,1191,215116,117221,97895,140882506.0,83081983.0,57800523.0,0.7824,0.5883,0.7088,0.5904
2023-07-26 10:10,2705,755,1950,233779,50833,182946,137526814.0,29651322.0,107875492.0,2587,697,1890,224952,45473,179479,132596788.0,26679722.0,105917066.0,0.5833,0.5897,0.5867,0.5901
2023-07-26 10:15,971,549,422,86822,53325,33497,51000275.0,31289853.0,19710422.0,873,505,368,77124,52260,24864,45341445.0,30677852.0,14663593.0,0.5868,0.5884,0.587,0.5898
2023-07-26 10:20,1912,704,1208,168865,46906,121959,122952677.0,51244984.0,71707692.0,1722,589,1133,168936,44505,124431,123046610.0,49838539.0,73208071.0,1.0925,0.588,1.1198,0.5883
2023-07-26 10:25,737,389,348,53128,33808,19320,31239330.0,19857451.0,11381879.0,668,361,307,48187,31330,16857,28331502.0,18392638.0,9938864.0,0.5874,0.5891,0.5871,0.5896
2023-07-26 10:30,1687,677,1010,172184,30128,142056,101231382.0,17678180.0,83553202.0,1560,641,919,164726,26827,137899,96952794.0,15735721.0,81217073.0,0.5868,0.5882,0.5866,0.589
2023-07-26 10:35,2228,533,1695,281736,30141,251595,165592276.0,17641254.0,147951022.0,2135,464,1671,275670,27318,248352,162102526.0,15986513.0,146116012.0,0.5853,0.5881,0.5852,0.5883
2023-07-26 10:40,539,152,387,80052,8168,71884,47027004.0,4783077.0,42243926.0,490,131,359,76815,7395,69420,57012292.0,16204181.0,40808110.0,0.5856,0.5877,2.1912,0.5878
2023-07-26 10:45,372,287,85,15194,9559,5635,20786200.0,17478235.0,3307965.0,317,262,55,13314,8676,4638,7808154.0,5078332.0,2729822.0,1.8285,0.587,0.5853,0.5886
2023-07-26 10:50,494,271,223,41068,19305,21763,24003823.0,11314143.0,12689680.0,405,232,173,36483,16791,19692,21392189.0,9823676.0,11568513.0,0.5861,0.5831,0.5851,0.5875
2023-07-26 10:55,607,288,319,36060,12252,23808,21130994.0,7162936.0,13968058.0,590,250,340,35555,11795,23760,20846869.0,6892921.0,13953947.0,0.5846,0.5867,0.5844,0.5873
2023-07-26 11:00,1806,451,1355,251886,26228,225658,183081383.0,50967341.0,132114041.0,1684,400,1284,245115,23951,221164,179255749.0,49609123.0,129646625.0,1.9432,0.5855,2.0713,0.5862
2023-07-26 11:05,3283,871,2412,415470,49969,365501,278578796.0,64824496.0,213754300.0,3034,714,2320,402829,43415,359414,271222829.0,60891149.0,210331679.0,1.2973,0.5848,1.4025,0.5852
2023-07-26 11:10,2455,801,1654,310066,39671,270395,181172516.0,23079013.0,158093502.0,2330,705,1625,302403,33814,268589,176715975.0,19669140.0,157046835.0,0.5818,0.5847,0.5817,0.5847
2023-07-26 11:15,1732,473,1259,220875,27578,193297,129102596.0,16098723.0,113003872.0,1603,396,1207,212119,23764,188355,124044902.0,13834054.0,110210848.0,0.5838,0.5846,0.5821,0.5851
2023-07-26 11:20,2597,572,2025,316597,25796,290801,184915558.0,15057190.0,169858367.0,2530,507,2023,312830,22656,290174,182727960.0,13180754.0,169547206.0,0.5837,0.5841,0.5818,0.5843
2023-07-26 11:25,1910,550,1360,226581,31990,194591,227119336.0,113573088.0,113546247.0,1687,385,1302,210121,22141,187980,217685524.0,107863935.0,109821589.0,3.5503,0.5835,4.8717,0.5842
2023-07-26 11:30,1962,503,1459,218524,41146,177378,151164405.0,47647681.0,103516724.0,1801,414,1387,210238,35082,175156,146338684.0,44125400.0,102213284.0,1.158,0.5836,1.2578,0.5836
2023-07-26 11:35,1786,424,1362,163572,18589,144983,119051099.0,34533648.0,84517451.0,1684,339,1345,160772,17045,143727,117460201.0,33633859.0,83826341.0,1.8577,0.5829,1.9732,0.5832
2023-07-26 11:40,1150,334,816,90074,11605,78469,64441396.0,18637221.0,45804175.0,1079,274,805,89817,11956,77861,64251998.0,18815763.0,45436235.0,1.606,0.5837,1.5738,0.5836
2023-07-26 11:45,1533,371,1162,166278,14887,151391,108878867.0,20508456.0,88370410.0,1377,270,1107,157166,11640,145526,103641476.0,18631137.0,85010338.0,1.3776,0.5837,1.6006,0.5842
2023-07-26 11:50,757,322,435,46895,14738,32157,74771925.0,56090080.0,18681844.0,637,235,402,40370,10183,30187,71042942.0,53420906.0,17622035.0,3.8058,0.581,5.2461,0.5838
2023-07-26 11:55,1137,396,741,77948,12043,65905,57359671.0,18875749.0,38483922.0,1075,347,728,75819,10904,64915,56122413.0,18213526.0,37908887.0,1.5674,0.5839,1.6704,0.584
2023-07-26 12:00,492,201,291,22367,9258,13109,13044302.0,5391756.0,7652546.0,460,178,282,23039,10127,12912,13414100.0,5879945.0,7534155.0,0.5824,0.5838,0.5806,0.5835
2023-07-26 12:05,480,168,312,46116,10333,35783,26906124.0,6009147.0,20896977.0,447,142,305,43123,7662,35461,25176957.0,4456612.0,20720344.0,0.5815,0.584,0.5817,0.5843
2023-07-26 12:10,952,323,629,112084,18146,93938,77305463.0,22400483.0,54904979.0,927,283,644,112651,17530,95121,77685971.0,22080519.0,55605452.0,1.2345,0.5845,1.2596,0.5846
2023-07-26 12:15,349,192,157,19042,10392,8650,11092999.0,6033032.0,5059966.0,316,162,154,16895,8223,8672,9867196.0,4790225.0,5076970.0,0.5805,0.585,0.5825,0.5854
2023-07-26 12:20,121,55,66,7999,2053,5946,4685145.0,1198821.0,3486323.0,104,47,57,10061,4576,5485,5872393.0,2659598.0,3212794.0,0.5839,0.5863,0.5812,0.5857
2023-07-26 12:25,672,255,417,64026,15223,48803,37454349.0,8902115.0,28552234.0,635,232,403,61691,13478,48213,36071793.0,7855989.0,28215804.0,0.5848,0.5851,0.5829,0.5852
2023-07-26 12:30,381,136,245,31265,11546,19719,18286287.0,6734087.0,11552199.0,350,125,225,29235,11422,17813,17080105.0,6661918.0,10418186.0,0.5832,0.5858,0.5833,0.5849
2023-07-26 12:35,604,229,375,45963,11635,34328,26890436.0,6796022.0,20094414.0,561,201,360,42861,9562,33299,25062615.0,5575092.0,19487523.0,0.5841,0.5854,0.583,0.5852
2023-07-26 12:40,1493,344,1149,193010,14617,178393,124576467.0,20375625.0,104200842.0,1453,314,1139,190302,13597,176705,123023367.0,19780441.0,103242925.0,1.394,0.5841,1.4548,0.5843
2023-07-26 12:45,2169,670,1499,236239,34167,202072,138041114.0,19959808.0,118081305.0,2015,629,1386,231909,31975,199934,135444512.0,18605716.0,116838796.0,0.5842,0.5844,0.5819,0.5844
2023-07-26 12:50,345,142,203,28733,5708,23025,16770144.0,3320185.0,13449959.0,319,124,195,27430,4924,22506,16009678.0,2862571.0,13147107.0,0.5817,0.5841,0.5814,0.5842
2023-07-26 12:55,398,197,201,24242,9314,14928,14148527.0,5454580.0,8693947.0,442,237,205,26254,11608,14646,15289027.0,6735421.0,8553606.0,0.5856,0.5824,0.5802,0.584
2023-07-26 13:00,345,156,189,21992,6834,15158,12815759.0,3993045.0,8822714.0,320,138,182,20671,6175,14496,12051256.0,3589874.0,8461382.0,0.5843,0.5821,0.5814,0.5837
2023-07-26 13:05,131,61,70,8206,2673,5533,4794800.0,1565424.0,3229376.0,100,46,54,7843,2519,5324,4570700.0,1462754.0,3107945.0,0.5856,0.5837,0.5807,0.5838
2023-07-26 13:10,150,90,60,7727,3169,4558,4485695.0,1835246.0,2650449.0,103,54,49,6392,2473,3919,3723163.0,1430051.0,2293112.0,0.5791,0.5815,0.5783,0.5851
2023-07-26 13:15,99,64,35,4006,2509,1497,2319738.0,1438594.0,881144.0,75,46,29,3427,2013,1414,2000450.0,1169991.0,830459.0,0.5734,0.5886,0.5812,0.5873
2023-07-26 13:20,161,93,68,11241,4652,6589,6554475.0,2705609.0,3848865.0,139,77,62,10720,4334,6386,6249340.0,2518527.0,3730812.0,0.5816,0.5841,0.5811,0.5842
2023-07-26 13:25,244,127,117,17450,5530,11920,10194872.0,3222521.0,6972351.0,224,106,118,16934,5173,11761,9883916.0,3008668.0,6875248.0,0.5827,0.5849,0.5816,0.5846
2023-07-26 13:30,250,89,161,28201,4542,23659,16504535.0,2645451.0,13859084.0,230,75,155,27032,3615,23417,15813130.0,2102100.0,13711029.0,0.5824,0.5858,0.5815,0.5855
2023-07-26 13:35,798,383,415,70198,20989,49209,53078237.0,24309471.0,28768766.0,746,348,398,66803,18815,47988,50893605.0,22835394.0,28058210.0,1.1582,0.5846,1.2137,0.5847
2023-07-26 13:40,364,198,166,30280,8609,21671,17693893.0,5018301.0,12675591.0,345,184,161,29955,8266,21689,17504032.0,4816975.0,12687057.0,0.5829,0.5849,0.5827,0.585
2023-07-26 13:45,597,418,179,41165,21303,19862,24050047.0,12428731.0,11621315.0,574,404,170,40861,21792,19069,23852171.0,12694324.0,11157846.0,0.5834,0.5851,0.5825,0.5851
2023-07-26 13:50,753,548,205,49530,39024,10506,28912365.0,22769206.0,6143158.0,733,535,198,49353,38482,10871,28789398.0,22432239.0,6357159.0,0.5835,0.5847,0.5829,0.5848
2023-07-26 13:55,822,424,398,77613,29539,48074,45336311.0,17259432.0,28076879.0,782,402,380,75991,28927,47064,44397503.0,16860336.0,27537166.0,0.5843,0.584,0.5829,0.5851
2023-07-26 14:00,1253,874,379,93512,68905,24607,54565601.0,40168940.0,14396661.0,1228,858,370,92590,67960,24630,54033419.0,39620205.0,14413214.0,0.583,0.5851,0.583,0.5852
2023-07-26 14:05,1270,1038,232,96654,84297,12357,56383758.0,49150171.0,7233587.0,1244,1015,229,95838,83789,12049,55905223.0,48851772.0,7053450.0,0.5831,0.5854,0.583,0.5854
2023-07-26 14:10,1158,908,250,100362,83047,17315,70469388.0,60314631.0,10154756.0,1131,892,239,98935,81989,16946,69637526.0,59695545.0,9941980.0,0.7263,0.5865,0.7281,0.5867
2023-07-26 14:15,1377,943,434,139268,112609,26659,81347469.0,65711052.0,15636416.0,1362,935,427,138971,112980,25991,81174548.0,65927893.0,15246655.0,0.5835,0.5865,0.5835,0.5866
2023-07-26 14:20,2210,1526,684,260278,222293,37985,175847943.0,153556578.0,22291365.0,2154,1490,664,258081,220763,37318,174553197.0,152651431.0,21901765.0,0.6908,0.5868,0.6915,0.5869
2023-07-26 14:25,1723,1256,467,204667,182172,22495,119577811.0,106381493.0,13196318.0,1676,1225,451,202907,181368,21539,118558972.0,105923509.0,12635462.0,0.584,0.5866,0.584,0.5866
2023-07-26 14:30,1642,1183,459,213989,198410,15579,125037453.0,115899604.0,9137848.0,1633,1175,458,214455,198349,16106,125308648.0,115862353.0,9446295.0,0.5841,0.5865,0.5841,0.5865
2023-07-26 14:35,1206,820,386,137297,122250,15047,80201166.0,71381091.0,8820074.0,1157,789,368,135777,121753,14024,79314535.0,71089844.0,8224691.0,0.5839,0.5862,0.5839,0.5865
2023-07-26 14:40,1398,1048,350,152869,142622,10247,89309555.0,83303363.0,6006192.0,1367,1028,339,152950,142777,10173,89345780.0,83382521.0,5963258.0,0.5841,0.5861,0.584,0.5862
2023-07-26 14:45,1457,1030,427,118002,98569,19433,69018362.0,57628207.0,11390155.0,1421,1007,414,116074,97602,18472,67811175.0,56981434.0,10829740.0,0.5846,0.5861,0.5838,0.5863
2023-07-26 14:50,1657,792,865,187404,80279,107125,109990735.0,47107570.0,62883165.0,1564,733,831,182028,77239,104789,106622310.0,45089177.0,61533132.0,0.5868,0.587,0.5838,0.5872
2023-07-26 14:55,2071,679,1392,202615,36873,165742,130879026.0,33495258.0,97383768.0,1978,610,1368,199037,34505,164532,128735078.0,32065285.0,96669793.0,0.9084,0.5876,0.9293,0.5875
2023-07-26 15:00,528,170,358,38651,8247,30404,22793795.0,4935631.0,17858163.0,472,131,341,33284,6592,26692,19538735.0,3855770.0,15682964.0,0.5985,0.5874,0.5849,0.5876
2023-07-26 15:05,657,254,403,59692,17072,42620,46875060.0,21870657.0,25004403.0,610,225,385,57804,16045,41759,45759209.0,21257511.0,24501698.0,1.2811,0.5867,1.3249,0.5867
2023-07-26 15:10,1958,490,1468,241478,17597,223881,153805520.0,22210875.0,131594644.0,1899,449,1450,241897,16075,225822,154018883.0,21278852.0,132740031.0,1.2622,0.5878,1.3237,0.5878
2023-07-26 15:15,225,104,121,19034,2901,16133,11183830.0,1699843.0,9483986.0,192,85,107,18234,2673,15561,10714977.0,1563515.0,9151461.0,0.586,0.5879,0.5849,0.5881
2023-07-26 15:20,958,248,710,130291,8499,121792,76620611.0,5009618.0,71610992.0,891,203,688,123719,6350,117369,72757652.0,3715815.0,69041836.0,0.5894,0.588,0.5852,0.5882
2023-07-26 15:25,546,246,300,49795,10834,38961,29232909.0,6351075.0,22881833.0,511,225,286,48079,9991,38088,28222890.0,5851805.0,22371084.0,0.5862,0.5873,0.5857,0.5874
2023-07-26 15:30,136,91,45,10421,3974,6447,6114011.0,2327174.0,3786837.0,113,73,40,9286,3933,5353,5441497.0,2298034.0,3143463.0,0.5856,0.5874,0.5843,0.5872
2023-07-26 15:35,127,70,57,6330,2180,4150,3744652.0,1282716.0,2461935.0,88,38,50,6411,1495,4916,3781838.0,874221.0,2907617.0,0.5884,0.5932,0.5848,0.5915
2023-07-26 15:40,86,51,35,6212,3700,2512,3647192.0,2169203.0,1477989.0,63,38,25,3126,1125,2001,1835560.0,658994.0,1176566.0,0.5863,0.5884,0.5858,0.588
2023-07-26 15:45,685,307,378,60604,14930,45674,35634407.0,8763927.0,26870479.0,643,281,362,56427,14300,42127,33170978.0,8382752.0,24788225.0,0.587,0.5883,0.5862,0.5884
2023-07-26 15:50,167,93,74,12110,3614,8496,7134683.0,2129936.0,5004747.0,129,69,60,10679,3468,7211,6268255.0,2030836.0,4237418.0,0.5894,0.5891,0.5856,0.5876
2023-07-26 15:55,353,199,154,19262,10944,8318,11289843.0,6414040.0,4875803.0,322,179,143,17700,9827,7873,10381970.0,5755798.0,4626171.0,0.5861,0.5862,0.5857,0.5876
2023-07-26 16:00,231,148,83,16373,11603,4770,9598416.0,6797988.0,2800427.0,209,138,71,20632,11431,9201,12106127.0,6696949.0,5409178.0,0.5859,0.5871,0.5859,0.5879
2023-07-26 16:05,1315,614,701,136056,34924,101132,79928330.0,20463792.0,59464538.0,1284,595,689,134504,34920,99584,79012322.0,20431089.0,58581233.0,0.586,0.588,0.5851,0.5883
2023-07-26 16:10,754,351,403,68276,22954,45322,40128694.0,13473344.0,26655349.0,719,331,388,65825,22147,43678,38652045.0,12971791.0,25680254.0,0.587,0.5881,0.5857,0.5879
2023-07-26 16:15,306,168,138,19433,9956,9477,11393141.0,5841222.0,5551919.0,285,155,130,19902,9869,10033,11671772.0,5778471.0,5893300.0,0.5867,0.5858,0.5855,0.5874
2023-07-26 16:20,626,324,302,34957,15154,19803,20505012.0,8884356.0,11620656.0,594,304,290,32406,15345,17061,19005760.0,8983889.0,10021871.0,0.5863,0.5868,0.5855,0.5874
2023-07-26 16:25,675,440,235,57101,32072,25029,69114258.0,54428183.0,14686074.0,616,399,217,49601,27209,22392,64705906.0,51556833.0,13149073.0,1.6971,0.5868,1.8948,0.5872
2023-07-26 16:30,306,170,136,26889,13055,13834,15689351.0,7632720.0,8056631.0,259,135,124,24658,12124,12534,14448115.0,7086734.0,7361380.0,0.5847,0.5824,0.5845,0.5873
2023-07-26 16:35,220,113,107,17704,5888,11816,10392465.0,3465721.0,6926744.0,185,86,99,16414,5074,11340,9614320.0,2963082.0,6651237.0,0.5886,0.5862,0.584,0.5865
2023-07-26 16:40,125,72,53,13374,5646,7728,7839485.0,3305881.0,4533604.0,89,57,32,7759,3406,4353,4550433.0,1988585.0,2561848.0,0.5855,0.5866,0.5838,0.5885
2023-07-26 16:45,379,192,187,21806,8250,13556,12794764.0,4830272.0,7964492.0,363,177,186,21751,7905,13846,12757723.0,4625136.0,8132586.0,0.5855,0.5875,0.5851,0.5874
2023-07-26 16:50,1035,339,696,120502,17371,103131,70740518.0,10206613.0,60533905.0,1022,330,692,119187,16484,102703,69930640.0,9646618.0,60284022.0,0.5876,0.587,0.5852,0.587
2023-07-26 16:55,430,214,216,31297,10885,20412,18355290.0,6385307.0,11969983.0,398,189,209,30545,10376,20169,17915521.0,6075539.0,11839982.0,0.5866,0.5864,0.5855,0.587
2023-07-26 17:00,485,112,373,54189,4794,49395,31767976.0,2807299.0,28960676.0,454,92,362,52488,4056,48432,30802730.0,2371241.0,28431488.0,0.5856,0.5863,0.5846,0.587
2023-07-26 17:05,255,53,202,30936,997,29939,18161295.0,586659.0,17574636.0,240,40,200,31066,932,30134,18237078.0,545083.0,17691995.0,0.5884,0.587,0.5849,0.5871
2023-07-26 17:10,225,70,155,24752,1267,23485,14527793.0,743988.0,13783805.0,196,42,154,24291,871,23420,14257717.0,509514.0,13748202.0,0.5872,0.5869,0.585,0.587
2023-07-26 17:15,427,100,327,57868,2996,54872,33947290.0,1754056.0,32193234.0,399,80,319,57058,2666,54392,33500472.0,1559455.0,31941016.0,0.5855,0.5867,0.5849,0.5872
2023-07-26 17:20,1705,250,1455,246764,11688,235076,144785360.0,6837803.0,137947557.0,1675,231,1444,246058,11289,234769,144372809.0,6600545.0,137772263.0,0.585,0.5868,0.5847,0.5868
2023-07-26 17:25,875,134,741,143809,4842,138967,84392960.0,2835567.0,81557393.0,849,109,740,143608,4654,138954,84270029.0,2718830.0,81551198.0,0.5856,0.5869,0.5842,0.5869
2023-07-26 17:30,1738,437,1301,209279,19959,189320,122699009.0,11656942.0,111042066.0,1723,425,1298,205411,16142,189269,120452274.0,9428437.0,111023837.0,0.584,0.5865,0.5841,0.5866
2023-07-26 17:35,1111,391,720,128468,13104,115364,75392235.0,7669116.0,67723119.0,1090,377,713,128014,12800,115214,75116814.0,7484066.0,67632748.0,0.5853,0.587,0.5847,0.587
2023-07-26 17:40,1026,340,686,113246,8799,104447,66492905.0,5173645.0,61319260.0,1008,331,677,112707,8491,104216,66150296.0,4965493.0,61184803.0,0.588,0.5871,0.5848,0.5871
2023-07-26 17:45,1064,335,729,120443,13594,106849,70697913.0,7961837.0,62736075.0,1048,326,722,119478,13116,106362,70121844.0,7670179.0,62451665.0,0.5857,0.5871,0.5848,0.5872
2023-07-26 17:50,821,236,585,99079,9938,89141,58118963.0,5835686.0,52283277.0,795,222,573,97490,9194,88296,57167380.0,5373351.0,51794028.0,0.5872,0.5865,0.5844,0.5866
2023-07-26 17:55,1286,418,868,118176,16735,101441,69353348.0,9838489.0,59514859.0,1244,392,852,116000,15430,100570,68031360.0,9022710.0,59008650.0,0.5879,0.5867,0.5848,0.5867
2023-07-26 18:00,1163,340,823,93982,14002,79980,55075608.0,8185074.0,46890534.0,1137,329,808,92855,14254,78601,54431305.0,8317447.0,46113858.0,0.5846,0.5863,0.5835,0.5867
2023-07-26 18:05,845,225,620,83023,10894,72129,48709364.0,6410941.0,42298422.0,817,203,614,81377,9593,71784,47735802.0,5606415.0,42129386.0,0.5885,0.5864,0.5844,0.5869
2023-07-26 18:10,1091,271,820,112647,10493,102154,66119268.0,6165808.0,59953460.0,1038,236,802,110875,9373,101502,65048936.0,5480097.0,59568838.0,0.5876,0.5869,0.5847,0.5869
2023-07-26 18:15,60,36,24,2564,1400,1164,1509997.0,826030.0,683966.0,36,18,18,2515,1231,1284,1474003.0,719026.0,754976.0,0.59,0.5876,0.5841,0.588
2023-07-26 18:20,235,105,130,17175,4770,12405,33871732.0,26592833.0,7278899.0,213,95,118,15024,4187,10837,32571225.0,26203176.0,6368049.0,5.575,0.5868,6.2582,0.5876
2023-07-26 18:25,325,96,229,44665,3767,40898,26231094.0,2198153.0,24032940.0,298,78,220,41944,3243,38701,24765546.0,1890070.0,22875476.0,0.5835,0.5876,0.5828,0.5911
2023-07-26 18:30,940,395,545,80058,29161,50897,47006173.0,17185168.0,29821004.0,888,363,525,77086,27393,49693,45151594.0,16011410.0,29140184.0,0.5893,0.5859,0.5845,0.5864
2023-07-26 18:35,192,102,90,15939,9685,6254,9325989.0,5662718.0,3663271.0,178,92,86,15614,10086,5528,9139157.0,5893467.0,3245689.0,0.5847,0.5857,0.5843,0.5871
2023-07-27 10:00,2570,1699,871,209494,127071,82423,127656864.0,78687097.0,48969767.0,2206,1547,659,189243,119653,69590,113312376.0,72360008.0,40952367.0,0.6192,0.5941,0.6047,0.5885
2023-07-27 10:05,2671,1944,727,337825,300987,36838,209868999.0,188175435.0,21693564.0,2577,1917,660,329640,295756,33884,195369723.0,175417039.0,19952684.0,0.6252,0.5889,0.5931,0.5889
2023-07-27 10:10,1097,703,394,93346,69681,23665,54732743.0,40745423.0,13987320.0,933,616,317,84984,66677,18307,49806891.0,39022554.0,10784337.0,0.5847,0.5911,0.5852,0.5891
2023-07-27 10:15,1610,920,690,149776,87316,62460,111718836.0,75001496.0,36717339.0,1491,863,628,144148,84194,59954,108361117.0,73088670.0,35272446.0,0.859,0.5879,0.8681,0.5883
2023-07-27 10:20,1763,1140,623,133472,88556,44916,102274198.0,75795567.0,26478631.0,1558,1025,533,130233,86948,43285,100316224.0,74787788.0,25528435.0,0.8559,0.5895,0.8601,0.5898
2023-07-27 10:25,1514,1253,261,206967,191087,15880,121431281.0,112062607.0,9368673.0,1470,1240,230,203054,189980,13074,119096299.0,111393099.0,7703199.0,0.5864,0.59,0.5863,0.5892
2023-07-27 10:30,793,559,234,88043,71779,16264,51935056.0,42203130.0,9731925.0,747,535,212,85681,69997,15684,50301709.0,41035142.0,9266567.0,0.588,0.5984,0.5862,0.5908
2023-07-27 10:35,252,149,103,17631,13681,3950,10343887.0,8023887.0,2320000.0,213,130,83,16315,12674,3641,9582400.0,7430476.0,2151924.0,0.5865,0.5873,0.5863,0.591
2023-07-27 10:40,265,136,129,15177,7560,7617,8930244.0,4433805.0,4496439.0,205,114,91,12906,6643,6263,7595883.0,3896842.0,3699041.0,0.5865,0.5903,0.5866,0.5906
2023-07-27 10:45,178,109,69,10865,5284,5581,6425568.0,3106770.0,3318797.0,135,94,41,8867,4844,4023,5212704.0,2842278.0,2370425.0,0.588,0.5947,0.5868,0.5892
2023-07-27 10:50,501,313,188,34071,20870,13201,19960166.0,12225982.0,7734184.0,470,287,183,31188,19880,11308,18311416.0,11641665.0,6669751.0,0.5858,0.5859,0.5856,0.5898
2023-07-27 10:55,866,494,372,79728,48387,31341,58606238.0,40204796.0,18401441.0,827,468,359,78528,47933,30595,57907484.0,39918576.0,17988907.0,0.8309,0.5871,0.8328,0.588
2023-07-27 11:00,610,366,244,47728,30364,17364,28007433.0,17806031.0,10201401.0,576,343,233,46708,29632,17076,27373008.0,17342407.0,10030600.0,0.5864,0.5875,0.5853,0.5874
2023-07-27 11:05,345,219,126,29228,14933,14295,17086182.0,8750351.0,8335831.0,298,188,110,26834,14077,12757,15737494.0,8241438.0,7496056.0,0.586,0.5831,0.5855,0.5876
2023-07-27 11:10,711,387,324,60506,20437,40069,35441988.0,11952806.0,23489181.0,675,356,319,58313,18979,39334,34196189.0,11104503.0,23091685.0,0.5849,0.5862,0.5851,0.5871
2023-07-27 11:15,854,437,417,76921,31520,45401,45140850.0,18461007.0,26679843.0,817,412,405,75208,30004,45204,44127860.0,17569762.0,26558097.0,0.5857,0.5876,0.5856,0.5875
2023-07-27 11:20,441,254,187,31623,15849,15774,18596553.0,9315369.0,9281184.0,399,225,174,30190,14620,15570,17721773.0,8565231.0,9156541.0,0.5878,0.5884,0.5859,0.5881
2023-07-27 11:25,304,180,124,21774,9165,12609,24699423.0,17278139.0,7421284.0,270,154,116,19398,7258,12140,23275663.0,16131267.0,7144396.0,1.8852,0.5886,2.2225,0.5885
2023-07-27 11:30,934,133,801,32623,8677,23946,31014914.0,16951455.0,14063459.0,173,115,58,13573,7904,5669,19841226.0,16505291.0,3335935.0,1.9536,0.5873,2.0882,0.5885
2023-07-27 11:35,482,346,136,52981,40777,12204,31186853.0,24014321.0,7172531.0,440,318,122,50811,38727,12084,29786773.0,22685291.0,7101481.0,0.5889,0.5877,0.5858,0.5877
2023-07-27 11:40,604,464,140,92087,81747,10340,54032365.0,47932191.0,6100173.0,579,448,131,90111,81261,8850,52849850.0,47643875.0,5205975.0,0.5863,0.59,0.5863,0.5882
2023-07-27 11:45,605,527,78,110178,102617,7561,76500593.0,72051341.0,4449252.0,576,511,65,105100,98544,6556,73511101.0,69654537.0,3856564.0,0.7021,0.5884,0.7068,0.5882
2023-07-27 11:50,927,626,301,135536,105053,30483,79561268.0,61636076.0,17925191.0,905,609,296,134905,104613,30292,79172735.0,61356289.0,17816446.0,0.5867,0.588,0.5865,0.5882
2023-07-27 11:55,377,340,37,54776,47455,7321,32165576.0,27857741.0,4307835.0,353,320,33,53307,46466,6841,31281829.0,27255634.0,4026195.0,0.587,0.5884,0.5866,0.5885
2023-07-27 12:00,218,195,23,32639,30607,2032,19148918.0,17949657.0,1199260.0,282,227,55,34223,31250,2973,20095135.0,18321214.0,1773921.0,0.5865,0.5902,0.5863,0.5967
2023-07-27 12:05,653,323,330,148848,90795,58053,87398092.0,53265015.0,34133076.0,547,281,266,145450,89869,55581,85407722.0,52716408.0,32691313.0,0.5867,0.588,0.5866,0.5882
2023-07-27 12:10,475,250,225,102849,50537,52312,61218897.0,30064659.0,31154237.0,355,147,208,84209,41878,42331,49484580.0,24583228.0,24901351.0,0.5949,0.5955,0.587,0.5883
2023-07-27 12:15,1080,531,549,302187,147257,154930,180000158.0,86858650.0,93141507.0,977,446,531,288932,135518,153414,171947564.0,79580201.0,92367363.0,0.5898,0.6012,0.5872,0.6021
2023-07-27 12:20,310,239,71,41398,27443,13955,24440504.0,16206836.0,8233667.0,262,203,59,38375,25159,13216,22565290.0,14776700.0,7788590.0,0.5906,0.59,0.5873,0.5893
2023-07-27 12:25,913,392,521,231199,61205,169994,136067005.0,35959819.0,100107185.0,854,348,506,223591,55616,167975,131555370.0,32629352.0,98926018.0,0.5875,0.5889,0.5867,0.5889
2023-07-27 12:30,1086,496,590,288016,110005,178011,169749158.0,64870207.0,104878951.0,1018,451,567,283787,106217,177570,167053406.0,62431199.0,104622207.0,0.5897,0.5892,0.5878,0.5892
2023-07-27 12:35,1283,730,553,293635,141533,152102,197207433.0,107418448.0,89788984.0,1187,665,522,284506,135229,149277,191523382.0,103409254.0,88114127.0,0.759,0.5903,0.7647,0.5903
2023-07-27 12:40,764,333,431,156356,62344,94012,92329483.0,36803468.0,55526015.0,672,292,380,149602,60716,88886,88334730.0,35792402.0,52542327.0,0.5903,0.5906,0.5895,0.5911
2023-07-27 12:45,770,369,401,190828,79117,111711,124327206.0,58462486.0,65864720.0,714,321,393,185109,76088,109021,120945684.0,56660693.0,64284990.0,0.7389,0.5896,0.7447,0.5897
2023-07-27 12:50,602,290,312,76989,43896,33093,45425308.0,25877857.0,19547450.0,545,258,287,69775,39316,30459,41139965.0,23154896.0,17985069.0,0.5895,0.5907,0.5889,0.5905
2023-07-27 12:55,1036,598,438,218619,118512,100107,129047301.0,69902761.0,59144540.0,974,564,410,217144,117855,99289,128168380.0,69493679.0,58674700.0,0.5898,0.5908,0.5897,0.5909
2023-07-27 13:00,491,300,191,94030,52802,41228,55499785.0,31158446.0,24341338.0,446,276,170,92719,52918,39801,54722969.0,31202899.0,23520070.0,0.5901,0.5904,0.5896,0.5909
2023-07-27 13:05,564,445,119,89904,65872,24032,53069134.0,38878514.0,14190620.0,495,390,105,87187,63304,23883,51431786.0,37316146.0,14115640.0,0.5902,0.5905,0.5895,0.591
2023-07-27 13:10,552,473,79,102885,90388,12497,72706675.0,65318886.0,7387789.0,483,422,61,99806,87210,12596,70786015.0,63338430.0,7447584.0,0.7226,0.5912,0.7263,0.5913
2023-07-27 13:15,664,559,105,161160,141198,19962,107423993.0,95610631.0,11813361.0,584,508,76,150791,134950,15841,101008687.0,91624502.0,9384185.0,0.6771,0.5918,0.679,0.5924
2023-07-27 13:20,772,498,274,153252,95819,57433,115737700.0,80426585.0,35311114.0,643,442,201,124360,82381,41979,97572643.0,72404929.0,25167714.0,0.8394,0.6148,0.8789,0.5995
2023-07-27 13:25,853,569,284,155441,97740,57701,108166032.0,69907183.0,38258848.0,733,511,222,145461,91034,54427,102023212.0,65757995.0,36265217.0,0.7152,0.6631,0.7223,0.6663
2023-07-27 13:30,1034,507,527,171969,68043,103926,132706335.0,64214198.0,68492137.0,838,437,401,155314,62585,92729,122195675.0,60865943.0,61329732.0,0.9437,0.659,0.9725,0.6614
2023-07-27 13:35,657,357,300,127946,46518,81428,92447772.0,39524219.0,52923553.0,563,304,259,116237,42397,73840,85328189.0,36959553.0,48368636.0,0.8497,0.6499,0.8717,0.655
2023-07-27 13:40,707,389,318,151609,63799,87810,121286404.0,61647876.0,59638528.0,664,358,306,143785,57016,86769,116477024.0,57436073.0,59040950.0,0.9663,0.6792,1.0074,0.6804
2023-07-27 13:45,432,276,156,62519,23848,38671,37602664.0,14047267.0,23555397.0,329,205,124,57870,19570,38300,35807192.0,11531815.0,24275377.0,0.589,0.6091,0.5893,0.6338
2023-07-27 13:50,167,99,68,26158,12292,13866,15442952.0,7255034.0,8187917.0,132,82,50,24314,10848,13466,14560554.0,6393078.0,8167475.0,0.5902,0.5905,0.5893,0.6065
2023-07-27 13:55,370,182,188,76973,24222,52751,57384286.0,26162155.0,31222131.0,317,141,176,74871,22947,51924,56336328.0,25388615.0,30947713.0,1.0801,0.5919,1.1064,0.596
2023-07-27 14:00,543,252,291,76178,17090,59088,44932392.0,10048940.0,34883451.0,451,210,241,71184,12420,58764,41993295.0,7299301.0,34693993.0,0.588,0.5904,0.5877,0.5904
2023-07-27 14:05,583,329,254,75135,31996,43139,56231375.0,30762939.0,25468436.0,527,291,236,72011,30293,41718,54335545.0,29694322.0,24641222.0,0.9615,0.5904,0.9802,0.5907
2023-07-27 14:10,299,159,140,36660,14036,22624,21653837.0,8275727.0,13378109.0,251,130,121,34030,13228,20802,20088437.0,7787390.0,12301047.0,0.5896,0.5913,0.5887,0.5913
2023-07-27 14:15,645,324,321,108814,52456,56358,76155638.0,42843413.0,33312225.0,584,285,299,102807,48483,54324,72605500.0,40476251.0,32129249.0,0.8167,0.5911,0.8349,0.5914
2023-07-27 14:20,499,278,221,70933,46829,24104,53853268.0,39569351.0,14283917.0,440,255,185,68862,46194,22668,52587750.0,39155460.0,13432290.0,0.845,0.5926,0.8476,0.5926
2023-07-27 14:25,901,516,385,136923,87211,49712,81051376.0,51600444.0,29450931.0,833,488,345,132076,86640,45436,78133731.0,51198849.0,26934882.0,0.5917,0.5924,0.5909,0.5928
2023-07-27 14:30,1016,587,429,148180,88791,59389,99333384.0,64327467.0,35005917.0,959,557,402,145173,88141,57032,97695216.0,63936631.0,33758584.0,0.7245,0.5894,0.7254,0.5919
2023-07-27 14:35,424,177,247,72325,24221,48104,42688382.0,14287297.0,28401085.0,397,155,242,72401,24624,47777,42763535.0,14516421.0,28247114.0,0.5899,0.5904,0.5895,0.5912
2023-07-27 14:40,335,154,181,54333,18453,35880,32171138.0,10897620.0,21273517.0,291,125,166,50049,16010,34039,29570698.0,9441964.0,20128733.0,0.5906,0.5929,0.5898,0.5913
2023-07-27 14:45,337,142,195,51161,21854,29307,42138806.0,24788927.0,17349879.0,302,120,182,46502,18595,27907,39368751.0,22848542.0,16520208.0,1.1343,0.592,1.2287,0.592
2023-07-27 14:50,479,249,230,72021,38074,33947,42566037.0,22490440.0,20075597.0,443,231,212,70305,37903,32402,41563609.0,22386468.0,19177141.0,0.5907,0.5914,0.5906,0.5919
2023-07-27 14:55,818,384,434,131382,51770,79612,89295757.0,42428640.0,46867117.0,781,360,421,126357,50746,75611,86512498.0,41814890.0,44697608.0,0.8196,0.5887,0.824,0.5912
2023-07-27 15:00,793,361,432,122391,47619,74772,72274278.0,28136612.0,44137666.0,751,327,424,119000,43841,75159,70259811.0,25850007.0,44409804.0,0.5909,0.5903,0.5896,0.5909
2023-07-27 15:05,203,101,102,19378,6669,12709,11450065.0,3933021.0,7517044.0,175,80,95,17769,6301,11468,10494825.0,3714330.0,6780494.0,0.5897,0.5915,0.5895,0.5913
2023-07-27 15:10,160,86,74,14905,5582,9323,8806779.0,3294920.0,5511859.0,124,59,65,13357,5237,8120,7891084.0,3088258.0,4802826.0,0.5903,0.5912,0.5897,0.5915
2023-07-27 15:15,371,183,188,52434,21799,30635,31008516.0,12903475.0,18105040.0,343,167,176,51172,20913,30259,30218224.0,12333694.0,17884530.0,0.5919,0.591,0.5898,0.591
2023-07-27 15:20,503,256,247,62167,23889,38278,36750443.0,14126473.0,22623969.0,479,240,239,61083,23269,37814,36071926.0,13721546.0,22350379.0,0.5913,0.591,0.5897,0.5911
2023-07-27 15:25,139,70,69,18000,4486,13514,10652593.0,2663936.0,7988656.0,109,53,56,15652,3768,11884,9245176.0,2220724.0,7024452.0,0.5938,0.5911,0.5894,0.5911
2023-07-27 15:30,161,87,74,18952,6698,12254,11172861.0,3947914.0,7224947.0,139,70,69,19894,6376,13518,11744242.0,3755363.0,7988879.0,0.5894,0.5896,0.589,0.591
2023-07-27 15:35,138,82,56,14642,6177,8465,8643959.0,3638149.0,5005810.0,104,58,46,13175,5485,7690,7773614.0,3227724.0,4545889.0,0.589,0.5914,0.5885,0.5911
2023-07-27 15:40,76,51,25,5863,3010,2853,3461238.0,1779007.0,1682231.0,51,38,13,5359,2895,2464,3161767.0,1704568.0,1457199.0,0.591,0.5896,0.5888,0.5914
2023-07-27 15:45,101,54,47,10623,3254,7369,6231422.0,1921163.0,4310259.0,78,38,40,9835,3104,6731,5811597.0,1827730.0,3983866.0,0.5904,0.5849,0.5888,0.5919
2023-07-27 15:50,314,192,122,35118,13337,21781,20706403.0,7850438.0,12855965.0,276,169,107,31072,12948,18124,18320040.0,7617473.0,10702567.0,0.5886,0.5902,0.5883,0.5905
2023-07-27 15:55,131,91,40,14738,6377,8361,20491011.0,15633424.0,4857587.0,91,62,29,12709,5374,7335,19360222.0,15033762.0,4326460.0,2.4515,0.581,2.7975,0.5898
2023-07-27 16:00,682,348,334,109599,50882,58717,64537947.0,29933863.0,34604084.0,640,316,324,102049,45236,56813,60062852.0,26578491.0,33484361.0,0.5883,0.5893,0.5876,0.5894
2023-07-27 16:05,472,234,238,69375,36414,32961,52808393.0,33368354.0,19440039.0,415,208,207,55239,27626,27613,44464617.0,28147661.0,16316955.0,0.9164,0.5898,1.0189,0.5909
2023-07-27 16:10,257,151,106,30758,18461,12297,18147550.0,10879909.0,7267640.0,240,141,99,31187,18950,12237,18390960.0,11160766.0,7230194.0,0.5893,0.591,0.589,0.5908
2023-07-27 16:15,611,269,342,76239,32919,43320,45019506.0,19419644.0,25599862.0,584,249,335,79224,36219,43005,46765465.0,21348133.0,25417331.0,0.5899,0.5909,0.5894,0.591
2023-07-27 16:20,218,107,111,30219,16281,13938,29728655.0,21484010.0,8244644.0,194,99,95,27548,15484,12064,28146372.0,21005918.0,7140454.0,1.3196,0.5915,1.3566,0.5919
2023-07-27 16:25,924,622,302,142573,106710,35863,120087327.0,98786884.0,21300442.0,848,595,253,132686,100036,32650,114095121.0,94721353.0,19373768.0,0.9258,0.5939,0.9469,0.5934
2023-07-27 16:30,870,617,253,133761,104734,29027,102890101.0,85694091.0,17196009.0,807,589,218,130310,103525,26785,100817795.0,84916891.0,15900903.0,0.8182,0.5924,0.8203,0.5936
2023-07-27 16:35,630,407,223,87609,58828,28781,63777431.0,46689948.0,17087483.0,583,382,201,83479,57111,26368,61297417.0,45646195.0,15651222.0,0.7937,0.5937,0.7993,0.5936
2023-07-27 16:40,632,517,115,123555,108073,15482,73216095.0,64017807.0,9198288.0,613,517,96,121751,107029,14722,72080322.0,63337886.0,8742436.0,0.5924,0.5941,0.5918,0.5938
2023-07-27 16:45,1771,648,1123,307098,101313,205785,264374320.0,142929290.0,121445030.0,1595,555,1040,282533,92623,189910,250021715.0,137736045.0,112285670.0,1.4108,0.5902,1.4871,0.5913
2023-07-27 16:50,1695,1127,568,220916,165128,55788,142589593.0,109537826.0,33051766.0,1609,1084,525,214031,160366,53665,138323046.0,106533097.0,31789949.0,0.6634,0.5925,0.6643,0.5924
2023-07-27 16:55,1463,1156,307,213837,188926,24911,126332067.0,111582111.0,14749955.0,1422,1135,287,211667,188421,23246,125045833.0,111264965.0,13780868.0,0.5906,0.5921,0.5905,0.5928
2023-07-27 17:00,1076,453,623,149375,76524,72851,100049558.0,57041928.0,43007629.0,1009,417,592,143450,73075,70375,96636126.0,54996583.0,41639543.0,0.7454,0.5904,0.7526,0.5917
2023-07-27 17:05,660,364,296,65634,36355,29279,38742937.0,21421482.0,17321455.0,632,350,282,65977,37289,28688,38937370.0,21961715.0,16975654.0,0.5892,0.5916,0.589,0.5917
2023-07-27 17:10,1669,904,765,189391,110239,79152,111858372.0,65053790.0,46804582.0,1632,885,747,188090,108952,79138,111001398.0,64198767.0,46802631.0,0.5901,0.5913,0.5892,0.5914
2023-07-27 17:15,1522,624,898,200710,84833,115877,130587982.0,62021006.0,68566976.0,1475,611,864,192894,82924,109970,125862881.0,60765555.0,65097326.0,0.7311,0.5917,0.7328,0.592
2023-07-27 17:20,918,399,519,112468,43010,69458,66477508.0,25386876.0,41090631.0,872,369,503,110263,42026,68237,65177980.0,24771235.0,40406745.0,0.5903,0.5916,0.5894,0.5922
2023-07-27 17:25,639,326,313,93796,40001,53795,79374444.0,47536956.0,31837488.0,605,307,298,90448,37417,53031,77210693.0,45805991.0,31404701.0,1.1884,0.5918,1.2242,0.5922
2023-07-27 17:30,942,233,709,103133,20247,82886,72886378.0,23819769.0,49066608.0,888,202,686,100495,18774,81721,71345546.0,22948605.0,48396941.0,1.1765,0.592,1.2224,0.5922
2023-07-27 17:35,236,72,164,31288,4417,26871,18566062.0,2649243.0,15916819.0,204,54,150,30308,3731,26577,17941477.0,2198974.0,15742503.0,0.5998,0.5923,0.5894,0.5923
2023-07-27 17:40,1220,416,804,148110,34905,113205,99460566.0,32445101.0,67015465.0,1181,395,786,145259,33487,111772,97796482.0,31611127.0,66185354.0,0.9295,0.592,0.944,0.5921
2023-07-27 17:45,533,292,241,35975,16340,19635,21234171.0,9627117.0,11607053.0,517,283,234,32734,15500,17234,19334005.0,9135621.0,10198384.0,0.5892,0.5911,0.5894,0.5918
2023-07-27 17:50,157,80,77,16976,5787,11189,10045539.0,3418698.0,6626840.0,135,70,65,14168,4420,9748,8376506.0,2605044.0,5771462.0,0.5908,0.5923,0.5894,0.5921
2023-07-27 17:55,251,129,122,27828,8788,19040,28305054.0,17053337.0,11251717.0,238,119,119,27317,8365,18952,28012972.0,16802453.0,11210518.0,1.9405,0.591,2.0087,0.5915
2023-07-27 18:00,411,191,220,40019,10956,29063,23617857.0,6451633.0,17166224.0,380,166,214,39668,11002,28666,23393842.0,6452439.0,16941402.0,0.5889,0.5907,0.5865,0.591
2023-07-27 18:05,194,88,106,15533,5366,10167,9170283.0,3158418.0,6011865.0,178,77,101,16000,5075,10925,9450200.0,2985010.0,6465190.0,0.5886,0.5913,0.5882,0.5918
2023-07-27 18:10,642,320,322,63811,24490,39321,49418539.0,26272576.0,23145963.0,581,276,305,56307,22088,34219,45052278.0,24860799.0,20191479.0,1.0728,0.5886,1.1255,0.5901
2023-07-27 18:15,340,141,199,33090,9028,24062,19407436.0,5324961.0,14082475.0,292,110,182,28476,7046,21430,16785331.0,4143211.0,12642119.0,0.5898,0.5853,0.588,0.5899
2023-07-27 18:20,621,277,344,60174,20330,39844,47006970.0,23804187.0,23202782.0,520,208,312,48241,13937,34304,40262623.0,20048401.0,20214222.0,1.1709,0.5823,1.4385,0.5893
2023-07-27 18:25,911,372,539,87511,24784,62727,51472277.0,14542231.0,36930045.0,871,323,548,83385,21258,62127,49093268.0,12471631.0,36621637.0,0.5868,0.5887,0.5867,0.5895
2023-07-27 18:30,202,100,102,18820,6102,12718,11065901.0,3574901.0,7491000.0,157,72,85,16154,4674,11480,9510891.0,2736300.0,6774591.0,0.5859,0.589,0.5854,0.5901
2023-07-27 18:35,295,131,164,29247,3587,25660,17286946.0,2122780.0,15164165.0,283,119,164,29255,3272,25983,17275823.0,1919835.0,15355988.0,0.5918,0.591,0.5867,0.591
2023-07-28 10:00,3430,872,2558,416342,50453,365889,249992492.0,34072061.0,215920431.0,3086,704,2382,392393,39690,352703,233242034.0,25578336.0,207663698.0,0.6753,0.5901,0.6445,0.5888
2023-07-28 10:05,1339,447,892,135039,21521,113518,79310584.0,12598353.0,66712230.0,1208,378,830,128701,19481,109220,75681089.0,11405426.0,64275663.0,0.5854,0.5877,0.5855,0.5885
2023-07-28 10:10,765,311,454,71485,17841,53644,42018957.0,10447047.0,31571910.0,658,241,417,68824,17476,51348,40382861.0,10188487.0,30194373.0,0.5856,0.5885,0.583,0.588
2023-07-28 10:15,1504,711,793,126857,49939,76918,74568828.0,29305649.0,45263179.0,1424,665,759,123104,48523,74581,72324077.0,28450151.0,43873925.0,0.5868,0.5885,0.5863,0.5883
2023-07-28 10:20,1371,547,824,101113,28832,72281,59417858.0,16899601.0,42518257.0,1199,437,762,97966,28385,69581,57594772.0,16643718.0,40951053.0,0.5861,0.5882,0.5864,0.5885
2023-07-28 10:25,387,191,196,25089,9368,15721,14703120.0,5468358.0,9234762.0,312,143,169,21727,6666,15061,12761668.0,3904697.0,8856971.0,0.5837,0.5874,0.5858,0.5881
2023-07-28 10:30,2124,475,1649,237641,26380,211261,174866593.0,51046215.0,123820377.0,1952,361,1591,220388,18469,201919,155499158.0,36861378.0,118637779.0,1.935,0.5861,1.9959,0.5876
2023-07-28 10:35,1886,381,1505,242757,18613,224144,143011466.0,10861358.0,132150108.0,1804,321,1483,238734,15817,222917,140233833.0,9242460.0,130991372.0,0.5835,0.5896,0.5843,0.5876
2023-07-28 10:40,1861,479,1382,207196,19935,187261,145266111.0,35407778.0,109858333.0,1768,403,1365,199542,16204,183338,140828571.0,33216130.0,107612441.0,1.7762,0.5867,2.0499,0.587
2023-07-28 10:45,2062,534,1528,211543,26897,184646,123964770.0,15733641.0,108231129.0,1959,456,1503,201674,22493,179181,118208057.0,13124511.0,105083545.0,0.585,0.5862,0.5835,0.5865
2023-07-28 10:50,1912,605,1307,194916,31617,163299,114348443.0,18571997.0,95776446.0,1843,561,1282,185400,27804,157596,108657242.0,16233390.0,92423852.0,0.5874,0.5865,0.5839,0.5865
2023-07-28 10:55,1789,545,1244,177485,27004,150481,132265433.0,27675145.0,104590287.0,1743,511,1232,174853,24933,149920,124898557.0,26435410.0,98463146.0,1.0249,0.695,1.0603,0.6568
2023-07-28 11:00,278,105,173,20982,4449,16533,18005974.0,2604160.0,15401814.0,225,75,150,14760,3762,10998,14450564.0,2191812.0,12258752.0,0.5853,0.9316,0.5826,1.1146
2023-07-28 11:05,731,320,411,60884,20798,40086,49254558.0,24071204.0,25183354.0,675,291,384,55348,18847,36501,44282859.0,22883343.0,21399515.0,1.1574,0.6282,1.2142,0.5863
2023-07-28 11:10,500,214,286,40397,11311,29086,23622605.0,6645901.0,16976704.0,443,185,258,36887,9690,27197,21562400.0,5653580.0,15908820.0,0.5876,0.5837,0.5834,0.5849
2023-07-28 11:15,1167,274,893,135427,12484,122943,80155960.0,7252654.0,72903306.0,1088,224,864,134046,10291,123755,80074657.0,5993597.0,74081059.0,0.581,0.593,0.5824,0.5986
2023-07-28 11:20,1233,230,1003,178326,13052,165274,104497027.0,7758455.0,96738571.0,1197,201,996,172564,10735,161829,108324538.0,6256092.0,102068446.0,0.5944,0.5853,0.5828,0.6307
2023-07-28 11:25,311,109,202,31918,8667,23251,18642231.0,5079236.0,13562995.0,258,67,191,28064,6127,21937,16451541.0,3567020.0,12884521.0,0.586,0.5833,0.5822,0.5873
2023-07-28 11:30,636,107,529,93501,5103,88398,54812488.0,2979526.0,51832961.0,613,86,527,93794,5641,88153,54973202.0,3290829.0,51682373.0,0.5839,0.5864,0.5834,0.5863
2023-07-28 11:35,890,193,697,134309,13798,120511,78660782.0,8059642.0,70601140.0,848,155,693,134357,12567,121790,78704892.0,7332258.0,71372634.0,0.5841,0.5858,0.5835,0.586
2023-07-28 11:40,1027,352,675,116072,26178,89894,68012372.0,15297847.0,52714524.0,991,328,663,114045,24692,89353,66830489.0,14420163.0,52410325.0,0.5844,0.5864,0.584,0.5866
2023-07-28 11:45,839,355,484,100647,34800,65847,71980080.0,32341554.0,39638525.0,789,324,465,87375,32337,55038,63111582.0,30807264.0,32304318.0,0.9294,0.602,0.9527,0.5869
2023-07-28 11:50,175,79,96,14099,7433,6666,20171470.0,16243229.0,3928241.0,122,49,73,12206,6085,6121,19045591.0,15437519.0,3608072.0,2.1853,0.5893,2.537,0.5895
2023-07-28 11:55,143,82,61,13179,6427,6752,7828901.0,3818688.0,4010213.0,88,60,28,7418,5344,2074,4357362.0,3121917.0,1235444.0,0.5942,0.5939,0.5842,0.5957
2023-07-28 12:00,969,581,388,102405,64427,37978,60154564.0,37813887.0,22340677.0,931,560,371,100519,61723,38796,59110962.0,36237912.0,22873050.0,0.5869,0.5883,0.5871,0.5896
2023-07-28 12:05,380,214,166,34389,18813,15576,20225730.0,11042821.0,9182909.0,353,198,155,32747,18496,14251,19239478.0,10856896.0,8382582.0,0.587,0.5896,0.587,0.5882
2023-07-28 12:10,326,216,110,22751,11883,10868,13367278.0,6974959.0,6392319.0,299,203,96,23410,11452,11958,13767844.0,6719225.0,7048618.0,0.587,0.5882,0.5867,0.5894
2023-07-28 12:15,107,70,37,8472,3959,4513,4994316.0,2335944.0,2658372.0,82,52,30,6976,2852,4124,4100417.0,1672836.0,2427581.0,0.59,0.589,0.5865,0.5886
2023-07-28 12:20,71,40,31,5319,2995,2324,3129902.0,1761686.0,1368215.0,52,25,27,3491,1724,1767,2051298.0,1011019.0,1040279.0,0.5882,0.5887,0.5864,0.5887
2023-07-28 12:25,1723,1226,497,208829,172114,36715,171386904.0,149621867.0,21765037.0,1557,1138,419,197433,155566,41867,165094149.0,139342521.0,25751628.0,0.8693,0.5928,0.8957,0.6151
2023-07-28 12:30,831,259,572,93206,22935,70271,67565059.0,25415138.0,42149921.0,732,221,511,76881,21192,55689,57446191.0,24388897.0,33057293.0,1.1081,0.5998,1.1509,0.5936
2023-07-28 12:35,1290,618,672,122605,44463,78142,96159656.0,49982028.0,46177628.0,1228,586,642,121135,44185,76950,95345753.0,49800878.0,45544874.0,1.1241,0.5909,1.1271,0.5919
2023-07-28 12:40,347,206,141,25297,14195,11102,14953829.0,8385838.0,6567991.0,319,192,127,22777,14206,8571,13466865.0,8388730.0,5078135.0,0.5908,0.5916,0.5905,0.5925
2023-07-28 12:45,437,227,210,35149,12805,22344,20788866.0,7552555.0,13236311.0,402,211,191,29955,12112,17843,17703850.0,7141074.0,10562776.0,0.5898,0.5924,0.5896,0.592
2023-07-28 12:50,472,257,215,33002,16464,16538,43224242.0,33456631.0,9767611.0,450,245,205,33462,15489,17973,43518554.0,32880126.0,10638428.0,2.0321,0.5906,2.1228,0.5919
2023-07-28 12:55,904,654,250,110923,78958,31965,77417986.0,58431606.0,18986380.0,868,634,234,107520,76820,30700,75311250.0,57134542.0,18176707.0,0.74,0.594,0.7437,0.5921
2023-07-28 13:00,310,182,128,21376,11027,10349,12629535.0,6500345.0,6129190.0,279,161,118,17936,9511,8425,10596245.0,5604435.0,4991809.0,0.5895,0.5922,0.5893,0.5925
2023-07-28 13:05,332,70,262,15965,4847,11118,9437269.0,2859300.0,6577969.0,300,49,251,13120,2883,10237,7755285.0,1698923.0,6056362.0,0.5899,0.5917,0.5893,0.5916
2023-07-28 13:10,339,48,291,34124,11485,22639,20203830.0,6786770.0,13417059.0,301,24,277,24718,3642,21076,14643121.0,2141133.0,12501988.0,0.5909,0.5927,0.5879,0.5932
2023-07-28 13:15,570,66,504,88631,2537,86094,52413760.0,1527636.0,50886124.0,531,49,482,78904,1965,76939,46665890.0,1159245.0,45506645.0,0.6021,0.5911,0.5899,0.5915
2023-07-28 13:20,152,96,56,10557,5608,4949,6269949.0,3341933.0,2928016.0,118,74,44,8074,3072,5002,4774432.0,1809636.0,2964796.0,0.5959,0.5916,0.5891,0.5927
2023-07-28 13:25,826,470,356,69313,38871,30442,41039478.0,22994875.0,18044603.0,797,457,340,66560,37887,28673,39377785.0,22376199.0,17001586.0,0.5916,0.5928,0.5906,0.5929
2023-07-28 13:30,790,408,382,58333,24691,33642,34453540.0,14582851.0,19870689.0,760,391,369,57751,24400,33351,34183514.0,14411421.0,19772093.0,0.5906,0.5907,0.5906,0.5928
2023-07-28 13:35,1044,505,539,86061,36989,49072,62937505.0,33808663.0,29128842.0,988,473,515,81669,34873,46796,60259131.0,32498925.0,27760205.0,0.914,0.5936,0.9319,0.5932
2023-07-28 13:40,1458,712,746,124788,73613,51175,74318115.0,43910087.0,30408028.0,1324,677,647,110975,68061,42914,65824175.0,40303783.0,25520391.0,0.5965,0.5942,0.5922,0.5947
2023-07-28 13:45,1504,730,774,152989,65644,87345,150488371.0,98629044.0,51859327.0,1265,594,671,128813,45102,83711,135842725.0,86107279.0,49735445.0,1.5025,0.5937,1.9092,0.5941
2023-07-28 13:50,1538,844,694,131018,83770,47248,101909422.0,73817417.0,28092004.0,1212,702,510,122593,82517,40076,96619106.0,72715612.0,23903494.0,0.8812,0.5946,0.8812,0.5965
2023-07-28 13:55,1468,1091,377,137395,110535,26860,117417726.0,101435783.0,15981942.0,1336,1026,310,122951,105724,17227,108663450.0,98393359.0,10270090.0,0.9177,0.595,0.9307,0.5962
2023-07-28 14:00,1420,975,445,139534,106694,32840,106539729.0,87142362.0,19397366.0,1277,892,385,134215,102261,31954,103379255.0,84363615.0,19015639.0,0.8168,0.5907,0.825,0.5951
2023-07-28 14:05,1075,648,427,97802,59663,38139,94132699.0,71238998.0,22893701.0,922,551,371,77168,48740,28428,81527729.0,64560089.0,16967639.0,1.194,0.6003,1.3246,0.5969
2023-07-28 14:10,1937,1332,605,185660,154757,30903,169808245.0,151474232.0,18334013.0,1761,1228,533,172706,146986,25720,162081333.0,146725483.0,15355849.0,0.9788,0.5933,0.9982,0.597
2023-07-28 14:15,1058,560,498,69638,37269,32369,41442120.0,22203482.0,19238638.0,961,507,454,63162,33170,29992,37597898.0,19704191.0,17893707.0,0.5958,0.5944,0.594,0.5966
2023-07-28 14:20,1069,697,372,104293,73333,30960,85918126.0,67737911.0,18180214.0,851,568,283,85820,61864,23956,74817837.0,60519936.0,14297901.0,0.9237,0.5872,0.9783,0.5968
2023-07-28 14:25,4883,2783,2100,489810,379209,110601,619255368.0,550729241.0,68526126.0,3239,2175,1064,379663,315934,63729,550327557.0,510478961.0,39848596.0,1.4523,0.6196,1.6158,0.6253
2023-07-28 14:30,4828,2350,2478,535667,266222,269445,538338279.0,374591094.0,163747185.0,3949,1961,1988,507141,258344,248797,521365029.0,369552334.0,151812695.0,1.4071,0.6077,1.4305,0.6102
2023-07-28 14:35,3042,2140,902,311772,247016,64756,330380302.0,291561720.0,38818581.0,2560,1908,652,293365,239677,53688,319295702.0,286763994.0,32531707.0,1.1803,0.5995,1.1965,0.6059
2023-07-28 14:40,1951,1088,863,203377,135538,67839,182251036.0,141259447.0,40991588.0,1647,940,707,179531,117314,62217,167849347.0,129993750.0,37855596.0,1.0422,0.6042,1.1081,0.6084
2023-07-28 14:45,2331,899,1432,182191,63748,118443,156447836.0,85990232.0,70457603.0,1663,585,1078,151660,52010,99650,138686756.0,78541763.0,60144992.0,1.3489,0.5949,1.5101,0.6036
2023-07-28 14:50,1394,689,705,105376,50270,55106,75479580.0,42307222.0,33172358.0,1133,527,606,92598,45554,47044,67546080.0,39199203.0,28346877.0,0.8416,0.602,0.8605,0.6026
2023-07-28 14:55,1987,646,1341,183301,56826,126475,192560564.0,117229615.0,75330949.0,1737,504,1233,166207,52916,113291,182964442.0,114818115.0,68146326.0,2.063,0.5956,2.1698,0.6015
2023-07-28 15:00,1230,654,576,100154,45261,54893,131051394.0,98309682.0,32741711.0,987,507,480,89848,41462,48386,125045170.0,96013523.0,29031646.0,2.1721,0.5965,2.3157,0.6
2023-07-28 15:05,1724,848,876,139488,61954,77534,142630231.0,96421616.0,46208615.0,1443,668,775,120363,48601,71762,131269757.0,88318611.0,42951146.0,1.5563,0.596,1.8172,0.5985
2023-07-28 15:10,2303,1638,665,248035,217809,30226,315302676.0,297117550.0,18185126.0,2153,1584,569,242388,215963,26425,311623514.0,295703693.0,15919820.0,1.3641,0.6016,1.3692,0.6025
2023-07-28 15:15,786,443,343,58217,39966,18251,46770616.0,35841336.0,10929280.0,632,361,271,52024,36939,15085,43130047.0,34035043.0,9095004.0,0.8968,0.5988,0.9214,0.6029
2023-07-28 15:20,1648,346,1302,172153,20623,151530,103329982.0,12369775.0,90960207.0,1553,282,1271,167945,18772,149173,100932539.0,11228015.0,89704524.0,0.5998,0.6003,0.5981,0.6013
2023-07-28 15:25,1955,1050,905,195603,138635,56968,141277448.0,107104468.0,34172980.0,1822,979,843,183894,130746,53148,134228726.0,102234317.0,31994409.0,0.7726,0.5999,0.7819,0.602
2023-07-28 15:30,573,147,426,38730,8196,30534,23319361.0,4972079.0,18347281.0,474,91,383,35140,7604,27536,21117462.0,4545464.0,16571997.0,0.6066,0.6009,0.5978,0.6018
2023-07-28 15:35,461,247,214,54715,34194,20521,33131990.0,20497559.0,12634430.0,423,227,196,42727,31672,11055,25624036.0,18980648.0,6643387.0,0.5994,0.6157,0.5993,0.6009
2023-07-28 15:40,169,74,95,10462,5121,5341,6146661.0,3089248.0,3057413.0,126,58,68,7676,4565,3111,4588985.0,2712847.0,1876138.0,0.6033,0.5724,0.5943,0.6031
2023-07-28 15:45,348,181,167,25483,11569,13914,15250776.0,6922061.0,8328714.0,283,135,148,22188,9582,12606,13304911.0,5729987.0,7574923.0,0.5983,0.5986,0.598,0.6009
2023-07-28 15:50,224,110,114,14340,4388,9952,20329604.0,14518813.0,5810790.0,182,82,100,11444,3608,7836,18742026.0,14034458.0,4707568.0,3.3088,0.5839,3.8898,0.6008
2023-07-28 15:55,304,135,169,16039,5919,10120,21499813.0,15429209.0,6070603.0,251,101,150,14116,4078,10038,20342894.0,14315020.0,6027873.0,2.6067,0.5999,3.5103,0.6005
2023-07-28 16:00,294,116,178,16760,5401,11359,21804501.0,15112294.0,6692206.0,244,85,159,13924,4231,9693,20230456.0,14405261.0,5825195.0,2.7981,0.5892,3.4047,0.601
2023-07-28 16:05,296,88,208,24254,5094,19160,14452275.0,3029379.0,11422896.0,237,52,185,21626,3937,17689,12960541.0,2349795.0,10610745.0,0.5947,0.5962,0.5968,0.5998
2023-07-28 16:10,125,48,77,7513,1981,5532,4480236.0,1196492.0,3283744.0,91,34,57,7199,2446,4753,4307037.0,1456792.0,2850244.0,0.604,0.5936,0.5956,0.5997
2023-07-28 16:15,404,54,350,45019,2097,42922,26962699.0,1251636.0,25711063.0,380,39,341,45632,3863,41769,27316246.0,2286833.0,25029413.0,0.5969,0.599,0.592,0.5992
2023-07-28 16:20,461,245,216,27805,4437,23368,16526828.0,2663842.0,13862985.0,393,210,183,25085,4043,21042,15005942.0,2403289.0,12602653.0,0.6004,0.5932,0.5944,0.5989
2023-07-28 16:25,358,159,199,18647,2050,16597,11116363.0,1228944.0,9887419.0,328,142,186,18055,1348,16707,10799757.0,797692.0,10002065.0,0.5995,0.5957,0.5918,0.5987
2023-07-28 16:30,156,93,63,8574,2735,5839,16957087.0,13545265.0,3411822.0,116,67,49,6247,1873,4374,15611930.0,12991884.0,2620045.0,4.9526,0.5843,6.9364,0.599
2023-07-28 16:35,525,149,376,52320,3202,49118,31252715.0,1902907.0,29349807.0,511,129,382,52785,2864,49921,31611903.0,1700491.0,29911412.0,0.5943,0.5975,0.5937,0.5992
2023-07-28 16:40,1775,421,1354,215575,6295,209280,129026526.0,3742370.0,125284156.0,1724,381,1343,211511,2799,208712,126610387.0,1667152.0,124943235.0,0.5945,0.5986,0.5956,0.5986
2023-07-28 16:45,758,300,458,54111,5297,48814,44281330.0,15049093.0,29232237.0,719,276,443,53390,4067,49323,43837461.0,14295057.0,29542403.0,2.8411,0.5988,3.5149,0.599
2023-07-28 16:50,454,289,165,24156,14560,9596,26436563.0,20679387.0,5757176.0,390,245,145,20229,11373,8856,23980529.0,18665775.0,5314753.0,1.4203,0.6,1.6412,0.6001
2023-07-28 16:55,182,101,81,9684,5014,4670,5807530.0,3036516.0,2771013.0,138,72,66,8868,4901,3967,5310125.0,2928834.0,2381291.0,0.6056,0.5934,0.5976,0.6003
2023-07-28 17:00,193,98,95,13465,6485,6980,8013699.0,3878409.0,4135289.0,148,79,69,11337,6171,5166,6790985.0,3686939.0,3104046.0,0.5981,0.5924,0.5975,0.6009
2023-07-28 17:05,160,100,60,14192,9607,4585,8490058.0,5759634.0,2730424.0,124,81,43,12837,8685,4152,7692313.0,5192826.0,2499487.0,0.5995,0.5955,0.5979,0.602
2023-07-28 17:10,132,79,53,8534,5896,2638,16962861.0,15399940.0,1562921.0,107,64,43,7898,5515,2383,16607952.0,15169832.0,1438119.0,2.6119,0.5925,2.7506,0.6035
2023-07-28 17:15,295,57,238,13120,2248,10872,7857607.0,1351118.0,6506489.0,274,45,229,13379,2726,10653,8007067.0,1621543.0,6385523.0,0.601,0.5985,0.5948,0.5994
2023-07-28 17:20,137,68,69,11170,5386,5784,6699315.0,3232304.0,3467011.0,120,57,63,11826,6149,5677,7076173.0,3668910.0,3407262.0,0.6001,0.5994,0.5967,0.6002
2023-07-28 17:25,383,139,244,30182,11820,18362,18159396.0,7137876.0,11021520.0,385,130,255,28444,10141,18303,17034513.0,6049983.0,10984530.0,0.6039,0.6002,0.5966,0.6001
2023-07-28 17:30,468,368,100,45156,40001,5155,38927635.0,35860773.0,3066862.0,363,329,34,39327,37268,2059,35415315.0,34174948.0,1240367.0,0.8965,0.5949,0.917,0.6024
2023-07-28 17:35,1226,1093,133,133089,124492,8597,79712003.0,74552529.0,5159474.0,1165,1066,99,126531,120897,5634,75759299.0,72361605.0,3397694.0,0.5989,0.6001,0.5985,0.6031
2023-07-28 17:40,1201,388,813,149614,54738,94876,137028732.0,80258519.0,56770212.0,1136,356,780,143782,55119,88663,133728773.0,80494793.0,53233979.0,1.4662,0.5984,1.4604,0.6004
2023-07-28 17:45,318,153,165,21800,8971,12829,36751415.0,29115139.0,7636275.0,260,118,142,19773,8052,11721,35589022.0,28558311.0,7030710.0,3.2455,0.5952,3.5467,0.5998
2023-07-28 17:50,239,142,97,11472,5088,6384,30555563.0,26800637.0,3754926.0,238,111,127,11724,4764,6960,30767039.0,26583015.0,4184024.0,5.2674,0.5882,5.58,0.6012
2023-07-28 17:55,838,63,775,80213,3031,77182,48023528.0,1811153.0,46212374.0,790,33,757,79939,2054,77885,47909182.0,1226197.0,46682985.0,0.5975,0.5987,0.597,0.5994
2023-07-28 18:00,1819,1522,297,214134,197671,16463,128189865.0,118307548.0,9882316.0,1749,1497,252,211129,195279,15850,126283118.0,116768975.0,9514142.0,0.5985,0.6003,0.598,0.6003
2023-07-28 18:05,711,436,275,52198,38504,13694,31213659.0,23021932.0,8191726.0,653,414,239,51756,40030,11726,30953812.0,23920812.0,7033000.0,0.5979,0.5982,0.5976,0.5998
2023-07-28 18:10,284,216,68,31436,25040,6396,18786814.0,14967566.0,3819248.0,264,204,60,29555,23993,5562,17675044.0,14336326.0,3338717.0,0.5977,0.5971,0.5975,0.6003
2023-07-28 18:15,277,160,117,24513,7754,16759,14551052.0,4643815.0,9907236.0,332,181,151,23818,9197,14621,14244719.0,5476727.0,8767992.0,0.5989,0.5912,0.5955,0.5997
2023-07-28 18:20,450,277,173,22854,8006,14848,13821086.0,4913601.0,8907485.0,362,207,155,18821,4811,14010,11303899.0,2874825.0,8429073.0,0.6137,0.5999,0.5976,0.6016
2023-07-28 18:25,1226,909,317,139203,122449,16754,108058326.0,97967181.0,10091145.0,1205,909,296,125673,111483,14190,99067657.0,90514749.0,8552907.0,0.8001,0.6023,0.8119,0.6027
2023-07-28 18:30,1643,1037,606,174410,126025,48385,140802366.0,111701012.0,29101353.0,1440,952,488,159159,119053,40106,131390887.0,107176909.0,24213977.0,0.8863,0.6015,0.9002,0.6037
2023-07-28 18:35,1327,995,332,131693,107244,24449,162417439.0,147722334.0,14695104.0,1284,986,298,123306,105079,18227,157341551.0,146334605.0,11006946.0,1.3774,0.6011,1.3926,0.6039
2023-07-31 10:00,4702,2280,2422,475144,245185,229959,406290198.0,265138771.0,141151426.0,3441,1790,1651,399951,208986,190965,348968768.0,231297604.0,117671164.0,1.0814,0.6138,1.1068,0.6162
2023-07-31 10:05,5653,3589,2064,575584,420257,155327,758717114.0,663198233.0,95518880.0,4564,3245,1319,517402,391484,125918,720438739.0,642977079.0,77461660.0,1.5781,0.615,1.6424,0.6152
2023-07-31 10:10,3377,1697,1680,268861,150208,118653,273131776.0,200057375.0,73074401.0,2667,1451,1216,227298,136580,90718,247373497.0,191138124.0,56235373.0,1.3319,0.6159,1.3995,0.6199
2023-07-31 10:15,3664,1330,2334,365051,104311,260740,343364090.0,183159411.0,160204678.0,3205,1122,2083,334374,89815,244559,324872322.0,173974578.0,150897744.0,1.7559,0.6144,1.937,0.617
2023-07-31 10:20,3349,2192,1157,331675,235425,96250,323359049.0,264067703.0,59291345.0,3092,2090,1002,313531,222772,90759,311734998.0,255707489.0,56027508.0,1.1217,0.616,1.1478,0.6173
2023-07-31 10:25,3282,1171,2111,334378,99869,234509,300672749.0,156461532.0,144211217.0,3006,1008,1998,306394,85062,221332,283531686.0,147126909.0,136404777.0,1.5667,0.6149,1.7296,0.6163
2023-07-31 10:30,1598,487,1111,143676,25394,118282,111848132.0,39271828.0,72576304.0,1413,427,986,133909,19567,114342,106006682.0,35703500.0,70303181.0,1.5465,0.6136,1.8247,0.6149
2023-07-31 10:35,1860,441,1419,204440,19776,184664,126028193.0,12121147.0,113907046.0,1744,384,1360,190162,17061,173101,116963713.0,10438732.0,106524980.0,0.6129,0.6168,0.6118,0.6154
2023-07-31 10:40,1870,506,1364,177124,25981,151143,144300345.0,51542874.0,92757471.0,1666,393,1273,174408,20628,153780,142890914.0,48210412.0,94680502.0,1.9839,0.6137,2.3371,0.6157
2023-07-31 10:45,1084,580,504,71067,26537,44530,55493833.0,28132784.0,27361049.0,899,476,423,68131,25515,42616,53603345.0,27424240.0,26179104.0,1.0601,0.6144,1.0748,0.6143
2023-07-31 10:50,1799,1484,315,180773,153801,26972,134727412.0,118066400.0,16661011.0,1630,1405,225,156422,138776,17646,119683077.0,108757683.0,10925394.0,0.7677,0.6177,0.7837,0.6191
2023-07-31 10:55,1233,742,491,102757,77941,24816,87245671.0,71869437.0,15376234.0,1073,680,393,102006,79319,22687,86629008.0,72536111.0,14092897.0,0.9221,0.6196,0.9145,0.6212
2023-07-31 11:00,1728,1138,590,147467,109159,38308,126518721.0,102863440.0,23655280.0,1520,1048,472,136480,107367,29113,119725073.0,101688913.0,18036159.0,0.9423,0.6175,0.9471,0.6195
2023-07-31 11:05,877,565,312,52811,40827,11984,44328747.0,36969580.0,7359167.0,742,510,232,47334,36657,10677,40969230.0,34370928.0,6598302.0,0.9055,0.6141,0.9376,0.618
2023-07-31 11:10,897,471,426,55387,39976,15411,34335915.0,24865444.0,9470471.0,773,463,310,45142,34533,10609,27826845.0,21253568.0,6573276.0,0.622,0.6145,0.6155,0.6196
2023-07-31 11:15,1833,886,947,151966,102202,49764,176373651.0,145841547.0,30532103.0,1736,840,896,147454,100496,46958,173735271.0,144788925.0,28946346.0,1.427,0.6135,1.4407,0.6164
2023-07-31 11:20,5201,4049,1152,613199,549894,63305,522744901.0,483420373.0,39324528.0,4507,3692,815,572668,522784,49884,496977552.0,465918624.0,31058927.0,0.8791,0.6212,0.8912,0.6226
2023-07-31 11:25,1832,1049,783,182806,128166,54640,126079029.0,91984252.0,34094777.0,1375,853,522,135243,108372,26871,96124956.0,79269775.0,16855180.0,0.7177,0.624,0.7315,0.6273
2023-07-31 11:30,1086,526,560,90032,48920,41112,79776074.0,54533260.0,25242813.0,768,388,380,62217,32922,29295,62678475.0,44282246.0,18396229.0,1.1147,0.614,1.3451,0.628
2023-07-31 11:35,1373,699,674,105407,64027,41380,78024417.0,52126296.0,25898121.0,1112,582,530,94291,57863,36428,70958900.0,48058841.0,22900059.0,0.8141,0.6259,0.8306,0.6286
2023-07-31 11:40,2370,1361,1009,222348,161695,60653,235329583.0,197391831.0,37937752.0,1751,1108,643,184530,140742,43788,210953416.0,183317667.0,27635749.0,1.2208,0.6255,1.3025,0.6311
2023-07-31 11:45,4156,2746,1410,463791,386711,77080,399681068.0,351163654.0,48517414.0,3481,2539,942,423654,363687,59967,374233152.0,336213771.0,38019380.0,0.9081,0.6294,0.9245,0.634
2023-07-31 11:50,2181,830,1351,169141,66383,102758,177214539.0,113159511.0,64055028.0,1658,585,1073,131024,49886,81138,153895132.0,102654088.0,51241043.0,1.7046,0.6234,2.0578,0.6315
2023-07-31 11:55,2534,1438,1096,241591,166824,74767,235380360.0,188387578.0,46992782.0,2236,1282,954,219797,153593,66204,221532748.0,179713908.0,41818840.0,1.1293,0.6285,1.1701,0.6317
2023-07-31 12:00,1805,1132,673,158282,98429,59853,159594752.0,121705123.0,37889629.0,1552,1016,536,142122,91693,50429,149325180.0,117311429.0,32013750.0,1.2365,0.633,1.2794,0.6348
2023-07-31 12:05,3776,2085,1691,385323,188978,196345,374194696.0,249951382.0,124243314.0,3504,1961,1543,359772,173708,186064,358182190.0,240261605.0,117920585.0,1.3226,0.6328,1.3831,0.6338
2023-07-31 12:10,2475,1279,1196,277253,158022,119231,257900980.0,182855539.0,75045441.0,2038,1053,985,255696,146999,108697,244598818.0,175836806.0,68762012.0,1.1572,0.6294,1.1962,0.6326
2023-07-31 12:15,3838,2731,1107,414769,350804,63965,359092529.0,318586689.0,40505840.0,3154,2572,582,383845,331309,52536,338844373.0,305210558.0,33633815.0,0.9082,0.6333,0.9212,0.6402
2023-07-31 12:20,3482,2079,1403,379016,218387,160629,361691193.0,258956399.0,102734793.0,2484,1566,918,279551,169990,109561,297783947.0,227353064.0,70430883.0,1.1858,0.6396,1.3374,0.6428
2023-07-31 12:25,5124,2676,2448,535363,251779,283584,543584203.0,362948039.0,180636163.0,4357,2265,2092,489509,225297,264212,515100591.0,345673106.0,169427485.0,1.4415,0.637,1.5343,0.6413
2023-07-31 12:30,3945,2150,1795,445195,219280,225915,391902075.0,248124347.0,143777728.0,3371,1874,1497,400444,201454,198990,363514900.0,235881767.0,127633132.0,1.1315,0.6364,1.1709,0.6414
2023-07-31 12:35,1718,1044,674,138787,83991,54796,100631014.0,65619264.0,35011749.0,1387,863,524,114095,71593,42502,84821526.0,57537763.0,27283763.0,0.7813,0.6389,0.8037,0.6419
2023-07-31 12:40,2709,1500,1209,217308,109020,108288,303458166.0,235446455.0,68011710.0,2170,1160,1010,189441,88795,100646,286910272.0,222550532.0,64359740.0,2.1597,0.6281,2.5063,0.6395
2023-07-31 12:45,2116,1415,701,208119,162087,46032,180306485.0,150947080.0,29359404.0,1817,1278,539,193334,157609,35725,170788050.0,147918108.0,22869941.0,0.9313,0.6378,0.9385,0.6402
2023-07-31 12:50,1078,602,476,80210,52709,27501,51211605.0,33636110.0,17575495.0,891,513,378,68718,50171,18547,43792113.0,31920319.0,11871793.0,0.6381,0.6391,0.6362,0.6401
2023-07-31 12:55,5821,3175,2646,597695,318228,279467,614487345.0,438977692.0,175509652.0,5005,2701,2304,523763,275030,248733,569449311.0,411543821.0,157905490.0,1.3794,0.628,1.4964,0.6348
2023-07-31 13:00,2343,1539,804,182636,125928,56708,163133083.0,127292592.0,35840490.0,2135,1429,706,169540,117531,52009,155095377.0,121884825.0,33210552.0,1.0108,0.632,1.037,0.6386
2023-07-31 13:05,979,427,552,56128,25537,30591,35749995.0,16347547.0,19402448.0,831,364,467,50487,27734,22753,32035391.0,17435652.0,14599738.0,0.6402,0.6343,0.6287,0.6417
2023-07-31 13:10,429,218,211,23700,12206,11494,15040416.0,7774990.0,7265425.0,338,171,167,22726,12545,10181,14474979.0,7969232.0,6505746.0,0.637,0.6321,0.6353,0.639
2023-07-31 13:15,1692,742,950,156868,47755,109113,134667724.0,65848808.0,68818915.0,1488,625,863,148306,48365,99941,129771567.0,66189584.0,63581983.0,1.3789,0.6307,1.3685,0.6362
2023-07-31 13:20,1849,719,1130,157120,46157,110963,111105960.0,40979837.0,70126123.0,1677,608,1069,154472,44709,109763,109625398.0,40049461.0,69575937.0,0.8878,0.632,0.8958,0.6339
2023-07-31 13:25,3898,853,3045,422426,54486,367940,266922497.0,34333562.0,232588935.0,3693,734,2959,406455,43238,363217,257182462.0,27204251.0,229978210.0,0.6301,0.6321,0.6292,0.6332
2023-07-31 13:30,4180,2883,1297,420477,316521,103956,372645216.0,306994903.0,65650312.0,3924,2742,1182,402012,303275,98737,361054219.0,298505243.0,62548975.0,0.9699,0.6315,0.9843,0.6335
2023-07-31 13:35,1712,1304,408,171321,138505,32816,144260598.0,123465572.0,20795026.0,1572,1249,323,159204,136554,22650,136583177.0,122173512.0,14409664.0,0.8914,0.6337,0.8947,0.6362
2023-07-31 13:40,570,262,308,33926,13048,20878,21483691.0,8300001.0,13183690.0,490,224,266,36976,17843,19133,23338221.0,11169957.0,12168264.0,0.6361,0.6315,0.626,0.636
2023-07-31 13:45,2678,1090,1588,245352,76023,169329,190913845.0,83619093.0,107294752.0,2501,1009,1492,235048,70060,164988,184558926.0,79868017.0,104690908.0,1.0999,0.6336,1.14,0.6345
2023-07-31 13:50,1757,522,1235,135328,23236,112092,121188714.0,50310426.0,70878287.0,1636,455,1181,130299,22393,107906,118135807.0,49739013.0,68396794.0,2.1652,0.6323,2.2212,0.6339
2023-07-31 13:55,2291,1298,993,211120,137434,73686,156998424.0,110438962.0,46559461.0,2140,1203,937,204113,132747,71366,152626371.0,107441756.0,45184614.0,0.8036,0.6319,0.8094,0.6331
2023-07-31 14:00,1504,714,790,106797,56965,49832,138236441.0,107124581.0,31111860.0,1346,622,724,91737,51829,39908,129122077.0,103886081.0,25235995.0,1.8805,0.6243,2.0044,0.6324
2023-07-31 14:05,3912,2978,934,452362,378756,73606,343068909.0,297325357.0,45743551.0,3604,2781,823,428351,360562,67789,328402109.0,285719575.0,42682534.0,0.785,0.6215,0.7924,0.6296
2023-07-31 14:10,3718,2795,923,410815,371146,39669,330768224.0,305783889.0,24984335.0,3546,2704,842,393706,359178,34528,319498617.0,297615458.0,21883159.0,0.8239,0.6298,0.8286,0.6338
2023-07-31 14:15,2045,1497,548,203873,173681,30192,188692537.0,169522791.0,19169746.0,1836,1420,416,197244,176795,20449,184388227.0,171329385.0,13058842.0,0.9761,0.6349,0.9691,0.6386
2023-07-31 14:20,650,417,233,46939,32602,14337,29803123.0,20715382.0,9087741.0,583,390,193,43683,29816,13867,27699011.0,18850526.0,8848485.0,0.6354,0.6339,0.6322,0.6381
2023-07-31 14:25,2214,1672,542,171900,128014,43886,132410954.0,104702985.0,27707969.0,2062,1589,473,162882,121977,40905,126868774.0,100869788.0,25998986.0,0.8179,0.6314,0.827,0.6356
2023-07-31 14:30,1923,1499,424,180745,147313,33432,126449579.0,105106866.0,21342712.0,1849,1458,391,163878,145959,17919,115592141.0,104196403.0,11395738.0,0.7135,0.6384,0.7139,0.636
2023-07-31 14:35,2343,1831,512,231328,201913,29415,158156675.0,139597484.0,18559190.0,2294,1804,490,241984,203888,38096,165009098.0,140769069.0,24240029.0,0.6914,0.6309,0.6904,0.6363
2023-07-31 14:40,3843,3332,511,421067,393444,27623,362415957.0,344834103.0,17581853.0,3672,3248,424,406833,385452,21381,353104656.0,339443371.0,13661284.0,0.8765,0.6365,0.8806,0.6389
2023-07-31 14:45,948,598,350,60231,35370,24861,38327220.0,22488976.0,15838244.0,809,524,285,55765,31951,23814,35490004.0,20293207.0,15196796.0,0.6358,0.6371,0.6351,0.6381
2023-07-31 14:50,349,214,135,24560,12950,11610,27353876.0,20073660.0,7280216.0,275,185,90,19227,11507,7720,24098262.0,19157372.0,4940889.0,1.5501,0.6271,1.6648,0.64
2023-07-31 14:55,581,368,213,43787,31622,12165,27720921.0,20025515.0,7695405.0,514,329,185,39409,30159,9250,24966130.0,19081481.0,5884649.0,0.6333,0.6326,0.6327,0.6362
2023-07-31 15:00,261,140,121,17389,10792,6597,11017388.0,6829975.0,4187413.0,209,114,95,17359,9971,7388,11004000.0,6305775.0,4698224.0,0.6329,0.6347,0.6324,0.6359
2023-07-31 15:05,2896,2092,804,321279,253367,67912,392319904.0,349849860.0,42470043.0,2720,1987,733,308139,246493,61646,384605633.0,345492185.0,39113448.0,1.3808,0.6254,1.4016,0.6345
2023-07-31 15:10,2229,1659,570,237155,209239,27916,149552988.0,131885260.0,17667728.0,2155,1621,534,231562,206837,24725,146185796.0,130489887.0,15695909.0,0.6303,0.6329,0.6309,0.6348
2023-07-31 15:15,2239,1215,1024,212969,126921,86048,181859211.0,127602815.0,54256396.0,2065,1114,951,202867,124460,78407,175600886.0,125951156.0,49649730.0,1.0054,0.6305,1.012,0.6332
2023-07-31 15:20,2401,684,1717,225918,36000,189918,213981096.0,93942589.0,120038506.0,2291,620,1671,218860,31913,186947,209732767.0,91347949.0,118384818.0,2.6095,0.6321,2.8624,0.6333
2023-07-31 15:25,2943,441,2502,338391,21248,317143,225894160.0,25220697.0,200673463.0,2814,366,2448,331383,16909,314474,221545335.0,22485373.0,199059962.0,1.187,0.6328,1.3298,0.633
2023-07-31 15:30,2910,1421,1489,285807,141401,144406,192758766.0,101238081.0,91520685.0,2828,1392,1436,283215,140531,142684,191042603.0,100588032.0,90454571.0,0.716,0.6338,0.7158,0.634
2023-07-31 15:35,2979,2159,820,265940,223371,42569,203532823.0,176602373.0,26930449.0,2898,2104,794,263324,221384,41940,201903928.0,175320503.0,26583425.0,0.7906,0.6326,0.7919,0.6338
2023-07-31 15:40,799,530,269,83845,68687,15158,64807902.0,55206628.0,9601274.0,761,511,250,84786,70919,13867,65363820.0,56573861.0,8789959.0,0.8037,0.6334,0.7977,0.6339
2023-07-31 15:45,1082,598,484,66895,39999,26896,42281582.0,25237362.0,17044220.0,1036,577,459,63943,37981,25962,40414871.0,23957692.0,16457178.0,0.6309,0.6337,0.6308,0.6339
2023-07-31 15:50,444,229,215,22293,12990,9303,26001150.0,20101508.0,5899641.0,375,192,183,18521,9361,9160,23604793.0,17788224.0,5816568.0,1.5475,0.6342,1.9002,0.635
2023-07-31 15:55,396,183,213,18385,7305,11080,11676577.0,4647749.0,7028827.0,339,159,180,16488,7511,8977,10453950.0,4753209.0,5700740.0,0.6362,0.6344,0.6328,0.635
2023-07-31 16:00,776,250,526,44170,11746,32424,27982820.0,7438865.0,20543954.0,730,228,502,42310,11055,31255,26855103.0,6993513.0,19861590.0,0.6333,0.6336,0.6326,0.6355
2023-07-31 16:05,441,146,295,32779,8552,24227,20700154.0,5415298.0,15284856.0,397,112,285,29233,6465,22768,18546132.0,4085037.0,14461094.0,0.6332,0.6309,0.6319,0.6351
2023-07-31 16:10,700,388,312,33209,22649,10560,44647768.0,38021697.0,6626071.0,647,367,280,31280,21443,9837,43549134.0,37295667.0,6253466.0,1.6787,0.6275,1.7393,0.6357
2023-07-31 16:15,1105,499,606,109770,39580,70190,69486031.0,24997330.0,44488700.0,1052,475,577,106685,38131,68554,67603460.0,24072864.0,43530596.0,0.6316,0.6338,0.6313,0.635
2023-07-31 16:20,924,382,542,63805,16212,47593,40479307.0,10261606.0,30217701.0,891,366,525,59329,15291,44038,37622278.0,9671413.0,27950864.0,0.633,0.6349,0.6325,0.6347
2023-07-31 16:25,628,403,225,33934,21042,12892,21478993.0,13289495.0,8189497.0,576,377,199,31409,19627,11782,19895357.0,12407311.0,7488046.0,0.6316,0.6352,0.6322,0.6355
2023-07-31 16:30,128,67,61,7488,4323,3165,4711273.0,2729362.0,1981911.0,94,45,49,6878,4372,2506,4345694.0,2754568.0,1591126.0,0.6314,0.6262,0.63,0.6349
2023-07-31 16:35,1904,1076,828,216197,164623,51574,148422274.0,115865867.0,32556406.0,1863,1047,816,214504,163849,50655,147477398.0,115362779.0,32114619.0,0.7038,0.6313,0.7041,0.634
2023-07-31 16:40,1725,982,743,174626,132695,41931,110405436.0,83838053.0,26567383.0,1680,952,728,172291,130577,41714,108963884.0,82501021.0,26462863.0,0.6318,0.6336,0.6318,0.6344
2023-07-31 16:45,559,329,230,52195,37694,14501,44931353.0,35753761.0,9177591.0,503,303,200,49075,35642,13433,42922164.0,34400140.0,8522023.0,0.9485,0.6329,0.9652,0.6344
2023-07-31 16:50,1420,1044,376,168348,156825,11523,106461455.0,99166505.0,7294950.0,1458,1073,385,170802,159584,11218,107980175.0,100854085.0,7126090.0,0.6323,0.6331,0.632,0.6352
2023-07-31 16:55,1767,1423,344,222424,207322,15102,152758477.0,143182431.0,9576046.0,1652,1356,296,217263,203019,14244,149501740.0,140429869.0,9071870.0,0.6906,0.6341,0.6917,0.6369
2023-07-31 17:00,3487,2226,1261,407881,330445,77436,270354139.0,221188843.0,49165296.0,3417,2193,1224,402295,329637,72658,266836961.0,220662143.0,46174818.0,0.6694,0.6349,0.6694,0.6355
2023-07-31 17:05,2948,527,2421,430509,48433,382076,285103460.0,42536133.0,242567327.0,2886,493,2393,427596,46891,380705,283295389.0,41559349.0,241736040.0,0.8782,0.6349,0.8863,0.635
2023-07-31 17:10,2037,1240,797,234136,136224,97912,160368082.0,98121267.0,62246815.0,2013,1238,775,229361,133824,95537,157298211.0,96588875.0,60709336.0,0.7203,0.6357,0.7218,0.6355
2023-07-31 17:15,2335,1951,384,303113,277786,25327,251936819.0,235852695.0,16084124.0,2198,1888,310,281650,264278,17372,238290340.0,227180349.0,11109991.0,0.849,0.6351,0.8596,0.6395
2023-07-31 17:20,2193,1850,343,299264,277554,21710,214678864.0,200818750.0,13860114.0,2016,1765,251,284111,270010,14101,204706493.0,195674198.0,9032295.0,0.7235,0.6384,0.7247,0.6405
2023-07-31 17:25,1185,744,441,95898,70623,25275,72806225.0,56757273.0,16048951.0,1087,703,384,91722,69852,21870,70181456.0,56225252.0,13956203.0,0.8037,0.635,0.8049,0.6381
2023-07-31 17:30,2204,1547,657,290970,260694,30276,184827380.0,165546162.0,19281218.0,2103,1496,607,289655,259381,30274,183993975.0,164691075.0,19302899.0,0.635,0.6368,0.6349,0.6376
2023-07-31 17:35,3349,2635,714,470244,432105,38139,358919705.0,334585150.0,24334555.0,3208,2574,634,455139,423954,31185,349151999.0,329192606.0,19959392.0,0.7743,0.638,0.7765,0.64
2023-07-31 17:40,1830,1353,477,243870,208604,35266,249771770.0,227659201.0,22112569.0,1679,1267,412,233043,203027,30016,243314582.0,224110625.0,19203956.0,1.0913,0.627,1.1038,0.6398
2023-07-31 17:45,1476,997,479,179193,149533,29660,233132945.0,214186827.0,18946118.0,1302,923,379,163327,141509,21818,222848868.0,208874395.0,13974473.0,1.4324,0.6388,1.4761,0.6405
2023-07-31 17:50,734,590,144,83777,73235,10542,53520816.0,46702415.0,6818400.0,678,580,98,76259,71026,5233,48647564.0,45265975.0,3381588.0,0.6377,0.6468,0.6373,0.6462
2023-07-31 17:55,3222,1938,1284,321945,238108,83837,337552547.0,283894301.0,53658245.0,2519,1611,908,271785,206577,65208,305535549.0,263383306.0,42152242.0,1.1923,0.64,1.275,0.6464
2023-07-31 18:00,2036,887,1149,207563,75207,132356,192803746.0,107749382.0,85054363.0,1654,701,953,169712,64111,105601,168517177.0,100478492.0,68038684.0,1.4327,0.6426,1.5673,0.6443
2023-07-31 18:05,1775,738,1037,189699,39796,149903,156023899.0,61050769.0,94973130.0,1456,521,935,174182,30479,143703,147182213.0,55053392.0,92128821.0,1.5341,0.6336,1.8063,0.6411
2023-07-31 18:10,2949,1791,1158,291768,151453,140315,233661655.0,144236280.0,89425375.0,2469,1449,1020,258417,136318,122099,212723967.0,134424634.0,78299333.0,0.9524,0.6373,0.9861,0.6413
2023-07-31 18:15,909,523,386,78987,49904,29083,52130081.0,31732720.0,20397361.0,796,457,339,73622,47987,25635,48118830.0,30447827.0,17671003.0,0.6359,0.7013,0.6345,0.6893
2023-07-31 18:20,1350,775,575,121601,80177,41424,101148024.0,74805664.0,26342360.0,1224,708,516,110624,74535,36089,94139239.0,71082236.0,23057002.0,0.933,0.6359,0.9537,0.6389
2023-07-31 18:25,1491,1042,449,146515,113973,32542,105256975.0,84492268.0,20764707.0,1361,921,440,150998,111760,39238,108153503.0,83014227.0,25139275.0,0.7413,0.6381,0.7428,0.6407
2023-07-31 18:30,1853,719,1134,195257,46753,148504,136206298.0,41659443.0,94546854.0,1747,644,1103,184468,44273,140195,129502007.0,40026920.0,89475087.0,0.8911,0.6367,0.9041,0.6382
2023-07-31 18:35,1653,406,1247,207294,23964,183330,143990905.0,27111854.0,116879051.0,1532,335,1197,201146,19517,181629,140125959.0,24255467.0,115870492.0,1.1314,0.6375,1.2428,0.638
2023-08-01 10:00,4631,2501,2130,450038,266135,183903,322640997.0,204967200.0,117673796.0,3902,2087,1815,403145,241033,162112,286031899.0,182240000.0,103791899.0,0.7702,0.6399,0.7561,0.6402
2023-08-01 10:05,3225,1073,2152,325719,85784,239935,349007809.0,196946650.0,152061159.0,2846,896,1950,303415,76166,227249,330636108.0,185975933.0,144660174.0,2.2958,0.6338,2.4417,0.6366
2023-08-01 10:10,2490,1469,1021,299517,196316,103201,366994892.0,301824663.0,65170228.0,2063,1214,849,261379,176711,84668,342590404.0,289078878.0,53511526.0,1.5374,0.6315,1.6359,0.632
2023-08-01 10:15,2754,1552,1202,299900,189541,110359,296475838.0,226650741.0,69825097.0,2380,1328,1052,275217,175276,99941,280478288.0,217122788.0,63355500.0,1.1958,0.6327,1.2387,0.6339
2023-08-01 10:20,1770,1282,488,198839,168946,29893,173534113.0,154383585.0,19150527.0,1632,1230,402,193986,164300,29686,170027351.0,151101057.0,18926294.0,0.9138,0.6406,0.9197,0.6375
2023-08-01 10:25,1976,1092,884,137489,84286,53203,98852536.0,65112596.0,33739940.0,1778,985,793,126112,80241,45871,91735322.0,62537064.0,29198258.0,0.7725,0.6342,0.7794,0.6365
2023-08-01 10:30,2403,941,1462,178098,60049,118049,171758080.0,97291680.0,74466399.0,2238,891,1347,171267,58326,112941,167639994.0,96147039.0,71492955.0,1.6202,0.6308,1.6484,0.633
2023-08-01 10:35,2198,795,1403,228264,37736,190528,179193412.0,59104024.0,120089388.0,1920,601,1319,211612,25499,186113,169052874.0,51567840.0,117485033.0,1.5663,0.6303,2.0223,0.6313
2023-08-01 10:40,1900,523,1377,193461,16447,177014,133309297.0,22202387.0,111106909.0,1817,444,1373,193139,21623,171516,133210934.0,25269110.0,107941824.0,1.3499,0.6277,1.1686,0.6293
2023-08-01 10:45,4876,2271,2605,448455,137627,310828,505871980.0,311513754.0,194358226.0,4473,2025,2448,429346,128099,301247,494412140.0,305492086.0,188920054.0,2.2635,0.6253,2.3848,0.6271
2023-08-01 10:50,4001,1931,2070,404828,186826,218002,421159643.0,284385097.0,136774546.0,3547,1708,1839,376184,169751,206433,402073418.0,272625353.0,129448065.0,1.5222,0.6274,1.606,0.6271
2023-08-01 10:55,4307,3030,1277,490905,410147,80758,403912468.0,352896274.0,51016193.0,4007,2889,1118,477032,403187,73845,394844334.0,348142075.0,46702258.0,0.8604,0.6317,0.8635,0.6324
2023-08-01 11:00,2834,2022,812,273366,239497,33869,244839056.0,223257241.0,21581814.0,2609,1940,669,258114,227373,30741,234576368.0,214965970.0,19610397.0,0.9322,0.6372,0.9454,0.6379
2023-08-01 11:05,2781,1643,1138,256029,199251,56778,197368195.0,161378373.0,35989822.0,2683,1576,1107,252886,199249,53637,195437450.0,161357643.0,34079806.0,0.8099,0.6339,0.8098,0.6354
2023-08-01 11:10,1290,559,731,97906,59983,37923,61691676.0,37758197.0,23933479.0,1196,508,688,94232,57706,36526,59471135.0,36341798.0,23129336.0,0.6295,0.6311,0.6298,0.6332
2023-08-01 11:15,1209,418,791,105511,31764,73747,90321758.0,43762650.0,46559108.0,1117,361,756,93862,28554,65308,83233587.0,41717170.0,41516417.0,1.3777,0.6313,1.461,0.6357
2023-08-01 11:20,2541,880,1661,324484,85521,238963,229276424.0,77905390.0,151371034.0,2464,873,1591,324152,86042,238110,228484312.0,77876633.0,150607679.0,0.911,0.6334,0.9051,0.6325
2023-08-01 11:25,5168,3401,1767,549556,385926,163630,454495159.0,350671039.0,103824120.0,4991,3289,1702,539833,380403,159430,448302855.0,347017058.0,101285797.0,0.9086,0.6345,0.9122,0.6353
2023-08-01 11:30,1390,635,755,130048,41691,88357,82387379.0,26257684.0,56129695.0,1361,622,739,131034,43645,87389,82832485.0,27301818.0,55530667.0,0.6298,0.6353,0.6255,0.6354
2023-08-01 11:35,1369,583,786,109198,31027,78171,80987222.0,31413577.0,49573644.0,1281,538,743,105199,29615,75584,78519125.0,30531129.0,47987996.0,1.0125,0.6342,1.0309,0.6349
2023-08-01 11:40,2417,766,1651,220071,37439,182632,175074919.0,59418548.0,115656370.0,2322,721,1601,214318,34091,180227,171421515.0,57114835.0,114306679.0,1.5871,0.6333,1.6754,0.6342
2023-08-01 11:45,1654,425,1229,133693,9246,124447,120183338.0,41439514.0,78743823.0,1598,394,1204,129176,8985,120191,117541824.0,41268242.0,76273581.0,4.4819,0.6327,4.593,0.6346
2023-08-01 11:50,1204,418,786,84171,15892,68279,52888564.0,10003674.0,42884890.0,1120,364,756,80122,12991,67131,50405190.0,8138021.0,42267169.0,0.6295,0.6281,0.6264,0.6296
2023-08-01 11:55,476,208,268,28720,8906,19814,18052508.0,5579405.0,12473103.0,447,195,252,28232,8433,19799,17757519.0,5287909.0,12469610.0,0.6265,0.6295,0.627,0.6298
2023-08-01 12:00,257,141,116,13385,7574,5811,8443583.0,4779878.0,3663704.0,219,121,98,12319,7061,5258,7740455.0,4419692.0,3320762.0,0.6311,0.6305,0.6259,0.6316
2023-08-01 12:05,762,400,362,35799,17817,17982,22536157.0,11206170.0,11329986.0,717,372,345,40449,16698,23751,25502306.0,10465076.0,15037230.0,0.629,0.6301,0.6267,0.6331
2023-08-01 12:10,856,329,527,78955,23807,55148,73703289.0,38792680.0,34910609.0,776,281,495,71431,17742,53689,68894676.0,34912949.0,33981726.0,1.6295,0.633,1.9678,0.6329
2023-08-01 12:15,1226,731,495,102108,65343,36765,88265332.0,65042694.0,23222638.0,1150,677,473,98649,62764,35885,86027762.0,63317980.0,22709781.0,0.9954,0.6317,1.0088,0.6328
2023-08-01 12:20,689,353,336,54052,27638,26414,46087201.0,29366258.0,16720943.0,623,326,297,48374,25829,22545,42423757.0,28138073.0,14285683.0,1.0625,0.633,1.0894,0.6337
2023-08-01 12:25,1426,443,983,150814,30796,120018,130949375.0,55086941.0,75862434.0,1377,414,963,148271,29757,118514,129284466.0,54367696.0,74916770.0,1.7888,0.6321,1.8271,0.6321
2023-08-01 12:30,633,314,319,46140,13295,32845,29181146.0,8370636.0,20810510.0,597,295,302,43695,12032,31663,27642678.0,7574431.0,20068247.0,0.6296,0.6336,0.6295,0.6338
2023-08-01 12:35,280,144,136,25411,7365,18046,16057506.0,4630964.0,11426542.0,245,120,125,23562,6137,17425,14892131.0,3858869.0,11033262.0,0.6288,0.6332,0.6288,0.6332
2023-08-01 12:40,480,240,240,26630,6879,19751,16837673.0,4338507.0,12499166.0,455,228,227,25209,5403,19806,15939493.0,3398148.0,12541344.0,0.6307,0.6328,0.6289,0.6332
2023-08-01 12:45,390,199,191,20218,9263,10955,12746606.0,5817436.0,6929169.0,343,177,166,17531,6570,10961,11081271.0,4139399.0,6941872.0,0.628,0.6325,0.63,0.6333
2023-08-01 12:50,476,215,261,32293,12409,19884,32263816.0,19698066.0,12565750.0,425,192,233,28778,10934,17844,30074095.0,18768106.0,11305989.0,1.5874,0.632,1.7165,0.6336
2023-08-01 12:55,930,463,467,73113,24802,48311,46240838.0,15640771.0,30600066.0,877,432,445,69790,22255,47535,44165648.0,14038601.0,30127047.0,0.6306,0.6334,0.6308,0.6338
2023-08-01 13:00,1875,914,961,145060,55926,89134,91768643.0,35345792.0,56422850.0,1835,890,945,144972,56032,88940,91625710.0,35324267.0,56301442.0,0.632,0.633,0.6304,0.633
2023-08-01 13:05,863,620,243,70230,56190,14040,44366409.0,35460304.0,8906104.0,832,607,225,70469,56583,13886,44495155.0,35678824.0,8816331.0,0.6311,0.6343,0.6306,0.6349
2023-08-01 13:10,662,456,206,55494,40649,14845,35117177.0,25659611.0,9457566.0,635,437,198,54398,40541,13857,34361460.0,25568397.0,8793063.0,0.6312,0.6371,0.6307,0.6346
2023-08-01 13:15,1407,1010,397,112632,88481,24151,71171918.0,55863249.0,15308669.0,1354,981,373,110118,87366,22752,69542915.0,55119422.0,14423493.0,0.6314,0.6339,0.6309,0.6339
2023-08-01 13:20,1378,1034,344,135515,120434,15081,85537168.0,75992177.0,9544990.0,1347,1017,330,135028,119975,15053,85233730.0,75698937.0,9534793.0,0.631,0.6329,0.631,0.6334
2023-08-01 13:25,1390,993,397,123713,107787,15926,78081420.0,68009298.0,10072122.0,1355,972,383,122864,107446,15418,77554915.0,67790200.0,9764715.0,0.631,0.6324,0.6309,0.6333
2023-08-01 13:30,662,518,144,62333,55048,7285,39313043.0,34700108.0,4612935.0,620,492,128,59175,52873,6302,37353262.0,33359897.0,3993365.0,0.6304,0.6332,0.6309,0.6337
2023-08-01 13:35,1140,847,293,113744,99401,14343,71809194.0,62706046.0,9103148.0,1120,835,285,113277,99512,13765,71508595.0,62775652.0,8732942.0,0.6308,0.6347,0.6308,0.6344
2023-08-01 13:40,1014,802,212,105544,98204,7340,66612522.0,61955547.0,4656974.0,982,787,195,104804,98025,6779,66129471.0,61830713.0,4298758.0,0.6309,0.6345,0.6308,0.6341
2023-08-01 13:45,1121,851,270,119321,106320,13001,87232501.0,78989122.0,8243379.0,1077,822,255,118465,106342,12123,86672593.0,78984602.0,7687991.0,0.7429,0.6341,0.7427,0.6342
2023-08-01 13:50,925,663,262,115660,94062,21598,73068076.0,59364295.0,13703781.0,899,651,248,116026,94016,22010,73299991.0,59333785.0,13966205.0,0.6311,0.6345,0.6311,0.6345
2023-08-01 13:55,670,363,307,83994,29537,54457,64950445.0,30511433.0,34439012.0,618,334,284,81710,29217,52493,63525964.0,30311266.0,33214698.0,1.033,0.6324,1.0375,0.6327
2023-08-01 14:00,1201,308,893,121709,13935,107774,76879925.0,8736043.0,68143881.0,1154,281,873,119583,12052,107531,75571332.0,7566376.0,68004955.0,0.6269,0.6323,0.6278,0.6324
2023-08-01 14:05,758,261,497,87752,8174,79578,55458906.0,5124486.0,50334419.0,730,244,486,87577,8126,79451,55349021.0,5091689.0,50257331.0,0.6269,0.6325,0.6266,0.6326
2023-08-01 14:10,1378,162,1216,197124,4988,192136,136494061.0,15003549.0,121490512.0,1326,130,1196,195626,4649,190977,135616793.0,14782202.0,120834591.0,3.0079,0.6323,3.1797,0.6327
2023-08-01 14:15,861,245,616,98954,4437,94517,62615211.0,2789842.0,59825369.0,818,215,603,98072,3986,94086,62038896.0,2505390.0,59533506.0,0.6288,0.633,0.6285,0.6328
2023-08-01 14:20,598,194,404,65242,5002,60240,41220152.0,3151164.0,38068988.0,557,167,390,65402,6224,59178,41322279.0,3893783.0,37428495.0,0.63,0.632,0.6256,0.6325
2023-08-01 14:25,1153,705,448,108817,68366,40451,80851357.0,55085429.0,25765928.0,1088,663,425,105787,66214,39573,78716533.0,53617105.0,25099428.0,0.8057,0.637,0.8098,0.6343
2023-08-01 14:30,1001,676,325,93112,70934,22178,58718329.0,44743112.0,13975217.0,961,649,312,91318,70438,20880,57664315.0,44428304.0,13236010.0,0.6308,0.6301,0.6307,0.6339
2023-08-01 14:35,736,398,338,42065,16426,25639,26544219.0,10358951.0,16185268.0,698,369,329,40795,15837,24958,25790165.0,9975768.0,15814397.0,0.6306,0.6313,0.6299,0.6336
2023-08-01 14:40,1581,577,1004,143973,19556,124417,114812481.0,36140038.0,78672442.0,1509,531,978,140729,17745,122984,112789051.0,34923505.0,77865546.0,1.848,0.6323,1.9681,0.6331
2023-08-01 14:45,1361,509,852,120114,30468,89646,76006919.0,19249319.0,56757600.0,1309,481,828,117769,29163,88606,74492684.0,18372608.0,56120076.0,0.6318,0.6331,0.63,0.6334
2023-08-01 14:50,830,353,477,78802,17954,60848,49892518.0,11339804.0,38552714.0,780,324,456,76327,16393,59934,48304147.0,10327315.0,37976831.0,0.6316,0.6336,0.63,0.6336
2023-08-01 14:55,1720,1217,503,160390,111191,49199,101375180.0,70190032.0,31185148.0,1678,1192,486,158329,110475,47854,100028468.0,69683295.0,30345172.0,0.6313,0.6339,0.6308,0.6341
2023-08-01 15:00,1404,919,485,130715,95908,34807,94362986.0,72363522.0,21999463.0,1354,886,468,126430,94029,32401,91677591.0,71158287.0,20519303.0,0.7545,0.632,0.7568,0.6333
2023-08-01 15:05,1471,438,1033,163223,31540,131683,197436831.0,114762920.0,82673911.0,1366,374,992,154734,28401,126333,192502328.0,112792057.0,79710270.0,3.6386,0.6278,3.9714,0.631
2023-08-01 15:10,4146,1136,3010,438598,45292,393306,300166661.0,52197461.0,247969199.0,4055,1070,2985,437087,44354,392733,299206712.0,51563942.0,247642770.0,1.1525,0.6305,1.1626,0.6306
2023-08-01 15:15,3422,1321,2101,338092,93183,244909,212523208.0,58377297.0,154145911.0,3323,1276,2047,336498,92635,243863,211543605.0,58019283.0,153524322.0,0.6265,0.6294,0.6263,0.6296
2023-08-01 15:20,2713,1927,786,275813,228943,46870,185097384.0,155556727.0,29540656.0,2658,1905,753,273193,226935,46258,183453470.0,154294147.0,29159323.0,0.6795,0.6303,0.6799,0.6304
2023-08-01 15:25,3563,2439,1124,407992,345395,62597,256408947.0,216910244.0,39498702.0,3503,2404,1099,406523,344607,61916,255480607.0,216411973.0,39068633.0,0.628,0.631,0.628,0.631
2023-08-01 15:30,1356,779,577,106748,68725,38023,67124076.0,43167442.0,23956634.0,1323,764,559,104615,68614,36001,65805826.0,43089851.0,22715974.0,0.6281,0.6301,0.628,0.631
2023-08-01 15:35,384,203,181,35397,15123,20274,22344777.0,9503665.0,12841112.0,361,191,170,33847,13953,19894,21353247.0,8756603.0,12596643.0,0.6284,0.6334,0.6276,0.6332
2023-08-01 15:40,322,213,109,17643,11934,5709,11092019.0,7498528.0,3593491.0,296,197,99,16332,11574,4758,10273949.0,7269367.0,3004581.0,0.6283,0.6294,0.6281,0.6315
2023-08-01 15:45,462,252,210,28219,16643,11576,17744557.0,10454996.0,7289561.0,441,243,198,27704,16204,11500,17433195.0,10175730.0,7257465.0,0.6282,0.6297,0.628,0.6311
2023-08-01 15:50,255,216,39,19014,16874,2140,11944276.0,10597956.0,1346320.0,230,198,32,18632,16588,2044,11707061.0,10414401.0,1292660.0,0.6281,0.6291,0.6278,0.6324
2023-08-01 15:55,2172,539,1633,249722,25557,224165,192431771.0,51664798.0,140766972.0,2092,473,1619,246081,24466,221615,190339576.0,50966319.0,139373256.0,2.0216,0.628,2.0831,0.6289
2023-08-01 16:00,2768,469,2299,381985,18468,363517,240339681.0,11540258.0,228799423.0,2717,443,2274,378867,15318,363549,238410391.0,9592778.0,228817613.0,0.6249,0.6294,0.6262,0.6294
2023-08-01 16:05,2876,592,2284,391247,16323,374924,269872740.0,33952717.0,235920023.0,2840,572,2268,389647,14918,374729,268903875.0,33090733.0,235813142.0,2.0801,0.6292,2.2182,0.6293
2023-08-01 16:10,2674,593,2081,336078,20124,315954,211246949.0,12574555.0,198672393.0,2625,560,2065,334736,19191,315545,210404977.0,11982712.0,198422265.0,0.6249,0.6288,0.6244,0.6288
2023-08-01 16:15,2408,340,2068,340103,8538,331565,213737581.0,5351327.0,208386254.0,2357,303,2054,336615,7618,328997,211549069.0,4764169.0,206784900.0,0.6268,0.6285,0.6254,0.6285
2023-08-01 16:20,2036,327,1709,241349,9230,232119,151514872.0,5776936.0,145737935.0,1956,269,1687,240250,6844,233406,150837241.0,4278201.0,146559040.0,0.6259,0.6279,0.6251,0.6279
2023-08-01 16:25,2866,933,1933,289585,39136,250449,217402337.0,60114392.0,157287945.0,2785,882,1903,285240,36184,249056,214674403.0,58250693.0,156423710.0,1.536,0.628,1.6098,0.6281
2023-08-01 16:30,3168,1179,1989,334615,63772,270843,257743999.0,87416849.0,170327149.0,3072,1141,1931,330379,62175,268204,255106683.0,86415941.0,168690742.0,1.3708,0.6289,1.3899,0.629
2023-08-01 16:35,1869,727,1142,207064,40885,166179,130110700.0,25586356.0,104524343.0,1839,703,1136,206273,40342,165931,129617119.0,25245301.0,104371818.0,0.6258,0.629,0.6258,0.629
2023-08-01 16:40,952,349,603,87466,17297,70169,66905620.0,22721380.0,44184239.0,935,349,586,87753,16990,70763,67087184.0,22521851.0,44565333.0,1.3136,0.6297,1.3256,0.6298
2023-08-01 16:45,659,359,300,53390,33237,20153,33509810.0,20805341.0,12704469.0,635,351,284,52438,32635,19803,32913334.0,20428134.0,12485200.0,0.626,0.6304,0.626,0.6305
2023-08-01 16:50,656,384,272,56369,44310,12059,47350097.0,39746682.0,7603415.0,588,344,244,55157,42921,12236,46551068.0,38811961.0,7739107.0,0.897,0.6305,0.9043,0.6325
2023-08-01 16:55,1668,993,675,136144,109298,26846,109454763.0,92502250.0,16952512.0,1602,961,641,132354,108483,23871,107048886.0,91972363.0,15076523.0,0.8463,0.6315,0.8478,0.6316
2023-08-01 17:00,380,249,131,17309,11947,5362,10912863.0,7527154.0,3385709.0,340,214,126,17153,11432,5721,10803941.0,7188706.0,3615235.0,0.63,0.6314,0.6288,0.6319
2023-08-01 17:05,401,210,191,20296,9207,11089,12737260.0,5776258.0,6961001.0,361,186,175,17968,9063,8905,11299681.0,5685170.0,5614511.0,0.6274,0.6277,0.6273,0.6305
2023-08-01 17:10,377,294,83,16748,12210,4538,10534462.0,7666430.0,2868032.0,345,273,72,16631,11950,4681,10456023.0,7499066.0,2956957.0,0.6279,0.632,0.6275,0.6317
2023-08-01 17:15,828,313,515,43632,17481,26151,27435067.0,10974434.0,16460632.0,802,292,510,42563,16974,25589,26776844.0,10649031.0,16127813.0,0.6278,0.6294,0.6274,0.6303
2023-08-01 17:20,451,90,361,25883,3188,22695,16291330.0,2001937.0,14289393.0,435,79,356,25585,3009,22576,16102034.0,1884838.0,14217196.0,0.628,0.6296,0.6264,0.6297
2023-08-01 17:25,425,221,204,26359,14043,12316,28407231.0,20678655.0,7728576.0,394,204,190,24635,13876,10759,27346313.0,20567904.0,6778409.0,1.4725,0.6275,1.4823,0.63
2023-08-01 17:30,1340,1203,137,172398,165145,7253,107712325.0,103152701.0,4559624.0,1310,1178,132,167081,159916,7165,104515330.0,100002115.0,4513215.0,0.6246,0.6287,0.6253,0.6299
2023-08-01 17:35,694,216,478,58062,29940,28122,48276039.0,30594661.0,17681378.0,663,193,470,55247,29786,25461,46493217.0,30497488.0,15995729.0,1.0219,0.6287,1.0239,0.6282
2023-08-01 17:40,235,137,98,15629,10206,5423,9802209.0,6408357.0,3393851.0,183,101,82,13750,9140,4610,8609107.0,5710622.0,2898485.0,0.6279,0.6258,0.6248,0.6287
2023-08-01 17:45,2887,742,2145,320667,35437,285230,248725547.0,69659909.0,179065637.0,2833,703,2130,320142,35127,285015,248497769.0,69464370.0,179033399.0,1.9657,0.6278,1.9775,0.6282
2023-08-01 17:50,2405,503,1902,302790,24618,278172,213731823.0,39139110.0,174592713.0,2347,455,1892,300190,22486,277704,212111237.0,37799815.0,174311421.0,1.5899,0.6276,1.681,0.6277
2023-08-01 17:55,1292,161,1131,178942,4959,173983,112321200.0,3103099.0,109218101.0,1248,135,1113,180139,6704,173435,113074469.0,4176391.0,108898078.0,0.6258,0.6278,0.623,0.6279
2023-08-01 18:00,1895,320,1575,284966,13421,271545,178853239.0,8391008.0,170462230.0,1872,306,1566,285906,14132,271774,179430686.0,8821139.0,170609546.0,0.6252,0.6277,0.6242,0.6278
2023-08-01 18:05,1920,442,1478,264827,17410,247417,166172475.0,10890191.0,155282284.0,1888,419,1469,263611,16908,246703,165444079.0,10575506.0,154868572.0,0.6255,0.6276,0.6255,0.6278
2023-08-01 18:10,342,183,159,27309,7553,19756,28964357.0,16598318.0,12366039.0,305,144,161,26543,7701,18842,28492805.0,16673912.0,11818892.0,2.1976,0.6259,2.1652,0.6273
2023-08-01 18:15,1310,383,927,153278,17327,135951,107950575.0,22693992.0,85256583.0,1230,335,895,150455,15079,135376,106182203.0,21282939.0,84899264.0,1.3097,0.6271,1.4114,0.6271
2023-08-01 18:20,822,376,446,78783,20669,58114,49452631.0,12960879.0,36491752.0,781,353,428,78213,20156,58057,49047880.0,12591643.0,36456236.0,0.6271,0.6279,0.6247,0.6279
2023-08-01 18:25,2446,702,1744,279500,29272,250228,199057334.0,42055545.0,157001788.0,2400,670,1730,277222,28943,248279,197636213.0,41839051.0,155797161.0,1.4367,0.6274,1.4456,0.6275
2023-08-01 18:30,1569,542,1027,154857,18889,135968,97100614.0,11795779.0,85304834.0,1539,516,1023,154484,16321,138163,96945526.0,10196194.0,86749332.0,0.6245,0.6274,0.6247,0.6279
2023-08-01 18:35,1053,149,904,130159,4269,125890,81645735.0,2670552.0,78975182.0,1015,120,895,132997,5982,127015,83390684.0,3699579.0,79691105.0,0.6256,0.6273,0.6185,0.6274
2023-08-02 10:00,2352,1113,1239,161598,63434,98164,160184869.0,98421926.0,61762943.0,1892,869,1023,138290,53104,85186,138445066.0,85054400.0,53390666.0,1.5516,0.6292,1.6017,0.6268
2023-08-02 10:05,3022,964,2058,276604,35863,240741,219741757.0,69641536.0,150100221.0,2564,661,1903,246358,20693,225665,200765226.0,59473592.0,141291634.0,1.9419,0.6235,2.8741,0.6261
2023-08-02 10:10,1938,961,977,93193,45862,47331,89490524.0,60056571.0,29433952.0,1564,743,821,74933,35119,39814,74215207.0,49415514.0,24799693.0,1.3095,0.6219,1.4071,0.6229
2023-08-02 10:15,909,436,473,43493,16079,27414,26988606.0,9882845.0,17105760.0,784,361,423,40872,15436,25436,25383266.0,9519124.0,15864142.0,0.6146,0.624,0.6167,0.6237
2023-08-02 10:20,859,432,427,33566,14142,19424,32626095.0,20609509.0,12016586.0,720,345,375,31225,14628,16597,31235144.0,20904941.0,10330203.0,1.4573,0.6186,1.4291,0.6224
2023-08-02 10:25,937,381,556,55631,15120,40511,46195380.0,21184727.0,25010653.0,801,284,517,52995,13221,39774,44695319.0,20016810.0,24678508.0,1.4011,0.6174,1.514,0.6205
2023-08-02 10:30,2215,1106,1109,224946,88416,136530,245209906.0,161941359.0,83268547.0,1615,692,923,158558,49955,108603,204521371.0,137452164.0,67069207.0,1.8316,0.6099,2.7515,0.6176
2023-08-02 10:35,945,516,429,61684,35492,26192,61836760.0,45675323.0,16161436.0,617,309,308,63635,40704,22931,62753162.0,48579213.0,14173949.0,1.2869,0.617,1.1935,0.6181
2023-08-02 10:40,3254,2152,1102,325053,242481,82572,248147084.0,197184863.0,50962221.0,2984,1997,987,317267,238055,79212,242956561.0,193958762.0,48997799.0,0.8132,0.6172,0.8148,0.6186
2023-08-02 10:45,1571,563,1008,144039,29208,114831,112627209.0,41740626.0,70886583.0,1408,478,930,135400,24658,110742,107351895.0,38898797.0,68453098.0,1.4291,0.6173,1.5775,0.6181
2023-08-02 10:50,816,323,493,77969,21449,56520,60057473.0,25033293.0,35024180.0,714,244,470,72484,17042,55442,56681839.0,22324147.0,34357691.0,1.1671,0.6197,1.3099,0.6197
2023-08-02 10:55,710,432,278,56410,37819,18591,46852666.0,35325681.0,11526985.0,602,357,245,54693,35546,19147,45715931.0,33837824.0,11878106.0,0.9341,0.62,0.9519,0.6204
2023-08-02 11:00,1016,569,447,67199,38663,28536,41495188.0,23830383.0,17664805.0,914,543,371,63566,36678,26888,39326874.0,22635891.0,16690982.0,0.6164,0.619,0.6172,0.6208
2023-08-02 11:05,1744,1232,512,178154,147235,30919,110032581.0,90886004.0,19146577.0,1662,1178,484,175232,145002,30230,108225452.0,89488189.0,18737263.0,0.6173,0.6192,0.6172,0.6198
2023-08-02 11:10,2133,721,1412,243997,60753,183244,174348820.0,61211724.0,113137095.0,2054,663,1391,235502,57243,178259,169418033.0,59047532.0,110370500.0,1.0076,0.6174,1.0315,0.6192
2023-08-02 11:15,2096,535,1561,223551,17200,206351,149906854.0,22462267.0,127444587.0,1981,471,1510,221688,16443,205245,148814453.0,21986830.0,126827623.0,1.3059,0.6176,1.3372,0.6179
2023-08-02 11:20,1340,400,940,156943,12169,144774,96848969.0,7474588.0,89374380.0,1289,323,966,155305,10510,144795,95799747.0,6421750.0,89377997.0,0.6142,0.6173,0.611,0.6173
2023-08-02 11:25,480,162,318,45984,5913,40071,28320136.0,3545567.0,24774568.0,395,102,293,44061,5022,39039,27180020.0,3037605.0,24142415.0,0.5996,0.6183,0.6049,0.6184
2023-08-02 11:30,318,124,194,25799,3153,22646,15966209.0,1938053.0,14028156.0,265,77,188,24389,1619,22770,15104807.0,995733.0,14109074.0,0.6147,0.6195,0.615,0.6196
2023-08-02 11:35,285,110,175,29254,4294,24960,30009196.0,14524722.0,15484473.0,235,68,167,28069,2638,25431,29277710.0,13498976.0,15778734.0,3.3826,0.6204,5.1171,0.6205
2023-08-02 11:40,226,126,100,12191,4103,8088,7536421.0,2534050.0,5002371.0,176,91,85,11990,4570,7420,7414038.0,2814851.0,4599186.0,0.6176,0.6185,0.6159,0.6198
2023-08-02 11:45,298,145,153,21254,5813,15441,13168963.0,3600272.0,9568691.0,259,119,140,20006,4803,15203,12392412.0,2960805.0,9431606.0,0.6193,0.6197,0.6164,0.6204
2023-08-02 11:50,442,207,235,25021,8800,16221,15519107.0,5445616.0,10073490.0,442,206,236,24354,8674,15680,15067824.0,5338545.0,9729279.0,0.6188,0.621,0.6155,0.6205
2023-08-02 11:55,546,229,317,51283,11569,39714,31799310.0,7144883.0,24654427.0,481,176,305,50353,11479,38874,32149171.0,8019803.0,24129368.0,0.6176,0.6208,0.6986,0.6207
2023-08-02 12:00,768,343,425,56800,19032,37768,47211779.0,23739320.0,23472459.0,703,313,390,54089,18136,35953,45416733.0,23083915.0,22332817.0,1.2473,0.6215,1.2728,0.6212
2023-08-02 12:05,1658,1073,585,164449,102919,61530,126225982.0,87655058.0,38570923.0,1519,989,530,153564,98691,54873,119028151.0,84844520.0,34183631.0,0.8517,0.6269,0.8597,0.623
2023-08-02 12:10,744,456,288,58649,48391,10258,36342960.0,30003162.0,6339798.0,633,389,244,56104,46808,9296,34780336.0,28982897.0,5797438.0,0.62,0.618,0.6192,0.6236
2023-08-02 12:15,854,458,396,70289,42118,28171,55508024.0,38004701.0,17503323.0,792,429,363,68054,40567,27487,54188575.0,36996803.0,17191772.0,0.9023,0.6213,0.912,0.6255
2023-08-02 12:20,1010,516,494,60366,37440,22926,49360189.0,35091608.0,14268581.0,882,471,411,55806,35224,20582,46507643.0,33696913.0,12810729.0,0.9373,0.6224,0.9566,0.6224
2023-08-02 12:25,565,279,286,34328,17015,17313,21342583.0,10577120.0,10765463.0,534,269,265,34184,18432,15752,21231227.0,11423504.0,9807723.0,0.6216,0.6218,0.6198,0.6226
2023-08-02 12:30,209,105,104,12036,6456,5580,7449652.0,3989957.0,3459694.0,173,79,94,9378,4185,5193,5821485.0,2591185.0,3230299.0,0.618,0.62,0.6192,0.622
2023-08-02 12:35,145,62,83,8315,2893,5422,5155995.0,1790587.0,3365408.0,122,44,78,7532,2615,4917,4686911.0,1618939.0,3067971.0,0.6189,0.6207,0.6191,0.624
2023-08-02 12:40,433,212,221,28242,14514,13728,17521423.0,8981026.0,8540397.0,390,189,201,30904,17492,13412,19074568.0,10714920.0,8359647.0,0.6188,0.6221,0.6126,0.6233
2023-08-02 12:45,369,171,198,26483,9809,16674,28361638.0,17959873.0,10401764.0,382,172,210,26404,9267,17137,28309376.0,17618935.0,10690441.0,1.831,0.6238,1.9013,0.6238
2023-08-02 12:50,1367,589,778,109717,27070,82647,68357869.0,16803213.0,51554655.0,1330,579,751,108535,26773,81762,67612959.0,16609870.0,51003089.0,0.6207,0.6238,0.6204,0.6238
2023-08-02 12:55,476,177,299,38871,8150,30721,24207392.0,5052368.0,19155023.0,459,167,292,38531,7750,30781,23999538.0,4806611.0,19192927.0,0.6199,0.6235,0.6202,0.6235
2023-08-02 13:00,453,218,235,49588,13963,35625,30919732.0,8650960.0,22268772.0,424,202,222,46017,12917,33100,28689931.0,8009192.0,20680739.0,0.6196,0.6251,0.6201,0.6248
2023-08-02 13:05,332,181,151,19629,7603,12026,12202722.0,4744461.0,7458261.0,309,166,143,20562,7674,12888,12777440.0,4752735.0,8024705.0,0.624,0.6202,0.6193,0.6226
2023-08-02 13:10,508,204,304,47476,10340,37136,29490468.0,6406080.0,23084388.0,470,183,287,44317,8976,35341,27574713.0,5556628.0,22018084.0,0.6195,0.6216,0.6191,0.623
2023-08-02 13:15,385,156,229,26882,6199,20683,16613333.0,3858434.0,12754898.0,356,142,214,24765,5671,19094,15394543.0,3511916.0,11882627.0,0.6224,0.6167,0.6193,0.6223
2023-08-02 13:20,203,111,92,9212,3997,5215,5622303.0,2476968.0,3145334.0,178,94,84,8674,4458,4216,5380684.0,2759790.0,2620894.0,0.6197,0.6031,0.6191,0.6217
2023-08-02 13:25,405,208,197,23598,11131,12467,14659863.0,6904812.0,7755051.0,377,189,188,21888,10390,11498,13587141.0,6442506.0,7144635.0,0.6203,0.622,0.6201,0.6214
2023-08-02 13:30,176,69,107,10896,3366,7530,6711032.0,2064779.0,4646252.0,153,58,95,9531,2512,7019,5928554.0,1556238.0,4372316.0,0.6134,0.617,0.6195,0.6229
2023-08-02 13:35,145,83,62,10124,3098,7026,6246565.0,1919771.0,4326794.0,123,67,56,7601,2377,5224,4731050.0,1472349.0,3258701.0,0.6197,0.6158,0.6194,0.6238
2023-08-02 13:40,85,53,32,4010,2040,1970,2461389.0,1263352.0,1198037.0,58,35,23,3473,1703,1770,2156785.0,1053950.0,1102834.0,0.6193,0.6081,0.6189,0.6231
2023-08-02 13:45,252,136,116,15021,6842,8179,9318124.0,4272887.0,5045237.0,214,106,108,12737,5233,7504,7912543.0,3240054.0,4672489.0,0.6245,0.6169,0.6192,0.6227
2023-08-02 13:50,383,185,198,25821,9617,16204,16047996.0,5962416.0,10085580.0,365,171,194,25246,9383,15863,15684655.0,5813915.0,9870739.0,0.62,0.6224,0.6196,0.6222
2023-08-02 13:55,371,153,218,28524,10277,18247,17690954.0,6355999.0,11334954.0,352,140,212,28104,9854,18250,17444510.0,6095456.0,11349054.0,0.6185,0.6212,0.6186,0.6219
2023-08-02 14:00,365,187,178,24356,7288,17068,15101769.0,4512748.0,10589020.0,331,160,171,25298,7397,17901,15726329.0,4577680.0,11148649.0,0.6192,0.6204,0.6189,0.6228
2023-08-02 14:05,300,178,122,19229,7652,11577,11970213.0,4753889.0,7216324.0,285,163,122,19087,7355,11732,11866962.0,4554612.0,7312349.0,0.6213,0.6233,0.6193,0.6233
2023-08-02 14:10,676,433,243,45301,29087,16214,51929855.0,41825076.0,10104779.0,638,414,224,42747,26929,15818,50316004.0,40458248.0,9857756.0,1.4379,0.6232,1.5024,0.6232
2023-08-02 14:15,1797,902,895,136346,47235,89111,84846156.0,29314081.0,55532074.0,1767,888,879,133813,46786,87027,83258143.0,29014634.0,54243509.0,0.6206,0.6232,0.6202,0.6233
2023-08-02 14:20,774,366,408,63482,18179,45303,51392777.0,23168537.0,28224239.0,748,349,399,61904,17117,44787,50390106.0,22491669.0,27898437.0,1.2745,0.623,1.314,0.6229
2023-08-02 14:25,207,78,129,19111,3962,15149,11945754.0,2481252.0,9464501.0,174,62,112,17775,2576,15199,11098986.0,1601568.0,9497417.0,0.6263,0.6248,0.6217,0.6249
2023-08-02 14:30,223,103,120,16607,5398,11209,10354921.0,3357993.0,6996928.0,200,98,102,15622,5489,10133,9777491.0,3404661.0,6372829.0,0.6221,0.6242,0.6203,0.6289
2023-08-02 14:35,266,136,130,18802,8768,10034,23583800.0,17329036.0,6254764.0,249,128,121,18121,9008,9113,23166552.0,17476661.0,5689891.0,1.9764,0.6234,1.9401,0.6244
2023-08-02 14:40,187,96,91,16861,9705,7156,10502384.0,6033211.0,4469172.0,160,81,79,11593,5806,5787,7223463.0,3607875.0,3615588.0,0.6217,0.6245,0.6214,0.6248
2023-08-02 14:45,2320,1730,590,237081,197364,39717,159822942.0,134919241.0,24903701.0,2219,1678,541,235015,197334,37681,158446970.0,134848328.0,23598641.0,0.6836,0.627,0.6834,0.6263
2023-08-02 14:50,1526,1120,406,185227,169027,16200,115443923.0,105307673.0,10136250.0,1510,1115,395,184985,168998,15987,115291837.0,105287294.0,10004543.0,0.623,0.6257,0.623,0.6258
2023-08-02 14:55,1101,815,286,128278,111866,16412,79963941.0,69700129.0,10263812.0,1094,812,282,129019,112645,16374,80418195.0,70173574.0,10244621.0,0.6231,0.6254,0.623,0.6257
2023-08-02 15:00,1021,719,302,104774,92463,12311,77379119.0,69668419.0,7710700.0,959,696,263,100082,88777,11305,74379818.0,67293081.0,7086737.0,0.7535,0.6263,0.758,0.6269
2023-08-02 15:05,623,349,274,44837,27312,17525,28078619.0,17088199.0,10990420.0,554,325,229,43051,28104,14947,26918324.0,17541704.0,9376619.0,0.6257,0.6271,0.6242,0.6273
2023-08-02 15:10,431,275,156,26099,13510,12589,16312354.0,8440785.0,7871569.0,344,216,128,21647,11563,10084,13551802.0,7221635.0,6330166.0,0.6248,0.6253,0.6245,0.6277
2023-08-02 15:15,653,314,339,30929,16890,14039,31196506.0,22428598.0,8767907.0,571,276,295,26665,13581,13084,28552276.0,20351142.0,8201134.0,1.3279,0.6245,1.4985,0.6268
2023-08-02 15:20,647,296,351,38421,16185,22236,24012269.0,10091638.0,13920631.0,593,259,334,35935,14923,21012,22491140.0,9323600.0,13167539.0,0.6235,0.626,0.6248,0.6267
2023-08-02 15:25,519,274,245,32490,8429,24061,32238627.0,17160054.0,15078573.0,492,256,236,31511,7535,23976,31616001.0,16582647.0,15033353.0,2.0358,0.6267,2.2007,0.627
2023-08-02 15:30,798,364,434,62525,16318,46207,39134133.0,10171929.0,28962204.0,770,355,415,64174,18687,45487,40137577.0,11603118.0,28534459.0,0.6234,0.6268,0.6209,0.6273
2023-08-02 15:35,323,153,170,30296,5673,24623,18997715.0,3544145.0,15453570.0,279,125,154,28625,5286,23339,17960527.0,3302833.0,14657693.0,0.6247,0.6276,0.6248,0.628
2023-08-02 15:40,528,290,238,25590,10535,15055,15995119.0,6582191.0,9412927.0,482,256,226,24795,10288,14507,15515013.0,6422773.0,9092240.0,0.6248,0.6252,0.6243,0.6267
2023-08-02 15:45,574,324,250,43442,14771,28671,38996842.0,21083655.0,17913186.0,499,278,221,40736,14191,26545,37351504.0,20718148.0,16633356.0,1.4274,0.6248,1.4599,0.6266
2023-08-02 15:50,905,568,337,40932,23709,17223,25580058.0,14788184.0,10791874.0,873,550,323,39761,23589,16172,24832377.0,14713685.0,10118692.0,0.6237,0.6266,0.6238,0.6257
2023-08-02 15:55,502,297,205,24096,13441,10655,15070751.0,8396851.0,6673900.0,483,284,199,23388,12670,10718,14620022.0,7905483.0,6714538.0,0.6247,0.6264,0.624,0.6265
2023-08-02 16:00,768,446,322,41523,23814,17709,37783924.0,26768429.0,11015495.0,702,396,306,38564,22353,16211,35990899.0,25834586.0,10156313.0,1.1241,0.622,1.1558,0.6265
2023-08-02 16:05,424,238,186,16242,9661,6581,10168904.0,6046725.0,4122179.0,388,219,169,16020,9510,6510,10025203.0,5943476.0,4081727.0,0.6259,0.6264,0.625,0.627
2023-08-02 16:10,370,185,185,17921,6078,11843,11205736.0,3796618.0,7409118.0,318,147,171,15513,5680,9833,9713684.0,3547203.0,6166481.0,0.6246,0.6256,0.6245,0.6271
2023-08-02 16:15,646,326,320,51834,21251,30583,56132082.0,37005424.0,19126657.0,588,283,305,49772,20064,29708,54857166.0,36264429.0,18592737.0,1.7413,0.6254,1.8074,0.6258
2023-08-02 16:20,2442,568,1874,300397,28654,271743,199359646.0,29695509.0,169664137.0,2345,497,1848,296944,27842,269102,197215220.0,29185774.0,168029445.0,1.0363,0.6244,1.0483,0.6244
2023-08-02 16:25,1992,1002,990,181652,72586,109066,136980050.0,68928934.0,68051115.0,1938,971,967,177331,69468,107863,134224030.0,66913522.0,67310508.0,0.9496,0.6239,0.9632,0.624
2023-08-02 16:30,2716,1055,1661,314308,58387,255921,195764456.0,36225270.0,159539185.0,2675,1013,1662,310717,55797,254920,193536829.0,34619168.0,158917660.0,0.6204,0.6234,0.6204,0.6234
2023-08-02 16:35,2211,973,1238,211985,45558,166427,144125698.0,40231922.0,103893776.0,2163,938,1225,208279,42076,166203,141769868.0,38019044.0,103750824.0,0.8831,0.6243,0.9036,0.6242
2023-08-02 16:40,2837,1766,1071,170961,88335,82626,106627969.0,54947912.0,51680057.0,2825,1766,1059,174421,90794,83627,108773560.0,56468989.0,52304570.0,0.622,0.6255,0.6219,0.6255
2023-08-02 16:45,1260,785,475,81870,48445,33425,50965508.0,30143856.0,20821651.0,1208,755,453,71478,39526,31952,44582709.0,24590525.0,19992184.0,0.6222,0.6229,0.6221,0.6257
2023-08-02 16:50,1114,571,543,74622,31617,43005,58439623.0,31572331.0,26867291.0,1083,547,536,79270,37460,41810,61355764.0,35214858.0,26140905.0,0.9986,0.6247,0.9401,0.6252
2023-08-02 16:55,1753,853,900,149915,56846,93069,93517427.0,35370367.0,58147059.0,1710,822,888,149722,56656,93066,93399583.0,35250438.0,58149144.0,0.6222,0.6248,0.6222,0.6248
2023-08-02 17:00,674,415,259,36966,21176,15790,22996820.0,13157071.0,9839749.0,631,376,255,35625,21000,14625,22167840.0,13045277.0,9122563.0,0.6213,0.6232,0.6212,0.6238
2023-08-02 17:05,775,447,328,39236,20329,18907,24401853.0,12635082.0,11766771.0,751,427,324,38772,20211,18561,24118615.0,12561491.0,11557124.0,0.6215,0.6224,0.6215,0.6227
2023-08-02 17:10,889,447,442,55192,19997,35195,46189818.0,24283587.0,21906231.0,847,415,432,54116,19657,34459,45559987.0,24072669.0,21487318.0,1.2144,0.6224,1.2246,0.6236
2023-08-02 17:15,1357,605,752,129085,40483,88602,80319527.0,25081344.0,55238183.0,1320,586,734,126442,38238,88204,78722364.0,23717656.0,55004708.0,0.6196,0.6234,0.6203,0.6236
2023-08-02 17:20,1215,759,456,97155,48178,48977,60478574.0,29924251.0,30554322.0,1176,729,447,96899,47875,49024,60311432.0,29725125.0,30586307.0,0.6211,0.6239,0.6209,0.6239
2023-08-02 17:25,2143,1015,1128,210366,67332,143034,154755174.0,65563277.0,89191897.0,2085,972,1113,208319,66949,141370,153497586.0,65307879.0,88189707.0,0.9737,0.6236,0.9755,0.6238
2023-08-02 17:30,1836,465,1371,156184,30126,126058,97314132.0,18709256.0,78604875.0,1798,436,1362,155737,29864,125873,97039891.0,18531335.0,78508556.0,0.621,0.6236,0.6205,0.6237
2023-08-02 17:35,1306,514,792,78619,28388,50231,60837927.0,29507926.0,31330001.0,1259,482,777,79410,29891,49519,61274521.0,30388993.0,30885528.0,1.0395,0.6237,1.0167,0.6237
2023-08-02 17:40,699,444,255,47767,22615,25152,29728786.0,14044211.0,15684575.0,666,415,251,47736,23052,24684,29713251.0,14307373.0,15405877.0,0.621,0.6236,0.6207,0.6241
2023-08-02 17:45,1345,373,972,160263,18526,141737,123446527.0,35250860.0,88195667.0,1268,309,959,157508,16265,141243,121855829.0,33828947.0,88026881.0,1.9028,0.6222,2.0799,0.6232
2023-08-02 17:50,733,200,533,91113,10685,80428,68496899.0,18467318.0,50029581.0,669,145,524,91323,10988,80335,68721438.0,18656710.0,50064728.0,1.7283,0.622,1.6979,0.6232
2023-08-02 17:55,970,306,664,101389,9537,91852,63039935.0,5901200.0,57138735.0,887,242,645,98467,7653,90814,61278696.0,4736871.0,56541825.0,0.6188,0.6221,0.619,0.6226
2023-08-02 18:00,1360,434,926,164710,8505,156205,102531468.0,5291862.0,97239606.0,1313,393,920,164788,8655,156133,102555535.0,5341900.0,97213635.0,0.6222,0.6225,0.6172,0.6226
2023-08-02 18:05,745,285,460,71182,5472,65710,44335697.0,3414333.0,40921364.0,694,244,450,70891,5050,65841,44130435.0,3127825.0,41002610.0,0.624,0.6228,0.6194,0.6228
2023-08-02 18:10,1033,478,555,108562,15058,93504,67615542.0,9347308.0,58268233.0,986,446,540,107426,14461,92965,66894550.0,8957061.0,57937489.0,0.6208,0.6232,0.6194,0.6232
2023-08-02 18:15,189,144,45,11097,4317,6780,6882330.0,2674818.0,4207511.0,156,114,42,9436,4962,4474,5863092.0,3067175.0,2795916.0,0.6196,0.6206,0.6181,0.6249
2023-08-02 18:20,193,117,76,14161,5532,8629,8799285.0,3425304.0,5373980.0,160,91,69,12228,2903,9325,7599623.0,1790409.0,5809213.0,0.6192,0.6228,0.6167,0.623
2023-08-02 18:25,926,212,714,158535,10935,147600,98718864.0,6792378.0,91926485.0,881,184,697,155768,10341,145427,96995140.0,6409009.0,90586131.0,0.6212,0.6228,0.6198,0.6229
2023-08-02 18:30,135,77,58,11710,7073,4637,19170189.0,16282330.0,2887859.0,107,60,47,10053,5759,4294,18127102.0,15446626.0,2680476.0,2.302,0.6228,2.6822,0.6242
2023-08-02 18:35,50,21,29,3122,863,2259,1941676.0,535425.0,1406251.0,41,13,28,4616,2024,2592,2871296.0,1253695.0,1617600.0,0.6204,0.6225,0.6194,0.6241
2023-08-03 10:00,1975,1056,919,165686,81944,83742,114598140.0,61655308.0,52942832.0,1614,872,742,141585,72756,68829,92835414.0,49808325.0,43027089.0,0.7524,0.6322,0.6846,0.6251
2023-08-03 10:05,525,252,273,32402,15262,17140,20153220.0,9434763.0,10718456.0,440,205,235,28342,12979,15363,17627818.0,8052952.0,9574866.0,0.6182,0.6253,0.6205,0.6232
2023-08-03 10:10,963,534,429,66083,33350,32733,52692110.0,32475126.0,20216984.0,876,480,396,56393,29242,27151,41340173.0,24424041.0,16916131.0,0.9738,0.6176,0.8352,0.623
2023-08-03 10:15,1431,668,763,112416,38886,73530,81316211.0,35855121.0,45461090.0,1292,582,710,107221,34133,73088,78283544.0,32957319.0,45326224.0,0.9221,0.6183,0.9656,0.6202
2023-08-03 10:20,488,247,241,24197,11806,12391,26723296.0,19145267.0,7578028.0,342,137,205,16880,6874,10006,22302700.0,16105422.0,6197278.0,1.6217,0.6116,2.3429,0.6194
2023-08-03 10:25,664,364,300,46526,28090,18436,53051208.0,41586509.0,11464698.0,577,318,259,40832,22979,17853,49032126.0,37946899.0,11085226.0,1.4805,0.6219,1.6514,0.6209
2023-08-03 10:30,3105,2677,428,412459,389248,23211,255366931.0,240928085.0,14438845.0,3046,2646,400,411016,388240,22776,254427699.0,240270016.0,14157682.0,0.619,0.6221,0.6189,0.6216
2023-08-03 10:35,1115,580,535,87300,43121,44179,54199627.0,26732796.0,27466830.0,1051,547,504,83124,41814,41310,51602823.0,25911513.0,25691310.0,0.6199,0.6217,0.6197,0.6219
2023-08-03 10:40,1536,460,1076,195217,29088,166129,133133163.0,29893260.0,103239902.0,1490,447,1043,191603,27442,164161,130909781.0,28858286.0,102051494.0,1.0277,0.6214,1.0516,0.6217
2023-08-03 10:45,444,112,332,58012,7317,50695,36050610.0,4523029.0,31527581.0,392,90,302,55655,7658,47997,34552795.0,4706322.0,29846473.0,0.6182,0.6219,0.6146,0.6218
2023-08-03 10:50,918,243,675,117288,8972,108316,84392063.0,17410386.0,66981677.0,862,213,649,113442,8526,104916,82234386.0,17133120.0,65101265.0,1.9405,0.6184,2.0095,0.6205
2023-08-03 10:55,2033,328,1705,325531,18249,307282,214173267.0,23178081.0,190995186.0,2004,312,1692,323911,16790,307121,213130790.0,22240024.0,190890766.0,1.2701,0.6216,1.3246,0.6215
2023-08-03 11:00,1887,187,1700,341999,19191,322808,212490693.0,11855901.0,200634792.0,1858,177,1681,340884,18936,321948,211830540.0,11697970.0,200132570.0,0.6178,0.6215,0.6178,0.6216
2023-08-03 11:05,1620,374,1246,253087,43576,209511,180804894.0,50693490.0,130111403.0,1582,353,1229,251833,43324,208509,180040468.0,50536172.0,129504296.0,1.1633,0.621,1.1665,0.6211
2023-08-03 11:10,1576,517,1059,219905,43617,176288,136362734.0,26927489.0,109435245.0,1542,498,1044,219062,43132,175930,135871688.0,26636891.0,109234796.0,0.6174,0.6208,0.6176,0.6209
2023-08-03 11:15,1021,615,406,91613,28387,63226,56853631.0,17544251.0,39309379.0,878,534,344,90343,27534,62809,56072816.0,17024549.0,39048267.0,0.618,0.6217,0.6183,0.6217
2023-08-03 11:20,1755,855,900,174291,76701,97590,120035977.0,59422521.0,60613456.0,1723,833,890,173009,74652,98357,119203109.0,58071629.0,61131480.0,0.7747,0.6211,0.7779,0.6215
2023-08-03 11:25,487,274,213,29983,17988,11995,30591017.0,23107648.0,7483369.0,430,238,192,26344,15600,10744,28254836.0,21541794.0,6713041.0,1.2846,0.6239,1.3809,0.6248
2023-08-03 11:30,781,434,347,52922,32647,20275,32929819.0,20286610.0,12643208.0,733,417,316,52224,33260,18964,32535034.0,20664586.0,11870447.0,0.6214,0.6236,0.6213,0.6259
2023-08-03 11:35,835,488,347,62590,44617,17973,74848452.0,63610063.0,11238389.0,764,450,314,57041,40691,16350,71124969.0,60909899.0,10215070.0,1.4257,0.6253,1.4969,0.6248
2023-08-03 11:40,917,619,298,64136,49557,14579,75862202.0,66659843.0,9202358.0,806,557,249,59693,47138,12555,72926106.0,65012506.0,7913599.0,1.3451,0.6312,1.3792,0.6303
2023-08-03 11:45,823,351,472,43944,20517,23427,39754145.0,24857972.0,14896172.0,680,302,378,35846,17181,18665,34424874.0,22623240.0,11801633.0,1.2116,0.6359,1.3168,0.6323
2023-08-03 11:50,2371,782,1589,226919,45362,181557,177217205.0,63895240.0,113321964.0,2264,725,1539,218411,44268,174143,172147996.0,63199055.0,108948941.0,1.4086,0.6242,1.4276,0.6256
2023-08-03 11:55,576,288,288,41174,25148,16026,37629098.0,27602150.0,10026948.0,528,266,262,38602,23153,15449,35965079.0,26295957.0,9669122.0,1.0976,0.6257,1.1357,0.6259
2023-08-03 12:00,1098,630,468,96221,69622,26599,71845308.0,55195096.0,16650212.0,1063,613,450,94981,68441,26540,71081537.0,54478078.0,16603458.0,0.7928,0.626,0.796,0.6256
2023-08-03 12:05,666,541,125,75995,70759,5236,47408307.0,44109977.0,3298330.0,621,507,114,73168,69621,3547,45609279.0,43384396.0,2224882.0,0.6234,0.6299,0.6232,0.6273
2023-08-03 12:10,1703,689,1014,159916,59533,100383,135408640.0,72720234.0,62688405.0,1656,657,999,158240,59483,98757,134448920.0,72672818.0,61776102.0,1.2215,0.6245,1.2217,0.6255
2023-08-03 12:15,630,293,337,42375,20112,22263,38342510.0,24416440.0,13926070.0,595,279,316,41356,19642,21714,37706186.0,24122710.0,13583475.0,1.214,0.6255,1.2281,0.6256
2023-08-03 12:20,1289,400,889,121153,20469,100684,87512986.0,24624618.0,62888368.0,1252,376,876,119044,19852,99192,86240076.0,24237985.0,62002091.0,1.203,0.6246,1.2209,0.6251
2023-08-03 12:25,627,119,508,66163,5132,61031,41281092.0,3189557.0,38091534.0,593,92,501,64267,4050,60217,40131964.0,2513698.0,37618265.0,0.6215,0.6241,0.6207,0.6247
2023-08-03 12:30,1162,484,678,96970,33430,63540,72322331.0,32636399.0,39685932.0,1111,452,659,95307,32529,62778,71330946.0,32101776.0,39229169.0,0.9763,0.6246,0.9869,0.6249
2023-08-03 12:35,917,411,506,93123,28593,64530,70032617.0,29701521.0,40331095.0,886,393,493,91915,27676,64239,69239167.0,29093845.0,40145321.0,1.0388,0.625,1.0512,0.6249
2023-08-03 12:40,1333,496,837,158001,49626,108375,98593893.0,30874655.0,67719237.0,1313,481,832,157576,49351,108225,98329194.0,30703452.0,67625742.0,0.6221,0.6249,0.6221,0.6249
2023-08-03 12:45,1125,666,459,114787,63540,51247,71576889.0,39550113.0,32026775.0,1096,647,449,114427,63502,50925,71349937.0,39518910.0,31831026.0,0.6224,0.6249,0.6223,0.6251
2023-08-03 12:50,1358,801,557,157517,83709,73808,98241374.0,52109501.0,46131873.0,1338,790,548,156582,83145,73437,97633693.0,51731226.0,45902467.0,0.6225,0.625,0.6222,0.6251
2023-08-03 12:55,2371,1302,1069,260322,177139,83183,162204248.0,110240798.0,51963449.0,2314,1277,1037,259259,176600,82659,161574856.0,109905240.0,51669616.0,0.6223,0.6247,0.6223,0.6251
2023-08-03 13:00,437,235,202,40851,25871,14980,25462454.0,16094647.0,9367806.0,420,224,196,40702,25893,14809,25367859.0,16107391.0,9260467.0,0.6221,0.6254,0.6221,0.6253
2023-08-03 13:05,307,187,120,26589,20114,6475,28502773.0,24450171.0,4052601.0,280,165,115,27573,18849,8724,29087691.0,23608174.0,5479517.0,1.2156,0.6259,1.2525,0.6281
2023-08-03 13:10,1960,1431,529,231201,184473,46728,144505234.0,115217858.0,29287376.0,1919,1412,507,225303,179215,46088,140692437.0,111808715.0,28883721.0,0.6246,0.6268,0.6239,0.6267
2023-08-03 13:15,1760,1125,635,196998,166451,30547,146817678.0,127659870.0,19157808.0,1720,1108,612,199970,170190,29780,148658352.0,129983014.0,18675338.0,0.767,0.6272,0.7638,0.6271
2023-08-03 13:20,942,589,353,104363,79376,24987,77130785.0,61432995.0,15697789.0,898,567,331,99853,75750,24103,74270272.0,59134239.0,15136032.0,0.7739,0.6282,0.7807,0.628
2023-08-03 13:25,966,614,352,92329,69776,22553,69635885.0,55453019.0,14182865.0,931,591,340,86296,67010,19286,65849965.0,53743256.0,12106709.0,0.7947,0.6289,0.802,0.6277
2023-08-03 13:30,336,176,160,20664,10422,10242,24827328.0,18405813.0,6421515.0,316,164,152,17947,8756,9191,23116753.0,17352025.0,5764727.0,1.7661,0.627,1.9817,0.6272
2023-08-03 13:35,510,208,302,46950,23874,23076,29348849.0,14916694.0,14432154.0,476,190,286,40354,18849,21505,25251210.0,11757906.0,13493304.0,0.6248,0.6254,0.6238,0.6274
2023-08-03 13:40,437,193,244,26895,6119,20776,16777529.0,3841739.0,12935790.0,400,173,227,25974,6917,19057,16298699.0,4325238.0,11973461.0,0.6278,0.6226,0.6253,0.6283
2023-08-03 13:45,2443,1644,799,234576,181626,52950,302568342.0,269109550.0,33458792.0,2149,1518,631,212290,169729,42561,288115236.0,261166850.0,26948386.0,1.4817,0.6319,1.5387,0.6332
2023-08-03 13:50,2057,1041,1016,165708,97574,68134,151862247.0,108782717.0,43079529.0,1930,972,958,157948,93133,64815,146915399.0,105968016.0,40947382.0,1.1149,0.6323,1.1378,0.6318
2023-08-03 13:55,4021,2298,1723,391435,243532,147903,436398143.0,343164852.0,93233290.0,3874,2202,1672,379802,235998,143804,429313603.0,338393653.0,90919949.0,1.4091,0.6304,1.4339,0.6322
2023-08-03 14:00,2494,1092,1402,206279,83531,122748,130032765.0,52489881.0,77542884.0,2429,1060,1369,205574,84011,121563,129593593.0,52781698.0,76811895.0,0.6284,0.6317,0.6283,0.6319
2023-08-03 14:05,896,272,624,95787,13881,81906,72206163.0,20585677.0,51620486.0,839,232,607,98977,17096,81881,74223553.0,22576522.0,51647031.0,1.483,0.6302,1.3206,0.6308
2023-08-03 14:10,817,310,507,56881,8271,48610,35869989.0,5189602.0,30680387.0,798,299,499,57528,8778,48750,36276901.0,5501281.0,30775619.0,0.6274,0.6312,0.6267,0.6313
2023-08-03 14:15,858,358,500,45815,11056,34759,28838069.0,6954325.0,21883744.0,806,316,490,44449,9820,34629,28004662.0,6161187.0,21843474.0,0.629,0.6296,0.6274,0.6308
2023-08-03 14:20,1060,548,512,51239,28570,22669,44058513.0,29828153.0,14230359.0,1019,532,487,49468,27543,21925,42999093.0,29173669.0,13825424.0,1.044,0.6277,1.0592,0.6306
2023-08-03 14:25,1015,514,501,51343,27693,23650,32352798.0,17459466.0,14893331.0,982,494,488,49947,26510,23437,31450595.0,16648531.0,14802064.0,0.6305,0.6297,0.628,0.6316
2023-08-03 14:30,723,420,303,49173,20343,28830,31028393.0,12780325.0,18248067.0,694,400,294,47734,19524,28210,30105383.0,12258715.0,17846668.0,0.6282,0.633,0.6279,0.6326
2023-08-03 14:35,499,265,234,21483,12659,8824,13516269.0,7954798.0,5561470.0,463,241,222,21484,13218,8266,13520669.0,8304846.0,5215822.0,0.6284,0.6303,0.6283,0.631
2023-08-03 14:40,1462,797,665,105036,36030,69006,66305395.0,22667736.0,43637659.0,1421,767,654,103838,35206,68632,65503948.0,22104335.0,43399613.0,0.6291,0.6324,0.6279,0.6324
2023-08-03 14:45,1474,765,709,99945,39226,60719,62992219.0,24641343.0,38350875.0,1425,730,695,98709,38686,60023,62230023.0,24299645.0,37930378.0,0.6282,0.6316,0.6281,0.6319
2023-08-03 14:50,175,100,75,8995,3859,5136,5665784.0,2425658.0,3240126.0,159,92,67,7790,3528,4262,4905778.0,2216250.0,2689527.0,0.6286,0.6309,0.6282,0.631
2023-08-03 14:55,901,441,460,47437,24082,23355,29848765.0,15132880.0,14715885.0,874,420,454,46911,23727,23184,29521234.0,14910406.0,14610828.0,0.6284,0.6301,0.6284,0.6302
2023-08-03 15:00,712,435,277,35129,22689,12440,22119042.0,14269664.0,7849378.0,670,407,263,33908,21629,12279,21341826.0,13589802.0,7752024.0,0.6289,0.631,0.6283,0.6313
2023-08-03 15:05,577,329,248,39320,21130,18190,36790623.0,25267741.0,11522882.0,528,301,227,36000,19057,16943,34603809.0,23866464.0,10737345.0,1.1958,0.6335,1.2524,0.6337
2023-08-03 15:10,2895,1994,901,257840,219999,37841,342275630.0,318217075.0,24058555.0,2408,1827,581,236961,209934,27027,328619181.0,311296796.0,17322385.0,1.4464,0.6358,1.4828,0.6409
2023-08-03 15:15,2958,1761,1197,229694,173322,56372,205576610.0,169608914.0,35967695.0,2708,1651,1057,216793,168557,48236,197263252.0,166446538.0,30816714.0,0.9786,0.638,0.9875,0.6389
2023-08-03 15:20,2007,895,1112,124761,59796,64965,126536045.0,85349478.0,41186567.0,1892,827,1065,123394,59241,64153,125876739.0,84987012.0,40889727.0,1.4273,0.634,1.4346,0.6374
2023-08-03 15:25,1860,1014,846,145277,91940,53337,127715703.0,93778239.0,33937464.0,1746,953,793,141679,89846,51833,125429019.0,92429945.0,32999073.0,1.02,0.6363,1.0288,0.6366
2023-08-03 15:30,804,376,428,37094,12376,24718,35329081.0,19694691.0,15634390.0,711,319,392,33621,10950,22671,33158026.0,18786564.0,14371462.0,1.5914,0.6325,1.7157,0.6339
2023-08-03 15:35,1637,427,1210,150469,30322,120147,118710643.0,42827361.0,75883282.0,1518,332,1186,146563,28594,117969,116420120.0,41745707.0,74674413.0,1.4124,0.6316,1.4599,0.633
2023-08-03 15:40,1025,509,516,53860,20857,33003,57900334.0,36977626.0,20922707.0,932,455,477,50798,19820,30978,55844103.0,36229077.0,19615026.0,1.7729,0.634,1.8279,0.6332
2023-08-03 15:45,794,436,358,40974,25907,15067,37673284.0,28180734.0,9492550.0,715,380,335,36543,22777,13766,34906812.0,26212001.0,8694811.0,1.0878,0.63,1.1508,0.6316
2023-08-03 15:50,350,193,157,15188,7117,8071,9597493.0,4501165.0,5096328.0,310,156,154,14287,6803,7484,9017317.0,4283666.0,4733651.0,0.6325,0.6314,0.6297,0.6325
2023-08-03 15:55,788,329,459,56742,18357,38385,35749760.0,11561899.0,24187861.0,746,304,442,54364,17684,36680,34335421.0,11135857.0,23199564.0,0.6298,0.6301,0.6297,0.6325
2023-08-03 16:00,931,312,619,86077,14205,71872,66356697.0,20814764.0,45541932.0,912,296,616,84535,12894,71641,65387707.0,19992078.0,45395629.0,1.4653,0.6337,1.5505,0.6337
2023-08-03 16:05,1364,641,723,94905,36352,58553,71870060.0,34816282.0,37053778.0,1302,601,701,91604,34049,57555,69849035.0,33349366.0,36499669.0,0.9578,0.6328,0.9795,0.6342
2023-08-03 16:10,1115,542,573,77650,26933,50717,49265692.0,17066703.0,32198989.0,1061,509,552,75892,26068,49824,48058157.0,16420164.0,31637993.0,0.6337,0.6349,0.6299,0.635
2023-08-03 16:15,1291,682,609,95461,35890,59571,60563215.0,22733337.0,37829878.0,1238,656,582,94108,35146,58962,59667799.0,22216978.0,37450821.0,0.6334,0.635,0.6321,0.6352
2023-08-03 16:20,2209,760,1449,233145,50574,182571,182669856.0,67540147.0,115129708.0,2132,710,1422,224278,47707,176571,177568605.0,65722770.0,111845834.0,1.3355,0.6306,1.3776,0.6334
2023-08-03 16:25,3606,631,2975,506044,26741,479303,320792059.0,16867557.0,303924502.0,3570,606,2964,506026,26316,479710,320783642.0,16596414.0,304187227.0,0.6308,0.6341,0.6307,0.6341
2023-08-03 16:30,2681,724,1957,288994,42340,246654,194994789.0,38608351.0,156386438.0,2640,704,1936,288407,42353,246054,194638932.0,38604247.0,156034685.0,0.9119,0.634,0.9115,0.6341
2023-08-03 16:35,2277,1093,1184,163756,61795,101961,115723626.0,51010610.0,64713016.0,2188,1027,1161,159798,58965,100833,113132510.0,49137047.0,63995462.0,0.8255,0.6347,0.8333,0.6347
2023-08-03 16:40,2343,1029,1314,153423,52818,100605,168704768.0,104721666.0,63983102.0,2205,956,1249,147348,51055,96293,164829733.0,103572013.0,61257719.0,1.9827,0.636,2.0286,0.6362
2023-08-03 16:45,1181,543,638,72381,23232,49149,45877047.0,14702384.0,31174663.0,1125,505,620,72440,21948,50492,45949775.0,13879194.0,32070580.0,0.6329,0.6343,0.6324,0.6352
2023-08-03 16:50,1680,718,962,82617,19285,63332,76366486.0,36061287.0,40305199.0,1562,641,921,77793,15758,62035,73241703.0,33749271.0,39492432.0,1.8699,0.6364,2.1417,0.6366
2023-08-03 16:55,1810,1123,687,106938,79998,26940,92112734.0,74899761.0,17212973.0,1657,1038,619,98400,74134,24266,86396445.0,70868490.0,15527955.0,0.9363,0.6389,0.956,0.6399
2023-08-03 17:00,1744,764,980,99046,48427,50619,86647032.0,54549530.0,32097502.0,1559,668,891,90336,45231,45105,81267514.0,52464650.0,28802864.0,1.1264,0.6341,1.1599,0.6386
2023-08-03 17:05,676,457,219,42827,30884,11943,50886803.0,43327726.0,7559077.0,613,411,202,38067,27855,10212,47891006.0,41373364.0,6517642.0,1.4029,0.6329,1.4853,0.6382
2023-08-03 17:10,1861,1062,799,163825,134875,28950,140081438.0,121597603.0,18483835.0,1733,992,741,156340,129455,26885,135067720.0,117887709.0,17180010.0,0.9016,0.6385,0.9106,0.639
2023-08-03 17:15,2478,1598,880,226958,198590,28368,229122013.0,210871868.0,18250144.0,2107,1458,649,201157,187342,13815,212083534.0,203152943.0,8930590.0,1.0618,0.6433,1.0844,0.6464
2023-08-03 17:20,1581,635,946,118197,37758,80439,99402009.0,47945863.0,51456146.0,1408,539,869,107882,32693,75189,93028824.0,44672783.0,48356041.0,1.2698,0.6397,1.3664,0.6431
2023-08-03 17:25,1853,776,1077,138706,29119,109587,124269873.0,54157538.0,70112334.0,1701,682,1019,129343,24532,104811,118562646.0,51283572.0,67279073.0,1.8599,0.6398,2.0905,0.6419
2023-08-03 17:30,1018,240,778,97349,12309,85040,62336204.0,7880658.0,54455546.0,938,187,751,91479,9735,81744,58552656.0,6204209.0,52348446.0,0.6402,0.6404,0.6373,0.6404
2023-08-03 17:35,471,118,353,48326,3245,45081,30919913.0,2074992.0,28844920.0,421,96,325,47138,3230,43908,30165688.0,2059875.0,28105813.0,0.6394,0.6398,0.6377,0.6401
2023-08-03 17:40,592,235,357,40011,16681,23330,25633692.0,10703680.0,14930011.0,558,220,338,37569,15181,22388,24028226.0,9690874.0,14337352.0,0.6417,0.6399,0.6384,0.6404
2023-08-03 17:45,534,238,296,42288,14208,28080,26877988.0,9054431.0,17823557.0,428,174,254,38594,13346,25248,24675709.0,8499044.0,16176665.0,0.6373,0.6347,0.6368,0.6407
2023-08-03 17:50,633,204,429,48083,6414,41669,30661972.0,4091041.0,26570931.0,550,151,399,45988,5758,40230,29417597.0,3659681.0,25757916.0,0.6378,0.6377,0.6356,0.6403
2023-08-03 17:55,2116,249,1867,242097,9985,232112,166192511.0,18231232.0,147961278.0,2012,194,1818,235870,7927,227943,162653090.0,16911636.0,145741453.0,1.8259,0.6375,2.1334,0.6394
2023-08-03 18:00,1843,213,1630,261184,9621,251563,166870275.0,6128674.0,160741600.0,1791,192,1599,260736,10102,250634,166626134.0,6396905.0,160229228.0,0.637,0.639,0.6332,0.6393
2023-08-03 18:05,2702,789,1913,264987,38441,226546,286863730.0,143023613.0,143840116.0,2477,640,1837,253492,32665,220827,280130768.0,139340024.0,140790744.0,3.7206,0.6349,4.2657,0.6376
2023-08-03 18:10,1108,510,598,63514,17045,46469,75960950.0,46380906.0,29580043.0,1026,453,573,61259,15897,45362,74524470.0,45670745.0,28853725.0,2.7211,0.6366,2.8729,0.6361
2023-08-03 18:15,1224,324,900,82804,15316,67488,64490915.0,21580062.0,42910853.0,1170,295,875,80875,13767,67108,63251373.0,20574973.0,42676400.0,1.409,0.6358,1.4945,0.6359
2023-08-03 18:20,847,339,508,46432,18070,28362,29552896.0,11533177.0,18019719.0,796,312,484,43486,15884,27602,27600850.0,10054292.0,17546557.0,0.6382,0.6353,0.633,0.6357
2023-08-03 18:25,2617,1856,761,185939,149118,36821,142794283.0,118474799.0,24319484.0,2532,1817,715,182715,147088,35627,140316508.0,117157596.0,23158911.0,0.7945,0.6605,0.7965,0.65
2023-08-03 18:30,1491,1078,413,112334,97013,15321,71458351.0,61678527.0,9779823.0,1427,1039,388,110263,95813,14450,70110982.0,60879526.0,9231456.0,0.6358,0.6383,0.6354,0.6389
2023-08-03 18:35,2826,2009,817,225090,188283,36807,178718809.0,155242735.0,23476074.0,2791,1984,807,223173,189107,34066,177376822.0,155645552.0,21731270.0,0.8245,0.6378,0.8231,0.6379
2023-08-04 10:00,5189,2832,2357,502732,293360,209372,399150686.0,264276492.0,134874193.0,4394,2464,1930,466763,278615,188148,364964478.0,243791301.0,121173177.0,0.9009,0.6442,0.875,0.644
2023-08-04 10:05,1014,527,487,62572,29853,32719,52491157.0,31095163.0,21395994.0,780,424,356,44768,24061,20707,39467176.0,26099108.0,13368068.0,1.0416,0.6539,1.0847,0.6456
2023-08-04 10:10,1369,824,545,98100,56339,41761,87227565.0,60345761.0,26881804.0,1178,741,437,83418,47573,35845,77474898.0,54321355.0,23153543.0,1.0711,0.6437,1.1419,0.6459
2023-08-04 10:15,2705,1451,1254,202821,133083,69738,177583920.0,132791859.0,44792061.0,2505,1355,1150,198297,130530,67767,174732636.0,131102907.0,43629729.0,0.9978,0.6423,1.0044,0.6438
2023-08-04 10:20,2674,1961,713,266233,234154,32079,206236664.0,185579773.0,20656891.0,2564,1919,645,261419,232674,28745,203164951.0,184621317.0,18543634.0,0.7926,0.6439,0.7935,0.6451
2023-08-04 10:25,1020,507,513,54228,31591,22637,58327812.0,43945790.0,14382022.0,921,446,475,49745,29047,20698,55614161.0,42309424.0,13304737.0,1.3911,0.6353,1.4566,0.6428
2023-08-04 10:30,1063,584,479,59528,33559,25969,50131158.0,33381071.0,16750087.0,948,516,432,55516,31248,24268,47501564.0,31859030.0,15642534.0,0.9947,0.645,1.0196,0.6446
2023-08-04 10:35,682,434,248,40198,29102,11096,25840769.0,18661429.0,7179340.0,593,381,212,36593,27765,8828,23466267.0,17778631.0,5687636.0,0.6412,0.647,0.6403,0.6443
2023-08-04 10:40,2006,1095,911,163267,114676,48591,104857896.0,73595555.0,31262340.0,1783,964,819,158902,112094,46808,102046473.0,71878181.0,30168291.0,0.6418,0.6434,0.6412,0.6445
2023-08-04 10:45,1499,805,694,99977,51925,48052,112321857.0,81277043.0,31044814.0,1147,668,479,82526,41282,41244,100821356.0,74109609.0,26711747.0,1.5653,0.6461,1.7952,0.6477
2023-08-04 10:50,8572,4910,3662,830975,532249,298726,1178491964.0,982107961.0,196384003.0,6275,3967,2308,677833,452710,225123,1076106219.0,927198796.0,148907422.0,1.8452,0.6574,2.0481,0.6614
2023-08-04 10:55,10370,5886,4484,1135285,685409,449876,1273952984.0,973127790.0,300825193.0,7633,4692,2941,906254,572016,334238,1119452011.0,893515213.0,225936797.0,1.4198,0.6687,1.562,0.676
2023-08-04 11:00,8488,4764,3724,924432,500427,424005,1256658182.0,975905863.0,280752319.0,6845,3950,2895,762581,427737,334844,1151058744.0,926164665.0,224894079.0,1.9501,0.6621,2.1653,0.6716
2023-08-04 11:05,7275,2942,4333,759847,266516,493331,635671378.0,308056523.0,327614854.0,6491,2597,3894,724015,244035,479980,613701571.0,292775606.0,320925964.0,1.1559,0.6641,1.1997,0.6686
2023-08-04 11:10,5270,2146,3124,518558,167865,350693,465638151.0,231040587.0,234597564.0,4823,1951,2872,497381,159971,337410,451233341.0,225186372.0,226046969.0,1.3763,0.669,1.4077,0.6699
2023-08-04 11:15,4421,2461,1960,431137,268578,162559,407383027.0,299018635.0,108364391.0,3980,2279,1701,398247,253108,145139,385314647.0,288018682.0,97295964.0,1.1133,0.6666,1.1379,0.6704
2023-08-04 11:20,3251,1554,1697,330991,144295,186696,281422545.0,156160827.0,125261717.0,2949,1421,1528,313349,136343,177006,269873509.0,150722509.0,119151000.0,1.0822,0.6709,1.1055,0.6731
2023-08-04 11:25,1969,853,1116,196412,90525,105887,166530020.0,96119625.0,70410394.0,1753,734,1019,180124,84958,95166,155956764.0,92233631.0,63723133.0,1.0618,0.665,1.0856,0.6696
2023-08-04 11:30,1890,1139,751,196562,163899,32663,191293504.0,169150073.0,22143431.0,1728,1072,656,188544,159312,29232,185863920.0,165835269.0,20028650.0,1.032,0.6779,1.0409,0.6852
2023-08-04 11:35,3823,2163,1660,346368,192475,153893,454146203.0,353331585.0,100814617.0,3215,1818,1397,307115,172172,134943,429973659.0,339773513.0,90200146.0,1.8357,0.6551,1.9735,0.6684
2023-08-04 11:40,2045,1163,882,175535,100396,75139,175530750.0,125807801.0,49722949.0,1697,952,745,159540,90227,69313,164995865.0,118907821.0,46088043.0,1.2531,0.6617,1.3179,0.6649
2023-08-04 11:45,932,472,460,67928,42877,25051,57012816.0,40337287.0,16675529.0,806,424,382,64988,40602,24386,55055889.0,38726106.0,16329782.0,0.9408,0.6657,0.9538,0.6696
2023-08-04 11:50,2389,909,1480,161280,55628,105652,142470512.0,72437194.0,70033318.0,2256,847,1409,151455,53422,98033,136212790.0,70931468.0,65281322.0,1.3022,0.6629,1.3278,0.6659
2023-08-04 11:55,2277,861,1416,171242,49428,121814,149529790.0,68400933.0,81128856.0,2183,812,1371,168875,48609,120266,147880374.0,67793305.0,80087069.0,1.3838,0.666,1.3947,0.6659
2023-08-04 12:00,2132,1031,1101,135307,65534,69773,137014352.0,90867076.0,46147276.0,1976,945,1031,125220,61738,63482,130565121.0,88235343.0,42329778.0,1.3866,0.6614,1.4292,0.6668
2023-08-04 12:05,3954,2520,1434,408263,294842,113421,592729154.0,517417799.0,75311355.0,3440,2273,1167,353098,260461,92637,555962367.0,493942445.0,62019922.0,1.7549,0.664,1.8964,0.6695
2023-08-04 12:10,3676,2297,1379,314076,237995,76081,244154333.0,193644402.0,50509930.0,3410,2163,1247,307460,239744,67716,239889506.0,194615790.0,45273715.0,0.8136,0.6639,0.8118,0.6686
2023-08-04 12:15,4590,2409,2181,411354,192587,218767,439136594.0,294093099.0,145043494.0,4344,2256,2088,391397,182305,209092,426591322.0,287167298.0,139424024.0,1.5271,0.663,1.5752,0.6668
2023-08-04 12:20,1111,623,488,78964,51864,27100,64697468.0,46498844.0,18198623.0,989,553,436,69053,49710,19343,57899066.0,44962921.0,12936145.0,0.8966,0.6715,0.9045,0.6688
2023-08-04 12:25,1330,862,468,88548,61191,27357,94768101.0,76449156.0,18318944.0,1182,792,390,82026,57230,24796,90355207.0,73708859.0,16646348.0,1.2494,0.6696,1.2879,0.6713
2023-08-04 12:30,1837,832,1005,135107,42046,93061,101947660.0,39931917.0,62015743.0,1669,751,918,124434,38614,85820,95055235.0,37576734.0,57478501.0,0.9497,0.6664,0.9731,0.6698
2023-08-04 12:35,1458,758,700,96872,51539,45333,90496453.0,58269007.0,32227445.0,1321,687,634,87579,46762,40817,82429552.0,54975384.0,27454167.0,1.1306,0.7109,1.1756,0.6726
2023-08-04 12:40,2288,1482,806,199513,150357,49156,228715287.0,195876231.0,32839056.0,1861,1221,640,173379,135002,38377,211287198.0,185402591.0,25884607.0,1.3027,0.6681,1.3733,0.6745
2023-08-04 12:45,2056,747,1309,158052,88369,69683,188815325.0,142341487.0,46473838.0,1910,681,1229,155024,90974,64050,187086858.0,143969963.0,43116895.0,1.6108,0.6669,1.5825,0.6732
2023-08-04 12:50,2794,1211,1583,213483,106043,107440,165891741.0,94437351.0,71454390.0,2620,1124,1496,203999,101016,102983,159898613.0,91000357.0,68898256.0,0.8906,0.6651,0.9009,0.669
2023-08-04 12:55,1993,1268,725,175363,127155,48208,140580205.0,108394624.0,32185580.0,1887,1221,666,167321,123180,44141,135139693.0,105624902.0,29514791.0,0.8525,0.6676,0.8575,0.6686
2023-08-04 13:00,731,444,287,42325,28390,13935,28188999.0,18858353.0,9330645.0,691,434,257,43491,27552,15939,29163552.0,18311274.0,10852278.0,0.6643,0.6696,0.6646,0.6809
2023-08-04 13:05,2529,1091,1438,191951,105356,86595,151553116.0,93808625.0,57744491.0,2426,1029,1397,186987,102538,84449,148336329.0,91920138.0,56416191.0,0.8904,0.6668,0.8964,0.6681
2023-08-04 13:10,3037,781,2256,332201,30463,301738,221620444.0,20302677.0,201317767.0,2973,767,2206,328421,29348,299073,221122490.0,19494843.0,201627647.0,0.6665,0.6672,0.6643,0.6742
2023-08-04 13:15,609,313,296,28455,16191,12264,18880106.0,10789416.0,8090689.0,553,283,270,25756,15007,10749,17142603.0,9961332.0,7181271.0,0.6664,0.6597,0.6638,0.6681
2023-08-04 13:20,748,396,352,42488,27011,15477,40111036.0,29882079.0,10228956.0,638,352,286,40546,26647,13899,38826300.0,29560421.0,9265878.0,1.1063,0.6609,1.1093,0.6667
2023-08-04 13:25,1659,1052,607,140945,114127,26818,105555690.0,87648180.0,17907509.0,1620,1039,581,140489,114376,26113,105221385.0,87789141.0,17432244.0,0.768,0.6677,0.7675,0.6676
2023-08-04 13:30,943,549,394,74937,54033,20904,61835460.0,47879820.0,13955639.0,884,511,373,72372,51951,20421,60037149.0,46393055.0,13644093.0,0.8861,0.6676,0.893,0.6681
2023-08-04 13:35,2511,1507,1004,252352,174216,78136,168272150.0,116055562.0,52216588.0,2441,1483,958,248654,173875,74779,165791857.0,115796591.0,49995265.0,0.6662,0.6683,0.666,0.6686
2023-08-04 13:40,2148,1310,838,207114,149636,57478,185741261.0,147370154.0,38371106.0,2076,1277,799,202241,146338,55903,182378215.0,145027884.0,37350331.0,0.9849,0.6676,0.991,0.6681
2023-08-04 13:45,1353,779,574,92499,56566,35933,85552289.0,61568138.0,23984151.0,1256,724,532,87821,53996,33825,82573747.0,59783643.0,22790103.0,1.0884,0.6675,1.1072,0.6738
2023-08-04 13:50,3076,1751,1325,270718,174196,96522,466741623.0,402147966.0,64593657.0,2865,1647,1218,253869,164690,89179,455328172.0,395376213.0,59951959.0,2.3086,0.6692,2.4007,0.6723
2023-08-04 13:55,1757,392,1365,135740,13727,122013,114592534.0,32887309.0,81705225.0,1667,342,1325,129922,9990,119932,110878890.0,30403008.0,80475881.0,2.3958,0.6696,3.0433,0.671
2023-08-04 14:00,2984,459,2525,375435,14449,360986,287216304.0,45278024.0,241938280.0,2890,409,2481,370277,13340,356937,283923459.0,44522950.0,239400509.0,3.1336,0.6702,3.3376,0.6707
2023-08-04 14:05,2379,392,1987,293048,11908,281140,208374272.0,19796898.0,188577374.0,2307,359,1948,289269,10054,279215,205937972.0,18581667.0,187356305.0,1.6625,0.6708,1.8482,0.671
2023-08-04 14:10,1415,323,1092,125686,32588,93098,84447136.0,21936460.0,62510675.0,1329,288,1041,120910,29677,91233,81134718.0,19845373.0,61289344.0,0.6731,0.6715,0.6687,0.6718
2023-08-04 14:15,1271,701,570,91314,39048,52266,73044920.0,38041481.0,35003438.0,1181,653,528,85937,36867,49070,69498902.0,36533251.0,32965651.0,0.9742,0.6697,0.9909,0.6718
2023-08-04 14:20,293,147,146,21748,9650,12098,26369740.0,18337505.0,8032234.0,223,105,118,17974,7791,10183,23919315.0,17080050.0,6839265.0,1.9003,0.6639,2.1923,0.6716
2023-08-04 14:25,559,214,345,48110,9890,38220,43831049.0,18430664.0,25400384.0,481,167,314,43047,7071,35976,40708119.0,16591458.0,24116661.0,1.8636,0.6646,2.3464,0.6704
2023-08-04 14:30,1759,807,952,159439,52935,106504,106603953.0,35440864.0,71163088.0,1660,771,889,149820,49004,100816,100144713.0,32660980.0,67483733.0,0.6695,0.6682,0.6665,0.6694
2023-08-04 14:35,1520,574,946,131796,49608,82188,123299930.0,68761730.0,54538199.0,1383,514,869,123233,47249,75984,117899006.0,67057327.0,50841678.0,1.3861,0.6636,1.4192,0.6691
2023-08-04 14:40,3547,1571,1976,279987,88409,191578,362058503.0,236592127.0,125466375.0,3102,1324,1778,249883,73791,176092,343323797.0,226628707.0,116695089.0,2.6761,0.6549,3.0712,0.6627
2023-08-04 14:45,6574,4019,2555,661834,437247,224587,685532301.0,537276283.0,148256018.0,6231,3873,2358,624705,425133,199572,661239207.0,528947719.0,132291487.0,1.2288,0.6601,1.2442,0.6629
2023-08-04 14:50,4265,2865,1400,443125,318825,124300,552111721.0,470382574.0,81729147.0,4012,2720,1292,431824,308800,123024,544491864.0,463420403.0,81071461.0,1.4754,0.6575,1.5007,0.659
2023-08-04 14:55,5000,2206,2794,507037,184510,322527,463299725.0,251378521.0,211921204.0,4836,2113,2723,498362,179660,318702,469826610.0,260064965.0,209761644.0,1.3624,0.6571,1.4475,0.6582
2023-08-04 15:00,3863,1117,2746,347297,35072,312225,252312327.0,46713703.0,205598624.0,3746,1062,2684,339621,31633,307988,235427062.0,32580840.0,202846222.0,1.3319,0.6585,1.03,0.6586
2023-08-04 15:05,3982,1043,2939,369763,40087,329676,300754264.0,85506061.0,215248203.0,3737,920,2817,352700,35669,317031,290315872.0,82580464.0,207735407.0,2.133,0.6529,2.3152,0.6553
2023-08-04 15:10,2775,835,1940,264573,44049,220524,184023392.0,40419620.0,143603771.0,2612,741,1871,253989,38888,215101,177429467.0,37043964.0,140385502.0,0.9176,0.6512,0.9526,0.6526
2023-08-04 15:15,1931,754,1177,134565,30349,104216,287793737.0,221325533.0,66468204.0,1665,632,1033,120787,27538,93249,279587412.0,219487522.0,60099889.0,7.2927,0.6378,7.9704,0.6445
2023-08-04 15:20,3443,1169,2274,255363,50128,205235,375397595.0,245500972.0,129896623.0,3037,942,2095,238155,44670,193485,364966967.0,241909445.0,123057521.0,4.8975,0.6329,5.4155,0.636
2023-08-04 15:25,5210,2864,2346,508175,258394,249781,1104206857.0,946234622.0,157972235.0,4873,2663,2210,490097,246040,244057,1092699833.0,938104176.0,154595656.0,3.662,0.6324,3.8128,0.6334
2023-08-04 15:30,2504,2009,495,242804,208034,34770,405864819.0,383443754.0,22421064.0,2152,1851,301,222238,197990,24248,392036525.0,376333928.0,15702597.0,1.8432,0.6448,1.9008,0.6476
2023-08-04 15:35,2933,1709,1224,280758,197141,83617,618748084.0,565134186.0,53613898.0,2649,1562,1087,266177,191032,75145,609572536.0,561084521.0,48488015.0,2.8666,0.6412,2.9371,0.6453
2023-08-04 15:40,2870,1742,1128,206097,138081,68016,263365854.0,219516060.0,43849794.0,2617,1616,1001,189940,127083,62857,252701751.0,212093689.0,40608061.0,1.5898,0.6447,1.6689,0.646
2023-08-04 15:45,1145,825,320,101050,80042,21008,65247636.0,51632552.0,13615084.0,978,735,243,90121,76978,13143,58092481.0,49555455.0,8537025.0,0.6451,0.6481,0.6438,0.6495
2023-08-04 15:50,3825,2235,1590,352212,199550,152662,809034815.0,710323307.0,98711507.0,3566,2087,1479,338523,189745,148778,800387407.0,703861340.0,96526066.0,3.5596,0.6466,3.7095,0.6488
2023-08-04 15:55,4629,1410,3219,392705,91253,301452,478866592.0,284121787.0,194744805.0,4447,1300,3147,381576,86421,295155,472081971.0,280991338.0,191090633.0,3.1136,0.646,3.2514,0.6474
2023-08-04 16:00,3245,1557,1688,292108,138475,153633,294811655.0,195627143.0,99184511.0,3072,1468,1604,281085,130436,150649,287842415.0,190442988.0,97399427.0,1.4127,0.6456,1.46,0.6465
2023-08-04 16:05,2805,1673,1132,215620,151451,64169,187365054.0,145785240.0,41579814.0,2661,1597,1064,203905,144111,59794,179527853.0,140633255.0,38894597.0,0.9626,0.648,0.9759,0.6505
2023-08-04 16:10,912,571,341,62054,46478,15576,40190126.0,30064532.0,10125593.0,819,512,307,64431,51009,13422,41700770.0,32946192.0,8754577.0,0.6469,0.6501,0.6459,0.6523
2023-08-04 16:15,1324,784,540,100134,68602,31532,101049385.0,80435950.0,20613435.0,1181,716,465,89664,63099,26565,93849027.0,76486391.0,17362635.0,1.1725,0.6537,1.2122,0.6536
2023-08-04 16:20,4211,2464,1747,353672,248543,105129,385229653.0,316586841.0,68642812.0,4025,2377,1648,342634,240642,101992,378030755.0,311133282.0,66897473.0,1.2738,0.6529,1.2929,0.6559
2023-08-04 16:25,3600,1119,2481,340386,54445,285941,269688794.0,83012871.0,186675923.0,3455,1053,2402,329632,49883,279749,263078947.0,79965842.0,183113105.0,1.5247,0.6528,1.6031,0.6546
2023-08-04 16:30,2660,465,2195,293552,15909,277643,215414027.0,34069245.0,181344782.0,2627,448,2179,291076,14782,276294,213894067.0,33342229.0,180551838.0,2.1415,0.6532,2.2556,0.6535
2023-08-04 16:35,3691,898,2793,397480,47660,349820,283123183.0,54802605.0,228320578.0,3606,850,2756,393042,45831,347211,280392660.0,53543960.0,226848700.0,1.1499,0.6527,1.1683,0.6533
2023-08-04 16:40,3039,833,2206,340067,52217,287850,328750351.0,140918586.0,187831764.0,2899,762,2137,326644,45271,281373,320189980.0,136293324.0,183896656.0,2.6987,0.6525,3.0106,0.6536
2023-08-04 16:45,3030,2091,939,286727,211737,74990,258246519.0,209159770.0,49086748.0,2889,2020,869,278695,206449,72246,252743156.0,205462489.0,47280667.0,0.9878,0.6546,0.9952,0.6544
2023-08-04 16:50,2814,1428,1386,184991,104425,80566,180422156.0,127713900.0,52708256.0,2603,1322,1281,166926,97970,68956,168463526.0,123212840.0,45250686.0,1.223,0.6542,1.2577,0.6562
2023-08-04 16:55,7782,4841,2941,884421,566803,317618,1235663559.0,1027229681.0,208433877.0,6744,4335,2409,780251,517463,262788,1166493034.0,993236527.0,173256506.0,1.8123,0.6562,1.9194,0.6593
2023-08-04 17:00,3934,2413,1521,368801,250687,118114,574556417.0,495986246.0,78570171.0,3479,2183,1296,344309,233332,110977,557637459.0,484663862.0,72973597.0,1.9785,0.6652,2.0771,0.6576
2023-08-04 17:05,2714,1512,1202,228307,99212,129095,302237150.0,218434546.0,83802604.0,2353,1301,1052,207830,87938,119892,289206445.0,211010590.0,78195854.0,2.2017,0.6492,2.3995,0.6522
2023-08-04 17:10,2803,1502,1301,194058,86093,107965,196446706.0,126576275.0,69870430.0,2434,1254,1180,174298,73280,101018,183958685.0,118465807.0,65492878.0,1.4702,0.6472,1.6166,0.6483
2023-08-04 17:15,2567,1728,839,184173,137361,46812,190390420.0,159774512.0,30615907.0,1675,1240,435,171436,132916,38520,182367605.0,156811479.0,25556126.0,1.1632,0.654,1.1798,0.6635
2023-08-04 17:20,2193,584,1609,309836,43551,266285,271006251.0,99243992.0,171762258.0,2022,478,1544,299273,39812,259461,264368104.0,96735664.0,167632440.0,2.2788,0.645,2.4298,0.6461
2023-08-04 17:25,2192,915,1277,240918,72328,168590,237500022.0,129473321.0,108026700.0,1961,777,1184,223175,61829,161346,226166002.0,122547338.0,103618664.0,1.7901,0.6408,1.982,0.6422
2023-08-04 17:30,2118,1471,647,232899,183474,49425,197462975.0,165540761.0,31922214.0,1927,1368,559,216602,173540,43062,186533867.0,158728320.0,27805547.0,0.9023,0.6459,0.9146,0.6457
2023-08-04 17:35,1354,792,562,117035,70975,46060,113243602.0,81513838.0,31729764.0,1225,728,497,107768,66483,41285,106903413.0,78330064.0,28573349.0,1.1485,0.6889,1.1782,0.6921
2023-08-04 17:40,3226,2236,990,355118,293091,62027,299680842.0,259721572.0,39959270.0,3123,2181,942,344833,287460,57373,293025333.0,255912099.0,37113234.0,0.8861,0.6442,0.8903,0.6469
2023-08-04 17:45,4458,1236,3222,468843,67614,401229,362568863.0,102999630.0,259569232.0,4339,1159,3180,459857,63634,396223,356900827.0,100310317.0,256590510.0,1.5233,0.6469,1.5764,0.6476
2023-08-04 17:50,1633,768,865,140808,74244,66564,114927049.0,71796275.0,43130774.0,1543,726,817,136195,71871,64324,111839737.0,70142979.0,41696757.0,0.967,0.648,0.976,0.6482
2023-08-04 17:55,1654,986,668,92510,63493,29017,83862270.0,64984512.0,18877757.0,1529,929,600,84820,59337,25483,78745963.0,62123975.0,16621987.0,1.0235,0.6506,1.047,0.6523
2023-08-04 18:00,1872,1038,834,98427,59182,39245,111748884.0,86158620.0,25590264.0,1751,975,776,91449,54582,36867,106999867.0,82865064.0,24134802.0,1.4558,0.6521,1.5182,0.6546
2023-08-04 18:05,2104,983,1121,93691,35348,58343,84792370.0,46754380.0,38037990.0,1993,921,1072,89996,32987,57009,82400276.0,45161442.0,37238833.0,1.3227,0.652,1.3691,0.6532
2023-08-04 18:10,3787,2831,956,414565,380075,34490,483391255.0,460836397.0,22554857.0,3654,2761,893,406782,375977,30805,478265341.0,458080326.0,20185015.0,1.2125,0.654,1.2184,0.6553
2023-08-04 18:15,1720,680,1040,136371,21783,114588,148073152.0,73506693.0,74566458.0,1620,604,1016,131754,21188,110566,145286773.0,73084555.0,72202218.0,3.3745,0.6507,3.4493,0.653
2023-08-04 18:20,3617,1403,2214,275119,38271,236848,226363838.0,72267545.0,154096292.0,3521,1356,2165,271033,36941,234092,223824561.0,71385162.0,152439399.0,1.8883,0.6506,1.9324,0.6512
2023-08-04 18:25,2515,1058,1457,219129,62366,156763,426420903.0,325006748.0,101414154.0,2407,992,1415,214754,61753,153001,423829968.0,324589123.0,99240845.0,5.2113,0.6469,5.2562,0.6486
2023-08-04 18:30,2021,989,1032,171174,59853,111321,193618154.0,121704220.0,71913934.0,1908,925,983,165393,55599,109794,189933268.0,118755707.0,71177560.0,2.0334,0.646,2.1359,0.6483
2023-08-04 18:35,2774,836,1938,305788,46503,259285,278842153.0,112685012.0,166157141.0,2615,708,1907,295923,38394,257529,273122711.0,107531554.0,165591157.0,2.4232,0.6408,2.8007,0.643
2023-08-07 10:00,8724,6653,2071,1219714,1047618,172096,961312116.0,849207962.0,112104153.0,7842,6211,1631,1169632,1022397,147235,921672277.0,825645511.0,96026766.0,0.8106,0.6514,0.8076,0.6522
2023-08-07 10:05,5543,4054,1489,730582,623664,106918,588776136.0,519100216.0,69675919.0,5122,3882,1240,703088,612447,90641,565996487.0,506774065.0,59222421.0,0.8323,0.6517,0.8275,0.6534
2023-08-07 10:10,4899,3192,1707,655673,529462,126211,518075085.0,435935540.0,82139544.0,4680,3092,1588,640122,525002,115120,507794348.0,433013013.0,74781334.0,0.8234,0.6508,0.8248,0.6496
2023-08-07 10:15,4583,2714,1869,576847,445709,131138,395991835.0,310887624.0,85104211.0,4451,2648,1803,568249,441045,127204,390393809.0,307828189.0,82565619.0,0.6975,0.649,0.698,0.6491
2023-08-07 10:20,4805,3976,829,738741,666287,72454,512473226.0,465584291.0,46888934.0,4718,3935,783,729511,663555,65956,506769613.0,463991647.0,42777966.0,0.6988,0.6472,0.6993,0.6486
2023-08-07 10:25,656,198,458,38956,13285,25671,25265988.0,8579586.0,16686402.0,581,151,430,34822,11868,22954,22516980.0,7650281.0,14866698.0,0.6458,0.65,0.6446,0.6477
2023-08-07 10:30,654,309,345,55353,24688,30665,47732652.0,27839970.0,19892681.0,578,263,315,50506,21288,29218,44585582.0,25605350.0,18980232.0,1.1277,0.6487,1.2028,0.6496
2023-08-07 10:35,4551,1510,3041,589680,171392,418288,416388345.0,145961197.0,270427148.0,4403,1438,2965,583784,168680,415104,412783213.0,144298565.0,268484648.0,0.8516,0.6465,0.8555,0.6468
2023-08-07 10:40,6051,1279,4772,948023,75141,872882,623965588.0,60166758.0,563798829.0,5927,1211,4716,945459,72608,872851,622287159.0,58461210.0,563825948.0,0.8007,0.6459,0.8052,0.646
2023-08-07 10:45,5408,1770,3638,777307,142192,635115,513627826.0,103189860.0,410437966.0,5336,1715,3621,774805,141778,633027,512055877.0,102921171.0,409134706.0,0.7257,0.6462,0.7259,0.6463
2023-08-07 10:50,9110,3083,6027,1536154,349816,1186338,1708844727.0,947224973.0,761619753.0,8761,2853,5908,1507137,335314,1171823,1690977909.0,937983038.0,752994871.0,2.7078,0.642,2.7973,0.6426
2023-08-07 10:55,4579,1385,3194,588208,62148,526060,387062191.0,51336514.0,335725677.0,4315,1171,3144,579628,57204,522424,381668344.0,48146181.0,333522163.0,0.826,0.6382,0.8417,0.6384
2023-08-07 11:00,14332,10283,4049,2142136,1709196,432940,2236376916.0,1951867273.0,284509643.0,12321,9273,3048,1983876,1624702,359174,2130460294.0,1893962420.0,236497874.0,1.142,0.6572,1.1657,0.6584
2023-08-07 11:05,10544,7827,2717,2037587,1762755,274832,1546745102.0,1365517861.0,181227240.0,9796,7497,2299,1981049,1734935,246114,1509187598.0,1346429045.0,162758552.0,0.7746,0.6594,0.7761,0.6613
2023-08-07 11:10,9045,5007,4038,1751814,889039,862775,1251112987.0,680936106.0,570176881.0,8705,4826,3879,1726094,875673,850421,1233769531.0,671840276.0,561929255.0,0.7659,0.6609,0.7672,0.6608
2023-08-07 11:15,6880,3601,3279,1064053,373208,690845,773089042.0,317096246.0,455992795.0,6633,3467,3166,1045999,364662,681337,761531167.0,311373121.0,450158046.0,0.8497,0.6601,0.8539,0.6607
2023-08-07 11:20,3473,2569,904,690177,553958,136219,537626816.0,447873393.0,89753422.0,3362,2519,843,675841,550752,125089,528357719.0,445723082.0,82634637.0,0.8085,0.6589,0.8093,0.6606
2023-08-07 11:25,2439,460,1979,426220,21474,404746,292615980.0,26024458.0,266591522.0,2334,406,1928,421438,21860,399578,289564699.0,26167746.0,263396953.0,1.2119,0.6587,1.1971,0.6592
2023-08-07 11:30,2031,1154,877,292824,212780,80044,192637015.0,139888902.0,52748112.0,1802,1048,754,288636,211118,77518,189841402.0,138724224.0,51117178.0,0.6574,0.659,0.6571,0.6594
2023-08-07 11:35,1975,1426,549,293318,229477,63841,192797790.0,150607049.0,42190741.0,1893,1384,509,289933,228272,61661,190564393.0,149803440.0,40760953.0,0.6563,0.6609,0.6562,0.661
2023-08-07 11:40,1346,971,375,176046,130188,45858,115983655.0,85749219.0,30234436.0,1260,924,336,171605,128658,42947,112964742.0,84562729.0,28402013.0,0.6587,0.6593,0.6573,0.6613
2023-08-07 11:45,1706,534,1172,204224,58278,145946,181244264.0,85595185.0,95649079.0,1545,451,1094,190928,53875,137053,172927745.0,82709288.0,90218457.0,1.4687,0.6554,1.5352,0.6583
2023-08-07 11:50,4054,3003,1051,730498,649658,80840,588183659.0,534956371.0,53227288.0,3655,2724,931,703581,628647,74934,569910805.0,520595572.0,49315233.0,0.8234,0.6584,0.8281,0.6581
2023-08-07 11:55,9713,7504,2209,1758160,1602854,155306,1383359727.0,1280178446.0,103181281.0,8768,7060,1708,1682152,1558307,123845,1332098497.0,1249398615.0,82699882.0,0.7987,0.6644,0.8018,0.6678
2023-08-07 12:00,3111,1396,1715,357879,176099,181780,286546952.0,164991619.0,121555333.0,2805,1263,1542,341247,166043,175204,275599395.0,158157446.0,117441949.0,0.9369,0.6687,0.9525,0.6703
2023-08-07 12:05,5060,1650,3410,803272,257249,546023,633419219.0,267384961.0,366034257.0,4664,1463,3201,770092,245470,524622,611761623.0,259202790.0,352558833.0,1.0394,0.6704,1.0559,0.672
2023-08-07 12:10,5506,1665,3841,766154,91692,674462,536143917.0,84830201.0,451313716.0,5281,1549,3732,753092,87528,665564,527553737.0,81971143.0,445582593.0,0.9252,0.6691,0.9365,0.6695
2023-08-07 12:15,6339,2986,3353,974261,516717,457544,724867667.0,418141034.0,306726632.0,6049,2858,3191,954612,503218,451394,711535856.0,408658894.0,302876961.0,0.8092,0.6704,0.8121,0.671
2023-08-07 12:20,4902,3489,1413,817110,574890,242220,607224769.0,444935500.0,162289269.0,4624,3350,1274,802369,564756,237613,597890367.0,437997212.0,159893154.0,0.7739,0.67,0.7756,0.6729
2023-08-07 12:25,10352,2180,8172,1683352,100098,1583254,1162709489.0,102486233.0,1060223255.0,10157,2092,8065,1673178,97580,1575598,1156314064.0,100772635.0,1055541428.0,1.0239,0.6696,1.0327,0.6699
2023-08-07 12:30,16972,1896,15076,2872427,44626,2827801,1976069159.0,88777886.0,1887291272.0,16780,1783,14997,2864183,40049,2824134,1970976579.0,85783387.0,1885193191.0,1.9894,0.6674,2.142,0.6675
2023-08-07 12:35,7959,1686,6273,1187793,41732,1146061,814727187.0,50779833.0,763947353.0,7838,1624,6214,1184037,39764,1144273,812782065.0,49936321.0,762845743.0,1.2168,0.6666,1.2558,0.6667
2023-08-07 12:40,7458,624,6834,1285090,17374,1267716,877026124.0,35198094.0,841828029.0,7175,446,6729,1273313,11400,1261913,869601757.0,31242479.0,838359278.0,2.0259,0.6641,2.7406,0.6644
2023-08-07 12:45,5347,885,4462,752261,33916,718345,534450676.0,57928262.0,476522414.0,5220,828,4392,740783,29478,711305,527068115.0,55027674.0,472040441.0,1.708,0.6634,1.8667,0.6636
2023-08-07 12:50,2507,701,1806,334938,37729,297209,221348027.0,24822514.0,196525513.0,2348,603,1745,328361,33158,295203,217035126.0,21696894.0,195338232.0,0.6579,0.6612,0.6543,0.6617
2023-08-07 12:55,10303,4641,5662,1435045,430643,1004402,1150155471.0,485900490.0,664254981.0,10106,4513,5593,1419375,420456,998919,1139799342.0,478951463.0,660847879.0,1.1283,0.6613,1.1391,0.6616
2023-08-07 13:00,3823,950,2873,546399,76643,469756,361387872.0,50548421.0,310839451.0,3719,899,2820,539726,75818,463908,357064888.0,49922825.0,307142062.0,0.6595,0.6617,0.6585,0.6621
2023-08-07 13:05,5801,1907,3894,884344,168293,716051,654666016.0,181994150.0,472671865.0,5683,1849,3834,877713,165166,712547,650830425.0,180006110.0,470824314.0,1.0814,0.6601,1.0898,0.6608
2023-08-07 13:10,6061,957,5104,1274653,29727,1244926,864078707.0,43260971.0,820817736.0,5922,869,5053,1271566,27663,1243903,862087361.0,41886323.0,820201038.0,1.4553,0.6593,1.5142,0.6594
2023-08-07 13:15,3048,842,2206,443639,52684,390955,304165734.0,46467843.0,257697891.0,2950,780,2170,441401,51014,390387,302717496.0,45320847.0,257396648.0,0.882,0.6591,0.8884,0.6593
2023-08-07 13:20,3788,727,3061,515095,63826,451269,339865446.0,41952444.0,297913002.0,3731,697,3034,512644,62871,449773,338254129.0,41305867.0,296948262.0,0.6573,0.6602,0.657,0.6602
2023-08-07 13:25,2226,688,1538,261079,132125,128954,183992718.0,98758934.0,85233784.0,2151,642,1509,256879,129665,127214,181194759.0,97069753.0,84125006.0,0.7475,0.661,0.7486,0.6613
2023-08-07 13:30,1487,631,856,179562,91304,88258,118670980.0,60197886.0,58473093.0,1396,591,805,170016,89252,80764,112205739.0,58776668.0,53429070.0,0.6593,0.6625,0.6585,0.6615
2023-08-07 13:35,2253,1688,565,349234,325786,23448,229650153.0,214232094.0,15418059.0,2195,1660,535,350296,323683,26613,230692024.0,212821920.0,17870103.0,0.6576,0.6575,0.6575,0.6715
2023-08-07 13:40,2506,1578,928,340322,288950,51372,236425054.0,202468456.0,33956598.0,2436,1549,887,337022,286894,50128,234170878.0,201020454.0,33150423.0,0.7007,0.661,0.7007,0.6613
2023-08-07 13:45,481,333,148,44617,34778,9839,29401616.0,22936193.0,6465423.0,425,298,127,41617,33523,8094,27463078.0,22094574.0,5368504.0,0.6595,0.6571,0.6591,0.6633
2023-08-07 13:50,1688,431,1257,244418,50464,193954,172823154.0,45065096.0,127758058.0,1620,406,1214,237550,49220,188330,168544922.0,44249561.0,124295361.0,0.893,0.6587,0.899,0.66
2023-08-07 13:55,6822,1659,5163,1238868,209534,1029334,828624874.0,149804798.0,678820076.0,6743,1617,5126,1234609,206100,1028509,825727822.0,147447317.0,678280504.0,0.7149,0.6595,0.7154,0.6595
2023-08-07 14:00,4167,2563,1604,654368,449070,205298,442706145.0,307365890.0,135340255.0,4094,2531,1563,651429,447027,204402,440911723.0,306001466.0,134910256.0,0.6844,0.6592,0.6845,0.66
2023-08-07 14:05,3969,580,3389,606121,26481,579640,411821493.0,29298573.0,382522920.0,3955,579,3376,605681,26265,579416,411535999.0,29148166.0,382387833.0,1.1064,0.6599,1.1098,0.66
2023-08-07 14:10,2936,451,2485,379646,14921,364725,262341357.0,21694035.0,240647321.0,2893,431,2462,378057,14481,363576,261302791.0,21398676.0,239904114.0,1.4539,0.6598,1.4777,0.6598
2023-08-07 14:15,4152,565,3587,535554,11304,524250,353111462.0,7428255.0,345683207.0,4114,545,3569,536167,11232,524935,353536662.0,7373286.0,346163376.0,0.6571,0.6594,0.6565,0.6594
2023-08-07 14:20,2552,216,2336,391450,4667,386783,258144824.0,3081286.0,255063538.0,2522,204,2318,391878,4382,387496,258457892.0,2874590.0,255583302.0,0.6602,0.6594,0.656,0.6596
2023-08-07 14:25,1576,151,1425,253100,5374,247726,166940505.0,3540000.0,163400505.0,1556,138,1418,254185,6030,248155,167660377.0,3956640.0,163703736.0,0.6587,0.6596,0.6562,0.6597
2023-08-07 14:30,1657,291,1366,243565,27795,215770,184353385.0,42009483.0,142343901.0,1624,276,1348,241362,27041,214321,182896121.0,41494686.0,141401435.0,1.5114,0.6597,1.5345,0.6598
2023-08-07 14:35,4375,458,3917,906282,22341,883941,620785668.0,38409991.0,582375676.0,4300,418,3882,900964,19920,881044,617493183.0,36823485.0,580669697.0,1.7193,0.6588,1.8486,0.6591
2023-08-07 14:40,6768,2158,4610,998356,191072,807284,809020649.0,279107327.0,529913322.0,6534,2004,4530,986042,184497,801545,801054071.0,274620543.0,526433528.0,1.4607,0.6564,1.4885,0.6568
2023-08-07 14:45,3895,1873,2022,584532,395663,188869,381795951.0,257975241.0,123820710.0,3846,1851,1995,584854,395282,189572,382026548.0,257697052.0,124329496.0,0.652,0.6556,0.6519,0.6558
2023-08-07 14:50,8191,6306,1885,1528797,1418120,110677,1135527285.0,1062636578.0,72890706.0,7624,5864,1760,1509020,1403576,105444,1122219609.0,1052770595.0,69449014.0,0.7493,0.6586,0.7501,0.6586
2023-08-07 14:55,4059,3504,555,587359,538482,48877,486572232.0,454090224.0,32482008.0,3024,2669,355,555492,522913,32579,465216767.0,443416758.0,21800009.0,0.8433,0.6646,0.848,0.6691
2023-08-07 15:00,3644,1993,1651,461910,175047,286863,331795757.0,140377628.0,191418129.0,3238,1674,1564,451345,168782,282563,324795796.0,136104608.0,188691188.0,0.8019,0.6673,0.8064,0.6678
2023-08-07 15:05,8267,5954,2313,1485824,1181585,304239,1098733679.0,895740428.0,202993251.0,7884,5705,2179,1468497,1171701,296796,1087392833.0,888886844.0,198505988.0,0.7581,0.6672,0.7586,0.6688
2023-08-07 15:10,9281,7655,1626,1980532,1834253,146279,1603816401.0,1505181162.0,98635238.0,8563,7275,1288,1933541,1807949,125592,1572150811.0,1486939547.0,85211264.0,0.8206,0.6743,0.8224,0.6785
2023-08-07 15:15,8841,3617,5224,1839033,439944,1399089,1483389386.0,544241729.0,939147657.0,8144,3223,4921,1800190,421760,1378430,1458534918.0,531784000.0,926750918.0,1.2371,0.6713,1.2609,0.6723
2023-08-07 15:20,5267,2581,2686,871878,282982,588896,618011216.0,224153848.0,393857368.0,5029,2432,2597,860208,278967,581241,610218380.0,221251110.0,388967270.0,0.7921,0.6688,0.7931,0.6692
2023-08-07 15:25,5011,2715,2296,857179,428253,428926,596100077.0,308896664.0,287203413.0,4817,2586,2231,848175,422211,425964,590336662.0,304951820.0,285384841.0,0.7213,0.6696,0.7223,0.67
2023-08-07 15:30,5922,4569,1353,1055108,881637,173471,764204931.0,648162418.0,116042513.0,5618,4379,1239,1034864,871018,163846,750929217.0,640780669.0,110148548.0,0.7352,0.6689,0.7357,0.6723
2023-08-07 15:35,7770,2181,5589,1605334,86632,1518702,1169477803.0,152678490.0,1016799313.0,7533,2008,5525,1599001,83909,1515092,1165437811.0,150827002.0,1014610808.0,1.7624,0.6695,1.7975,0.6697
2023-08-07 15:40,5016,1381,3635,1086407,66356,1020051,761166797.0,79715860.0,681450937.0,4856,1284,3572,1081725,64768,1016957,758081159.0,78640339.0,679440820.0,1.2013,0.6681,1.2142,0.6681
2023-08-07 15:45,2875,840,2035,522779,64800,457979,361158322.0,55019551.0,306138771.0,2668,683,1985,517828,61469,456359,357813442.0,52736648.0,305076794.0,0.8491,0.6685,0.8579,0.6685
2023-08-07 15:50,3159,1906,1253,379264,339515,39749,264984263.0,238373461.0,26610802.0,3016,1816,1200,374038,335987,38051,261419759.0,235902054.0,25517704.0,0.7021,0.6695,0.7021,0.6706
2023-08-07 15:55,2153,1360,793,205720,193571,12149,137233943.0,129093803.0,8140140.0,2070,1304,766,203654,192799,10855,135870406.0,128584280.0,7286126.0,0.6669,0.67,0.6669,0.6712
2023-08-07 16:00,412,279,133,46862,34799,12063,43076469.0,35020060.0,8056408.0,332,217,115,43131,32472,10659,40618317.0,33476729.0,7141588.0,1.0064,0.6679,1.0309,0.67
2023-08-07 16:05,451,239,212,38558,24313,14245,49544027.0,39950870.0,9593157.0,373,193,180,36529,22827,13702,48190087.0,38942670.0,9247417.0,1.6432,0.6734,1.706,0.6749
2023-08-07 16:10,2642,1608,1034,257071,193407,63664,171530577.0,128866024.0,42664553.0,2590,1579,1011,255140,193217,61923,170174539.0,128699974.0,41474564.0,0.6663,0.6702,0.6661,0.6698
2023-08-07 16:15,7118,2883,4235,1036159,221453,814706,785446614.0,242208239.0,543238374.0,7002,2808,4194,1030198,219656,810542,781924177.0,240994657.0,540929519.0,1.0937,0.6668,1.0971,0.6674
2023-08-07 16:20,4550,646,3904,978624,43130,935494,675496507.0,52346678.0,623149829.0,4454,575,3879,974486,41201,933285,672979380.0,51067722.0,621911657.0,1.2137,0.6661,1.2395,0.6664
2023-08-07 16:25,6334,2517,3817,1080604,296248,784356,731792069.0,208767072.0,523024996.0,6210,2451,3759,1073980,291739,782241,727296355.0,205622641.0,521673713.0,0.7047,0.6668,0.7048,0.6669
2023-08-07 16:30,7978,4090,3888,1062123,555067,507056,730994677.0,392557204.0,338437472.0,7882,4029,3853,1057580,551930,505650,728062951.0,390472990.0,337589960.0,0.7072,0.6675,0.7075,0.6676
2023-08-07 16:35,2608,1574,1034,418458,315591,102867,290549710.0,221696458.0,68853252.0,2560,1548,1012,413313,313422,99891,287087190.0,220252980.0,66834210.0,0.7025,0.6693,0.7027,0.6691
2023-08-07 16:40,3282,2875,407,650912,624231,26681,433244898.0,415394169.0,17850729.0,3218,2831,387,648805,622283,26522,431794356.0,414045531.0,17748824.0,0.6654,0.669,0.6654,0.6692
2023-08-07 16:45,3022,2051,971,602033,544120,57913,401078578.0,362362674.0,38715904.0,2966,2021,945,600031,543839,56192,399763187.0,362176012.0,37587175.0,0.666,0.6685,0.666,0.6689
2023-08-07 16:50,3161,2126,1035,584148,524974,59174,389652157.0,350066868.0,39585289.0,3096,2092,1004,579682,523251,56431,386571009.0,348814001.0,37757008.0,0.6668,0.669,0.6666,0.6691
2023-08-07 16:55,540,450,90,66015,56472,9543,43947951.0,37601624.0,6346326.0,472,414,58,62766,55051,7715,41814886.0,36648175.0,5166711.0,0.6658,0.665,0.6657,0.6697
2023-08-07 17:00,2066,1080,986,305820,103132,202688,227491825.0,92379717.0,135112107.0,2004,1046,958,302408,102140,200268,225404236.0,91717545.0,133686690.0,0.8957,0.6666,0.898,0.6675
2023-08-07 17:05,1318,260,1058,268765,18667,250098,179208791.0,12428261.0,166780530.0,1274,234,1040,268827,17650,251177,179313550.0,11706153.0,167607396.0,0.6658,0.6669,0.6632,0.6673
2023-08-07 17:10,2014,374,1640,366776,21524,345252,244479611.0,14276250.0,230203361.0,1949,335,1614,365549,20544,345005,243719190.0,13626023.0,230093167.0,0.6633,0.6668,0.6633,0.6669
2023-08-07 17:15,3228,703,2525,727033,40755,686278,484717858.0,27070079.0,457647778.0,3162,659,2503,723665,37953,685712,482511594.0,25203971.0,457307623.0,0.6642,0.6669,0.6641,0.6669
2023-08-07 17:20,3801,1000,2801,722199,68648,653551,492864716.0,57478940.0,435385775.0,3740,966,2774,715200,66369,648831,488338127.0,55932920.0,432405206.0,0.8373,0.6662,0.8428,0.6664
2023-08-07 17:25,7201,908,6293,1758775,38671,1720104,1181646261.0,37429574.0,1144216687.0,7077,835,6242,1757842,38059,1719783,1181171867.0,37014858.0,1144157009.0,0.9679,0.6652,0.9726,0.6653
2023-08-07 17:30,4947,651,4296,1177219,35689,1141530,795552837.0,35492124.0,760060712.0,4840,585,4255,1174047,33216,1140831,793433859.0,33832661.0,759601198.0,0.9945,0.6658,1.0186,0.6658
2023-08-07 17:35,1149,528,621,136927,57352,79575,102928987.0,49863441.0,53065545.0,1079,491,588,133899,56289,77610,100891782.0,49142367.0,51749414.0,0.8694,0.6669,0.873,0.6668
2023-08-07 17:40,2430,696,1734,334944,88582,246362,269834473.0,106103269.0,163731204.0,2370,654,1716,330516,86458,244058,267085802.0,104713486.0,162372316.0,1.1978,0.6646,1.2111,0.6653
2023-08-07 17:45,3900,1054,2846,726570,83808,642762,495383729.0,67380014.0,428003715.0,3818,1006,2812,721564,79833,641731,492041281.0,64721989.0,427319292.0,0.804,0.6659,0.8107,0.6659
2023-08-07 17:50,4504,1009,3495,817482,78305,739177,544200586.0,51823264.0,492377322.0,4450,969,3481,816765,78724,738041,543743126.0,52086437.0,491656689.0,0.6618,0.6661,0.6616,0.6662
2023-08-07 17:55,3110,1050,2060,409512,99882,309630,308035015.0,101880882.0,206154132.0,3020,989,2031,404911,96165,308746,304888288.0,99325701.0,205562586.0,1.02,0.6658,1.0329,0.6658
2023-08-07 18:00,2464,1513,951,278174,231269,46905,184435317.0,153210317.0,31224999.0,2418,1485,933,276591,231102,45489,183343555.0,153048040.0,30295515.0,0.6625,0.6657,0.6623,0.666
2023-08-07 18:05,2731,846,1885,272788,79776,193012,192879553.0,64702367.0,128177186.0,2690,816,1874,271376,79564,191812,192068052.0,64561691.0,127506360.0,0.8111,0.6641,0.8114,0.6647
2023-08-07 18:10,883,279,604,88617,20668,67949,82318774.0,37447503.0,44871270.0,827,245,582,87796,20437,67359,82054991.0,37276211.0,44778779.0,1.8119,0.6604,1.824,0.6648
2023-08-07 18:15,5885,1333,4552,892137,78047,814090,615604390.0,75343508.0,540260881.0,5783,1266,4517,882389,74752,807637,609862003.0,73143933.0,536718069.0,0.9654,0.6636,0.9785,0.6646
2023-08-07 18:20,3070,366,2704,541016,20291,520725,358914463.0,13500735.0,345413727.0,2961,301,2660,529120,14749,514371,351078761.0,9722092.0,341356668.0,0.6654,0.6633,0.6592,0.6636
2023-08-07 18:25,1826,328,1498,260091,10009,250082,172078840.0,6628931.0,165449909.0,1762,291,1471,255551,7585,247966,169176931.0,5006207.0,164170723.0,0.6623,0.6616,0.66,0.6621
2023-08-07 18:30,1631,231,1400,246884,12275,234609,163557746.0,8166927.0,155390819.0,1558,190,1368,241580,9488,232092,160046516.0,6253375.0,153793140.0,0.6653,0.6623,0.6591,0.6626
2023-08-07 18:35,4434,2652,1782,737030,500141,236889,547471787.0,390591993.0,156879793.0,4297,2608,1689,723067,492112,230955,538185662.0,384932275.0,153253386.0,0.781,0.6623,0.7822,0.6636
2023-08-08 10:00,6743,2289,4454,736394,214258,522136,550295650.0,202234329.0,348061321.0,5635,1621,4014,688813,195224,493589,511560380.0,181941200.0,329619180.0,0.9439,0.6666,0.932,0.6678
2023-08-08 10:05,6170,2173,3997,830195,280453,549742,692560465.0,327448761.0,365111704.0,5745,1965,3780,808533,269034,539499,673848518.0,315175813.0,358672705.0,1.1676,0.6642,1.1715,0.6648
2023-08-08 10:10,2476,1151,1325,215034,79289,135745,236241305.0,146794955.0,89446349.0,2063,917,1146,200816,72924,127892,227202868.0,142498861.0,84704007.0,1.8514,0.6589,1.9541,0.6623
2023-08-08 10:15,4167,1309,2858,424275,85002,339273,384327876.0,162265326.0,222062550.0,3752,1010,2742,408653,76490,332163,374580878.0,156693738.0,217887140.0,1.909,0.6545,2.0486,0.656
2023-08-08 10:20,3751,1204,2547,344474,86407,258067,273064058.0,103725641.0,169338417.0,3527,1073,2454,337519,84064,253455,268543990.0,102202018.0,166341972.0,1.2004,0.6562,1.2158,0.6563
2023-08-08 10:25,10331,8775,1556,1778715,1700287,78428,1559440207.0,1507181082.0,52259125.0,9428,8451,977,1710101,1650703,59398,1511254177.0,1471770083.0,39484094.0,0.8864,0.6663,0.8916,0.6647
2023-08-08 10:30,26316,15727,10589,4234007,2508077,1725930,4765130856.0,3560301524.0,1204829332.0,22494,14204,8290,3930725,2358218,1572507,4553380898.0,3451955822.0,1101425075.0,1.4195,0.6981,1.4638,0.7004
2023-08-08 10:35,25090,15477,9613,4273511,2806194,1467317,4496747423.0,3403876140.0,1092871283.0,21150,13627,7523,3899041,2621473,1277568,4225358904.0,3268723912.0,956634992.0,1.213,0.7448,1.2469,0.7488
2023-08-08 10:40,20887,11109,9778,3232463,1388215,1844248,3957611379.0,1726375939.0,2231235440.0,17794,9510,8284,2934978,1253505,1681473,3766547141.0,1641887847.0,2124659293.0,1.2436,1.2098,1.3098,1.2636
2023-08-08 10:45,23805,17129,6676,4275940,3372556,903384,3888945338.0,2391657628.0,1497287710.0,20873,15683,5190,4025385,3239373,786012,3709614160.0,2293455117.0,1416159043.0,0.7092,1.6574,0.708,1.8017
2023-08-08 10:50,11358,5443,5915,1989959,890424,1099535,1767988884.0,636176477.0,1131812407.0,9838,4803,5035,1849933,824332,1025601,1669481208.0,587860879.0,1081620328.0,0.7145,1.0294,0.7131,1.0546
2023-08-08 10:55,23072,12513,10559,3758828,1946503,1812325,3871494818.0,1415535199.0,2455959618.0,18400,10475,7925,3343407,1735642,1607765,3572475614.0,1257900621.0,2314574992.0,0.7272,1.3551,0.7247,1.4396
2023-08-08 11:00,16018,8257,7761,2566095,1161475,1404620,2221971896.0,838352656.0,1383619240.0,14015,7259,6756,2408693,1085826,1322867,2113985605.0,783921058.0,1330064546.0,0.7218,0.985,0.722,1.0054
2023-08-08 11:05,11551,5513,6038,2018402,752026,1266376,1915658853.0,539418863.0,1376239990.0,10268,4950,5318,1913399,706793,1206606,1842660825.0,506189410.0,1336471415.0,0.7173,1.0868,0.7162,1.1076
2023-08-08 11:10,17597,8794,8803,2852332,1170730,1681602,2562744404.0,834437982.0,1728306421.0,16144,8048,8096,2723755,1112479,1611276,2474087238.0,792118618.0,1681968619.0,0.7128,1.0278,0.712,1.0439
2023-08-08 11:15,12616,5952,6664,2007263,849795,1157468,1754959621.0,602243493.0,1152716128.0,11499,5323,6176,1909789,801659,1108130,1688093200.0,566707136.0,1121386064.0,0.7087,0.9959,0.7069,1.012
2023-08-08 11:20,8714,4467,4247,1548631,702182,846449,1296548300.0,498157764.0,798390536.0,7833,4047,3786,1480603,663661,816942,1249316308.0,470583652.0,778732655.0,0.7094,0.9432,0.7091,0.9532
2023-08-08 11:25,14460,4934,9526,2570973,524763,2046210,2298578579.0,371948828.0,1926629750.0,13609,4505,9104,2502187,495799,2006388,2250674207.0,350756758.0,1899917449.0,0.7088,0.9416,0.7075,0.9469
2023-08-08 11:30,7799,4443,3356,1191604,652213,539391,945371421.0,464834764.0,480536656.0,7158,4194,2964,1129017,617089,511928,899734603.0,438619354.0,461115249.0,0.7127,0.8909,0.7108,0.9007
2023-08-08 11:35,4871,2010,2861,618276,197539,420737,503889056.0,140770170.0,363118886.0,4302,1728,2574,569056,180268,388788,460820592.0,128233293.0,332587298.0,0.7126,0.8631,0.7113,0.8554
2023-08-08 11:40,4950,2168,2782,782514,279125,503389,579488277.0,198796534.0,380691743.0,4644,2002,2642,758789,265600,493189,562421925.0,188553223.0,373868702.0,0.7122,0.7563,0.7099,0.7581
2023-08-08 11:45,1869,960,909,252628,94099,158529,180101520.0,67138210.0,112963309.0,1555,800,755,234749,83651,151098,167474838.0,59453598.0,108021240.0,0.7135,0.7126,0.7107,0.7149
2023-08-08 11:50,5301,2746,2555,809228,426457,382771,660089967.0,303002082.0,357087884.0,4724,2401,2323,752620,396719,355901,620910320.0,281288015.0,339622305.0,0.7105,0.9329,0.709,0.9543
2023-08-08 11:55,4280,3387,893,684407,590597,93810,517243648.0,418708654.0,98534994.0,3962,3227,735,654206,574827,79379,496185575.0,407338422.0,88847152.0,0.709,1.0504,0.7086,1.1193
2023-08-08 12:00,2379,1140,1239,321730,115367,206363,260241662.0,81769544.0,178472118.0,2050,916,1134,304386,103055,201331,248356332.0,72936969.0,175419362.0,0.7088,0.8648,0.7077,0.8713
2023-08-08 12:05,7768,5107,2661,1084661,758065,326596,913033629.0,539327172.0,373706457.0,6753,4402,2351,1032892,729317,303575,876160844.0,518102032.0,358058812.0,0.7115,1.1442,0.7104,1.1795
2023-08-08 12:10,6038,4439,1599,1055960,861728,194232,773393185.0,613740991.0,159652194.0,5687,4248,1439,1049022,858069,190953,769327547.0,611044333.0,158283214.0,0.7122,0.822,0.7121,0.8289
2023-08-08 12:15,6366,1064,5302,1304318,55781,1248537,1000616247.0,39443668.0,961172578.0,5882,750,5132,1263528,34222,1229306,974204629.0,24146588.0,950058041.0,0.7071,0.7698,0.7056,0.7728
2023-08-08 12:20,9708,5296,4412,1689399,855924,833475,1240672749.0,606890477.0,633782271.0,8886,4669,4217,1657359,842602,814757,1218629783.0,597161637.0,621468145.0,0.709,0.7604,0.7087,0.7628
2023-08-08 12:25,9565,2851,6714,1849650,361107,1488543,1360369429.0,254943999.0,1105425429.0,8699,2202,6497,1814041,345460,1468581,1336126467.0,243774504.0,1092351962.0,0.706,0.7426,0.7057,0.7438
2023-08-08 12:30,3875,1730,2145,431297,148982,282315,336185579.0,104948518.0,231237060.0,3569,1561,2008,416877,143313,273564,326815840.0,100907627.0,225908213.0,0.7044,0.8191,0.7041,0.8258
2023-08-08 12:35,5962,1884,4078,947808,117461,830347,769939716.0,82616507.0,687323209.0,5179,1398,3781,888527,90226,798301,730568115.0,63081733.0,667486382.0,0.7034,0.8278,0.6992,0.8361
2023-08-08 12:40,5881,2710,3171,858319,333708,524611,738627401.0,233388259.0,505239141.0,5280,2265,3015,827803,314625,513178,717474220.0,219490835.0,497983385.0,0.6994,0.9631,0.6976,0.9704
2023-08-08 12:45,9086,5424,3662,1692991,1181449,511542,1247268681.0,826951831.0,420316849.0,8624,5138,3486,1643078,1158213,484865,1214150448.0,810530392.0,403620056.0,0.6999,0.8217,0.6998,0.8324
2023-08-08 12:50,8141,4489,3652,1167806,638955,528851,916283560.0,444094501.0,472189059.0,7117,3686,3431,1111411,611243,500168,878614385.0,424413912.0,454200472.0,0.695,0.8929,0.6943,0.9081
2023-08-08 12:55,9281,7093,2188,1623770,1396955,226815,1173744855.0,973268328.0,200476527.0,8599,6552,2047,1605946,1382600,223346,1160914531.0,962594379.0,198320152.0,0.6967,0.8839,0.6962,0.888
2023-08-08 13:00,3976,2648,1328,465698,348688,117010,411980418.0,244753564.0,167226853.0,3403,2277,1126,436974,339468,97506,391907254.0,237673330.0,154233924.0,0.7019,1.4292,0.7001,1.5818
2023-08-08 13:05,8905,7725,1180,1692683,1608814,83869,1306376774.0,1129471837.0,176904937.0,8385,7426,959,1661140,1591568,69572,1283449744.0,1116567955.0,166881788.0,0.7021,2.1093,0.7016,2.3987
2023-08-08 13:10,5834,2460,3374,805741,354129,451612,640370498.0,248377663.0,391992834.0,5587,2345,3242,792465,346963,445502,631660676.0,243210847.0,388449829.0,0.7014,0.868,0.701,0.8719
2023-08-08 13:15,3737,1303,2434,529392,165728,363664,382362118.0,116294312.0,266067805.0,3592,1221,2371,519065,161774,357291,375450140.0,113375882.0,262074257.0,0.7017,0.7316,0.7008,0.7335
2023-08-08 13:20,1872,941,931,254685,120385,134300,189432550.0,84374438.0,105058112.0,1771,890,881,245151,114990,130161,182769813.0,80571204.0,102198609.0,0.7009,0.7823,0.7007,0.7852
2023-08-08 13:25,7609,6650,959,1453325,1394816,58509,1074993506.0,980219231.0,94774275.0,7332,6512,820,1427728,1379811,47917,1056396477.0,969079160.0,87317316.0,0.7028,1.6198,0.7023,1.8223
2023-08-08 13:30,6494,4052,2442,1075275,562560,512715,767211367.0,395488034.0,371723332.0,6325,3985,2340,1072432,561760,510672,765477915.0,394855936.0,370621979.0,0.703,0.725,0.7029,0.7258
2023-08-08 13:35,6687,3117,3570,1074635,334323,740312,777277590.0,234777998.0,542499592.0,6549,3059,3490,1067215,331629,735586,772280785.0,232768442.0,539512343.0,0.7022,0.7328,0.7019,0.7334
2023-08-08 13:40,6093,1210,4883,1244908,73678,1171230,979485610.0,51564775.0,927920834.0,5841,1048,4793,1227036,65943,1161093,967694487.0,46063381.0,921631106.0,0.6999,0.7923,0.6985,0.7938
2023-08-08 13:45,8848,6096,2752,1411241,1011206,400035,1169058837.0,713810621.0,455248215.0,7935,5602,2333,1332295,969843,362452,1112442095.0,683469114.0,428972980.0,0.7059,1.138,0.7047,1.1835
2023-08-08 13:50,10447,5553,4894,1664260,818209,846051,1413131907.0,582560855.0,830571051.0,9593,5148,4445,1609387,788841,820546,1374241322.0,560878890.0,813362432.0,0.712,0.9817,0.711,0.9912
2023-08-08 13:55,11487,5482,6005,1945911,790253,1155658,1612253000.0,562746915.0,1049506085.0,10708,5059,5649,1889589,754217,1135372,1573194413.0,536527280.0,1036667132.0,0.7121,0.9081,0.7114,0.9131
2023-08-08 14:00,6896,2172,4724,1097012,171084,925928,878618273.0,121084412.0,757533860.0,6573,1992,4581,1067702,154130,913572,858352427.0,109108297.0,749244130.0,0.7077,0.8181,0.7079,0.8201
2023-08-08 14:05,3166,729,2437,549570,56152,493418,423479078.0,39967442.0,383511636.0,2933,620,2313,533332,46925,486407,412375308.0,33275875.0,379099433.0,0.7118,0.7773,0.7091,0.7794
2023-08-08 14:10,7060,1418,5642,1244618,94795,1149823,904961862.0,67230698.0,837731163.0,6738,1264,5474,1220864,83592,1137272,889616934.0,59139195.0,830477739.0,0.7092,0.7286,0.7075,0.7302
2023-08-08 14:15,5532,2152,3380,938301,290251,648050,729268883.0,205703965.0,523564918.0,5271,2022,3249,917291,285067,632224,715046752.0,201787038.0,513259714.0,0.7087,0.8079,0.7079,0.8118
2023-08-08 14:20,3990,1951,2039,582776,310702,272074,444873595.0,219882616.0,224990978.0,3668,1756,1912,562543,299632,262911,430589392.0,211867182.0,218722209.0,0.7077,0.8269,0.7071,0.8319
2023-08-08 14:25,3081,563,2518,598079,29623,568456,455512467.0,20956980.0,434555486.0,2824,390,2434,587607,24550,563057,448324808.0,17335468.0,430989339.0,0.7075,0.7644,0.7061,0.7654
2023-08-08 14:30,3617,571,3046,626072,39419,586653,442491941.0,27777632.0,414714309.0,3453,433,3020,619354,37534,581820,437906562.0,26425872.0,411480690.0,0.7047,0.7069,0.7041,0.7072
2023-08-08 14:35,2569,1580,989,343118,261763,81355,242425741.0,184825183.0,57600558.0,2429,1510,919,336759,259050,77709,237731955.0,182769951.0,54962003.0,0.7061,0.708,0.7055,0.7073
2023-08-08 14:40,3095,629,2466,577556,75241,502315,418932098.0,53144170.0,365787928.0,2918,570,2348,562965,72176,490789,408810171.0,50904022.0,357906149.0,0.7063,0.7282,0.7053,0.7292
2023-08-08 14:45,3669,577,3092,797162,37278,759884,573229454.0,26311059.0,546918395.0,3523,503,3020,786172,30539,755633,565892667.0,21496995.0,544395672.0,0.7058,0.7197,0.7039,0.7204
2023-08-08 14:50,2949,322,2627,488163,15654,472509,344585502.0,11044573.0,333540928.0,2865,285,2580,487328,17873,469455,344090420.0,12480613.0,331609807.0,0.7055,0.7059,0.6983,0.7064
2023-08-08 14:55,2910,1570,1340,429753,312926,116827,325015559.0,220959475.0,104056083.0,2713,1472,1241,418429,306153,112276,316857972.0,215965365.0,100892606.0,0.7061,0.8907,0.7054,0.8986
2023-08-08 15:00,6199,4733,1466,1307391,1190443,116948,933574808.0,840068760.0,93506048.0,6043,4664,1379,1300974,1189157,111817,929184340.0,839062409.0,90121931.0,0.7057,0.7996,0.7056,0.806
2023-08-08 15:05,4230,3175,1055,1000507,932488,68019,706301878.0,658057021.0,48244857.0,4220,3147,1073,1001942,931283,70659,707398529.0,657187099.0,50211429.0,0.7057,0.7093,0.7057,0.7106
2023-08-08 15:10,6080,912,5168,1358374,76104,1282270,989162681.0,53379721.0,935782960.0,5818,727,5091,1345976,71813,1274163,981151141.0,50334122.0,930817019.0,0.7014,0.7298,0.7009,0.7305
2023-08-08 15:15,4043,650,3393,709886,33835,676051,510848147.0,23856917.0,486991229.0,3834,496,3338,705341,29539,675802,507587618.0,20656654.0,486930964.0,0.7051,0.7203,0.6993,0.7205
2023-08-08 15:20,5088,2072,3016,866915,340718,526197,642460781.0,239840374.0,402620406.0,4956,2003,2953,863593,343315,520278,640459827.0,241618083.0,398841744.0,0.7039,0.7652,0.7038,0.7666
2023-08-08 15:25,6942,3329,3613,1531986,837838,694148,1109267782.0,588704555.0,520563226.0,6794,3236,3558,1528664,834361,694303,1107067546.0,586032207.0,521035338.0,0.7026,0.7499,0.7024,0.7504
2023-08-08 15:30,6315,5917,398,1477623,1451529,26094,1051068814.0,1021809581.0,29259233.0,6160,5867,293,1466968,1447442,19526,1043388793.0,1018784166.0,24604627.0,0.704,1.1213,0.7039,1.2601
2023-08-08 15:35,5313,2504,2809,1012991,528370,484621,734965774.0,372008716.0,362957058.0,5202,2448,2754,1006062,526045,480017,730235209.0,370338949.0,359896259.0,0.7041,0.749,0.704,0.7498
2023-08-08 15:40,3622,1541,2081,536783,174590,362193,399405436.0,122719797.0,276685639.0,3552,1489,2063,537242,169441,367801,399899131.0,119018632.0,280880498.0,0.7029,0.7639,0.7024,0.7637
2023-08-08 15:45,1187,385,802,165906,23905,142001,127287924.0,16818965.0,110468959.0,1131,335,796,161602,21539,140063,124568314.0,15130811.0,109437503.0,0.7036,0.7779,0.7025,0.7813
2023-08-08 15:50,5552,1170,4382,1101826,93129,1008697,816770080.0,65419555.0,751350524.0,5397,1065,4332,1086252,86523,999729,806520049.0,60728745.0,745791304.0,0.7025,0.7449,0.7019,0.746
2023-08-08 15:55,3071,805,2266,411299,68485,342814,321165139.0,48103000.0,273062139.0,2975,751,2224,406036,65748,340288,317494969.0,46125643.0,271369326.0,0.7024,0.7965,0.7016,0.7975
2023-08-08 16:00,1929,680,1249,240766,83732,157034,169084683.0,58907396.0,110177287.0,1833,622,1211,230014,79221,150793,161650278.0,55578191.0,106072087.0,0.7035,0.7016,0.7016,0.7034
2023-08-08 16:05,3559,600,2959,590271,32788,557483,444954275.0,22950612.0,422003663.0,3319,466,2853,565927,23095,542832,429030849.0,16140273.0,412890575.0,0.7,0.757,0.6989,0.7606
2023-08-08 16:10,5611,1222,4389,973879,76976,896903,713365109.0,53758288.0,659606820.0,5441,1113,4328,964596,69689,894907,706885045.0,48576126.0,658308919.0,0.6984,0.7354,0.697,0.7356
2023-08-08 16:15,5079,1185,3894,930572,70961,859611,691868768.0,49440041.0,642428726.0,4894,1078,3816,924744,71336,853408,688576705.0,49636748.0,638939957.0,0.6967,0.7473,0.6958,0.7487
2023-08-08 16:20,4931,2296,2635,682645,210320,472325,555514028.0,145225235.0,410288793.0,4318,1924,2394,634728,181363,453365,523545621.0,125015266.0,398530355.0,0.6905,0.8687,0.6893,0.879
2023-08-08 16:25,5798,2863,2935,856894,335029,521865,638145837.0,232564507.0,405581330.0,5560,2746,2814,850944,335705,515239,633817401.0,232623136.0,401194265.0,0.6942,0.7772,0.6929,0.7787
2023-08-08 16:30,4455,1698,2757,616837,218286,398551,449672814.0,151365304.0,298307510.0,4315,1629,2686,613196,217366,395830,447218895.0,150654957.0,296563938.0,0.6934,0.7485,0.6931,0.7492
2023-08-08 16:35,6192,1771,4421,1043184,147516,895668,807745971.0,101955062.0,705790909.0,6020,1651,4369,1028562,137905,890657,797952893.0,95184416.0,702768477.0,0.6911,0.788,0.6902,0.789
2023-08-08 16:40,3489,451,3038,778351,20791,757560,614333997.0,14313525.0,600020471.0,3381,390,2991,768672,14619,754053,607703107.0,10085838.0,597617269.0,0.6884,0.792,0.6899,0.7925
2023-08-08 16:45,7670,4537,3133,1499470,860246,639224,1132644948.0,593823251.0,538821697.0,7483,4438,3045,1482550,850687,631863,1120694612.0,587015782.0,533678830.0,0.6903,0.8429,0.69,0.8446
2023-08-08 16:50,3858,1649,2209,525517,244516,281001,395715277.0,168882745.0,226832531.0,3789,1614,2175,526081,244958,281123,395995420.0,169049721.0,226945699.0,0.6907,0.8072,0.6901,0.8073
2023-08-08 16:55,2100,1202,898,302418,208362,94056,230469657.0,144069553.0,86400103.0,2039,1157,882,297833,207111,90722,227358334.0,143194120.0,84164214.0,0.6914,0.9186,0.6914,0.9277
2023-08-08 17:00,373,172,201,50339,11501,38838,34901110.0,7946222.0,26954887.0,331,134,197,51448,10077,41371,35831913.0,6915729.0,28916184.0,0.6909,0.694,0.6863,0.6989
2023-08-08 17:05,3201,1579,1622,552452,239066,313386,415535381.0,165887485.0,249647895.0,3040,1492,1548,538175,229017,309158,405440089.0,158649121.0,246790968.0,0.6939,0.7966,0.6927,0.7983
2023-08-08 17:10,2642,1874,768,339844,289188,50656,279299044.0,201667072.0,77631972.0,2368,1786,582,323384,284622,38762,267963030.0,198202595.0,69760435.0,0.6974,1.5325,0.6964,1.7997
2023-08-08 17:15,3186,1734,1452,406354,248189,158165,315353261.0,172788493.0,142564768.0,3089,1681,1408,399519,244263,155256,310536562.0,169941979.0,140594583.0,0.6962,0.9014,0.6957,0.9056
2023-08-08 17:20,7570,5424,2146,1283284,1095524,187760,952583874.0,767215024.0,185368850.0,7373,5338,2035,1269205,1088444,180761,942436516.0,762011380.0,180425135.0,0.7003,0.9873,0.7001,0.9981
2023-08-08 17:25,6636,1444,5192,1412340,149225,1263115,1001892116.0,104260898.0,897631218.0,6539,1404,5135,1408250,147295,1260955,998920857.0,102810398.0,896110459.0,0.6987,0.7106,0.698,0.7107
2023-08-08 17:30,4028,1727,2301,681849,238026,443823,509105381.0,166100466.0,343004915.0,3894,1655,2239,664287,222870,441417,497209459.0,155495556.0,341713903.0,0.6978,0.7728,0.6977,0.7741
2023-08-08 17:35,6707,4426,2281,1239716,895715,344001,878355029.0,626138231.0,252216797.0,6620,4385,2235,1234963,893404,341559,874919797.0,624408264.0,250511532.0,0.699,0.7332,0.6989,0.7334
2023-08-08 17:40,5609,4081,1528,1131000,1004360,126640,790225397.0,701324127.0,88901270.0,5542,4047,1495,1127359,1003300,124059,787706334.0,700540631.0,87165703.0,0.6983,0.702,0.6982,0.7026
2023-08-08 17:45,2730,2135,595,649257,592176,57081,452956612.0,412920271.0,40036340.0,2667,2111,556,648249,592163,56086,452297473.0,412891479.0,39405994.0,0.6973,0.7014,0.6973,0.7026
2023-08-08 17:50,4583,1379,3204,899602,131892,767710,691332642.0,91770006.0,599562635.0,4377,1263,3114,885204,125245,759959,682067092.0,87156811.0,594910280.0,0.6958,0.781,0.6959,0.7828
2023-08-08 17:55,2861,728,2133,513247,35386,477861,380094542.0,24673293.0,355421249.0,2761,657,2104,509376,32596,476780,377369086.0,22686444.0,354682641.0,0.6973,0.7438,0.696,0.7439
2023-08-08 18:00,2165,682,1483,342346,37710,304636,271168330.0,26303016.0,244865314.0,2103,655,1448,339847,36698,303149,269343257.0,25500639.0,243842618.0,0.6975,0.8038,0.6949,0.8044
2023-08-08 18:05,4256,2880,1376,605242,460184,145058,455063817.0,321561697.0,133502120.0,4142,2810,1332,593398,453085,140313,446776178.0,316451062.0,130325115.0,0.6988,0.9203,0.6984,0.9288
2023-08-08 18:10,3423,2084,1339,438726,282432,156294,382087705.0,197619333.0,184468371.0,3236,1991,1245,420408,272269,148139,369006120.0,190196059.0,178810061.0,0.6997,1.1803,0.6986,1.207
2023-08-08 18:15,4830,3603,1227,768613,668642,99971,549364583.0,468450095.0,80914488.0,4732,3561,1171,765600,666508,99092,547103038.0,466783148.0,80319890.0,0.7006,0.8094,0.7003,0.8106
2023-08-08 18:20,6135,5455,680,1319479,1302780,16699,948600000.0,915413567.0,33186433.0,5911,5379,532,1307969,1296912,11057,939873437.0,910649300.0,29224137.0,0.7027,1.9873,0.7022,2.643
2023-08-08 18:25,4894,3970,924,736926,673067,63859,550379031.0,473211539.0,77167492.0,4768,3913,855,727388,668652,58736,543707509.0,470013806.0,73693703.0,0.7031,1.2084,0.7029,1.2547
2023-08-08 18:30,3327,2462,865,561032,436938,124094,405268800.0,307274344.0,97994455.0,3225,2397,828,552843,433491,119352,399710147.0,304739681.0,94970465.0,0.7032,0.7897,0.703,0.7957
2023-08-08 18:35,4882,3767,1115,734960,627056,107904,537988566.0,440559896.0,97428669.0,4776,3717,1059,724394,622244,102150,530917491.0,437352965.0,93564526.0,0.7026,0.9029,0.7029,0.916
2023-08-09 10:00,9302,5878,3424,1058178,710240,347938,1066474051.0,499394986.0,567079065.0,7797,5106,2691,952993,653387,299606,982350536.0,459224091.0,523126444.0,0.7031,1.6298,0.7028,1.746
2023-08-09 10:05,7513,4065,3448,862882,453636,409246,822491707.0,318839349.0,503652357.0,7012,3798,3214,832039,440891,391148,801199069.0,309474750.0,491724318.0,0.7029,1.2307,0.7019,1.2571
2023-08-09 10:10,5491,3316,2175,521818,342362,179456,564775452.0,238246821.0,326528630.0,4911,2960,1951,502816,328390,174426,551541666.0,228165025.0,323376641.0,0.6959,1.8195,0.6948,1.8539
2023-08-09 10:15,9715,3459,6256,1177074,365937,811137,1293930524.0,254313137.0,1039617387.0,9037,3057,5980,1141132,347623,793509,1269012936.0,241491166.0,1027521770.0,0.695,1.2817,0.6947,1.2949
2023-08-09 10:20,5819,2769,3050,702777,382936,319841,530502721.0,265412470.0,265090251.0,5584,2631,2953,689359,376946,312413,521281502.0,261172507.0,260108995.0,0.6931,0.8288,0.6929,0.8326
2023-08-09 10:25,5671,1899,3772,945933,213710,732223,740948115.0,148206361.0,592741754.0,5374,1710,3664,923840,199542,724298,725786894.0,138126120.0,587660774.0,0.6935,0.8095,0.6922,0.8114
2023-08-09 10:30,8534,7030,1504,1258734,1126932,131802,1050630833.0,787443365.0,263187467.0,8084,6771,1313,1244052,1120317,123735,1039769273.0,782144993.0,257624280.0,0.6987,1.9968,0.6981,2.0821
2023-08-09 10:35,6554,4772,1782,1002869,828438,174431,900970469.0,583653477.0,317316991.0,6142,4641,1501,967509,814602,152907,875096431.0,573187287.0,301909144.0,0.7045,1.8192,0.7036,1.9745
2023-08-09 10:40,5749,4050,1699,912270,759747,152523,718981667.0,535570187.0,183411479.0,5446,3941,1505,898021,756898,141123,709031036.0,533354656.0,175676379.0,0.7049,1.2025,0.7047,1.2448
2023-08-09 10:45,8298,6342,1956,1477927,1345461,132466,1085895311.0,948853042.0,137042269.0,7980,6187,1793,1468029,1339874,128155,1078913807.0,944691925.0,134221881.0,0.7052,1.0345,0.7051,1.0473
2023-08-09 10:50,6206,5238,968,1177772,1119989,57783,832638229.0,791623385.0,41014843.0,5976,5141,835,1163593,1114153,49440,822639050.0,787476336.0,35162713.0,0.7068,0.7098,0.7068,0.7112
2023-08-09 10:55,1807,1316,491,221802,170013,51789,156461509.0,119965482.0,36496027.0,1664,1240,424,212468,164648,47820,150132291.0,116136418.0,33995872.0,0.7056,0.7047,0.7054,0.7109
2023-08-09 11:00,3164,2638,526,505861,473532,32329,367792138.0,334096120.0,33696017.0,3059,2592,467,502043,472202,29841,365084655.0,333099075.0,31985580.0,0.7055,1.0423,0.7054,1.0719
2023-08-09 11:05,4374,721,3653,813796,38178,775618,618247024.0,26941612.0,591305412.0,4189,635,3554,802640,34383,768257,610599175.0,24189134.0,586410041.0,0.7057,0.7624,0.7035,0.7633
2023-08-09 11:10,2094,416,1678,357815,16464,341351,262545206.0,11327782.0,251217424.0,1977,366,1611,354259,14119,340140,260449203.0,9891454.0,250557749.0,0.688,0.736,0.7006,0.7366
2023-08-09 11:15,4086,487,3599,764833,14550,750283,560127393.0,10205216.0,549922176.0,3964,412,3552,763055,12551,750504,558928687.0,8799178.0,550129508.0,0.7014,0.733,0.7011,0.733
2023-08-09 11:20,4227,672,3555,657444,17308,640136,472859133.0,12199191.0,460659942.0,3955,557,3398,649871,13761,636110,467701887.0,9612349.0,458089537.0,0.7048,0.7196,0.6985,0.7201
2023-08-09 11:25,4305,2027,2278,691050,323418,367632,539308631.0,227046968.0,312261663.0,4194,1964,2230,670414,307429,362985,524659446.0,215468019.0,309191426.0,0.702,0.8494,0.7009,0.8518
2023-08-09 11:30,2872,392,2480,492188,17360,474828,357423801.0,12214970.0,345208831.0,2766,331,2435,489098,16176,472922,355206992.0,11339261.0,343867731.0,0.7036,0.727,0.701,0.7271
2023-08-09 11:35,1199,484,715,146897,30688,116209,113988763.0,21574791.0,92413971.0,1095,418,677,140503,27373,113130,109604754.0,19199135.0,90405619.0,0.703,0.7952,0.7014,0.7991
2023-08-09 11:40,3152,555,2597,566303,31371,534932,398077249.0,22170043.0,375907206.0,3027,473,2554,556366,26521,529845,391367027.0,18621684.0,372745343.0,0.7067,0.7027,0.7021,0.7035
2023-08-09 11:45,517,308,209,45872,23427,22445,32306168.0,16481058.0,15825110.0,444,268,176,42781,21937,20844,30134460.0,15401181.0,14733279.0,0.7035,0.7051,0.7021,0.7068
2023-08-09 11:50,700,156,544,105250,8270,96980,84883524.0,5864993.0,79018531.0,633,116,517,99602,6256,93346,80933138.0,4387408.0,76545730.0,0.7092,0.8148,0.7013,0.82
2023-08-09 11:55,2807,687,2120,453109,50199,402910,319473571.0,35290784.0,284182786.0,2759,652,2107,452819,50095,402724,319277489.0,35205670.0,284071819.0,0.703,0.7053,0.7028,0.7054
2023-08-09 12:00,2510,1156,1354,413780,165041,248739,302737565.0,116401887.0,186335678.0,2432,1098,1334,407861,159780,248081,298387389.0,112509694.0,185877694.0,0.7053,0.7491,0.7042,0.7493
2023-08-09 12:05,9276,8460,816,2133180,2067658,65522,1525343462.0,1457221184.0,68122278.0,9125,8457,668,2132342,2069251,63091,1524413822.0,1458126782.0,66287039.0,0.7048,1.0397,0.7047,1.0507
2023-08-09 12:10,8707,2341,6366,1527259,226248,1301011,1111325873.0,159450310.0,951875563.0,8445,2199,6246,1517286,220320,1296966,1104756286.0,155280413.0,949475873.0,0.7048,0.7316,0.7048,0.7321
2023-08-09 12:15,6099,1071,5028,1165742,23422,1142320,835173033.0,16507218.0,818665814.0,5958,966,4992,1155118,15129,1139989,827661876.0,10662336.0,816999540.0,0.7048,0.7167,0.7048,0.7167
2023-08-09 12:20,3875,2474,1401,530867,332719,198148,396753039.0,235089173.0,161663866.0,3785,2425,1360,527045,330298,196747,394071477.0,233164872.0,160906605.0,0.7066,0.8159,0.7059,0.8178
2023-08-09 12:25,2675,1609,1066,337674,255704,81970,249184390.0,180467687.0,68716702.0,2597,1563,1034,334524,254882,79642,247000404.0,179870731.0,67129673.0,0.7058,0.8383,0.7057,0.8429
2023-08-09 12:30,3279,320,2959,537770,17728,520042,379641770.0,12502003.0,367139767.0,3199,260,2939,532490,16216,516274,376364023.0,11431888.0,364932135.0,0.7052,0.706,0.705,0.7069
2023-08-09 12:35,4415,425,3990,797252,15023,782229,562908121.0,10628552.0,552279569.0,4347,379,3968,793040,13108,779932,559925166.0,9214330.0,550710836.0,0.7075,0.706,0.703,0.7061
2023-08-09 12:40,3623,515,3108,648910,51450,597460,500286588.0,36337610.0,463948978.0,3519,456,3063,639835,48032,591803,494165567.0,33812366.0,460353201.0,0.7063,0.7765,0.704,0.7779
2023-08-09 12:45,5742,274,5468,1194474,7707,1186767,862454359.0,5389940.0,857064419.0,5660,221,5439,1190910,6076,1184834,859909570.0,4245107.0,855664463.0,0.6994,0.7222,0.6987,0.7222
2023-08-09 12:50,2515,888,1627,411697,95570,316127,311799254.0,67561969.0,244237285.0,2433,846,1587,404056,90713,313343,306028430.0,63766082.0,242262347.0,0.7069,0.7726,0.7029,0.7732
2023-08-09 12:55,2118,658,1460,366477,72765,293712,268642176.0,51145870.0,217496306.0,2058,636,1422,363640,72809,290831,266776204.0,51175785.0,215600419.0,0.7029,0.7405,0.7029,0.7413
2023-08-09 13:00,3040,580,2460,544338,29734,514604,382733076.0,20805779.0,361927296.0,2976,523,2453,542247,29093,513154,381416190.0,20331983.0,361084206.0,0.6997,0.7033,0.6989,0.7037
2023-08-09 13:05,1402,493,909,176485,34017,142468,124233394.0,23951634.0,100281760.0,1309,432,877,173136,32430,140706,121809122.0,22754768.0,99054353.0,0.7041,0.7039,0.7017,0.704
2023-08-09 13:10,1304,807,497,146534,103087,43447,103014215.0,72416811.0,30597404.0,1266,784,482,146152,103091,43061,102712889.0,72386205.0,30326683.0,0.7025,0.7042,0.7022,0.7043
2023-08-09 13:15,1637,1229,408,203223,161843,41380,142780441.0,113590005.0,29190436.0,1593,1201,392,201480,161426,40054,141524151.0,113294006.0,28230145.0,0.7019,0.7054,0.7018,0.7048
2023-08-09 13:20,2744,384,2360,575567,24031,551536,426050043.0,16972403.0,409077639.0,2670,344,2326,565665,20114,545551,419204373.0,14081821.0,405122551.0,0.7063,0.7417,0.7001,0.7426
2023-08-09 13:25,6664,2291,4373,1374014,362811,1011203,1049924485.0,254611539.0,795312946.0,6514,2226,4288,1352601,355843,996758,1035412481.0,249466427.0,785946054.0,0.7018,0.7865,0.7011,0.7885
2023-08-09 13:30,8515,3521,4994,1198737,407898,790839,967765487.0,285003263.0,682762224.0,8327,3411,4916,1183774,396238,787536,957984523.0,276918487.0,681066036.0,0.6987,0.8633,0.6989,0.8648
2023-08-09 13:35,7357,3860,3497,1116761,805724,311037,813378714.0,562850882.0,250527831.0,7299,3826,3473,1122447,807382,315065,817462972.0,563953141.0,253509831.0,0.6986,0.8055,0.6985,0.8046
2023-08-09 13:40,5484,3140,2344,809823,653754,156069,577536661.0,457056341.0,120480320.0,5438,3114,2324,806977,652285,154692,575413999.0,455924526.0,119489472.0,0.6991,0.772,0.699,0.7724
2023-08-09 13:45,6013,3283,2730,974840,801448,173392,681556610.0,559675240.0,121881370.0,5977,3268,2709,972735,801256,171479,680033820.0,559531608.0,120502212.0,0.6983,0.7029,0.6983,0.7027
2023-08-09 13:50,527,236,291,50446,36594,13852,35247024.0,25537626.0,9709397.0,465,232,233,50269,36967,13302,35131159.0,25786839.0,9344320.0,0.6979,0.7009,0.6976,0.7025
2023-08-09 13:55,1599,995,604,237408,187345,50063,166027358.0,130835347.0,35192011.0,1576,990,586,236711,186438,50273,165513617.0,130163982.0,35349635.0,0.6984,0.703,0.6982,0.7032
2023-08-09 14:00,1958,1314,644,332779,280552,52227,232624426.0,195942470.0,36681956.0,1917,1291,626,329815,279917,49898,230521286.0,195451826.0,35069460.0,0.6984,0.7024,0.6982,0.7028
2023-08-09 14:05,1721,779,942,283457,119064,164393,219758299.0,83203947.0,136554351.0,1657,752,905,277659,117742,159917,215888922.0,82264618.0,133624304.0,0.6988,0.8307,0.6987,0.8356
2023-08-09 14:10,1029,697,332,157773,113330,44443,120922352.0,79111871.0,41810481.0,986,681,305,154225,112039,42186,118475864.0,78205785.0,40270078.0,0.6981,0.9408,0.698,0.9546
2023-08-09 14:15,1533,869,664,251572,192474,59098,175710444.0,134311240.0,41399203.0,1482,845,637,249906,191076,58830,174481602.0,133247937.0,41233664.0,0.6978,0.7005,0.6974,0.7009
2023-08-09 14:20,232,64,168,21135,7869,13266,14780195.0,5485035.0,9295160.0,206,49,157,20690,7785,12905,14482617.0,5425102.0,9057514.0,0.697,0.7007,0.6969,0.7019
2023-08-09 14:25,359,214,145,58335,46966,11369,40954398.0,32973170.0,7981227.0,338,200,138,57291,46133,11158,40064002.0,32229231.0,7834771.0,0.7021,0.702,0.6986,0.7022
2023-08-09 14:30,1547,943,604,304281,244127,60154,223582658.0,170662943.0,52919714.0,1528,931,597,305011,243696,61315,224063656.0,170349887.0,53713769.0,0.6991,0.8797,0.699,0.876
2023-08-09 14:35,5524,4696,828,1181842,1133350,48492,849195605.0,793887463.0,55308142.0,5344,4544,800,1173947,1128032,45915,843182635.0,789558326.0,53624309.0,0.7005,1.1406,0.6999,1.1679
2023-08-09 14:40,6090,5186,904,1221636,1161346,60290,900294835.0,814946535.0,85348299.0,5967,5123,844,1216696,1157057,59639,896716932.0,811685389.0,85031543.0,0.7017,1.4156,0.7015,1.4258
2023-08-09 14:45,896,226,670,125584,11861,113723,99094035.0,8300199.0,90793835.0,859,207,652,122378,11253,111125,96970241.0,7880315.0,89089925.0,0.6998,0.7984,0.7003,0.8017
2023-08-09 14:50,896,200,696,151246,16801,134445,106297269.0,11770883.0,94526385.0,874,184,690,151529,16325,135204,106599687.0,11438318.0,95161369.0,0.7006,0.7031,0.7007,0.7038
2023-08-09 14:55,461,154,307,65481,7221,58260,46116493.0,5100580.0,41015912.0,433,141,292,63959,6342,57617,45038401.0,4445225.0,40593175.0,0.7064,0.704,0.7009,0.7045
2023-08-09 15:00,152,102,50,20420,14083,6337,14323557.0,9865033.0,4458524.0,129,93,36,14822,10494,4328,10398573.0,7348161.0,3050412.0,0.7005,0.7036,0.7002,0.7048
2023-08-09 15:05,128,90,38,8870,3558,5312,6253260.0,2508419.0,3744840.0,104,71,33,8600,3405,5195,6050760.0,2386988.0,3663772.0,0.705,0.705,0.701,0.7052
2023-08-09 15:10,179,64,115,18085,4911,13174,12732596.0,3459929.0,9272667.0,153,44,109,17045,4303,12742,11988869.0,3014733.0,8974136.0,0.7045,0.7039,0.7006,0.7043
2023-08-09 15:15,442,113,329,54881,11118,43763,38612538.0,7791144.0,30821393.0,429,109,320,54342,11025,43317,38227865.0,7721084.0,30506780.0,0.7008,0.7043,0.7003,0.7043
2023-08-09 15:20,289,100,189,36093,7019,29074,25392244.0,4924482.0,20467762.0,268,88,180,35903,7732,28171,25251366.0,5418644.0,19832722.0,0.7016,0.704,0.7008,0.704
2023-08-09 15:25,81,28,53,7763,1393,6370,5459994.0,976654.0,4483339.0,71,23,48,9272,1676,7596,6518030.0,1172565.0,5345465.0,0.7011,0.7038,0.6996,0.7037
2023-08-09 15:30,128,52,76,13497,5643,7854,9506149.0,3979703.0,5526446.0,117,47,70,11991,5136,6855,8417255.0,3594156.0,4823099.0,0.7052,0.7036,0.6998,0.7036
2023-08-09 15:35,240,50,190,21480,3561,17919,25724809.0,2495261.0,23229548.0,225,41,184,20969,3083,17886,25438913.0,2160282.0,23278630.0,0.7007,1.2964,0.7007,1.3015
2023-08-09 15:40,570,291,279,78108,40546,37562,54851480.0,28430507.0,26420973.0,539,273,266,77747,40232,37515,54620952.0,28204939.0,26416012.0,0.7012,0.7034,0.7011,0.7041
2023-08-09 15:45,148,78,70,11111,5795,5316,7789436.0,4057801.0,3731634.0,126,64,62,10057,4939,5118,7065556.0,3456957.0,3608599.0,0.7002,0.702,0.6999,0.7051
2023-08-09 15:50,880,236,644,147675,9946,137729,103835814.0,6981292.0,96854521.0,850,218,632,145946,8980,136966,102605502.0,6283861.0,96321640.0,0.7019,0.7032,0.6998,0.7033
2023-08-09 15:55,425,98,327,80007,6240,73767,66491155.0,4361553.0,62129601.0,394,81,313,73303,3592,69711,62212710.0,2510517.0,59702192.0,0.699,0.8422,0.6989,0.8564
2023-08-09 16:00,1443,1117,326,229173,178272,50901,171413475.0,124973207.0,46440267.0,1414,1096,318,223118,172899,50219,167132572.0,121173080.0,45959492.0,0.701,0.9124,0.7008,0.9152
2023-08-09 16:05,4240,992,3248,761200,140802,620398,534348697.0,98713176.0,435635520.0,4206,972,3234,756947,138714,618233,531511484.0,97224133.0,434287351.0,0.7011,0.7022,0.7009,0.7025
2023-08-09 16:10,3408,475,2933,654709,46853,607856,481299909.0,32948835.0,448351073.0,3376,456,2920,652074,44345,607729,479343085.0,31074013.0,448269071.0,0.7032,0.7376,0.7007,0.7376
2023-08-09 16:15,2474,1242,1232,329142,153354,175788,241760855.0,107481700.0,134279154.0,2444,1227,1217,320454,151195,169259,235638266.0,105968261.0,129670005.0,0.7009,0.7639,0.7009,0.7661
2023-08-09 16:20,173,120,53,18648,14435,4213,13081277.0,10125327.0,2955950.0,148,102,46,18093,13562,4531,12695275.0,9503220.0,3192054.0,0.7014,0.7016,0.7007,0.7045
2023-08-09 16:25,1504,625,879,221315,82534,138781,166278960.0,57902439.0,108376521.0,1481,612,869,220291,81884,138407,165491182.0,57409141.0,108082040.0,0.7016,0.7809,0.7011,0.7809
2023-08-09 16:30,2679,1339,1340,380188,175945,204243,267012406.0,123292120.0,143720286.0,2650,1326,1324,377941,174820,203121,265537882.0,122579979.0,142957903.0,0.7007,0.7037,0.7012,0.7038
2023-08-09 16:35,1859,1243,616,246319,155617,90702,172971066.0,109143154.0,63827912.0,1842,1235,607,245211,154810,90401,172151459.0,108531489.0,63619970.0,0.7014,0.7037,0.7011,0.7038
2023-08-09 16:40,839,772,67,110390,100897,9493,77416522.0,70736487.0,6680035.0,817,755,62,107731,102537,5194,75540893.0,71879421.0,3661472.0,0.7011,0.7037,0.701,0.7049
2023-08-09 16:45,242,195,47,28480,27095,1385,19969431.0,18989474.0,979957.0,220,184,36,28027,26712,1315,19648242.0,18720883.0,927359.0,0.7008,0.7076,0.7008,0.7052
2023-08-09 16:50,1059,158,901,204493,28454,176039,143235934.0,19942695.0,123293238.0,1032,148,884,200839,28038,172801,140913450.0,19649929.0,121263520.0,0.7009,0.7004,0.7008,0.7018
2023-08-09 16:55,2198,104,2094,476742,3760,472982,345124837.0,2643582.0,342481255.0,2163,89,2074,475544,4073,471471,344295668.0,2836073.0,341459595.0,0.7031,0.7241,0.6963,0.7242
2023-08-09 17:00,1869,91,1778,371357,3214,368143,260480976.0,2221653.0,258259323.0,1845,73,1772,371228,3293,367935,260435186.0,2298979.0,258136206.0,0.6912,0.7015,0.6981,0.7016
2023-08-09 17:05,520,104,416,77457,7009,70448,54463401.0,4929547.0,49533854.0,489,87,402,75527,5145,70382,53015954.0,3593085.0,49422869.0,0.7033,0.7031,0.6984,0.7022
2023-08-09 17:10,266,177,89,18481,12648,5833,23662163.0,8895746.0,14766417.0,237,156,81,17631,11691,5940,23020548.0,8191105.0,14829443.0,0.7033,2.5315,0.7006,2.4965
2023-08-09 17:15,74,46,28,6750,3524,3226,4726372.0,2459608.0,2266763.0,53,31,22,5707,3252,2455,3979556.0,2253773.0,1725783.0,0.698,0.7027,0.693,0.703
2023-08-09 17:20,63,44,19,5564,3974,1590,4015148.0,2909070.0,1106078.0,43,32,11,3691,2484,1207,2582530.0,1732697.0,849832.0,0.732,0.6956,0.6975,0.7041
2023-08-09 17:25,110,78,32,12194,10702,1492,8578585.0,7532364.0,1046221.0,83,65,18,10554,9268,1286,7380229.0,6474449.0,905780.0,0.7038,0.7012,0.6986,0.7043
2023-08-09 17:30,122,67,55,10072,6658,3414,7054513.0,4682093.0,2372419.0,100,60,40,9766,7156,2610,6807050.0,4973065.0,1833985.0,0.7032,0.6949,0.695,0.7027
2023-08-09 17:35,103,64,39,10425,7458,2967,7289764.0,5214272.0,2075492.0,84,52,32,9338,6807,2531,6523784.0,4741905.0,1781879.0,0.6992,0.6995,0.6966,0.704
2023-08-09 17:40,177,118,59,17432,9006,8426,12372625.0,6437976.0,5934648.0,130,87,43,14305,7049,7256,10043257.0,4923455.0,5119801.0,0.7149,0.7043,0.6985,0.7056
2023-08-09 17:45,120,58,62,14311,5137,9174,10022988.0,3607850.0,6415138.0,100,52,48,12262,3931,8331,8619730.0,2746665.0,5873065.0,0.7023,0.6993,0.6987,0.705
2023-08-09 17:50,2623,296,2327,496403,8483,487920,348058817.0,5957034.0,342101783.0,2572,261,2311,489895,5610,484285,343717104.0,3918538.0,339798565.0,0.7022,0.7011,0.6985,0.7016
2023-08-09 17:55,4820,320,4500,973703,11203,962500,693538396.0,7822381.0,685716015.0,4796,306,4490,971700,10844,960856,692309816.0,7570388.0,684739428.0,0.6982,0.7124,0.6981,0.7126
2023-08-09 18:00,4194,193,4001,846187,6473,839714,604220955.0,4516983.0,599703971.0,4173,180,3993,847987,8414,839573,605460754.0,5859479.0,599601275.0,0.6978,0.7142,0.6964,0.7142
2023-08-09 18:05,1168,99,1069,221068,5380,215688,155053476.0,3773690.0,151279786.0,1141,82,1059,218729,4248,214481,153474486.0,2967348.0,150507137.0,0.7014,0.7014,0.6985,0.7017
2023-08-09 18:10,1028,302,726,149010,48739,100271,104425942.0,34030236.0,70395705.0,1007,292,715,147203,48033,99170,103155780.0,33533264.0,69622516.0,0.6982,0.7021,0.6981,0.7021
2023-08-09 18:15,222,70,152,28190,8583,19607,19750134.0,6001826.0,13748308.0,212,70,142,27025,8593,18432,18911818.0,5968214.0,12943604.0,0.6993,0.7012,0.6945,0.7022
2023-08-09 18:20,749,253,496,118411,59288,59123,83071056.0,41603515.0,41467540.0,729,237,492,117524,58567,58957,82265850.0,40904248.0,41361602.0,0.7017,0.7014,0.6984,0.7016
2023-08-09 18:25,210,114,96,26052,17051,9001,18328835.0,12056642.0,6272192.0,173,88,85,20554,13343,7211,14372687.0,9309375.0,5063312.0,0.7071,0.6968,0.6977,0.7022
2023-08-09 18:30,2927,596,2331,543401,65020,478381,432707573.0,45276224.0,387431349.0,2797,521,2276,535444,59949,475495,427960297.0,41764790.0,386195506.0,0.6963,0.8099,0.6967,0.8122
2023-08-09 18:35,2610,524,2086,408919,31077,377842,297000878.0,21653147.0,275347731.0,2545,468,2077,408168,30345,377823,296455050.0,21107809.0,275347241.0,0.6968,0.7287,0.6956,0.7288
2023-08-10 10:00,7314,3847,3467,826702,431458,395244,896619566.0,304092291.0,592527274.0,6387,3464,2923,765308,402280,363028,842808908.0,283418368.0,559390540.0,0.7048,1.4991,0.7045,1.5409
2023-08-10 10:05,3817,2511,1306,461954,284542,177412,411778457.0,200495888.0,211282568.0,3474,2347,1127,444751,275554,169197,399406334.0,193754916.0,205651418.0,0.7046,1.1909,0.7031,1.2155
2023-08-10 10:10,2965,1843,1122,399962,240596,159366,335179949.0,169155331.0,166024617.0,2767,1754,1013,388020,235133,152887,327003724.0,165296150.0,161707574.0,0.7031,1.0418,0.703,1.0577
2023-08-10 10:15,5521,722,4799,887880,56052,831828,699291086.0,39277642.0,660013444.0,5356,640,4716,881790,53041,828749,695123436.0,37124745.0,657998690.0,0.7007,0.7934,0.6999,0.794
2023-08-10 10:20,9335,2531,6804,1236928,245819,991109,1266175991.0,171788940.0,1094387050.0,8861,2226,6635,1213336,232711,980625,1250185310.0,162406800.0,1087778510.0,0.6988,1.1042,0.6979,1.1093
2023-08-10 10:25,969,340,629,83463,14599,68864,68617736.0,10047245.0,58570491.0,693,148,545,74133,7076,67057,62282181.0,4902446.0,57379734.0,0.6882,0.8505,0.6928,0.8557
2023-08-10 10:30,4540,1538,3002,617992,104543,513449,627416125.0,72193692.0,555222432.0,4444,1448,2996,599794,98013,501781,615439017.0,67564388.0,547874629.0,0.6906,1.0814,0.6893,1.0919
2023-08-10 10:35,9063,1896,7167,1579035,100406,1478629,1323629447.0,69032269.0,1254597177.0,8581,1618,6963,1559364,91094,1468270,1310308352.0,62699122.0,1247609229.0,0.6875,0.8485,0.6883,0.8497
2023-08-10 10:40,6906,2059,4847,1053662,99730,953932,861071799.0,68380811.0,792690988.0,6302,1587,4715,1027139,87857,939282,842889431.0,60049963.0,782839468.0,0.6857,0.831,0.6835,0.8334
2023-08-10 10:45,4457,2587,1870,529743,424237,105506,417205421.0,291793692.0,125411729.0,4128,2454,1674,524963,421467,103496,413747749.0,289706994.0,124040755.0,0.6878,1.1887,0.6874,1.1985
2023-08-10 10:50,1008,784,224,213712,203711,10001,157400028.0,139948099.0,17451929.0,795,655,140,210773,202591,8182,155355699.0,139175032.0,16180666.0,0.687,1.745,0.687,1.9776
2023-08-10 10:55,430,185,245,35726,27771,7955,45615817.0,19109061.0,26506755.0,294,139,155,33029,25191,7838,43793473.0,17319594.0,26473878.0,0.6881,3.3321,0.6875,3.3776
2023-08-10 11:00,3320,1096,2224,443167,193337,249830,326072551.0,132606391.0,193466160.0,3113,961,2152,436762,191384,245378,321778690.0,131221204.0,190557486.0,0.6859,0.7744,0.6856,0.7766
2023-08-10 11:05,3255,360,2895,509085,14802,494283,351627145.0,10187774.0,341439370.0,3160,295,2865,507099,13730,493369,350226370.0,9383923.0,340842447.0,0.6883,0.6908,0.6835,0.6908
2023-08-10 11:10,2344,440,1904,275618,27404,248214,190314490.0,18895603.0,171418886.0,2247,371,1876,271830,24113,247717,187919963.0,16541954.0,171378009.0,0.6895,0.6906,0.686,0.6918
2023-08-10 11:15,5934,1362,4572,1007847,86791,921056,826696600.0,59261231.0,767435369.0,5816,1242,4574,993107,78177,914930,816775931.0,53322945.0,763452985.0,0.6828,0.8332,0.6821,0.8344
2023-08-10 11:20,5436,670,4766,1189902,38155,1151747,848153345.0,26038261.0,822115083.0,5159,461,4698,1180842,31389,1149453,842020717.0,21435767.0,820584950.0,0.6824,0.7138,0.6829,0.7139
2023-08-10 11:25,4883,687,4196,821646,34233,787413,604981293.0,23460825.0,581520467.0,4581,572,4009,820567,35451,785116,604360529.0,24142480.0,580218049.0,0.6853,0.7385,0.681,0.739
2023-08-10 11:30,7357,1934,5423,1392789,78433,1314356,963682061.0,53478441.0,910203620.0,7373,1863,5510,1387112,74512,1312600,959850168.0,50765601.0,909084566.0,0.6818,0.6925,0.6813,0.6926
2023-08-10 11:35,5449,3748,1701,850393,630051,220342,591347172.0,429991645.0,161355527.0,5349,3687,1662,844506,625516,218990,587001109.0,426598741.0,160402368.0,0.6825,0.7323,0.682,0.7325
2023-08-10 11:40,1564,1207,357,250142,237266,12876,181648869.0,162396660.0,19252209.0,1395,1138,257,246532,235198,11334,179053618.0,160840197.0,18213420.0,0.6844,1.4952,0.6839,1.607
2023-08-10 11:45,4427,1642,2785,675298,174748,500550,635114486.0,119786832.0,515327653.0,3720,1238,2482,623372,151787,471585,600135731.0,102773817.0,497361914.0,0.6855,1.0295,0.6771,1.0547
2023-08-10 11:50,5396,2788,2608,670424,305220,365204,568164790.0,207776929.0,360387861.0,4821,2402,2419,641556,290608,350948,549066755.0,197839612.0,351227143.0,0.6807,0.9868,0.6808,1.0008
2023-08-10 11:55,8156,2914,5242,1377267,173874,1203393,1063950188.0,120098700.0,943851488.0,7259,2280,4979,1338253,145742,1192511,1037092466.0,100309180.0,936783286.0,0.6907,0.7843,0.6883,0.7856
2023-08-10 12:00,2640,2356,284,581001,553441,27560,410830165.0,371823875.0,39006290.0,2277,2079,198,562503,546423,16080,397847401.0,366531130.0,31316270.0,0.6718,1.4153,0.6708,1.9475
2023-08-10 12:05,7103,4772,2331,1368806,1028863,339943,1092782268.0,696716528.0,396065739.0,6759,4602,2157,1341811,1014581,327230,1074295917.0,686793637.0,387502280.0,0.6772,1.1651,0.6769,1.1842
2023-08-10 12:10,2795,635,2160,506952,30729,476223,354729037.0,20985009.0,333744027.0,2659,538,2121,503272,26475,476797,352097949.0,17905022.0,334192927.0,0.6829,0.7008,0.6763,0.7009
2023-08-10 12:15,5078,622,4456,1061512,31223,1030289,731480166.0,21112398.0,710367767.0,4919,515,4404,1056075,28966,1027109,728087975.0,19571830.0,708516145.0,0.6762,0.6895,0.6757,0.6898
2023-08-10 12:20,4394,379,4015,997016,19846,977170,688238320.0,13422966.0,674815354.0,4337,346,3991,996202,19333,976869,687641334.0,13001694.0,674639639.0,0.6764,0.6906,0.6725,0.6906
2023-08-10 12:25,5994,1178,4816,1247591,67345,1180246,898894852.0,45530521.0,853364330.0,5865,1084,4781,1240633,63260,1177373,894361447.0,42708176.0,851653271.0,0.6761,0.723,0.6751,0.7234
2023-08-10 12:30,4666,1152,3514,745570,103979,641591,558228426.0,70301717.0,487926708.0,4572,1087,3485,743139,103370,639769,556458320.0,69794939.0,486663381.0,0.6761,0.7605,0.6752,0.7607
2023-08-10 12:35,7431,4899,2532,1440206,1261425,178781,1027888729.0,854178331.0,173710398.0,7211,4782,2429,1428430,1256859,171571,1019548305.0,850835959.0,168712346.0,0.6772,0.9716,0.677,0.9833
2023-08-10 12:40,6435,2941,3494,1029162,659457,369705,781183285.0,446299719.0,334883566.0,6317,2874,3443,1012667,655944,356723,769414482.0,443702280.0,325712202.0,0.6768,0.9058,0.6764,0.9131
2023-08-10 12:45,6861,4581,2280,1369643,1223727,145916,927435004.0,827997111.0,99437893.0,6794,4556,2238,1366713,1223453,143260,925528642.0,827759197.0,97769445.0,0.6766,0.6815,0.6766,0.6825
2023-08-10 12:50,13536,7083,6453,2242540,1468797,773743,1561977549.0,993689911.0,568287637.0,13434,7008,6426,2239941,1467560,772381,1560218139.0,992813715.0,567404424.0,0.6765,0.7345,0.6765,0.7346
2023-08-10 12:55,11560,7329,4231,2123866,1682634,441232,1460385608.0,1138975032.0,321410576.0,11447,7252,4195,2120336,1680424,439912,1457845452.0,1137334323.0,320511129.0,0.6769,0.7284,0.6768,0.7286
2023-08-10 13:00,6712,5257,1455,1484164,1385751,98413,1038766029.0,940241386.0,98524642.0,6525,5139,1386,1471797,1379031,92766,1029795687.0,935335579.0,94460108.0,0.6785,1.0011,0.6783,1.0183
2023-08-10 13:05,5514,4101,1413,936107,753343,182764,648598639.0,513324126.0,135274513.0,5278,3967,1311,927054,749034,178020,642452638.0,510267554.0,132185084.0,0.6814,0.7402,0.6812,0.7425
2023-08-10 13:10,2170,1534,636,288127,216549,71578,207233859.0,147796574.0,59437284.0,2032,1449,583,282820,211756,71064,203381182.0,144290491.0,59090691.0,0.6825,0.8304,0.6814,0.8315
2023-08-10 13:15,792,499,293,83166,58206,24960,67808359.0,40018616.0,27789742.0,601,433,168,73609,55979,17630,60844496.0,38252899.0,22591596.0,0.6875,1.1134,0.6833,1.2814
2023-08-10 13:20,598,368,230,65003,31358,33645,44497910.0,21502579.0,22995330.0,893,526,367,56234,25237,30997,38591638.0,17202849.0,21388789.0,0.6857,0.6835,0.6817,0.69
2023-08-10 13:25,837,736,101,82479,73630,8849,56732688.0,50604234.0,6128454.0,766,686,80,81537,72769,8768,55970767.0,49854026.0,6116741.0,0.6873,0.6926,0.6851,0.6976
2023-08-10 13:30,5939,1950,3989,970481,170642,799839,706145331.0,116466076.0,589679255.0,5710,1867,3843,964131,170962,793169,702007095.0,116630742.0,585376353.0,0.6825,0.7372,0.6822,0.738
2023-08-10 13:35,6636,1553,5083,1268120,156662,1111458,879443499.0,106799016.0,772644482.0,6557,1498,5059,1265698,155386,1110312,877822375.0,105922206.0,771900168.0,0.6817,0.6952,0.6817,0.6952
2023-08-10 13:40,6596,3161,3435,976012,352781,623231,678742367.0,240800217.0,437942149.0,6437,3016,3421,974174,350855,623319,677399093.0,239413351.0,437985742.0,0.6826,0.7027,0.6824,0.7027
2023-08-10 13:45,2979,2446,533,516443,483761,32682,363534014.0,330613780.0,32920233.0,2914,2396,518,518155,482783,35372,364655085.0,329883456.0,34771629.0,0.6834,1.0073,0.6833,0.983
2023-08-10 13:50,1722,1388,334,254605,242429,12176,174521611.0,166120884.0,8400726.0,1661,1341,320,253396,241704,11692,174818051.0,166750173.0,8067878.0,0.6852,0.6899,0.6899,0.69
2023-08-10 13:55,3660,1660,2000,532773,177268,355505,396542218.0,121519265.0,275022953.0,3495,1545,1950,523581,174408,349173,390542983.0,119510663.0,271032320.0,0.6855,0.7736,0.6852,0.7762
2023-08-10 14:00,7408,4222,3186,1033525,351767,681758,729921892.0,240556224.0,489365668.0,7072,3918,3154,1032309,346861,685448,729135977.0,237104183.0,492031793.0,0.6839,0.7178,0.6836,0.7178
2023-08-10 14:05,5650,4935,715,710358,631521,78837,497596568.0,432820766.0,64775801.0,5429,4746,683,708901,631536,77365,496543366.0,432779108.0,63764258.0,0.6854,0.8216,0.6853,0.8242
2023-08-10 14:10,4553,3914,639,894490,870744,23746,621696770.0,594928196.0,26768574.0,4425,3881,544,889314,869012,20302,618103604.0,593642373.0,24461231.0,0.6832,1.1273,0.6831,1.2049
2023-08-10 14:15,6626,5936,690,1372059,1336551,35508,937868733.0,913513273.0,24355460.0,6521,5869,652,1367893,1334340,33553,935038624.0,911937465.0,23101159.0,0.6835,0.6859,0.6834,0.6885
2023-08-10 14:20,3919,3457,462,650297,616259,34038,444635679.0,421185885.0,23449793.0,3849,3412,437,649174,615688,33486,443862476.0,420775772.0,23086704.0,0.6835,0.6889,0.6834,0.6894
2023-08-10 14:25,2133,1629,504,248188,203234,44954,170472533.0,139615401.0,30857131.0,2039,1558,481,244754,200909,43845,168206421.0,138020133.0,30186287.0,0.687,0.6864,0.687,0.6885
2023-08-10 14:30,2600,1774,826,284036,221467,62569,205604030.0,152025502.0,53578528.0,2504,1716,788,278709,219128,59581,201679045.0,150152194.0,51526851.0,0.6864,0.8563,0.6852,0.8648
2023-08-10 14:35,3316,2899,417,570667,545200,25467,391608311.0,374035256.0,17573054.0,3248,2855,393,567245,542467,24778,389163765.0,372056095.0,17107669.0,0.6861,0.69,0.6859,0.6904
2023-08-10 14:40,1490,1395,95,213142,209954,3188,146275736.0,144074045.0,2201690.0,1440,1359,81,212384,209962,2422,145736167.0,144059568.0,1676598.0,0.6862,0.6906,0.6861,0.6922
2023-08-10 14:45,1391,1317,74,218263,213765,4498,160328122.0,146735582.0,13592540.0,1358,1297,61,215751,211578,4173,158536411.0,145192469.0,13343941.0,0.6864,3.0219,0.6862,3.1977
2023-08-10 14:50,1551,1423,128,207050,191156,15894,142337977.0,131331131.0,11006845.0,1524,1409,115,206876,191260,15616,142214222.0,131375555.0,10838667.0,0.687,0.6925,0.6869,0.6941
2023-08-10 14:55,2007,1693,314,220880,190043,30837,151762030.0,130496912.0,21265118.0,1977,1675,302,220050,189587,30463,151212303.0,130174403.0,21037899.0,0.6867,0.6896,0.6866,0.6906
2023-08-10 15:00,2434,2078,356,317852,277717,40135,218453399.0,190770236.0,27683163.0,2602,2168,434,318944,278512,40432,219191502.0,191293782.0,27897719.0,0.6869,0.6898,0.6868,0.69
2023-08-10 15:05,1500,1179,321,173311,144538,28773,119151968.0,99316691.0,19835276.0,1463,1157,306,171996,143749,28247,118258422.0,98755124.0,19503298.0,0.6871,0.6894,0.687,0.6905
2023-08-10 15:10,632,480,152,56911,42022,14889,39155187.0,28857024.0,10298163.0,621,465,156,58425,42170,16255,40188542.0,28948027.0,11240515.0,0.6867,0.6917,0.6865,0.6915
2023-08-10 15:15,992,582,410,107180,62853,44327,73737392.0,43172339.0,30565053.0,947,556,391,105264,62240,43024,72493449.0,42750327.0,29743121.0,0.6869,0.6895,0.6869,0.6913
2023-08-10 15:20,498,433,65,21865,17470,4395,15037757.0,12004475.0,3033282.0,460,408,52,20086,16339,3747,13810880.0,11221493.0,2589387.0,0.6871,0.6902,0.6868,0.6911
2023-08-10 15:25,995,599,396,112697,67866,44831,98213908.0,46535973.0,51677934.0,915,550,365,111105,67403,43702,97313744.0,46207461.0,51106282.0,0.6857,1.1527,0.6855,1.1694
2023-08-10 15:30,2517,1027,1490,333684,51552,282132,229611675.0,35320427.0,194291248.0,2479,999,1480,332564,51356,281208,228836189.0,35168349.0,193667840.0,0.6851,0.6887,0.6848,0.6887
2023-08-10 15:35,4144,1313,2831,635600,57962,577638,447798874.0,39768822.0,408030052.0,4098,1276,2822,634779,57298,577481,447196090.0,39287468.0,407908621.0,0.6861,0.7064,0.6857,0.7064
2023-08-10 15:40,2958,836,2122,472946,29678,443268,325420117.0,20332632.0,305087485.0,2931,818,2113,471434,28254,443180,324394568.0,19362774.0,305031793.0,0.6851,0.6883,0.6853,0.6883
2023-08-10 15:45,2026,409,1617,312883,15676,297207,215430621.0,10758698.0,204671922.0,1990,387,1603,312170,15642,296528,214934244.0,10729746.0,204204498.0,0.6863,0.6887,0.686,0.6887
2023-08-10 15:50,2263,295,1968,385200,9030,376170,265304506.0,6195660.0,259108845.0,2243,282,1961,384443,8660,375783,264786293.0,5939699.0,258846594.0,0.6861,0.6888,0.6859,0.6888
2023-08-10 15:55,1799,445,1354,262278,15252,247026,180549104.0,10480483.0,170068620.0,1758,413,1345,261306,14386,246920,179878133.0,9865832.0,170012300.0,0.6872,0.6885,0.6858,0.6885
2023-08-10 16:00,2623,904,1719,347265,62213,285052,238889214.0,42676708.0,196212506.0,2596,882,1714,347041,62169,284872,238720112.0,42604189.0,196115922.0,0.686,0.6883,0.6853,0.6884
2023-08-10 16:05,3246,1300,1946,410819,96551,314268,282609368.0,66222413.0,216386955.0,3221,1283,1938,409382,95659,313723,281622320.0,65596493.0,216025826.0,0.6859,0.6885,0.6857,0.6886
2023-08-10 16:10,2899,1478,1421,374863,130988,243875,257918843.0,89948326.0,167970517.0,2858,1443,1415,373359,130344,243015,256809237.0,89439871.0,167369366.0,0.6867,0.6888,0.6862,0.6887
2023-08-10 16:15,1044,842,202,121159,107125,14034,83230831.0,73591842.0,9638989.0,1000,815,185,119347,106300,13047,81998652.0,73010677.0,8987975.0,0.687,0.6868,0.6868,0.6889
2023-08-10 16:20,1585,738,847,135388,83518,51870,93013233.0,57299628.0,35713605.0,1552,713,839,134811,83091,51720,92629527.0,57007882.0,35621645.0,0.6861,0.6885,0.6861,0.6887
2023-08-10 16:25,415,282,133,52954,46683,6271,36304163.0,32016430.0,4287732.0,396,278,118,52149,46442,5707,35783543.0,31850265.0,3933277.0,0.6858,0.6837,0.6858,0.6892
2023-08-10 16:30,553,476,77,55852,52618,3234,38383072.0,36150311.0,2232761.0,537,464,73,55996,51979,4017,38491403.0,35693137.0,2798266.0,0.687,0.6904,0.6867,0.6966
2023-08-10 16:35,2686,1941,745,434856,387770,47086,298303146.0,265866840.0,32436305.0,2650,1912,738,432513,386931,45582,296688439.0,265292114.0,31396324.0,0.6856,0.6889,0.6856,0.6888
2023-08-10 16:40,683,541,142,91226,83547,7679,62721797.0,57317851.0,5403946.0,656,525,131,88655,82809,5846,60821898.0,56789460.0,4032437.0,0.6861,0.7037,0.6858,0.6898
2023-08-10 16:45,1811,1244,567,246111,218929,27182,168793959.0,150153722.0,18640237.0,1759,1214,545,243882,218255,25627,167325328.0,149676223.0,17649104.0,0.6859,0.6858,0.6858,0.6887
2023-08-10 16:50,720,520,200,74273,63954,10319,51017166.0,43910761.0,7106404.0,683,492,191,72352,63140,9212,49672103.0,43328089.0,6344014.0,0.6866,0.6887,0.6862,0.6887
2023-08-10 16:55,869,748,121,101804,98673,3131,69912435.0,67755975.0,2156460.0,850,734,116,101835,98685,3150,69934303.0,67762194.0,2172109.0,0.6867,0.6887,0.6867,0.6896
2023-08-10 17:00,1224,998,226,176911,164876,12035,121315457.0,113065594.0,8249862.0,1203,987,216,177285,166256,11029,121522751.0,113916843.0,7605908.0,0.6858,0.6855,0.6852,0.6896
2023-08-10 17:05,3797,3120,677,558421,522577,35844,383089890.0,358428087.0,24661803.0,3775,3109,666,555372,520157,35215,381015604.0,356762309.0,24253294.0,0.6859,0.688,0.6859,0.6887
2023-08-10 17:10,2144,1587,557,298354,268019,30335,204709310.0,183838452.0,20870858.0,2113,1573,540,295970,266872,29098,202949174.0,182927766.0,20021407.0,0.6859,0.688,0.6855,0.6881
2023-08-10 17:15,2162,1863,299,281891,271819,10072,193496541.0,186562189.0,6934351.0,2152,1854,298,282092,271809,10283,193632138.0,186538099.0,7094039.0,0.6863,0.6885,0.6863,0.6899
2023-08-10 17:20,1470,1194,276,180340,171644,8696,123835193.0,117831792.0,6003400.0,1440,1186,254,178471,170908,7563,122533107.0,117321067.0,5212040.0,0.6865,0.6904,0.6865,0.6891
2023-08-10 17:25,1783,1518,265,186300,178035,8265,127976973.0,122280063.0,5696909.0,1771,1511,260,185622,177701,7921,127511229.0,122048285.0,5462944.0,0.6868,0.6893,0.6868,0.6897
2023-08-10 17:30,2184,1559,625,295689,275364,20325,213598846.0,189092641.0,24506204.0,2159,1551,608,292342,272456,19886,211215354.0,187029808.0,24185545.0,0.6867,1.2057,0.6865,1.2162
2023-08-10 17:35,339,285,54,27277,25082,2195,18781985.0,17269745.0,1512240.0,309,270,39,25768,24076,1692,17734117.0,16561527.0,1172589.0,0.6885,0.6889,0.6879,0.693
2023-08-10 17:40,67,30,37,7478,1099,6379,5215587.0,770930.0,4444657.0,46,11,35,3598,704,2894,2487143.0,484063.0,2003080.0,0.7015,0.6968,0.6876,0.6921
2023-08-10 17:45,221,113,108,25840,14901,10939,17798951.0,10250062.0,7548889.0,198,97,101,28126,14337,13789,19429851.0,9854925.0,9574926.0,0.6879,0.6901,0.6874,0.6944
2023-08-10 17:50,3349,2740,609,525279,466713,58566,361132350.0,320677186.0,40455164.0,3314,2715,599,524934,466379,58555,360887761.0,320433900.0,40453860.0,0.6871,0.6908,0.6871,0.6909
2023-08-10 17:55,2449,1959,490,334585,300115,34470,230145202.0,206344128.0,23801073.0,2420,1938,482,333229,298957,34272,229236739.0,205529539.0,23707200.0,0.6876,0.6905,0.6875,0.6917
2023-08-10 18:00,1220,829,391,171331,146504,24827,118051222.0,100909071.0,17142151.0,1206,823,383,172277,147251,25026,118704691.0,101397906.0,17306785.0,0.6888,0.6905,0.6886,0.6916
2023-08-10 18:05,3683,3138,545,632241,600538,31703,435553688.0,413606943.0,21946745.0,3649,3119,530,631031,599952,31079,434710751.0,413192608.0,21518142.0,0.6887,0.6923,0.6887,0.6924
2023-08-10 18:10,628,395,233,59734,39106,20628,41112531.0,26931205.0,14181325.0,582,371,211,56638,37631,19007,39017383.0,25870922.0,13146460.0,0.6887,0.6875,0.6875,0.6917
2023-08-10 18:15,416,136,280,39076,6517,32559,26951967.0,4481183.0,22470784.0,372,103,269,35510,4483,31027,24501793.0,3076112.0,21425681.0,0.6876,0.6902,0.6862,0.6905
2023-08-10 18:20,309,60,249,51649,1419,50230,35623909.0,979590.0,34644319.0,284,48,236,50184,1270,48914,34698084.0,872464.0,33825619.0,0.6903,0.6897,0.687,0.6915
2023-08-10 18:25,419,103,316,73315,3350,69965,50799197.0,2319355.0,48479842.0,402,91,311,72372,3117,69255,50131246.0,2143981.0,47987265.0,0.6923,0.6929,0.6878,0.6929
2023-08-10 18:30,676,213,463,80009,8826,71183,55380528.0,6130275.0,49250253.0,649,195,454,78278,7210,71068,54141612.0,4960556.0,49181055.0,0.6946,0.6919,0.688,0.692
2023-08-10 18:35,423,72,351,29392,3254,26138,20267842.0,2240612.0,18027229.0,396,58,338,29209,3095,26114,20164552.0,2123652.0,18040899.0,0.6886,0.6897,0.6862,0.6909
2023-08-11 10:00,6502,2843,3659,704672,310701,393971,610731349.0,212463491.0,398267857.0,5794,2532,3262,682545,298765,383780,584979443.0,204634256.0,380345186.0,0.6838,1.0109,0.6849,0.9911
2023-08-11 10:05,2307,1795,512,231541,197748,33793,223726392.0,136884798.0,86841594.0,1933,1666,267,213499,188576,24923,210962346.0,130256025.0,80706321.0,0.6922,2.5698,0.6907,3.2382
2023-08-11 10:10,1011,556,455,97234,57573,39661,109843710.0,39952677.0,69891032.0,774,467,307,73690,49983,23707,93562728.0,34616658.0,58946070.0,0.6939,1.7622,0.6926,2.4864
2023-08-11 10:15,2045,590,1455,257398,53807,203591,218718209.0,36936446.0,181781763.0,1808,459,1349,241827,44203,197624,208718312.0,30344473.0,178373839.0,0.6865,0.8929,0.6865,0.9026
2023-08-11 10:20,6776,2397,4379,806035,175478,630557,785682728.0,120490785.0,665191943.0,6585,2288,4297,797530,171777,625753,779748010.0,117810577.0,661937433.0,0.6866,1.0549,0.6858,1.0578
2023-08-11 10:25,7594,3399,4195,900569,290854,609715,725819171.0,200322334.0,525496836.0,7400,3285,4115,891973,281804,610169,719869472.0,194016962.0,525852509.0,0.6887,0.8619,0.6885,0.8618
2023-08-11 10:30,5316,4058,1258,713420,637804,75616,534777370.0,440062857.0,94714512.0,5216,4022,1194,709946,636963,72983,532308913.0,439396856.0,92912057.0,0.69,1.2526,0.6898,1.2731
2023-08-11 10:35,987,719,268,74087,56406,17681,61586290.0,38777160.0,22809130.0,944,700,244,70269,53468,16801,59102287.0,36911538.0,22190749.0,0.6875,1.29,0.6903,1.3208
2023-08-11 10:40,7532,6349,1183,1170370,1077686,92684,885608838.0,747082637.0,138526201.0,6958,5974,984,1143192,1064381,78811,866764983.0,737837894.0,128927088.0,0.6932,1.4946,0.6932,1.6359
2023-08-11 10:45,3942,2467,1475,547770,375996,171774,420963080.0,259891976.0,161071103.0,3805,2394,1411,534723,368590,166133,411832280.0,254501722.0,157330557.0,0.6912,0.9377,0.6905,0.947
2023-08-11 10:50,2765,699,2066,338266,65323,272943,287026031.0,45231771.0,241794259.0,2650,637,2013,327488,60260,267228,279620133.0,41625793.0,237994340.0,0.6924,0.8859,0.6908,0.8906
2023-08-11 10:55,792,435,357,83002,59660,23342,57310139.0,41066585.0,16243553.0,724,387,337,81604,59034,22570,56341467.0,40698318.0,15643149.0,0.6883,0.6959,0.6894,0.6931
2023-08-11 11:00,778,372,406,87019,58663,28356,59964913.0,40334961.0,19629951.0,729,349,380,77742,50869,26873,53692343.0,35083775.0,18608568.0,0.6876,0.6923,0.6897,0.6925
2023-08-11 11:05,5295,1670,3625,737142,182100,555042,550829748.0,125348024.0,425481724.0,5082,1547,3535,732001,180648,551353,547342095.0,124341232.0,423000863.0,0.6883,0.7666,0.6883,0.7672
2023-08-11 11:10,6999,1253,5746,1340756,82154,1258602,946842812.0,56431885.0,890410926.0,6898,1180,5718,1341128,83357,1257771,947324371.0,57257562.0,890066809.0,0.6869,0.7075,0.6869,0.7077
2023-08-11 11:15,4352,720,3632,583460,47567,535893,402853795.0,32655073.0,370198721.0,4285,688,3597,579658,46090,533568,400244415.0,31656557.0,368587858.0,0.6865,0.6908,0.6868,0.6908
2023-08-11 11:20,3906,833,3073,572295,119819,452476,394838839.0,82305968.0,312532870.0,3833,786,3047,565235,114678,450557,390071663.0,78758335.0,311313327.0,0.6869,0.6907,0.6868,0.691
2023-08-11 11:25,2733,2184,549,299199,242416,56783,227506823.0,167146213.0,60360610.0,2658,2139,519,295672,241146,54526,224982035.0,166203057.0,58778977.0,0.6895,1.063,0.6892,1.078
2023-08-11 11:30,3128,966,2162,402269,121467,280802,277648203.0,83634234.0,194013968.0,3060,920,2140,400227,120756,279471,276446897.0,83140996.0,193305900.0,0.6885,0.6909,0.6885,0.6917
2023-08-11 11:35,3003,503,2500,573449,52098,521351,417247251.0,35811601.0,381435650.0,2941,464,2477,568071,49912,518159,413613666.0,34303324.0,379310342.0,0.6874,0.7316,0.6873,0.732
2023-08-11 11:40,1832,282,1550,307720,22528,285192,223423364.0,15652551.0,207770813.0,1761,239,1522,298559,19105,279454,216840913.0,13135836.0,203705077.0,0.6948,0.7285,0.6876,0.7289
2023-08-11 11:45,2169,959,1210,276882,113398,163484,212167820.0,78162767.0,134005052.0,2038,899,1139,269945,108737,161208,207282387.0,74821878.0,132460508.0,0.6893,0.8197,0.6881,0.8217
2023-08-11 11:50,2302,1013,1289,273178,150709,122469,209302719.0,103740528.0,105562191.0,2114,969,1145,270296,150253,120043,207298851.0,103391088.0,103907763.0,0.6883,0.862,0.6881,0.8656
2023-08-11 11:55,2593,547,2046,407551,46410,361141,291446979.0,31885419.0,259561560.0,2517,512,2005,403219,45736,357483,288620218.0,31412470.0,257207747.0,0.687,0.7187,0.6868,0.7195
2023-08-11 12:00,5925,698,5227,1341016,40609,1300407,924940187.0,27821527.0,897118660.0,5842,664,5178,1336277,37347,1298930,921723418.0,25613184.0,896110234.0,0.6851,0.6899,0.6858,0.6899
2023-08-11 12:05,6055,834,5221,1432694,65131,1367563,987896971.0,44690443.0,943206528.0,6002,813,5189,1431165,63642,1367523,986828295.0,43643740.0,943184555.0,0.6862,0.6897,0.6858,0.6897
2023-08-11 12:10,6922,772,6150,1483005,49702,1433303,1126603157.0,34082032.0,1092521125.0,6849,738,6111,1479540,48933,1430607,1124240701.0,33554541.0,1090686160.0,0.6857,0.7622,0.6857,0.7624
2023-08-11 12:15,5610,177,5433,1261780,6467,1255313,953588333.0,4479664.0,949108669.0,5535,148,5387,1260853,6149,1254704,952906574.0,4214412.0,948692162.0,0.6927,0.7561,0.6854,0.7561
2023-08-11 12:20,5055,439,4616,1073122,14863,1058259,739794193.0,10205484.0,729588708.0,4963,407,4556,1071839,14191,1057648,738909192.0,9739013.0,729170179.0,0.6866,0.6894,0.6863,0.6894
2023-08-11 12:25,4685,389,4296,908625,25193,883432,626590399.0,17313954.0,609276445.0,4634,366,4268,906118,23246,882872,624864520.0,15941937.0,608922583.0,0.6873,0.6897,0.6858,0.6897
2023-08-11 12:30,3669,68,3601,737439,5958,731481,508950398.0,4109668.0,504840730.0,3643,56,3587,736229,5683,730546,508152110.0,3902746.0,504249363.0,0.6898,0.6902,0.6867,0.6902
2023-08-11 12:35,3983,1174,2809,712649,120660,591989,523155632.0,82869400.0,440286231.0,3915,1142,2773,707760,118069,589691,519738901.0,81074987.0,438663914.0,0.6868,0.7437,0.6867,0.7439
2023-08-11 12:40,3539,1250,2289,443042,148533,294509,315588017.0,102068346.0,213519671.0,3491,1231,2260,442263,148254,294009,315162744.0,101869379.0,213293364.0,0.6872,0.725,0.6871,0.7255
2023-08-11 12:45,5452,1230,4222,806962,199311,607651,556290728.0,136933378.0,419357350.0,5410,1215,4195,805939,200505,605434,555522994.0,137715245.0,417807748.0,0.687,0.6901,0.6868,0.6901
2023-08-11 12:50,7058,1118,5940,1439121,150684,1288437,991793082.0,103407388.0,888385693.0,7023,1106,5917,1437267,150485,1286782,990551173.0,103271755.0,887279418.0,0.6863,0.6895,0.6863,0.6895
2023-08-11 12:55,7260,777,6483,1612081,66655,1545426,1120694893.0,45712814.0,1074982079.0,7222,764,6458,1611167,66257,1544910,1120077979.0,45435788.0,1074642191.0,0.6858,0.6956,0.6858,0.6956
2023-08-11 13:00,7171,1248,5923,1590012,76090,1513922,1094864234.0,52180214.0,1042684020.0,7116,1220,5896,1589076,75606,1513470,1094220456.0,51846243.0,1042374213.0,0.6858,0.6887,0.6857,0.6887
2023-08-11 13:05,6096,446,5650,1524597,11628,1512969,1049924819.0,7982686.0,1041942132.0,6010,409,5601,1523416,10797,1512619,1049133564.0,7409344.0,1041724219.0,0.6865,0.6887,0.6862,0.6887
2023-08-11 13:10,5306,145,5161,1469141,4849,1464292,1011980359.0,3251629.0,1008728730.0,5259,122,5137,1466021,2462,1463559,1009907716.0,1684367.0,1008223348.0,0.6706,0.6889,0.6841,0.6889
2023-08-11 13:15,5131,587,4544,1204435,15961,1188474,830099956.0,10952111.0,819147844.0,5079,568,4511,1203973,16018,1187955,829792258.0,10978882.0,818813376.0,0.6862,0.6892,0.6854,0.6893
2023-08-11 13:20,5085,315,4770,1186138,12121,1174017,816965786.0,8327731.0,808638055.0,5021,287,4734,1183152,11041,1172111,814990149.0,7566547.0,807423602.0,0.687,0.6888,0.6853,0.6889
2023-08-11 13:25,3728,552,3176,851909,70225,781684,607410495.0,48319584.0,559090911.0,3657,509,3148,848276,67863,780413,604771559.0,46540990.0,558230568.0,0.6881,0.7152,0.6858,0.7153
2023-08-11 13:30,3997,817,3180,536267,133320,402947,368973700.0,91397637.0,277576062.0,3936,786,3150,535543,132846,402697,368478622.0,91069196.0,277409426.0,0.6856,0.6889,0.6855,0.6889
2023-08-11 13:35,4858,379,4479,788635,10902,777733,543188953.0,7470769.0,535718183.0,4810,357,4453,788148,10403,777745,542884881.0,7129248.0,535755633.0,0.6853,0.6888,0.6853,0.6889
2023-08-11 13:40,2814,372,2442,519047,17940,501107,357480994.0,12316397.0,345164597.0,2757,346,2411,513868,14791,499077,353856016.0,10136191.0,343719824.0,0.6865,0.6888,0.6853,0.6887
2023-08-11 13:45,2446,1928,518,422222,353025,69197,300596307.0,242356626.0,58239681.0,2398,1909,489,421275,354472,66803,299770833.0,243197938.0,56572895.0,0.6865,0.8417,0.6861,0.8469
2023-08-11 13:50,3541,3043,498,731797,715047,16750,502484853.0,490939216.0,11545636.0,3504,3025,479,730495,714174,16321,501588920.0,490337755.0,11251164.0,0.6866,0.6893,0.6866,0.6894
2023-08-11 13:55,4893,3314,1579,907579,870638,36941,623300205.0,597863597.0,25436608.0,4871,3301,1570,907556,870439,37117,623289207.0,597730269.0,25558938.0,0.6867,0.6886,0.6867,0.6886
2023-08-11 14:00,4039,2884,1155,663111,628271,34840,455443285.0,431459275.0,23984009.0,4022,2867,1155,662931,628167,34764,455324713.0,431376880.0,23947833.0,0.6867,0.6884,0.6867,0.6889
2023-08-11 14:05,3993,3651,342,676396,659195,17201,464661311.0,452800489.0,11860822.0,3976,3644,332,676107,659664,16443,464457056.0,453120601.0,11336455.0,0.6869,0.6895,0.6869,0.6894
2023-08-11 14:10,4898,3869,1029,867520,840481,27039,595733700.0,577085661.0,18648038.0,4871,3854,1017,866444,840306,26138,594956838.0,576957707.0,17999131.0,0.6866,0.6897,0.6866,0.6886
2023-08-11 14:15,4744,4063,681,842738,825562,17176,578925821.0,567092213.0,11833607.0,4714,4038,676,842309,824757,17552,578593489.0,566500043.0,12093445.0,0.6869,0.689,0.6869,0.689
2023-08-11 14:20,3193,3004,189,683398,672160,11238,469655253.0,461905777.0,7749476.0,3177,2999,178,682769,671746,11023,469213011.0,461609783.0,7603227.0,0.6872,0.6896,0.6872,0.6898
2023-08-11 14:25,5164,4634,530,1069262,1048043,21219,734764306.0,720140488.0,14623817.0,5145,4627,518,1068576,1047672,20904,734293739.0,719884903.0,14408835.0,0.6871,0.6892,0.6871,0.6893
2023-08-11 14:30,4299,3971,328,918777,908109,10668,631414600.0,624054908.0,7359692.0,4292,3968,324,918735,908163,10572,631383407.0,624093320.0,7290087.0,0.6872,0.6899,0.6872,0.6896
2023-08-11 14:35,5119,4778,341,1092503,1079392,13111,750796799.0,741748758.0,9048041.0,5103,4769,334,1092349,1079427,12922,750684258.0,741768808.0,8915450.0,0.6872,0.6901,0.6872,0.6899
2023-08-11 14:40,3186,2820,366,592313,567617,24696,407098668.0,390060526.0,17038141.0,3172,2810,362,592310,567531,24779,407101690.0,390001296.0,17100394.0,0.6872,0.6899,0.6872,0.6901
2023-08-11 14:45,3153,2928,225,637206,624732,12474,437962288.0,429353087.0,8609201.0,3134,2922,212,637316,623881,13435,438059683.0,428752201.0,9307481.0,0.6873,0.6902,0.6872,0.6928
2023-08-11 14:50,2045,1750,295,285944,265074,20870,196804735.0,182392808.0,14411927.0,2000,1726,274,282901,263652,19249,194616374.0,181315861.0,13300513.0,0.6881,0.6906,0.6877,0.691
2023-08-11 14:55,2394,1092,1302,343630,122121,221509,236657084.0,83947754.0,152709330.0,2362,1080,1282,341507,121413,220094,235193651.0,83452443.0,151741207.0,0.6874,0.6894,0.6873,0.6894
2023-08-11 15:00,3502,989,2513,568055,99155,468900,391078568.0,68088557.0,322990011.0,3472,968,2504,566463,98496,467967,390043924.0,67635878.0,322408045.0,0.6867,0.6888,0.6867,0.689
2023-08-11 15:05,2542,700,1842,382167,59970,322197,263405518.0,41219310.0,222186208.0,2525,690,1835,380909,59323,321586,262504550.0,40743294.0,221761256.0,0.6873,0.6896,0.6868,0.6896
2023-08-11 15:10,1528,750,778,175886,62543,113343,121231309.0,42984800.0,78246508.0,1507,740,767,174327,60649,113678,120139678.0,41650684.0,78488994.0,0.6873,0.6904,0.6867,0.6905
2023-08-11 15:15,4522,3443,1079,612918,499515,113403,443870542.0,344440770.0,99429771.0,4364,3337,1027,603801,492853,110948,437134101.0,339458766.0,97675335.0,0.6896,0.8768,0.6888,0.8804
2023-08-11 15:20,4326,3413,913,625167,540047,85120,452644027.0,372761198.0,79882829.0,4218,3351,867,616802,536210,80592,446968432.0,370047849.0,76920583.0,0.6902,0.9385,0.6901,0.9544
2023-08-11 15:25,2996,1422,1574,424876,249435,175441,293681029.0,172151201.0,121529827.0,2941,1386,1555,420783,247695,173088,290849909.0,170940173.0,119909735.0,0.6902,0.6927,0.6901,0.6928
2023-08-11 15:30,2075,1258,817,301650,214361,87289,208445557.0,147965040.0,60480516.0,2048,1245,803,305248,219658,85590,210856687.0,151555732.0,59300955.0,0.6903,0.6929,0.69,0.6928
2023-08-11 15:35,2931,1897,1034,479187,378058,101129,331093339.0,261030009.0,70063329.0,2896,1874,1022,478090,377490,100600,330294996.0,260596483.0,69698512.0,0.6904,0.6928,0.6903,0.6928
2023-08-11 15:40,1731,1308,423,349337,303650,45687,241310548.0,209640464.0,31670084.0,1704,1293,411,348740,303401,45339,240870417.0,209444447.0,31425969.0,0.6904,0.6932,0.6903,0.6931
2023-08-11 15:45,2013,1496,517,346714,288109,58605,239445345.0,198829969.0,40615376.0,1996,1486,510,346581,288171,58410,239344855.0,198859995.0,40484860.0,0.6901,0.693,0.6901,0.6931
2023-08-11 15:50,2122,1600,522,312430,252358,60072,215801756.0,174152539.0,41649217.0,2096,1593,503,310027,251692,58335,214109755.0,173680172.0,40429583.0,0.6901,0.6933,0.6901,0.6931
2023-08-11 15:55,2460,1972,488,388138,346086,42052,268111298.0,238969808.0,29141489.0,2424,1955,469,385758,343435,42323,266456877.0,237119166.0,29337711.0,0.6905,0.693,0.6904,0.6932
2023-08-11 16:00,3695,1670,2025,426108,198761,227347,294445051.0,137194731.0,157250319.0,3642,1647,1995,422540,197413,225127,292113178.0,136260610.0,155852567.0,0.6902,0.6917,0.6902,0.6923
2023-08-11 16:05,2251,1562,689,340023,259237,80786,234903883.0,178990096.0,55913787.0,2225,1546,679,339097,258490,80607,234279331.0,178471369.0,55807962.0,0.6904,0.6921,0.6904,0.6923
2023-08-11 16:10,2022,1162,860,289055,163432,125623,199837377.0,112860176.0,86977201.0,1984,1136,848,288785,163045,125740,199647181.0,112569036.0,87078145.0,0.6906,0.6924,0.6904,0.6925
2023-08-11 16:15,1988,456,1532,353336,52800,300536,254789303.0,36441994.0,218347309.0,1977,443,1534,351510,52701,298809,253655424.0,36349307.0,217306117.0,0.6902,0.7265,0.6897,0.7272
2023-08-11 16:20,1992,1114,878,312537,137078,175459,216149065.0,94747901.0,121401163.0,1969,1101,868,310097,134650,175447,214324988.0,92929795.0,121395192.0,0.6912,0.6919,0.6902,0.6919
2023-08-11 16:25,3438,2973,465,592562,535626,56936,441414866.0,370274347.0,71140519.0,3374,2947,427,589418,533441,55977,439023515.0,368597606.0,70425909.0,0.6913,1.2495,0.691,1.2581
2023-08-11 16:30,3124,2445,679,555184,478162,77022,404917440.0,330658925.0,74258515.0,3046,2407,639,549903,477209,72694,401451863.0,329984778.0,71467084.0,0.6915,0.9641,0.6915,0.9831
2023-08-11 16:35,5078,684,4394,740113,90613,649500,533230901.0,62500152.0,470730749.0,5045,669,4376,738891,90098,648793,532473099.0,62144840.0,470328259.0,0.6897,0.7248,0.6897,0.7249
2023-08-11 16:40,3459,397,3062,635888,52076,583812,440385286.0,35886868.0,404498418.0,3444,387,3057,626503,51868,574635,433548020.0,35741445.0,397806575.0,0.6891,0.6929,0.6891,0.6923
2023-08-11 16:45,6197,937,5260,1180041,108769,1071272,816091759.0,74934967.0,741156792.0,6182,921,5261,1178054,108232,1069822,814797723.0,74563070.0,740234653.0,0.6889,0.6918,0.6889,0.6919
2023-08-11 16:50,6510,1116,5394,1155566,92255,1063311,829249763.0,63510421.0,765739342.0,6461,1092,5369,1150333,90464,1059869,826092472.0,62276285.0,763816187.0,0.6884,0.7201,0.6884,0.7207
2023-08-11 16:55,4562,572,3990,907281,45360,861921,625979868.0,31164707.0,594815160.0,4530,552,3978,905833,44561,861272,625150830.0,30612013.0,594538817.0,0.6871,0.6901,0.687,0.6903
2023-08-11 17:00,1753,222,1531,268570,14317,254253,195181934.0,9848717.0,185333216.0,1722,191,1531,263708,12189,251519,192311962.0,8381533.0,183930428.0,0.6879,0.7289,0.6876,0.7313
2023-08-11 17:05,4113,1087,3026,616215,80229,535986,424505170.0,55058136.0,369447033.0,4090,1075,3015,615294,79404,535890,423855545.0,54458484.0,369397060.0,0.6863,0.6893,0.6858,0.6893
2023-08-11 17:10,4758,1603,3155,546996,159524,387472,387090486.0,109479144.0,277611342.0,4723,1590,3133,546703,159779,386924,386849959.0,109628146.0,277221812.0,0.6863,0.7165,0.6861,0.7165
2023-08-11 17:15,3987,1157,2830,436121,126081,310040,300381965.0,86557250.0,213824715.0,3980,1154,2826,436455,126411,310044,300609605.0,86771249.0,213838356.0,0.6865,0.6897,0.6864,0.6897
2023-08-11 17:20,4884,1249,3635,583867,128354,455513,402138588.0,88080460.0,314058127.0,4861,1237,3624,582099,127636,454463,400978851.0,87584756.0,313394095.0,0.6862,0.6895,0.6862,0.6896
2023-08-11 17:25,4075,1385,2690,575234,196865,378369,416934160.0,135189584.0,281744576.0,4036,1364,2672,573090,195361,377729,415454268.0,134134432.0,281319836.0,0.6867,0.7446,0.6866,0.7448
2023-08-11 17:30,1748,802,946,236746,159968,76778,162659770.0,109784833.0,52874937.0,1724,787,937,235881,159584,76297,162085111.0,109510158.0,52574953.0,0.6863,0.6887,0.6862,0.6891
2023-08-11 17:35,1602,1020,582,225109,178726,46383,154914334.0,122896410.0,32017924.0,1570,1003,567,223526,177784,45742,153735819.0,122157804.0,31578014.0,0.6876,0.6903,0.6871,0.6904
2023-08-11 17:40,3009,1749,1260,450686,305380,145306,310228748.0,209801120.0,100427627.0,2997,1739,1258,450132,304516,145616,309852453.0,209207019.0,100645434.0,0.687,0.6911,0.687,0.6912
2023-08-11 17:45,2797,1890,907,475301,389368,85933,337511488.0,267622088.0,69889399.0,2767,1875,892,474732,389550,85182,337008275.0,267673317.0,69334957.0,0.6873,0.8133,0.6871,0.814
2023-08-11 17:50,3015,1280,1735,477827,264038,213789,329314279.0,181548795.0,147765484.0,2998,1271,1727,477266,263670,213596,328909976.0,181272499.0,147637477.0,0.6876,0.6912,0.6875,0.6912
2023-08-11 17:55,1261,530,731,214892,124714,90178,148091309.0,85721203.0,62370105.0,1242,519,723,214902,124957,89945,148091770.0,85881241.0,62210528.0,0.6873,0.6916,0.6873,0.6917
2023-08-11 18:00,1296,864,432,175606,147463,28143,120863928.0,101401005.0,19462923.0,1279,857,422,175848,147862,27986,120985779.0,101633322.0,19352457.0,0.6876,0.6916,0.6874,0.6915
2023-08-11 18:05,2224,1375,849,360348,266621,93727,248378071.0,183597323.0,64780747.0,2188,1363,825,358856,265881,92975,247357984.0,183057631.0,64300352.0,0.6886,0.6912,0.6885,0.6916
2023-08-11 18:10,2640,1773,867,480879,388126,92753,331598125.0,267415512.0,64182612.0,2601,1748,853,480096,387330,92766,331048974.0,266854451.0,64194523.0,0.689,0.692,0.689,0.692
2023-08-11 18:15,2537,1837,700,458830,406143,52687,316278264.0,279816863.0,36461400.0,2533,1842,691,457918,406036,51882,315620923.0,279705980.0,35914943.0,0.689,0.692,0.6889,0.6922
2023-08-11 18:20,2109,1526,583,431961,402602,29359,297578116.0,277262923.0,20315192.0,2093,1517,576,430777,401535,29242,296759943.0,276517991.0,20241951.0,0.6887,0.692,0.6887,0.6922
2023-08-11 18:25,2824,2327,497,443078,421663,21415,327114431.0,291191420.0,35923011.0,2769,2302,467,436341,416979,19362,322142650.0,287689532.0,34453117.0,0.6906,1.6775,0.6899,1.7794
2023-08-11 18:30,1795,1245,550,285634,264621,21013,197074479.0,182516874.0,14557605.0,1769,1228,541,284523,264184,20339,196269138.0,182171964.0,14097174.0,0.6897,0.6928,0.6896,0.6931
2023-08-11 18:35,3054,2631,423,551854,532013,19841,391835622.0,367515633.0,24319989.0,3005,2610,395,547636,529287,18349,388677625.0,365399011.0,23278613.0,0.6908,1.2257,0.6904,1.2687
2023-08-14 10:00,4256,2821,1435,455498,387012,68486,574666791.0,269650396.0,305016394.0,3331,2480,851,419052,367129,51923,538492118.0,256231530.0,282260587.0,0.6967,4.4537,0.6979,5.4361
2023-08-14 10:05,1524,955,569,154136,118857,35279,150553727.0,83119270.0,67434457.0,1216,832,384,142907,115518,27389,142740529.0,80747856.0,61992673.0,0.6993,1.9115,0.699,2.2634
2023-08-14 10:10,1045,640,405,88069,46388,41681,61819958.0,32423483.0,29396475.0,893,581,312,78581,42711,35870,55078192.0,29804852.0,25273339.0,0.699,0.7053,0.6978,0.7046
2023-08-14 10:15,784,379,405,65018,31460,33558,45579576.0,21962320.0,23617256.0,665,335,330,59267,31046,28221,41517406.0,21646210.0,19871195.0,0.6981,0.7038,0.6972,0.7041
2023-08-14 10:20,3364,1834,1530,331757,200484,131273,383374657.0,141625699.0,241748958.0,2534,1409,1125,270209,165787,104422,339905498.0,116456606.0,223448892.0,0.7064,1.8416,0.7024,2.1399
2023-08-14 10:25,1279,640,639,131152,97998,33154,102877227.0,68892586.0,33984640.0,987,510,477,120120,95552,24568,95261499.0,67029479.0,28232020.0,0.703,1.0251,0.7015,1.1491
2023-08-14 10:30,2894,2062,832,298119,243654,54465,263753709.0,171635582.0,92118127.0,2702,1976,726,290802,239618,51184,258530248.0,168635932.0,89894316.0,0.7044,1.6913,0.7038,1.7563
2023-08-14 10:35,1553,1248,305,162862,147978,14884,125813973.0,104512983.0,21300990.0,1380,1173,207,153251,143833,9418,118817012.0,101400104.0,17416907.0,0.7063,1.4311,0.705,1.8493
2023-08-14 10:40,2420,1660,760,233800,174247,59553,207940653.0,123069131.0,84871521.0,2207,1576,631,215959,164413,51546,195488850.0,116025737.0,79463112.0,0.7063,1.4251,0.7057,1.5416
2023-08-14 10:45,1734,1394,340,166971,141511,25460,118085752.0,100109889.0,17975862.0,1575,1331,244,161785,138157,23628,114350421.0,97484476.0,16865945.0,0.7074,0.706,0.7056,0.7138
2023-08-14 10:50,1635,1132,503,186794,145466,41328,131959156.0,102657685.0,29301471.0,1459,1053,406,165704,143574,22130,117001843.0,101279026.0,15722817.0,0.7057,0.709,0.7054,0.7105
2023-08-14 10:55,1601,1183,418,103156,69328,33828,94028451.0,48614492.0,45413959.0,1516,1140,376,99601,65915,33686,91824732.0,46443335.0,45381397.0,0.7012,1.3425,0.7046,1.3472
2023-08-14 11:00,778,536,242,65496,37945,27551,57063948.0,26741397.0,30322551.0,702,504,198,62616,37362,25254,55087841.0,26329037.0,28758803.0,0.7047,1.1006,0.7047,1.1388
2023-08-14 11:05,836,396,440,82087,26889,55198,68476554.0,18751258.0,49725296.0,732,343,389,72113,22366,49747,61571990.0,15728592.0,45843397.0,0.6974,0.9009,0.7032,0.9215
2023-08-14 11:10,740,467,273,58768,12383,46385,41372282.0,8711271.0,32661011.0,666,413,253,57118,11178,45940,40294520.0,7863779.0,32430741.0,0.7035,0.7041,0.7035,0.7059
2023-08-14 11:15,940,226,714,90014,6442,83572,74155165.0,4519302.0,69635863.0,757,121,636,88707,5891,82816,73278914.0,4135781.0,69143133.0,0.7015,0.8332,0.7021,0.8349
2023-08-14 11:20,850,335,515,80189,32739,47450,56533256.0,22988600.0,33544656.0,804,314,490,77256,31800,45456,54371216.0,22320311.0,32050904.0,0.7022,0.7069,0.7019,0.7051
2023-08-14 11:25,843,304,539,119024,27136,91888,94249224.0,19028157.0,75221067.0,755,259,496,114435,24710,89725,91163906.0,17314765.0,73849141.0,0.7012,0.8186,0.7007,0.8231
2023-08-14 11:30,486,128,358,52900,10085,42815,47383322.0,7121364.0,40261958.0,378,66,312,40884,6454,34430,39364624.0,4476779.0,34887844.0,0.7061,0.9404,0.6936,1.0133
2023-08-14 11:35,235,73,162,20817,6202,14615,14610909.0,4345828.0,10265081.0,161,35,126,18349,5330,13019,12876762.0,3714747.0,9162015.0,0.7007,0.7024,0.697,0.7037
2023-08-14 11:40,705,124,581,75868,14762,61106,53211218.0,10310700.0,42900517.0,633,82,551,74363,13935,60428,52158287.0,9711119.0,42447168.0,0.6985,0.7021,0.6969,0.7024
2023-08-14 11:45,1771,808,963,213732,104316,109416,182692093.0,73298165.0,109393928.0,1698,764,934,202506,97360,105146,174510250.0,68292931.0,106217319.0,0.7027,0.9998,0.7014,1.0102
2023-08-14 11:50,1814,623,1191,223338,107020,116318,167639955.0,75022914.0,92617041.0,1775,601,1174,222166,106288,115878,166877960.0,74492064.0,92385896.0,0.701,0.7962,0.7009,0.7973
2023-08-14 11:55,2876,1778,1098,282625,156969,125656,209513720.0,110216692.0,99297027.0,2831,1750,1081,280895,156427,124468,208238369.0,109818044.0,98420325.0,0.7022,0.7902,0.702,0.7907
2023-08-14 12:00,2531,2172,359,183996,162539,21457,129373876.0,114194675.0,15179200.0,2490,2155,335,181616,161412,20204,127655646.0,113395896.0,14259750.0,0.7026,0.7074,0.7025,0.7058
2023-08-14 12:05,2368,1657,711,251503,204106,47397,176754578.0,143331577.0,33423001.0,2336,1647,689,251111,204506,46605,176468222.0,143607089.0,32861133.0,0.7022,0.7052,0.7022,0.7051
2023-08-14 12:10,2828,1741,1087,291519,227365,64154,204718428.0,159508136.0,45210292.0,2781,1720,1061,291432,226825,64607,204679309.0,159146519.0,45532790.0,0.7016,0.7047,0.7016,0.7048
2023-08-14 12:15,1670,849,821,181051,148561,32490,127108337.0,104217619.0,22890718.0,1618,834,784,179352,147483,31869,125968691.0,103501075.0,22467615.0,0.7015,0.7045,0.7018,0.705
2023-08-14 12:20,627,325,302,72597,40172,32425,50891477.0,28165838.0,22725639.0,584,294,290,68791,38311,30480,48369020.0,26885613.0,21483406.0,0.7011,0.7009,0.7018,0.7048
2023-08-14 12:25,1150,751,399,106144,47399,58745,74651987.0,33315572.0,41336415.0,1103,719,384,104300,46349,57951,73395554.0,32540246.0,40855308.0,0.7029,0.7037,0.7021,0.705
2023-08-14 12:30,845,599,246,77261,45413,31848,54391348.0,31889481.0,22501866.0,799,571,228,75456,45192,30264,53086672.0,31728581.0,21358090.0,0.7022,0.7065,0.7021,0.7057
2023-08-14 12:35,792,324,468,63356,21412,41944,44535823.0,15038607.0,29497216.0,758,312,446,61947,21071,40876,43603370.0,14794786.0,28808583.0,0.7023,0.7033,0.7021,0.7048
2023-08-14 12:40,972,492,480,71051,28442,42609,60653017.0,19977713.0,40675303.0,930,469,461,65750,25304,40446,56960006.0,17754139.0,39205866.0,0.7024,0.9546,0.7016,0.9693
2023-08-14 12:45,332,118,214,25549,6612,18937,17970465.0,4645742.0,13324722.0,296,100,196,28307,10879,17428,19850592.0,7580604.0,12269988.0,0.7026,0.7036,0.6968,0.704
2023-08-14 12:50,366,112,254,52463,5690,46773,36843678.0,3984653.0,32859024.0,358,108,250,53321,6174,47147,37442997.0,4317155.0,33125841.0,0.7003,0.7025,0.6992,0.7026
2023-08-14 12:55,907,234,673,122691,16493,106198,96757769.0,11554091.0,85203678.0,859,208,651,119235,14997,104238,94382110.0,10496772.0,83885338.0,0.7005,0.8023,0.6999,0.8047
2023-08-14 13:00,960,162,798,99442,12397,87045,80481696.0,8691124.0,71790571.0,936,146,790,98783,11416,87367,80018770.0,7993650.0,72025120.0,0.7011,0.8248,0.7002,0.8244
2023-08-14 13:05,231,105,126,19158,6073,13085,13475059.0,4278386.0,9196673.0,202,91,111,17407,5552,11855,12232174.0,3888180.0,8343994.0,0.7045,0.7028,0.7003,0.7038
2023-08-14 13:10,388,68,320,23587,5688,17899,16583658.0,3994363.0,12589295.0,359,48,311,21962,4244,17718,15417668.0,2967476.0,12450192.0,0.7022,0.7034,0.6992,0.7027
2023-08-14 13:15,393,144,249,36765,11356,25409,25805135.0,7953269.0,17851866.0,366,124,242,36156,10840,25316,25379458.0,7592124.0,17787334.0,0.7004,0.7026,0.7004,0.7026
2023-08-14 13:20,563,444,119,65226,49834,15392,67515107.0,35221114.0,32293993.0,430,342,88,57991,43873,14118,62164003.0,30817850.0,31346153.0,0.7068,2.0981,0.7024,2.2203
2023-08-14 13:25,1013,839,174,112216,95816,16400,78998502.0,67498092.0,11500409.0,885,766,119,105640,93316,12324,74398381.0,65684568.0,8713813.0,0.7045,0.7012,0.7039,0.7071
2023-08-14 13:30,974,875,99,85786,80826,4960,60400497.0,56913481.0,3487015.0,918,837,81,85909,80231,5678,60477194.0,56461541.0,4015653.0,0.7041,0.703,0.7037,0.7072
2023-08-14 13:35,305,224,81,29234,22707,6527,20580841.0,16023172.0,4557669.0,254,192,62,26707,21387,5320,18829074.0,15068139.0,3760935.0,0.7056,0.6983,0.7045,0.7069
2023-08-14 13:40,406,274,132,47066,32500,14566,33310231.0,23017988.0,10292243.0,363,249,114,42943,30928,12015,30289495.0,21792727.0,8496768.0,0.7082,0.7066,0.7046,0.7072
2023-08-14 13:45,416,312,104,49357,41492,7865,34751155.0,29222756.0,5528398.0,377,288,89,46483,40239,6244,32743678.0,28312003.0,4431674.0,0.7043,0.7029,0.7036,0.7097
2023-08-14 13:50,464,305,159,48507,35646,12861,34136314.0,25080038.0,9056276.0,437,288,149,48062,35852,12210,33852940.0,25225109.0,8627831.0,0.7036,0.7042,0.7036,0.7066
2023-08-14 13:55,545,421,124,79843,70794,9049,56235822.0,49846001.0,6389821.0,505,399,106,78369,67943,10426,55153247.0,47784646.0,7368601.0,0.7041,0.7061,0.7033,0.7068
2023-08-14 14:00,184,139,45,20125,15986,4139,14199102.0,11249968.0,2949133.0,156,122,34,19103,15571,3532,13455496.0,10951903.0,2503593.0,0.7037,0.7125,0.7034,0.7088
2023-08-14 14:05,443,400,43,37830,32883,4947,26650065.0,23161719.0,3488345.0,410,382,28,35337,32306,3031,24897598.0,22749140.0,2148458.0,0.7044,0.7051,0.7042,0.7088
2023-08-14 14:10,197,119,78,23709,13571,10138,16419945.0,9552047.0,6867897.0,151,97,54,19948,12274,7674,14089599.0,8637567.0,5452031.0,0.7039,0.6774,0.7037,0.7105
2023-08-14 14:15,971,495,476,96390,32413,63977,67970052.0,22853507.0,45116545.0,932,470,462,95072,31248,63824,66992805.0,21967132.0,45025673.0,0.7051,0.7052,0.703,0.7055
2023-08-14 14:20,382,224,158,49579,22747,26832,45626165.0,15992360.0,29633805.0,354,213,141,48003,22810,25193,44544278.0,16037123.0,28507155.0,0.7031,1.1044,0.7031,1.1316
2023-08-14 14:25,381,132,249,25978,10300,15678,18296917.0,7249491.0,11047425.0,366,120,246,25960,9801,16159,18275176.0,6881219.0,11393957.0,0.7038,0.7046,0.7021,0.7051
2023-08-14 14:30,137,65,72,12252,4394,7858,19305346.0,3089745.0,16215601.0,105,50,55,10659,3870,6789,18216543.0,2714307.0,15502236.0,0.7032,2.0636,0.7014,2.2834
2023-08-14 14:35,101,38,63,19058,1513,17545,13527260.0,1108536.0,12418723.0,73,22,51,19039,1502,17537,13489454.0,1051897.0,12437556.0,0.7327,0.7078,0.7003,0.7092
2023-08-14 14:40,112,52,60,9719,3737,5982,6828246.0,2625773.0,4202472.0,87,38,49,8907,3261,5646,6265636.0,2287531.0,3978105.0,0.7026,0.7025,0.7015,0.7046
2023-08-14 14:45,117,55,62,10886,4870,6016,7679047.0,3443595.0,4235451.0,101,48,53,10041,4138,5903,7057650.0,2901833.0,4155817.0,0.7071,0.704,0.7013,0.704
2023-08-14 14:50,456,106,350,34231,7427,26804,24062708.0,5208000.0,18854707.0,438,92,346,34549,7403,27146,24294748.0,5187346.0,19107401.0,0.7012,0.7034,0.7007,0.7039
2023-08-14 14:55,226,48,178,28552,5291,23261,20069916.0,3712310.0,16357606.0,210,38,172,28709,5466,23243,20181833.0,3825941.0,16355892.0,0.7016,0.7032,0.7,0.7037
2023-08-14 15:00,184,97,87,15568,6290,9278,10916547.0,4400096.0,6516451.0,158,81,77,14188,5784,8404,9967861.0,4053654.0,5914206.0,0.6995,0.7024,0.7008,0.7037
2023-08-14 15:05,367,190,177,32215,12280,19935,33259249.0,8690580.0,24568669.0,319,169,150,27816,11536,16280,30223314.0,8094071.0,22129243.0,0.7077,1.2324,0.7016,1.3593
2023-08-14 15:10,347,227,120,32000,12607,19393,22149471.0,8825497.0,13323974.0,316,204,112,25258,8378,16880,17719939.0,5862521.0,11857418.0,0.7,0.6871,0.6998,0.7025
2023-08-14 15:15,200,76,124,22868,2676,20192,16050553.0,1878638.0,14171914.0,178,59,119,19546,1811,17735,13714488.0,1264902.0,12449585.0,0.702,0.7019,0.6985,0.702
2023-08-14 15:20,1718,325,1393,282641,26326,256315,219587650.0,18406819.0,201180830.0,1663,286,1377,278021,22590,255431,216383453.0,15792218.0,200591234.0,0.6992,0.7849,0.6991,0.7853
2023-08-14 15:25,1606,394,1212,229008,20530,208478,160700170.0,14367683.0,146332487.0,1593,388,1205,229209,20408,208801,160861155.0,14267699.0,146593456.0,0.6998,0.7019,0.6991,0.7021
2023-08-14 15:30,1216,429,787,142758,49590,93168,100198017.0,34813885.0,65384132.0,1181,404,777,141057,48173,92884,98953054.0,33746310.0,65206744.0,0.702,0.7018,0.7005,0.702
2023-08-14 15:35,2164,1417,747,255666,208864,46802,190025907.0,146440896.0,43585011.0,2138,1403,735,254163,208618,45545,188925422.0,146241859.0,42683562.0,0.7011,0.9313,0.701,0.9372
2023-08-14 15:40,865,450,415,86810,66332,20478,60955360.0,46518905.0,14436455.0,835,434,401,85321,66083,19238,59864435.0,46332156.0,13532279.0,0.7013,0.705,0.7011,0.7034
2023-08-14 15:45,456,189,267,33722,21180,12542,23831309.0,14850439.0,8980870.0,428,172,256,33151,20079,13072,23423451.0,14075821.0,9347630.0,0.7012,0.7161,0.701,0.7151
2023-08-14 15:50,85,57,28,6299,3780,2519,4412601.0,2663251.0,1749349.0,54,34,20,4303,2939,1364,3018568.0,2057060.0,961508.0,0.7046,0.6945,0.6999,0.7049
2023-08-14 15:55,225,133,92,24141,18215,5926,16924944.0,12775177.0,4149766.0,207,124,83,23168,17948,5220,16247040.0,12573522.0,3673518.0,0.7014,0.7003,0.7006,0.7037
2023-08-14 16:00,1635,750,885,219227,153878,65349,153764720.0,107976307.0,45788412.0,1602,733,869,216670,153243,63427,152075912.0,107520448.0,44555464.0,0.7017,0.7007,0.7016,0.7025
2023-08-14 16:05,222,123,99,15756,6911,8845,11057717.0,4839635.0,6218082.0,202,109,93,15179,6735,8444,10652367.0,4714917.0,5937450.0,0.7003,0.703,0.7001,0.7032
2023-08-14 16:10,784,188,596,81886,9250,72636,67869605.0,6472877.0,61396728.0,753,167,586,79341,8496,70845,66322423.0,5940672.0,60381750.0,0.6998,0.8453,0.6992,0.8523
2023-08-14 16:15,2125,760,1365,396654,11126,385528,278187012.0,7801664.0,270385347.0,2096,739,1357,395570,10272,385298,277427911.0,7184740.0,270243171.0,0.7012,0.7013,0.6994,0.7014
2023-08-14 16:20,262,110,152,28321,6155,22166,19897775.0,4359341.0,15538434.0,247,104,143,28202,6588,21614,19795340.0,4607552.0,15187788.0,0.7083,0.701,0.6994,0.7027
2023-08-14 16:25,425,347,78,27261,19001,8260,19122032.0,13313094.0,5808938.0,417,341,76,27479,19183,8296,19263302.0,13430345.0,5832957.0,0.7007,0.7033,0.7001,0.7031
2023-08-14 16:30,350,226,124,30406,15449,14957,21303934.0,10819435.0,10484498.0,317,211,106,29579,15128,14451,20758568.0,10593678.0,10164890.0,0.7003,0.701,0.7003,0.7034
2023-08-14 16:35,82,51,31,4042,1520,2522,2842717.0,1064970.0,1777747.0,64,37,27,3851,1364,2487,2707579.0,955015.0,1752564.0,0.7006,0.7049,0.7002,0.7047
2023-08-14 16:40,157,69,88,13810,4547,9263,9623014.0,3182249.0,6440765.0,132,54,78,11631,2817,8814,8163007.0,1971076.0,6191931.0,0.6999,0.6953,0.6997,0.7025
2023-08-14 16:45,294,112,182,31240,7028,24212,21885741.0,4901449.0,16984291.0,273,102,171,30090,6974,23116,21103239.0,4877102.0,16226136.0,0.6974,0.7015,0.6993,0.7019
2023-08-14 16:50,431,124,307,73127,5794,67333,51302285.0,4053537.0,47248747.0,411,102,309,72961,5519,67442,51189202.0,3858897.0,47330305.0,0.6996,0.7017,0.6992,0.7018
2023-08-14 16:55,210,101,109,22108,3235,18873,15539176.0,2293679.0,13245497.0,188,84,104,21719,2221,19498,15238659.0,1553191.0,13685468.0,0.709,0.7018,0.6993,0.7019
2023-08-14 17:00,846,232,614,77920,10786,67134,54444651.0,7621001.0,46823649.0,783,195,588,71079,7534,63545,49849614.0,5275951.0,44573663.0,0.7066,0.6975,0.7003,0.7015
2023-08-14 17:05,240,178,62,29343,25268,4075,20563893.0,17687449.0,2876443.0,216,168,48,29042,25907,3135,20326393.0,18122260.0,2204133.0,0.7,0.7059,0.6995,0.7031
2023-08-14 17:10,2462,811,1651,379344,59746,319598,317950561.0,41686788.0,276263773.0,2326,736,1590,370603,54829,315774,312340242.0,38264954.0,274075287.0,0.6977,0.8644,0.6979,0.8679
2023-08-14 17:15,2471,947,1524,325736,38035,287701,309255491.0,26236319.0,283019171.0,2141,724,1417,305655,31980,273675,296188955.0,22035602.0,274153353.0,0.6898,0.9837,0.689,1.0017
2023-08-14 17:20,3907,2680,1227,450756,320262,130494,392592941.0,219380878.0,173212063.0,3536,2440,1096,430700,311596,119104,378891438.0,213275361.0,165616077.0,0.685,1.3274,0.6845,1.3905
2023-08-14 17:25,3063,2145,918,357680,260951,96729,286010903.0,178119862.0,107891041.0,2836,1998,838,344614,253913,90701,277379293.0,173332389.0,104046904.0,0.6826,1.1154,0.6826,1.1471
2023-08-14 17:30,4231,1223,3008,455984,65082,390902,607592170.0,44089253.0,563502917.0,3668,835,2833,441266,56640,384626,598280984.0,38289234.0,559991749.0,0.6774,1.4415,0.676,1.4559
2023-08-14 17:35,2980,1878,1102,280866,206928,73938,272704411.0,139792403.0,132912007.0,2615,1641,974,268782,200800,67982,263898876.0,135377406.0,128521470.0,0.6756,1.7976,0.6742,1.8905
2023-08-14 17:40,4598,1012,3586,559953,96766,463187,515399250.0,66067793.0,449331456.0,4363,876,3487,551653,92880,458773,509334004.0,62876509.0,446457495.0,0.6828,0.9701,0.677,0.9732
2023-08-14 17:45,3218,1037,2181,278318,67537,210781,199848463.0,45801608.0,154046855.0,3055,929,2126,276028,64854,211174,198466869.0,43932142.0,154534727.0,0.6782,0.7308,0.6774,0.7318
2023-08-14 17:50,1179,405,774,72527,30577,41950,59687269.0,20817031.0,38870238.0,1058,347,711,65879,27014,38865,55265555.0,18356577.0,36908978.0,0.6808,0.9266,0.6795,0.9497
2023-08-14 17:55,926,700,226,72589,55560,17029,60283584.0,38195378.0,22088205.0,788,602,186,64797,49672,15125,54666136.0,33888601.0,20777535.0,0.6875,1.2971,0.6822,1.3737
2023-08-14 18:00,2233,963,1270,222594,99244,123350,183659275.0,67759191.0,115900083.0,2133,904,1229,216779,96676,120103,179761629.0,65999031.0,113762598.0,0.6828,0.9396,0.6827,0.9472
2023-08-14 18:05,1959,398,1561,220890,13043,207847,181963350.0,8924484.0,173038865.0,1828,316,1512,217648,10645,207003,180017198.0,7270032.0,172747165.0,0.6842,0.8325,0.683,0.8345
2023-08-14 18:10,3670,1038,2632,404731,35017,369714,530949871.0,24770623.0,506179248.0,3168,736,2432,381442,22528,358914,515219151.0,15836514.0,499382636.0,0.7074,1.3691,0.703,1.3914
2023-08-14 18:15,1882,651,1231,131672,50322,81350,159548718.0,33724190.0,125824527.0,1591,470,1121,107417,39907,67510,144586672.0,27912557.0,116674115.0,0.6702,1.5467,0.6994,1.7282
2023-08-14 18:20,1530,371,1159,112082,35891,76191,146857722.0,24281734.0,122575988.0,1357,271,1086,100246,30515,69731,139030942.0,20435123.0,118595819.0,0.6765,1.6088,0.6697,1.7008
2023-08-14 18:25,2340,620,1720,284972,53871,231101,211551166.0,36155207.0,175395958.0,2205,526,1679,281835,49348,232487,209402606.0,33011258.0,176391347.0,0.6711,0.759,0.6689,0.7587
2023-08-14 18:30,2452,739,1713,210858,103201,107657,193091144.0,69235340.0,123855803.0,2348,673,1675,203998,101244,102754,188428052.0,67860743.0,120567309.0,0.6709,1.1505,0.6703,1.1734
2023-08-14 18:35,1724,286,1438,173767,13025,160742,177843084.0,8800453.0,169042631.0,1563,175,1388,170229,13081,157148,175880004.0,8772385.0,167107619.0,0.6757,1.0516,0.6706,1.0634
2023-08-15 10:00,6808,3477,3331,809815,370072,439743,1232304552.0,247761168.0,984543384.0,5035,2577,2458,698528,310862,387666,1148558128.0,207368282.0,941189845.0,0.6695,2.2389,0.6671,2.4278
2023-08-15 10:05,8325,4027,4298,838466,314930,523536,1725990123.0,210387671.0,1515602451.0,7186,3380,3806,746427,278173,468254,1664912048.0,185025684.0,1479886364.0,0.668,2.8949,0.6651,3.1604
2023-08-15 10:10,3977,1499,2478,357851,86628,271223,387341631.0,57344790.0,329996841.0,3252,1092,2160,337859,75782,262077,374958897.0,49957987.0,325000909.0,0.662,1.2167,0.6592,1.2401
2023-08-15 10:15,4646,1433,3213,434071,55784,378287,474547620.0,36598575.0,437949045.0,3914,968,2946,415461,44276,371185,462580656.0,28968279.0,433612377.0,0.6561,1.1577,0.6543,1.1682
2023-08-15 10:20,2642,1346,1296,172936,87383,85553,165417298.0,57829331.0,107587967.0,2175,1107,1068,158134,78957,79177,155461607.0,52071747.0,103389860.0,0.6618,1.2576,0.6595,1.3058
2023-08-15 10:25,3866,846,3020,381338,56167,325171,343886272.0,37119256.0,306767016.0,3568,685,2883,378385,53447,324938,341990664.0,35290843.0,306699820.0,0.6609,0.9434,0.6603,0.9439
2023-08-15 10:30,3649,1444,2205,355179,81384,273795,581423870.0,53252900.0,528170970.0,3185,1180,2005,336836,73366,263470,570298809.0,47952147.0,522346662.0,0.6543,1.9291,0.6536,1.9826
2023-08-15 10:35,2806,1786,1020,249563,189197,60366,233899987.0,123891110.0,110008877.0,2482,1610,872,230302,183329,46973,220484087.0,119862540.0,100621547.0,0.6548,1.8224,0.6538,2.1421
2023-08-15 10:40,2621,1753,868,223075,173481,49594,258687617.0,114690080.0,143997537.0,2284,1560,724,211991,167634,44357,250952692.0,110522371.0,140430321.0,0.6611,2.9035,0.6593,3.1659
2023-08-15 10:45,1880,852,1028,156731,115846,40885,144571205.0,76767222.0,67803982.0,1652,763,889,149888,112829,37059,139991601.0,74683182.0,65308419.0,0.6627,1.6584,0.6619,1.7623
2023-08-15 10:50,1773,980,793,153401,108175,45226,182304544.0,71868636.0,110435908.0,1564,842,722,145751,103386,42365,176667991.0,68031678.0,108636313.0,0.6644,2.4419,0.658,2.5643
2023-08-15 10:55,1398,631,767,80733,42789,37944,73855543.0,28317946.0,45537597.0,1178,491,687,73273,37253,36020,68856340.0,24635660.0,44220680.0,0.6618,1.2001,0.6613,1.2277
2023-08-15 11:00,2609,1564,1045,241392,200959,40433,212470224.0,134442797.0,78027427.0,2381,1518,863,231419,196436,34983,205508644.0,131152257.0,74356386.0,0.669,1.9298,0.6677,2.1255
2023-08-15 11:05,1628,1106,522,150534,115863,34671,152116905.0,77596919.0,74519986.0,1284,965,319,142603,117384,25219,146271094.0,78001722.0,68269372.0,0.6697,2.1493,0.6645,2.7071
2023-08-15 11:10,3835,1561,2274,337933,117420,220513,436515149.0,77842740.0,358672409.0,3538,1379,2159,330774,113251,217523,432062671.0,74965471.0,357097200.0,0.6629,1.6265,0.6619,1.6417
2023-08-15 11:15,1946,1106,840,134533,47021,87512,89785508.0,31195245.0,58590262.0,1783,979,804,128165,44605,83560,85300785.0,29555872.0,55744912.0,0.6634,0.6695,0.6626,0.6671
2023-08-15 11:20,2114,975,1139,176168,29655,146513,158255712.0,19727965.0,138527747.0,1955,853,1102,172219,28234,143985,155740314.0,18789046.0,136951267.0,0.6652,0.9455,0.6655,0.9511
2023-08-15 11:25,1520,408,1112,134551,20086,114465,119623022.0,13307457.0,106315565.0,1426,361,1065,130488,18292,112196,117003430.0,12123768.0,104879661.0,0.6625,0.9288,0.6628,0.9348
2023-08-15 11:30,1149,225,924,141237,6511,134726,93748963.0,4298203.0,89450760.0,996,143,853,138254,6006,132248,91847179.0,3969381.0,87877798.0,0.6601,0.6639,0.6609,0.6645
2023-08-15 11:35,393,158,235,17700,3918,13782,21779942.0,2576453.0,19203489.0,280,87,193,14157,1674,12483,19554228.0,1115142.0,18439086.0,0.6576,1.3934,0.6662,1.4771
2023-08-15 11:40,2539,1552,987,217569,111428,106141,205613597.0,74126109.0,131487487.0,2401,1474,927,214282,108736,105546,203180994.0,72142701.0,131038292.0,0.6652,1.2388,0.6635,1.2415
2023-08-15 11:45,1223,1009,214,74544,57862,16682,49814753.0,38550527.0,11264225.0,1135,954,181,70069,56801,13268,46676802.0,37797294.0,8879507.0,0.6662,0.6752,0.6654,0.6692
2023-08-15 11:50,3065,869,2196,319384,41187,278197,242698889.0,27408446.0,215290442.0,2840,763,2077,315133,39333,275800,240161241.0,26161682.0,213999559.0,0.6655,0.7739,0.6651,0.7759
2023-08-15 11:55,542,109,433,67029,3848,63181,44524199.0,2554881.0,41969318.0,487,74,413,60471,2844,57627,40237510.0,1885789.0,38351721.0,0.664,0.6643,0.6631,0.6655
2023-08-15 12:00,2114,730,1384,212720,34694,178026,171382907.0,22921811.0,148461096.0,1982,639,1343,207563,29972,177591,167980189.0,19799711.0,148180477.0,0.6607,0.8339,0.6606,0.8344
2023-08-15 12:05,2125,1095,1030,168031,56752,111279,111631405.0,37508404.0,74123000.0,2042,1042,1000,166552,55832,110720,110633192.0,36880429.0,73752762.0,0.6609,0.6661,0.6606,0.6661
2023-08-15 12:10,2777,1533,1244,268323,114179,154144,199072204.0,76029597.0,123042606.0,2624,1422,1202,263643,111224,152419,195582211.0,73742955.0,121839256.0,0.6659,0.7982,0.663,0.7994
2023-08-15 12:15,1796,1295,501,138152,105327,32825,112232856.0,70036164.0,42196691.0,1712,1248,464,134286,103439,30847,109770312.0,68770881.0,40999431.0,0.6649,1.2855,0.6648,1.3291
2023-08-15 12:20,1460,1031,429,147503,119338,28165,118974967.0,79685442.0,39289524.0,1328,978,350,142098,116512,25586,115290361.0,77745945.0,37544416.0,0.6677,1.395,0.6673,1.4674
2023-08-15 12:25,1983,1134,849,201943,112898,89045,155697709.0,75512786.0,80184923.0,1894,1091,803,197465,111956,85509,152752914.0,74838304.0,77914610.0,0.6689,0.9005,0.6685,0.9112
2023-08-15 12:30,1466,879,587,108096,45202,62894,82598452.0,30212495.0,52385957.0,1413,846,567,103931,42332,61599,79800010.0,28287643.0,51512366.0,0.6684,0.8329,0.6682,0.8363
2023-08-15 12:35,1146,861,285,81772,62521,19251,64848098.0,41776580.0,23071518.0,1106,845,261,80510,62062,18448,63971094.0,41402791.0,22568302.0,0.6682,1.1985,0.6671,1.2233
2023-08-15 12:40,1212,796,416,100803,61050,39753,88059665.0,41032024.0,47027640.0,1153,773,380,95601,58681,36920,84454789.0,39255278.0,45199511.0,0.6721,1.183,0.669,1.2243
2023-08-15 12:45,1201,482,719,117463,42412,75051,78791303.0,28363482.0,50427821.0,1141,443,698,116894,42062,74832,78410743.0,28114541.0,50296201.0,0.6688,0.6719,0.6684,0.6721
2023-08-15 12:50,799,273,526,83285,26157,57128,55862237.0,17464644.0,38397592.0,721,203,518,77902,21187,56715,52306867.0,14188793.0,38118073.0,0.6677,0.6721,0.6697,0.6721
2023-08-15 12:55,402,80,322,50809,4725,46084,34232031.0,3166382.0,31065648.0,375,65,310,48896,4722,44174,32863392.0,3154953.0,29708439.0,0.6701,0.6741,0.6681,0.6725
2023-08-15 13:00,1478,335,1143,138227,22028,116199,92676107.0,14709893.0,77966214.0,1431,310,1121,135676,21709,113967,91117620.0,14495047.0,76622572.0,0.6678,0.671,0.6677,0.6723
2023-08-15 13:05,1897,311,1586,180544,22910,157634,121336544.0,15333837.0,106002707.0,1883,306,1577,178271,22354,155917,119665435.0,14936667.0,104728768.0,0.6693,0.6725,0.6682,0.6717
2023-08-15 13:10,1524,250,1274,134119,14880,119239,100363417.0,9968628.0,90394789.0,1477,208,1269,132130,13564,118566,99001229.0,9076019.0,89925209.0,0.6699,0.7581,0.6691,0.7584
2023-08-15 13:15,918,468,450,76369,21691,54678,82092848.0,14628256.0,67464592.0,830,418,412,72193,19171,53022,79281728.0,12875014.0,66406714.0,0.6744,1.2339,0.6716,1.2524
2023-08-15 13:20,711,369,342,55280,18028,37252,37232384.0,12124871.0,25107512.0,706,385,321,54816,18057,36759,36906695.0,12125683.0,24781012.0,0.6726,0.674,0.6715,0.6741
2023-08-15 13:25,1440,222,1218,105691,17247,88444,91382610.0,11558414.0,79824196.0,1389,194,1195,103699,16568,87131,90176854.0,11097240.0,79079614.0,0.6702,0.9025,0.6698,0.9076
2023-08-15 13:30,1548,196,1352,129418,20086,109332,96987322.0,13408349.0,83578972.0,1517,174,1343,128090,19492,108598,96181918.0,13005463.0,83176455.0,0.6675,0.7645,0.6672,0.7659
2023-08-15 13:35,2183,1100,1083,199765,94679,105086,154352045.0,63290825.0,91061219.0,2147,1080,1067,198281,93435,104846,153298874.0,62427807.0,90871066.0,0.6685,0.8665,0.6681,0.8667
2023-08-15 13:40,2706,2368,338,328831,306467,22364,282548137.0,205941457.0,76606680.0,2563,2308,255,318598,300500,18098,275566903.0,201785369.0,73781533.0,0.672,3.4254,0.6715,4.0768
2023-08-15 13:45,2432,2190,242,319372,309160,10212,246027650.0,208139334.0,37888316.0,2287,2134,153,314520,305913,8607,242527647.0,205779008.0,36748639.0,0.6732,3.7102,0.6727,4.2696
2023-08-15 13:50,2571,1989,582,283308,261628,21680,254114536.0,177142526.0,76972010.0,2351,1898,453,271805,254714,17091,245939064.0,172154510.0,73784553.0,0.6771,3.5504,0.6759,4.3172
2023-08-15 13:55,2391,1167,1224,163523,101527,61996,203956586.0,68744785.0,135211801.0,2184,1094,1090,157982,99650,58332,200253296.0,67433459.0,132819836.0,0.6771,2.181,0.6767,2.277
2023-08-15 14:00,2309,1156,1153,171411,81733,89678,239963119.0,55229705.0,184733414.0,2161,1083,1078,165971,79495,86476,236357063.0,53708344.0,182648719.0,0.6757,2.06,0.6756,2.1121
2023-08-15 14:05,1235,508,727,70270,28300,41970,78614803.0,19158991.0,59455812.0,1123,462,661,66721,25447,41274,76159800.0,17142102.0,59017698.0,0.677,1.4166,0.6736,1.4299
2023-08-15 14:10,1690,909,781,176492,126862,49630,213626803.0,86327047.0,127299755.0,1374,764,610,161899,119695,42204,203452084.0,81140961.0,122311122.0,0.6805,2.565,0.6779,2.8981
2023-08-15 14:15,1915,1471,444,193217,177476,15741,152548478.0,120908685.0,31639793.0,1795,1397,398,190900,176217,14683,150751894.0,119880308.0,30871585.0,0.6813,2.01,0.6803,2.1025
2023-08-15 14:20,1703,1258,445,91838,62811,29027,93725608.0,42814313.0,50911295.0,1563,1180,383,83810,58616,25194,88475182.0,39935297.0,48539885.0,0.6816,1.7539,0.6813,1.9266
2023-08-15 14:25,552,296,256,42742,22682,20060,50046088.0,15435502.0,34610585.0,467,249,218,39119,20427,18692,47481591.0,13869267.0,33612323.0,0.6805,1.7254,0.679,1.7982
2023-08-15 14:30,664,380,284,42643,26410,16233,39515023.0,17980192.0,21534831.0,583,332,251,40297,25805,14492,37913195.0,17557177.0,20356017.0,0.6808,1.3266,0.6804,1.4046
2023-08-15 14:35,1020,530,490,75646,45205,30441,82735897.0,30726143.0,52009754.0,949,472,477,72726,43247,29479,80776905.0,29409168.0,51367737.0,0.6797,1.7085,0.68,1.7425
2023-08-15 14:40,864,517,347,81946,71124,10822,66453384.0,48607357.0,17846026.0,800,474,326,76878,66734,10144,62763547.0,45427169.0,17336378.0,0.6834,1.6491,0.6807,1.709
2023-08-15 14:45,1066,620,446,91162,70783,20379,114796237.0,48533596.0,66262641.0,851,529,322,82374,66791,15583,108621409.0,45620744.0,63000664.0,0.6857,3.2515,0.683,4.0429
2023-08-15 14:50,735,581,154,48550,38481,10069,33391241.0,26447975.0,6943265.0,644,530,114,45133,38846,6287,30938493.0,26590675.0,4347818.0,0.6873,0.6896,0.6845,0.6916
2023-08-15 14:55,435,317,118,47044,39368,7676,42771354.0,27028087.0,15743267.0,356,284,72,43702,37854,5848,40488454.0,25968901.0,14519552.0,0.6865,2.051,0.686,2.4828
2023-08-15 15:00,553,352,201,43536,33498,10038,50893395.0,23039037.0,27854358.0,468,371,97,40135,34556,5579,48248396.0,23468335.0,24780060.0,0.6878,2.7749,0.6791,4.4417
2023-08-15 15:05,203,118,85,12655,8725,3930,19154128.0,6009106.0,13145021.0,113,53,60,7286,3935,3351,15450672.0,2683592.0,12767079.0,0.6887,3.3448,0.682,3.8099
2023-08-15 15:10,2316,1068,1248,206863,106959,99904,193660250.0,73248796.0,120411454.0,2177,987,1190,190433,103726,86707,182574055.0,70898799.0,111675255.0,0.6848,1.2053,0.6835,1.288
2023-08-15 15:15,3241,1508,1733,294701,50048,244653,398085947.0,34135706.0,363950240.0,3058,1391,1667,283069,45134,237935,390590076.0,30725966.0,359864110.0,0.6821,1.4876,0.6808,1.5124
2023-08-15 15:20,2523,628,1895,287604,35999,251605,268126375.0,24545367.0,243581008.0,2309,470,1839,275996,29573,246423,260389788.0,20155304.0,240234484.0,0.6818,0.9681,0.6815,0.9749
2023-08-15 15:25,2607,638,1969,353675,32419,321256,262230464.0,21894911.0,240335553.0,2523,600,1923,351111,29906,321205,260417688.0,20106830.0,240310858.0,0.6754,0.7481,0.6723,0.7482
2023-08-15 15:30,3096,787,2309,373628,39422,334206,296849748.0,26821377.0,270028371.0,3036,754,2282,371143,38096,333047,295130954.0,25888216.0,269242737.0,0.6804,0.808,0.6796,0.8084
2023-08-15 15:35,1050,233,817,120834,23890,96944,82612376.0,16228920.0,66383456.0,1031,221,810,118521,23735,94786,81015229.0,16122868.0,64892361.0,0.6793,0.6848,0.6793,0.6846
2023-08-15 15:40,566,199,367,78835,18153,60682,53936235.0,12387955.0,41548279.0,527,182,345,77181,17131,60050,52785021.0,11642227.0,41142794.0,0.6824,0.6847,0.6796,0.6851
2023-08-15 15:45,1394,133,1261,163455,14893,148562,111824789.0,10130152.0,101694637.0,1370,116,1254,162265,14090,148175,111012721.0,9582611.0,101430110.0,0.6802,0.6845,0.6801,0.6845
2023-08-15 15:50,720,218,502,100904,16622,84282,79352136.0,11296347.0,68055789.0,679,199,480,99462,15750,83712,78344517.0,10701609.0,67642907.0,0.6796,0.8075,0.6795,0.808
2023-08-15 15:55,310,127,183,38236,16825,21411,26121647.0,11484485.0,14637162.0,279,109,170,36670,15843,20827,25012258.0,10761196.0,14251061.0,0.6826,0.6836,0.6792,0.6843
2023-08-15 16:00,388,71,317,22427,7259,15168,15345858.0,4987007.0,10358851.0,352,48,304,21048,6355,14693,14366916.0,4319154.0,10047761.0,0.687,0.6829,0.6796,0.6838
2023-08-15 16:05,466,320,146,56858,46025,10833,38846722.0,31430414.0,7416308.0,419,295,124,53010,44136,8874,36119538.0,30042626.0,6076912.0,0.6829,0.6846,0.6807,0.6848
2023-08-15 16:10,883,583,300,125710,113691,12019,84441396.0,76246397.0,8194999.0,865,575,290,117263,104684,12579,79398372.0,70785047.0,8613325.0,0.6706,0.6818,0.6762,0.6847
2023-08-15 16:15,614,324,290,66054,41726,24328,45031275.0,28410105.0,16621169.0,586,313,273,64850,41152,23698,44247128.0,28008546.0,16238581.0,0.6809,0.6832,0.6806,0.6852
2023-08-15 16:20,327,40,287,31142,6470,24672,21280728.0,4405032.0,16875696.0,311,36,275,30560,6561,23999,20872657.0,4465484.0,16407172.0,0.6808,0.684,0.6806,0.6837
2023-08-15 16:25,1252,376,876,115438,40033,75405,99177133.0,27230462.0,71946671.0,1193,342,851,110260,38061,72199,95784011.0,25829009.0,69955001.0,0.6802,0.9541,0.6786,0.9689
2023-08-15 16:30,1570,595,975,164991,59402,105589,112107187.0,40269089.0,71838097.0,1506,560,946,161672,57585,104087,109848037.0,38965400.0,70882636.0,0.6779,0.6804,0.6767,0.681
2023-08-15 16:35,1112,698,414,112728,85044,27684,86997342.0,57774837.0,29222505.0,1091,692,399,110173,82783,27390,85170832.0,56174204.0,28996628.0,0.6794,1.0556,0.6786,1.0587
2023-08-15 16:40,2071,441,1630,259211,48860,210351,196500883.0,33125378.0,163375505.0,1986,395,1591,253472,47593,205879,192999023.0,32266548.0,160732475.0,0.678,0.7767,0.678,0.7807
2023-08-15 16:45,2613,181,2432,404780,4867,399913,275324057.0,3320811.0,272003246.0,2588,164,2424,409089,4719,404370,278327835.0,3203611.0,275124224.0,0.6823,0.6802,0.6789,0.6804
2023-08-15 16:50,3230,384,2846,432058,31349,400709,335040008.0,21215506.0,313824501.0,3196,368,2828,431215,30832,400383,334467830.0,20842958.0,313624872.0,0.6768,0.7832,0.676,0.7833
2023-08-15 16:55,860,127,733,119507,7737,111770,81256761.0,5240692.0,76016069.0,851,114,737,121702,7295,114407,82774655.0,4935139.0,77839515.0,0.6774,0.6801,0.6765,0.6804
2023-08-15 17:00,461,74,387,59851,3769,56082,51090271.0,2567255.0,48523015.0,433,57,376,58324,2954,55370,50030550.0,2007619.0,48022930.0,0.6812,0.8652,0.6796,0.8673
2023-08-15 17:05,829,164,665,66715,8677,58038,45450709.0,5913295.0,39537413.0,806,151,655,66056,7803,58253,44991112.0,5304146.0,39686966.0,0.6815,0.6812,0.6798,0.6813
2023-08-15 17:10,1218,310,908,119120,23700,95420,81049628.0,16039448.0,65010179.0,1193,295,898,119176,23493,95683,81107618.0,15896303.0,65211314.0,0.6768,0.6813,0.6766,0.6815
2023-08-15 17:15,608,99,509,37756,6738,31018,46199281.0,4569552.0,41629728.0,558,70,488,36914,5791,31123,45760316.0,3924752.0,41835563.0,0.6782,1.3421,0.6777,1.3442
2023-08-15 17:20,2165,613,1552,224808,45725,179083,172195268.0,30862551.0,141332716.0,1993,512,1481,219221,42749,176472,168585921.0,28790839.0,139795082.0,0.675,0.7892,0.6735,0.7922
2023-08-15 17:25,2275,549,1726,262546,29723,232823,217935960.0,20020620.0,197915340.0,2164,474,1690,256795,26803,229992,214349172.0,18042189.0,196306983.0,0.6736,0.8501,0.6731,0.8535
2023-08-15 17:30,3129,309,2820,415020,6633,408387,300490909.0,4497996.0,295992912.0,3056,266,2790,415062,7237,407825,300511429.0,4862356.0,295649073.0,0.6781,0.7248,0.6719,0.7249
2023-08-15 17:35,2320,284,2036,340646,4933,335713,229817337.0,3344216.0,226473120.0,2234,234,2000,338125,2879,335246,228126890.0,1954710.0,226172180.0,0.6779,0.6746,0.679,0.6746
2023-08-15 17:40,1257,318,939,187989,13353,174636,137035003.0,8996109.0,128038894.0,1214,293,921,186615,12320,174295,136061956.0,8270804.0,127791152.0,0.6737,0.7332,0.6713,0.7332
2023-08-15 17:45,1805,487,1318,212558,34705,177853,153774283.0,23350753.0,130423530.0,1749,452,1297,210183,32513,177670,152147600.0,21871959.0,130275640.0,0.6728,0.7333,0.6727,0.7332
2023-08-15 17:50,1275,357,918,118568,22387,96181,80120509.0,15084906.0,65035603.0,1228,323,905,118584,21827,96757,80128446.0,14684700.0,65443746.0,0.6738,0.6762,0.6728,0.6764
2023-08-15 17:55,706,185,521,84886,14862,70024,57356038.0,9993842.0,47362196.0,700,183,517,80163,10215,69948,54189107.0,6877818.0,47311289.0,0.6724,0.6764,0.6733,0.6764
2023-08-15 18:00,549,152,397,62134,9720,52414,52180308.0,6538799.0,45641509.0,533,142,391,61521,9421,52100,51808488.0,6336939.0,45471548.0,0.6727,0.8708,0.6726,0.8728
2023-08-15 18:05,673,177,496,68534,11835,56699,46284333.0,7965962.0,38318371.0,664,168,496,76174,16165,60009,51473901.0,10868599.0,40605302.0,0.6731,0.6758,0.6724,0.6767
2023-08-15 18:10,2682,443,2239,319953,25382,294571,338337269.0,17072303.0,321264965.0,2567,379,2188,314100,23968,290132,334492377.0,16118836.0,318373541.0,0.6726,1.0906,0.6725,1.0973
2023-08-15 18:15,2852,691,2161,402422,35201,367221,454295569.0,23710878.0,430584691.0,2656,590,2066,395024,32457,362567,449554967.0,21859948.0,427695018.0,0.6736,1.1725,0.6735,1.1796
2023-08-15 18:20,1763,766,997,159311,39086,120225,137410305.0,26198206.0,111212098.0,1622,693,929,154649,35494,119155,134255099.0,23706618.0,110548481.0,0.6703,0.925,0.6679,0.9278
2023-08-15 18:25,708,356,352,66655,29001,37654,85462007.0,19459048.0,66002958.0,669,322,347,63497,25882,37615,83300570.0,17286788.0,66013782.0,0.671,1.7529,0.6679,1.755
2023-08-15 18:30,275,109,166,28003,11373,16630,18782439.0,7601702.0,11180737.0,253,101,152,27422,11809,15613,18385584.0,7881445.0,10504139.0,0.6684,0.6723,0.6674,0.6728
2023-08-15 18:35,341,199,142,39092,22041,17051,26128113.0,14688076.0,11440037.0,327,184,143,39732,22885,16847,26612214.0,15279181.0,11333032.0,0.6664,0.6709,0.6677,0.6727
2023-08-16 10:00,3283,1687,1596,291197,122966,168231,237492797.0,82476710.0,155016087.0,2694,1458,1236,270389,113744,156645,212653953.0,76096480.0,136557473.0,0.6707,0.9214,0.669,0.8718
2023-08-16 10:05,1135,580,555,72683,28624,44059,79716482.0,19231827.0,60484654.0,972,497,475,65322,23679,41643,74689197.0,15876579.0,58812618.0,0.6719,1.3728,0.6705,1.4123
2023-08-16 10:10,1118,758,360,58268,26797,31471,39318362.0,17962239.0,21356122.0,1049,722,327,54833,25969,28864,36917322.0,17406627.0,19510694.0,0.6703,0.6786,0.6703,0.676
2023-08-16 10:15,2255,197,2058,193992,23209,170783,150822369.0,15495231.0,135327137.0,2192,178,2014,189400,20736,168664,147797675.0,13839258.0,133958417.0,0.6676,0.7924,0.6674,0.7942
2023-08-16 10:20,1926,691,1235,194171,48099,146072,181444421.0,32062223.0,149382197.0,1872,707,1165,184918,47957,136961,175034189.0,31966531.0,143067657.0,0.6666,1.0227,0.6666,1.0446
2023-08-16 10:25,3152,1608,1544,253502,85066,168436,259725710.0,56615347.0,203110363.0,2818,1364,1454,238394,75538,162856,250233123.0,50338379.0,199894744.0,0.6655,1.2059,0.6664,1.2274
2023-08-16 10:30,3426,1637,1789,328838,99476,229362,289255416.0,65856802.0,223398614.0,3137,1439,1698,314781,91736,223045,280140000.0,60785479.0,219354520.0,0.662,0.974,0.6626,0.9835
2023-08-16 10:35,1715,536,1179,146982,47079,99903,107997436.0,31262420.0,76735016.0,1627,483,1144,143517,44750,98767,105670003.0,29697544.0,75972459.0,0.664,0.7681,0.6636,0.7692
2023-08-16 10:40,1371,829,542,101136,80057,21079,77585392.0,53345213.0,24240179.0,1280,780,500,99233,78694,20539,76142530.0,52289769.0,23852761.0,0.6663,1.15,0.6645,1.1613
2023-08-16 10:45,2085,904,1181,145498,71872,73626,117244288.0,47754919.0,69489368.0,2028,886,1142,144183,72526,71657,116250444.0,48110007.0,68140436.0,0.6644,0.9438,0.6633,0.9509
2023-08-16 10:50,2061,742,1319,119920,54602,65318,110150216.0,36286260.0,73863956.0,1997,712,1285,115907,53924,61983,107549225.0,35799326.0,71749899.0,0.6646,1.1308,0.6639,1.1576
2023-08-16 10:55,2048,717,1331,158462,25257,133205,165097965.0,16689222.0,148408743.0,1821,560,1261,145295,14962,130333,156670219.0,9908800.0,146761419.0,0.6608,1.1141,0.6623,1.126
2023-08-16 11:00,3091,1631,1460,275065,127031,148034,292968027.0,84212380.0,208755647.0,2966,1558,1408,270229,126189,144040,289551134.0,83370031.0,206181102.0,0.6629,1.4102,0.6607,1.4314
2023-08-16 11:05,2166,1535,631,250847,226080,24767,165814764.0,149416087.0,16398677.0,2093,1502,591,248512,225317,23195,164337283.0,148926927.0,15410355.0,0.6609,0.6621,0.661,0.6644
2023-08-16 11:10,2915,803,2112,307277,48598,258679,323332682.0,32102102.0,291230580.0,2717,694,2023,299796,46627,253169,318848183.0,30774560.0,288073623.0,0.6606,1.1258,0.66,1.1379
2023-08-16 11:15,2354,1172,1182,195811,37627,158184,178355280.0,24615808.0,153739471.0,2167,975,1192,185478,31053,154425,171805494.0,20319649.0,151485845.0,0.6542,0.9719,0.6544,0.981
2023-08-16 11:20,2536,715,1821,264071,22696,241375,360649740.0,14921944.0,345727795.0,2176,482,1694,250626,16488,234138,352274858.0,10807905.0,341466953.0,0.6575,1.4323,0.6555,1.4584
2023-08-16 11:25,2528,1467,1061,207890,111031,96859,215481943.0,72749886.0,142732057.0,2231,1273,958,196355,106414,89941,207430983.0,69398176.0,138032807.0,0.6552,1.4736,0.6522,1.5347
2023-08-16 11:30,1041,692,349,111439,95065,16374,92997211.0,62200806.0,30796405.0,915,624,291,109056,94873,14183,91303400.0,61947379.0,29356021.0,0.6543,1.8808,0.653,2.0698
2023-08-16 11:35,2178,1007,1171,223151,130238,92913,176185167.0,85281106.0,90904060.0,1922,883,1039,218584,129376,89208,173401405.0,84705267.0,88696137.0,0.6548,0.9784,0.6547,0.9943
2023-08-16 11:40,3410,1063,2347,410377,72393,337984,356409050.0,46999800.0,309409249.0,3098,884,2214,385355,59268,326087,340939371.0,38505934.0,302433437.0,0.6492,0.9155,0.6497,0.9275
2023-08-16 11:45,2577,1626,951,183815,110304,73511,219581604.0,71537604.0,148044000.0,2428,1545,883,180363,107376,72987,216923883.0,69460389.0,147463494.0,0.6485,2.0139,0.6469,2.0204
2023-08-16 11:50,962,527,435,77475,40278,37197,51464794.0,26666813.0,24797981.0,827,435,392,69347,37612,31735,45453136.0,24251187.0,21201949.0,0.6621,0.6667,0.6448,0.6681
2023-08-16 11:55,1270,777,493,134339,94479,39860,97356982.0,61449468.0,35907513.0,1166,706,460,131982,93568,38414,95620402.0,60642848.0,34977554.0,0.6504,0.9008,0.6481,0.9105
2023-08-16 12:00,3295,1618,1677,295844,182651,113193,252597433.0,119040703.0,133556730.0,3155,1542,1613,290568,180166,110402,249025399.0,117240643.0,131784756.0,0.6517,1.1799,0.6507,1.1937
2023-08-16 12:05,2802,2307,495,342397,324491,17906,283859702.0,212302709.0,71556993.0,2645,2206,439,335457,320297,15160,279123861.0,209397169.0,69726691.0,0.6543,3.9963,0.6538,4.5994
2023-08-16 12:10,1409,670,739,145750,98106,47644,105114543.0,63987345.0,41127197.0,1327,619,708,140163,95834,44329,101565011.0,62523963.0,39041047.0,0.6522,0.8632,0.6524,0.8807
2023-08-16 12:15,2333,981,1352,230537,148590,81947,150619568.0,96918265.0,53701303.0,2251,915,1336,229586,148114,81472,149993769.0,96597997.0,53395771.0,0.6523,0.6553,0.6522,0.6554
2023-08-16 12:20,2230,1137,1093,204677,162609,42068,133666916.0,106067162.0,27599754.0,2166,1103,1063,207632,164970,42662,135570399.0,107513531.0,28056868.0,0.6523,0.6561,0.6517,0.6577
2023-08-16 12:25,1524,493,1031,126550,81457,45093,92418015.0,53028152.0,39389863.0,1445,448,997,119813,77724,42089,88149126.0,50632937.0,37516188.0,0.651,0.8735,0.6514,0.8914
2023-08-16 12:30,2179,620,1559,178401,34503,143898,225820839.0,22953560.0,202867279.0,2079,573,1506,174907,33883,141024,223075105.0,21972535.0,201102570.0,0.6653,1.4098,0.6485,1.426
2023-08-16 12:35,879,280,599,92471,10832,81639,89870668.0,7108056.0,82762612.0,775,222,553,88752,9215,79537,88070722.0,6553070.0,81517652.0,0.6562,1.0138,0.7111,1.0249
2023-08-16 12:40,1142,866,276,132884,96461,36423,106390260.0,63246981.0,43143279.0,878,681,197,114922,86484,28438,94307921.0,56203276.0,38104645.0,0.6557,1.1845,0.6499,1.3399
2023-08-16 12:45,2973,2488,485,343775,302141,41634,241756932.0,195186321.0,46570611.0,2797,2371,426,336641,295858,40783,236780375.0,190698264.0,46082110.0,0.646,1.1186,0.6446,1.1299
2023-08-16 12:50,2622,626,1996,292002,36786,255216,208686955.0,23700216.0,184986738.0,2520,580,1940,281867,31313,250554,202870377.0,20733224.0,182137152.0,0.6443,0.7248,0.6621,0.7269
2023-08-16 12:55,1367,532,835,123110,17533,105577,98693468.0,11323259.0,87370209.0,1168,405,763,117159,17069,100090,95216752.0,10967256.0,84249495.0,0.6458,0.8275,0.6425,0.8417
2023-08-16 13:00,2045,1067,978,201670,64864,136806,197419037.0,41954697.0,155464340.0,1772,889,883,185586,56746,128840,186924097.0,36230888.0,150693209.0,0.6468,1.1364,0.6385,1.1696
2023-08-16 13:05,2554,1130,1424,246732,65082,181650,206403492.0,41633752.0,164769740.0,2269,939,1330,231870,57308,174562,197010336.0,36555737.0,160454598.0,0.6397,0.9071,0.6379,0.9192
2023-08-16 13:10,1629,789,840,168564,92016,76548,156523866.0,58782111.0,97741755.0,1481,691,790,160727,87824,72903,151439979.0,55987553.0,95452426.0,0.6388,1.2769,0.6375,1.3093
2023-08-16 13:15,2796,1197,1599,241016,134618,106398,241785201.0,86023613.0,155761588.0,2651,1106,1545,235906,132583,103323,238619354.0,84605225.0,154014129.0,0.639,1.464,0.6381,1.4906
2023-08-16 13:20,1387,565,822,105800,29621,76179,165085527.0,18985930.0,146099596.0,1269,485,784,97509,25308,72201,159615130.0,16067893.0,143547236.0,0.641,1.9178,0.6349,1.9882
2023-08-16 13:25,2220,1134,1086,176760,105297,71463,134562575.0,68844725.0,65717850.0,2088,1061,1027,169738,101495,68243,129375553.0,65706656.0,63668896.0,0.6538,0.9196,0.6474,0.933
2023-08-16 13:30,1342,681,661,113661,82834,30827,92754078.0,53227766.0,39526312.0,1255,631,624,109872,80765,29107,90300469.0,51879730.0,38420738.0,0.6426,1.2822,0.6424,1.32
2023-08-16 13:35,1568,486,1082,191175,49531,141644,143006722.0,31895334.0,111111388.0,1487,441,1046,189375,48505,140870,141929236.0,31225141.0,110704094.0,0.6439,0.7844,0.6438,0.7859
2023-08-16 13:40,823,317,506,97087,27779,69308,72467801.0,17884769.0,54583031.0,769,282,487,94243,26896,67347,70697894.0,17309762.0,53388132.0,0.6438,0.7875,0.6436,0.7927
2023-08-16 13:45,2544,1430,1114,225823,128183,97640,176440344.0,83812104.0,92628240.0,2436,1372,1064,211337,115979,95358,166996559.0,75859277.0,91137281.0,0.6538,0.9487,0.6541,0.9557
2023-08-16 13:50,1944,502,1442,233601,37475,196126,190509526.0,24731965.0,165777561.0,1869,441,1428,234077,42085,191992,191477128.0,28211259.0,163265869.0,0.66,0.8453,0.6703,0.8504
2023-08-16 13:55,1043,367,676,119065,24432,94633,86705636.0,15716464.0,70989172.0,1071,339,732,119536,22753,96783,87601905.0,15196648.0,72405257.0,0.6433,0.7502,0.6679,0.7481
2023-08-16 14:00,1274,427,847,140856,27233,113623,110675532.0,17531379.0,93144152.0,1154,390,764,136070,26079,109991,107514751.0,16741655.0,90773096.0,0.6438,0.8198,0.642,0.8253
2023-08-16 14:05,768,463,305,53293,17679,35614,54042960.0,11371204.0,42671755.0,730,443,287,53568,18242,35326,54218419.0,11731319.0,42487100.0,0.6432,1.1982,0.6431,1.2027
2023-08-16 14:10,701,332,369,50467,12926,37541,32577017.0,8316471.0,24260546.0,647,290,357,49838,12790,37048,32187805.0,8218893.0,23968912.0,0.6434,0.6462,0.6426,0.647
2023-08-16 14:15,563,168,395,77974,9691,68283,60125024.0,6235344.0,53889679.0,519,137,382,77350,9838,67512,59746917.0,6328425.0,53418492.0,0.6434,0.7892,0.6433,0.7912
2023-08-16 14:20,567,243,324,58868,18494,40374,37951143.0,11861496.0,26089646.0,505,203,302,56165,15885,40280,36254939.0,10193463.0,26061475.0,0.6414,0.6462,0.6417,0.647
2023-08-16 14:25,2084,1148,936,215954,57227,158727,228356386.0,37078758.0,191277628.0,1985,1093,892,208693,53967,154726,223440905.0,34810670.0,188630235.0,0.6479,1.2051,0.645,1.2191
2023-08-16 14:30,2266,838,1428,292733,43520,249213,209279634.0,28099844.0,181179790.0,2189,798,1391,289209,42919,246290,207145263.0,27692987.0,179452276.0,0.6457,0.727,0.6452,0.7286
2023-08-16 14:35,787,227,560,89185,12309,76876,57668565.0,7959150.0,49709415.0,729,194,535,86858,11003,75855,56130618.0,7057311.0,49073306.0,0.6466,0.6466,0.6414,0.6469
2023-08-16 14:40,1118,782,336,98424,60626,37798,83346455.0,39246041.0,44100414.0,1077,754,323,95707,58428,37279,81400226.0,37643370.0,43756855.0,0.6473,1.1667,0.6443,1.1738
2023-08-16 14:45,901,598,303,75679,46762,28917,48843394.0,30124480.0,18718914.0,867,572,295,74574,46378,28196,48109649.0,29857993.0,18251656.0,0.6442,0.6473,0.6438,0.6473
2023-08-16 14:50,519,396,123,44151,36334,7817,28432084.0,23393906.0,5038177.0,494,371,123,44353,36629,7724,28580091.0,23579982.0,5000108.0,0.6439,0.6445,0.6438,0.6473
2023-08-16 14:55,1036,277,759,124850,23963,100887,90315386.0,15420907.0,74894479.0,994,253,741,123654,23627,100027,89614351.0,15204583.0,74409768.0,0.6435,0.7424,0.6435,0.7439
2023-08-16 15:00,1029,418,611,111720,21203,90517,91441164.0,13604760.0,77836403.0,946,360,586,108329,20229,88100,89325040.0,12975097.0,76349943.0,0.6416,0.8599,0.6414,0.8666
2023-08-16 15:05,2047,1563,484,142146,65718,76428,111291499.0,42403284.0,68888214.0,1979,1522,457,140160,63878,76282,109783994.0,41033867.0,68750126.0,0.6452,0.9013,0.6424,0.9013
2023-08-16 15:10,816,660,156,79715,45539,34176,51573694.0,29299292.0,22274402.0,781,637,144,67143,43250,23893,43363382.0,27815267.0,15548114.0,0.6434,0.6518,0.6431,0.6507
2023-08-16 15:15,1711,429,1282,210764,34765,175999,184533940.0,22390235.0,162143704.0,1657,406,1251,215485,32987,182498,188126257.0,21251442.0,166874814.0,0.644,0.9213,0.6442,0.9144
2023-08-16 15:20,2898,673,2225,408521,16225,392296,408288310.0,10443763.0,397844547.0,2790,600,2190,403793,14553,389240,405334644.0,9375463.0,395959180.0,0.6437,1.0141,0.6442,1.0173
2023-08-16 15:25,2885,896,1989,361511,32497,329014,523050984.0,20744109.0,502306874.0,2744,809,1935,355666,28106,327560,519372524.0,17888267.0,501484257.0,0.6383,1.5267,0.6365,1.531
2023-08-16 15:30,1151,410,741,138136,18233,119903,117374489.0,12087158.0,105287330.0,952,286,666,123235,13153,110082,107690522.0,8363136.0,99327386.0,0.6629,0.8781,0.6358,0.9023
2023-08-16 15:35,2085,679,1406,267207,23679,243528,237334241.0,15051477.0,222282764.0,1910,558,1352,265224,18441,246783,236142291.0,11749215.0,224393076.0,0.6356,0.9128,0.6371,0.9093
2023-08-16 15:40,3986,1405,2581,460231,98373,361858,416425428.0,62146757.0,354278671.0,3702,1223,2479,444466,91118,353348,406542736.0,57421372.0,349121363.0,0.6317,0.9791,0.6302,0.988
2023-08-16 15:45,2368,1342,1026,171010,96335,74675,194139247.0,60605080.0,133534167.0,2199,1217,982,162957,90568,72389,189030892.0,56899138.0,132131754.0,0.6291,1.7882,0.6282,1.8253
2023-08-16 15:50,2029,591,1438,131656,19574,112082,216976321.0,12486989.0,204489331.0,1840,466,1374,124741,15674,109067,212645148.0,9949255.0,202695892.0,0.6379,1.8245,0.6348,1.8585
2023-08-16 15:55,1706,776,930,118546,70376,48170,142795945.0,45170555.0,97625390.0,1532,677,855,110679,64670,46009,137178316.0,40748803.0,96429513.0,0.6418,2.0267,0.6301,2.0959
2023-08-16 16:00,1239,615,624,108479,63545,44934,168648375.0,43214674.0,125433701.0,1019,486,533,101457,59982,41475,164022592.0,40765528.0,123257064.0,0.6801,2.7915,0.6796,2.9718
2023-08-16 16:05,1592,598,994,126848,82032,44816,110596974.0,53091512.0,57505462.0,1492,531,961,122129,78425,43704,107022812.0,50223399.0,56799413.0,0.6472,1.2831,0.6404,1.2996
2023-08-16 16:10,1168,491,677,126998,81394,45604,80779067.0,51651386.0,29127681.0,1110,459,651,123824,80971,42853,79820266.0,52461760.0,27358506.0,0.6346,0.6387,0.6479,0.6384
2023-08-16 16:15,499,250,249,47118,33476,13642,29928482.0,21227280.0,8701201.0,443,221,222,46478,33186,13292,29520752.0,21037802.0,8482950.0,0.6341,0.6378,0.6339,0.6382
2023-08-16 16:20,485,233,252,59240,31112,28128,47351164.0,19721385.0,27629779.0,429,200,229,52607,30220,22387,43097116.0,19138738.0,23958377.0,0.6339,0.9823,0.6333,1.0702
2023-08-16 16:25,373,147,226,37511,23359,14152,33594130.0,14845176.0,18748953.0,308,99,209,38616,23942,14674,34350915.0,15177486.0,19173429.0,0.6355,1.3248,0.6339,1.3066
2023-08-16 16:30,933,444,489,78978,56262,22716,81010582.0,35979643.0,45030938.0,801,364,437,66718,48094,18624,72634327.0,30675602.0,41958725.0,0.6395,1.9823,0.6378,2.2529
2023-08-16 16:35,2090,1534,556,235792,205410,30382,151509903.0,131661224.0,19848679.0,1999,1502,497,227831,202542,25289,145970472.0,129283564.0,16686908.0,0.641,0.6533,0.6383,0.6598
2023-08-16 16:40,1533,1268,265,245619,220992,24627,176409926.0,140992643.0,35417282.0,1462,1225,237,241027,217921,23106,173440336.0,138998390.0,34441945.0,0.638,1.4381,0.6378,1.4906
2023-08-16 16:45,455,337,118,49738,44423,5315,31757866.0,28333308.0,3424557.0,437,327,110,51182,44179,7003,32671649.0,28164504.0,4507145.0,0.6378,0.6443,0.6375,0.6436
2023-08-16 16:50,248,158,90,27903,19976,7927,17888803.0,12791290.0,5097513.0,222,135,87,27474,18927,8547,17627105.0,12118512.0,5508592.0,0.6403,0.6431,0.6403,0.6445
2023-08-16 16:55,1736,1366,370,227316,210523,16793,185994955.0,135894203.0,50100752.0,1655,1322,333,216643,203591,13052,178839229.0,131216915.0,47622314.0,0.6455,2.9834,0.6445,3.6487
2023-08-16 17:00,4029,1683,2346,436648,244132,192516,389293123.0,156943602.0,232349521.0,3918,1650,2268,428642,240796,187846,384255495.0,154775823.0,229479672.0,0.6429,1.2069,0.6428,1.2216
2023-08-16 17:05,2216,1207,1009,251081,162014,89067,210741920.0,104303514.0,106438406.0,2149,1177,972,247610,160618,86992,208437754.0,103262210.0,105175544.0,0.6438,1.195,0.6429,1.209
2023-08-16 17:10,1366,765,601,175769,132088,43681,132427818.0,84653945.0,47773872.0,1310,741,569,172617,131207,41410,130346530.0,84024482.0,46322048.0,0.6409,1.0937,0.6404,1.1186
2023-08-16 17:15,561,234,327,59543,30661,28882,38326933.0,19674782.0,18652151.0,549,225,324,58987,30393,28594,37964396.0,19494434.0,18469962.0,0.6417,0.6458,0.6414,0.6459
2023-08-16 17:20,323,170,153,32233,24729,7504,20716908.0,15872385.0,4844522.0,294,153,141,30968,23802,7166,19881169.0,15249529.0,4631640.0,0.6419,0.6456,0.6407,0.6463
2023-08-16 17:25,1040,628,412,144469,96680,47789,92844172.0,61941748.0,30902424.0,1001,610,391,132533,96477,36056,85076482.0,61800497.0,23275984.0,0.6407,0.6466,0.6406,0.6456
2023-08-16 17:30,4628,2234,2394,468495,172523,295972,349009115.0,111050336.0,237958779.0,4463,2134,2329,463659,165578,298081,345988584.0,106084068.0,239904515.0,0.6437,0.804,0.6407,0.8048
2023-08-16 17:35,4055,2670,1385,404743,246008,158735,287759992.0,156863781.0,130896211.0,3997,2636,1361,403186,245289,157897,286557338.0,156238502.0,130318836.0,0.6376,0.8246,0.637,0.8253
2023-08-16 17:40,2117,1698,419,314070,292237,21833,200435096.0,186420210.0,14014886.0,2075,1667,408,311375,289692,21683,198741557.0,184821702.0,13919854.0,0.6379,0.6419,0.638,0.642
2023-08-16 17:45,1228,1053,175,178296,173196,5100,113772976.0,110493176.0,3279800.0,1192,1026,166,179948,174641,5307,114799479.0,111382263.0,3417215.0,0.638,0.6431,0.6378,0.6439
2023-08-16 17:50,2430,2031,399,305848,277256,28592,205460036.0,177226721.0,28233315.0,2389,2005,384,306373,276675,29698,205710549.0,176805424.0,28905125.0,0.6392,0.9875,0.639,0.9733
2023-08-16 17:55,1525,1319,206,217603,205009,12594,139259849.0,131143234.0,8116615.0,1498,1304,194,218195,205724,12471,139641587.0,131597886.0,8043700.0,0.6397,0.6445,0.6397,0.645
2023-08-16 18:00,1589,1359,230,191185,176753,14432,151860532.0,113181563.0,38678968.0,1541,1318,223,188234,174152,14082,149858700.0,111385861.0,38472838.0,0.6403,2.6801,0.6396,2.7321
2023-08-16 18:05,1518,1086,432,187104,149782,37322,149265449.0,95932461.0,53332987.0,1432,1035,397,178763,148238,30525,143925892.0,94890741.0,49035151.0,0.6405,1.429,0.6401,1.6064
2023-08-16 18:10,700,296,404,73245,49348,23897,46901542.0,31558558.0,15342984.0,662,274,388,71598,48188,23410,45881533.0,30825174.0,15056358.0,0.6395,0.642,0.6397,0.6432
2023-08-16 18:15,710,359,351,89829,53511,36318,57554370.0,34216840.0,23337530.0,692,344,348,89804,53676,36128,57537330.0,34322062.0,23215267.0,0.6394,0.6426,0.6394,0.6426
2023-08-16 18:20,291,137,154,33562,18294,15268,21551047.0,11718939.0,9832108.0,277,119,158,36414,17983,18431,23396350.0,11515650.0,11880700.0,0.6406,0.644,0.6404,0.6446
2023-08-16 18:25,727,130,597,37075,13027,24048,23835432.0,8351562.0,15483869.0,700,111,589,36566,12716,23850,23501557.0,8140374.0,15361183.0,0.6411,0.6439,0.6402,0.6441
2023-08-16 18:30,517,77,440,58642,5775,52867,37778880.0,3712276.0,34066604.0,506,68,438,58884,6295,52589,37904932.0,4010337.0,33894595.0,0.6428,0.6444,0.6371,0.6445
2023-08-16 18:35,976,329,647,101086,33453,67633,84278736.0,21381813.0,62896922.0,924,285,639,97262,32583,64679,81892879.0,20816138.0,61076741.0,0.6392,0.93,0.6389,0.9443
2023-08-17 10:00,3755,2634,1121,344845,260455,84390,350414164.0,167899376.0,182514787.0,3190,2381,809,304462,245949,58513,312668987.0,157447346.0,155221641.0,0.6446,2.1628,0.6402,2.6528
2023-08-17 10:05,4249,3062,1187,390724,296591,94133,388901512.0,190443612.0,198457899.0,4000,2923,1077,376646,288993,87653,379505319.0,185342116.0,194163203.0,0.6421,2.1083,0.6413,2.2151
2023-08-17 10:10,4033,3488,545,490746,446007,44739,346094762.0,287481880.0,58612881.0,3812,3385,427,479890,441157,38733,338832548.0,284200574.0,54631973.0,0.6446,1.3101,0.6442,1.4105
2023-08-17 10:15,2527,1587,940,183282,133816,49466,157232439.0,86075735.0,71156703.0,2319,1502,817,182082,133256,48826,156529356.0,85704134.0,70825222.0,0.6432,1.4385,0.6432,1.4506
2023-08-17 10:20,3726,2128,1598,379574,166505,213069,293002834.0,106877872.0,186124961.0,3609,2054,1555,369727,160637,209090,286721865.0,103110731.0,183611134.0,0.6419,0.8735,0.6419,0.8781
2023-08-17 10:25,2567,2319,248,300095,275167,24928,242308808.0,177111920.0,65196888.0,2337,2179,158,287674,267994,19680,234203535.0,172370713.0,61832822.0,0.6437,2.6154,0.6432,3.1419
2023-08-17 10:30,2878,2119,759,238008,201672,36336,263224690.0,130765872.0,132458818.0,2375,1829,546,224221,196059,28162,253973421.0,126798847.0,127174574.0,0.6484,3.6454,0.6467,4.5158
2023-08-17 10:35,2443,767,1676,238819,47637,191182,164917290.0,30719173.0,134198117.0,2291,674,1617,233972,44634,189338,161894337.0,28808039.0,133086298.0,0.6449,0.7019,0.6454,0.7029
2023-08-17 10:40,1617,476,1141,175597,23065,152532,124061633.0,14917043.0,109144589.0,1526,444,1082,172413,21984,150429,121933296.0,14197985.0,107735310.0,0.6467,0.7156,0.6458,0.7162
2023-08-17 10:45,3366,2296,1070,319066,226477,92589,236868397.0,147003961.0,89864436.0,3227,2235,992,313568,223047,90521,233140193.0,144576436.0,88563757.0,0.6491,0.9706,0.6482,0.9784
2023-08-17 10:50,2990,1608,1382,287207,122942,164265,215955167.0,79675513.0,136279654.0,2874,1539,1335,280932,119618,161314,211915362.0,77424108.0,134491253.0,0.6481,0.8296,0.6473,0.8337
2023-08-17 10:55,1416,982,434,96173,70558,25615,62385998.0,45748493.0,16637505.0,1330,929,401,93582,68046,25536,60763751.0,44093576.0,16670175.0,0.6484,0.6495,0.648,0.6528
2023-08-17 11:00,1160,604,556,91206,67295,23911,88982849.0,43703979.0,45278869.0,1066,558,508,86612,64828,21784,85888574.0,42027388.0,43861186.0,0.6494,1.8936,0.6483,2.0135
2023-08-17 11:05,1111,366,745,139445,41367,98078,130196809.0,26839505.0,103357303.0,1047,341,706,129400,40766,88634,123604638.0,26435147.0,97169490.0,0.6488,1.0538,0.6485,1.0963
2023-08-17 11:10,1249,352,897,174495,32378,142117,113381449.0,20937106.0,92444342.0,1194,314,880,171769,31007,140762,111619891.0,20036608.0,91583283.0,0.6466,0.6505,0.6462,0.6506
2023-08-17 11:15,1706,637,1069,203346,44248,159098,141549219.0,28591857.0,112957362.0,1643,602,1041,199999,43126,156873,139464489.0,27866309.0,111598180.0,0.6462,0.71,0.6462,0.7114
2023-08-17 11:20,1822,521,1301,215794,24636,191158,139941246.0,15924022.0,124017224.0,1781,502,1279,214537,23776,190761,139104015.0,15353963.0,123750052.0,0.6464,0.6488,0.6458,0.6487
2023-08-17 11:25,2083,169,1914,324731,10137,314594,210492588.0,6496180.0,203996407.0,2066,153,1913,324957,10104,314853,210643050.0,6462072.0,204180977.0,0.6408,0.6484,0.6396,0.6485
2023-08-17 11:30,1227,368,859,160894,23188,137706,104380163.0,14971988.0,89408175.0,1194,351,843,159457,22371,137086,103443533.0,14442303.0,89001229.0,0.6457,0.6493,0.6456,0.6492
2023-08-17 11:35,1347,899,448,179680,110631,69049,136063405.0,71619647.0,64443757.0,1302,878,424,177267,109168,68099,134451216.0,70550130.0,63901085.0,0.6474,0.9333,0.6463,0.9384
2023-08-17 11:40,1307,921,386,119432,72586,46846,196624170.0,47173187.0,149450983.0,1221,884,337,111795,67734,44061,191490558.0,43970702.0,147519856.0,0.6499,3.1903,0.6492,3.3481
2023-08-17 11:45,1974,1124,850,167505,76064,91441,179282152.0,49678826.0,129603326.0,1775,1055,720,158325,73306,85019,173206719.0,47802060.0,125404659.0,0.6531,1.4173,0.6521,1.475
2023-08-17 11:50,1483,755,728,127868,37249,90619,103553247.0,24237130.0,79316117.0,1439,731,708,125070,35036,90034,101840471.0,22795338.0,79045132.0,0.6507,0.8753,0.6506,0.8779
2023-08-17 11:55,951,484,467,70113,37738,32375,45704438.0,24556868.0,21147569.0,874,460,414,69740,38105,31635,45419294.0,24744321.0,20674973.0,0.6507,0.6532,0.6494,0.6535
2023-08-17 12:00,1067,702,365,81492,51726,29766,73275331.0,33823684.0,39451646.0,959,632,327,77568,48219,29349,70571233.0,31434723.0,39136510.0,0.6539,1.3254,0.6519,1.3335
2023-08-17 12:05,5360,3599,1761,475140,298845,176295,577992936.0,198410865.0,379582071.0,4335,3047,1288,432326,274708,157618,548857644.0,181649451.0,367208193.0,0.6639,2.1531,0.6612,2.3297
2023-08-17 12:10,3421,1958,1463,382785,143512,239273,314085689.0,95073570.0,219012119.0,3109,1770,1339,367742,140473,227269,304379760.0,92866753.0,211513007.0,0.6625,0.9153,0.6611,0.9307
2023-08-17 12:15,5049,2970,2079,581556,305012,276544,695671395.0,201346687.0,494324707.0,4781,2823,1958,569661,299976,269685,688295068.0,197767069.0,490527998.0,0.6601,1.7875,0.6593,1.8189
2023-08-17 12:20,1297,762,535,138483,59835,78648,131043651.0,39480868.0,91562783.0,1127,647,480,120900,51695,69205,119449309.0,33859620.0,85589689.0,0.6598,1.1642,0.655,1.2368
2023-08-17 12:25,1638,583,1055,188560,35394,153166,143511695.0,23101876.0,120409818.0,1546,529,1017,181729,29893,151836,139212335.0,19492513.0,119719822.0,0.6527,0.7861,0.6521,0.7885
2023-08-17 12:30,1761,1208,553,173495,113049,60446,133309230.0,73837029.0,59472201.0,1619,1123,496,168669,110744,57925,130331294.0,72330296.0,58000997.0,0.6531,0.9839,0.6531,1.0013
2023-08-17 12:35,2188,1160,1028,224706,132236,92470,196272106.0,86367768.0,109904338.0,2057,1108,949,221156,127819,93337,195392770.0,84481247.0,110911523.0,0.6531,1.1885,0.6609,1.1883
2023-08-17 12:40,2221,781,1440,194311,64094,130217,146664015.0,41741822.0,104922193.0,2074,693,1381,187031,58998,128033,141911043.0,38312534.0,103598509.0,0.6513,0.8057,0.6494,0.8092
2023-08-17 12:45,1775,896,879,170214,94106,76108,150196225.0,61230006.0,88966219.0,1644,830,814,155212,83823,71389,140568943.0,54372503.0,86196440.0,0.6506,1.1689,0.6487,1.2074
2023-08-17 12:50,2801,1922,879,284357,234360,49997,224339709.0,152186050.0,72153659.0,2698,1880,818,281704,235538,46166,222648116.0,152822324.0,69825792.0,0.6494,1.4432,0.6488,1.5125
2023-08-17 12:55,1290,562,728,122138,63390,58748,89108114.0,41000187.0,48107927.0,1226,528,698,120337,62556,57781,87989194.0,40443650.0,47545544.0,0.6468,0.8189,0.6465,0.8229
2023-08-17 13:00,2723,1138,1585,302577,145965,156612,275727908.0,94684589.0,181043319.0,2631,1092,1539,291074,142670,148404,268336987.0,92518463.0,175818524.0,0.6487,1.156,0.6485,1.1847
2023-08-17 13:05,1992,767,1225,190885,37505,153380,142899396.0,24399500.0,118499896.0,1846,686,1160,177820,32251,145569,135363492.0,20817119.0,114546373.0,0.6506,0.7726,0.6455,0.7869
2023-08-17 13:10,681,270,411,74255,15959,58296,48237327.0,10357414.0,37879913.0,574,196,378,69730,12444,57286,45278564.0,8029924.0,37248640.0,0.649,0.6498,0.6453,0.6502
2023-08-17 13:15,1463,592,871,163945,34389,129556,136224622.0,22298178.0,113926444.0,1438,568,870,162195,33203,128992,135005136.0,21483040.0,113522095.0,0.6484,0.8794,0.647,0.8801
2023-08-17 13:20,1261,214,1047,88485,21876,66609,67301122.0,14157543.0,53143579.0,1237,201,1036,88521,21888,66633,67376053.0,14163675.0,53212378.0,0.6472,0.7978,0.6471,0.7986
2023-08-17 13:25,1090,293,797,110336,17724,92612,91355091.0,11484092.0,79870999.0,1060,279,781,109022,16987,92035,90516793.0,10978162.0,79538631.0,0.6479,0.8624,0.6463,0.8642
2023-08-17 13:30,2084,829,1255,277217,57534,219683,180377671.0,37310306.0,143067364.0,2053,813,1240,278338,55865,222473,181099311.0,36165735.0,144933576.0,0.6485,0.6512,0.6474,0.6515
2023-08-17 13:35,2241,746,1495,287590,72680,214910,246444514.0,47151450.0,199293064.0,2194,723,1471,287705,72880,214825,246396368.0,47179746.0,199216622.0,0.6488,0.9273,0.6474,0.9273
2023-08-17 13:40,1456,376,1080,205701,53178,152523,133777830.0,34442396.0,99335434.0,1425,359,1066,202762,51873,150889,131948608.0,33600579.0,98348028.0,0.6477,0.6513,0.6477,0.6518
2023-08-17 13:45,851,325,526,96085,56263,39822,72237517.0,36463052.0,35774465.0,837,315,522,95856,55978,39878,72117011.0,36276924.0,35840087.0,0.6481,0.8984,0.6481,0.8987
2023-08-17 13:50,524,236,288,61276,42597,18679,39772291.0,27633342.0,12138949.0,505,227,278,59953,42365,17588,38919901.0,27470243.0,11449658.0,0.6487,0.6499,0.6484,0.651
2023-08-17 13:55,866,169,697,101801,20779,81022,66111098.0,13465317.0,52645781.0,842,162,680,99957,20908,79049,64926175.0,13550712.0,51375463.0,0.648,0.6498,0.6481,0.6499
2023-08-17 14:00,1623,313,1310,192955,24338,168617,134983349.0,15742048.0,119241301.0,1600,296,1304,190679,23404,167275,133639700.0,15134174.0,118505526.0,0.6468,0.7072,0.6466,0.7084
2023-08-17 14:05,4396,1281,3115,540923,88614,452309,518154978.0,57269485.0,460885492.0,4346,1250,3096,538321,87365,450956,516583497.0,56454095.0,460129401.0,0.6463,1.019,0.6462,1.0203
2023-08-17 14:10,4272,2311,1961,452142,205857,246285,391754748.0,133248281.0,258506467.0,4245,2300,1945,450057,203974,246083,390310787.0,131935847.0,258374940.0,0.6473,1.0496,0.6468,1.05
2023-08-17 14:15,1966,1905,61,339536,334665,4871,219714350.0,216547110.0,3167240.0,1941,1894,47,338855,334416,4439,219272787.0,216387591.0,2885196.0,0.6471,0.6502,0.6471,0.65
2023-08-17 14:20,2274,1929,345,281254,243615,37639,242891944.0,158627016.0,84264928.0,1998,1773,225,254376,229535,24841,224885306.0,149015791.0,75869515.0,0.6511,2.2388,0.6492,3.0542
2023-08-17 14:25,2341,1846,495,220972,155407,65565,164791098.0,101964267.0,62826831.0,2126,1705,421,208930,148692,60238,156867958.0,97258980.0,59608977.0,0.6561,0.9582,0.6541,0.9896
2023-08-17 14:30,3148,2681,467,375682,314815,60867,266278013.0,206311343.0,59966670.0,3041,2629,412,366221,310591,55630,259916693.0,203365572.0,56551120.0,0.6553,0.9852,0.6548,1.0166
2023-08-17 14:35,2703,1509,1194,237592,119295,118297,186004294.0,78306839.0,107697455.0,2565,1436,1129,231228,117064,114164,181996378.0,76754861.0,105241516.0,0.6564,0.9104,0.6557,0.9218
2023-08-17 14:40,3877,2078,1799,368607,158359,210248,271738534.0,103512686.0,168225848.0,3826,2052,1774,367022,157461,209561,270653375.0,102890166.0,167763209.0,0.6537,0.8001,0.6534,0.8005
2023-08-17 14:45,4340,1302,3038,513602,119753,393849,536064645.0,78380637.0,457684008.0,4227,1238,2989,502416,115386,387030,528933953.0,75489394.0,453444559.0,0.6545,1.1621,0.6542,1.1716
2023-08-17 14:50,1328,306,1022,187315,30154,157161,122651932.0,19646439.0,103005493.0,1289,283,1006,185101,29055,156046,121255972.0,18929829.0,102326142.0,0.6515,0.6554,0.6515,0.6557
2023-08-17 14:55,1022,545,477,113517,36486,77031,104168905.0,23854683.0,80314221.0,980,516,464,111263,34547,76716,102608730.0,22510313.0,80098417.0,0.6538,1.0426,0.6516,1.0441
2023-08-17 15:00,3104,1373,1731,361638,92718,268920,267511557.0,60663133.0,206848424.0,3045,1338,1707,359522,91606,267916,266020274.0,59830430.0,206189843.0,0.6543,0.7692,0.6531,0.7696
2023-08-17 15:05,2061,696,1365,222510,59307,163203,195794998.0,38715690.0,157079307.0,2029,681,1348,220550,58341,162209,194558763.0,38084817.0,156473945.0,0.6528,0.9625,0.6528,0.9646
2023-08-17 15:10,1605,975,630,166924,100835,66089,169093528.0,65861864.0,103231664.0,1563,955,608,165286,99870,65416,167998295.0,65218267.0,102780027.0,0.6532,1.562,0.653,1.5712
2023-08-17 15:15,2032,439,1593,267128,44324,222804,184881829.0,28980725.0,155901104.0,1979,408,1571,264164,42552,221612,183056076.0,27781472.0,155274603.0,0.6538,0.6997,0.6529,0.7007
2023-08-17 15:20,1057,362,695,116597,20619,95978,76375760.0,13448894.0,62926865.0,1026,352,674,115423,20438,94985,75601654.0,13315314.0,62286339.0,0.6523,0.6556,0.6515,0.6557
2023-08-17 15:25,932,218,714,99484,19700,79784,65037570.0,12840975.0,52196594.0,903,198,705,98769,19287,79482,64584757.0,12556545.0,52028211.0,0.6518,0.6542,0.651,0.6546
2023-08-17 15:30,540,189,351,54612,13891,40721,35695610.0,9046563.0,26649047.0,521,177,344,53577,13248,40329,35015334.0,8623754.0,26391580.0,0.6513,0.6544,0.6509,0.6544
2023-08-17 15:35,843,249,594,69411,23848,45563,45352332.0,15549524.0,29802807.0,798,227,571,68696,23169,45527,44940387.0,15097389.0,29842997.0,0.652,0.6541,0.6516,0.6555
2023-08-17 15:40,300,65,235,28495,4928,23567,18588978.0,3211268.0,15377710.0,269,48,221,26913,4346,22567,17605824.0,2829540.0,14776284.0,0.6516,0.6525,0.6511,0.6548
2023-08-17 15:45,1011,276,735,94242,27172,67070,61639049.0,17752670.0,43886378.0,990,262,728,93120,26385,66735,60856815.0,17188664.0,43668151.0,0.6533,0.6543,0.6515,0.6544
2023-08-17 15:50,1992,165,1827,204108,24442,179666,153189804.0,15932674.0,137257130.0,1966,148,1818,202222,23308,178914,152048799.0,15192813.0,136855986.0,0.6519,0.764,0.6518,0.7649
2023-08-17 15:55,1107,498,609,88509,43364,45145,57792655.0,28233580.0,29559074.0,1079,488,591,87650,43380,44270,57224386.0,28244224.0,28980162.0,0.6511,0.6548,0.6511,0.6546
2023-08-17 16:00,888,368,520,55716,30132,25584,36327575.0,19618377.0,16709198.0,873,359,514,55715,30191,25524,36330114.0,19654551.0,16675563.0,0.6511,0.6531,0.651,0.6533
2023-08-17 16:05,1040,686,354,87912,51545,36367,67535397.0,33665354.0,33870043.0,986,659,327,85650,50821,34829,65985458.0,33182767.0,32802690.0,0.6531,0.9313,0.6529,0.9418
2023-08-17 16:10,2852,2433,419,333139,309827,23312,228419886.0,203003928.0,25415958.0,2746,2392,354,326548,304959,21589,223977510.0,199736409.0,24241101.0,0.6552,1.0903,0.655,1.1228
2023-08-17 16:15,2430,1818,612,279190,257323,21867,213306242.0,168852226.0,44454016.0,2325,1767,558,274053,254542,19511,209909469.0,166996809.0,42912659.0,0.6562,2.0329,0.6561,2.1994
2023-08-17 16:20,2618,2111,507,285542,256996,28546,218131131.0,169204558.0,48926573.0,2471,2041,430,277748,254676,23072,213019068.0,167621421.0,45397647.0,0.6584,1.714,0.6582,1.9677
2023-08-17 16:25,1685,650,1035,113744,46098,67646,95012883.0,30330459.0,64682423.0,1614,604,1010,112588,46087,66501,94311344.0,30308808.0,64002535.0,0.658,0.9562,0.6576,0.9624
2023-08-17 16:30,1950,838,1112,191758,43368,148390,136636415.0,28528915.0,108107499.0,1913,815,1098,188211,40854,147357,134317477.0,26863282.0,107454194.0,0.6578,0.7285,0.6575,0.7292
2023-08-17 16:35,552,290,262,50688,11409,39279,53519339.0,7521018.0,45998320.0,520,277,243,50392,11038,39354,53327868.0,7274653.0,46053214.0,0.6592,1.1711,0.6591,1.1702
2023-08-17 16:40,484,154,330,57382,5305,52077,57883733.0,3489216.0,54394517.0,447,131,316,56345,4013,52332,57204125.0,2633159.0,54570966.0,0.6577,1.0445,0.6562,1.0428
2023-08-17 16:45,284,110,174,29006,4628,24378,19159280.0,3049009.0,16110270.0,267,105,162,29439,5045,24394,19501736.0,3325025.0,16176710.0,0.6588,0.6609,0.6591,0.6631
2023-08-17 16:50,139,73,66,7822,2804,5018,5163902.0,1844899.0,3319003.0,124,61,63,6543,2192,4351,4320876.0,1440654.0,2880221.0,0.658,0.6614,0.6572,0.662
2023-08-17 16:55,1181,784,397,117709,81508,36201,77640748.0,53668013.0,23972735.0,1158,770,388,117225,81435,35790,77263130.0,53562422.0,23700707.0,0.6584,0.6622,0.6577,0.6622
2023-08-17 17:00,1416,843,573,119365,79441,39924,78665804.0,52249358.0,26416446.0,1377,822,555,118144,78384,39760,77855293.0,51542560.0,26312732.0,0.6577,0.6617,0.6576,0.6618
2023-08-17 17:05,324,168,156,28842,16455,12387,19024417.0,10824238.0,8200179.0,311,162,149,28504,16153,12351,18800911.0,10624260.0,8176651.0,0.6578,0.662,0.6577,0.662
2023-08-17 17:10,355,57,298,14220,3948,10272,9430453.0,2631852.0,6798600.0,339,49,290,12864,3481,9383,8503745.0,2293543.0,6210202.0,0.6666,0.6619,0.6589,0.6619
2023-08-17 17:15,108,42,66,10948,3281,7667,7365763.0,2149261.0,5216502.0,85,35,50,6615,3050,3565,4357667.0,1996085.0,2361581.0,0.6551,0.6804,0.6545,0.6624
2023-08-17 17:20,1260,432,828,101372,30932,70440,76688887.0,20310081.0,56378805.0,1202,404,798,101903,30230,71673,77290429.0,19838640.0,57451789.0,0.6566,0.8004,0.6563,0.8016
2023-08-17 17:25,515,92,423,67998,5165,62833,54746317.0,3400738.0,51345579.0,471,72,399,65695,4298,61397,53304202.0,2828073.0,50476129.0,0.6584,0.8172,0.658,0.8221
2023-08-17 17:30,1282,390,892,159911,30918,128993,125396558.0,20283577.0,105112981.0,1249,376,873,158272,29975,128297,124317277.0,19664529.0,104652748.0,0.656,0.8149,0.656,0.8157
2023-08-17 17:35,271,83,188,31717,8012,23705,20874524.0,5250329.0,15624194.0,253,75,178,31228,8217,23011,20558292.0,5384875.0,15173417.0,0.6553,0.6591,0.6553,0.6594
2023-08-17 17:40,879,359,520,85567,48680,36887,56388528.0,32063831.0,24324697.0,850,342,508,83332,46613,36719,54809558.0,30592364.0,24217194.0,0.6587,0.6594,0.6563,0.6595
2023-08-17 17:45,543,292,251,57965,44980,12985,38078876.0,29514070.0,8564805.0,533,287,246,56527,44142,12385,37135730.0,28965296.0,8170433.0,0.6562,0.6596,0.6562,0.6597
2023-08-17 17:50,439,79,360,46454,12910,33544,40643117.0,8510438.0,32132679.0,419,69,350,45970,13022,32948,40273063.0,8562430.0,31710633.0,0.6592,0.9579,0.6575,0.9624
2023-08-17 17:55,400,69,331,43225,10102,33123,38713293.0,6820899.0,31892394.0,379,58,321,40061,7469,32592,36429707.0,4914800.0,31514906.0,0.6752,0.9628,0.658,0.967
2023-08-17 18:00,3600,2078,1522,348994,262788,86206,240078243.0,172972938.0,67105305.0,3568,2062,1506,349885,263365,86520,240650131.0,173312386.0,67337745.0,0.6582,0.7784,0.6581,0.7783
2023-08-17 18:05,2671,697,1974,289569,83086,206483,201074547.0,54659186.0,146415360.0,2642,685,1957,285413,81770,203643,198401274.0,53797451.0,144603822.0,0.6579,0.7091,0.6579,0.7101
2023-08-17 18:10,1954,538,1416,204256,47104,157152,174727470.0,30950691.0,143776778.0,1930,528,1402,205943,49120,156823,175819025.0,32255307.0,143563718.0,0.6571,0.9149,0.6567,0.9155
2023-08-17 18:15,697,246,451,75072,22274,52798,49561272.0,14633579.0,34927693.0,678,236,442,74468,21638,52830,49159753.0,14211545.0,34948208.0,0.657,0.6615,0.6568,0.6615
2023-08-17 18:20,1336,399,937,113086,67969,45117,74402361.0,44593578.0,29808783.0,1319,395,924,110096,66403,43693,72435471.0,43562344.0,28873127.0,0.6561,0.6607,0.656,0.6608
2023-08-17 18:25,428,238,190,56729,41125,15604,37262520.0,26979458.0,10283062.0,410,232,178,55839,40897,14942,36680017.0,26825343.0,9854673.0,0.656,0.659,0.6559,0.6595
2023-08-17 18:30,509,308,201,65416,48222,17194,42968005.0,31632644.0,11335361.0,472,275,197,64819,47579,17240,42583763.0,31197335.0,11386427.0,0.656,0.6593,0.6557,0.6605
2023-08-17 18:35,248,107,141,26070,13017,13053,17213751.0,8603924.0,8609827.0,234,97,137,25957,12917,13040,17105144.0,8476701.0,8628443.0,0.661,0.6596,0.6562,0.6617
2023-08-18 10:00,4054,2638,1416,402848,255235,147613,373702032.0,166317546.0,207384486.0,3330,2308,1022,367824,239021,128803,340704251.0,155997944.0,184706307.0,0.6516,1.4049,0.6527,1.434
2023-08-18 10:05,3908,2883,1025,419753,286587,133166,376701241.0,188252779.0,188448462.0,3663,2745,918,406636,278589,128047,367848901.0,182884506.0,184964394.0,0.6569,1.4151,0.6565,1.4445
2023-08-18 10:10,1231,979,252,116558,82521,34037,77052738.0,54213955.0,22838783.0,1122,906,216,105087,80514,24573,69178888.0,52913292.0,16265595.0,0.657,0.671,0.6572,0.6619
2023-08-18 10:15,1309,961,348,81961,61632,20329,63953329.0,40524050.0,23429278.0,1116,863,253,81641,62727,18914,63770187.0,41225391.0,22544795.0,0.6575,1.1525,0.6572,1.192
2023-08-18 10:20,2235,666,1569,185913,45191,140722,172325532.0,29636275.0,142689257.0,2171,622,1549,184629,44823,139806,171519157.0,29394828.0,142124328.0,0.6558,1.014,0.6558,1.0166
2023-08-18 10:25,1417,302,1115,133380,20985,112395,97942076.0,13781519.0,84160557.0,1373,280,1093,132103,20419,111684,97067548.0,13409725.0,83657822.0,0.6567,0.7488,0.6567,0.7491
2023-08-18 10:30,1490,772,718,113940,46722,67218,84758562.0,30518754.0,54239807.0,1449,724,725,110554,43887,66667,82752603.0,28804980.0,53947622.0,0.6532,0.8069,0.6563,0.8092
2023-08-18 10:35,1105,699,406,85630,41981,43649,66287803.0,27587861.0,38699942.0,1031,660,371,81443,40991,40452,63547342.0,26911989.0,36635353.0,0.6572,0.8866,0.6565,0.9056
2023-08-18 10:40,1549,662,887,127567,39902,87665,83818851.0,26137994.0,57680856.0,1495,628,867,123206,36909,86297,81035885.0,24188010.0,56847875.0,0.6551,0.658,0.6553,0.6587
2023-08-18 10:45,2846,1716,1130,236108,77260,158848,155004973.0,50538670.0,104466302.0,2784,1690,1094,233667,76915,156752,153407148.0,50315771.0,103091377.0,0.6541,0.6576,0.6542,0.6577
2023-08-18 10:50,584,273,311,58234,8520,49714,38138577.0,5577262.0,32561314.0,522,249,273,56582,8214,48368,37083576.0,5374560.0,31709016.0,0.6546,0.655,0.6543,0.6556
2023-08-18 10:55,662,224,438,75205,6524,68681,59197142.0,4260737.0,54936404.0,632,208,424,74182,6084,68098,58564745.0,3970770.0,54593974.0,0.6531,0.7999,0.6527,0.8017
2023-08-18 11:00,257,78,179,24678,3794,20884,16157768.0,2478078.0,13679689.0,242,69,173,22071,3261,18810,14459446.0,2128791.0,12330654.0,0.6532,0.655,0.6528,0.6555
2023-08-18 11:05,1553,548,1005,164001,18294,145707,117162043.0,11925341.0,105236701.0,1503,516,987,164411,17529,146882,117505500.0,11430590.0,106074909.0,0.6519,0.7222,0.6521,0.7222
2023-08-18 11:10,3445,1051,2394,279908,41492,238416,183043815.0,27078456.0,155965359.0,3396,1025,2371,277697,40460,237237,181563080.0,26380197.0,155182883.0,0.6526,0.6542,0.652,0.6541
2023-08-18 11:15,2971,681,2290,254733,40299,214434,166519606.0,26284819.0,140234787.0,2948,665,2283,253661,39535,214126,165789231.0,25752847.0,140036383.0,0.6522,0.654,0.6514,0.654
2023-08-18 11:20,2458,1778,680,239823,179743,60080,166659149.0,117366646.0,49292502.0,2434,1761,673,237256,178235,59021,164909342.0,116332335.0,48577007.0,0.653,0.8204,0.6527,0.823
2023-08-18 11:25,1467,980,487,141235,117415,23820,92304895.0,76701206.0,15603688.0,1431,957,474,139514,115623,23891,91180676.0,75525513.0,15655162.0,0.6532,0.6551,0.6532,0.6553
2023-08-18 11:30,2629,1865,764,272442,241809,30633,177849975.0,157778160.0,20071814.0,2607,1856,751,269912,241464,28448,176181580.0,157547723.0,18633857.0,0.6525,0.6552,0.6525,0.655
2023-08-18 11:35,1487,1179,308,158430,149026,9404,103511964.0,97346747.0,6165217.0,1421,1127,294,154362,145235,9127,100759757.0,94776114.0,5983642.0,0.6532,0.6556,0.6526,0.6556
2023-08-18 11:40,881,566,315,89521,77895,11626,58507668.0,50966324.0,7541344.0,815,520,295,83949,75547,8402,54838733.0,49330009.0,5508723.0,0.6543,0.6487,0.653,0.6556
2023-08-18 11:45,401,252,149,34458,24699,9759,22621992.0,16206399.0,6415593.0,351,219,132,33292,23462,9830,21836336.0,15317903.0,6518432.0,0.6562,0.6574,0.6529,0.6631
2023-08-18 11:50,716,553,163,83394,78393,5001,54451976.0,51178177.0,3273799.0,688,533,155,83238,78541,4697,54352977.0,51271486.0,3081490.0,0.6528,0.6546,0.6528,0.6561
2023-08-18 11:55,284,216,68,34417,31533,2884,22491433.0,20591188.0,1900245.0,249,181,68,32959,30621,2338,21515471.0,19982191.0,1533279.0,0.653,0.6589,0.6526,0.6558
2023-08-18 12:00,685,551,134,90327,85009,5318,58968134.0,55504866.0,3463268.0,657,532,125,89099,84787,4312,58205675.0,55360802.0,2844872.0,0.6529,0.6512,0.6529,0.6598
2023-08-18 12:05,316,268,48,32294,28911,3383,21108139.0,18884174.0,2223965.0,292,249,43,29985,27574,2411,19585504.0,18003961.0,1581542.0,0.6532,0.6574,0.6529,0.656
2023-08-18 12:10,271,234,37,30013,24987,5026,19700885.0,16346219.0,3354666.0,243,214,29,29043,24365,4678,19033203.0,15907088.0,3126114.0,0.6542,0.6675,0.6529,0.6683
2023-08-18 12:15,3356,1075,2281,439920,57545,382375,327398024.0,37706827.0,289691197.0,3186,966,2220,432325,53669,378656,322472255.0,35093009.0,287379245.0,0.6553,0.7576,0.6539,0.7589
2023-08-18 12:20,413,102,311,51731,5553,46178,33895208.0,3641395.0,30253812.0,379,75,304,49252,4103,45149,32220745.0,2677116.0,29543629.0,0.6558,0.6552,0.6525,0.6544
2023-08-18 12:25,1241,646,595,113713,48016,65697,94093514.0,31283013.0,62810501.0,1196,632,564,111811,47088,64723,92854484.0,30662815.0,62191669.0,0.6515,0.9561,0.6512,0.9609
2023-08-18 12:30,1176,567,609,123685,52891,70794,100774961.0,34534324.0,66240637.0,1130,534,596,120958,50578,70380,98926734.0,32998313.0,65928421.0,0.6529,0.9357,0.6524,0.9367
2023-08-18 12:35,1995,1688,307,269134,232082,37052,186058452.0,151717173.0,34341279.0,1935,1645,290,263315,228005,35310,182217614.0,149037203.0,33180410.0,0.6537,0.9268,0.6537,0.9397
2023-08-18 12:40,2052,1286,766,229599,169758,59841,150381834.0,111015930.0,39365904.0,2013,1262,751,227642,168776,58866,149054868.0,110330459.0,38724409.0,0.654,0.6578,0.6537,0.6578
2023-08-18 12:45,2942,1513,1429,386616,235653,150963,253374721.0,154169969.0,99204752.0,2900,1489,1411,384442,235085,149357,252034096.0,153775712.0,98258383.0,0.6542,0.6571,0.6541,0.6579
2023-08-18 12:50,1813,823,990,218939,121951,96988,153622039.0,79789091.0,73832948.0,1778,797,981,216992,120316,96676,152320157.0,78711461.0,73608695.0,0.6543,0.7613,0.6542,0.7614
2023-08-18 12:55,2021,989,1032,221992,104274,117718,145779465.0,68268346.0,77511119.0,2000,975,1025,222175,104699,117476,145878660.0,68534440.0,77344220.0,0.6547,0.6584,0.6546,0.6584
2023-08-18 13:00,2448,924,1524,232315,57566,174749,162958872.0,37766114.0,125192758.0,2404,894,1510,230256,56251,174005,161538211.0,36857291.0,124680920.0,0.656,0.7164,0.6552,0.7165
2023-08-18 13:05,549,349,200,45059,29464,15595,29710365.0,19441492.0,10268873.0,478,311,167,40668,26991,13677,26734894.0,17709739.0,9025154.0,0.6598,0.6585,0.6561,0.6599
2023-08-18 13:10,805,600,205,55140,39665,15475,36247071.0,26087126.0,10159945.0,773,581,192,53563,39413,14150,35248611.0,25909070.0,9339540.0,0.6577,0.6565,0.6574,0.66
2023-08-18 13:15,456,294,162,31158,18474,12684,20508691.0,12146768.0,8361923.0,445,284,161,31049,18513,12536,20437795.0,12173050.0,8264745.0,0.6575,0.6592,0.6575,0.6593
2023-08-18 13:20,3299,1248,2051,325396,101621,223775,244208075.0,66822677.0,177385397.0,3220,1211,2009,322027,99109,222918,241947366.0,65098394.0,176848972.0,0.6576,0.7927,0.6568,0.7933
2023-08-18 13:25,936,593,343,80899,45659,35240,63181340.0,29944796.0,33236544.0,915,578,337,79613,44695,34918,62310451.0,29291376.0,33019075.0,0.6558,0.9431,0.6554,0.9456
2023-08-18 13:30,680,209,471,64808,21449,43359,62698839.0,14128673.0,48570165.0,659,199,460,63493,20427,43066,61789124.0,13408933.0,48380191.0,0.6587,1.1202,0.6564,1.1234
2023-08-18 13:35,2026,1012,1014,206272,124203,82069,155474766.0,81431633.0,74043132.0,1978,986,992,204342,122939,81403,154218300.0,80587956.0,73630344.0,0.6556,0.9022,0.6555,0.9045
2023-08-18 13:40,1531,969,562,167916,115357,52559,120104264.0,75585838.0,44518425.0,1517,961,556,166503,114860,51643,119258817.0,75257928.0,44000888.0,0.6552,0.847,0.6552,0.852
2023-08-18 13:45,412,267,145,24361,9924,14437,16019121.0,6507320.0,9511801.0,392,257,135,22827,8791,14036,15013071.0,5764622.0,9248448.0,0.6557,0.6588,0.6557,0.6589
2023-08-18 13:50,430,375,55,29877,21729,8148,19610906.0,14244675.0,5366230.0,418,366,52,29406,21591,7815,19302263.0,14152935.0,5149328.0,0.6556,0.6586,0.6555,0.6589
2023-08-18 13:55,1060,469,591,90088,48141,41947,68990094.0,31479113.0,37510981.0,1041,458,583,90920,49784,41136,69535929.0,32529232.0,37006697.0,0.6539,0.8942,0.6534,0.8996
2023-08-18 14:00,135,80,55,9763,5420,4343,6410239.0,3550317.0,2859922.0,126,74,52,9202,5211,3991,6040764.0,3410520.0,2630243.0,0.655,0.6585,0.6545,0.659
2023-08-18 14:05,540,182,358,37708,14506,23202,24692245.0,9478467.0,15213778.0,533,180,353,37702,14784,22918,24698655.0,9644545.0,15054109.0,0.6534,0.6557,0.6524,0.6569
2023-08-18 14:10,420,107,313,30493,13054,17439,19918447.0,8530526.0,11387921.0,402,98,304,28122,11371,16751,18448381.0,7434810.0,11013571.0,0.6535,0.653,0.6538,0.6575
2023-08-18 14:15,524,296,228,66470,41431,25039,43516626.0,27074156.0,16442469.0,507,287,220,66310,41373,24937,43418201.0,27033319.0,16384881.0,0.6535,0.6567,0.6534,0.6571
2023-08-18 14:20,737,522,215,66250,47119,19131,43326632.0,30767659.0,12558973.0,713,506,207,65306,46240,19066,42725581.0,30204486.0,12521095.0,0.653,0.6565,0.6532,0.6567
2023-08-18 14:25,593,324,269,59031,33592,25439,38654561.0,21943675.0,16710886.0,581,315,266,58899,33516,25383,38568505.0,21894603.0,16673902.0,0.6532,0.6569,0.6533,0.6569
2023-08-18 14:30,1365,846,519,138750,92789,45961,161018044.0,60777144.0,100240900.0,1343,830,513,137734,92204,45530,160299483.0,60381552.0,99917931.0,0.655,2.181,0.6549,2.1946
2023-08-18 14:35,2103,1189,914,209936,132376,77560,167705699.0,86704403.0,81001296.0,2067,1168,899,205790,130140,75650,165024574.0,85260640.0,79763934.0,0.655,1.0444,0.6551,1.0544
2023-08-18 14:40,2430,1693,737,265624,196252,69372,214527503.0,128809298.0,85718205.0,2397,1680,717,263751,195526,68225,213287685.0,128328269.0,84959415.0,0.6563,1.2356,0.6563,1.2453
2023-08-18 14:45,1997,1662,335,207916,156376,51540,146628671.0,102621988.0,44006683.0,1980,1656,324,206056,155786,50270,145356664.0,102233702.0,43122961.0,0.6563,0.8538,0.6562,0.8578
2023-08-18 14:50,2372,1767,605,346929,297926,49003,247713144.0,195424125.0,52289019.0,2349,1759,590,345700,297973,47727,246962994.0,195458851.0,51504142.0,0.6559,1.0671,0.656,1.0791
2023-08-18 14:55,1809,1315,494,261689,216397,45292,171720066.0,141887770.0,29832296.0,1790,1303,487,260085,216167,43918,170671369.0,141736141.0,28935228.0,0.6557,0.6587,0.6557,0.6588
2023-08-18 15:00,1849,449,1400,234657,24469,210188,154513094.0,16051262.0,138461832.0,1838,440,1398,234601,24638,209963,154476582.0,16162733.0,138313849.0,0.656,0.6588,0.656,0.6588
2023-08-18 15:05,1964,451,1513,238374,47812,190562,156738728.0,31284955.0,125453773.0,1949,445,1504,238080,47583,190497,156566617.0,31128997.0,125437619.0,0.6543,0.6583,0.6542,0.6585
2023-08-18 15:10,2326,1049,1277,243079,135871,107208,159625196.0,89017703.0,70607493.0,2310,1036,1274,242318,135153,107165,159123838.0,88544789.0,70579048.0,0.6552,0.6586,0.6551,0.6586
2023-08-18 15:15,1460,691,769,159419,80761,78658,104725487.0,52930317.0,51795170.0,1451,684,767,157953,80967,76986,103756911.0,53061443.0,50695467.0,0.6554,0.6585,0.6553,0.6585
2023-08-18 15:20,634,299,335,68711,29397,39314,55068485.0,19262814.0,35805670.0,612,284,328,67467,28678,38789,54279181.0,18795465.0,35483716.0,0.6553,0.9108,0.6554,0.9148
2023-08-18 15:25,4413,1691,2722,530977,182195,348782,487368768.0,119131232.0,368237536.0,4334,1637,2697,524818,177309,347509,483352783.0,115912896.0,367439886.0,0.6539,1.0558,0.6537,1.0574
2023-08-18 15:30,3918,2630,1288,475009,355949,119060,330747290.0,232572558.0,98174731.0,3883,2615,1268,474529,355765,118764,330439240.0,232446127.0,97993113.0,0.6534,0.8246,0.6534,0.8251
2023-08-18 15:35,3540,2757,783,369408,316113,53295,241453683.0,206506517.0,34947166.0,3527,2751,776,370741,316199,54542,242351855.0,206562101.0,35789754.0,0.6533,0.6557,0.6533,0.6562
2023-08-18 15:40,3923,2910,1013,401031,322198,78833,262178258.0,210440328.0,51737930.0,3903,2898,1005,400676,321912,78764,261946750.0,210252033.0,51694717.0,0.6531,0.6563,0.6531,0.6563
2023-08-18 15:45,2005,1005,1000,187894,85665,102229,123051465.0,55955496.0,67095968.0,1989,997,992,186914,85739,101175,122450712.0,56003198.0,66447514.0,0.6532,0.6563,0.6532,0.6568
2023-08-18 15:50,1294,634,660,127679,44082,83597,83663879.0,28784882.0,54878997.0,1286,630,656,127571,44062,83509,83594469.0,28770102.0,54824367.0,0.653,0.6565,0.6529,0.6565
2023-08-18 15:55,1665,938,727,168880,61867,107013,140644025.0,40412362.0,100231662.0,1709,957,752,169474,62493,106981,140995871.0,40809059.0,100186811.0,0.6532,0.9366,0.653,0.9365
2023-08-18 16:00,3463,1629,1834,366198,80710,285488,280371605.0,52791594.0,227580011.0,3407,1581,1826,365003,79652,285351,279602643.0,52106368.0,227496274.0,0.6541,0.7972,0.6542,0.7973
2023-08-18 16:05,2224,1018,1206,222968,54381,168587,146460875.0,35579266.0,110881609.0,2198,996,1202,220668,52459,168209,144963890.0,34332611.0,110631279.0,0.6543,0.6577,0.6545,0.6577
2023-08-18 16:10,2498,1091,1407,267807,78377,189430,195931533.0,51333174.0,144598358.0,2477,1086,1391,266853,78888,187965,195299165.0,51666084.0,143633080.0,0.655,0.7633,0.6549,0.7641
2023-08-18 16:15,2789,1066,1723,321910,69285,252625,211611320.0,45389160.0,166222159.0,2784,1063,1721,322147,69265,252882,211767124.0,45374495.0,166392629.0,0.6551,0.658,0.6551,0.658
2023-08-18 16:20,2421,840,1581,289081,66470,222611,190099405.0,43536474.0,146562931.0,2409,836,1573,287763,65952,221811,189238201.0,43199085.0,146039116.0,0.655,0.6584,0.655,0.6584
2023-08-18 16:25,1813,632,1181,210003,56223,153780,138057956.0,36811555.0,101246401.0,1810,631,1179,209935,56350,153585,138009816.0,36893570.0,101116245.0,0.6547,0.6584,0.6547,0.6584
2023-08-18 16:30,1622,658,964,190943,69395,121548,125432402.0,45434791.0,79997611.0,1620,654,966,191950,69434,122516,126094649.0,45460786.0,80633863.0,0.6547,0.6582,0.6547,0.6581
2023-08-18 16:35,1444,616,828,162329,59454,102875,106719276.0,38936801.0,67782474.0,1438,610,828,162907,58939,103968,107133432.0,38599585.0,68533846.0,0.6549,0.6589,0.6549,0.6592
2023-08-18 16:40,590,346,244,43618,37011,6607,28592900.0,24247670.0,4345230.0,572,334,238,43384,36831,6553,28438395.0,24129096.0,4309299.0,0.6551,0.6577,0.6551,0.6576
2023-08-18 16:45,557,234,323,56873,22568,34305,37438764.0,14812109.0,22626655.0,544,227,317,56842,22289,34553,37419634.0,14627347.0,22792287.0,0.6563,0.6596,0.6563,0.6596
2023-08-18 16:50,1100,371,729,103810,27309,76501,78415964.0,17926612.0,60489351.0,1092,366,726,103286,26982,76304,78047432.0,17711165.0,60336267.0,0.6564,0.7907,0.6564,0.7907
2023-08-18 16:55,1153,649,504,99070,49940,49130,165529816.0,32915943.0,132613872.0,1127,638,489,97463,49050,48413,164360510.0,32212112.0,132148398.0,0.6591,2.6992,0.6567,2.7296
2023-08-18 17:00,2071,859,1212,222515,75013,147502,146657615.0,49264405.0,97393209.0,2033,829,1204,221129,74045,147084,145746125.0,48627195.0,97118930.0,0.6567,0.6603,0.6567,0.6603
2023-08-18 17:05,905,337,568,81811,31602,50209,64031486.0,20820925.0,43210561.0,873,321,552,79420,29943,49477,62389929.0,19691821.0,42698107.0,0.6588,0.8606,0.6576,0.863
2023-08-18 17:10,3063,1830,1233,293235,210987,82248,203684646.0,139135424.0,64549222.0,2976,1786,1190,290249,209601,80648,201644699.0,138157797.0,63486902.0,0.6595,0.7848,0.6591,0.7872
2023-08-18 17:15,1634,1157,477,171501,151525,19976,133260164.0,99873126.0,33387038.0,1567,1135,432,169250,150833,18417,131757585.0,99376514.0,32381071.0,0.6591,1.6714,0.6589,1.7582
2023-08-18 17:20,2140,867,1273,218831,87708,131123,225241474.0,57847617.0,167393856.0,2102,849,1253,215446,86577,128869,223047282.0,57094795.0,165952487.0,0.6595,1.2766,0.6595,1.2878
2023-08-18 17:25,2797,703,2094,302990,31538,271452,210690438.0,20790191.0,189900246.0,2768,682,2086,303171,32062,271109,210871581.0,21137003.0,189734578.0,0.6592,0.6996,0.6593,0.6998
2023-08-18 17:30,1862,504,1358,246615,28266,218349,163383489.0,18640373.0,144743116.0,1839,485,1354,247109,27735,219374,163706663.0,18279600.0,145427063.0,0.6595,0.6629,0.6591,0.6629
2023-08-18 17:35,1159,292,867,140480,11286,129194,93152725.0,7455022.0,85697703.0,1139,282,857,140082,11095,128987,92886429.0,7313491.0,85572937.0,0.6606,0.6633,0.6592,0.6634
2023-08-18 17:40,1054,429,625,109923,31723,78200,72732736.0,20913065.0,51819671.0,1043,423,620,110164,32165,77999,72899055.0,21203840.0,51695215.0,0.6592,0.6627,0.6592,0.6628
2023-08-18 17:45,1285,555,730,135710,40692,95018,99792280.0,26822404.0,72969875.0,1273,546,727,135257,40309,94948,99519502.0,26568253.0,72951248.0,0.6592,0.768,0.6591,0.7683
2023-08-18 17:50,1203,488,715,105500,42955,62545,79782551.0,28334023.0,51448528.0,1186,479,707,104574,42757,61817,79132378.0,28186234.0,50946143.0,0.6596,0.8226,0.6592,0.8241
2023-08-18 17:55,1544,602,942,205393,40765,164628,135977897.0,26887896.0,109090001.0,1522,588,934,205280,40865,164415,135890478.0,26945514.0,108944964.0,0.6596,0.6626,0.6594,0.6626
2023-08-18 18:00,844,411,433,101355,33872,67483,67076914.0,22346423.0,44730491.0,825,402,423,100339,33208,67131,66392506.0,21887060.0,44505445.0,0.6597,0.6628,0.6591,0.663
2023-08-18 18:05,328,48,280,18021,4567,13454,21987750.0,3024908.0,18962841.0,309,39,270,17306,4166,13140,21521774.0,2748414.0,18773359.0,0.6623,1.4095,0.6597,1.4287
2023-08-18 18:10,1067,508,559,140846,53819,87027,93266698.0,35528818.0,57737879.0,1113,559,554,142906,55512,87394,94603493.0,36611902.0,57991590.0,0.6602,0.6634,0.6595,0.6636
2023-08-18 18:15,333,132,201,38719,9747,28972,25653541.0,6434735.0,19218805.0,317,124,193,39076,10221,28855,25894942.0,6738487.0,19156455.0,0.6602,0.6634,0.6593,0.6639
2023-08-18 18:20,2786,1549,1237,297722,183773,113949,217119772.0,121449709.0,95670063.0,2740,1524,1216,293472,181068,112404,214215000.0,119514654.0,94700346.0,0.6609,0.8396,0.6601,0.8425
2023-08-18 18:25,1511,953,558,143721,111106,32615,94907150.0,73288092.0,21619057.0,1502,949,553,143464,111042,32422,94755956.0,73245906.0,21510050.0,0.6596,0.6629,0.6596,0.6634
2023-08-18 18:30,994,529,465,86719,60970,25749,67275920.0,40198164.0,27077755.0,969,514,455,85000,60444,24556,66191851.0,39841140.0,26350710.0,0.6593,1.0516,0.6591,1.0731
2023-08-18 18:35,820,417,403,75318,56017,19301,59663943.0,36920688.0,22743255.0,787,391,396,76296,54285,22011,60520120.0,35731225.0,24788895.0,0.6591,1.1783,0.6582,1.1262
2023-08-21 10:00,4401,2740,1661,504357,352575,151782,441864202.0,236338823.0,205525378.0,3543,2435,1108,461223,335439,125784,402288678.0,224737761.0,177550916.0,0.6703,1.3541,0.67,1.4116
2023-08-21 10:05,4118,2437,1681,428759,269826,158933,317897919.0,180389713.0,137508206.0,3721,2277,1444,408155,260904,147251,304510792.0,174693050.0,129817742.0,0.6685,0.8652,0.6696,0.8816
2023-08-21 10:10,3750,2433,1317,395265,247750,147515,286864406.0,166383403.0,120481002.0,3523,2318,1205,380199,242045,138154,276134314.0,162321234.0,113813080.0,0.6716,0.8167,0.6706,0.8238
2023-08-21 10:15,2791,2253,538,304156,283864,20292,204377706.0,190698248.0,13679457.0,2493,2133,360,299874,280109,19765,201491698.0,188113512.0,13378186.0,0.6718,0.6741,0.6716,0.6769
2023-08-21 10:20,5025,2952,2073,620763,438923,181840,458049498.0,294450197.0,163599300.0,4877,2885,1992,611923,436238,175685,452073260.0,292605908.0,159467352.0,0.6708,0.8997,0.6707,0.9077
2023-08-21 10:25,4932,2345,2587,547776,255445,292331,368235019.0,171279751.0,196955267.0,4818,2282,2536,544236,253715,290521,365885879.0,170117435.0,195768444.0,0.6705,0.6737,0.6705,0.6739
2023-08-21 10:30,2870,2267,603,360522,330164,30358,263073773.0,222024335.0,41049438.0,2728,2188,540,350788,323166,27622,256445410.0,217266668.0,39178742.0,0.6725,1.3522,0.6723,1.4184
2023-08-21 10:35,1107,894,213,99887,86147,13740,67223032.0,57960559.0,9262473.0,1033,859,174,94166,82635,11531,63343064.0,55557906.0,7785158.0,0.6728,0.6741,0.6723,0.6752
2023-08-21 10:40,1966,1343,623,210792,170740,40052,142044988.0,114831631.0,27213357.0,1888,1299,589,201352,168341,33011,135532693.0,113163185.0,22369508.0,0.6726,0.6795,0.6722,0.6776
2023-08-21 10:45,593,366,227,28217,18063,10154,19033211.0,12191263.0,6841948.0,526,338,188,25246,16160,9086,17010577.0,10856899.0,6153678.0,0.6749,0.6738,0.6718,0.6773
2023-08-21 10:50,298,208,90,19256,14291,4965,13065881.0,9631772.0,3434109.0,246,177,69,15730,13189,2541,10606603.0,8876463.0,1730140.0,0.674,0.6917,0.673,0.6809
2023-08-21 10:55,3904,1652,2252,393782,139156,254626,265395035.0,93526239.0,171868796.0,3840,1622,2218,389987,137743,252244,262811273.0,92545036.0,170266237.0,0.6721,0.675,0.6719,0.675
2023-08-21 11:00,4925,2490,2435,660546,265831,394715,525795643.0,178322630.0,347473012.0,4815,2430,2385,656378,263687,392691,523284466.0,176867277.0,346417189.0,0.6708,0.8803,0.6707,0.8822
2023-08-21 11:05,6229,4046,2183,816327,634291,182036,558558900.0,425579258.0,132979642.0,6162,4010,2152,817747,632555,185192,559496155.0,424380951.0,135115204.0,0.671,0.7305,0.6709,0.7296
2023-08-21 11:10,4053,3345,708,530476,462483,67993,356768347.0,310883109.0,45885238.0,4005,3323,682,529823,461874,67949,356344070.0,310473955.0,45870115.0,0.6722,0.6749,0.6722,0.6751
2023-08-21 11:15,6335,4389,1946,895947,723694,172253,602975123.0,486726212.0,116248911.0,6257,4356,1901,891068,722654,168414,599717857.0,486014752.0,113703105.0,0.6726,0.6749,0.6725,0.6751
2023-08-21 11:20,2917,1559,1358,368909,191772,177137,248425946.0,128895081.0,119530865.0,2875,1542,1333,362734,190432,172302,244230171.0,127978876.0,116251295.0,0.6721,0.6748,0.672,0.6747
2023-08-21 11:25,1444,1228,216,193664,175761,17903,140235539.0,117953069.0,22282469.0,1370,1212,158,191371,175394,15977,138711976.0,117703320.0,21008655.0,0.6711,1.2446,0.6711,1.3149
2023-08-21 11:30,2496,1604,892,212940,139090,73850,152742848.0,93154743.0,59588105.0,2374,1559,815,209384,138259,71125,150685196.0,92601003.0,58084192.0,0.6697,0.8069,0.6698,0.8166
2023-08-21 11:35,2619,696,1923,339931,38262,301669,228189704.0,25576142.0,202613562.0,2536,637,1899,337388,36479,300909,226542004.0,24377736.0,202164268.0,0.6684,0.6716,0.6683,0.6718
2023-08-21 11:40,3857,1161,2696,564532,71330,493202,478482726.0,47531683.0,430951042.0,3694,1068,2626,551754,65259,486495,470473973.0,43468306.0,427005667.0,0.6664,0.8738,0.6661,0.8777
2023-08-21 11:45,4320,2973,1347,435143,330459,104684,321227984.0,220565364.0,100662620.0,4243,2938,1305,435036,331501,103535,320995231.0,221126646.0,99868585.0,0.6675,0.9616,0.667,0.9646
2023-08-21 11:50,2332,1530,802,314421,255746,58675,220021201.0,170608773.0,49412427.0,2263,1492,771,312359,254369,57990,218712652.0,169665246.0,49047405.0,0.6671,0.8421,0.667,0.8458
2023-08-21 11:55,1749,555,1194,254404,95350,159054,170171071.0,63555154.0,106615917.0,1717,533,1184,253946,95497,158449,169860087.0,63645271.0,106214816.0,0.6665,0.6703,0.6665,0.6703
2023-08-21 12:00,2606,1004,1602,319033,146370,172663,213459405.0,97681619.0,115777786.0,2568,978,1590,319076,146183,172893,213498575.0,97544298.0,115954277.0,0.6674,0.6705,0.6673,0.6707
2023-08-21 12:05,1972,922,1050,211906,107581,104325,151971483.0,71830415.0,80141068.0,1940,907,1033,211111,107286,103825,151397868.0,71601813.0,79796055.0,0.6677,0.7682,0.6674,0.7686
2023-08-21 12:10,3201,1307,1894,422274,190830,231444,292320860.0,127266831.0,165054029.0,3169,1285,1884,420039,190573,229466,290934612.0,127095130.0,163839481.0,0.6669,0.7131,0.6669,0.714
2023-08-21 12:15,3337,1176,2161,427174,149277,277897,285532381.0,99556954.0,185975427.0,3314,1161,2153,425803,148234,277569,284636978.0,98863905.0,185773072.0,0.6669,0.6692,0.6669,0.6693
2023-08-21 12:20,2411,1306,1105,260718,140232,120486,184517039.0,93623599.0,90893439.0,2374,1284,1090,260648,140363,120285,184420131.0,93683583.0,90736548.0,0.6676,0.7544,0.6674,0.7543
2023-08-21 12:25,712,512,200,38060,27660,10400,25459418.0,18486542.0,6972876.0,642,464,178,35637,26464,9173,23850599.0,17691112.0,6159486.0,0.6683,0.6705,0.6685,0.6715
2023-08-21 12:30,760,218,542,40800,19891,20909,27423020.0,13301594.0,14121426.0,744,206,538,39588,19371,20217,26511244.0,12930831.0,13580413.0,0.6687,0.6754,0.6675,0.6717
2023-08-21 12:35,1228,746,482,113790,66010,47780,86245067.0,44088153.0,42156914.0,1183,717,466,110315,64841,45474,83925398.0,43284392.0,40641006.0,0.6679,0.8823,0.6675,0.8937
2023-08-21 12:40,3223,2085,1138,346625,222514,124111,231459462.0,148331985.0,83127477.0,3180,2050,1130,345189,221425,123764,230520131.0,147600918.0,82919213.0,0.6666,0.6698,0.6666,0.67
2023-08-21 12:45,2195,2082,113,227870,217316,10554,152074147.0,144991419.0,7082728.0,2175,2068,107,227601,217385,10216,151893381.0,145037039.0,6856341.0,0.6672,0.6711,0.6672,0.6711
2023-08-21 12:50,2671,2286,385,234209,199467,34742,156370491.0,133079375.0,23291115.0,2657,2278,379,234075,200095,33980,156257672.0,133476637.0,22781034.0,0.6672,0.6704,0.6671,0.6704
2023-08-21 12:55,3628,2664,964,322970,255239,67731,215527475.0,170186894.0,45340581.0,3600,2647,953,322416,255030,67386,215178729.0,170045700.0,45133029.0,0.6668,0.6694,0.6668,0.6698
2023-08-21 13:00,3537,1841,1696,361671,151629,210042,241450922.0,101037391.0,140413531.0,3516,1825,1691,361443,151082,210361,241292986.0,100651427.0,140641559.0,0.6663,0.6685,0.6662,0.6686
2023-08-21 13:05,3068,2170,898,260642,182611,78031,173942124.0,121716647.0,52225476.0,3048,2158,890,260424,182054,78370,173794298.0,121343141.0,52451157.0,0.6665,0.6693,0.6665,0.6693
2023-08-21 13:10,1427,1188,239,105923,82581,23342,70698736.0,55052150.0,15646586.0,1403,1167,236,103326,81103,22223,68981183.0,54090449.0,14890734.0,0.6666,0.6703,0.6669,0.6701
2023-08-21 13:15,80,47,33,4385,1354,3031,2945965.0,908756.0,2037209.0,67,37,30,4489,1511,2978,3010182.0,1007919.0,2002263.0,0.6712,0.6721,0.6671,0.6724
2023-08-21 13:20,68,42,26,3407,1373,2034,2290233.0,917969.0,1372263.0,51,34,17,2671,846,1825,1790780.0,564761.0,1226019.0,0.6686,0.6747,0.6676,0.6718
2023-08-21 13:25,64,39,25,7226,2732,4494,4833039.0,1820227.0,3012812.0,54,33,21,6014,1742,4272,4028663.0,1159211.0,2869452.0,0.6663,0.6704,0.6654,0.6717
2023-08-21 13:30,1723,343,1380,254152,34048,220104,180716599.0,22809377.0,157907221.0,1683,307,1376,252034,32061,219973,179227876.0,21429020.0,157798855.0,0.6699,0.7174,0.6684,0.7174
2023-08-21 13:35,1236,209,1027,143939,15649,128290,96561099.0,10463785.0,86097313.0,1216,195,1021,143350,15451,127899,96175482.0,10328893.0,85846589.0,0.6687,0.6711,0.6685,0.6712
2023-08-21 13:40,2898,749,2149,421900,71591,350309,282933348.0,47859943.0,235073405.0,2872,732,2140,422028,71729,350299,283047433.0,47940411.0,235107022.0,0.6685,0.671,0.6684,0.6712
2023-08-21 13:45,3150,732,2418,490325,75654,414671,328833677.0,50508165.0,278325512.0,3126,716,2410,489489,75446,414043,328263293.0,50363355.0,277899937.0,0.6676,0.6712,0.6675,0.6712
2023-08-21 13:50,3802,822,2980,617567,73044,544523,413929075.0,48676460.0,365252615.0,3771,802,2969,612627,69601,543026,410671400.0,46398808.0,364272592.0,0.6664,0.6708,0.6666,0.6708
2023-08-21 13:55,3747,829,2918,618580,56943,561637,414694497.0,37968821.0,376725675.0,3719,810,2909,617342,56136,561206,413982356.0,37438413.0,376543943.0,0.6668,0.6708,0.6669,0.671
2023-08-21 14:00,1673,416,1257,245701,36553,209148,175029225.0,24429980.0,150599244.0,1643,399,1244,241288,33449,207839,172036821.0,22345485.0,149691335.0,0.6683,0.7201,0.668,0.7202
2023-08-21 14:05,589,362,227,33675,21175,12500,22741891.0,14319259.0,8422631.0,520,305,215,30164,18113,12051,20264145.0,12144571.0,8119573.0,0.6762,0.6738,0.6705,0.6738
2023-08-21 14:10,513,184,329,42056,18867,23189,38548446.0,12690450.0,25857996.0,469,155,314,39986,17886,22100,37079554.0,11977652.0,25101902.0,0.6726,1.1151,0.6697,1.1358
2023-08-21 14:15,570,255,315,41106,19458,21648,38003866.0,13133683.0,24870182.0,513,233,280,33008,15225,17783,32474820.0,10231083.0,22243737.0,0.675,1.1488,0.672,1.2508
2023-08-21 14:20,1196,695,501,94775,76684,18091,63896569.0,51668304.0,12228264.0,1161,684,477,94748,75157,19591,63866741.0,50621379.0,13245362.0,0.6738,0.6759,0.6735,0.6761
2023-08-21 14:25,471,184,287,40846,26126,14720,27537068.0,17615481.0,9921586.0,434,166,268,40269,27094,13175,27168077.0,18261953.0,8906124.0,0.6743,0.674,0.674,0.676
2023-08-21 14:30,2702,2102,600,370035,316030,54005,291966800.0,214018297.0,77948502.0,2514,1999,515,353275,307048,46227,279908051.0,207354996.0,72553054.0,0.6772,1.4434,0.6753,1.5695
2023-08-21 14:35,5200,3490,1710,644983,556113,88870,487012611.0,375304009.0,111708601.0,5117,3447,1670,640850,552934,87916,484295743.0,373129324.0,111166419.0,0.6749,1.257,0.6748,1.2645
2023-08-21 14:40,1453,909,544,185809,149694,36115,136275394.0,101347824.0,34927570.0,1363,864,499,181473,147830,33643,133229938.0,100003846.0,33226091.0,0.677,0.9671,0.6765,0.9876
2023-08-21 14:45,3998,2278,1720,521944,284302,237642,374346884.0,192286920.0,182059963.0,3909,2227,1682,519447,282701,236746,372661731.0,191157215.0,181504516.0,0.6763,0.7661,0.6762,0.7667
2023-08-21 14:50,4125,2534,1591,515563,311071,204492,359219228.0,210235761.0,148983467.0,4046,2495,1551,513661,309436,204225,358118909.0,209111542.0,149007367.0,0.6758,0.7286,0.6758,0.7296
2023-08-21 14:55,6233,4497,1736,915859,764201,151658,684799214.0,519435729.0,165363485.0,5985,4375,1610,890092,747378,142714,666023713.0,506853476.0,159170237.0,0.6797,1.0904,0.6782,1.1153
2023-08-21 15:00,3929,1054,2875,548273,100551,447722,446215138.0,68542596.0,377672541.0,3708,971,2737,534390,95321,439069,437397026.0,64911114.0,372485911.0,0.6817,0.8435,0.681,0.8484
2023-08-21 15:05,4154,3118,1036,525530,433403,92127,410209810.0,295158223.0,115051587.0,4011,3057,954,513396,426646,86750,401607679.0,290208836.0,111398843.0,0.681,1.2488,0.6802,1.2841
2023-08-21 15:10,4603,3316,1287,564659,432473,132186,404631833.0,293709803.0,110922029.0,4570,3347,1223,564018,434795,129223,404307258.0,295240692.0,109066566.0,0.6791,0.8391,0.679,0.844
2023-08-21 15:15,3128,2209,919,368853,257918,110935,260681256.0,174812938.0,85868317.0,2967,2102,865,363048,254215,108833,256890745.0,172342440.0,84548305.0,0.6778,0.774,0.6779,0.7769
2023-08-21 15:20,1143,370,773,181877,20178,161699,133738742.0,13675186.0,120063556.0,1021,282,739,173765,16259,157506,128343329.0,11012492.0,117330837.0,0.6777,0.7425,0.6773,0.7449
2023-08-21 15:25,1032,366,666,95239,31790,63449,95796509.0,21624934.0,74171575.0,946,327,619,94619,29583,65036,95404920.0,20058979.0,75345940.0,0.6802,1.169,0.6781,1.1585
2023-08-21 15:30,4182,2956,1226,610952,459417,151535,424926894.0,311514660.0,113412234.0,4134,2946,1188,607658,458727,148931,422740095.0,310944150.0,111795945.0,0.6781,0.7484,0.6778,0.7507
2023-08-21 15:35,1761,864,897,186818,77386,109432,137244723.0,52484341.0,84760381.0,1733,848,885,184264,74927,109337,135433921.0,50749205.0,84684716.0,0.6782,0.7745,0.6773,0.7745
2023-08-21 15:40,3997,3121,876,551558,486384,65174,385213031.0,330382657.0,54830374.0,3943,3094,849,547459,483028,64431,382303696.0,327994728.0,54308968.0,0.6793,0.8413,0.679,0.8429
2023-08-21 15:45,5471,4072,1399,743283,637906,105377,515404668.0,433269076.0,82135592.0,5412,4047,1365,740012,637346,102666,513263644.0,432856356.0,80407288.0,0.6792,0.7794,0.6792,0.7832
2023-08-21 15:50,6097,4465,1632,732909,485035,247874,518993297.0,329472686.0,189520610.0,6046,4442,1604,729191,483065,246126,516508975.0,328106202.0,188402772.0,0.6793,0.7646,0.6792,0.7655
2023-08-21 15:55,4237,1379,2858,717471,93120,624351,488104062.0,63135757.0,424968305.0,4218,1366,2852,717812,93652,624160,488340142.0,63497435.0,424842707.0,0.678,0.6807,0.678,0.6807
2023-08-21 16:00,4658,1623,3035,827202,98382,728820,562817625.0,66677181.0,496140443.0,4632,1612,3020,827459,99113,728346,562985536.0,67169593.0,495815943.0,0.6777,0.6807,0.6777,0.6807
2023-08-21 16:05,3644,1037,2607,682529,53595,628934,464583839.0,36323990.0,428259849.0,3607,1017,2590,681342,52535,628807,463791883.0,35599402.0,428192480.0,0.6777,0.6809,0.6776,0.681
2023-08-21 16:10,510,210,300,62543,8721,53822,42605544.0,5924490.0,36681053.0,482,206,276,60711,7511,53200,41359419.0,5081031.0,36278387.0,0.6793,0.6815,0.6765,0.6819
2023-08-21 16:15,2429,1215,1214,315086,169424,145662,347342868.0,114811757.0,232531111.0,2350,1179,1171,309706,169039,140667,344092764.0,114548159.0,229544605.0,0.6777,1.5964,0.6776,1.6318
2023-08-21 16:20,6106,1743,4363,990249,100907,889342,732404007.0,68080138.0,664323869.0,5945,1649,4296,977190,93132,884058,723966915.0,62812745.0,661154169.0,0.6747,0.747,0.6744,0.7479
2023-08-21 16:25,3427,814,2613,560772,26325,534447,380143653.0,17713968.0,362429684.0,3395,799,2596,559120,25334,533786,379038324.0,17044589.0,361993735.0,0.6729,0.6781,0.6728,0.6782
2023-08-21 16:30,4139,1303,2836,581119,56488,524631,403132777.0,38001216.0,365131561.0,4121,1297,2824,584950,59817,525133,405772353.0,40203917.0,365568435.0,0.6727,0.696,0.6721,0.6961
2023-08-21 16:35,3966,1496,2470,531008,111112,419896,389563211.0,74795189.0,314768021.0,3919,1467,2452,529261,109612,419649,388293558.0,73708399.0,314585159.0,0.6732,0.7496,0.6724,0.7496
2023-08-21 16:40,1729,1019,710,207631,153243,54388,160752212.0,103358888.0,57393323.0,1700,1007,693,205176,152021,53155,158983648.0,102430039.0,56553609.0,0.6745,1.0553,0.6738,1.0639
2023-08-21 16:45,2501,924,1577,267589,153282,114307,180230840.0,102901613.0,77329227.0,2472,908,1564,267254,153223,114031,180045335.0,102863899.0,77181435.0,0.6713,0.6765,0.6713,0.6768
2023-08-21 16:50,1009,455,554,90721,58297,32424,61102258.0,39185837.0,21916420.0,991,447,544,88316,56481,31835,59492706.0,37949563.0,21543143.0,0.6722,0.6759,0.6719,0.6767
2023-08-21 16:55,944,269,675,77813,27138,50675,52493000.0,18230342.0,34262657.0,937,269,668,78711,28529,50182,53140098.0,19167174.0,33972924.0,0.6718,0.6761,0.6718,0.677
2023-08-21 17:00,4903,3372,1531,601293,489712,111581,445186805.0,328932191.0,116254614.0,4852,3339,1513,597434,487187,110247,442739364.0,327274606.0,115464757.0,0.6717,1.0419,0.6718,1.0473
2023-08-21 17:05,2636,1770,866,322648,229225,93423,217136006.0,153990588.0,63145417.0,2593,1747,846,321041,227948,93093,216080758.0,153130964.0,62949794.0,0.6718,0.6759,0.6718,0.6762
2023-08-21 17:10,922,698,224,83641,65657,17984,66650941.0,44233268.0,22417673.0,913,691,222,84855,66901,17954,67360912.0,44988190.0,22372721.0,0.6737,1.2465,0.6725,1.2461
2023-08-21 17:15,2061,1126,935,239140,149991,89149,161121680.0,100931631.0,60190049.0,2048,1119,929,238838,150292,88546,160976770.0,101133997.0,59842773.0,0.6729,0.6752,0.6729,0.6758
2023-08-21 17:20,585,260,325,55567,17940,37627,37470544.0,12053774.0,25416769.0,575,256,319,55483,17978,37505,37412867.0,12078360.0,25334506.0,0.6719,0.6755,0.6718,0.6755
2023-08-21 17:25,1636,1112,524,216760,173838,42922,177459665.0,117602881.0,59856784.0,1594,1089,505,209151,167739,41412,171953812.0,113114154.0,58839658.0,0.6765,1.3945,0.6743,1.4208
2023-08-21 17:30,4691,3811,880,797781,759433,38348,538623156.0,512519155.0,26104001.0,4656,3792,864,797146,759003,38143,538176100.0,512212137.0,25963962.0,0.6749,0.6807,0.6748,0.6807
2023-08-21 17:35,4568,2920,1648,630524,471954,158570,457506506.0,318863819.0,138642686.0,4523,2903,1620,628348,470955,157393,455995198.0,318106641.0,137888557.0,0.6756,0.8743,0.6755,0.8761
2023-08-21 17:40,7519,4484,3035,1011211,695993,315218,715261445.0,470108454.0,245152990.0,7476,4461,3015,1010729,695614,315115,714897177.0,469832618.0,245064559.0,0.6754,0.7777,0.6754,0.7777
2023-08-21 17:45,7498,2204,5294,1340406,352640,987766,998260710.0,238135816.0,760124893.0,7316,2106,5210,1324742,346637,978105,988659790.0,234119909.0,754539881.0,0.6753,0.7695,0.6754,0.7714
2023-08-21 17:50,8714,1772,6942,1477166,76564,1400602,1263799127.0,51454304.0,1212344822.0,8587,1685,6902,1470647,73815,1396832,1259838232.0,49610335.0,1210227897.0,0.672,0.8656,0.6721,0.8664
2023-08-21 17:55,6499,724,5775,1319238,24913,1294325,929044159.0,16717320.0,912326838.0,6376,631,5745,1313655,22904,1290751,925667148.0,15365613.0,910301535.0,0.671,0.7049,0.6709,0.7052
2023-08-21 18:00,3885,929,2956,613361,32074,581287,451449817.0,21488259.0,429961558.0,3641,780,2861,607078,30174,576904,447537203.0,20092350.0,427444853.0,0.67,0.7397,0.6659,0.7409
2023-08-21 18:05,4121,2109,2012,486507,225656,260851,406970786.0,150666177.0,256304609.0,3908,1990,1918,475721,219725,255996,399718772.0,146622302.0,253096469.0,0.6677,0.9826,0.6673,0.9887
2023-08-21 18:10,2327,1611,716,252514,187916,64598,188942409.0,125374389.0,63568019.0,2304,1610,694,252960,189129,63831,189311885.0,126166069.0,63145816.0,0.6672,0.9841,0.6671,0.9893
2023-08-21 18:15,5561,2193,3368,658619,172579,486040,481294481.0,115053995.0,366240485.0,5442,2113,3329,654728,169815,484913,478672864.0,113201867.0,365470997.0,0.6667,0.7535,0.6666,0.7537
2023-08-21 18:20,3216,2010,1206,304990,150526,154464,214631954.0,100709715.0,113922239.0,3122,1947,1175,299083,146912,152171,210610128.0,98266670.0,112343458.0,0.6691,0.7375,0.6689,0.7383
2023-08-21 18:25,592,288,304,62822,25470,37352,42204275.0,17043303.0,25160972.0,549,276,273,63086,26855,36231,42357152.0,17949133.0,24408019.0,0.6692,0.6736,0.6684,0.6737
2023-08-21 18:30,2101,1625,476,238678,216886,21792,170561133.0,145667819.0,24893313.0,2039,1595,444,235958,215233,20725,168582034.0,144426028.0,24156006.0,0.6716,1.1423,0.671,1.1655
2023-08-21 18:35,959,329,630,84551,30784,53767,66993685.0,20658189.0,46335496.0,1025,312,713,82217,30449,51768,65479198.0,20416840.0,45062358.0,0.6711,0.8618,0.6705,0.8705
2023-08-22 10:00,6533,3107,3426,522872,246438,276434,517972387.0,165593490.0,352378896.0,5955,2863,3092,501301,237950,263351,492912303.0,160175973.0,332736329.0,0.6719,1.2747,0.6731,1.2635
2023-08-22 10:05,2717,1872,845,251360,195613,55747,169521326.0,131594823.0,37926503.0,2609,1798,811,246144,190973,55171,166135351.0,128655306.0,37480044.0,0.6727,0.6803,0.6737,0.6793
2023-08-22 10:10,1376,811,565,94859,53369,41490,74595084.0,36074992.0,38520091.0,1230,730,500,89555,49806,39749,70952641.0,33645701.0,37306939.0,0.676,0.9284,0.6755,0.9386
2023-08-22 10:15,1639,721,918,125289,52925,72364,116071161.0,35811530.0,80259630.0,1308,582,726,120053,51218,68835,112473662.0,34563816.0,77909846.0,0.6766,1.1091,0.6748,1.1318
2023-08-22 10:20,2557,725,1832,284326,30090,254236,233267433.0,20273202.0,212994231.0,2267,562,1705,277773,29396,248377,229035669.0,19785504.0,209250165.0,0.6738,0.8378,0.6731,0.8425
2023-08-22 10:25,873,462,411,41654,17025,24629,38233383.0,11420207.0,26813176.0,704,339,365,31443,13136,18307,31376363.0,8820760.0,22555603.0,0.6708,1.0887,0.6715,1.2321
2023-08-22 10:30,2125,600,1525,247414,66742,180672,176751814.0,44787963.0,131963851.0,2022,532,1490,246089,65389,180700,175781506.0,43840602.0,131940904.0,0.6711,0.7304,0.6705,0.7302
2023-08-22 10:35,2228,433,1795,227228,59702,167526,173333086.0,40063733.0,133269353.0,2123,387,1736,225101,58095,167006,171844208.0,38938846.0,132905362.0,0.6711,0.7955,0.6703,0.7958
2023-08-22 10:40,1872,1431,441,252608,237229,15379,169957341.0,159577636.0,10379704.0,1821,1404,417,248791,234316,14475,167194894.0,157426812.0,9768081.0,0.6727,0.6749,0.6719,0.6748
2023-08-22 10:45,2576,2087,489,363979,339189,24790,244782133.0,227994837.0,16787295.0,2672,2138,534,362797,339039,23758,243926180.0,227817251.0,16108929.0,0.6722,0.6772,0.6719,0.678
2023-08-22 10:50,2056,1439,617,272283,219671,52612,183223129.0,147640614.0,35582515.0,2014,1416,598,271586,219314,52272,182769539.0,147401797.0,35367742.0,0.6721,0.6763,0.6721,0.6766
2023-08-22 10:55,4562,3049,1513,542579,433863,108716,386743247.0,292523456.0,94219791.0,4441,2996,1445,535166,428977,106189,381559138.0,289107433.0,92451705.0,0.6742,0.8667,0.6739,0.8706
2023-08-22 11:00,6092,4088,2004,817459,702297,115162,604273039.0,474581631.0,129691407.0,5978,4034,1944,812535,699499,113036,601045070.0,472690733.0,128354337.0,0.6758,1.1262,0.6758,1.1355
2023-08-22 11:05,4693,3294,1399,591363,478557,112806,399641751.0,323238736.0,76403014.0,4656,3274,1382,588767,478140,110627,397952316.0,322950196.0,75002120.0,0.6754,0.6773,0.6754,0.678
2023-08-22 11:10,1546,657,889,179215,64795,114420,121271629.0,43773709.0,77497920.0,1492,624,868,165837,57504,108333,112310858.0,38861419.0,73449439.0,0.6756,0.6773,0.6758,0.678
2023-08-22 11:15,1287,903,384,82915,59249,23666,66369211.0,40074611.0,26294599.0,1090,731,359,81830,59427,22403,65677276.0,40176325.0,25500951.0,0.6764,1.1111,0.6761,1.1383
2023-08-22 11:20,648,400,248,70084,56341,13743,47433303.0,38115361.0,9317942.0,615,384,231,69973,57212,12761,47362465.0,38695854.0,8666611.0,0.6765,0.678,0.6764,0.6791
2023-08-22 11:25,4128,1257,2871,567390,114493,452897,404950572.0,77351087.0,327599485.0,4070,1223,2847,562373,113068,449305,401659403.0,76395869.0,325263534.0,0.6756,0.7233,0.6757,0.7239
2023-08-22 11:30,6037,1232,4805,974381,88632,885749,670173819.0,59805327.0,610368492.0,6001,1209,4792,971816,87644,884172,668467083.0,59137394.0,609329689.0,0.6748,0.6891,0.6747,0.6892
2023-08-22 11:35,2676,629,2047,395636,21512,374124,268056320.0,14519227.0,253537092.0,2623,598,2025,392646,19948,372698,266024537.0,13458632.0,252565904.0,0.6749,0.6777,0.6747,0.6777
2023-08-22 11:40,2257,825,1432,319859,66044,253815,216539146.0,44535837.0,172003309.0,2211,797,1414,317449,65026,252423,214898721.0,43848204.0,171050516.0,0.6743,0.6777,0.6743,0.6776
2023-08-22 11:45,2869,1512,1357,378957,211489,167468,266758721.0,142952553.0,123806167.0,2797,1471,1326,375452,208018,167434,264169188.0,140412113.0,123757075.0,0.6759,0.7393,0.675,0.7391
2023-08-22 11:50,3099,2113,986,460565,410398,50167,311140524.0,277129847.0,34010677.0,3051,2076,975,458714,409595,49119,309931691.0,276603675.0,33328016.0,0.6753,0.6779,0.6753,0.6785
2023-08-22 11:55,1607,1168,439,240411,217442,22969,162337442.0,146784965.0,15552476.0,1563,1146,417,239562,216655,22907,161781669.0,146248402.0,15533266.0,0.6751,0.6771,0.675,0.6781
2023-08-22 12:00,1952,574,1378,245152,47655,197497,176309335.0,32155857.0,144153477.0,1919,555,1364,240711,44561,196150,173384829.0,30081881.0,143302948.0,0.6748,0.7299,0.6751,0.7306
2023-08-22 12:05,3202,1121,2081,460450,74090,386360,312029013.0,50024214.0,262004799.0,3166,1098,2068,458872,72727,386145,310967985.0,49108559.0,261859426.0,0.6752,0.6781,0.6752,0.6781
2023-08-22 12:10,2080,773,1307,197343,44609,152734,133577057.0,30104494.0,103472563.0,2057,761,1296,200144,47828,152316,135466601.0,32267751.0,103198849.0,0.6749,0.6775,0.6747,0.6775
2023-08-22 12:15,963,300,663,138757,15310,123447,104091895.0,10315678.0,93776217.0,917,273,644,137159,14700,122459,103123303.0,9906121.0,93217182.0,0.6738,0.7596,0.6739,0.7612
2023-08-22 12:20,5314,2163,3151,790660,231534,559126,534433453.0,156002881.0,378430571.0,5275,2143,3132,786303,227689,558614,531426497.0,153328037.0,378098460.0,0.6738,0.6768,0.6734,0.6769
2023-08-22 12:25,3067,814,2253,488357,65535,422822,330306484.0,44208113.0,286098371.0,3038,802,2236,486330,65206,421124,328930607.0,43970994.0,284959612.0,0.6746,0.6766,0.6743,0.6767
2023-08-22 12:30,4138,916,3222,633099,37816,595283,428347077.0,25498989.0,402848088.0,4125,907,3218,632789,37737,595052,428133426.0,25445973.0,402687453.0,0.6743,0.6767,0.6743,0.6767
2023-08-22 12:35,3247,695,2552,425566,26148,399418,287968043.0,17663102.0,270304940.0,3209,679,2530,424461,25473,398988,287206414.0,17175132.0,270031281.0,0.6755,0.6767,0.6742,0.6768
2023-08-22 12:40,4187,1125,3062,591421,62145,529276,410093513.0,41901594.0,368191918.0,4141,1102,3039,588483,62613,525870,408190395.0,42206957.0,365983438.0,0.6743,0.6957,0.6741,0.696
2023-08-22 12:45,4467,754,3713,804950,19663,785287,564240395.0,13227157.0,551013238.0,4420,724,3696,806490,21964,784526,565308645.0,14778271.0,550530373.0,0.6727,0.7017,0.6728,0.7017
2023-08-22 12:50,3771,516,3255,618881,16830,602051,418030005.0,11249422.0,406780583.0,3750,503,3247,617412,15042,602370,417111718.0,10106233.0,407005484.0,0.6684,0.6757,0.6719,0.6757
2023-08-22 12:55,2819,289,2530,470743,18723,452020,328749747.0,12611852.0,316137895.0,2797,276,2521,467568,16356,451212,326583240.0,11014277.0,315568963.0,0.6736,0.6994,0.6734,0.6994
2023-08-22 13:00,2459,379,2080,325484,23324,302160,230582361.0,15735219.0,214847141.0,2431,368,2063,324830,22967,301863,230081169.0,15462905.0,214618263.0,0.6746,0.711,0.6733,0.711
2023-08-22 13:05,1428,332,1096,164859,24150,140709,111524632.0,16333590.0,95191041.0,1410,318,1092,164478,23879,140599,111227796.0,16106929.0,95120867.0,0.6763,0.6765,0.6745,0.6765
2023-08-22 13:10,1052,172,880,134380,19788,114592,101025422.0,13280576.0,87744846.0,1029,161,868,132816,18984,113832,100045390.0,12779563.0,87265827.0,0.6711,0.7657,0.6732,0.7666
2023-08-22 13:15,1002,28,974,105388,2835,102553,71371006.0,1906044.0,69464962.0,992,21,971,104943,2457,102486,71073464.0,1650833.0,69422630.0,0.6723,0.6774,0.6719,0.6774
2023-08-22 13:20,1318,175,1143,182089,16289,165800,123346190.0,10960624.0,112385566.0,1312,175,1137,181555,16231,165324,123013188.0,10921611.0,112091577.0,0.6729,0.6778,0.6729,0.678
2023-08-22 13:25,1043,201,842,159606,23242,136364,108030437.0,15638245.0,92392191.0,1026,189,837,159196,23132,136064,107761614.0,15560973.0,92200641.0,0.6728,0.6775,0.6727,0.6776
2023-08-22 13:30,1287,203,1084,200955,25836,175119,135821831.0,17374080.0,118447751.0,1272,191,1081,201630,25638,175992,136305375.0,17239605.0,119065770.0,0.6725,0.6764,0.6724,0.6765
2023-08-22 13:35,1755,498,1257,257019,47610,209409,173714421.0,32046441.0,141667980.0,1737,489,1248,254726,47406,207320,172216646.0,31910225.0,140306421.0,0.6731,0.6765,0.6731,0.6768
2023-08-22 13:40,5506,2431,3075,721605,245014,476591,487280018.0,164931032.0,322348985.0,5487,2418,3069,720869,244506,476363,486786571.0,164602491.0,322184079.0,0.6731,0.6764,0.6732,0.6763
2023-08-22 13:45,2579,2210,369,379952,350952,29000,278091585.0,237694957.0,40396628.0,2296,1974,322,368373,343453,24920,269769055.0,232218105.0,37550949.0,0.6773,1.393,0.6761,1.5069
2023-08-22 13:50,1854,971,883,182512,130553,51959,176308073.0,88958854.0,87349219.0,1673,862,811,173201,123962,49239,169634654.0,84161233.0,85473420.0,0.6814,1.6811,0.6789,1.7359
2023-08-22 13:55,3383,2064,1319,457908,316362,141546,363373144.0,215100586.0,148272558.0,3162,1936,1226,449202,312935,136267,357545684.0,212699928.0,144845756.0,0.6799,1.0475,0.6797,1.063
2023-08-22 14:00,3100,1790,1310,480139,406864,73275,355892283.0,275448858.0,80443425.0,2954,1701,1253,467501,403305,64196,347668052.0,272983473.0,74684579.0,0.677,1.0978,0.6769,1.1634
2023-08-22 14:05,2989,2001,988,464259,375353,88906,314610330.0,254052745.0,60557584.0,2903,1949,954,459554,372787,86767,311320704.0,252281503.0,59039201.0,0.6768,0.6811,0.6767,0.6804
2023-08-22 14:10,4594,3661,933,773860,746715,27145,535394643.0,506534122.0,28860521.0,4481,3589,892,770404,744344,26060,532995879.0,504865099.0,28130780.0,0.6784,1.0632,0.6783,1.0795
2023-08-22 14:15,3826,1671,2155,528429,273477,254952,473031676.0,185676371.0,287355305.0,3748,1624,2124,525488,272336,253152,471112958.0,184842229.0,286270729.0,0.6789,1.1271,0.6787,1.1308
2023-08-22 14:20,4239,998,3241,580198,102546,477652,394809597.0,69596462.0,325213135.0,4159,948,3211,577095,101050,476045,392714813.0,68522261.0,324192552.0,0.6787,0.6809,0.6781,0.681
2023-08-22 14:25,1496,731,765,142914,56048,86866,97176358.0,37987501.0,59188857.0,1449,709,740,142037,55790,86247,96573437.0,37810138.0,58763298.0,0.6778,0.6814,0.6777,0.6813
2023-08-22 14:30,196,82,114,22124,5213,16911,15050177.0,3527243.0,11522933.0,211,108,103,21053,4945,16108,14321056.0,3343018.0,10978037.0,0.6766,0.6814,0.676,0.6815
2023-08-22 14:35,1373,408,965,158286,48668,109618,127935721.0,32898761.0,95036960.0,1312,364,948,156411,48196,108215,126768370.0,32582420.0,94185949.0,0.676,0.867,0.676,0.8704
2023-08-22 14:40,2580,238,2342,387863,20340,367523,273573694.0,13770439.0,259803255.0,2519,202,2317,385427,18999,366428,271886060.0,12836630.0,259049430.0,0.677,0.7069,0.6756,0.707
2023-08-22 14:45,5003,590,4413,772532,29952,742580,534379058.0,20226417.0,514152641.0,4916,531,4385,767429,27448,739981,530961329.0,18521206.0,512440123.0,0.6753,0.6924,0.6748,0.6925
2023-08-22 14:50,2841,172,2669,390103,3289,386814,275133587.0,2234212.0,272899375.0,2804,141,2663,389627,2765,386862,274789201.0,1878670.0,272910530.0,0.6793,0.7055,0.6794,0.7054
2023-08-22 14:55,2530,237,2293,446809,12495,434314,323665390.0,8430758.0,315234631.0,2473,203,2270,442676,11632,431044,320907532.0,7845719.0,313061813.0,0.6747,0.7258,0.6745,0.7263
2023-08-22 15:00,5374,1151,4223,928254,47955,880299,741397248.0,32308867.0,709088380.0,5268,1082,4186,921966,44355,877611,737190229.0,29868233.0,707321995.0,0.6737,0.8055,0.6734,0.806
2023-08-22 15:05,5049,915,4134,897732,29210,868522,648857013.0,19695985.0,629161027.0,5000,880,4120,896148,28606,867542,647771247.0,19283054.0,628488193.0,0.6743,0.7244,0.6741,0.7244
2023-08-22 15:10,1790,314,1476,252100,19305,232795,180777031.0,13000964.0,167776066.0,1754,292,1462,251324,19274,232050,180281400.0,12979364.0,167302036.0,0.6735,0.7207,0.6734,0.721
2023-08-22 15:15,4408,991,3417,706807,34653,672154,508776359.0,23318881.0,485457477.0,4338,942,3396,705603,34183,671420,508045837.0,22978145.0,485067692.0,0.6729,0.7222,0.6722,0.7225
2023-08-22 15:20,4758,824,3934,770456,47391,723065,531257994.0,31920641.0,499337352.0,4723,799,3924,769927,46987,722940,530835913.0,31606776.0,499229137.0,0.6736,0.6906,0.6727,0.6906
2023-08-22 15:25,5440,2450,2990,755431,280215,475216,521548878.0,188900505.0,332648372.0,5398,2427,2971,753153,278698,474455,519871883.0,187766906.0,332104976.0,0.6741,0.7,0.6737,0.7
2023-08-22 15:30,5340,2323,3017,856737,369253,487484,579563510.0,248813245.0,330750265.0,5322,2313,3009,855902,368902,487000,578999033.0,248570721.0,330428312.0,0.6738,0.6785,0.6738,0.6785
2023-08-22 15:35,3504,961,2543,546347,218874,327473,369432875.0,147462730.0,221970145.0,3476,945,2531,545554,218075,327479,368911002.0,146912165.0,221998836.0,0.6737,0.6778,0.6737,0.6779
2023-08-22 15:40,3392,634,2758,571925,107965,463960,387279308.0,72749194.0,314530114.0,3366,618,2748,571540,107735,463805,387143169.0,72592178.0,314550990.0,0.6738,0.6779,0.6738,0.6782
2023-08-22 15:45,1693,219,1474,332962,40174,292788,225537351.0,27047524.0,198489826.0,1680,209,1471,332735,40139,292596,225391380.0,27023674.0,198367706.0,0.6733,0.6779,0.6733,0.678
2023-08-22 15:50,3984,550,3434,784028,69692,714336,531251965.0,46941632.0,484310333.0,3948,528,3420,782549,69021,713528,530258001.0,46486973.0,483771027.0,0.6736,0.678,0.6735,0.678
2023-08-22 15:55,4688,1126,3562,768736,98585,670151,592407735.0,66448383.0,525959351.0,4650,1104,3546,766935,97915,669020,591316860.0,65985920.0,525330940.0,0.674,0.7848,0.6739,0.7852
2023-08-22 16:00,4964,917,4047,803644,54428,749216,543787626.0,36669907.0,507117719.0,4938,902,4036,801506,53397,748109,542402661.0,35974662.0,506427999.0,0.6737,0.6769,0.6737,0.6769
2023-08-22 16:05,2714,456,2258,464196,18808,445388,324876513.0,12693630.0,312182883.0,2641,398,2243,458732,14751,443981,321214047.0,9948235.0,311265811.0,0.6749,0.7009,0.6744,0.7011
2023-08-22 16:10,7036,2911,4125,991813,397270,594543,788791539.0,270124224.0,518667314.0,6841,2802,4039,975026,385352,589674,776258628.0,261041494.0,515217134.0,0.68,0.8724,0.6774,0.8737
2023-08-22 16:15,4350,2479,1871,574603,310765,263838,433977604.0,212031741.0,221945863.0,4110,2389,1721,562338,306097,256241,425587658.0,208539888.0,217047769.0,0.6823,0.8412,0.6813,0.847
2023-08-22 16:20,600,435,165,51742,26578,25164,35326990.0,18102608.0,17224382.0,525,388,137,50442,25487,24955,34413013.0,17319054.0,17093959.0,0.6811,0.6845,0.6795,0.685
2023-08-22 16:25,1012,569,443,127618,57706,69912,87046143.0,39241718.0,47804424.0,962,545,417,124560,56078,68482,84961177.0,38099835.0,46861342.0,0.68,0.6838,0.6794,0.6843
2023-08-22 16:30,725,313,412,89895,22322,67573,71639570.0,15192460.0,56447110.0,667,284,383,85965,21022,64943,69021969.0,14274692.0,54747277.0,0.6806,0.8354,0.679,0.843
2023-08-22 16:35,1198,676,522,136950,129335,7615,92953258.0,87762038.0,5191219.0,1165,655,510,135509,128220,7289,91976584.0,87002590.0,4973994.0,0.6786,0.6817,0.6785,0.6824
2023-08-22 16:40,1024,784,240,158619,145441,13178,107650982.0,98674773.0,8976209.0,988,765,223,158763,145879,12884,107762402.0,98954285.0,8808117.0,0.6785,0.6812,0.6783,0.6836
2023-08-22 16:45,1575,1363,212,233128,208260,24868,158165531.0,141141479.0,17024052.0,1543,1349,194,232082,207700,24382,157449124.0,140757880.0,16691243.0,0.6777,0.6846,0.6777,0.6846
2023-08-22 16:50,2770,1320,1450,313610,174046,139564,213458303.0,118126625.0,95331677.0,2721,1289,1432,312067,173151,138916,212385858.0,117455503.0,94930354.0,0.6787,0.6831,0.6783,0.6834
2023-08-22 16:55,1933,827,1106,208901,61081,147820,142361029.0,41411245.0,100949784.0,1892,808,1084,207828,60946,146882,141631948.0,41315397.0,100316551.0,0.678,0.6829,0.6779,0.683
2023-08-22 17:00,2099,1365,734,236671,116960,119711,171293180.0,79305440.0,91987739.0,2061,1346,715,235360,116643,118717,170432611.0,79091137.0,91341473.0,0.6781,0.7684,0.6781,0.7694
2023-08-22 17:05,3055,1927,1128,338340,229250,109090,240068779.0,155395272.0,84673507.0,3020,1909,1111,336060,227699,108361,238470613.0,154311726.0,84158887.0,0.6778,0.7762,0.6777,0.7767
2023-08-22 17:10,3359,2322,1037,358173,277142,81031,243405018.0,188079946.0,55325072.0,3315,2291,1024,356123,276046,80077,241953339.0,187269642.0,54683697.0,0.6786,0.6828,0.6784,0.6829
2023-08-22 17:15,1658,833,825,189018,103137,85881,139110286.0,70124793.0,68985492.0,1605,807,798,185306,101694,83612,136583252.0,69129710.0,67453542.0,0.6799,0.8033,0.6798,0.8067
2023-08-22 17:20,1385,741,644,240694,95244,145450,174297194.0,64666619.0,109630575.0,1381,736,645,240817,95160,145657,174413597.0,64607847.0,109805750.0,0.679,0.7537,0.6789,0.7539
2023-08-22 17:25,5115,2955,2160,621969,354656,267313,456132168.0,242058235.0,214073933.0,5017,2901,2116,614118,349879,264239,450532554.0,238454281.0,212078273.0,0.6825,0.8008,0.6815,0.8026
2023-08-22 17:30,4221,2397,1824,571250,437670,133580,431915659.0,298776105.0,133139554.0,4076,2327,1749,559525,430259,129266,423729250.0,293557276.0,130171974.0,0.6827,0.9967,0.6823,1.007
2023-08-22 17:35,1270,891,379,163866,141853,22013,122541805.0,97146335.0,25395469.0,1038,769,269,151998,135499,16499,114268211.0,92530039.0,21738171.0,0.6848,1.1537,0.6829,1.3175
2023-08-22 17:40,2747,1789,958,409631,318140,91491,300592753.0,217274661.0,83318092.0,2663,1740,923,404867,316565,88302,297457569.0,216124372.0,81333196.0,0.683,0.9107,0.6827,0.9211
2023-08-22 17:45,3330,2758,572,570429,540169,30260,432053499.0,369635408.0,62418090.0,3131,2630,501,562108,534193,27915,426041859.0,365296545.0,60745313.0,0.6843,2.0627,0.6838,2.1761
2023-08-22 17:50,8197,5119,3078,1113835,823746,290089,1055709559.0,569734403.0,485975156.0,7100,4701,2399,1049613,792442,257171,1010877775.0,547038631.0,463839144.0,0.6916,1.6753,0.6903,1.8036
2023-08-22 17:55,3403,2234,1169,401972,290988,110984,354016116.0,202788180.0,151227935.0,2790,1993,797,355008,264091,90917,320652770.0,183219883.0,137432886.0,0.6969,1.3626,0.6938,1.5116
2023-08-22 18:00,6443,2162,4281,952551,117424,835127,818460124.0,81447595.0,737012529.0,5853,1834,4019,914194,99190,815004,793344796.0,68678352.0,724666444.0,0.6936,0.8825,0.6924,0.8892
2023-08-22 18:05,4177,1211,2966,631231,86749,544482,468783714.0,59840624.0,408943090.0,3933,1055,2878,620298,74111,546187,461328156.0,51090740.0,410237416.0,0.6898,0.7511,0.6894,0.7511
2023-08-22 18:10,4075,2873,1202,521515,398889,122626,393512865.0,276318342.0,117194523.0,3887,2800,1087,508664,397011,111653,384175011.0,274759005.0,109416005.0,0.6927,0.9557,0.6921,0.98
2023-08-22 18:15,3569,2490,1079,508030,475806,32224,373341689.0,329734735.0,43606954.0,3435,2432,1003,512775,479845,32930,376465951.0,332374857.0,44091093.0,0.693,1.3532,0.6927,1.3389
2023-08-22 18:20,3339,2420,919,529259,488417,40842,399292954.0,339192074.0,60100880.0,3126,2332,794,518412,483102,35310,391637690.0,335228482.0,56409208.0,0.6945,1.4715,0.6939,1.5975
2023-08-22 18:25,5588,3254,2334,722483,496669,225814,511153789.0,343801691.0,167352097.0,5423,3160,2263,716521,493384,223137,507311704.0,341506988.0,165804716.0,0.6922,0.7411,0.6922,0.7431
2023-08-22 18:30,4067,2303,1764,493550,262643,230907,394815538.0,181745383.0,213070154.0,3952,2244,1708,486475,260050,226425,389952126.0,179837222.0,210114904.0,0.692,0.9228,0.6915,0.928
2023-08-22 18:35,4198,2081,2117,494299,237449,256850,363590574.0,164357498.0,199233076.0,4101,2035,2066,494578,237266,257312,363680189.0,164046683.0,199633506.0,0.6922,0.7757,0.6914,0.7758
2023-08-23 10:00,9113,5475,3638,1139976,635609,504367,939899588.0,440490387.0,499409201.0,8192,5084,3108,1095030,611463,483567,898374550.0,424102312.0,474272238.0,0.693,0.9902,0.6936,0.9808
2023-08-23 10:05,6873,1273,5600,948102,62788,885314,751757103.0,43131897.0,708625205.0,6546,1108,5438,928775,53242,875533,738767224.0,36597377.0,702169847.0,0.6869,0.8004,0.6874,0.802
2023-08-23 10:10,1727,683,1044,172504,32137,140367,119193365.0,22150133.0,97043231.0,1570,588,982,166827,29637,137190,115315347.0,20412177.0,94903169.0,0.6892,0.6914,0.6887,0.6918
2023-08-23 10:15,1294,434,860,108328,18534,89794,74742223.0,12615393.0,62126829.0,1137,345,792,104584,14192,90392,72468823.0,9761685.0,62707137.0,0.6807,0.6919,0.6878,0.6937
2023-08-23 10:20,533,289,244,32574,15431,17143,22657042.0,10671752.0,11985289.0,406,227,179,27130,12748,14382,18852852.0,8768473.0,10084379.0,0.6916,0.6991,0.6878,0.7012
2023-08-23 10:25,921,602,319,74374,62316,12058,62075805.0,43134790.0,18941015.0,816,532,284,67125,56288,10837,56907870.0,38892728.0,18015142.0,0.6922,1.5708,0.691,1.6624
2023-08-23 10:30,1028,663,365,49439,29484,19955,34253191.0,20394921.0,13858269.0,854,553,301,43303,25983,17320,30026900.0,17966431.0,12060468.0,0.6917,0.6945,0.6915,0.6963
2023-08-23 10:35,955,363,592,81646,19455,62191,56443052.0,13477584.0,42965468.0,889,325,564,80578,18752,61826,55922203.0,12956079.0,42966124.0,0.6928,0.6909,0.6909,0.695
2023-08-23 10:40,391,159,232,34398,12285,22113,23830387.0,8374484.0,15455902.0,297,103,194,26409,7543,18866,18321762.0,5205832.0,13115930.0,0.6817,0.699,0.6902,0.6952
2023-08-23 10:45,1079,375,704,102592,26842,75750,81217450.0,18540330.0,62677119.0,1012,348,664,96431,25843,70588,77337500.0,17869107.0,59468392.0,0.6907,0.8274,0.6914,0.8425
2023-08-23 10:50,3243,532,2711,353767,27748,326019,266052931.0,19183963.0,246868967.0,3182,496,2686,351098,25892,325206,264157170.0,17831761.0,246325409.0,0.6914,0.7572,0.6887,0.7574
2023-08-23 10:55,2325,311,2014,275814,41428,234386,190744221.0,28493585.0,162250636.0,2259,276,1983,274036,40646,233390,189553098.0,27951737.0,161601361.0,0.6878,0.6922,0.6877,0.6924
2023-08-23 11:00,4305,777,3528,472585,55741,416844,357335059.0,38319838.0,319015221.0,4019,592,3427,451460,45730,405730,343234471.0,31421938.0,311812532.0,0.6875,0.7653,0.6871,0.7685
2023-08-23 11:05,3987,1207,2780,441033,89998,351035,314203603.0,61808428.0,252395175.0,3833,1112,2721,433219,86028,347191,308750139.0,58986494.0,249763645.0,0.6868,0.719,0.6857,0.7194
2023-08-23 11:10,3140,637,2503,401029,47345,353684,286759707.0,32502102.0,254257605.0,3071,598,2473,399735,47169,352566,285906637.0,32359503.0,253547134.0,0.6865,0.7189,0.686,0.7191
2023-08-23 11:15,4479,1019,3460,558324,57671,500653,395059446.0,39596729.0,355462716.0,4397,958,3439,553879,54062,499817,391960562.0,37104566.0,354855996.0,0.6866,0.71,0.6863,0.71
2023-08-23 11:20,2753,1628,1125,306166,210089,96077,221537546.0,144498683.0,77038863.0,2618,1559,1059,296943,207404,89539,215022014.0,142618983.0,72403031.0,0.6878,0.8018,0.6876,0.8086
2023-08-23 11:25,3559,2770,789,463163,413899,49264,319054570.0,284936666.0,34117904.0,3458,2734,724,459815,413719,46096,316716941.0,284762390.0,31954551.0,0.6884,0.6926,0.6883,0.6932
2023-08-23 11:30,5927,4315,1612,761692,621303,140389,555543121.0,427290837.0,128252284.0,5864,4287,1577,750818,618921,131897,548123834.0,425650235.0,122473599.0,0.6877,0.9135,0.6877,0.9286
2023-08-23 11:35,3345,1150,2195,437907,101204,336703,322575053.0,69546264.0,253028788.0,3300,1118,2182,444724,102401,342323,327320416.0,70335683.0,256984733.0,0.6872,0.7515,0.6869,0.7507
2023-08-23 11:40,3332,1680,1652,353339,85041,268298,243257043.0,58379198.0,184877844.0,3288,1658,1630,351725,83713,268012,242162973.0,57463043.0,184699930.0,0.6865,0.6891,0.6864,0.6891
2023-08-23 11:45,2385,900,1485,328076,41663,286413,246470090.0,28537203.0,217932887.0,2296,870,1426,321881,39254,282627,242471427.0,26946735.0,215524692.0,0.685,0.7609,0.6865,0.7626
2023-08-23 11:50,7083,3078,4005,964919,382545,582374,683379691.0,262157701.0,421221989.0,6986,3020,3966,962484,380458,582026,681638710.0,260579648.0,421059062.0,0.6853,0.7233,0.6849,0.7234
2023-08-23 11:55,5737,4076,1661,826172,650772,175400,587838398.0,446246414.0,141591984.0,5674,4042,1632,823024,648168,174856,585500917.0,444298744.0,141202172.0,0.6857,0.8073,0.6855,0.8075
2023-08-23 12:00,6500,2643,3857,825170,340356,484814,577159726.0,233150245.0,344009481.0,6448,2617,3831,823029,340242,482787,575822320.0,233072160.0,342750160.0,0.685,0.7096,0.685,0.7099
2023-08-23 12:05,3061,576,2485,394758,41549,353209,271567978.0,28495437.0,243072540.0,3020,548,2472,395189,40860,354329,271849448.0,27987464.0,243861984.0,0.6858,0.6882,0.685,0.6882
2023-08-23 12:10,2585,1008,1577,283009,83260,199749,226188762.0,57227676.0,168961086.0,2394,984,1410,279917,81334,198583,223928484.0,55796450.0,168132033.0,0.6873,0.8459,0.686,0.8467
2023-08-23 12:15,2015,1223,792,239211,116487,122724,164599444.0,79990278.0,84609166.0,1989,1208,781,236547,114327,122220,162746059.0,78485369.0,84260690.0,0.6867,0.6894,0.6865,0.6894
2023-08-23 12:20,755,344,411,66141,33081,33060,56192397.0,22863938.0,33328458.0,707,318,389,65473,33340,32133,55582296.0,22920635.0,32661660.0,0.6912,1.0081,0.6875,1.0165
2023-08-23 12:25,3656,1760,1896,435961,131799,304162,331641659.0,90542775.0,241098883.0,3609,1730,1879,434109,131097,303012,330463378.0,90061565.0,240401812.0,0.687,0.7927,0.687,0.7934
2023-08-23 12:30,2461,509,1952,335678,37138,298540,241897216.0,25521187.0,216376029.0,2434,488,1946,332156,34412,297744,239436183.0,23634949.0,215801234.0,0.6872,0.7248,0.6868,0.7248
2023-08-23 12:35,1383,891,492,121364,78159,43205,83762447.0,53930505.0,29831941.0,1336,864,472,119172,76565,42607,82116485.0,52698003.0,29418482.0,0.69,0.6905,0.6883,0.6905
2023-08-23 12:40,391,276,115,36383,28701,7682,24957927.0,19654525.0,5303402.0,345,249,96,33494,27699,5795,23060234.0,19043770.0,4016464.0,0.6848,0.6904,0.6875,0.6931
2023-08-23 12:45,4905,1060,3845,688382,45570,642812,525805420.0,31313659.0,494491761.0,4767,958,3809,673632,39343,634289,516122518.0,27037594.0,489084924.0,0.6872,0.7693,0.6872,0.7711
2023-08-23 12:50,4225,969,3256,565390,67368,498022,419804705.0,46296410.0,373508294.0,4054,865,3189,551035,58552,492483,409845975.0,40083871.0,369762104.0,0.6872,0.75,0.6846,0.7508
2023-08-23 12:55,4438,2251,2187,538384,271483,266901,369251408.0,185858505.0,183392902.0,4361,2217,2144,536684,271133,265551,368058211.0,185590858.0,182467353.0,0.6846,0.6871,0.6845,0.6871
2023-08-23 13:00,6591,4545,2046,806166,609153,197013,552603843.0,417196144.0,135407699.0,6546,4520,2026,804399,608170,196229,551362917.0,416481227.0,134881690.0,0.6849,0.6873,0.6848,0.6874
2023-08-23 13:05,4589,3910,679,529506,472959,56547,362922676.0,324030216.0,38892460.0,4564,3897,667,530296,473996,56300,363437106.0,324719120.0,38717986.0,0.6851,0.6878,0.6851,0.6877
2023-08-23 13:10,3304,2464,840,350443,289969,60474,240179982.0,198612628.0,41567353.0,3276,2444,832,349853,289452,60401,239806096.0,198285232.0,41520864.0,0.6849,0.6874,0.685,0.6874
2023-08-23 13:15,3220,1555,1665,378983,160496,218487,259830304.0,109939661.0,149890642.0,3177,1531,1646,376580,159981,216599,258259353.0,109580588.0,148678764.0,0.685,0.686,0.685,0.6864
2023-08-23 13:20,3702,1005,2697,511211,63421,447790,350747906.0,43385615.0,307362291.0,3653,961,2692,509916,62111,447805,349875997.0,42495320.0,307380676.0,0.6841,0.6864,0.6842,0.6864
2023-08-23 13:25,3122,400,2722,480624,18476,462148,340017881.0,12610319.0,327407562.0,3042,348,2694,478913,17488,461425,338922953.0,11936655.0,326986298.0,0.6825,0.7084,0.6826,0.7086
2023-08-23 13:30,3540,596,2944,573756,26366,547390,393414709.0,18013075.0,375401634.0,3475,552,2923,571799,25055,546744,392108125.0,17120292.0,374987832.0,0.6832,0.6858,0.6833,0.6859
2023-08-23 13:35,2712,534,2178,428310,30519,397791,293586783.0,20871549.0,272715233.0,2679,510,2169,426442,30384,396058,292349569.0,20736251.0,271613317.0,0.6839,0.6856,0.6825,0.6858
2023-08-23 13:40,767,154,613,65568,10068,55500,44922644.0,6888706.0,38033938.0,736,141,595,64386,9437,54949,44084077.0,6426984.0,37657093.0,0.6842,0.6853,0.681,0.6853
2023-08-23 13:45,926,332,594,85106,15286,69820,68475052.0,10441630.0,58033422.0,830,268,562,80872,14172,66700,65786572.0,9667552.0,56119020.0,0.6831,0.8312,0.6822,0.8414
2023-08-23 13:50,1553,535,1018,166325,21293,145032,124129522.0,14529151.0,109600371.0,1461,469,992,164491,20411,144080,122925293.0,13910602.0,109014691.0,0.6823,0.7557,0.6815,0.7566
2023-08-23 13:55,1224,576,648,160570,65898,94672,109645110.0,44894879.0,64750231.0,1166,530,636,159055,64260,94795,108606866.0,43769895.0,64836971.0,0.6813,0.6839,0.6811,0.684
2023-08-23 14:00,4453,927,3526,634690,141372,493318,444655217.0,96390721.0,348264496.0,4416,899,3517,633653,140850,492803,443885199.0,96001601.0,347883598.0,0.6818,0.706,0.6816,0.7059
2023-08-23 14:05,3076,905,2171,357860,122968,234892,254839881.0,83847872.0,170992009.0,2997,856,2141,353522,121835,231687,252098854.0,83041609.0,169057244.0,0.6819,0.728,0.6816,0.7297
2023-08-23 14:10,4739,1793,2946,523690,166553,357137,378041688.0,113370129.0,264671558.0,4627,1737,2890,518338,164926,353412,374656773.0,112295389.0,262361383.0,0.6807,0.7411,0.6809,0.7424
2023-08-23 14:15,4777,1132,3645,622089,50863,571226,485097099.0,34454453.0,450642645.0,4618,1025,3593,612086,46728,565358,478634663.0,31626716.0,447007947.0,0.6774,0.7889,0.6768,0.7907
2023-08-23 14:20,1390,540,850,115923,36774,79149,78736099.0,24935314.0,53800784.0,1274,460,814,107404,32993,74411,73018333.0,22353991.0,50664342.0,0.6781,0.6797,0.6775,0.6809
2023-08-23 14:25,2639,684,1955,316294,54082,262212,224616338.0,36563934.0,188052404.0,2490,580,1910,308957,49414,259543,219869284.0,33423261.0,186446022.0,0.6761,0.7172,0.6764,0.7184
2023-08-23 14:30,5817,3200,2617,738849,479602,259247,668396786.0,325834006.0,342562780.0,5581,3081,2500,728107,474234,253873,660676467.0,321801897.0,338874570.0,0.6794,1.3214,0.6786,1.3348
2023-08-23 14:35,6001,3137,2864,726002,488038,237964,503629109.0,330993307.0,172635801.0,5915,3084,2831,724787,488010,236777,502818288.0,330937317.0,171880971.0,0.6782,0.7255,0.6781,0.7259
2023-08-23 14:40,1073,628,445,115304,72719,42585,78317715.0,49270597.0,29047117.0,1013,588,425,112275,71120,41155,76280568.0,48188732.0,28091836.0,0.6775,0.6821,0.6776,0.6826
2023-08-23 14:45,2588,1165,1423,271607,135113,136494,184779459.0,91635481.0,93143978.0,2542,1133,1409,270344,133854,136490,183912295.0,90770297.0,93141997.0,0.6782,0.6824,0.6781,0.6824
2023-08-23 14:50,3252,1553,1699,314048,144500,169548,213667860.0,98028640.0,115639220.0,3206,1533,1673,312008,144840,167168,212316651.0,98263276.0,114053375.0,0.6784,0.682,0.6784,0.6823
2023-08-23 14:55,3557,1061,2496,498198,80812,417386,348296139.0,54617585.0,293678554.0,3451,980,2471,493352,77511,415841,345057338.0,52389695.0,292667643.0,0.6759,0.7036,0.6759,0.7038
2023-08-23 15:00,6136,4665,1471,920370,806469,113901,699474996.0,549267912.0,150207084.0,5713,4362,1351,897109,790268,106841,682942299.0,537563357.0,145378941.0,0.6811,1.3188,0.6802,1.3607
2023-08-23 15:05,3698,1489,2209,536867,221970,314897,416854877.0,150862000.0,265992877.0,3528,1374,2154,535594,225141,310453,415855994.0,152817765.0,263038228.0,0.6797,0.8447,0.6788,0.8473
2023-08-23 15:10,3143,645,2498,537655,44061,493594,365403805.0,29871069.0,335532736.0,3069,599,2470,533997,42020,491977,362900786.0,28433580.0,334467205.0,0.6779,0.6798,0.6767,0.6798
2023-08-23 15:15,4615,1732,2883,740410,235007,505403,513368571.0,159335703.0,354032867.0,4564,1701,2863,739434,233654,505780,512582206.0,158309514.0,354272692.0,0.678,0.7005,0.6775,0.7004
2023-08-23 15:20,3984,1165,2819,623101,158775,464326,433857587.0,107535967.0,326321620.0,3933,1133,2800,619132,156433,462699,431188305.0,105931012.0,325257293.0,0.6773,0.7028,0.6772,0.703
2023-08-23 15:25,890,428,462,130340,77889,52451,88241102.0,52674484.0,35566618.0,849,403,446,128455,77616,50839,87034867.0,52488957.0,34545909.0,0.6763,0.6781,0.6763,0.6795
2023-08-23 15:30,1102,312,790,135886,32722,103164,92326221.0,22159061.0,70167160.0,1068,292,776,134294,30996,103298,91244797.0,20981799.0,70262998.0,0.6772,0.6802,0.6769,0.6802
2023-08-23 15:35,4447,2223,2224,614613,353770,260843,427519161.0,239597718.0,187921443.0,4414,2201,2213,608117,347308,260809,423311099.0,235414030.0,187897068.0,0.6773,0.7204,0.6778,0.7204
2023-08-23 15:40,2687,1058,1629,342401,152520,189881,232552352.0,102829685.0,129722667.0,2618,1020,1598,334294,149560,184734,227022952.0,101166301.0,125856651.0,0.6742,0.6832,0.6764,0.6813
2023-08-23 15:45,2413,1120,1293,291441,163954,127487,197909192.0,111091525.0,86817667.0,2371,1100,1271,291288,163994,127294,197814762.0,111115587.0,86699175.0,0.6776,0.681,0.6776,0.6811
2023-08-23 15:50,1933,677,1256,214708,96210,118498,155821380.0,65107746.0,90713633.0,1889,656,1233,211340,95732,115608,153631311.0,64783404.0,88847906.0,0.6767,0.7655,0.6767,0.7685
2023-08-23 15:55,6635,1593,5042,961298,109205,852093,744402264.0,73829650.0,670572613.0,6552,1536,5016,964845,114569,850276,746261088.0,76807426.0,669453661.0,0.6761,0.787,0.6704,0.7873
2023-08-23 16:00,4395,782,3613,796594,29617,766977,560534243.0,19971515.0,540562727.0,4304,719,3585,793025,28260,764765,558217477.0,19061440.0,539156036.0,0.6743,0.7048,0.6745,0.705
2023-08-23 16:05,3950,1493,2457,593375,169906,423469,411596639.0,114532494.0,297064145.0,3822,1418,2404,588144,167061,421083,408069809.0,112577290.0,295492519.0,0.6741,0.7015,0.6739,0.7017
2023-08-23 16:10,2663,1715,948,350406,259387,91019,256568007.0,174874190.0,81693816.0,2544,1651,893,344302,257396,86906,252729833.0,173484943.0,79244890.0,0.6742,0.8975,0.674,0.9118
2023-08-23 16:15,3883,1304,2579,543662,126631,417031,396480244.0,84917167.0,311563076.0,3713,1178,2535,537688,122313,415375,392680835.0,81991538.0,310689297.0,0.6706,0.7471,0.6703,0.748
2023-08-23 16:20,4634,1261,3373,651599,125091,526508,460263975.0,84125349.0,376138626.0,4541,1207,3334,646370,121462,524908,456683494.0,81637891.0,375045603.0,0.6725,0.7144,0.6721,0.7145
2023-08-23 16:25,3720,1965,1755,467811,383311,84500,335944628.0,258146359.0,77798268.0,3615,1919,1696,462650,379943,82707,332269835.0,255731993.0,76537841.0,0.6735,0.9207,0.6731,0.9254
2023-08-23 16:30,3433,877,2556,450196,166181,284015,304873389.0,112314077.0,192559311.0,3361,845,2516,447038,165918,281120,302691516.0,112018280.0,190673236.0,0.6759,0.678,0.6751,0.6783
2023-08-23 16:35,738,415,323,60402,52454,7948,40742035.0,35350413.0,5391622.0,694,384,310,58831,51635,7196,39671528.0,34788501.0,4883027.0,0.6739,0.6784,0.6737,0.6786
2023-08-23 16:40,394,312,82,54423,49038,5385,36914465.0,33253272.0,3661192.0,356,284,72,52825,47269,5556,35749383.0,31968380.0,3781003.0,0.6781,0.6799,0.6763,0.6805
2023-08-23 16:45,1942,1288,654,224026,152337,71689,161754905.0,102860511.0,58894394.0,1859,1230,629,218968,150358,68610,158344816.0,101504578.0,56840238.0,0.6752,0.8215,0.6751,0.8285
2023-08-23 16:50,2635,1462,1173,283978,111428,172550,212797746.0,75222361.0,137575385.0,2606,1453,1153,283153,110465,172688,212194753.0,74539200.0,137655553.0,0.6751,0.7973,0.6748,0.7971
2023-08-23 16:55,1617,1035,582,165212,112753,52459,111738820.0,76216128.0,35522692.0,1580,1016,564,162774,111862,50912,110045585.0,75513969.0,34531616.0,0.676,0.6772,0.6751,0.6783
2023-08-23 17:00,3109,2513,596,500057,463709,36348,358431754.0,313169183.0,45262571.0,3072,2494,578,497884,462854,35030,356949477.0,312546297.0,44403179.0,0.6754,1.2453,0.6753,1.2676
2023-08-23 17:05,2609,1545,1064,315852,228003,87849,213317803.0,153751222.0,59566581.0,2573,1525,1048,314667,227483,87184,212512673.0,153388778.0,59123894.0,0.6743,0.6781,0.6743,0.6782
2023-08-23 17:10,4580,1738,2842,615120,169428,445692,436700733.0,114247502.0,322453230.0,4522,1699,2823,612399,168587,443812,434958086.0,113674358.0,321283728.0,0.6743,0.7235,0.6743,0.7239
2023-08-23 17:15,2173,1558,615,290358,170949,119409,227701255.0,115802654.0,111898600.0,2126,1537,589,287039,167943,119096,225228180.0,113549702.0,111678477.0,0.6774,0.9371,0.6761,0.9377
2023-08-23 17:20,673,250,423,49771,33309,16462,43995141.0,22548446.0,21446695.0,642,235,407,47109,31882,15227,42189516.0,21553454.0,20636062.0,0.6769,1.3028,0.676,1.3552
2023-08-23 17:25,801,162,639,60267,17772,42495,40877694.0,12034354.0,28843339.0,768,141,627,59045,16667,42378,40042669.0,11275261.0,28767408.0,0.6772,0.6787,0.6765,0.6788
2023-08-23 17:30,698,378,320,98169,56096,42073,97988150.0,38304808.0,59683342.0,639,347,292,94050,52770,41280,94867652.0,35791391.0,59076261.0,0.6828,1.4186,0.6783,1.4311
2023-08-23 17:35,6276,2757,3519,908012,353488,554524,1061946879.0,239755073.0,822191805.0,6201,2720,3481,905814,354198,551616,1060470156.0,240165878.0,820304278.0,0.6783,1.4827,0.6781,1.4871
2023-08-23 17:40,3982,902,3080,664564,77245,587319,461942250.0,52285291.0,409656959.0,3908,850,3058,661352,76283,585069,459844624.0,51630085.0,408214539.0,0.6769,0.6975,0.6768,0.6977
2023-08-23 17:45,2684,579,2105,482519,41786,440733,358996481.0,28272700.0,330723781.0,2643,552,2091,483327,41987,441340,359509744.0,28392580.0,331117163.0,0.6766,0.7504,0.6762,0.7503
2023-08-23 17:50,1503,568,935,247932,61941,185991,219979116.0,42102048.0,177877068.0,1409,514,895,240208,56283,183925,214705827.0,38139640.0,176566187.0,0.6797,0.9564,0.6776,0.96
2023-08-23 17:55,2137,1747,390,227583,206509,21074,154713265.0,140346259.0,14367005.0,2074,1708,366,227668,207524,20144,154761255.0,141008661.0,13752593.0,0.6796,0.6817,0.6795,0.6827
2023-08-23 18:00,1847,1561,286,205904,184658,21246,150792245.0,125894195.0,24898050.0,1790,1532,258,204506,184360,20146,149610377.0,125477062.0,24133315.0,0.6818,1.1719,0.6806,1.1979
2023-08-23 18:05,875,650,225,123050,103497,19553,83811277.0,70450703.0,13360574.0,846,638,208,120665,101845,18820,82150843.0,69278043.0,12872800.0,0.6807,0.6833,0.6802,0.684
2023-08-23 18:10,1799,1392,407,183753,166789,16964,125182612.0,113617840.0,11564772.0,1770,1376,394,183257,166643,16614,124869565.0,113491331.0,11378233.0,0.6812,0.6817,0.681,0.6849
2023-08-23 18:15,2317,1914,403,257665,238321,19344,175603604.0,162370045.0,13233559.0,2285,1902,383,255842,237882,17960,174401813.0,162058766.0,12343046.0,0.6813,0.6841,0.6813,0.6873
2023-08-23 18:20,3341,2920,421,485181,468348,16833,330460630.0,318947985.0,11512644.0,3313,2911,402,485379,468667,16712,330598203.0,319165435.0,11432767.0,0.681,0.6839,0.681,0.6841
2023-08-23 18:25,2649,2556,93,296358,294379,1979,201751021.0,200403875.0,1347146.0,2604,2524,80,295863,293979,1884,201416486.0,200127097.0,1289389.0,0.6808,0.6807,0.6808,0.6844
2023-08-23 18:30,4185,3356,829,555202,515501,39701,387847627.0,350409455.0,37438172.0,4165,3347,818,554809,515818,38991,387630922.0,350601489.0,37029433.0,0.6797,0.943,0.6797,0.9497
2023-08-23 18:35,3771,3034,737,588625,545564,43061,411109225.0,371296520.0,39812705.0,3751,3019,732,587196,544248,42948,410025174.0,370304771.0,39720402.0,0.6806,0.9246,0.6804,0.9248
2023-08-24 10:00,5886,1495,4391,901171,131072,770099,649361863.0,87460411.0,561901452.0,5130,1171,3959,872141,116027,756114,619956446.0,77833185.0,542123261.0,0.6673,0.7296,0.6708,0.717
2023-08-24 10:05,4714,2749,1965,672829,353517,319312,506163325.0,238808326.0,267354999.0,4400,2570,1830,655733,340380,315353,494306751.0,229777616.0,264529134.0,0.6755,0.8373,0.6751,0.8388
2023-08-24 10:10,3555,1907,1648,353719,188390,165329,269643007.0,127060080.0,142582927.0,3306,1806,1500,348706,187158,161548,266400203.0,126179150.0,140221053.0,0.6745,0.8624,0.6742,0.868
2023-08-24 10:15,3889,965,2924,411670,68849,342821,288958471.0,46332523.0,242625948.0,3746,872,2874,402695,65613,337082,282640703.0,44191938.0,238448764.0,0.673,0.7077,0.6735,0.7074
2023-08-24 10:20,3217,507,2710,452175,8765,443410,336387828.0,5911713.0,330476115.0,3122,449,2673,449023,8170,440853,334308294.0,5517288.0,328791006.0,0.6745,0.7453,0.6753,0.7458
2023-08-24 10:25,4317,655,3662,732653,7292,725361,515355576.0,4894516.0,510461060.0,4234,597,3637,729826,5945,723881,513556831.0,4002868.0,509553962.0,0.6712,0.7037,0.6733,0.7039
2023-08-24 10:30,4023,694,3329,671749,15052,656697,473644396.0,10144388.0,463500007.0,3796,548,3248,667888,12954,654934,471066569.0,8729336.0,462337232.0,0.674,0.7058,0.6739,0.7059
2023-08-24 10:35,5288,2725,2563,641667,236304,405363,443338973.0,159031784.0,284307189.0,5214,2679,2535,637799,233503,404296,440576228.0,157029767.0,283546461.0,0.673,0.7014,0.6725,0.7013
2023-08-24 10:40,2481,1635,846,264744,198269,66475,188801229.0,133488047.0,55313182.0,2415,1592,823,262548,197352,65196,187190082.0,132783927.0,54406154.0,0.6733,0.8321,0.6728,0.8345
2023-08-24 10:45,1969,1117,852,224960,157924,67036,172375153.0,106309295.0,66065857.0,1887,1090,797,221942,156761,65181,170196913.0,105450488.0,64746425.0,0.6732,0.9855,0.6727,0.9933
2023-08-24 10:50,291,254,37,40199,38795,1404,27052301.0,26080754.0,971547.0,277,246,31,39960,38806,1154,26882198.0,26088410.0,793787.0,0.6723,0.692,0.6723,0.6879
2023-08-24 10:55,2281,1610,671,249946,216577,33369,178618613.0,145751736.0,32866876.0,2222,1576,646,248387,216033,32354,177575737.0,145363317.0,32212419.0,0.673,0.985,0.6729,0.9956
2023-08-24 11:00,4128,2984,1144,548817,490840,57977,402131796.0,331883501.0,70248294.0,4042,2939,1103,542575,486907,55668,397661029.0,328974792.0,68686237.0,0.6762,1.2117,0.6756,1.2339
2023-08-24 11:05,5413,3496,1917,863039,787845,75194,593740308.0,532291520.0,61448787.0,5362,3474,1888,860337,786412,73925,591900744.0,531314192.0,60586551.0,0.6756,0.8172,0.6756,0.8196
2023-08-24 11:10,1364,1042,322,179292,170974,8318,121151488.0,115483658.0,5667829.0,1295,1018,277,175683,169113,6570,118689396.0,114212342.0,4477054.0,0.6754,0.6814,0.6754,0.6814
2023-08-24 11:15,3363,2272,1091,480942,442549,38393,337033419.0,300347355.0,36686064.0,3298,2238,1060,477826,441417,36409,334827862.0,299567726.0,35260136.0,0.6787,0.9555,0.6787,0.9684
2023-08-24 11:20,4007,3228,779,652283,633213,19070,454034695.0,430647940.0,23386755.0,3936,3197,739,648612,631209,17403,451373344.0,429151727.0,22221617.0,0.6801,1.2264,0.6799,1.2769
2023-08-24 11:25,2642,2112,530,315277,295766,19511,214380694.0,201039735.0,13340958.0,2557,2117,440,313359,295764,17595,213083977.0,201044464.0,12039513.0,0.6797,0.6838,0.6797,0.6843
2023-08-24 11:30,3381,1095,2286,495146,124372,370774,357794153.0,84526596.0,273267556.0,3219,1034,2185,489598,122400,367198,354287948.0,83187341.0,271100607.0,0.6796,0.737,0.6796,0.7383
2023-08-24 11:35,3256,501,2755,562886,11909,550977,383453521.0,8051047.0,375402474.0,3220,480,2740,561929,11535,550394,382860105.0,7799851.0,375060253.0,0.676,0.6813,0.6762,0.6814
2023-08-24 11:40,2010,306,1704,347485,11743,335742,236743519.0,7963063.0,228780456.0,1968,276,1692,345686,11687,333999,235497851.0,7922796.0,227575055.0,0.6781,0.6814,0.6779,0.6814
2023-08-24 11:45,3122,878,2244,538872,47418,491454,377074465.0,32119001.0,344955464.0,3067,842,2225,535941,45261,490680,375117361.0,30653838.0,344463523.0,0.6774,0.7019,0.6773,0.702
2023-08-24 11:50,6611,2711,3900,1099922,313864,786058,870455794.0,212481293.0,657974500.0,6465,2622,3843,1086536,306095,780441,861518203.0,207213374.0,654304828.0,0.677,0.8371,0.677,0.8384
2023-08-24 11:55,970,216,754,44558,15533,29025,30290395.0,10523513.0,19766881.0,922,184,738,42125,14026,28099,28629812.0,9497034.0,19132778.0,0.6775,0.681,0.6771,0.6809
2023-08-24 12:00,650,348,302,59769,27134,32635,51004346.0,18408380.0,32595965.0,582,303,279,60166,27889,32277,51248389.0,18903014.0,32345375.0,0.6784,0.9988,0.6778,1.0021
2023-08-24 12:05,1922,1477,445,237924,189888,48036,172143737.0,129005406.0,43138331.0,1903,1468,435,238217,189567,48650,172280808.0,128738564.0,43542244.0,0.6794,0.898,0.6791,0.895
2023-08-24 12:10,2880,2210,670,394489,337815,56674,278455525.0,229463843.0,48991681.0,2841,2190,651,393725,337261,56464,277947089.0,229061144.0,48885944.0,0.6793,0.8644,0.6792,0.8658
2023-08-24 12:15,2583,890,1693,243596,77760,165836,165840728.0,52810211.0,113030517.0,2557,871,1686,242772,77565,165207,165296360.0,52678081.0,112618278.0,0.6791,0.6816,0.6791,0.6817
2023-08-24 12:20,1881,773,1108,250750,105395,145355,170434337.0,71379529.0,99054808.0,1864,767,1097,249936,105099,144837,169867304.0,71160870.0,98706433.0,0.6773,0.6815,0.6771,0.6815
2023-08-24 12:25,1028,368,660,171096,73277,97819,116163935.0,49528167.0,66635767.0,999,356,643,145842,73003,72839,98964470.0,49343732.0,49620738.0,0.6759,0.6812,0.6759,0.6812
2023-08-24 12:30,4830,3356,1474,789529,642674,146855,544731212.0,434683741.0,110047471.0,4792,3333,1459,786418,641481,144937,542737329.0,433868622.0,108868707.0,0.6764,0.7494,0.6764,0.7511
2023-08-24 12:35,4867,3471,1396,842129,727973,114156,590486642.0,492245095.0,98241547.0,4913,3476,1437,843399,728258,115141,591346002.0,492421198.0,98924804.0,0.6762,0.8606,0.6762,0.8592
2023-08-24 12:40,2838,1514,1324,378061,302556,75505,255819798.0,204502924.0,51316874.0,2743,1512,1231,376608,302428,74180,254824543.0,204415826.0,50408717.0,0.6759,0.6796,0.6759,0.6795
2023-08-24 12:45,711,200,511,61100,34589,26511,41871930.0,23297232.0,18574698.0,673,171,502,50091,31601,18490,33920011.0,21351213.0,12568797.0,0.6735,0.7006,0.6756,0.6798
2023-08-24 12:50,2111,912,1199,237047,120748,116299,160553767.0,81513959.0,79039807.0,2056,860,1196,235727,119570,116157,159697405.0,80754086.0,78943319.0,0.6751,0.6796,0.6754,0.6796
2023-08-24 12:55,902,236,666,115944,36923,79021,78682334.0,24981615.0,53700719.0,889,224,665,116059,36872,79187,78767265.0,24946666.0,53820599.0,0.6766,0.6796,0.6766,0.6797
2023-08-24 13:00,1331,600,731,167072,94112,72960,123678250.0,63741640.0,59936609.0,1304,583,721,165401,93135,72266,122516693.0,63072889.0,59443804.0,0.6773,0.8215,0.6772,0.8226
2023-08-24 13:05,1252,414,838,154871,91702,63169,105091585.0,62174713.0,42916871.0,1230,407,823,154190,92191,61999,104640344.0,62503020.0,42137324.0,0.678,0.6794,0.678,0.6796
2023-08-24 13:10,1765,407,1358,180539,31137,149402,132869686.0,21076127.0,111793559.0,1729,381,1348,179941,30825,149116,132517034.0,20852620.0,111664414.0,0.6769,0.7483,0.6765,0.7488
2023-08-24 13:15,3726,1031,2695,480250,146722,333528,325847001.0,99294984.0,226552017.0,3689,1019,2670,486907,146720,340187,330868784.0,99285628.0,231583156.0,0.6768,0.6793,0.6767,0.6808
2023-08-24 13:20,6064,1976,4088,813625,295390,518235,551788210.0,199802293.0,351985917.0,6028,1955,4073,812114,294669,517445,550768432.0,199307579.0,351460852.0,0.6764,0.6792,0.6764,0.6792
2023-08-24 13:25,6139,1894,4245,804656,228311,576345,556166022.0,154467529.0,401698492.0,6114,1878,4236,803879,228386,575493,555625977.0,154465971.0,401160005.0,0.6766,0.697,0.6763,0.6971
2023-08-24 13:30,5687,1959,3728,888347,255304,633043,602498731.0,172633942.0,429864789.0,5670,1947,3723,888259,255268,632991,602441377.0,172610645.0,429830731.0,0.6762,0.679,0.6762,0.679
2023-08-24 13:35,3895,754,3141,535517,55259,480258,363361625.0,37344663.0,326016962.0,3876,742,3134,534504,54759,479745,362672960.0,37019157.0,325653802.0,0.6758,0.6788,0.676,0.6788
2023-08-24 13:40,3614,780,2834,533872,108164,425708,362076922.0,73072363.0,289004559.0,3603,775,2828,533615,108233,425382,361917351.0,73118989.0,288798362.0,0.6756,0.6789,0.6756,0.6789
2023-08-24 13:45,2770,869,1901,387293,75693,311600,262470123.0,51114728.0,211355394.0,2747,854,1893,386197,75051,311146,261774230.0,50679281.0,211094949.0,0.6753,0.6783,0.6753,0.6784
2023-08-24 13:50,2912,913,1999,378339,65345,312994,256571009.0,44145928.0,212425080.0,2892,901,1991,378200,65456,312744,256455776.0,44200798.0,212254977.0,0.6756,0.6787,0.6753,0.6787
2023-08-24 13:55,3097,1355,1742,381772,137438,244334,258302419.0,92672247.0,165630172.0,3074,1343,1731,380450,136497,243953,257421397.0,92031326.0,165390070.0,0.6743,0.6779,0.6742,0.678
2023-08-24 14:00,3509,1411,2098,424106,206743,217363,286706814.0,139282017.0,147424797.0,3482,1396,2086,422893,206084,216809,285885730.0,138835297.0,147050433.0,0.6737,0.6782,0.6737,0.6782
2023-08-24 14:05,3066,1640,1426,370618,224306,146312,250822282.0,151466336.0,99355945.0,3051,1631,1420,370139,224087,146052,250497297.0,151317064.0,99180233.0,0.6753,0.6791,0.6753,0.6791
2023-08-24 14:10,1834,1418,416,164034,123993,40041,121004693.0,83597782.0,37406911.0,1797,1399,398,158875,122918,35957,117578514.0,82872505.0,34706009.0,0.6742,0.9342,0.6742,0.9652
2023-08-24 14:15,6036,3484,2552,784589,417364,367225,540254934.0,281220185.0,259034748.0,6010,3469,2541,783871,416876,366995,539713540.0,280857603.0,258855936.0,0.6738,0.7054,0.6737,0.7053
2023-08-24 14:20,3755,2235,1520,448585,295854,152731,302882764.0,199340494.0,103542269.0,3737,2227,1510,448484,295549,152935,302819424.0,199134050.0,103685373.0,0.6738,0.6779,0.6738,0.678
2023-08-24 14:25,4515,2560,1955,500669,322390,178279,337982884.0,217218474.0,120764410.0,4506,2551,1955,502317,324029,178288,338977057.0,218206268.0,120770789.0,0.6738,0.6774,0.6734,0.6774
2023-08-24 14:30,3913,772,3141,575384,88034,487350,398908664.0,59330203.0,339578461.0,3850,736,3114,570084,86799,483285,395608478.0,58494205.0,337114273.0,0.6739,0.6968,0.6739,0.6975
2023-08-24 14:35,7477,2122,5355,1371290,109405,1261885,956586033.0,73515374.0,883070658.0,7428,2095,5333,1370392,108380,1262012,956043500.0,72850626.0,883192874.0,0.672,0.6998,0.6722,0.6998
2023-08-24 14:40,4538,1126,3412,838004,40408,797596,576356483.0,27159049.0,549197434.0,4508,1105,3403,837200,39876,797324,575795665.0,26800511.0,548995154.0,0.6721,0.6886,0.6721,0.6885
2023-08-24 14:45,4117,1830,2287,612973,87214,525759,414173867.0,58678510.0,355495357.0,4095,1813,2282,611308,85853,525455,413059565.0,57765208.0,355294357.0,0.6728,0.6762,0.6728,0.6762
2023-08-24 14:50,2753,1027,1726,525192,51143,474049,355018480.0,34438970.0,320579510.0,2740,1025,1715,524565,50589,473976,354595240.0,34065168.0,320530072.0,0.6734,0.6763,0.6734,0.6763
2023-08-24 14:55,2381,1020,1361,408402,77527,330875,275999374.0,52154145.0,223845228.0,2355,1009,1346,407892,76967,330925,275662208.0,51770379.0,223891829.0,0.6727,0.6765,0.6726,0.6766
2023-08-24 15:00,3305,1545,1760,404506,112019,292487,283772803.0,75384356.0,208388447.0,3284,1532,1752,394163,111577,282586,276666419.0,75081476.0,201584942.0,0.673,0.7125,0.6729,0.7134
2023-08-24 15:05,3774,1981,1793,413689,197574,216115,279427858.0,133137180.0,146290678.0,3770,1980,1790,423774,197545,226229,286299738.0,133085293.0,153214445.0,0.6739,0.6769,0.6737,0.6773
2023-08-24 15:10,2933,1447,1486,342884,145714,197170,231508537.0,98242231.0,133266305.0,2903,1430,1473,340693,144878,195815,230101636.0,97681519.0,132420117.0,0.6742,0.6759,0.6742,0.6763
2023-08-24 15:15,300,55,245,46600,2512,44088,31554081.0,1717722.0,29836358.0,275,38,237,44931,996,43935,30401227.0,668905.0,29732321.0,0.6838,0.6767,0.6716,0.6767
2023-08-24 15:20,1784,832,952,206788,79021,127767,150308353.0,53358167.0,96950185.0,1763,819,944,205783,77763,128020,149614916.0,52518299.0,97096616.0,0.6752,0.7588,0.6754,0.7584
2023-08-24 15:25,1702,894,808,165537,78852,86685,112009133.0,53239137.0,58769995.0,1693,894,799,165686,79852,85834,112073175.0,53888881.0,58184293.0,0.6752,0.678,0.6749,0.6779
2023-08-24 15:30,397,148,249,65697,18568,47129,44507803.0,12532889.0,31974914.0,370,122,248,65559,18498,47061,44399908.0,12472533.0,31927375.0,0.675,0.6785,0.6743,0.6784
2023-08-24 15:35,1271,416,855,205812,35441,170371,139547851.0,23928217.0,115619634.0,1252,403,849,205230,35604,169626,139127059.0,24014605.0,115112454.0,0.6752,0.6786,0.6745,0.6786
2023-08-24 15:40,944,300,644,134083,32463,101620,90776216.0,21890604.0,68885612.0,923,292,631,133392,31991,101401,90341153.0,21569498.0,68771654.0,0.6743,0.6779,0.6742,0.6782
2023-08-24 15:45,1919,626,1293,299748,56650,243098,203140925.0,38246981.0,164893944.0,1908,616,1292,300232,56623,243609,203485011.0,38225394.0,165259617.0,0.6751,0.6783,0.6751,0.6784
2023-08-24 15:50,3233,790,2443,582340,75540,506800,394853526.0,50985097.0,343868428.0,3221,782,2439,582370,75545,506825,394866891.0,50983357.0,343883533.0,0.6749,0.6785,0.6749,0.6785
2023-08-24 15:55,1785,482,1303,314835,55906,258929,213437591.0,37729654.0,175707936.0,1774,474,1300,314338,55622,258716,213098114.0,37534809.0,175563305.0,0.6749,0.6786,0.6748,0.6786
2023-08-24 16:00,926,651,275,87739,51634,36105,59292890.0,34824967.0,24467923.0,911,644,267,86855,51548,35307,58701210.0,34766809.0,23934401.0,0.6745,0.6777,0.6745,0.6779
2023-08-24 16:05,2901,1212,1689,395251,77309,317942,277529361.0,52150463.0,225378897.0,2852,1182,1670,393178,76663,316515,276172472.0,51706562.0,224465910.0,0.6746,0.7089,0.6745,0.7092
2023-08-24 16:10,4249,1612,2637,638051,76492,561559,441292342.0,51431383.0,389860958.0,4221,1590,2631,637254,75587,561667,440810754.0,50846746.0,389964007.0,0.6724,0.6942,0.6727,0.6943
2023-08-24 16:15,3205,1011,2194,445592,48233,397359,311582414.0,32541251.0,279041162.0,3158,985,2173,443538,46983,396555,310126439.0,31648511.0,278477928.0,0.6747,0.7022,0.6736,0.7022
2023-08-24 16:20,2614,2019,595,186968,105699,81269,126394907.0,71304705.0,55090201.0,2594,2013,581,186406,105615,80791,126000372.0,71248530.0,54751841.0,0.6746,0.6779,0.6746,0.6777
2023-08-24 16:25,1919,824,1095,270208,41987,228221,182708712.0,28314085.0,154394626.0,1922,828,1094,270799,42589,228210,183098183.0,28707376.0,154390806.0,0.6744,0.6765,0.6741,0.6765
2023-08-24 16:30,3642,2271,1371,393301,152768,240533,265905514.0,103081411.0,162824103.0,3610,2246,1364,391034,151556,239478,264342048.0,102236281.0,162105767.0,0.6748,0.6769,0.6746,0.6769
2023-08-24 16:35,2500,2009,491,293660,204210,89450,198569269.0,137840203.0,60729066.0,2492,2003,489,292552,203306,89246,197822158.0,137226623.0,60595535.0,0.675,0.6789,0.675,0.679
2023-08-24 16:40,3020,2095,925,285325,205897,79428,192676797.0,138913388.0,53763409.0,3010,2092,918,284929,205771,79158,192439945.0,138829039.0,53610906.0,0.6747,0.6769,0.6747,0.6773
2023-08-24 16:45,4252,2945,1307,434911,291950,142961,293815133.0,196982252.0,96832881.0,4231,2930,1301,434324,291187,143137,293418397.0,196464648.0,96953749.0,0.6747,0.6773,0.6747,0.6773
2023-08-24 16:50,2423,1805,618,291314,243987,47327,206984562.0,164621757.0,42362804.0,2390,1785,605,290222,244178,46044,206209944.0,164731147.0,41478796.0,0.6747,0.8951,0.6746,0.9009
2023-08-24 16:55,1706,1388,318,325178,302688,22490,219418072.0,204159187.0,15258885.0,1684,1370,314,324233,301653,22580,218775446.0,203455218.0,15320227.0,0.6745,0.6785,0.6745,0.6785
2023-08-24 17:00,3367,1979,1388,451502,338076,113426,315163322.0,228121564.0,87041758.0,3326,1951,1375,449541,337483,112058,313950451.0,227720719.0,86229732.0,0.6748,0.7674,0.6748,0.7695
2023-08-24 17:05,2405,1339,1066,234152,151103,83049,158319365.0,102001392.0,56317972.0,2376,1315,1061,233110,150089,83021,157613323.0,101303522.0,56309800.0,0.675,0.6781,0.675,0.6783
2023-08-24 17:10,2872,1076,1796,467656,249944,217712,316239357.0,168471209.0,147768148.0,2863,1069,1794,467949,249988,217961,316437365.0,168500105.0,147937260.0,0.674,0.6787,0.674,0.6787
2023-08-24 17:15,2079,1162,917,260023,205276,54747,175533759.0,138462782.0,37070977.0,2073,1160,913,260431,205747,54684,175843262.0,138777688.0,37065573.0,0.6745,0.6771,0.6745,0.6778
2023-08-24 17:20,2663,1786,877,339728,267467,72261,229399886.0,180386218.0,49013668.0,2644,1771,873,339466,267146,72320,229213413.0,180160032.0,49053381.0,0.6744,0.6783,0.6744,0.6783
2023-08-24 17:25,2983,1904,1079,419579,308168,111411,293679785.0,207857332.0,85822453.0,2953,1891,1062,417657,307959,109698,292390176.0,207692604.0,84697572.0,0.6745,0.7703,0.6744,0.7721
2023-08-24 17:30,2264,1372,892,327771,252521,75250,231507312.0,170239055.0,61268256.0,2244,1363,881,328457,252719,75738,231985454.0,170366256.0,61619197.0,0.6742,0.8142,0.6741,0.8136
2023-08-24 17:35,3555,1497,2058,517680,185931,331749,349897440.0,125390970.0,224506469.0,3535,1486,2049,515695,185392,330303,348607670.0,125026741.0,223580929.0,0.6744,0.6767,0.6744,0.6769
2023-08-24 17:40,2367,607,1760,371850,38311,333539,251565852.0,25832706.0,225733146.0,2352,598,1754,371498,37966,333532,251327255.0,25599693.0,225727562.0,0.6743,0.6768,0.6743,0.6768
2023-08-24 17:45,1592,405,1187,258194,22788,235406,174684304.0,15375407.0,159308897.0,1576,394,1182,257409,22715,234694,174208045.0,15325599.0,158882446.0,0.6747,0.6767,0.6747,0.677
2023-08-24 17:50,2237,254,1983,479878,14317,465561,324618018.0,9651001.0,314967016.0,2222,240,1982,479890,14024,465866,324674836.0,9443325.0,315231510.0,0.6741,0.6765,0.6734,0.6767
2023-08-24 17:55,962,102,860,203506,4867,198639,147924036.0,3268977.0,144655058.0,938,90,848,202034,4246,197788,146967141.0,2856359.0,144110782.0,0.6717,0.7282,0.6727,0.7286
2023-08-24 18:00,2858,721,2137,477474,25005,452469,322646444.0,16833979.0,305812464.0,2824,698,2126,475939,23996,451943,321662336.0,16144815.0,305517521.0,0.6732,0.6759,0.6728,0.676
2023-08-24 18:05,598,206,392,60718,7109,53609,40988189.0,4778534.0,36209654.0,581,195,386,59289,6212,53077,40029224.0,4176680.0,35852543.0,0.6722,0.6754,0.6724,0.6755
2023-08-24 18:10,1646,748,898,175029,18261,156768,128181871.0,12300912.0,115880958.0,1571,699,872,172075,17357,154718,126260163.0,11678390.0,114581772.0,0.6736,0.7392,0.6728,0.7406
2023-08-24 18:15,2940,897,2043,401638,40333,361305,270564472.0,27224277.0,243340195.0,2885,857,2028,397512,38650,358862,267923807.0,26011200.0,241912606.0,0.675,0.6735,0.673,0.6741
2023-08-24 18:20,4710,1913,2797,520768,107986,412782,350679137.0,72485461.0,278193676.0,4666,1877,2789,519900,107369,412531,350085398.0,72060639.0,278024758.0,0.6712,0.6739,0.6711,0.6739
2023-08-24 18:25,2848,1023,1825,374379,61955,312424,252038702.0,41603585.0,210435117.0,2804,993,1811,372757,60631,312126,250941381.0,40686619.0,210254762.0,0.6715,0.6736,0.6711,0.6736
2023-08-24 18:30,3283,1138,2145,413317,115737,297580,278724033.0,77746094.0,200977939.0,3255,1124,2131,412507,115522,296985,278138375.0,77570103.0,200568271.0,0.6717,0.6754,0.6715,0.6753
2023-08-24 18:35,2352,1542,810,291185,220673,70512,195865007.0,148252900.0,47612106.0,2350,1541,809,292273,220681,71592,196601995.0,148254983.0,48347012.0,0.6718,0.6752,0.6718,0.6753
2023-08-25 10:00,7346,3652,3694,855735,564794,290941,658674133.0,378695724.0,279978409.0,6782,3373,3409,833037,554085,278952,632923332.0,372046376.0,260876955.0,0.6705,0.9623,0.6715,0.9352
2023-08-25 10:05,8041,4730,3311,1046674,849517,197157,809444939.0,572300406.0,237144532.0,7807,4603,3204,1029266,839589,189677,797015952.0,565156542.0,231859409.0,0.6737,1.2028,0.6731,1.2224
2023-08-25 10:10,1134,505,629,82239,60883,21356,66186930.0,41266464.0,24920466.0,910,418,492,70611,57292,13319,58278949.0,38772843.0,19506106.0,0.6778,1.1669,0.6768,1.4645
2023-08-25 10:15,1404,1113,291,184346,168305,16041,124986715.0,114042630.0,10944085.0,1256,1048,208,175309,166781,8528,118814383.0,112980167.0,5834215.0,0.6776,0.6823,0.6774,0.6841
2023-08-25 10:20,3719,2426,1293,443014,346241,96773,341382445.0,234347411.0,107035033.0,3490,2287,1203,435587,344279,91308,336427338.0,233003778.0,103423559.0,0.6768,1.106,0.6768,1.1327
2023-08-25 10:25,2833,1038,1795,306134,132754,173380,217876935.0,89620064.0,128256870.0,2726,986,1740,303954,130270,173684,216482284.0,87924764.0,128557520.0,0.6751,0.7397,0.6749,0.7402
2023-08-25 10:30,1572,1133,439,268824,225522,43302,212682747.0,152355494.0,60327252.0,1500,1113,387,265233,223812,41421,210277141.0,151186325.0,59090815.0,0.6756,1.3932,0.6755,1.4266
2023-08-25 10:35,233,180,53,27008,19778,7230,18286062.0,13367934.0,4918128.0,199,158,41,21833,16321,5512,14762468.0,11008920.0,3753547.0,0.6759,0.6802,0.6745,0.681
2023-08-25 10:40,834,466,368,90815,65099,25716,61444457.0,43940102.0,17504355.0,794,444,350,87606,62517,25089,59414661.0,42329135.0,17085526.0,0.675,0.6807,0.6771,0.681
2023-08-25 10:45,2821,2216,605,376763,335504,41259,276654225.0,227871665.0,48782560.0,2743,2184,559,371669,333059,38610,273137104.0,226177893.0,46959210.0,0.6792,1.1823,0.6791,1.2162
2023-08-25 10:50,990,695,295,101880,83078,18802,69238938.0,56416263.0,12822674.0,937,672,265,99539,82136,17403,67645039.0,55784035.0,11861003.0,0.6791,0.682,0.6792,0.6815
2023-08-25 10:55,1057,829,228,96191,84411,11780,75654094.0,57298153.0,18355941.0,1011,809,202,94204,83081,11123,74317190.0,56382234.0,17934955.0,0.6788,1.5582,0.6786,1.6124
2023-08-25 11:00,1893,1504,389,153640,139387,14253,104243406.0,94533448.0,9709958.0,1848,1476,372,152832,139537,13295,103689012.0,94635492.0,9053520.0,0.6782,0.6813,0.6782,0.681
2023-08-25 11:05,2849,1730,1119,295714,178467,117247,200644756.0,121006959.0,79637797.0,2801,1702,1099,294233,177481,116752,199788086.0,120338622.0,79449464.0,0.678,0.6792,0.678,0.6805
2023-08-25 11:10,1478,878,600,155087,121438,33649,105369463.0,82444356.0,22925107.0,1404,837,567,149589,120203,29386,101600154.0,81595657.0,20004496.0,0.6789,0.6813,0.6788,0.6807
2023-08-25 11:15,642,417,225,75471,62623,12848,51276567.0,42538459.0,8738108.0,609,406,203,72449,60884,11565,49255274.0,41375442.0,7879832.0,0.6793,0.6801,0.6796,0.6814
2023-08-25 11:20,1652,1211,441,193469,174277,19192,132860564.0,118475231.0,14385332.0,1608,1190,418,192583,174863,17720,130918929.0,118843808.0,12075121.0,0.6798,0.7495,0.6796,0.6814
2023-08-25 11:25,842,334,508,87840,21420,66420,70038886.0,14530418.0,55508468.0,807,330,477,86595,21253,65342,69247791.0,14420103.0,54827687.0,0.6784,0.8357,0.6785,0.8391
2023-08-25 11:30,670,255,415,64479,24930,39549,45041038.0,16879356.0,28161682.0,627,234,393,60935,23933,37002,42648744.0,16200670.0,26448074.0,0.6771,0.7121,0.6769,0.7148
2023-08-25 11:35,743,241,502,63963,17569,46394,43349070.0,11890036.0,31459033.0,714,222,492,62407,16652,45755,42315719.0,11263362.0,31052356.0,0.6768,0.6781,0.6764,0.6787
2023-08-25 11:40,1146,292,854,79623,14162,65461,64246421.0,9619954.0,54626466.0,1122,285,837,78640,14055,64585,63604421.0,9501020.0,54103401.0,0.6793,0.8345,0.676,0.8377
2023-08-25 11:45,1799,590,1209,123524,29701,93823,83563760.0,20075799.0,63487961.0,1777,578,1199,121911,29617,92294,82568814.0,20017539.0,62551275.0,0.6759,0.6767,0.6759,0.6777
2023-08-25 11:50,209,85,124,22467,4404,18063,15210969.0,2971221.0,12239748.0,190,75,115,21964,4120,17844,14858117.0,2766877.0,12091239.0,0.6747,0.6776,0.6716,0.6776
2023-08-25 11:55,1876,522,1354,261785,31321,230464,187746934.0,21107709.0,166639225.0,1835,495,1340,260792,33145,227647,188046988.0,22337067.0,165709921.0,0.6739,0.7231,0.6739,0.7279
2023-08-25 12:00,2260,1224,1036,344725,189352,155373,243640528.0,128084345.0,115556183.0,2208,1200,1008,337087,186385,150702,238175706.0,125876514.0,112299192.0,0.6764,0.7437,0.6754,0.7452
2023-08-25 12:05,3544,2988,556,480377,466401,13976,345123383.0,315079475.0,30043908.0,3515,2971,544,480246,466601,13645,345033073.0,315202185.0,29830888.0,0.6756,2.1497,0.6755,2.1862
2023-08-25 12:10,3044,2224,820,422101,405417,16684,285250205.0,273950552.0,11299653.0,3026,2212,814,421703,405084,16619,284981315.0,273720187.0,11261128.0,0.6757,0.6773,0.6757,0.6776
2023-08-25 12:15,2792,2159,633,354349,338451,15898,239498851.0,228725390.0,10773461.0,2785,2154,631,354153,338208,15945,239367899.0,228562429.0,10805470.0,0.6758,0.6777,0.6758,0.6777
2023-08-25 12:20,680,584,96,121139,117413,3726,102478907.0,79363948.0,23114959.0,663,572,91,120100,116612,3488,101769372.0,78818759.0,22950613.0,0.6759,6.2037,0.6759,6.5799
2023-08-25 12:25,2023,1886,137,342119,335777,6342,231488956.0,227100896.0,4388060.0,2004,1874,130,340693,334941,5752,230431759.0,226453356.0,3978403.0,0.6763,0.6919,0.6761,0.6917
2023-08-25 12:30,2685,2207,478,453240,434385,18855,306373565.0,293587408.0,12786156.0,2678,2204,474,452378,433644,18734,305787085.0,293081880.0,12705205.0,0.6759,0.6781,0.6759,0.6782
2023-08-25 12:35,936,782,154,103070,91414,11656,69721110.0,61815466.0,7905643.0,915,766,149,103275,91190,12085,69848130.0,61645829.0,8202300.0,0.6762,0.6782,0.676,0.6787
2023-08-25 12:40,2203,1838,365,341131,315701,25430,230505231.0,213265453.0,17239777.0,2186,1828,358,341428,316346,25082,230706177.0,213702071.0,17004106.0,0.6755,0.6779,0.6755,0.6779
2023-08-25 12:45,883,845,38,106402,104835,1567,71932435.0,70868984.0,1063451.0,863,829,34,106281,104396,1885,71855170.0,70568099.0,1287070.0,0.676,0.6787,0.676,0.6828
2023-08-25 12:50,1033,835,198,150222,138631,11591,101549170.0,93666693.0,7882477.0,1019,825,194,149241,138377,10864,100858674.0,93488789.0,7369885.0,0.6757,0.6801,0.6756,0.6784
2023-08-25 12:55,1848,1390,458,229124,208169,20955,154907687.0,140718294.0,14189393.0,1827,1378,449,232094,208483,23611,156999776.0,140929665.0,16070110.0,0.676,0.6771,0.676,0.6806
2023-08-25 13:00,1335,969,366,157995,141447,16548,117062757.0,95575928.0,21486829.0,1307,945,362,157375,140963,16412,116677872.0,95249028.0,21428843.0,0.6757,1.2985,0.6757,1.3057
2023-08-25 13:05,1464,1249,215,189866,181010,8856,128346132.0,122354221.0,5991911.0,1431,1224,207,189181,180272,8909,127874319.0,121827701.0,6046617.0,0.676,0.6766,0.6758,0.6787
2023-08-25 13:10,1449,1042,407,204196,187855,16341,148407071.0,127020899.0,21386171.0,1433,1026,407,203798,187292,16506,148118020.0,126639094.0,21478925.0,0.6762,1.3087,0.6762,1.3013
2023-08-25 13:15,470,187,283,36680,28318,8362,24850602.0,19177795.0,5672806.0,443,167,276,35195,26978,8217,23823221.0,18247758.0,5575463.0,0.6772,0.6784,0.6764,0.6785
2023-08-25 13:20,2003,1437,566,259311,238772,20539,175613059.0,161663844.0,13949215.0,1978,1421,557,259987,237872,22115,176091447.0,161047585.0,15043862.0,0.6771,0.6792,0.677,0.6803
2023-08-25 13:25,1350,975,375,175435,158044,17391,129234716.0,107086534.0,22148182.0,1333,963,370,174550,157443,17107,128596512.0,106662392.0,21934120.0,0.6776,1.2735,0.6775,1.2822
2023-08-25 13:30,2018,1518,500,311961,294464,17497,211374446.0,199469005.0,11905441.0,1972,1495,477,310862,294135,16727,210622849.0,199240535.0,11382314.0,0.6774,0.6804,0.6774,0.6805
2023-08-25 13:35,4908,4131,777,812298,781883,30415,550967785.0,530261260.0,20706525.0,4894,4130,764,811393,781575,29818,550360647.0,530057495.0,20303152.0,0.6782,0.6808,0.6782,0.6809
2023-08-25 13:40,6850,5390,1460,1066238,1014467,51771,735119125.0,688305454.0,46813670.0,6809,5371,1438,1044589,1013388,31201,719140765.0,687562175.0,31578590.0,0.6785,0.9042,0.6785,1.0121
2023-08-25 13:45,4251,3556,695,716101,699436,16665,485994901.0,474645704.0,11349197.0,4240,3549,691,717510,699396,18114,486974731.0,474616700.0,12358031.0,0.6786,0.681,0.6786,0.6822
2023-08-25 13:50,4116,2962,1154,692336,640624,51712,490521044.0,434712687.0,55808357.0,4077,2938,1139,689516,638873,50643,488633388.0,433481343.0,55152044.0,0.6786,1.0792,0.6785,1.089
2023-08-25 13:55,3265,2393,872,601055,538803,62252,408105145.0,365714383.0,42390762.0,3230,2374,856,599626,538033,61593,407126952.0,365185855.0,41941096.0,0.6788,0.681,0.6787,0.6809
2023-08-25 14:00,3158,2303,855,537563,491359,46204,364833932.0,333381063.0,31452868.0,3138,2297,841,537479,491708,45771,364784885.0,333615660.0,31169225.0,0.6785,0.6807,0.6785,0.681
2023-08-25 14:05,1821,1264,557,252632,216994,35638,181598957.0,147121911.0,34477046.0,1784,1244,540,250154,216020,34134,180018739.0,146447035.0,33571704.0,0.678,0.9674,0.6779,0.9835
2023-08-25 14:10,2871,1961,910,358895,251273,107622,264516319.0,170540096.0,93976223.0,2843,1955,888,356515,249224,107291,262800326.0,169089004.0,93711322.0,0.6787,0.8732,0.6785,0.8734
2023-08-25 14:15,7643,4318,3325,1049512,735280,314232,843129619.0,502283607.0,340846011.0,7257,4180,3077,1024049,721086,302963,825812757.0,492316505.0,333496251.0,0.6831,1.0847,0.6827,1.1008
2023-08-25 14:20,5327,3692,1635,668183,515073,153110,644457892.0,359476883.0,284981009.0,4122,3134,988,540515,439071,101444,553029169.0,303430939.0,249598230.0,0.6979,1.8613,0.6911,2.4605
2023-08-25 14:25,3302,2170,1132,400439,246431,154008,342741793.0,172163993.0,170577800.0,2690,1828,862,345244,223932,121312,303714526.0,155771575.0,147942951.0,0.6986,1.1076,0.6956,1.2195
2023-08-25 14:30,1573,859,714,153680,78688,74992,117659462.0,55233500.0,62425962.0,1301,763,538,127193,66589,60604,99490906.0,46691089.0,52799817.0,0.7019,0.8324,0.7012,0.8712
2023-08-25 14:35,3818,2558,1260,533673,405743,127930,382101114.0,282834110.0,99267003.0,3189,2261,928,475292,373898,101394,341141501.0,259790653.0,81350848.0,0.6971,0.7759,0.6948,0.8023
2023-08-25 14:40,2756,1156,1600,294636,100104,194532,225825096.0,69978359.0,155846736.0,2496,1018,1478,272217,91086,181131,210218638.0,63110411.0,147108227.0,0.6991,0.8011,0.6929,0.8122
2023-08-25 14:45,1641,746,895,139133,50041,89092,96346135.0,34627392.0,61718743.0,1479,654,825,133549,46387,87162,92618588.0,32061430.0,60557158.0,0.692,0.6928,0.6912,0.6948
2023-08-25 14:50,618,321,297,51133,27750,23383,46175506.0,19408759.0,26766746.0,437,236,201,36593,17491,19102,35952633.0,12105601.0,23847032.0,0.6994,1.1447,0.6921,1.2484
2023-08-25 14:55,800,252,548,78374,13516,64858,64782578.0,9342154.0,55440424.0,680,171,509,68902,8073,60829,58366236.0,5583053.0,52783183.0,0.6912,0.8548,0.6916,0.8677
2023-08-25 15:00,502,323,179,31418,16359,15059,21648798.0,11363837.0,10284961.0,389,267,122,25106,12832,12274,17416666.0,8886172.0,8530494.0,0.6947,0.683,0.6925,0.695
2023-08-25 15:05,666,441,225,58651,42255,16396,51335670.0,29402214.0,21933456.0,520,346,174,44566,34990,9576,41470740.0,24270331.0,17200409.0,0.6958,1.3377,0.6936,1.7962
2023-08-25 15:10,1083,876,207,99176,72079,27097,68871471.0,50018419.0,18853052.0,1006,831,175,96336,70925,25411,67531456.0,49835485.0,17695971.0,0.6939,0.6958,0.7027,0.6964
2023-08-25 15:15,515,198,317,32376,10802,21574,22539823.0,7601040.0,14938782.0,430,161,269,27618,8376,19242,19191867.0,5811227.0,13380640.0,0.7037,0.6924,0.6938,0.6954
2023-08-25 15:20,2941,2249,692,387158,289913,97245,300915362.0,201578932.0,99336429.0,2850,2211,639,369560,284753,84807,288423900.0,197674944.0,90748955.0,0.6953,1.0215,0.6942,1.0701
2023-08-25 15:25,2422,878,1544,314365,59839,254526,259724278.0,41384836.0,218339442.0,2267,774,1493,301564,53681,247883,251140844.0,37111189.0,214029654.0,0.6916,0.8578,0.6913,0.8634
2023-08-25 15:30,2948,388,2560,494566,15709,478857,353480868.0,10848370.0,342632498.0,2860,329,2531,488172,11580,476592,349227350.0,7984800.0,341242550.0,0.6906,0.7155,0.6895,0.716
2023-08-25 15:35,2539,367,2172,448792,17811,430981,321834420.0,12344958.0,309489462.0,2465,322,2143,444416,15451,428965,318747561.0,10665514.0,308082047.0,0.6931,0.7181,0.6903,0.7182
2023-08-25 15:40,1074,493,581,135469,52990,82479,93931244.0,36660941.0,57270303.0,1017,457,560,134430,49996,84434,93247274.0,34587101.0,58660172.0,0.6918,0.6944,0.6918,0.6947
2023-08-25 15:45,1126,535,591,128163,43768,84395,88942700.0,30310874.0,58631826.0,1077,507,570,124332,42049,82283,86274843.0,29099599.0,57175243.0,0.6925,0.6947,0.692,0.6949
2023-08-25 15:50,4375,3189,1186,643396,530160,113236,534546463.0,370848767.0,163697696.0,3863,3003,860,591143,503255,87888,497790075.0,351575423.0,146214652.0,0.6995,1.4456,0.6986,1.6636
2023-08-25 15:55,1899,878,1021,231425,119887,111538,181698487.0,83353967.0,98344519.0,1705,789,916,220604,118231,102373,174682665.0,82101697.0,92580968.0,0.6953,0.8817,0.6944,0.9043
2023-08-25 16:00,3875,1433,2442,556739,128344,428395,419350896.0,89194232.0,330156663.0,3731,1360,2371,547494,124555,422939,412763291.0,86418388.0,326344903.0,0.695,0.7707,0.6938,0.7716
2023-08-25 16:05,1355,637,718,151868,88367,63501,105671251.0,61431377.0,44239873.0,1263,599,664,138861,85336,53525,96526493.0,59235353.0,37291139.0,0.6952,0.6967,0.6941,0.6967
2023-08-25 16:10,1337,912,425,185503,164873,20630,139889301.0,114936928.0,24952373.0,1220,876,344,172155,157653,14502,130436833.0,109728173.0,20708659.0,0.6971,1.2095,0.696,1.428
2023-08-25 16:15,1223,795,428,130186,108120,22066,91715072.0,75233350.0,16481721.0,1122,746,376,123403,104919,18484,86441093.0,72950273.0,13490820.0,0.6958,0.7469,0.6953,0.7299
2023-08-25 16:20,166,99,67,13674,8906,4768,10158765.0,6958651.0,3200114.0,120,80,40,7585,4801,2784,5909181.0,3954667.0,1954514.0,0.7813,0.6712,0.8237,0.7021
2023-08-25 16:25,701,427,274,64825,38839,25986,66298544.0,26987155.0,39311389.0,621,386,235,60396,33763,26633,63257280.0,23489974.0,39767306.0,0.6948,1.5128,0.6957,1.4932
2023-08-25 16:30,1044,736,308,97358,77986,19372,67797402.0,54273230.0,13524172.0,992,713,279,95058,76940,18118,66185095.0,53539040.0,12646054.0,0.6959,0.6981,0.6959,0.698
2023-08-25 16:35,573,277,296,49061,34799,14262,34128524.0,24195578.0,9932946.0,500,252,248,44225,34194,10031,30763688.0,23761532.0,7002156.0,0.6953,0.6965,0.6949,0.6981
2023-08-25 16:40,451,182,269,44574,18114,26460,41413122.0,12559455.0,28853666.0,399,163,236,47223,19481,27742,43459685.0,13485025.0,29974660.0,0.6934,1.0905,0.6922,1.0805
2023-08-25 16:45,1106,779,327,147341,89679,57662,102491613.0,62290329.0,40201284.0,1083,775,308,144071,89033,55038,100208921.0,61808210.0,38400711.0,0.6946,0.6972,0.6942,0.6977
2023-08-25 16:50,1247,516,731,208802,40420,168382,155689952.0,28032014.0,127657937.0,1156,466,690,205218,38255,166963,153440385.0,26500728.0,126939656.0,0.6935,0.7581,0.6927,0.7603
2023-08-25 16:55,1448,869,579,128716,66731,61985,110813303.0,46410232.0,64403071.0,1383,836,547,126376,66700,59676,109118293.0,46308718.0,62809575.0,0.6955,1.039,0.6943,1.0525
2023-08-25 17:00,4088,424,3664,801626,20259,781367,577617362.0,14034018.0,563583343.0,3889,346,3543,790303,15546,774757,570040325.0,10727097.0,559313228.0,0.6927,0.7213,0.69,0.7219
2023-08-25 17:05,4037,2098,1939,639933,297379,342554,463993087.0,205666910.0,258326176.0,3836,1972,1864,631170,289464,341706,458030096.0,200087606.0,257942489.0,0.6916,0.7541,0.6912,0.7549
2023-08-25 17:10,3578,1053,2525,540119,168237,371882,384446538.0,116317866.0,268128671.0,3483,989,2494,535285,165579,369706,381880782.0,115095493.0,266785289.0,0.6914,0.721,0.6951,0.7216
2023-08-25 17:15,3698,2404,1294,501409,316154,185255,368454119.0,218889345.0,149564773.0,3620,2365,1255,498971,314174,184797,366634344.0,217409417.0,149224927.0,0.6924,0.8073,0.692,0.8075
2023-08-25 17:20,5839,4771,1068,900427,814934,85493,634054341.0,564130762.0,69923579.0,5776,4740,1036,897386,813281,84105,632000372.0,562964768.0,69035604.0,0.6922,0.8179,0.6922,0.8208
2023-08-25 17:25,528,246,282,21614,6312,15302,15015326.0,4391589.0,10623736.0,506,236,270,19789,5716,14073,13739640.0,3956109.0,9783530.0,0.6958,0.6943,0.6921,0.6952
2023-08-25 17:30,5402,4270,1132,1041642,1002396,39246,733951824.0,695966859.0,37984965.0,5251,4223,1028,1024524,997839,26685,721734140.0,692568094.0,29166046.0,0.6943,0.9679,0.6941,1.093
2023-08-25 17:35,3376,2529,847,661166,635478,25688,479629408.0,440641681.0,38987727.0,3311,2495,816,659144,634317,24827,478195517.0,439757943.0,38437573.0,0.6934,1.5177,0.6933,1.5482
2023-08-25 17:40,4581,3868,713,860342,847653,12689,597167575.0,588326538.0,8841037.0,4539,3848,691,860332,847256,13076,597195527.0,588026271.0,9169256.0,0.6941,0.6967,0.694,0.7012
2023-08-25 17:45,4003,2305,1698,677352,458237,219115,480590090.0,317930824.0,162659266.0,3932,2270,1662,672020,456179,215841,477314083.0,316484427.0,160829655.0,0.6938,0.7423,0.6938,0.7451
2023-08-25 17:50,4437,1107,3330,714075,92411,621664,506430390.0,63980047.0,442450342.0,4401,1099,3302,711743,92586,619157,504837678.0,64086206.0,440751471.0,0.6923,0.7117,0.6922,0.7119
2023-08-25 17:55,3698,1256,2442,488535,79071,409464,349651689.0,54737369.0,294914320.0,3658,1227,2431,487620,78201,409419,349009871.0,54122297.0,294887573.0,0.6923,0.7202,0.6921,0.7203
2023-08-25 18:00,3201,661,2540,569009,46266,522743,395419866.0,32033183.0,363386682.0,3173,653,2520,570277,46594,523683,396297054.0,32210889.0,364086164.0,0.6924,0.6952,0.6913,0.6952
2023-08-25 18:05,1104,543,561,141619,43686,97933,130093292.0,30343053.0,99750239.0,1053,517,536,137672,41509,96163,127388917.0,28794114.0,98594803.0,0.6946,1.0186,0.6937,1.0253
2023-08-25 18:10,2217,525,1692,336837,45515,291322,234065408.0,31540401.0,202525007.0,2172,509,1663,335514,45692,289822,233185411.0,31656504.0,201528906.0,0.693,0.6952,0.6928,0.6954
2023-08-25 18:15,1257,248,1009,190654,17302,173352,142447531.0,11962409.0,130485122.0,1193,208,985,184317,15807,168510,138383581.0,10925122.0,127458459.0,0.6914,0.7527,0.6912,0.7564
2023-08-25 18:20,1051,285,766,172234,20787,151447,129943940.0,14388665.0,115555274.0,1011,259,752,165720,19035,146685,125441054.0,13147741.0,112293313.0,0.6922,0.763,0.6907,0.7655
2023-08-25 18:25,5121,3586,1535,866276,696484,169792,770939710.0,483946751.0,286992959.0,4910,3495,1415,844031,679962,164069,754357675.0,471355289.0,283002385.0,0.6948,1.6903,0.6932,1.7249
2023-08-25 18:30,3173,2122,1051,483952,368139,115813,368245815.0,256177562.0,112068252.0,3044,2082,962,462975,361740,101235,353639893.0,251325167.0,102314726.0,0.6959,0.9677,0.6948,1.0107
2023-08-25 18:35,838,331,507,67831,36879,30952,47194756.0,25693463.0,21501292.0,812,310,502,67963,35761,32202,47260748.0,24815436.0,22445312.0,0.6967,0.6947,0.6939,0.697
2023-08-28 10:00,3013,1730,1283,299688,203650,96038,307446600.0,143119050.0,164327550.0,2122,1388,734,259494,188338,71156,267908227.0,132021076.0,135887151.0,0.7028,1.7111,0.701,1.9097
2023-08-28 10:05,4626,2133,2493,512944,243944,269000,434256174.0,170981113.0,263275061.0,4221,1914,2307,480274,230256,250018,411012660.0,161003107.0,250009553.0,0.7009,0.9787,0.6992,1.0
2023-08-28 10:10,2727,1775,952,292904,211199,81705,226738757.0,148042809.0,78695947.0,2493,1662,831,277056,204061,72995,215531126.0,142850912.0,72680214.0,0.701,0.9632,0.7,0.9957
2023-08-28 10:15,2877,2065,812,347816,280450,67366,266583821.0,197581294.0,69002527.0,2652,1963,689,319296,266218,53078,245643286.0,186794818.0,58848467.0,0.7045,1.0243,0.7017,1.1087
2023-08-28 10:20,1195,664,531,153475,85567,67908,130581400.0,60377480.0,70203920.0,884,496,388,110625,74356,36269,99419594.0,52289200.0,47130393.0,0.7056,1.0338,0.7032,1.2995
2023-08-28 10:25,1688,471,1217,222084,55554,166530,167457130.0,39201739.0,128255390.0,1475,410,1065,203392,49251,154141,154470542.0,34627798.0,119842743.0,0.7057,0.7702,0.7031,0.7775
2023-08-28 10:30,4356,3645,711,663160,594456,68704,489919990.0,419743994.0,70175996.0,4135,3522,613,643456,583083,60373,475570900.0,411384620.0,64186280.0,0.7061,1.0214,0.7055,1.0632
2023-08-28 10:35,4209,3797,412,625213,590455,34758,462523733.0,416552547.0,45971186.0,4050,3712,338,616103,585751,30352,456108970.0,413100230.0,43008740.0,0.7055,1.3226,0.7052,1.417
2023-08-28 10:40,843,635,208,66271,56709,9562,46882308.0,40114293.0,6768014.0,722,580,142,64012,56274,7738,45255216.0,39765244.0,5489972.0,0.7074,0.7078,0.7066,0.7095
2023-08-28 10:45,1727,754,973,222460,87852,134608,167819060.0,61884747.0,105934313.0,1624,698,926,215758,85249,130509,163174517.0,60023235.0,103151281.0,0.7044,0.787,0.7041,0.7904
2023-08-28 10:50,295,190,105,35073,25152,9921,24652120.0,17645332.0,7006788.0,230,170,60,26349,19612,6737,18549810.0,13776321.0,4773488.0,0.7015,0.7063,0.7024,0.7085
2023-08-28 10:55,1055,406,649,109104,52378,56726,88045899.0,37433817.0,50612081.0,992,378,614,104235,50466,53769,84774931.0,36077225.0,48697706.0,0.7147,0.8922,0.7149,0.9057
2023-08-28 11:00,4143,2297,1846,528164,318411,209753,382150074.0,223675977.0,158474097.0,3991,2220,1771,521970,314675,207295,378022455.0,220975697.0,157046758.0,0.7025,0.7555,0.7022,0.7576
2023-08-28 11:05,6204,2824,3380,839421,194897,644524,622741372.0,136826309.0,485915062.0,6095,2759,3336,834474,192788,641686,619478728.0,135342687.0,484136040.0,0.702,0.7539,0.702,0.7545
2023-08-28 11:10,3409,637,2772,520887,22328,498559,388270991.0,15692165.0,372578825.0,3323,579,2744,515484,17778,497706,384472301.0,12462430.0,372009870.0,0.7028,0.7473,0.701,0.7474
2023-08-28 11:15,1077,219,858,111984,7197,104787,78874017.0,5063620.0,73810396.0,1009,180,829,110161,6022,104139,77565186.0,4202461.0,73362725.0,0.7036,0.7044,0.6979,0.7045
2023-08-28 11:20,1836,482,1354,201757,13490,188267,152850342.0,9513491.0,143336851.0,1789,450,1339,199816,11711,188105,151419371.0,8223707.0,143195664.0,0.7052,0.7613,0.7022,0.7613
2023-08-28 11:25,868,349,519,68461,17922,50539,48231666.0,12618575.0,35613090.0,814,330,484,67759,18836,48923,47768671.0,13248375.0,34520296.0,0.7041,0.7047,0.7034,0.7056
2023-08-28 11:30,1424,309,1115,141501,27025,114476,99758294.0,19013969.0,80744324.0,1376,284,1092,137729,23961,113768,97144799.0,16846124.0,80298675.0,0.7036,0.7053,0.7031,0.7058
2023-08-28 11:35,587,143,444,55619,24780,30839,39179812.0,17455592.0,21724219.0,556,125,431,52833,22692,30141,37254613.0,15953674.0,21300939.0,0.7044,0.7044,0.7031,0.7067
2023-08-28 11:40,2661,1790,871,369874,245047,124827,314938309.0,173085628.0,141852681.0,2472,1662,810,359291,238509,120782,307057696.0,168084730.0,138972966.0,0.7063,1.1364,0.7047,1.1506
2023-08-28 11:45,1087,339,748,132641,29421,103220,104154928.0,20728517.0,83426410.0,988,310,678,129391,29193,100198,102067198.0,20546008.0,81521189.0,0.7045,0.8082,0.7038,0.8136
2023-08-28 11:50,739,191,548,88811,14606,74205,62652935.0,10299778.0,52353157.0,691,165,526,86731,13900,72831,61184744.0,9779115.0,51405629.0,0.7052,0.7055,0.7035,0.7058
2023-08-28 11:55,1573,771,802,182616,97159,85457,139562198.0,68472898.0,71089300.0,1529,745,784,179728,95483,84245,137451847.0,67240957.0,70210890.0,0.7048,0.8319,0.7042,0.8334
2023-08-28 12:00,1606,1348,258,204190,180656,23534,143859663.0,127219887.0,16639775.0,1558,1327,231,205832,183355,22477,144998494.0,129105394.0,15893100.0,0.7042,0.7071,0.7041,0.7071
2023-08-28 12:05,2411,1687,724,359063,282193,76870,253141276.0,198773826.0,54367450.0,2374,1670,704,354475,281288,73187,249855277.0,198121862.0,51733415.0,0.7044,0.7073,0.7043,0.7069
2023-08-28 12:10,1859,1260,599,296532,218297,78235,219540899.0,153698984.0,65841915.0,1795,1230,565,288810,212385,76425,214164564.0,149515362.0,64649201.0,0.7041,0.8416,0.704,0.8459
2023-08-28 12:15,1160,207,953,144047,24798,119249,101516242.0,17398207.0,84118034.0,1123,193,930,145311,26658,118653,102486420.0,18692358.0,83794062.0,0.7016,0.7054,0.7012,0.7062
2023-08-28 12:20,915,383,532,86727,41107,45620,61213365.0,28974270.0,32239094.0,878,370,508,84317,39370,44947,59480029.0,27712211.0,31767817.0,0.7049,0.7067,0.7039,0.7068
2023-08-28 12:25,1108,639,469,118995,66797,52198,83934944.0,47066947.0,36867997.0,1073,615,458,115399,63893,51506,81450140.0,45010450.0,36439690.0,0.7046,0.7063,0.7045,0.7075
2023-08-28 12:30,757,335,422,75710,33661,42049,53511807.0,23795177.0,29716630.0,715,317,398,72236,31457,40779,50991663.0,22157424.0,28834238.0,0.7069,0.7067,0.7044,0.7071
2023-08-28 12:35,342,251,91,34151,26637,7514,34832949.0,18776920.0,16056029.0,295,229,66,34520,28184,6336,35054504.0,19854581.0,15199922.0,0.7049,2.1368,0.7045,2.399
2023-08-28 12:40,784,540,244,97654,77985,19669,68941200.0,55022529.0,13918671.0,753,522,231,95379,76282,19097,67289134.0,53763493.0,13525641.0,0.7056,0.7076,0.7048,0.7083
2023-08-28 12:45,683,330,353,79133,60002,19131,55719335.0,42318741.0,13400593.0,641,316,325,69896,56406,13490,49238842.0,39688010.0,9550831.0,0.7053,0.7005,0.7036,0.708
2023-08-28 12:50,896,757,139,170663,160123,10540,119970103.0,112535570.0,7434533.0,870,748,122,168481,159518,8963,118320440.0,111992818.0,6327622.0,0.7028,0.7054,0.7021,0.706
2023-08-28 12:55,2673,2199,474,460762,412650,48112,334715289.0,290193296.0,44521992.0,2633,2178,455,458278,411680,46598,333089551.0,289487483.0,43602068.0,0.7032,0.9254,0.7032,0.9357
2023-08-28 13:00,4529,3297,1232,541786,398762,143024,381282742.0,280453972.0,100828770.0,4495,3282,1213,539091,397130,141961,379435025.0,279306316.0,100128709.0,0.7033,0.705,0.7033,0.7053
2023-08-28 13:05,2342,1708,634,233544,168919,64625,164366349.0,118793426.0,45572922.0,2327,1700,627,233875,169295,64580,164603362.0,119059422.0,45543940.0,0.7033,0.7052,0.7033,0.7052
2023-08-28 13:10,1768,878,890,239195,64278,174917,179178277.0,45191376.0,133986901.0,1733,853,880,239842,63186,176656,179706764.0,44421504.0,135285260.0,0.7031,0.766,0.703,0.7658
2023-08-28 13:15,276,173,103,33969,14504,19465,23938168.0,10194506.0,13743661.0,251,162,89,33016,14153,18863,23251451.0,9946447.0,13305004.0,0.7029,0.7061,0.7028,0.7053
2023-08-28 13:20,117,67,50,9102,4004,5098,17173473.0,2846751.0,14326722.0,93,58,35,8141,3954,4187,16435850.0,2785108.0,13650742.0,0.711,2.8103,0.7044,3.2603
2023-08-28 13:25,172,121,51,15336,7559,7777,10805785.0,5317033.0,5488752.0,150,111,39,12738,7363,5375,8971328.0,5175678.0,3795649.0,0.7034,0.7058,0.7029,0.7062
2023-08-28 13:30,530,298,232,32226,20344,11882,22632059.0,14326237.0,8305822.0,505,285,220,28147,17348,10799,19810354.0,12191939.0,7618414.0,0.7042,0.699,0.7028,0.7055
2023-08-28 13:35,240,175,65,24108,15151,8957,16984637.0,10677751.0,6306886.0,218,163,55,24743,14159,10584,17410073.0,9942961.0,7467111.0,0.7048,0.7041,0.7022,0.7055
2023-08-28 13:40,396,131,265,44335,9385,34950,31217412.0,6600277.0,24617135.0,380,128,252,45510,11573,33937,32042219.0,8125329.0,23916889.0,0.7033,0.7044,0.7021,0.7047
2023-08-28 13:45,1067,408,659,145548,45573,99975,113176896.0,32048906.0,81127989.0,1028,388,640,143903,44423,99480,112057831.0,31208136.0,80849694.0,0.7032,0.8115,0.7025,0.8127
2023-08-28 13:50,1061,474,587,125735,37138,88597,88465250.0,26093285.0,62371965.0,1014,447,567,124538,36860,87678,87670200.0,25895893.0,61774306.0,0.7026,0.704,0.7025,0.7046
2023-08-28 13:55,562,455,107,45115,40070,5045,31709487.0,28162517.0,3546970.0,514,427,87,43559,38998,4561,30602746.0,27389558.0,3213188.0,0.7028,0.7031,0.7023,0.7045
2023-08-28 14:00,822,673,149,66480,56704,9776,46764198.0,39949050.0,6815148.0,778,653,125,63421,55213,8208,44574015.0,38789919.0,5784096.0,0.7045,0.6971,0.7026,0.7047
2023-08-28 14:05,1062,580,482,88248,50388,37860,62017150.0,35400194.0,26616955.0,1023,560,463,86587,49805,36782,60898137.0,34976367.0,25921769.0,0.7026,0.703,0.7023,0.7047
2023-08-28 14:10,1121,790,331,147406,117431,29975,103614476.0,82576709.0,21037766.0,1085,775,310,145658,116073,29585,102436948.0,81582083.0,20854864.0,0.7032,0.7018,0.7029,0.7049
2023-08-28 14:15,1148,268,880,185231,29565,155666,130322529.0,20733939.0,109588590.0,1120,260,860,184039,29248,154791,129497731.0,20512461.0,108985270.0,0.7013,0.704,0.7013,0.7041
2023-08-28 14:20,1954,373,1581,340632,43818,296814,250308696.0,30714227.0,219594468.0,1903,346,1557,337167,41884,295283,247927872.0,29362400.0,218565472.0,0.701,0.7398,0.701,0.7402
2023-08-28 14:25,2514,560,1954,404192,31864,372328,295135416.0,22368137.0,272767279.0,2482,542,1940,402959,31112,371847,294233597.0,21808789.0,272424808.0,0.702,0.7326,0.701,0.7326
2023-08-28 14:30,699,158,541,108854,14233,94621,87152370.0,9970435.0,77181934.0,661,130,531,108235,14528,93707,86803981.0,10175986.0,76627994.0,0.7005,0.8157,0.7004,0.8177
2023-08-28 14:35,1051,230,821,90743,21146,69597,63708834.0,14815588.0,48893246.0,1019,208,811,88995,19875,69120,62506051.0,13927383.0,48578667.0,0.7006,0.7025,0.7007,0.7028
2023-08-28 14:40,440,112,328,67449,9427,58022,47422938.0,6673736.0,40749202.0,404,91,313,64687,7976,56711,45510893.0,5598156.0,39912737.0,0.7079,0.7023,0.7019,0.7038
2023-08-28 14:45,851,376,475,84655,29242,55413,70279259.0,20605018.0,49674241.0,806,350,456,82311,26980,55331,68553470.0,18943242.0,49610227.0,0.7046,0.8964,0.7021,0.8966
2023-08-28 14:50,4191,742,3449,694563,45167,649396,539509875.0,31579822.0,507930053.0,3990,617,3373,677262,40214,637048,528770111.0,28143068.0,500627043.0,0.6992,0.7822,0.6998,0.7859
2023-08-28 14:55,7847,1410,6437,1357461,58372,1299089,1110906559.0,40880171.0,1070026388.0,7656,1279,6377,1343211,53152,1290059,1101477530.0,37111803.0,1064365727.0,0.7003,0.8237,0.6982,0.8251
2023-08-28 15:00,2871,1040,1831,392399,45324,347075,296184895.0,31645759.0,264539135.0,2751,958,1793,384485,36027,348458,290710591.0,25121420.0,265589170.0,0.6982,0.7622,0.6973,0.7622
2023-08-28 15:05,2541,777,1764,339984,38126,301858,238052840.0,26581083.0,211471757.0,2480,740,1740,339535,41084,298451,237709757.0,28632179.0,209077577.0,0.6972,0.7006,0.6969,0.7005
2023-08-28 15:10,1462,291,1171,242163,24403,217760,180442312.0,17102289.0,163340023.0,1418,275,1143,236182,21504,214678,176226218.0,15004225.0,161221993.0,0.7008,0.7501,0.6977,0.751
2023-08-28 15:15,4297,3281,1016,768504,666104,102400,624683187.0,467068207.0,157614980.0,4164,3216,948,756024,659933,96091,615627787.0,462546914.0,153080873.0,0.7012,1.5392,0.7009,1.5931
2023-08-28 15:20,4052,2736,1316,620966,511668,109298,514295122.0,361249148.0,153045974.0,3303,2362,941,519432,442629,76803,442228434.0,312382538.0,129845895.0,0.706,1.4003,0.7057,1.6906
2023-08-28 15:25,3116,1447,1669,354645,145483,209162,307289611.0,104407564.0,202882046.0,2421,1207,1214,335781,147974,187807,293413575.0,105039493.0,188374082.0,0.7177,0.97,0.7099,1.003
2023-08-28 15:30,1555,670,885,157098,45005,112093,135369066.0,32102155.0,103266911.0,1331,571,760,130434,36031,94403,114682382.0,25602260.0,89080122.0,0.7133,0.9213,0.7106,0.9436
2023-08-28 15:35,784,473,311,66673,52642,14031,47401196.0,37428768.0,9972427.0,635,418,217,56953,49194,7759,40333403.0,34803058.0,5530344.0,0.711,0.7107,0.7075,0.7128
2023-08-28 15:40,611,519,92,54107,45403,8704,38343133.0,32213321.0,6129811.0,552,489,63,46813,40882,5931,33258279.0,29015411.0,4242867.0,0.7095,0.7043,0.7097,0.7154
2023-08-28 15:45,647,269,378,66839,27550,39289,47520326.0,19549593.0,27970733.0,568,240,328,57335,26170,31165,40723711.0,18534819.0,22188892.0,0.7096,0.7119,0.7082,0.712
2023-08-28 15:50,484,138,346,49422,12287,37135,45739599.0,8666022.0,37073577.0,427,105,322,44660,10586,34074,42475190.0,7445685.0,35029505.0,0.7053,0.9983,0.7034,1.028
2023-08-28 15:55,200,115,85,10455,3774,6681,7289827.0,2689860.0,4599967.0,134,73,61,7381,2500,4881,5239017.0,1768618.0,3470399.0,0.7127,0.6885,0.7074,0.711
2023-08-28 16:00,408,270,138,49311,37507,11804,34995586.0,26604865.0,8390721.0,337,232,105,44360,34830,9530,31376903.0,24598510.0,6778392.0,0.7093,0.7108,0.7062,0.7113
2023-08-28 16:05,786,628,158,97790,86114,11676,80337654.0,61207153.0,19130501.0,724,589,135,93660,82523,11137,77271247.0,58536511.0,18734736.0,0.7108,1.6384,0.7093,1.6822
2023-08-28 16:10,1354,940,414,193359,162809,30550,137329798.0,115631432.0,21698366.0,1286,905,381,190147,161626,28521,135062611.0,114756295.0,20306316.0,0.7102,0.7103,0.71,0.712
2023-08-28 16:15,719,294,425,63917,45260,18657,45297846.0,32085020.0,13212826.0,649,257,392,60097,43607,16490,42616916.0,30875396.0,11741520.0,0.7089,0.7082,0.708,0.712
2023-08-28 16:20,294,224,70,40953,36320,4633,29087766.0,25818394.0,3269372.0,242,190,52,38381,34081,4300,27188345.0,24115981.0,3072363.0,0.7109,0.7057,0.7076,0.7145
2023-08-28 16:25,733,504,229,61811,53597,8214,55428223.0,38761358.0,16666864.0,630,444,186,52330,46061,6269,48097291.0,32780048.0,15317242.0,0.7232,2.0291,0.7117,2.4433
2023-08-28 16:30,1206,1011,195,187367,145392,41975,133691920.0,103751972.0,29939947.0,1069,955,114,152378,140077,12301,108398341.0,99593173.0,8805168.0,0.7136,0.7133,0.711,0.7158
2023-08-28 16:35,4223,1227,2996,679567,95329,584238,591003774.0,67627893.0,523375881.0,4026,1102,2924,689099,90994,598105,598027237.0,64485325.0,533541912.0,0.7094,0.8958,0.7087,0.8921
2023-08-28 16:40,4371,1009,3362,747086,58613,688473,542225994.0,41547235.0,500678759.0,4267,950,3317,740150,50865,689285,537282050.0,35986280.0,501295770.0,0.7088,0.7272,0.7075,0.7273
2023-08-28 16:45,1451,362,1089,172416,22229,150187,133759859.0,15956910.0,117802949.0,1354,321,1033,168470,20401,148069,130886397.0,14488191.0,116398205.0,0.7178,0.7844,0.7102,0.7861
2023-08-28 16:50,1269,344,925,152936,17044,135892,119806458.0,12131402.0,107675056.0,1222,311,911,150948,16605,134343,118423244.0,11787289.0,106635955.0,0.7118,0.7924,0.7099,0.7938
2023-08-28 16:55,689,278,411,93366,11470,81896,66491880.0,8145295.0,58346584.0,639,259,380,90758,10962,79796,64706185.0,7782484.0,56923701.0,0.7101,0.7124,0.71,0.7134
2023-08-28 17:00,2290,489,1801,333742,16837,316905,237352450.0,11960122.0,225392328.0,2271,484,1787,332767,17021,315746,236715585.0,12075735.0,224639849.0,0.7103,0.7112,0.7095,0.7115
2023-08-28 17:05,796,494,302,67461,27756,39705,47961124.0,19723864.0,28237260.0,740,465,275,65475,26223,39252,46580030.0,18622413.0,27957617.0,0.7106,0.7112,0.7102,0.7123
2023-08-28 17:10,1304,233,1071,255910,12707,243203,192872672.0,9018245.0,183854426.0,1258,205,1053,249984,8913,241071,188690092.0,6322707.0,182367384.0,0.7097,0.756,0.7094,0.7565
2023-08-28 17:15,1851,819,1032,280424,120645,159779,231845218.0,85875681.0,145969536.0,1777,788,989,256063,115015,141048,214330999.0,81535747.0,132795252.0,0.7118,0.9136,0.7089,0.9415
2023-08-28 17:20,258,160,98,27697,21789,5908,30567550.0,15541655.0,15025894.0,206,136,70,22215,17426,4789,26564782.0,12361683.0,14203099.0,0.7133,2.5433,0.7094,2.9658
2023-08-28 17:25,101,52,49,7033,3040,3993,4988647.0,2155353.0,2833293.0,87,38,49,9403,5916,3487,6664919.0,4180420.0,2484498.0,0.709,0.7096,0.7066,0.7125
2023-08-28 17:30,171,62,109,14247,6164,8083,10085017.0,4408101.0,5676916.0,121,40,81,11479,4383,7096,8144180.0,3090909.0,5053271.0,0.7151,0.7023,0.7052,0.7121
2023-08-28 17:35,405,189,216,64029,34096,29933,45501723.0,24334294.0,21167428.0,339,160,179,58353,30775,27578,41476856.0,21853436.0,19623419.0,0.7137,0.7072,0.7101,0.7116
2023-08-28 17:40,101,48,53,10505,5583,4922,7445952.0,3961512.0,3484440.0,64,32,32,6411,3024,3387,4553392.0,2140257.0,2413134.0,0.7096,0.7079,0.7078,0.7125
2023-08-28 17:45,88,54,34,9468,6022,3446,6674649.0,4271605.0,2403044.0,68,46,22,8233,5847,2386,5847861.0,4146251.0,1701610.0,0.7093,0.6973,0.7091,0.7132
2023-08-28 17:50,212,121,91,25513,13506,12007,18247957.0,9689703.0,8558253.0,166,94,72,19456,11363,8093,13828018.0,8062033.0,5765985.0,0.7174,0.7128,0.7095,0.7125
2023-08-28 17:55,950,898,52,205099,201100,3999,145724459.0,142885982.0,2838476.0,932,889,43,203457,199865,3592,144508545.0,141948967.0,2559577.0,0.7105,0.7098,0.7102,0.7126
2023-08-28 18:00,3619,1468,2151,644397,245749,398648,489986565.0,174277924.0,315708640.0,3544,1431,2113,635646,242377,393269,483757756.0,171846805.0,311910951.0,0.7092,0.7919,0.709,0.7931
2023-08-28 18:05,6154,2382,3772,928980,316379,612601,702874751.0,224261968.0,478612783.0,6086,2350,3736,925971,314259,611712,700676786.0,222676934.0,477999851.0,0.7088,0.7813,0.7086,0.7814
2023-08-28 18:10,2900,839,2061,377395,100997,276398,268042709.0,71648177.0,196394532.0,2860,810,2050,373175,99116,274059,265026066.0,70212322.0,194813743.0,0.7094,0.7105,0.7084,0.7108
2023-08-28 18:15,1866,938,928,246329,118832,127497,174857921.0,84196716.0,90661205.0,1835,921,914,247279,118851,128428,175524589.0,84188337.0,91336251.0,0.7085,0.7111,0.7084,0.7112
2023-08-28 18:20,956,644,312,124751,111161,13590,88462886.0,78797379.0,9665506.0,931,626,305,122634,109390,13244,86915723.0,77491652.0,9424070.0,0.7089,0.7112,0.7084,0.7116
2023-08-28 18:25,863,639,224,124619,106476,18143,99110563.0,75468726.0,23641837.0,820,619,201,122715,106087,16628,97789546.0,75164062.0,22625484.0,0.7088,1.3031,0.7085,1.3607
2023-08-28 18:30,346,266,80,44846,35342,9504,31804547.0,25062107.0,6742439.0,309,250,59,43023,34922,8101,30503632.0,24734363.0,5769269.0,0.7091,0.7094,0.7083,0.7122
2023-08-28 18:35,398,248,150,43226,28445,14781,30742890.0,20226995.0,10515895.0,354,229,125,40916,26991,13925,29050027.0,19128393.0,9921633.0,0.7111,0.7114,0.7087,0.7125
2023-08-29 10:00,3894,1856,2038,467945,234160,233785,378166056.0,166194474.0,211971582.0,3171,1484,1687,411427,214798,196629,326735223.0,153126297.0,173608926.0,0.7097,0.9067,0.7129,0.8829
2023-08-29 10:05,3038,1674,1364,361252,181493,179759,313835953.0,129058864.0,184777089.0,2782,1549,1233,345826,175190,170636,300903520.0,124548397.0,176355123.0,0.7111,1.0279,0.7109,1.0335
2023-08-29 10:10,7339,4950,2389,894749,734005,160744,861715453.0,527042433.0,334673019.0,6384,4619,1765,829390,707333,122057,814319790.0,507025799.0,307293991.0,0.718,2.082,0.7168,2.5176
2023-08-29 10:15,8991,4733,4258,1100931,572780,528151,964898700.0,411000723.0,553897977.0,8263,4428,3835,1073296,552279,521017,945298516.0,395833635.0,549464880.0,0.7176,1.0487,0.7167,1.0546
2023-08-29 10:20,4533,2874,1659,443816,254804,189012,328752453.0,182089107.0,146663345.0,4252,2716,1536,433265,250197,183068,321143307.0,178724641.0,142418665.0,0.7146,0.7759,0.7143,0.778
2023-08-29 10:25,2788,1766,1022,346353,247078,99275,303868824.0,177534678.0,126334145.0,2324,1519,805,313957,232431,81526,280132544.0,166507116.0,113625427.0,0.7185,1.2726,0.7164,1.3937
2023-08-29 10:30,7298,3825,3473,989038,719017,270021,785386114.0,514615358.0,270770755.0,7043,3695,3348,968688,710083,258605,771148671.0,508093574.0,263055096.0,0.7157,1.0028,0.7155,1.0172
2023-08-29 10:35,3406,2208,1198,514424,411559,102865,380981328.0,295800556.0,85180771.0,3198,2107,1091,487904,398143,89761,361476487.0,285720717.0,75755770.0,0.7187,0.8281,0.7176,0.844
2023-08-29 10:40,2295,2020,275,395908,381976,13932,285005202.0,274970369.0,10034833.0,2162,1951,211,391314,380599,10715,281628338.0,273871259.0,7757079.0,0.7199,0.7203,0.7196,0.7239
2023-08-29 10:45,2998,1521,1477,407946,178108,229838,314945458.0,127774259.0,187171199.0,2824,1418,1406,402694,173131,229563,311584915.0,124294482.0,187290433.0,0.7174,0.8144,0.7179,0.8159
2023-08-29 10:50,1837,544,1293,196678,44615,152063,163554835.0,32110255.0,131444579.0,1722,480,1242,190320,39359,150961,158811738.0,28199190.0,130612548.0,0.7197,0.8644,0.7165,0.8652
2023-08-29 10:55,314,105,209,25018,4830,20188,18069320.0,3482506.0,14586814.0,265,88,177,26857,5080,21777,19367512.0,3629355.0,15738157.0,0.721,0.7225,0.7144,0.7227
2023-08-29 11:00,1045,742,303,102178,77749,24429,84970781.0,56320212.0,28650569.0,917,662,255,93054,70979,22075,78093785.0,51167883.0,26925901.0,0.7244,1.1728,0.7209,1.2197
2023-08-29 11:05,2175,1514,661,271185,205367,65818,195718622.0,148114819.0,47603803.0,2075,1471,604,263883,204983,58900,190420478.0,147825174.0,42595303.0,0.7212,0.7233,0.7212,0.7232
2023-08-29 11:10,2186,1560,626,248835,213287,35548,212239784.0,153783962.0,58455821.0,2082,1511,571,241559,209975,31584,207106842.0,151337452.0,55769389.0,0.721,1.6444,0.7207,1.7657
2023-08-29 11:15,1392,573,819,109743,41635,68108,100663571.0,29996146.0,70667425.0,1297,537,760,109453,45103,64350,100694094.0,32339652.0,68354441.0,0.7205,1.0376,0.717,1.0622
2023-08-29 11:20,2704,1111,1593,377718,166124,211594,293169842.0,119234022.0,173935820.0,2581,1059,1522,363116,156654,206462,283017074.0,112397000.0,170620073.0,0.7177,0.822,0.7175,0.8264
2023-08-29 11:25,3750,2933,817,625883,486225,139658,495246217.0,350660893.0,144585323.0,3600,2872,728,612138,479280,132858,485163023.0,345460295.0,139702728.0,0.7212,1.0353,0.7208,1.0515
2023-08-29 11:30,3629,1580,2049,487814,163145,324669,373025606.0,117193346.0,255832260.0,3484,1509,1975,477696,159862,317834,366068586.0,114835336.0,251233249.0,0.7183,0.788,0.7183,0.7905
2023-08-29 11:35,689,436,253,60470,18947,41523,43568065.0,13651543.0,29916522.0,632,403,229,37884,17685,20199,27284343.0,12719329.0,14565013.0,0.7205,0.7205,0.7192,0.7211
2023-08-29 11:40,3174,1362,1812,400214,167678,232536,309529866.0,120400593.0,189129272.0,2997,1251,1746,416295,164602,251693,321324074.0,118203338.0,203120735.0,0.718,0.8133,0.7181,0.807
2023-08-29 11:45,6701,4557,2144,828286,635386,192900,744761579.0,460957345.0,283804234.0,5235,3681,1554,724149,572297,151852,667564698.0,413501681.0,254063017.0,0.7255,1.4713,0.7225,1.6731
2023-08-29 11:50,4832,2390,2442,637790,306173,331617,599952696.0,224498823.0,375453872.0,4013,1967,2046,581738,280762,300976,558945056.0,204986177.0,353958879.0,0.7332,1.1322,0.7301,1.176
2023-08-29 11:55,5919,3757,2162,1007294,651731,355563,783173655.0,477961527.0,305212127.0,5230,3396,1834,938406,624879,313527,731951783.0,457295646.0,274656137.0,0.7334,0.8584,0.7318,0.876
2023-08-29 12:00,3357,2230,1127,516963,354155,162808,400526414.0,259219689.0,141306725.0,3063,2059,1004,498554,343176,155378,387180313.0,250931102.0,136249210.0,0.7319,0.8679,0.7312,0.8769
2023-08-29 12:05,5228,2881,2347,779038,480291,298747,757760713.0,356587920.0,401172793.0,3738,2231,1507,627651,383946,243705,642423237.0,281879543.0,360543694.0,0.7424,1.3429,0.7342,1.4794
2023-08-29 12:10,5494,2771,2723,804628,391895,412733,709539614.0,290768074.0,418771539.0,4532,2381,2151,727196,358827,368369,652551999.0,265558891.0,386993108.0,0.742,1.0146,0.7401,1.0506
2023-08-29 12:15,4738,2971,1767,575912,357148,218764,458680990.0,263843405.0,194837585.0,4151,2624,1527,552649,342088,210561,441967451.0,252357029.0,189610422.0,0.7388,0.8906,0.7377,0.9005
2023-08-29 12:20,4759,2390,2369,717136,405171,311965,564703541.0,299768449.0,264935092.0,4343,2174,2169,693873,393618,300255,547994534.0,291004048.0,256990486.0,0.7399,0.8492,0.7393,0.8559
2023-08-29 12:25,1887,923,964,188423,72840,115583,161668995.0,53753029.0,107915966.0,1680,811,869,174892,66454,108438,151834724.0,48917032.0,102917691.0,0.738,0.9337,0.7361,0.9491
2023-08-29 12:30,696,440,256,34298,21091,13207,25310927.0,15643478.0,9667448.0,574,393,181,32614,23665,8949,23946887.0,17305795.0,6641091.0,0.7417,0.732,0.7313,0.7421
2023-08-29 12:35,3628,1210,2418,386038,108102,277936,368756940.0,78808732.0,289948208.0,2895,773,2122,326097,78417,247680,327928497.0,57053885.0,270874612.0,0.729,1.0432,0.7276,1.0936
2023-08-29 12:40,4979,3169,1810,717289,576749,140540,617075313.0,423755351.0,193319962.0,4601,3005,1596,689942,560659,129283,596245541.0,411164000.0,185081540.0,0.7347,1.3756,0.7334,1.4316
2023-08-29 12:45,5675,4454,1221,891954,833310,58644,817609466.0,615682760.0,201926706.0,5176,4236,940,855861,816526,39335,789993052.0,602510905.0,187482146.0,0.7388,3.4433,0.7379,4.7663
2023-08-29 12:50,7506,4258,3248,1104236,759597,344639,1064696692.0,568098177.0,496598515.0,6020,3620,2400,978954,692900,286054,971324327.0,516809823.0,454514504.0,0.7479,1.4409,0.7459,1.5889
2023-08-29 12:55,5370,2084,3286,680803,203089,477714,602196473.0,152607047.0,449589426.0,4243,1564,2679,588044,149761,438283,532967708.0,111819363.0,421148344.0,0.7514,0.9411,0.7467,0.9609
2023-08-29 13:00,4772,1583,3189,638265,144741,493524,559080465.0,108965510.0,450114955.0,4365,1398,2967,601640,127369,474271,531611103.0,95268126.0,436342977.0,0.7528,0.912,0.748,0.92
2023-08-29 13:05,3810,1636,2174,502687,206786,295901,465058555.0,154108972.0,310949583.0,3311,1380,1931,453655,183217,270438,429707985.0,136346897.0,293361088.0,0.7453,1.0509,0.7442,1.0848
2023-08-29 13:10,1216,708,508,113976,79298,34678,85061205.0,59180614.0,25880590.0,1008,616,392,97636,71664,25972,72750190.0,53323831.0,19426359.0,0.7463,0.7463,0.7441,0.748
2023-08-29 13:15,1554,729,825,148316,64823,83493,133617061.0,48527913.0,85089148.0,1366,650,716,137199,60783,76416,125210980.0,45300935.0,79910044.0,0.7486,1.0191,0.7453,1.0457
2023-08-29 13:20,2598,1831,767,315017,240445,74572,281535248.0,180131033.0,101404214.0,2386,1727,659,293297,225870,67427,265074389.0,168886681.0,96187708.0,0.7492,1.3598,0.7477,1.4265
2023-08-29 13:25,1264,619,645,102293,56463,45830,87973056.0,42291283.0,45681773.0,1059,524,535,92233,52718,39515,80536930.0,39226656.0,41310274.0,0.749,0.9968,0.7441,1.0454
2023-08-29 13:30,1256,528,728,124410,41127,83283,104838215.0,30934081.0,73904133.0,1092,451,641,119618,40514,79104,101159258.0,30225843.0,70933415.0,0.7522,0.8874,0.7461,0.8967
2023-08-29 13:35,4101,1082,3019,549041,92974,456067,444672713.0,69422390.0,375250322.0,3885,975,2910,525776,87902,437874,427827484.0,65554379.0,362273104.0,0.7467,0.8228,0.7458,0.8273
2023-08-29 13:40,2614,1796,818,333481,224851,108630,260413878.0,167745166.0,92668711.0,2473,1725,748,328583,220828,107755,256903605.0,164685170.0,92218435.0,0.746,0.8531,0.7458,0.8558
2023-08-29 13:45,4422,1357,3065,662825,170368,492457,539301001.0,126940148.0,412360852.0,4183,1218,2965,641913,161290,480623,524226662.0,120134931.0,404091731.0,0.7451,0.8374,0.7448,0.8408
2023-08-29 13:50,3983,862,3121,491258,66042,425216,388870949.0,49092469.0,339778479.0,3836,800,3036,480063,59833,420230,380794694.0,44444180.0,336350514.0,0.7434,0.7991,0.7428,0.8004
2023-08-29 13:55,5668,1478,4190,825837,124176,701661,757948548.0,91710982.0,666237565.0,5175,1160,4015,792038,108288,683750,734267645.0,79844889.0,654422756.0,0.7386,0.9495,0.7373,0.9571
2023-08-29 14:00,5146,2651,2495,635375,253866,381509,558312099.0,187446799.0,370865300.0,4709,2365,2344,606613,231787,374826,536502814.0,170321092.0,366181721.0,0.7384,0.9721,0.7348,0.9769
2023-08-29 14:05,4306,3167,1139,515275,413336,101939,425370740.0,304906762.0,120463978.0,3937,2926,1011,494734,405254,89480,409969943.0,298545520.0,111424423.0,0.7377,1.1817,0.7367,1.2452
2023-08-29 14:10,2237,1531,706,239326,167695,71631,199471960.0,123879896.0,75592063.0,2029,1391,638,229070,163015,66055,191730578.0,120234349.0,71496229.0,0.7387,1.0553,0.7376,1.0824
2023-08-29 14:15,4876,1807,3069,652257,114955,537302,525842518.0,84537395.0,441305123.0,4601,1632,2969,636572,106530,530042,514960225.0,78246085.0,436714140.0,0.7354,0.8213,0.7345,0.8239
2023-08-29 14:20,3048,529,2519,489500,29992,459508,382444688.0,21998472.0,360446215.0,2811,391,2420,468907,17372,451535,368043049.0,12595244.0,355447805.0,0.7335,0.7844,0.725,0.7872
2023-08-29 14:25,2527,697,1830,311536,57109,254427,251983913.0,42154367.0,209829546.0,2359,590,1769,299140,48586,250554,242741015.0,35723560.0,207017455.0,0.7381,0.8247,0.7353,0.8262
2023-08-29 14:30,6347,2531,3816,923029,332546,590483,853316744.0,246598953.0,606717791.0,6151,2437,3714,909118,328684,580434,843016980.0,243255271.0,599761709.0,0.7415,1.0275,0.7401,1.0333
2023-08-29 14:35,4361,2196,2165,517954,340257,177697,521116385.0,252931856.0,268184528.0,4138,2088,2050,499538,331676,167862,507109725.0,246079368.0,261030357.0,0.7434,1.5092,0.7419,1.555
2023-08-29 14:40,1740,944,796,170562,88394,82168,206134357.0,65886795.0,140247561.0,1615,885,730,156037,82179,73858,195716590.0,61135678.0,134580912.0,0.7454,1.7068,0.7439,1.8222
2023-08-29 14:45,2611,913,1698,339868,119464,220404,298686325.0,88931709.0,209754615.0,2530,876,1654,331388,115548,215840,292498322.0,85975682.0,206522640.0,0.7444,0.9517,0.7441,0.9568
2023-08-29 14:50,2325,1778,547,311430,268161,43269,254606893.0,199790171.0,54816722.0,2204,1721,483,301881,263377,38504,247613919.0,196145429.0,51468489.0,0.745,1.2669,0.7447,1.3367
2023-08-29 14:55,1331,952,379,153650,123182,30468,125894412.0,91890673.0,34003739.0,1195,876,319,144701,121670,23031,119293753.0,90680749.0,28613003.0,0.746,1.116,0.7453,1.2424
2023-08-29 15:00,1194,376,818,117549,22809,94740,98621131.0,16909853.0,81711278.0,1114,346,768,112343,23220,89123,94986033.0,17157942.0,77828091.0,0.7414,0.8625,0.7389,0.8733
2023-08-29 15:05,837,664,173,58144,40977,17167,43066689.0,30419426.0,12647263.0,783,653,130,58790,40137,18653,43684308.0,29776870.0,13907438.0,0.7424,0.7367,0.7419,0.7456
2023-08-29 15:10,532,121,411,90848,11890,78958,67821374.0,8901725.0,58919648.0,486,107,379,91721,13698,78023,68339337.0,10086310.0,58253026.0,0.7487,0.7462,0.7363,0.7466
2023-08-29 15:15,2643,1108,1535,436643,121874,314769,402687323.0,89821360.0,312865963.0,2494,1034,1460,425645,114452,311193,394941401.0,84346767.0,310594634.0,0.737,0.994,0.737,0.9981
2023-08-29 15:20,5705,1584,4121,947546,135775,811771,793527132.0,100263877.0,693263255.0,5537,1491,4046,943521,132168,811353,790521686.0,97407307.0,693114379.0,0.7385,0.854,0.737,0.8543
2023-08-29 15:25,5486,1099,4387,958892,60417,898475,776719353.0,44483755.0,732235598.0,5346,1017,4329,941024,52560,888464,764622208.0,38673231.0,725948976.0,0.7363,0.815,0.7358,0.8171
2023-08-29 15:30,7652,3974,3678,1180764,635331,545433,1317174086.0,470577503.0,846596583.0,7368,3833,3535,1160422,623169,537253,1301435054.0,460936248.0,840498805.0,0.7407,1.5522,0.7397,1.5644
2023-08-29 15:35,5888,4291,1597,957131,837787,119344,868168286.0,620780817.0,247387468.0,5712,4209,1503,944980,833982,110998,859119839.0,617885888.0,241233950.0,0.741,2.0729,0.7409,2.1733
2023-08-29 15:40,4166,2993,1173,655947,570603,85344,508068207.0,422103979.0,85964227.0,4052,2945,1107,645331,563993,81338,500355630.0,417230647.0,83124982.0,0.7398,1.0073,0.7398,1.022
2023-08-29 15:45,894,720,174,135162,111332,23830,111068614.0,82238764.0,28829850.0,798,675,123,128719,108728,19991,106368877.0,80309372.0,26059504.0,0.7387,1.2098,0.7386,1.3036
2023-08-29 15:50,3061,972,2089,342290,58303,283987,363729079.0,42712526.0,321016552.0,2728,762,1966,323559,48315,275244,350275828.0,35349563.0,314926265.0,0.7326,1.1304,0.7316,1.1442
2023-08-29 15:55,3124,1628,1496,283400,79424,203976,242461457.0,58268364.0,184193093.0,3057,1596,1461,278984,79779,199205,238863343.0,58465025.0,180398318.0,0.7336,0.903,0.7328,0.9056
2023-08-29 16:00,3528,1671,1857,311446,93241,218205,262568648.0,68389880.0,194178768.0,3396,1597,1799,306462,90099,216363,258918162.0,66018123.0,192900038.0,0.7335,0.8899,0.7327,0.8916
2023-08-29 16:05,1408,500,908,112335,55955,56380,104763934.0,40986735.0,63777198.0,1319,450,869,104909,51093,53816,99191245.0,37220261.0,61970984.0,0.7325,1.1312,0.7285,1.1515
2023-08-29 16:10,2227,650,1577,292203,43977,248226,270624575.0,32231847.0,238392728.0,2089,568,1521,276897,32062,244835,259342527.0,23380269.0,235962258.0,0.7329,0.9604,0.7292,0.9638
2023-08-29 16:15,2693,1389,1304,334404,146651,187753,290978418.0,107761616.0,183216801.0,2548,1307,1241,321004,142543,178461,280905077.0,104601917.0,176303159.0,0.7348,0.9758,0.7338,0.9879
2023-08-29 16:20,1599,864,735,145506,50592,94914,129256955.0,37013330.0,92243624.0,1516,804,712,137816,43033,94783,123728317.0,31516551.0,92211766.0,0.7316,0.9719,0.7324,0.9729
2023-08-29 16:25,1673,638,1035,167546,23729,143817,134439733.0,17391857.0,117047876.0,1589,588,1001,165551,22393,143158,133009772.0,16401492.0,116608279.0,0.7329,0.8139,0.7324,0.8145
2023-08-29 16:30,463,190,273,48100,10579,37521,46545506.0,7780487.0,38765019.0,397,152,245,42506,9983,32523,42355829.0,7240911.0,35114918.0,0.7355,1.0332,0.7253,1.0797
2023-08-29 16:35,593,84,509,86480,5957,80523,74551314.0,4370021.0,70181292.0,558,66,492,92281,10100,82181,78798868.0,7292463.0,71506405.0,0.7336,0.8716,0.722,0.8701
2023-08-29 16:40,2475,691,1784,335768,53256,282512,280920816.0,39213505.0,241707311.0,2357,625,1732,324614,46099,278515,272514400.0,33852450.0,238661950.0,0.7363,0.8556,0.7343,0.8569
2023-08-29 16:45,1709,1175,534,157795,121294,36501,116474371.0,89507466.0,26966905.0,1568,1082,486,149376,118503,30873,110074281.0,87231838.0,22842443.0,0.7379,0.7388,0.7361,0.7399
2023-08-29 16:50,3088,1903,1185,295587,221899,73688,228945073.0,163485727.0,65459346.0,2978,1846,1132,287441,216651,70790,223188183.0,159591169.0,63597013.0,0.7368,0.8883,0.7366,0.8984
2023-08-29 16:55,1599,1108,491,138819,100580,38239,102142518.0,74099477.0,28043040.0,1520,1056,464,134561,98039,36522,99152525.0,72174508.0,26978017.0,0.7367,0.7334,0.7362,0.7387
2023-08-29 17:00,2290,1536,754,224074,135005,89069,187731661.0,99588241.0,88143419.0,2217,1500,717,216772,133626,83146,182330631.0,98473198.0,83857433.0,0.7377,0.9896,0.7369,1.0086
2023-08-29 17:05,1449,823,626,137827,74369,63458,112864168.0,54844057.0,58020111.0,1381,780,601,135501,72092,63409,111166484.0,53117374.0,58049110.0,0.7375,0.9143,0.7368,0.9155
2023-08-29 17:10,1242,417,825,104490,32355,72135,88293774.0,23804990.0,64488784.0,1179,378,801,103587,32348,71239,87611844.0,23737753.0,63874091.0,0.7357,0.894,0.7338,0.8966
2023-08-29 17:15,1292,495,797,107991,44277,63714,79438671.0,32367426.0,47071245.0,1259,475,784,101555,39452,62103,74930719.0,29019861.0,45910857.0,0.731,0.7388,0.7356,0.7393
2023-08-29 17:20,935,566,369,75283,44497,30786,55391771.0,32735561.0,22656210.0,874,531,343,81138,52228,28910,59704065.0,38356767.0,21347298.0,0.7357,0.7359,0.7344,0.7384
2023-08-29 17:25,136,78,58,10322,3014,7308,7586977.0,2219834.0,5367143.0,104,62,42,5801,2226,3575,4277045.0,1636793.0,2640251.0,0.7365,0.7344,0.7353,0.7385
2023-08-29 17:30,226,135,91,24754,16703,8051,29306215.0,12273975.0,17032240.0,198,123,75,21575,16538,5037,27067054.0,12148141.0,14918913.0,0.7348,2.1155,0.7346,2.9619
2023-08-29 17:35,1873,217,1656,241249,35672,205577,177137415.0,26214506.0,150922908.0,1826,192,1634,225985,22810,203175,166332561.0,16744781.0,149587779.0,0.7349,0.7341,0.7341,0.7363
2023-08-29 17:40,1440,107,1333,308440,10850,297590,227067927.0,8006709.0,219061218.0,1386,78,1308,302554,7669,294885,222738674.0,5621709.0,217116965.0,0.7379,0.7361,0.733,0.7363
2023-08-29 17:45,1132,122,1010,235185,6126,229059,173173667.0,4525145.0,168648522.0,1082,91,991,236783,7224,229559,174354417.0,5308645.0,169045771.0,0.7387,0.7363,0.7349,0.7364
2023-08-29 17:50,321,67,254,42587,3069,39518,31391393.0,2269039.0,29122353.0,284,45,239,40967,2485,38482,30221291.0,1824042.0,28397249.0,0.7393,0.7369,0.734,0.7379
2023-08-29 17:55,1667,431,1236,209682,59376,150306,165995772.0,43858175.0,122137596.0,1600,392,1208,208554,59510,149044,165016307.0,43824535.0,121191772.0,0.7387,0.8126,0.7364,0.8131
2023-08-29 18:00,2712,2050,662,335909,281765,54144,316389745.0,208632800.0,107756945.0,2520,1954,566,321302,273765,47537,305122523.0,202289041.0,102833482.0,0.7404,1.9902,0.7389,2.1632
2023-08-29 18:05,3830,2958,872,440679,378272,62407,520722423.0,282053797.0,238668626.0,3515,2796,719,413049,362481,50568,499598389.0,269382410.0,230215978.0,0.7456,3.8244,0.7432,4.5526
2023-08-29 18:10,2159,1694,465,249816,212046,37770,208676603.0,158071943.0,50604659.0,1900,1569,331,225760,202171,23589,190592294.0,150351332.0,40240962.0,0.7455,1.3398,0.7437,1.7059
2023-08-29 18:15,1194,754,440,120847,66978,53869,135065444.0,49767550.0,85297893.0,1089,702,387,108108,60589,47519,125682763.0,44949097.0,80733665.0,0.743,1.5834,0.7419,1.699
2023-08-29 18:20,1966,1738,228,286930,272667,14263,236267148.0,202956185.0,33310962.0,1843,1693,150,278634,267374,11260,230010235.0,198895535.0,31114700.0,0.7443,2.3355,0.7439,2.7633
2023-08-29 18:25,1513,814,699,132454,101960,30494,98743350.0,75994543.0,22748807.0,1379,750,629,123040,98807,24233,91770943.0,73617735.0,18153208.0,0.7453,0.746,0.7451,0.7491
2023-08-29 18:30,1315,725,590,148469,68636,79833,144129988.0,51006408.0,93123579.0,1214,678,536,132973,63778,69195,132948175.0,47345680.0,85602495.0,0.7431,1.1665,0.7424,1.2371
2023-08-29 18:35,2599,1453,1146,272460,130414,142046,225087723.0,96899455.0,128188268.0,2472,1369,1103,268129,125478,142651,222129740.0,93152075.0,128977665.0,0.743,0.9024,0.7424,0.9041
2023-08-30 10:00,9862,5476,4386,1165673,757017,408656,1662276011.0,575222769.0,1087053242.0,6691,4364,2327,909028,635736,273292,1455042624.0,480421046.0,974621578.0,0.7599,2.6601,0.7557,3.5662
2023-08-30 10:05,5435,3034,2401,584393,332536,251857,652344186.0,253854424.0,398489761.0,4282,2471,1811,488704,284604,204100,580682976.0,216068332.0,364614644.0,0.7634,1.5822,0.7592,1.7865
2023-08-30 10:10,3573,1142,2431,354887,69821,285066,303858854.0,53017390.0,250841464.0,2824,754,2070,325907,50838,275069,282687661.0,38506147.0,244181514.0,0.7593,0.8799,0.7574,0.8877
2023-08-30 10:15,2112,1004,1108,144598,55755,88843,135338531.0,42368269.0,92970261.0,1585,761,824,132853,51707,81146,119409835.0,39063224.0,80346610.0,0.7599,1.0465,0.7555,0.9901
2023-08-30 10:20,2154,914,1240,160775,52733,108042,121869245.0,40073154.0,81796091.0,1806,747,1059,147715,47277,100438,111995251.0,35721215.0,76274036.0,0.7599,0.7571,0.7556,0.7594
2023-08-30 10:25,998,589,409,59391,34793,24598,56568155.0,26521408.0,30046747.0,678,371,307,46377,27803,18574,46599799.0,20951261.0,25648538.0,0.7623,1.2215,0.7536,1.3809
2023-08-30 10:30,1299,606,693,84038,40137,43901,86860816.0,30551031.0,56309785.0,1048,517,531,64762,30722,34040,72087520.0,23211316.0,48876204.0,0.7612,1.2827,0.7555,1.4358
2023-08-30 10:35,1547,736,811,123289,42251,81038,149417155.0,31742482.0,117674672.0,1203,537,666,102263,35410,66853,134509198.0,26632645.0,107876552.0,0.7513,1.4521,0.7521,1.6136
2023-08-30 10:40,1743,1238,505,156880,107871,49009,175458388.0,81394554.0,94063834.0,1384,1013,371,150269,98407,51862,177477247.0,73970522.0,103506725.0,0.7546,1.9193,0.7517,1.9958
2023-08-30 10:45,732,404,328,71710,39809,31901,65376929.0,29924691.0,35452238.0,613,344,269,62318,35108,27210,58536761.0,26392025.0,32144735.0,0.7517,1.1113,0.7517,1.1814
2023-08-30 10:50,915,377,538,76950,30775,46175,68884440.0,23142220.0,45742220.0,770,290,480,66208,23358,42850,61414887.0,17551449.0,43863438.0,0.752,0.9906,0.7514,1.0237
2023-08-30 10:55,2081,1193,888,243060,157348,85712,358271161.0,119777151.0,238494009.0,1850,1077,773,217186,142568,74618,337386667.0,107498057.0,229888610.0,0.7612,2.7825,0.754,3.0809
2023-08-30 11:00,2832,1985,847,305707,237271,68436,278291926.0,180115877.0,98176049.0,2554,1879,675,292714,232921,59793,268340095.0,176413925.0,91926170.0,0.7591,1.4346,0.7574,1.5374
2023-08-30 11:05,1949,556,1393,184740,33887,150853,162802773.0,25541469.0,137261304.0,1804,486,1318,171513,28937,142576,152854198.0,21808237.0,131045961.0,0.7537,0.9099,0.7536,0.9191
2023-08-30 11:10,1161,275,886,98654,21453,77201,85601137.0,16179856.0,69421281.0,1041,238,803,89733,19900,69833,79245890.0,14942052.0,64303837.0,0.7542,0.8992,0.7509,0.9208
2023-08-30 11:15,1933,906,1027,191239,56811,134428,189105633.0,42543327.0,146562306.0,1599,717,882,167620,44391,123229,171946886.0,33239273.0,138707613.0,0.7489,1.0903,0.7488,1.1256
2023-08-30 11:20,1576,1096,480,138105,78757,59348,160260541.0,58950251.0,101310290.0,1324,960,364,127748,71933,55815,152681544.0,53751507.0,98930037.0,0.7485,1.7071,0.7472,1.7725
2023-08-30 11:25,1508,978,530,148717,92147,56570,134133458.0,68872669.0,65260788.0,1338,873,465,130958,85650,45308,120859567.0,64003080.0,56856486.0,0.7474,1.1536,0.7473,1.2549
2023-08-30 11:30,2311,1580,731,250437,150300,100137,210911246.0,112780139.0,98131107.0,2180,1501,679,238776,143087,95689,202044099.0,107190941.0,94853157.0,0.7504,0.98,0.7491,0.9913
2023-08-30 11:35,2012,1182,830,178534,102683,75851,145681799.0,77171483.0,68510315.0,1916,1130,786,173268,98199,75069,141638701.0,73733937.0,67904764.0,0.7516,0.9032,0.7509,0.9046
2023-08-30 11:40,2128,1354,774,186533,120532,66001,151825235.0,90710373.0,61114861.0,2028,1311,717,186372,118087,68285,151723089.0,88755853.0,62967236.0,0.7526,0.926,0.7516,0.9221
2023-08-30 11:45,1589,440,1149,191498,19775,171723,155429218.0,14848632.0,140580585.0,1545,423,1122,188096,20365,167731,153110085.0,15284593.0,137825492.0,0.7509,0.8186,0.7505,0.8217
2023-08-30 11:50,912,374,538,98968,16796,82172,74460272.0,12632466.0,61827806.0,860,344,516,94164,14066,80098,70917561.0,10547370.0,60370191.0,0.7521,0.7524,0.7498,0.7537
2023-08-30 11:55,292,142,150,25872,7176,18696,19481433.0,5390102.0,14091331.0,243,116,127,24724,7465,17259,18629390.0,5589892.0,13039498.0,0.7511,0.7537,0.7488,0.7555
2023-08-30 12:00,1768,1091,677,180149,132639,47510,170238521.0,99944561.0,70293959.0,1692,1054,638,172364,126449,45915,164248514.0,95191428.0,69057086.0,0.7535,1.4796,0.7528,1.504
2023-08-30 12:05,1540,969,571,144449,110265,34184,108804364.0,83036292.0,25768072.0,1467,936,531,140795,108738,32057,106056093.0,81839967.0,24216125.0,0.7531,0.7538,0.7526,0.7554
2023-08-30 12:10,1271,655,616,113814,64253,49561,85891353.0,48384085.0,37507268.0,1209,624,585,112285,67882,44403,84605987.0,51045314.0,33560673.0,0.753,0.7568,0.752,0.7558
2023-08-30 12:15,1338,544,794,126663,77086,49577,118437938.0,57970492.0,60467445.0,1257,506,751,118913,74534,44379,112649820.0,56075105.0,56574715.0,0.752,1.2197,0.7523,1.2748
2023-08-30 12:20,336,212,124,34351,27807,6544,25901353.0,20952747.0,4948605.0,306,195,111,34284,27504,6780,25836425.0,20697543.0,5138882.0,0.7535,0.7562,0.7525,0.7579
2023-08-30 12:25,1144,696,448,89075,62399,26676,78901365.0,47203866.0,31697499.0,1033,650,383,82750,58896,23854,73912233.0,44358266.0,29553967.0,0.7565,1.1882,0.7532,1.239
2023-08-30 12:30,257,129,128,20655,12077,8578,15583139.0,9147061.0,6436078.0,194,92,102,17610,10800,6810,13302465.0,8124956.0,5177508.0,0.7574,0.7503,0.7523,0.7603
2023-08-30 12:35,371,181,190,30885,17758,13127,23325245.0,13373389.0,9951856.0,315,159,156,26665,18120,8545,20115094.0,13637768.0,6477326.0,0.7531,0.7581,0.7526,0.758
2023-08-30 12:40,946,320,626,71938,23893,48045,54397736.0,18033294.0,36364441.0,896,288,608,71757,24504,47253,54245973.0,18472988.0,35772984.0,0.7548,0.7569,0.7539,0.7571
2023-08-30 12:45,893,582,311,93544,41568,51976,70738700.0,31359707.0,39378993.0,851,559,292,91320,40740,50580,68997078.0,30701074.0,38296004.0,0.7544,0.7576,0.7536,0.7571
2023-08-30 12:50,843,611,232,59640,44754,14886,45129841.0,33892119.0,11237722.0,771,576,195,51915,40334,11581,39258768.0,30458836.0,8799932.0,0.7573,0.7549,0.7552,0.7599
2023-08-30 12:55,560,399,161,26993,18866,8127,20373565.0,14274458.0,6099107.0,503,364,139,25575,17810,7765,19374912.0,13473842.0,5901070.0,0.7566,0.7505,0.7565,0.76
2023-08-30 13:00,965,254,711,73851,25299,48552,78918207.0,19395745.0,59522462.0,868,188,680,65645,20169,45476,72753253.0,15222876.0,57530376.0,0.7667,1.226,0.7548,1.2651
2023-08-30 13:05,2577,1117,1460,242664,92672,149992,183568246.0,70069140.0,113499106.0,2498,1078,1420,237279,90168,147111,179576393.0,68095138.0,111481254.0,0.7561,0.7567,0.7552,0.7578
2023-08-30 13:10,1902,292,1610,260344,23326,237018,208460679.0,17552317.0,190908362.0,1859,269,1590,258897,22610,236287,207461781.0,17039488.0,190422293.0,0.7525,0.8055,0.7536,0.8059
2023-08-30 13:15,2113,184,1929,249882,13089,236793,189024720.0,9839210.0,179185510.0,2071,171,1900,247758,12807,234951,187449490.0,9630729.0,177818761.0,0.7517,0.7567,0.752,0.7568
2023-08-30 13:20,3790,573,3217,454565,30481,424084,411315667.0,22889905.0,388425761.0,3682,517,3165,451035,28677,422358,409099309.0,21528235.0,387571073.0,0.751,0.9159,0.7507,0.9176
2023-08-30 13:25,2536,426,2110,259889,10255,249634,207182008.0,7701758.0,199480250.0,2466,381,2085,256732,8641,248091,204879301.0,6480779.0,198398522.0,0.751,0.7991,0.75,0.7997
2023-08-30 13:30,2214,249,1965,278723,6833,271890,210472814.0,5136957.0,205335857.0,2161,215,1946,271775,3728,268047,204915202.0,2796441.0,202118760.0,0.7518,0.7552,0.7501,0.754
2023-08-30 13:35,1921,375,1546,218028,4115,213913,164473650.0,3092242.0,161381408.0,1879,352,1527,216011,2740,213271,162997955.0,2053797.0,160944158.0,0.7515,0.7544,0.7496,0.7546
2023-08-30 13:40,2054,660,1394,227525,26187,201338,194573824.0,19739968.0,174833856.0,1996,631,1365,225672,26294,199378,193225136.0,19740543.0,173484593.0,0.7538,0.8684,0.7508,0.8701
2023-08-30 13:45,1745,926,819,149777,36624,113153,135784209.0,27572886.0,108211322.0,1680,888,792,147154,34899,112255,133797434.0,26214171.0,107583262.0,0.7529,0.9563,0.7511,0.9584
2023-08-30 13:50,2871,1039,1832,273621,33096,240525,252128481.0,24875019.0,227253462.0,2825,1013,1812,270973,32553,238420,250132117.0,24431092.0,225701025.0,0.7516,0.9448,0.7505,0.9467
2023-08-30 13:55,1367,337,1030,134301,5799,128502,101073352.0,4349250.0,96724102.0,1297,303,994,134744,3756,130988,101916199.0,2814565.0,99101634.0,0.75,0.7527,0.7494,0.7566
2023-08-30 14:00,1222,92,1130,155639,2423,153216,117479494.0,1854688.0,115624806.0,1171,61,1110,150640,1723,148917,113632210.0,1291620.0,112340589.0,0.7655,0.7547,0.7496,0.7544
2023-08-30 14:05,1748,155,1593,244407,2117,242290,184245115.0,1552128.0,182692986.0,1700,122,1578,242979,1200,241779,183213916.0,897926.0,182315990.0,0.7332,0.754,0.7483,0.7541
2023-08-30 14:10,1402,307,1095,169643,10293,159350,127852674.0,7742333.0,120110340.0,1361,281,1080,169127,9988,159139,127467730.0,7499728.0,119968002.0,0.7522,0.7538,0.7509,0.7539
2023-08-30 14:15,1691,520,1171,218186,33383,184803,164315561.0,25006288.0,139309272.0,1656,505,1151,216354,32460,183894,163050834.0,24356432.0,138694401.0,0.7491,0.7538,0.7504,0.7542
2023-08-30 14:20,587,454,133,34987,17114,17873,26282139.0,12856359.0,13425780.0,551,426,125,33667,16615,17052,25324684.0,12469894.0,12854790.0,0.7512,0.7512,0.7505,0.7539
2023-08-30 14:25,733,154,579,95843,6343,89500,72082720.0,4603678.0,67479042.0,710,138,572,94553,4931,89622,71306394.0,3701746.0,67604647.0,0.7258,0.754,0.7507,0.7543
2023-08-30 14:30,2681,1142,1539,282476,62084,220392,246979823.0,46668130.0,200311693.0,2589,1089,1500,272627,59558,213069,239648234.0,44729254.0,194918980.0,0.7517,0.9089,0.751,0.9148
2023-08-30 14:35,2277,1185,1092,248965,131138,117827,198840895.0,98667012.0,100173882.0,2217,1159,1058,246113,129456,116657,196661533.0,97271364.0,99390168.0,0.7524,0.8502,0.7514,0.852
2023-08-30 14:40,1651,284,1367,220868,24699,196169,177965871.0,18572636.0,159393235.0,1604,257,1347,219824,24005,195819,177134058.0,18019304.0,159114753.0,0.752,0.8125,0.7506,0.8126
2023-08-30 14:45,1096,290,806,141542,20771,120771,118043476.0,15607000.0,102436475.0,1024,248,776,132616,18218,114398,111384253.0,13668762.0,97715491.0,0.7514,0.8482,0.7503,0.8542
2023-08-30 14:50,2566,531,2035,293026,19245,273781,231925976.0,14470519.0,217455457.0,2492,479,2013,291383,17178,274205,230692725.0,12872038.0,217820687.0,0.7519,0.7943,0.7493,0.7944
2023-08-30 14:55,1875,473,1402,203484,14868,188616,175901912.0,11150216.0,164751696.0,1844,455,1389,204188,14356,189832,176547213.0,10767399.0,165779814.0,0.7499,0.8735,0.75,0.8733
2023-08-30 15:00,2397,369,2028,305792,22127,283665,230322159.0,16632167.0,213689991.0,2371,355,2016,305306,21958,283348,229907159.0,16451327.0,213455831.0,0.7517,0.7533,0.7492,0.7533
2023-08-30 15:05,1689,227,1462,195268,6598,188670,146861507.0,4936521.0,141924985.0,1648,205,1443,192239,5110,187129,144696811.0,3831265.0,140865546.0,0.7482,0.7522,0.7498,0.7528
2023-08-30 15:10,1125,303,822,116926,6760,110166,99316579.0,5077076.0,94239502.0,1086,280,806,115994,6188,109806,98631468.0,4629614.0,94001854.0,0.751,0.8554,0.7482,0.8561
2023-08-30 15:15,1003,344,659,74619,10854,63765,56107031.0,8144054.0,47962977.0,964,328,636,70692,9024,61668,53137313.0,6763135.0,46374177.0,0.7503,0.7522,0.7495,0.752
2023-08-30 15:20,711,152,559,54573,6673,47900,41034812.0,5036757.0,35998054.0,673,129,544,53207,5916,47291,39836908.0,4274798.0,35562109.0,0.7548,0.7515,0.7226,0.752
2023-08-30 15:25,1100,512,588,75127,43679,31448,67854874.0,32785637.0,35069237.0,1057,489,568,71877,41427,30450,65408438.0,31092244.0,34316194.0,0.7506,1.1152,0.7505,1.127
2023-08-30 15:30,733,347,386,50134,32833,17301,37625392.0,24648456.0,12976936.0,693,332,361,46796,30789,16007,35149150.0,23101905.0,12047245.0,0.7507,0.7501,0.7503,0.7526
2023-08-30 15:35,630,265,365,58622,23437,35185,44146045.0,17613508.0,26532536.0,593,246,347,58904,23524,35380,44341817.0,17656650.0,26685167.0,0.7515,0.7541,0.7506,0.7542
2023-08-30 15:40,849,427,422,61986,23290,38696,69714737.0,17572360.0,52142376.0,781,389,392,56554,20326,36228,65523241.0,15290709.0,50232532.0,0.7545,1.3475,0.7523,1.3866
2023-08-30 15:45,502,158,344,20843,5248,15595,15730466.0,3955581.0,11774884.0,476,144,332,20529,5289,15240,15488130.0,3979626.0,11508504.0,0.7537,0.755,0.7524,0.7552
2023-08-30 15:50,872,512,360,55292,29000,26292,41646780.0,21883480.0,19763300.0,823,487,336,53921,28296,25625,40697651.0,21319254.0,19378396.0,0.7546,0.7517,0.7534,0.7562
2023-08-30 15:55,3287,1827,1460,319244,183430,135814,263128139.0,138042302.0,125085837.0,3193,1776,1417,311814,180149,131665,257681193.0,135413448.0,122267745.0,0.7526,0.921,0.7517,0.9286
2023-08-30 16:00,4130,1994,2136,378869,139216,239653,285268422.0,104576837.0,180691584.0,4062,1954,2108,374458,137156,237302,281965812.0,103019496.0,178946316.0,0.7512,0.754,0.7511,0.7541
2023-08-30 16:05,1621,278,1343,178520,9249,169271,145773911.0,6944680.0,138829231.0,1569,243,1326,176257,8489,167768,144139333.0,6360449.0,137778883.0,0.7509,0.8202,0.7493,0.8212
2023-08-30 16:10,1061,289,772,119708,15487,104221,124268131.0,11635587.0,112632543.0,992,262,730,115131,13177,101954,120900067.0,9866068.0,111033998.0,0.7513,1.0807,0.7487,1.0891
2023-08-30 16:15,1022,426,596,86031,21541,64490,64647243.0,16154634.0,48492609.0,984,400,584,85662,21473,64189,64397293.0,16090134.0,48307158.0,0.7499,0.7519,0.7493,0.7526
2023-08-30 16:20,1589,742,847,118887,35913,82974,89313837.0,26914370.0,62399467.0,1535,713,822,117305,35022,82283,88149922.0,26238630.0,61911292.0,0.7494,0.752,0.7492,0.7524
2023-08-30 16:25,1873,548,1325,238924,29240,209684,179677049.0,21927407.0,157749642.0,1827,520,1307,235209,27186,208023,176891501.0,20371012.0,156520489.0,0.7499,0.7523,0.7493,0.7524
2023-08-30 16:30,2410,398,2012,293826,11264,282562,220978454.0,8444697.0,212533756.0,2378,378,2000,293175,11064,282111,220498953.0,8288822.0,212210131.0,0.7497,0.7522,0.7492,0.7522
2023-08-30 16:35,2424,454,1970,271238,14500,256738,203946402.0,10770159.0,193176242.0,2370,423,1947,268546,13019,255527,202078097.0,9750109.0,192327988.0,0.7428,0.7524,0.7489,0.7527
2023-08-30 16:40,1322,241,1081,159089,12362,146727,142679935.0,9311723.0,133368211.0,1231,200,1031,139390,9781,129609,127629400.0,7306492.0,120322907.0,0.7533,0.909,0.747,0.9284
2023-08-30 16:45,1954,689,1265,165925,34269,131656,157983807.0,25562118.0,132421689.0,1746,580,1166,160967,32031,128936,154422239.0,23816382.0,130605857.0,0.7459,1.0058,0.7435,1.013
2023-08-30 16:50,2773,681,2092,342825,30099,312726,279562322.0,22541899.0,257020423.0,2681,644,2037,338789,28679,310110,276365884.0,21273174.0,255092710.0,0.7489,0.8219,0.7418,0.8226
2023-08-30 16:55,3288,697,2591,424020,26738,397282,317087422.0,19903627.0,297183794.0,3236,671,2565,422297,25779,396518,315874249.0,19188190.0,296686059.0,0.7444,0.748,0.7443,0.7482
2023-08-30 17:00,4230,1079,3151,546806,46656,500150,497371120.0,34611307.0,462759813.0,3921,895,3026,532133,41313,490820,487178949.0,30626198.0,456552750.0,0.7418,0.9252,0.7413,0.9302
2023-08-30 17:05,2992,1197,1795,354083,53163,300920,298454421.0,39703575.0,258750846.0,2900,1149,1751,343665,45690,297975,290427264.0,33939226.0,256488038.0,0.7468,0.8599,0.7428,0.8608
2023-08-30 17:10,3653,969,2684,414551,56708,357843,353368562.0,42113591.0,311254970.0,3541,907,2634,397767,51060,346707,341653238.0,37915497.0,303737741.0,0.7426,0.8698,0.7426,0.8761
2023-08-30 17:15,2970,981,1989,284600,48799,235801,289413722.0,36154566.0,253259156.0,2682,763,1919,280117,41479,238638,286624916.0,30601546.0,256023369.0,0.7409,1.074,0.7378,1.0729
2023-08-30 17:20,3349,1001,2348,287101,67841,219260,302715712.0,50298374.0,252417338.0,3236,931,2305,279419,63826,215593,297026272.0,47136049.0,249890223.0,0.7414,1.1512,0.7385,1.1591
2023-08-30 17:25,1549,354,1195,175724,34209,141515,152515032.0,25275851.0,127239180.0,1464,307,1157,169914,31148,138766,148425765.0,22988645.0,125437120.0,0.7389,0.8991,0.738,0.9039
2023-08-30 17:30,1814,498,1316,196551,54096,142455,168514184.0,40060044.0,128454139.0,1746,453,1293,194904,53810,141094,167220193.0,39705338.0,127514855.0,0.7405,0.9017,0.7379,0.9038
2023-08-30 17:35,1430,456,974,117445,32516,84929,109126387.0,23968883.0,85157503.0,1287,369,918,111836,30210,81626,105158090.0,22227646.0,82930444.0,0.7371,1.0027,0.7358,1.016
2023-08-30 17:40,1751,651,1100,140135,79639,60496,125764593.0,58644415.0,67120178.0,1674,608,1066,138125,78312,59813,124234403.0,57604161.0,66630241.0,0.7364,1.1095,0.7356,1.114
2023-08-30 17:45,1772,368,1404,124267,23480,100787,103269694.0,17318994.0,85950700.0,1704,325,1379,124092,22138,101954,103106515.0,16287110.0,86819404.0,0.7376,0.8528,0.7357,0.8516
2023-08-30 17:50,1720,584,1136,145954,26362,119592,119360196.0,19490019.0,99870176.0,1669,557,1112,146532,29826,116706,119465186.0,21767373.0,97697812.0,0.7393,0.8351,0.7298,0.8371
2023-08-30 17:55,730,464,266,38979,16377,22602,28825309.0,12111791.0,16713518.0,681,441,240,37368,15595,21773,27637499.0,11499624.0,16137874.0,0.7396,0.7395,0.7374,0.7412
2023-08-30 18:00,624,416,208,25389,9890,15499,29903521.0,7281847.0,22621674.0,566,378,188,22536,8020,14516,27907399.0,5902573.0,22004825.0,0.7363,1.4596,0.736,1.5159
2023-08-30 18:05,710,502,208,35459,18107,17352,37500290.0,13379555.0,24120735.0,654,467,187,32462,16358,16104,35223830.0,12057313.0,23166516.0,0.7389,1.3901,0.7371,1.4386
2023-08-30 18:10,705,475,230,40524,26731,13793,29999118.0,19760749.0,10238368.0,665,445,220,39896,26497,13399,29533162.0,19573176.0,9959986.0,0.7392,0.7423,0.7387,0.7433
2023-08-30 18:15,724,494,230,38760,22362,16398,40004299.0,16598878.0,23405421.0,651,446,205,34607,19145,15462,36937576.0,14176639.0,22760936.0,0.7423,1.4273,0.7405,1.4721
2023-08-30 18:20,477,265,212,30656,13509,17147,34138828.0,10073403.0,24065425.0,417,233,184,29442,13122,16320,33140474.0,9708679.0,23431794.0,0.7457,1.4035,0.7399,1.4358
2023-08-30 18:25,1268,691,577,89752,52956,36796,78281577.0,39505985.0,38775592.0,1161,634,527,85286,52401,32885,74602647.0,38751042.0,35851604.0,0.746,1.0538,0.7395,1.0902
2023-08-30 18:30,3110,1702,1408,360017,186994,173023,291403938.0,139582045.0,151821893.0,3019,1662,1357,351497,183627,167870,285132436.0,136886197.0,148246239.0,0.7465,0.8775,0.7455,0.8831
2023-08-30 18:35,2205,508,1697,260043,29718,230325,194164697.0,22157073.0,172007623.0,2185,492,1693,261888,29781,232107,195542423.0,22153234.0,173389189.0,0.7456,0.7468,0.7439,0.747
2023-08-31 10:00,4888,1526,3362,540650,94993,445657,948030682.0,69977868.0,878052814.0,4334,1195,3139,504157,74538,429619,910489172.0,55511778.0,854977394.0,0.7367,1.9702,0.7447,1.9901
2023-08-31 10:05,2760,1538,1222,196710,98312,98398,181512190.0,73454048.0,108058142.0,2549,1449,1100,192903,99620,93283,178417398.0,74202019.0,104215379.0,0.7472,1.0982,0.7449,1.1172
2023-08-31 10:10,3279,1115,2164,266444,53508,212936,267027282.0,39902973.0,227124309.0,3098,1032,2066,257285,50117,207168,260432097.0,37309090.0,223123006.0,0.7457,1.0666,0.7444,1.077
2023-08-31 10:15,4786,1739,3047,450941,88897,362044,539003374.0,67844241.0,471159132.0,4246,1400,2846,426115,76308,349807,520739063.0,57698543.0,463040520.0,0.7632,1.3014,0.7561,1.3237
2023-08-31 10:20,2815,2061,754,300965,244507,56458,312938411.0,180608079.0,132330332.0,2538,1914,624,288345,236189,52156,303439695.0,174419171.0,129020524.0,0.7387,2.3439,0.7385,2.4737
2023-08-31 10:25,872,418,454,40860,26409,14451,41684780.0,19560482.0,22124298.0,752,362,390,36030,23344,12686,38062956.0,17267638.0,20795318.0,0.7407,1.531,0.7397,1.6392
2023-08-31 10:30,526,230,296,28225,15211,13014,55181463.0,11356818.0,43824645.0,397,179,218,24314,14520,9794,52201335.0,10775499.0,41425835.0,0.7466,3.3675,0.7421,4.2297
2023-08-31 10:35,1135,510,625,96864,30525,66339,83429142.0,22713869.0,60715273.0,1050,473,577,92710,30097,62613,80550654.0,22388052.0,58162601.0,0.7441,0.9152,0.7439,0.9289
2023-08-31 10:40,2181,1441,740,200457,171521,28936,207096400.0,128332644.0,78763756.0,2019,1354,665,188836,165293,23543,197793338.0,123283549.0,74509789.0,0.7482,2.722,0.7458,3.1648
2023-08-31 10:45,1972,1241,731,151228,120011,31217,159125496.0,89911216.0,69214280.0,1810,1182,628,136084,117645,18439,147532107.0,88011126.0,59520981.0,0.7492,2.2172,0.7481,3.228
2023-08-31 10:50,4581,3157,1424,521204,448663,72541,543716407.0,339404160.0,204312246.0,3726,2809,917,449107,403663,45444,487175407.0,303588003.0,183587403.0,0.7565,2.8165,0.7521,4.0399
2023-08-31 10:55,7905,4244,3661,835253,484255,350998,1119004398.0,372493173.0,746511224.0,6195,3482,2713,718979,429505,289474,1029403509.0,328148271.0,701255237.0,0.7692,2.1268,0.764,2.4225
2023-08-31 11:00,4846,3218,1628,548584,404319,144265,562937260.0,312275446.0,250661813.0,4083,2823,1260,477985,360513,117472,506497817.0,276159326.0,230338491.0,0.7723,1.7375,0.766,1.9608
2023-08-31 11:05,3348,1349,1999,322728,107948,214780,363542970.0,82630865.0,280912105.0,2865,1111,1754,294748,99949,194799,343146767.0,76417547.0,266729219.0,0.7655,1.3079,0.7646,1.3693
2023-08-31 11:10,2767,1038,1729,262026,59011,203015,291011983.0,44873483.0,246138500.0,2339,811,1528,231762,48701,183061,269057918.0,36716974.0,232340943.0,0.7604,1.2124,0.7539,1.2692
2023-08-31 11:15,2441,951,1490,205209,60262,144947,179564563.0,45906454.0,133658109.0,2257,860,1397,188895,53214,135681,166780429.0,40300537.0,126479892.0,0.7618,0.9221,0.7573,0.9322
2023-08-31 11:20,2317,949,1368,254491,136083,118408,217086582.0,103553331.0,113533251.0,2142,861,1281,244271,131998,112273,208922499.0,100136729.0,108785770.0,0.761,0.9588,0.7586,0.9689
2023-08-31 11:25,2898,1228,1670,278166,121609,156557,269158291.0,92162031.0,176996260.0,2728,1123,1605,266328,116165,150163,260368815.0,88018061.0,172350754.0,0.7579,1.1306,0.7577,1.1478
2023-08-31 11:30,3881,822,3059,478235,53306,424929,410042517.0,40350853.0,369691664.0,3748,739,3009,471942,49516,422426,405272779.0,37430212.0,367842567.0,0.757,0.87,0.7559,0.8708
2023-08-31 11:35,3315,1082,2233,358058,92495,265563,340145328.0,69900798.0,270244529.0,3098,965,2133,347354,88111,259243,332589409.0,66517702.0,266071707.0,0.7557,1.0176,0.7549,1.0263
2023-08-31 11:40,3837,2500,1337,378698,246307,132391,308656779.0,185582672.0,123074107.0,3661,2385,1276,374924,244146,130778,306039721.0,183939498.0,122100223.0,0.7535,0.9296,0.7534,0.9336
2023-08-31 11:45,2520,1607,913,220372,128982,91390,177896483.0,97138250.0,80758232.0,2407,1531,876,214178,126330,87848,173244883.0,95137632.0,78107251.0,0.7531,0.8837,0.7531,0.8891
2023-08-31 11:50,1496,1011,485,118901,55207,63694,101266281.0,41584922.0,59681359.0,1365,946,419,109719,51759,57960,94362052.0,38963962.0,55398090.0,0.7533,0.937,0.7528,0.9558
2023-08-31 11:55,2689,1026,1663,285879,47074,238805,261327580.0,35397818.0,225929761.0,2530,897,1633,280848,45236,235612,257630685.0,34015476.0,223615209.0,0.752,0.9461,0.752,0.9491
2023-08-31 12:00,4308,2716,1592,384521,228435,156086,360025255.0,172673489.0,187351766.0,4103,2600,1503,376331,222821,153510,353519550.0,168135440.0,185384109.0,0.7559,1.2003,0.7546,1.2076
2023-08-31 12:05,3066,1553,1513,283162,126552,156610,272055401.0,95781517.0,176273883.0,2921,1472,1449,273150,121244,151906,264616331.0,91714557.0,172901774.0,0.7569,1.1256,0.7564,1.1382
2023-08-31 12:10,1955,549,1406,213155,27220,185935,161224129.0,20514950.0,140709178.0,1848,472,1376,209812,25989,183823,158880857.0,19590850.0,139290006.0,0.7537,0.7568,0.7538,0.7577
2023-08-31 12:15,1269,608,661,73934,48987,24947,67713679.0,37005918.0,30707761.0,1170,555,615,70196,46130,24066,64649707.0,34826586.0,29823121.0,0.7554,1.2309,0.755,1.2392
2023-08-31 12:20,976,656,320,106348,83626,22722,92226039.0,63453158.0,28772881.0,884,604,280,99736,79182,20554,87110044.0,59921826.0,27188218.0,0.7588,1.2663,0.7568,1.3228
2023-08-31 12:25,1917,709,1208,175377,35069,140308,155736413.0,26489340.0,129247072.0,1771,618,1153,166651,31277,135374,149383224.0,23594612.0,125788611.0,0.7553,0.9212,0.7544,0.9292
2023-08-31 12:30,2248,716,1532,272258,18955,253303,217757077.0,14266143.0,203490934.0,2174,667,1507,272184,20098,252086,217698025.0,15084931.0,202613093.0,0.7526,0.8033,0.7506,0.8037
2023-08-31 12:35,1790,584,1206,212169,14738,197431,172355250.0,11123160.0,161232089.0,1699,528,1171,209526,12256,197270,170318343.0,9226232.0,161092111.0,0.7547,0.8167,0.7528,0.8166
2023-08-31 12:40,1054,155,899,117145,3879,113266,88842162.0,2950777.0,85891385.0,989,111,878,116283,3303,112980,88174794.0,2484245.0,85690549.0,0.7607,0.7583,0.7521,0.7585
2023-08-31 12:45,1749,703,1046,143300,35201,108099,120146647.0,26653050.0,93493596.0,1705,675,1030,141642,33745,107897,118827619.0,25499468.0,93328151.0,0.7572,0.8649,0.7557,0.865
2023-08-31 12:50,939,447,492,77604,16545,61059,70351223.0,12528440.0,57822783.0,856,389,467,75360,15672,59688,68709195.0,11832172.0,56877023.0,0.7572,0.947,0.755,0.9529
2023-08-31 12:55,2383,572,1811,261057,23373,237684,253718871.0,17606947.0,236111924.0,2275,509,1766,251611,21385,230226,247443108.0,16063405.0,231379703.0,0.7533,0.9934,0.7512,1.005
2023-08-31 13:00,4106,1415,2691,522169,105014,417155,405718569.0,79051236.0,326667332.0,3988,1342,2646,513538,102898,410640,399039851.0,77378709.0,321661142.0,0.7528,0.7831,0.752,0.7833
2023-08-31 13:05,3235,1351,1884,364268,107279,256989,286123356.0,80681947.0,205441409.0,3168,1311,1857,362866,107172,255694,285212861.0,80582802.0,204630059.0,0.7521,0.7994,0.7519,0.8003
2023-08-31 13:10,2390,521,1869,256671,13194,243477,205320129.0,9936532.0,195383596.0,2340,497,1843,256282,11971,244311,205026325.0,9001004.0,196025321.0,0.7531,0.8025,0.7519,0.8024
2023-08-31 13:15,1708,781,927,140232,48657,91575,117576635.0,36643137.0,80933497.0,1660,755,905,137268,48155,89113,115118521.0,36226066.0,78892455.0,0.7531,0.8838,0.7523,0.8853
2023-08-31 13:20,3612,2077,1535,303232,159619,143613,240321255.0,120143188.0,120178066.0,3559,2045,1514,301151,157979,143172,238667586.0,118851512.0,119816074.0,0.7527,0.8368,0.7523,0.8369
2023-08-31 13:25,1732,738,994,154756,76188,78568,117160345.0,57556695.0,59603649.0,1674,702,972,151879,74690,77189,114898085.0,56338151.0,58559933.0,0.7555,0.7586,0.7543,0.7587
2023-08-31 13:30,558,307,251,63195,35442,27753,59541640.0,26884094.0,32657545.0,499,267,232,59959,31011,28948,57103285.0,23393549.0,33709735.0,0.7585,1.1767,0.7544,1.1645
2023-08-31 13:35,1743,701,1042,145322,77080,68242,110114365.0,58278483.0,51835882.0,1669,661,1008,143469,76482,66987,108687220.0,57781926.0,50905294.0,0.7561,0.7596,0.7555,0.7599
2023-08-31 13:40,1952,1105,847,144242,100788,43454,144309246.0,76533814.0,67775432.0,1826,1038,788,137859,93441,44418,139214157.0,70707110.0,68507047.0,0.7594,1.5597,0.7567,1.5423
2023-08-31 13:45,553,376,177,49463,33786,15677,37529120.0,25605584.0,11923536.0,477,341,136,38535,28966,9569,29224283.0,21909977.0,7314305.0,0.7579,0.7606,0.7564,0.7644
2023-08-31 13:50,528,354,174,90469,68570,21899,68594814.0,51905740.0,16689073.0,494,338,156,89298,68572,20726,67710993.0,51890453.0,15820540.0,0.757,0.7621,0.7567,0.7633
2023-08-31 13:55,808,382,426,55686,31265,24421,42352971.0,23730198.0,18622773.0,768,363,405,52972,28843,24129,40303798.0,21887629.0,18416168.0,0.759,0.7626,0.7589,0.7632
2023-08-31 14:00,1427,988,439,112416,85725,26691,97419446.0,65452689.0,31966757.0,1349,948,401,110273,84106,26167,95672891.0,64053323.0,31619568.0,0.7635,1.1977,0.7616,1.2084
2023-08-31 14:05,382,106,276,23662,11481,12181,18053358.0,8747801.0,9305557.0,320,69,251,22180,10816,11364,16909805.0,8213590.0,8696215.0,0.7619,0.7639,0.7594,0.7652
2023-08-31 14:10,2423,1350,1073,233828,144099,89729,202310267.0,110484039.0,91826228.0,2237,1277,960,221604,138821,82783,192643211.0,105903861.0,86739350.0,0.7667,1.0234,0.7629,1.0478
2023-08-31 14:15,1900,626,1274,202024,44892,157132,177628175.0,34198446.0,143429729.0,1798,568,1230,193555,39648,153907,171397248.0,30194014.0,141203233.0,0.7618,0.9128,0.7616,0.9175
2023-08-31 14:20,1800,514,1286,194730,19942,174788,172301265.0,15259511.0,157041753.0,1699,465,1234,178081,17787,160294,159762565.0,13570352.0,146192212.0,0.7652,0.8985,0.7629,0.912
2023-08-31 14:25,1807,696,1111,173493,37791,135702,144009664.0,28749172.0,115260491.0,1722,659,1063,175422,37584,137838,145637276.0,28590084.0,117047192.0,0.7607,0.8494,0.7607,0.8492
2023-08-31 14:30,2970,948,2022,362397,56405,305992,287683240.0,42831184.0,244852055.0,2869,888,1981,353840,52732,301108,281375068.0,40021766.0,241353302.0,0.7594,0.8002,0.759,0.8016
2023-08-31 14:35,1788,540,1248,207912,15512,192400,170158112.0,11763256.0,158394856.0,1731,500,1231,201562,13817,187745,165274535.0,10486007.0,154788527.0,0.7583,0.8233,0.7589,0.8245
2023-08-31 14:40,1127,554,573,103653,12782,90871,79077810.0,9730574.0,69347235.0,1087,538,549,102743,12650,90093,78382116.0,9591048.0,68791067.0,0.7613,0.7631,0.7582,0.7636
2023-08-31 14:45,410,182,228,36884,6212,30672,39720305.0,4710128.0,35010177.0,361,153,208,28128,5080,23048,33035910.0,3834333.0,29201577.0,0.7582,1.1414,0.7548,1.267
2023-08-31 14:50,1387,356,1031,128498,7941,120557,97781992.0,6029725.0,91752267.0,1346,329,1017,133609,8127,125482,101736892.0,6160243.0,95576649.0,0.7593,0.7611,0.758,0.7617
2023-08-31 14:55,1935,394,1541,189536,17450,172086,167173730.0,13223900.0,153949830.0,1870,356,1514,185391,14828,170563,164025222.0,11226881.0,152798340.0,0.7578,0.8946,0.7571,0.8958
2023-08-31 15:00,780,186,594,52859,12436,40423,51520292.0,9304457.0,42215835.0,704,152,552,47861,10603,37258,47861884.0,8014196.0,39847687.0,0.7482,1.0444,0.7558,1.0695
2023-08-31 15:05,1239,259,980,125710,10646,115064,95477658.0,8054221.0,87423436.0,1222,241,981,123975,9363,114612,94177220.0,7083117.0,87094102.0,0.7565,0.7598,0.7565,0.7599
2023-08-31 15:10,2274,401,1873,266173,23505,242668,224701741.0,17734278.0,206967463.0,2172,341,1831,259800,21473,238327,219962000.0,16198260.0,203763740.0,0.7545,0.8529,0.7544,0.855
2023-08-31 15:15,1999,773,1226,208795,33955,174840,192755054.0,25633528.0,167121526.0,1913,718,1195,201549,29488,172061,187252646.0,22227908.0,165024738.0,0.7549,0.9559,0.7538,0.9591
2023-08-31 15:20,1869,651,1218,238998,29005,209993,192846949.0,21933333.0,170913616.0,1829,623,1206,237452,27900,209552,191656192.0,21069246.0,170586946.0,0.7562,0.8139,0.7552,0.8141
2023-08-31 15:25,2275,593,1682,294657,30339,264318,234650194.0,23023997.0,211626197.0,2196,550,1646,288681,28302,260379,230233733.0,21310659.0,208923073.0,0.7589,0.8006,0.753,0.8024
2023-08-31 15:30,1866,1015,851,149753,52900,96853,136331433.0,39898374.0,96433059.0,1812,988,824,147583,52311,95272,134690429.0,39445279.0,95245149.0,0.7542,0.9957,0.7541,0.9997
2023-08-31 15:35,424,277,147,32047,15501,16546,35846775.0,11759294.0,24087480.0,379,249,130,29189,13981,15208,33601818.0,10542756.0,23059062.0,0.7586,1.4558,0.7541,1.5162
2023-08-31 15:40,1914,1186,728,172999,119950,53049,130758793.0,90509210.0,40249583.0,1859,1152,707,171723,118696,53027,129803539.0,89562510.0,40241028.0,0.7546,0.7587,0.7546,0.7589
2023-08-31 15:45,1428,910,518,139582,101046,38536,105482636.0,76235183.0,29247452.0,1396,890,506,137882,100251,37631,104185478.0,75638572.0,28546906.0,0.7545,0.759,0.7545,0.7586
2023-08-31 15:50,1409,720,689,104211,74086,30125,78800403.0,55952095.0,22848308.0,1361,691,670,102981,73271,29710,77851246.0,55307297.0,22543948.0,0.7552,0.7585,0.7548,0.7588
2023-08-31 15:55,1487,382,1105,137209,26615,110594,103980859.0,20111304.0,83869554.0,1464,368,1096,136836,26702,110134,103664012.0,20142396.0,83521615.0,0.7556,0.7584,0.7543,0.7584
2023-08-31 16:00,1819,703,1116,193185,55636,137549,146305077.0,41970964.0,104334113.0,1790,690,1100,191886,55269,136617,145312260.0,41683539.0,103628720.0,0.7544,0.7585,0.7542,0.7585
2023-08-31 16:05,2285,1161,1124,187155,84376,102779,187249942.0,63606046.0,123643896.0,2225,1124,1101,184746,83815,100931,185552993.0,63174034.0,122378958.0,0.7538,1.203,0.7537,1.2125
2023-08-31 16:10,1614,801,813,117213,29858,87355,111164331.0,22397767.0,88766563.0,1325,582,743,106143,24017,82126,102987724.0,18027672.0,84960052.0,0.7501,1.0162,0.7506,1.0345
2023-08-31 16:15,1580,1080,500,121184,45794,75390,102667242.0,34376861.0,68290381.0,1493,1021,472,118309,44328,73981,100546727.0,33271100.0,67275627.0,0.7507,0.9058,0.7506,0.9094
2023-08-31 16:20,3099,1035,2064,336417,33375,303042,321288038.0,25031458.0,296256580.0,2898,889,2009,329914,30299,299615,316481330.0,22673561.0,293807769.0,0.75,0.9776,0.7483,0.9806
2023-08-31 16:25,1680,533,1147,183632,13425,170207,138513027.0,10083340.0,128429686.0,1624,502,1122,176932,14299,162633,133190593.0,10629389.0,122561204.0,0.7511,0.7545,0.7434,0.7536
2023-08-31 16:30,2004,513,1491,214428,12462,201966,161252204.0,9325205.0,151926999.0,1939,465,1474,214771,12153,202618,161644541.0,9087450.0,152557090.0,0.7483,0.7522,0.7478,0.7529
2023-08-31 16:35,763,225,538,89488,6361,83127,89944423.0,4753384.0,85191038.0,714,191,523,88534,6118,82416,89402209.0,4568168.0,84834040.0,0.7473,1.0248,0.7467,1.0293
2023-08-31 16:40,2351,987,1364,228310,34638,193672,216830119.0,25940898.0,190889221.0,2253,917,1336,225190,31672,193518,214397604.0,23652582.0,190745021.0,0.7489,0.9856,0.7468,0.9857
2023-08-31 16:45,2942,1459,1483,274526,70614,203912,251240699.0,52768109.0,198472589.0,2870,1412,1458,270758,68323,202435,248505283.0,51038126.0,197467156.0,0.7473,0.9733,0.747,0.9755
2023-08-31 16:50,2472,829,1643,228252,47814,180438,194897046.0,36040453.0,158856593.0,2403,788,1615,220696,42603,178093,188888437.0,31892502.0,156995935.0,0.7538,0.8804,0.7486,0.8815
2023-08-31 16:55,3755,2208,1547,329307,214429,114878,248101220.0,161287968.0,86813252.0,3693,2182,1511,329480,214001,115479,248136041.0,160819129.0,87316912.0,0.7522,0.7557,0.7515,0.7561
2023-08-31 17:00,3175,1587,1588,269465,193768,75697,202793080.0,145614341.0,57178738.0,3126,1567,1559,272237,192079,80158,205076732.0,144358677.0,60718055.0,0.7515,0.7554,0.7516,0.7575
2023-08-31 17:05,2443,1401,1042,229250,170431,58819,195515741.0,128181333.0,67334408.0,2409,1387,1022,229734,170873,58861,195807167.0,128420575.0,67386592.0,0.7521,1.1448,0.7516,1.1448
2023-08-31 17:10,2489,1434,1055,258873,182722,76151,194941223.0,137382061.0,57559162.0,2451,1419,1032,257993,182945,75048,194219899.0,137480650.0,56739249.0,0.7519,0.7559,0.7515,0.756
2023-08-31 17:15,1009,422,587,81326,48568,32758,61307009.0,36523091.0,24783917.0,976,400,576,79181,46088,33093,59794931.0,34625546.0,25169384.0,0.752,0.7566,0.7513,0.7606
2023-08-31 17:20,1184,873,311,73525,54528,18997,67001193.0,41147478.0,25853715.0,1140,854,286,72541,54139,18402,66273158.0,40844616.0,25428542.0,0.7546,1.3609,0.7544,1.3818
2023-08-31 17:25,561,371,190,39038,27203,11835,29511099.0,20527927.0,8983171.0,538,358,180,36291,26106,10185,27429663.0,19701866.0,7727796.0,0.7546,0.759,0.7547,0.7587
2023-08-31 17:30,480,116,364,38553,17658,20895,40350659.0,13290369.0,27060289.0,452,105,347,36773,17109,19664,39275442.0,12878650.0,26396792.0,0.7527,1.2951,0.7527,1.3424
2023-08-31 17:35,1622,120,1502,148169,16584,131585,112022530.0,12512856.0,99509674.0,1580,96,1484,146222,15501,130721,110522998.0,11645672.0,98877325.0,0.7545,0.7562,0.7513,0.7564
2023-08-31 17:40,1867,125,1742,212563,9899,202664,160671427.0,7471452.0,153199974.0,1835,105,1730,210969,9035,201934,159503962.0,6792033.0,152711929.0,0.7548,0.7559,0.7517,0.7562
2023-08-31 17:45,1810,656,1154,207086,91503,115583,191006617.0,69194270.0,121812347.0,1746,629,1117,203670,88434,115236,188414919.0,66674250.0,121740669.0,0.7562,1.0539,0.7539,1.0564
2023-08-31 17:50,547,319,228,55712,31899,23813,41867856.0,24011171.0,17856684.0,502,292,210,48006,30587,17419,36189755.0,23013967.0,13175788.0,0.7527,0.7499,0.7524,0.7564
2023-08-31 17:55,1684,869,815,146884,62794,84090,122048818.0,47213751.0,74835066.0,1650,850,800,143487,61485,82002,119654373.0,46225678.0,73428694.0,0.7519,0.8899,0.7518,0.8955
2023-08-31 18:00,531,358,173,43659,30083,13576,32838531.0,22599705.0,10238826.0,505,338,167,43470,29493,13977,32706393.0,22148246.0,10558146.0,0.7512,0.7542,0.751,0.7554
2023-08-31 18:05,1492,1072,420,106513,66411,40102,80144927.0,49900927.0,30244000.0,1442,1034,408,104378,65136,39242,78541833.0,48935270.0,29606562.0,0.7514,0.7542,0.7513,0.7545
2023-08-31 18:10,973,690,283,62926,38842,24084,47361667.0,29227639.0,18134028.0,939,670,269,61841,38179,23662,46508344.0,28663787.0,17844556.0,0.7525,0.7529,0.7508,0.7541
2023-08-31 18:15,975,694,281,106721,91733,14988,80314300.0,69000332.0,11313968.0,941,680,261,105235,90328,14907,79131855.0,67872914.0,11258941.0,0.7522,0.7549,0.7514,0.7553
2023-08-31 18:20,870,579,291,63200,40795,22405,59148931.0,30794683.0,28354247.0,830,564,266,62687,41550,21137,58632823.0,31209457.0,27423365.0,0.7549,1.2655,0.7511,1.2974
2023-08-31 18:25,1307,726,581,120139,50226,69913,90769779.0,37878632.0,52891146.0,1286,714,572,119203,49513,69690,90000890.0,37263013.0,52737877.0,0.7542,0.7565,0.7526,0.7567
2023-08-31 18:30,1028,585,443,69976,27276,42700,52655613.0,20529352.0,32126260.0,969,548,421,63493,23684,39809,47959163.0,17848282.0,30110881.0,0.7527,0.7524,0.7536,0.7564
2023-08-31 18:35,459,302,157,39954,21090,18864,30196250.0,15921861.0,14274388.0,417,271,146,35227,20140,15087,26583793.0,15153273.0,11430519.0,0.7549,0.7567,0.7524,0.7576
2023-09-01 10:00,4340,3178,1162,592946,468609,124337,597026939.0,352859881.0,244167058.0,3859,2937,922,553042,453572,99470,554685860.0,341259156.0,213426703.0,0.753,1.9638,0.7524,2.1456
2023-09-01 10:05,4286,2607,1679,436277,292938,143339,532073591.0,225086742.0,306986849.0,3056,2123,933,331282,236061,95221,449893713.0,179746952.0,270146761.0,0.7684,2.1417,0.7614,2.8371
2023-09-01 10:10,2579,1397,1182,228036,130169,97867,209972167.0,100385584.0,109586583.0,1909,1046,863,195983,107557,88426,185257229.0,82238265.0,103018964.0,0.7712,1.1198,0.7646,1.165
2023-09-01 10:15,3705,1353,2352,349004,88538,260466,312816026.0,67430963.0,245385063.0,3136,1021,2115,318467,73002,245465,289973380.0,55572002.0,234401378.0,0.7616,0.9421,0.7612,0.9549
2023-09-01 10:20,2003,1049,954,194282,98212,96070,196151024.0,75652814.0,120498209.0,1616,818,798,174216,88281,85935,180325289.0,67548841.0,112776447.0,0.7703,1.2543,0.7652,1.3123
2023-09-01 10:25,2017,1253,764,234827,130873,103954,215829309.0,100947784.0,114881524.0,1645,1044,601,191230,108768,82462,181703536.0,83356988.0,98346548.0,0.7713,1.1051,0.7664,1.1926
2023-09-01 10:30,4419,2751,1668,539287,324861,214426,758177588.0,252794620.0,505382968.0,2818,1823,995,374117,232372,141745,630583587.0,179688559.0,450895028.0,0.7782,2.3569,0.7733,3.181
2023-09-01 10:35,3443,1915,1528,382366,189086,193280,400871069.0,146118966.0,254752103.0,2958,1672,1286,353935,177944,175991,378937557.0,136998380.0,241939177.0,0.7728,1.318,0.7699,1.3747
2023-09-01 10:40,2980,1793,1187,313941,144724,169217,277183372.0,111594255.0,165589116.0,2650,1571,1079,291626,134764,156862,259994007.0,103587423.0,156406584.0,0.7711,0.9786,0.7687,0.9971
2023-09-01 10:45,1774,1117,657,177307,99362,77945,172720328.0,77116271.0,95604057.0,1341,876,465,147098,80179,66919,149010075.0,61884206.0,87125869.0,0.7761,1.2266,0.7718,1.302
2023-09-01 10:50,3076,1234,1842,342243,91094,251149,383187905.0,71243144.0,311944761.0,2497,958,1539,286328,80717,205611,340012716.0,62361852.0,277650864.0,0.7821,1.2421,0.7726,1.3504
2023-09-01 10:55,2492,1200,1292,277401,109820,167581,249675956.0,84848297.0,164827659.0,2168,1023,1145,246859,96384,150475,225927134.0,74287303.0,151639831.0,0.7726,0.9836,0.7707,1.0077
2023-09-01 11:00,2861,799,2062,354677,69334,285343,309169139.0,53593186.0,255575952.0,2583,648,1935,336063,62388,273675,294803172.0,47942085.0,246861087.0,0.773,0.8957,0.7685,0.902
2023-09-01 11:05,1910,1024,886,182146,79173,102973,152123873.0,61059693.0,91064180.0,1717,920,797,170784,73702,97082,143588548.0,56800401.0,86788147.0,0.7712,0.8844,0.7707,0.894
2023-09-01 11:10,2100,817,1283,220183,54341,165842,193278299.0,41970342.0,151307956.0,1902,707,1195,208945,49373,159572,184866567.0,38059585.0,146806982.0,0.7724,0.9124,0.7709,0.92
2023-09-01 11:15,1862,357,1505,228834,26549,202285,211138781.0,20487045.0,190651735.0,1693,265,1428,214313,20986,193327,200617838.0,16087164.0,184530673.0,0.7717,0.9425,0.7666,0.9545
2023-09-01 11:20,2304,1005,1299,229284,71304,157980,211021893.0,54872947.0,156148945.0,2052,866,1186,218399,63939,154460,202569142.0,48739429.0,153829713.0,0.7696,0.9884,0.7623,0.9959
2023-09-01 11:25,2358,1324,1034,264007,131337,132670,250697912.0,101149245.0,149548667.0,2211,1241,970,261180,127514,133666,248417798.0,97877976.0,150539821.0,0.7702,1.1272,0.7676,1.1262
2023-09-01 11:30,1536,1127,409,153585,127919,25666,118237033.0,98257639.0,19979394.0,1424,1086,338,146039,126100,19939,112254823.0,96852935.0,15401888.0,0.7681,0.7784,0.7681,0.7725
2023-09-01 11:35,1776,1191,585,150713,99512,51201,127433718.0,76425343.0,51008375.0,1659,1109,550,148884,97632,51252,126259816.0,74949446.0,51310369.0,0.768,0.9962,0.7677,1.0011
2023-09-01 11:40,669,211,458,64495,24766,39729,49432467.0,18914710.0,30517757.0,584,160,424,57890,20865,37025,44503479.0,15981344.0,28522134.0,0.7637,0.7681,0.7659,0.7703
2023-09-01 11:45,1703,1306,397,394366,283517,110849,303298742.0,217956560.0,85342182.0,1614,1246,368,388982,279674,109308,299114794.0,214910784.0,84204010.0,0.7688,0.7699,0.7684,0.7703
2023-09-01 11:50,1713,888,825,473667,170853,302814,364246297.0,131265034.0,232981262.0,1633,844,789,467055,167347,299708,359320459.0,128567024.0,230753435.0,0.7683,0.7694,0.7683,0.7699
2023-09-01 11:55,907,201,706,222070,36089,185981,170649640.0,27489110.0,143160530.0,837,167,670,216023,34247,181776,165998991.0,26061526.0,139937464.0,0.7617,0.7698,0.761,0.7698
2023-09-01 12:00,946,219,727,197840,19541,178299,152286866.0,14747383.0,137539482.0,835,135,700,195798,13961,181837,151028865.0,10660084.0,140368781.0,0.7547,0.7714,0.7636,0.7719
2023-09-01 12:05,1352,258,1094,308174,12956,295218,248443336.0,9951942.0,238491393.0,1276,220,1056,303388,11450,291938,244929842.0,8764420.0,236165421.0,0.7681,0.8078,0.7655,0.809
2023-09-01 12:10,1477,426,1051,273995,56324,217671,222359667.0,43253647.0,179106019.0,1408,385,1023,269070,52110,216960,218520835.0,39987997.0,178532838.0,0.7679,0.8228,0.7674,0.8229
2023-09-01 12:15,1747,1256,491,301960,221390,80570,232118388.0,170125667.0,61992721.0,1666,1203,463,296443,216553,79890,227842587.0,166267315.0,61575272.0,0.7684,0.7694,0.7678,0.7708
2023-09-01 12:20,1998,1333,665,352163,197830,154333,295169337.0,152458474.0,142710862.0,1816,1238,578,353216,194084,159132,295682616.0,149324170.0,146358446.0,0.7707,0.9247,0.7694,0.9197
2023-09-01 12:25,2101,1407,694,383876,236218,147658,296133520.0,181986168.0,114147352.0,2032,1366,666,380172,233862,146310,293198088.0,180079476.0,113118612.0,0.7704,0.7731,0.77,0.7731
2023-09-01 12:30,1822,833,989,332880,103143,229737,256734392.0,79438337.0,177296055.0,1761,799,962,329595,101270,228325,254423961.0,77982324.0,176441636.0,0.7702,0.7717,0.77,0.7728
2023-09-01 12:35,1344,311,1033,259972,33908,226064,212321301.0,26097294.0,186224007.0,1270,267,1003,255964,33515,222449,209318428.0,25770726.0,183547701.0,0.7697,0.8238,0.7689,0.8251
2023-09-01 12:40,1451,510,941,227060,62575,164485,175186144.0,48144174.0,127041970.0,1391,472,919,218834,54793,164041,168822397.0,42127336.0,126695061.0,0.7694,0.7724,0.7688,0.7723
2023-09-01 12:45,960,290,670,175876,36464,139412,147687821.0,28225280.0,119462541.0,878,239,639,171179,34238,136941,144007635.0,26399966.0,117607669.0,0.7741,0.8569,0.7711,0.8588
2023-09-01 12:50,1183,383,800,201731,45512,156219,167221990.0,35082140.0,132139849.0,1110,341,769,196838,44010,152828,163638078.0,33903864.0,129734214.0,0.7708,0.8459,0.7704,0.8489
2023-09-01 12:55,2198,276,1922,348813,18607,330206,269174819.0,14300614.0,254874205.0,2152,249,1903,357592,23522,334070,275950181.0,18078713.0,257871468.0,0.7686,0.7719,0.7686,0.7719
2023-09-01 13:00,3783,1173,2610,531003,127351,403652,498957633.0,97206381.0,401751252.0,3355,894,2461,491067,109196,381871,470219895.0,83383173.0,386836721.0,0.7633,0.9953,0.7636,1.013
2023-09-01 13:05,2188,744,1444,240747,86811,153936,195921938.0,66389428.0,129532510.0,2040,652,1388,238811,88313,150498,194326046.0,67431959.0,126894086.0,0.7648,0.8415,0.7636,0.8432
2023-09-01 13:10,847,354,493,106688,39901,66787,81979681.0,30607728.0,51371953.0,780,314,466,103160,36619,66541,79215579.0,28019937.0,51195641.0,0.7671,0.7692,0.7652,0.7694
2023-09-01 13:15,2728,551,2177,352421,34954,317467,270383206.0,26785444.0,243597762.0,2665,516,2149,353099,36154,316945,271044833.0,27639343.0,243405490.0,0.7663,0.7673,0.7645,0.768
2023-09-01 13:20,844,227,617,106691,10778,95913,93775929.0,8300023.0,85475906.0,780,180,600,104303,9378,94925,91860268.0,7182212.0,84678055.0,0.7701,0.8912,0.7659,0.8921
2023-09-01 13:25,1552,313,1239,180303,16759,163544,138650644.0,12901953.0,125748691.0,1506,289,1217,178390,16099,162291,137133899.0,12319541.0,124814358.0,0.7699,0.7689,0.7652,0.7691
2023-09-01 13:30,2061,759,1302,188107,57169,130938,156099459.0,43857670.0,112241788.0,1986,714,1272,183445,55729,127716,152683198.0,42733406.0,109949791.0,0.7672,0.8572,0.7668,0.8609
2023-09-01 13:35,924,310,614,88657,22214,66443,79882767.0,17100491.0,62782276.0,860,273,587,83244,18948,64296,75700254.0,14522631.0,61177622.0,0.7698,0.9449,0.7664,0.9515
2023-09-01 13:40,635,310,325,54291,23808,30483,53024935.0,18262285.0,34762650.0,565,272,293,49526,22386,27140,49690495.0,17152086.0,32538408.0,0.7671,1.1404,0.7662,1.1989
2023-09-01 13:45,2110,733,1377,215808,50315,165493,165349495.0,38537823.0,126811671.0,2047,686,1361,213754,48104,165650,163926426.0,36814306.0,127112119.0,0.7659,0.7663,0.7653,0.7674
2023-09-01 13:50,1683,609,1074,156620,31929,124691,120482821.0,24700248.0,95782572.0,1597,548,1049,151668,29150,122518,116420479.0,22316068.0,94104411.0,0.7736,0.7682,0.7656,0.7681
2023-09-01 13:55,888,393,495,69802,19221,50581,53647789.0,14775395.0,38872394.0,842,367,475,69462,18418,51044,53381258.0,14103732.0,39277526.0,0.7687,0.7685,0.7658,0.7695
2023-09-01 14:00,1147,226,921,119647,8975,110672,91861284.0,6836900.0,85024383.0,1098,194,904,117312,8178,109134,90110689.0,6256652.0,83854037.0,0.7618,0.7683,0.7651,0.7684
2023-09-01 14:05,402,181,221,43963,16472,27491,33836448.0,12711061.0,21125386.0,358,156,202,37794,14361,23433,29005767.0,10977405.0,18028362.0,0.7717,0.7684,0.7644,0.7694
2023-09-01 14:10,433,125,308,25953,11924,14029,31596063.0,9125589.0,22470474.0,396,98,298,27640,10352,17288,32831773.0,7884245.0,24947527.0,0.7653,1.6017,0.7616,1.4431
2023-09-01 14:15,841,348,493,82566,31653,50913,63530251.0,24306738.0,39223513.0,777,300,477,77008,30425,46583,59208879.0,23325459.0,35883420.0,0.7679,0.7704,0.7667,0.7703
2023-09-01 14:20,738,422,316,69309,44716,24593,65181767.0,34529336.0,30652431.0,689,392,297,65622,41803,23819,62129746.0,32101171.0,30028574.0,0.7722,1.2464,0.7679,1.2607
2023-09-01 14:25,2095,713,1382,304876,84503,220373,234887425.0,64974641.0,169912783.0,2049,695,1354,302177,83040,219137,232811588.0,63818582.0,168993006.0,0.7689,0.771,0.7685,0.7712
2023-09-01 14:30,1877,925,952,259165,111924,147241,259331501.0,86802726.0,172528775.0,1698,830,868,233352,99376,133976,238710010.0,76493137.0,162216872.0,0.7756,1.1717,0.7697,1.2108
2023-09-01 14:35,2178,1204,974,261329,156001,105328,213558082.0,120431636.0,93126446.0,2115,1183,932,253100,151090,102010,206999399.0,116372644.0,90626755.0,0.772,0.8842,0.7702,0.8884
2023-09-01 14:40,2115,1624,491,257277,232724,24553,198235329.0,179261851.0,18973478.0,2053,1588,465,255070,231655,23415,196517289.0,178388511.0,18128777.0,0.7703,0.7728,0.7701,0.7742
2023-09-01 14:45,1292,641,651,130809,74852,55957,123911561.0,57630737.0,66280824.0,1230,611,619,126068,73621,52447,120639221.0,56673868.0,63965353.0,0.7699,1.1845,0.7698,1.2196
2023-09-01 14:50,398,175,223,21450,7869,13581,16567339.0,6079183.0,10488155.0,345,148,197,20368,7529,12839,15707557.0,5785300.0,9922256.0,0.7725,0.7723,0.7684,0.7728
2023-09-01 14:55,456,174,282,43693,16443,27250,33653619.0,12673572.0,20980047.0,416,154,262,42769,15859,26910,32986545.0,12196498.0,20790046.0,0.7708,0.7699,0.7691,0.7726
2023-09-01 15:00,776,290,486,65420,18391,47029,50293599.0,14172212.0,36121387.0,741,271,470,64046,16732,47314,49375078.0,12858134.0,36516944.0,0.7706,0.7681,0.7685,0.7718
2023-09-01 15:05,1192,723,469,101596,48288,53308,78360545.0,37173620.0,41186925.0,1157,701,456,97400,46177,51223,75127596.0,35546133.0,39581463.0,0.7698,0.7726,0.7698,0.7727
2023-09-01 15:10,129,88,41,13174,7049,6125,10397649.0,5409667.0,4987981.0,91,63,28,10127,6780,3347,7798333.0,5205754.0,2592578.0,0.7674,0.8144,0.7678,0.7746
2023-09-01 15:15,249,155,94,23845,13637,10208,18273546.0,10381415.0,7892131.0,208,129,79,22685,11932,10753,17592926.0,9161237.0,8431689.0,0.7613,0.7731,0.7678,0.7841
2023-09-01 15:20,281,122,159,27886,12685,15201,21451962.0,9757174.0,11694787.0,248,109,139,26790,10231,16559,20797719.0,7746606.0,13051112.0,0.7692,0.7693,0.7572,0.7882
2023-09-01 15:25,2502,1950,552,306321,245421,60900,273458023.0,191041804.0,82416219.0,1996,1604,392,253465,210067,43398,231568712.0,162313422.0,69255290.0,0.7784,1.3533,0.7727,1.5958
2023-09-01 15:30,1775,936,839,190072,118094,71978,196256187.0,92961504.0,103294683.0,1260,741,519,143084,92501,50583,158801696.0,71739907.0,87061789.0,0.7872,1.4351,0.7756,1.7212
2023-09-01 15:35,1146,643,503,92530,66836,25694,84338816.0,52482164.0,31856652.0,852,444,408,70601,49112,21489,66794905.0,38158904.0,28636000.0,0.7852,1.2398,0.777,1.3326
2023-09-01 15:40,2700,1930,770,333332,265494,67838,344699857.0,208328116.0,136371741.0,1981,1560,421,277553,240109,37444,300121264.0,187437603.0,112683661.0,0.7847,2.0103,0.7806,3.0094
2023-09-01 15:45,4272,2034,2238,517331,243849,273482,498651887.0,190370183.0,308281704.0,3701,1711,1990,456302,205292,251010,451451042.0,159989905.0,291461136.0,0.7807,1.1272,0.7793,1.1612
2023-09-01 15:50,3290,2137,1153,359436,234733,124703,315755752.0,182912534.0,132843218.0,2693,1672,1021,331705,213935,117770,294828659.0,166828909.0,127999749.0,0.7792,1.0653,0.7798,1.0869
2023-09-01 15:55,1625,1050,575,142483,93518,48965,123336589.0,73306908.0,50029681.0,1377,894,483,126709,85760,40949,110971929.0,66906955.0,44064974.0,0.7839,1.0217,0.7802,1.0761
2023-09-01 16:00,1772,724,1048,216187,83191,132996,179991166.0,64903734.0,115087431.0,1565,608,957,197118,73892,123226,165560468.0,57422889.0,108137579.0,0.7802,0.8653,0.7771,0.8776
2023-09-01 16:05,1681,796,885,148194,39195,108999,115789238.0,30676108.0,85113130.0,1508,688,820,134439,32782,101657,105002869.0,25477635.0,79525233.0,0.7827,0.7809,0.7772,0.7823
2023-09-01 16:10,1500,417,1083,145684,19581,126103,137582673.0,15237957.0,122344716.0,1391,350,1041,145312,21061,124251,137196516.0,16348733.0,120847783.0,0.7782,0.9702,0.7763,0.9726
2023-09-01 16:15,2222,1149,1073,214418,129572,84846,179426541.0,101243976.0,78182565.0,2115,1093,1022,211347,126848,84499,176801353.0,98885472.0,77915880.0,0.7814,0.9215,0.7796,0.9221
2023-09-01 16:20,3513,1863,1650,284318,216942,67376,271228814.0,170623625.0,100605188.0,2549,1672,877,253475,207174,46301,246091747.0,161927604.0,84164143.0,0.7865,1.4932,0.7816,1.8178
2023-09-01 16:25,2498,946,1552,234550,93964,140586,242522438.0,73414528.0,169107910.0,2197,805,1392,213973,82520,131453,227159267.0,64364538.0,162794728.0,0.7813,1.2029,0.78,1.2384
2023-09-01 16:30,1900,1009,891,150428,104349,46079,141724068.0,81721529.0,60002539.0,1785,943,842,151247,106569,44678,142090748.0,83189664.0,58901084.0,0.7832,1.3022,0.7806,1.3183
2023-09-01 16:35,2293,1501,792,228220,172793,55427,190880973.0,135473965.0,55407008.0,2132,1425,707,215860,164000,51860,181030449.0,128299825.0,52730624.0,0.784,0.9996,0.7823,1.0168
2023-09-01 16:40,1215,753,462,105323,81515,23808,94167870.0,63842027.0,30325843.0,1055,676,379,97957,80849,17108,88504311.0,63109713.0,25394598.0,0.7832,1.2738,0.7806,1.4844
2023-09-01 16:45,1441,788,653,107532,60531,47001,108063411.0,47401397.0,60662014.0,1288,709,579,93846,56485,37361,97171509.0,44076575.0,53094934.0,0.7831,1.2907,0.7803,1.4211
2023-09-01 16:50,917,240,677,92903,15235,77668,96128333.0,11899893.0,84228440.0,853,200,653,88539,14001,74538,93142931.0,10893970.0,82248960.0,0.7811,1.0845,0.7781,1.1035
2023-09-01 16:55,2083,403,1680,238043,25938,212105,221935044.0,20557391.0,201377653.0,1971,346,1625,229450,23206,206244,215094237.0,18086955.0,197007282.0,0.7926,0.9494,0.7794,0.9552
2023-09-01 17:00,3323,1443,1880,413313,168095,245218,394569721.0,131456976.0,263112744.0,3182,1374,1808,403002,163572,239430,386823007.0,127814409.0,259008597.0,0.782,1.073,0.7814,1.0818
2023-09-01 17:05,2882,1115,1767,340657,123909,216748,266528733.0,96809111.0,169719621.0,2791,1081,1710,335588,121441,214147,262555547.0,94746802.0,167808745.0,0.7813,0.783,0.7802,0.7836
2023-09-01 17:10,1799,915,884,202937,86016,116921,158853513.0,67223281.0,91630231.0,1684,857,827,189120,77894,111226,148026604.0,60754392.0,87272211.0,0.7815,0.7837,0.78,0.7846
2023-09-01 17:15,1586,669,917,141262,47008,94254,109998446.0,36716613.0,73281832.0,1503,636,867,142693,49880,92813,111596815.0,38922080.0,72674734.0,0.7811,0.7775,0.7803,0.783
2023-09-01 17:20,2961,1894,1067,333319,242850,90469,332374963.0,190103128.0,142271834.0,2818,1812,1006,316797,227793,89004,319435929.0,178035292.0,141400637.0,0.7828,1.5726,0.7816,1.5887
2023-09-01 17:25,1204,471,733,96602,30118,66484,99650018.0,23692511.0,75957507.0,1098,427,671,88574,30020,58554,93242847.0,23459287.0,69783560.0,0.7867,1.1425,0.7815,1.1918
2023-09-01 17:30,475,235,240,39282,15205,24077,30726868.0,11878281.0,18848586.0,437,228,209,36990,14209,22781,28974185.0,11096865.0,17877320.0,0.7812,0.7828,0.781,0.7847
2023-09-01 17:35,911,131,780,67407,15613,51794,52746322.0,12249780.0,40496542.0,854,102,752,61688,13175,48513,48267242.0,10277238.0,37990004.0,0.7846,0.7819,0.7801,0.7831
2023-09-01 17:40,733,133,600,63650,11605,52045,49821796.0,9060271.0,40761525.0,676,110,566,57719,10558,47161,45166006.0,8235771.0,36930235.0,0.7807,0.7832,0.7801,0.7831
2023-09-01 17:45,831,219,612,73430,17829,55601,81232882.0,13943454.0,67289427.0,770,187,583,72938,16614,56324,80894496.0,12974658.0,67919837.0,0.7821,1.2102,0.7809,1.2059
2023-09-01 17:50,1508,156,1352,159682,7859,151823,136859639.0,6144087.0,130715552.0,1428,114,1314,154014,6906,147108,132477977.0,5389165.0,127088812.0,0.7818,0.861,0.7804,0.8639
2023-09-01 17:55,664,87,577,92975,11812,81163,72748416.0,9274547.0,63473868.0,623,55,568,90375,12833,77542,70641205.0,9963702.0,60677502.0,0.7852,0.7821,0.7764,0.7825
2023-09-01 18:00,1900,114,1786,296434,9302,287132,231881523.0,7260835.0,224620687.0,1852,87,1765,292279,5169,287110,228650823.0,4019182.0,224631641.0,0.7806,0.7823,0.7776,0.7824
2023-09-01 18:05,1363,355,1008,114680,17591,97089,89726666.0,13794408.0,75932257.0,1315,331,984,112993,17724,95269,88402721.0,13835700.0,74567021.0,0.7842,0.7821,0.7806,0.7827
2023-09-01 18:10,589,352,237,29105,12705,16400,22622772.0,9900112.0,12722660.0,537,328,209,30319,15766,14553,23678255.0,12282128.0,11396126.0,0.7792,0.7758,0.779,0.7831
2023-09-01 18:15,606,140,466,66570,9239,57331,52030130.0,7322644.0,44707486.0,521,103,418,60719,5792,54927,47489571.0,4503486.0,42986085.0,0.7926,0.7798,0.7775,0.7826
2023-09-01 18:20,1487,797,690,166361,40905,125456,129896728.0,31962484.0,97934244.0,1446,777,669,164231,37761,126470,128308837.0,29447245.0,98861592.0,0.7814,0.7806,0.7798,0.7817
2023-09-01 18:25,446,142,304,45231,11224,34007,35298959.0,8799730.0,26499228.0,381,96,285,38091,6341,31750,29801707.0,4943183.0,24858523.0,0.784,0.7792,0.7796,0.7829
2023-09-01 18:30,425,231,194,41877,20848,21029,32588961.0,16255304.0,16333656.0,359,198,161,37271,18680,18591,29096972.0,14547457.0,14549515.0,0.7797,0.7767,0.7788,0.7826
2023-09-01 18:35,377,243,134,37912,26398,11514,29373955.0,20641036.0,8732919.0,344,221,123,34775,25358,9417,27087972.0,19712028.0,7375944.0,0.7819,0.7585,0.7773,0.7833
2023-09-04 10:00,5574,3372,2202,574369,388814,185555,766348560.0,306908143.0,459440417.0,4337,2748,1589,504200,361251,142949,698448999.0,284595787.0,413853211.0,0.7893,2.476,0.7878,2.8951
2023-09-04 10:05,5306,2690,2616,432671,211730,220941,472050649.0,166629282.0,305421367.0,4539,2241,2298,406423,197960,208463,452021235.0,155645498.0,296375737.0,0.787,1.3824,0.7862,1.4217
2023-09-04 10:10,2568,1705,863,218236,173847,44389,185667777.0,138554007.0,47113770.0,2046,1408,638,179819,149922,29897,154425902.0,118624332.0,35801570.0,0.797,1.0614,0.7912,1.1975
2023-09-04 10:15,2635,1761,874,288437,217107,71330,242315570.0,173443540.0,68872030.0,2019,1430,589,247199,193780,53419,208325251.0,153690204.0,54635047.0,0.7989,0.9655,0.7931,1.0228
2023-09-04 10:20,5568,2737,2831,646692,349680,297012,859432180.0,281632763.0,577799417.0,4039,2198,1841,509456,269739,239717,748150535.0,215082720.0,533067815.0,0.8054,1.9454,0.7974,2.2237
2023-09-04 10:25,5444,2870,2574,594602,346092,248510,700475811.0,280169967.0,420305843.0,3930,2180,1750,500120,296070,204050,623190168.0,238083054.0,385107114.0,0.8095,1.6913,0.8041,1.8873
2023-09-04 10:30,5588,2375,3213,606637,270991,335646,680470195.0,221977232.0,458492963.0,3707,1542,2165,429421,181633,247788,538099790.0,147777813.0,390321977.0,0.8191,1.366,0.8136,1.5752
2023-09-04 10:35,4550,1918,2632,464310,154321,309989,461365019.0,125306049.0,336058969.0,3673,1409,2264,413604,139819,273785,421155688.0,112507134.0,308648554.0,0.812,1.0841,0.8047,1.1273
2023-09-04 10:40,2861,1445,1416,199760,69576,130184,173718452.0,56296279.0,117422173.0,2431,1170,1261,186486,65781,120705,163081327.0,52945946.0,110135381.0,0.8091,0.902,0.8049,0.9124
2023-09-04 10:45,2165,1247,918,185059,125948,59111,199322251.0,102192766.0,97129484.0,1764,1034,730,165007,113543,51464,182886699.0,91695589.0,91191110.0,0.8114,1.6432,0.8076,1.7719
2023-09-04 10:50,3099,2176,923,311268,244830,66438,340626060.0,198826548.0,141799512.0,2787,2039,748,283203,229820,53383,316291143.0,186284813.0,130006330.0,0.8121,2.1343,0.8106,2.4354
2023-09-04 10:55,2980,1543,1437,261765,147190,114575,237445743.0,119603111.0,117842632.0,2585,1338,1247,243099,137780,105319,222307043.0,111659492.0,110647550.0,0.8126,1.0285,0.8104,1.0506
2023-09-04 11:00,2795,1663,1132,280028,154757,125271,264424731.0,125664973.0,138759757.0,2495,1493,1002,266420,149450,116970,253624658.0,121268619.0,132356039.0,0.812,1.1077,0.8114,1.1315
2023-09-04 11:05,3497,1020,2477,370288,78247,292041,435981119.0,63358757.0,372622361.0,3165,828,2337,354052,71954,282098,422773627.0,58097631.0,364675996.0,0.8097,1.2759,0.8074,1.2927
2023-09-04 11:10,1996,775,1221,203499,93938,109561,189958065.0,76118270.0,113839795.0,1819,709,1110,192410,90129,102281,180875273.0,72944083.0,107931190.0,0.8103,1.0391,0.8093,1.0552
2023-09-04 11:15,3199,1352,1847,326835,107894,218941,326462195.0,87331853.0,239130342.0,2898,1199,1699,306289,98452,207837,310004995.0,79599034.0,230405961.0,0.8094,1.0922,0.8085,1.1086
2023-09-04 11:20,2316,920,1396,193403,52352,141051,181381814.0,42394815.0,138986998.0,2116,808,1308,186602,48301,138301,175932961.0,39024331.0,136908630.0,0.8098,0.9854,0.8079,0.9899
2023-09-04 11:25,1016,360,656,58005,26652,31353,60824488.0,21488109.0,39336379.0,881,297,584,47463,24650,22813,50669799.0,19848068.0,30821731.0,0.8062,1.2546,0.8052,1.3511
2023-09-04 11:30,1754,859,895,128699,57233,71466,127724076.0,46100451.0,81623624.0,1503,723,780,115834,52348,63486,117999986.0,42125343.0,75874643.0,0.8055,1.1421,0.8047,1.1951
2023-09-04 11:35,1779,713,1066,129836,70867,58969,130054144.0,57945632.0,72108512.0,1550,564,986,122308,62805,59503,123936042.0,51230662.0,72705379.0,0.8177,1.2228,0.8157,1.2219
2023-09-04 11:40,2501,859,1642,194398,44759,149639,168423301.0,36201910.0,132221390.0,2306,751,1555,184177,40664,143513,160790799.0,32674393.0,128116405.0,0.8088,0.8836,0.8035,0.8927
2023-09-04 11:45,1656,1253,403,183529,157810,25719,183355747.0,125699087.0,57656659.0,1471,1164,307,155417,135726,19691,162009834.0,109253316.0,52756518.0,0.7965,2.2418,0.805,2.6792
2023-09-04 11:50,1525,1180,345,198004,180032,17972,159555858.0,145036645.0,14519213.0,1432,1134,298,195805,178239,17566,157786544.0,143560100.0,14226444.0,0.8056,0.8079,0.8054,0.8099
2023-09-04 11:55,3132,2034,1098,347905,231098,116807,334558112.0,187555175.0,147002937.0,2920,1981,939,292816,217100,75716,286595784.0,175554891.0,111040892.0,0.8116,1.2585,0.8086,1.4665
2023-09-04 12:00,1993,927,1066,170468,53752,116716,175359668.0,43645987.0,131713681.0,1749,776,973,159129,47359,111770,166406432.0,38294530.0,128111902.0,0.812,1.1285,0.8086,1.1462
2023-09-04 12:05,2079,1084,995,172440,99742,72698,166382267.0,82701005.0,83681262.0,1840,938,902,186958,89478,97480,180902515.0,74276063.0,106626452.0,0.8291,1.1511,0.8301,1.0938
2023-09-04 12:10,2448,1168,1280,222898,126882,96016,271224298.0,105867727.0,165356571.0,2044,996,1048,196530,113946,82584,247448398.0,92755979.0,154692418.0,0.8344,1.7222,0.814,1.8732
2023-09-04 12:15,1271,680,591,102483,64102,38381,96206264.0,52268933.0,43937331.0,1095,591,504,90047,60472,29575,85902255.0,49238745.0,36663510.0,0.8154,1.1448,0.8142,1.2397
2023-09-04 12:20,1522,896,626,113375,69570,43805,92255319.0,56642407.0,35612911.0,1391,823,568,106476,68779,37697,86738161.0,55919874.0,30818286.0,0.8142,0.813,0.813,0.8175
2023-09-04 12:25,1366,692,674,104687,60198,44489,109993176.0,49015666.0,60977510.0,1265,646,619,101633,56292,45341,107589975.0,45761690.0,61828285.0,0.8142,1.3706,0.8129,1.3636
2023-09-04 12:30,1102,505,597,65812,24311,41501,53665899.0,19851242.0,33814656.0,948,438,510,51269,19802,31467,41827513.0,16092541.0,25734971.0,0.8166,0.8148,0.8127,0.8178
2023-09-04 12:35,571,178,393,41520,13885,27635,46118329.0,11288122.0,34830207.0,490,145,345,38687,13707,24980,43935122.0,11122845.0,32812277.0,0.813,1.2604,0.8115,1.3135
2023-09-04 12:40,654,238,416,50489,14249,36240,41045131.0,11605644.0,29439487.0,545,185,360,43257,12463,30794,35233665.0,10118404.0,25115261.0,0.8145,0.8123,0.8119,0.8156
2023-09-04 12:45,2534,1079,1455,219007,57047,161960,190279146.0,46287323.0,143991822.0,2393,1001,1392,211493,52856,158637,184372322.0,42870997.0,141501325.0,0.8114,0.8891,0.8111,0.892
2023-09-04 12:50,3936,1653,2283,434012,156174,277838,416269147.0,127608211.0,288660936.0,3754,1560,2194,417225,145443,271782,402076038.0,118230025.0,283846013.0,0.8171,1.039,0.8129,1.0444
2023-09-04 12:55,2436,1193,1243,228954,89277,139677,186559744.0,72554232.0,114005512.0,2369,1163,1206,223219,89607,133612,181880074.0,72799398.0,109080676.0,0.8127,0.8162,0.8124,0.8164
2023-09-04 13:00,1857,707,1150,190212,55785,134427,154835553.0,45270747.0,109564806.0,1755,653,1102,184925,53442,131483,150646509.0,43310986.0,107335522.0,0.8115,0.8151,0.8104,0.8163
2023-09-04 13:05,985,419,566,120046,33933,86113,110094043.0,27464133.0,82629909.0,885,377,508,117584,33267,84317,108047139.0,26806312.0,81240826.0,0.8094,0.9596,0.8058,0.9635
2023-09-04 13:10,1003,387,616,112052,33079,78973,91217941.0,26753755.0,64464186.0,921,340,581,109048,31576,77472,88964271.0,25504878.0,63459393.0,0.8088,0.8163,0.8077,0.8191
2023-09-04 13:15,2106,1169,937,221736,102088,119648,231185334.0,83827949.0,147357385.0,1995,1111,884,208994,91151,117843,220003864.0,74136424.0,145867439.0,0.8211,1.2316,0.8133,1.2378
2023-09-04 13:20,1847,1354,493,224349,185643,38706,195434666.0,151461788.0,43972877.0,1683,1295,388,211317,182090,29227,184850063.0,148455703.0,36394359.0,0.8159,1.1361,0.8153,1.2452
2023-09-04 13:25,564,310,254,46127,27075,19052,37609592.0,22085535.0,15524057.0,480,260,220,42383,22982,19401,34599051.0,18713738.0,15885313.0,0.8157,0.8148,0.8143,0.8188
2023-09-04 13:30,877,635,242,58679,49878,8801,47901436.0,40736726.0,7164710.0,793,589,204,57896,46644,11252,47276382.0,38065182.0,9211199.0,0.8167,0.8141,0.8161,0.8186
2023-09-04 13:35,1706,996,710,143020,98048,44972,141981410.0,80193986.0,61787424.0,1518,885,633,127321,88192,39129,129122336.0,71985919.0,57136417.0,0.8179,1.3739,0.8162,1.4602
2023-09-04 13:40,1001,579,422,60256,36517,23739,61716213.0,29896405.0,31819808.0,801,482,319,48422,29690,18732,52217587.0,24241153.0,27976433.0,0.8187,1.3404,0.8165,1.4935
2023-09-04 13:45,3110,1837,1273,291747,215721,76026,329097529.0,178524428.0,150573100.0,2336,1454,882,240566,187771,52795,285922832.0,154413044.0,131509788.0,0.8276,1.9805,0.8223,2.491
2023-09-04 13:50,1295,670,625,100272,56872,43400,95823632.0,47228384.0,48595248.0,874,436,438,75379,41201,34178,74928350.0,33927728.0,41000622.0,0.8304,1.1197,0.8235,1.1996
2023-09-04 13:55,2124,971,1153,290809,129239,161570,253680372.0,106725611.0,146954760.0,1885,864,1021,278223,125252,152971,244129661.0,102996369.0,141133291.0,0.8258,0.9095,0.8223,0.9226
2023-09-04 14:00,2254,872,1382,228199,88495,139704,212251959.0,72989694.0,139262265.0,2007,751,1256,204271,77535,126736,193776356.0,63911933.0,129864423.0,0.8248,0.9968,0.8243,1.0247
2023-09-04 14:05,1594,718,876,160941,77045,83896,145569457.0,63659397.0,81910060.0,1466,659,807,152101,73149,78952,138158601.0,60353124.0,77805477.0,0.8263,0.9763,0.8251,0.9855
2023-09-04 14:10,812,586,226,72806,34996,37810,60026832.0,28902713.0,31124118.0,712,547,165,51949,28649,23300,42888592.0,23608631.0,19279961.0,0.8259,0.8232,0.8241,0.8275
2023-09-04 14:15,1606,643,963,194248,62058,132190,172574308.0,51142837.0,121431471.0,1462,563,899,180402,59035,121367,161233617.0,48576327.0,112657290.0,0.8241,0.9186,0.8228,0.9282
2023-09-04 14:20,1148,632,516,100679,48056,52623,82849481.0,39610368.0,43239112.0,1040,574,466,96126,45623,50503,79199660.0,37535869.0,41663790.0,0.8243,0.8217,0.8227,0.825
2023-09-04 14:25,1898,667,1231,231338,87240,144098,216385882.0,72309923.0,144075958.0,1746,589,1157,232392,79953,152439,216871347.0,65847581.0,151023765.0,0.8289,0.9998,0.8236,0.9907
2023-09-04 14:30,2853,1823,1030,315303,222751,92552,311734738.0,184692851.0,127041887.0,2290,1540,750,276328,201013,75315,279174864.0,166020617.0,113154247.0,0.8291,1.3727,0.8259,1.5024
2023-09-04 14:35,3826,1839,1987,397187,182403,214784,381590626.0,152159945.0,229430681.0,3050,1431,1619,343023,151418,191605,336475010.0,125655272.0,210819738.0,0.8342,1.0682,0.8299,1.1003
2023-09-04 14:40,3448,1891,1557,357826,193240,164586,361869150.0,161452018.0,200417132.0,3030,1690,1340,335272,183198,152074,343195324.0,152580441.0,190614882.0,0.8355,1.2177,0.8329,1.2534
2023-09-04 14:45,1580,776,804,140060,84890,55170,154651660.0,70805691.0,83845968.0,1317,653,664,124624,76587,48037,142004964.0,63770141.0,78234823.0,0.8341,1.5198,0.8326,1.6286
2023-09-04 14:50,2070,1409,661,256574,192418,64156,226311975.0,160552785.0,65759189.0,1756,1240,516,225959,178183,47776,200943985.0,148336104.0,52607880.0,0.8344,1.025,0.8325,1.1011
2023-09-04 14:55,1989,1156,833,196898,132803,64095,177562492.0,111243205.0,66319286.0,1636,938,698,169827,116954,52873,154531242.0,97481286.0,57049956.0,0.8377,1.0347,0.8335,1.079
2023-09-04 15:00,1687,867,820,184681,96287,88394,167338827.0,80565101.0,86773725.0,1453,745,708,158936,82498,76438,145627183.0,68595572.0,77031610.0,0.8367,0.9817,0.8315,1.0078
2023-09-04 15:05,2251,1111,1140,220334,147323,73011,236047362.0,124037377.0,112009985.0,1650,838,812,179659,126377,53282,201534793.0,105604222.0,95930571.0,0.8419,1.5342,0.8356,1.8004
2023-09-04 15:10,2553,1118,1435,293331,133005,160326,297967546.0,112290182.0,185677364.0,2062,918,1144,249242,117215,132027,261026470.0,98271084.0,162755386.0,0.8443,1.1581,0.8384,1.2327
2023-09-04 15:15,2814,1016,1798,325583,91378,234205,310666735.0,76510204.0,234156531.0,2403,799,1604,285622,65569,220053,278291707.0,54923666.0,223368040.0,0.8373,0.9998,0.8376,1.0151
2023-09-04 15:20,3652,1350,2302,349054,116159,232895,381151686.0,97509316.0,283642369.0,3037,1045,1992,316109,100031,216078,354418279.0,83689513.0,270728766.0,0.8394,1.2179,0.8366,1.2529
2023-09-04 15:25,1935,1125,810,163133,91110,72023,136402493.0,76473178.0,59929314.0,1594,974,620,143063,83163,59900,119814314.0,69565125.0,50249188.0,0.8393,0.8321,0.8365,0.8389
2023-09-04 15:30,1241,537,704,112465,41493,70972,119456099.0,34891748.0,84564350.0,1034,435,599,98621,35757,62864,108230081.0,29948402.0,78281678.0,0.8409,1.1915,0.8376,1.2453
2023-09-04 15:35,1162,370,792,111218,10538,100680,92717729.0,8864713.0,83853016.0,967,277,690,98149,6768,91381,82257090.0,5638186.0,76618903.0,0.8412,0.8329,0.8331,0.8385
2023-09-04 15:40,1636,867,769,183566,118069,65497,192803696.0,99501353.0,93302343.0,1342,696,646,168538,108683,59855,179649733.0,91020696.0,88629037.0,0.8427,1.4245,0.8375,1.4807
2023-09-04 15:45,2836,1106,1730,358511,136019,222492,327383864.0,114924089.0,212459774.0,2441,913,1528,323474,123940,199534,297622393.0,104091811.0,193530581.0,0.8449,0.9549,0.8399,0.9699
2023-09-04 15:50,2823,721,2102,375422,54572,320850,363876898.0,45738326.0,318138572.0,2346,501,1845,331826,34644,297182,328759670.0,28841018.0,299918651.0,0.8381,0.9915,0.8325,1.0092
2023-09-04 15:55,1688,318,1370,255160,16294,238866,225518244.0,13650222.0,211868022.0,1474,198,1276,238369,8504,229865,212106029.0,7084803.0,205021225.0,0.8377,0.887,0.8331,0.8919
2023-09-04 16:00,1943,647,1296,350571,94716,255855,306254825.0,79287260.0,226967565.0,1791,578,1213,337461,88908,248553,295337509.0,74377107.0,220960402.0,0.8371,0.8871,0.8366,0.889
2023-09-04 16:05,1693,172,1521,443734,18357,425377,382714098.0,15386624.0,367327473.0,1544,136,1408,420244,15773,404471,364104247.0,13153423.0,350950823.0,0.8382,0.8635,0.8339,0.8677
2023-09-04 16:10,4646,1996,2650,685722,233418,452304,728267539.0,192855388.0,535412150.0,3827,1557,2270,615579,199102,416477,672999854.0,164050155.0,508949699.0,0.8262,1.1837,0.824,1.222
2023-09-04 16:15,2870,1054,1816,375482,105871,269611,322947775.0,87464981.0,235482793.0,2554,895,1659,364220,100598,263622,313812714.0,82951872.0,230860842.0,0.8261,0.8734,0.8246,0.8757
2023-09-04 16:20,2896,1762,1134,424963,317037,107926,416394924.0,263627633.0,152767290.0,2629,1633,996,400742,299056,101686,395407019.0,247757919.0,147649100.0,0.8315,1.4155,0.8285,1.452
2023-09-04 16:25,2974,1036,1938,400779,140814,259965,358656946.0,116947587.0,241709359.0,2791,945,1846,392143,136800,255343,351878704.0,113575756.0,238302947.0,0.8305,0.9298,0.8302,0.9333
2023-09-04 16:30,1957,985,972,206935,87928,119007,197816858.0,73189445.0,124627413.0,1802,920,882,197722,85214,112508,190298106.0,70825132.0,119472974.0,0.8324,1.0472,0.8311,1.0619
2023-09-04 16:35,1889,1140,749,219594,137406,82188,195427745.0,114627912.0,80799833.0,1742,1051,691,198954,125382,73572,178497571.0,104296601.0,74200970.0,0.8342,0.9831,0.8318,1.0085
2023-09-04 16:40,1575,633,942,158181,46544,111637,180992756.0,38624002.0,142368754.0,1423,560,863,142286,40785,101501,169003827.0,33879009.0,135124818.0,0.8298,1.2753,0.8307,1.3313
2023-09-04 16:45,4174,1921,2253,413837,159092,254745,478690982.0,131166116.0,347524866.0,3605,1627,1978,380142,142883,237259,451203066.0,117429628.0,333773438.0,0.8245,1.3642,0.8219,1.4068
2023-09-04 16:50,3857,1016,2841,395726,35726,360000,413085644.0,29380097.0,383705547.0,3433,734,2699,380045,29893,350152,400820773.0,24522422.0,376298351.0,0.8224,1.0658,0.8203,1.0747
2023-09-04 16:55,5831,3165,2666,590793,294688,296105,800312765.0,243238047.0,557074718.0,4937,2637,2300,518275,258370,259905,740561658.0,212409719.0,528151939.0,0.8254,1.8813,0.8221,2.0321
2023-09-04 17:00,5387,2934,2453,623774,334693,289081,737055053.0,275140102.0,461914951.0,4888,2662,2226,591900,314480,277420,711117875.0,258014737.0,453103138.0,0.8221,1.5979,0.8204,1.6333
2023-09-04 17:05,2942,2300,642,343756,308843,34913,333806791.0,254672107.0,79134684.0,2745,2209,536,329570,302455,27115,321972350.0,249174297.0,72798053.0,0.8246,2.2666,0.8238,2.6848
2023-09-04 17:10,1414,911,503,113467,84881,28586,93361152.0,69804147.0,23557005.0,1319,858,461,107306,84117,23189,88344773.0,69146896.0,19197877.0,0.8224,0.8241,0.822,0.8279
2023-09-04 17:15,774,425,349,52626,34503,18123,43309155.0,28404170.0,14904984.0,697,387,310,56982,34316,22666,46954322.0,28196914.0,18757408.0,0.8232,0.8224,0.8217,0.8276
2023-09-04 17:20,661,302,359,49170,29051,20119,52946201.0,23901284.0,29044917.0,569,256,313,43147,25063,18084,48089477.0,20598913.0,27490564.0,0.8227,1.4437,0.8219,1.5202
2023-09-04 17:25,1968,620,1348,181129,54209,126920,210983697.0,44547423.0,166436274.0,1840,566,1274,171616,50043,121573,203735987.0,41087429.0,162648557.0,0.8218,1.3113,0.821,1.3379
2023-09-04 17:30,1364,246,1118,122018,16020,105998,124976066.0,13132577.0,111843489.0,1247,178,1069,112872,11847,101025,117729388.0,9672257.0,108057130.0,0.8198,1.0551,0.8164,1.0696
2023-09-04 17:35,779,305,474,101231,41494,59737,108444541.0,34230976.0,74213564.0,664,250,414,90650,37303,53347,99730486.0,30659985.0,69070501.0,0.825,1.2423,0.8219,1.2947
2023-09-04 17:40,844,529,315,112221,82745,29476,105375122.0,68405886.0,36969235.0,731,481,250,103032,78883,24149,97598461.0,65007170.0,32591291.0,0.8267,1.2542,0.8241,1.3496
2023-09-04 17:45,1533,1124,409,222380,186328,36052,183711654.0,153957509.0,29754144.0,1411,1061,350,218073,183524,34549,180186477.0,151530731.0,28655745.0,0.8263,0.8253,0.8257,0.8294
2023-09-04 17:50,1111,388,723,156151,54155,101996,141404261.0,44662964.0,96741297.0,1012,341,671,152344,52028,100316,138464670.0,42881775.0,95582895.0,0.8247,0.9485,0.8242,0.9528
2023-09-04 17:55,892,676,216,81986,48664,33322,67728970.0,40148615.0,27580355.0,835,639,196,81470,48360,33110,67297593.0,39883063.0,27414530.0,0.825,0.8277,0.8247,0.828
2023-09-04 18:00,1249,685,564,109794,55930,53864,90633110.0,46178826.0,44454284.0,1174,636,538,106161,53584,52577,87687406.0,44153984.0,43533422.0,0.8257,0.8253,0.824,0.828
2023-09-04 18:05,798,519,279,45403,18850,26553,37606925.0,15634593.0,21972332.0,715,463,252,38872,16587,22285,32095261.0,13637278.0,18457983.0,0.8294,0.8275,0.8222,0.8283
2023-09-04 18:10,706,303,403,48388,14035,34353,39804929.0,11592030.0,28212899.0,603,236,367,43251,11513,31738,35757046.0,9480234.0,26276811.0,0.8259,0.8213,0.8234,0.8279
2023-09-04 18:15,798,515,283,53224,19836,33388,56728001.0,16457634.0,40270367.0,706,462,244,49317,16215,33102,53418399.0,13367547.0,40050852.0,0.8297,1.2061,0.8244,1.2099
2023-09-04 18:20,2932,2051,881,319233,252259,66974,430734668.0,210026285.0,220708383.0,2498,1892,606,296648,239979,56669,411656213.0,199500180.0,212156032.0,0.8326,3.2954,0.8313,3.7438
2023-09-04 18:25,2072,1006,1066,170233,83837,86396,167179547.0,69919873.0,97259674.0,1703,760,943,155843,78665,77178,155207794.0,65339723.0,89868070.0,0.834,1.1257,0.8306,1.1644
2023-09-04 18:30,2477,1474,1003,216498,116780,99718,218075637.0,97147651.0,120927985.0,2268,1346,922,201416,111541,89875,205738799.0,92686090.0,113052709.0,0.8319,1.2127,0.831,1.2579
2023-09-04 18:35,2911,1294,1617,248792,78981,169811,257242408.0,65631238.0,191611169.0,2753,1180,1573,242323,74403,167920,252337310.0,61773152.0,190564157.0,0.831,1.1284,0.8303,1.1349
2023-09-05 10:00,7096,4452,2644,849616,567600,282016,719956476.0,482733142.0,237223334.0,5393,3713,1680,701453,493972,207481,591200798.0,416268321.0,174932477.0,0.8505,0.8412,0.8427,0.8431
2023-09-05 10:05,5120,2382,2738,636720,274675,362045,544431833.0,235830231.0,308601602.0,3682,1654,2028,543032,230092,312940,464712862.0,196181155.0,268531707.0,0.8586,0.8524,0.8526,0.8581
2023-09-05 10:10,3751,1986,1765,462064,264840,197224,397362695.0,228676498.0,168686197.0,2611,1460,1151,354802,207908,146894,305183653.0,178677285.0,126506368.0,0.8635,0.8553,0.8594,0.8612
2023-09-05 10:15,5976,2218,3758,773148,267359,505789,662511309.0,229811162.0,432700146.0,4964,1751,3213,677045,224166,452879,583146363.0,192272880.0,390873482.0,0.8596,0.8555,0.8577,0.8631
2023-09-05 10:20,3953,2430,1523,468738,316586,152152,402678023.0,272178080.0,130499943.0,3297,2094,1203,438851,307426,131425,376937050.0,263750077.0,113186973.0,0.8597,0.8577,0.8579,0.8612
2023-09-05 10:25,2728,1669,1059,328266,236086,92180,281438443.0,202290935.0,79147508.0,2339,1439,900,299270,219119,80151,256664442.0,187707723.0,68956718.0,0.8569,0.8586,0.8566,0.8603
2023-09-05 10:30,1743,901,842,195809,114333,81476,168230356.0,98459565.0,69770790.0,1433,744,689,172887,102912,69975,148554060.0,88201212.0,60352848.0,0.8612,0.8563,0.8571,0.8625
2023-09-05 10:35,5563,3146,2417,626126,275975,350151,536409034.0,236964712.0,299444322.0,5059,2892,2167,595257,255805,339452,510995953.0,219205443.0,291790510.0,0.8586,0.8552,0.8569,0.8596
2023-09-05 10:40,1447,680,767,134279,75856,58423,115131985.0,65083602.0,50048382.0,1199,554,645,127075,71093,55982,109072578.0,60943495.0,48129083.0,0.858,0.8567,0.8572,0.8597
2023-09-05 10:45,2059,1184,875,226766,116270,110496,194893443.0,99804829.0,95088613.0,1835,1052,783,200715,108389,92326,172389583.0,92987157.0,79402426.0,0.8584,0.8606,0.8579,0.86
2023-09-05 10:50,1341,952,389,134189,89299,44890,114687231.0,76362738.0,38324493.0,1096,810,286,123605,84006,39599,105869364.0,71665187.0,34204177.0,0.8551,0.8537,0.8531,0.8638
2023-09-05 10:55,1272,760,512,111954,56530,55424,95316355.0,48291090.0,47025265.0,1083,672,411,107638,50966,56672,92064911.0,43474865.0,48590046.0,0.8543,0.8485,0.853,0.8574
2023-09-05 11:00,3283,1734,1549,331421,129582,201839,282223895.0,110571148.0,171652746.0,3004,1578,1426,302454,120612,181842,258233406.0,102739975.0,155493430.0,0.8533,0.8504,0.8518,0.8551
2023-09-05 11:05,3021,1486,1535,301322,106989,194333,256982404.0,91474724.0,165507680.0,2747,1343,1404,284811,97416,187395,243059453.0,82947641.0,160111811.0,0.855,0.8517,0.8515,0.8544
2023-09-05 11:10,3290,1644,1646,308947,153948,154999,265094944.0,132203303.0,132891641.0,3035,1492,1543,283303,141750,141553,242209256.0,121064504.0,121144751.0,0.8588,0.8574,0.8541,0.8558
2023-09-05 11:15,1556,889,667,135787,93372,42415,116198333.0,79932527.0,36265806.0,1411,815,596,126585,90109,36476,108191904.0,76908847.0,31283057.0,0.8561,0.855,0.8535,0.8576
2023-09-05 11:20,3285,1208,2077,368363,70376,297987,319257424.0,60212301.0,259045123.0,2930,1027,1903,344191,60977,283214,296982109.0,51794634.0,245187475.0,0.8556,0.8693,0.8494,0.8657
2023-09-05 11:25,4048,2076,1972,366674,158124,208550,313981855.0,135519514.0,178462341.0,3344,1705,1639,332358,137311,195047,282325895.0,116520029.0,165805865.0,0.857,0.8557,0.8486,0.8501
2023-09-05 11:30,2964,1024,1940,264719,77328,187391,224652332.0,65494373.0,159157959.0,2738,883,1855,255402,70244,185158,216732137.0,59312637.0,157419499.0,0.847,0.8493,0.8444,0.8502
2023-09-05 11:35,2306,1007,1299,174126,79573,94553,147908548.0,67619238.0,80289309.0,2145,933,1212,165662,73416,92246,140738145.0,62279737.0,78458408.0,0.8498,0.8491,0.8483,0.8505
2023-09-05 11:40,1401,763,638,92038,45707,46331,78332879.0,38935901.0,39396978.0,1291,712,579,85147,43602,41545,73174056.0,37720170.0,35453886.0,0.8519,0.8503,0.8651,0.8534
2023-09-05 11:45,2587,900,1687,209917,38735,171182,178597736.0,32900249.0,145697486.0,2411,792,1619,204217,35684,168533,173843385.0,30261058.0,143582326.0,0.8494,0.8511,0.848,0.852
2023-09-05 11:50,2110,1336,774,140523,85997,54526,119647079.0,73143888.0,46503190.0,2000,1276,724,138819,84848,53971,118133538.0,72075012.0,46058525.0,0.8505,0.8529,0.8495,0.8534
2023-09-05 11:55,1867,1188,679,119208,86634,32574,101797537.0,73944703.0,27852834.0,1718,1110,608,111314,81251,30063,94909950.0,69190742.0,25719208.0,0.8535,0.8551,0.8516,0.8555
2023-09-05 12:00,2322,1456,866,236376,181503,54873,202269660.0,155265447.0,47004213.0,2064,1358,706,217851,172660,45191,186235538.0,147396530.0,38839008.0,0.8554,0.8566,0.8537,0.8594
2023-09-05 12:05,2271,1158,1113,183381,124847,58534,156811093.0,106748383.0,50062709.0,2115,1071,1044,174158,121349,52809,149060144.0,103698882.0,45361261.0,0.855,0.8553,0.8546,0.859
2023-09-05 12:10,948,605,343,78611,67606,11005,67249432.0,57803015.0,9446416.0,867,560,307,75223,65205,10018,64313315.0,55705193.0,8608121.0,0.855,0.8584,0.8543,0.8593
2023-09-05 12:15,2423,1695,728,259669,211676,47993,222725684.0,181585112.0,41140571.0,2306,1626,680,250897,205481,45416,214601390.0,175608268.0,38993121.0,0.8578,0.8572,0.8546,0.8586
2023-09-05 12:20,2014,868,1146,194867,108402,86465,166840792.0,92705303.0,74135488.0,1913,833,1080,188326,105821,82505,161195839.0,90370367.0,70825472.0,0.8552,0.8574,0.854,0.8584
2023-09-05 12:25,995,469,526,109595,34533,75062,93920015.0,29547723.0,64372291.0,907,427,480,103281,32249,71032,88500317.0,27545138.0,60955179.0,0.8556,0.8576,0.8541,0.8581
2023-09-05 12:30,1143,756,387,130967,89898,41069,111793429.0,76609950.0,35183479.0,1076,733,343,127545,87003,40542,109018856.0,74228958.0,34789898.0,0.8522,0.8567,0.8532,0.8581
2023-09-05 12:35,2003,1120,883,252605,123815,128790,214871870.0,105561274.0,109310596.0,1842,1076,766,239378,116222,123156,205086068.0,99758944.0,105327124.0,0.8526,0.8488,0.8583,0.8552
2023-09-05 12:40,5042,2617,2425,586102,280220,305882,490930276.0,235397547.0,255532728.0,4100,2064,2036,525786,255343,270443,442159238.0,213566860.0,228592377.0,0.84,0.8354,0.8364,0.8453
2023-09-05 12:45,4198,2172,2026,411986,182482,229504,347019982.0,153759255.0,193260727.0,3688,1879,1809,383521,167245,216276,322728610.0,140250585.0,182478024.0,0.8426,0.8421,0.8386,0.8437
2023-09-05 12:50,4043,2469,1574,387554,267274,120280,326112105.0,224822249.0,101289856.0,3761,2325,1436,370367,260406,109961,311723151.0,218801998.0,92921153.0,0.8412,0.8421,0.8402,0.845
2023-09-05 12:55,3667,2435,1232,346810,243912,102898,291304038.0,205088491.0,86215546.0,3454,2322,1132,337624,241453,96171,283705843.0,202769114.0,80936729.0,0.8408,0.8379,0.8398,0.8416
2023-09-05 13:00,3144,1168,1976,308367,65273,243094,258835735.0,54870646.0,203965088.0,2853,995,1858,293909,58674,235235,246554196.0,49060097.0,197494099.0,0.8406,0.839,0.8361,0.8396
2023-09-05 13:05,1113,791,322,69170,55985,13185,58013411.0,46951217.0,11062194.0,995,726,269,64346,50669,13677,53941417.0,42427574.0,11513843.0,0.8386,0.839,0.8373,0.8418
2023-09-05 13:10,2412,1265,1147,205777,112475,93302,172708159.0,94585272.0,78122887.0,2194,1156,1038,194390,107820,86570,163008964.0,90284951.0,72724013.0,0.8409,0.8373,0.8374,0.8401
2023-09-05 13:15,4133,1989,2144,366103,142121,223982,303961165.0,118189148.0,185772017.0,3689,1738,1951,347006,133741,213265,288270177.0,110630870.0,177639306.0,0.8316,0.8294,0.8272,0.833
2023-09-05 13:20,3326,922,2404,329085,65335,263750,274261310.0,54168452.0,220092858.0,3069,773,2296,306276,59322,246954,255311365.0,49241401.0,206069964.0,0.8291,0.8345,0.8301,0.8344
2023-09-05 13:25,3344,1816,1528,331399,179596,151803,276834572.0,149940672.0,126893900.0,3117,1687,1430,328077,173926,154151,274034133.0,144913621.0,129120511.0,0.8349,0.8359,0.8332,0.8376
2023-09-05 13:30,2071,1140,931,183455,126586,56869,152979494.0,105436468.0,47543026.0,1940,1064,876,179067,123420,55647,149379189.0,102765823.0,46613365.0,0.8329,0.836,0.8327,0.8377
2023-09-05 13:35,2363,1740,623,223385,181879,41506,188235358.0,153404889.0,34830468.0,2128,1621,507,203003,165449,37554,170645415.0,138983981.0,31661434.0,0.8434,0.8392,0.84,0.8431
2023-09-05 13:40,3032,1230,1802,291295,101653,189642,245649060.0,85649243.0,159999817.0,2860,1136,1724,275442,98054,177388,232355900.0,82494324.0,149861576.0,0.8426,0.8437,0.8413,0.8448
2023-09-05 13:45,1442,742,700,100699,37436,63263,85169208.0,31350774.0,53818434.0,1323,675,648,85897,34899,50998,72093265.0,29219235.0,42874030.0,0.8374,0.8507,0.8373,0.8407
2023-09-05 13:50,1738,538,1200,164026,30247,133779,137401367.0,25227482.0,112173884.0,1650,477,1173,162486,23462,139024,136244083.0,19561006.0,116683076.0,0.834,0.8385,0.8337,0.8393
2023-09-05 13:55,1959,970,989,174572,40783,133789,147635686.0,35088272.0,112547414.0,1836,891,945,166993,35467,131526,140361135.0,29680352.0,110680782.0,0.8604,0.8412,0.8368,0.8415
2023-09-05 14:00,2629,940,1689,244724,48564,196160,205445289.0,40640439.0,164804849.0,2513,870,1643,239158,46885,192273,201108936.0,39256234.0,161852701.0,0.8368,0.8402,0.8373,0.8418
2023-09-05 14:05,2129,974,1155,174427,41719,132708,146535532.0,34960361.0,111575171.0,2051,929,1122,170878,39791,131087,143612512.0,33321165.0,110291347.0,0.838,0.8408,0.8374,0.8414
2023-09-05 14:10,2487,2037,450,224679,209882,14797,188533008.0,176083255.0,12449753.0,2437,2014,423,223608,208915,14693,187637266.0,175247036.0,12390230.0,0.839,0.8414,0.8388,0.8433
2023-09-05 14:15,2659,1429,1230,227817,160055,67762,190957223.0,134117992.0,56839230.0,2551,1375,1176,223876,159511,64365,187674920.0,133554821.0,54120099.0,0.8379,0.8388,0.8373,0.8408
2023-09-05 14:20,1974,1110,864,161885,85926,75959,136031058.0,72079046.0,63952011.0,1912,1066,846,160559,84454,76105,134820425.0,70747260.0,64073165.0,0.8389,0.8419,0.8377,0.8419
2023-09-05 14:25,3143,1561,1582,262488,150390,112098,220631494.0,126256492.0,94375002.0,3038,1499,1539,254345,147805,106540,213691554.0,123942344.0,89749209.0,0.8395,0.8419,0.8386,0.8424
2023-09-05 14:30,2676,1171,1505,242275,138205,104070,203795520.0,115969750.0,87825769.0,2600,1130,1470,239158,135848,103310,201300371.0,114111388.0,87188982.0,0.8391,0.8439,0.84,0.844
2023-09-05 14:35,1620,569,1051,119229,33503,85726,100236490.0,28124677.0,72111813.0,1563,538,1025,118184,33675,84509,99308582.0,28068976.0,71239605.0,0.8395,0.8412,0.8335,0.843
2023-09-05 14:40,3251,1649,1602,260655,120589,140066,218876956.0,101102439.0,117774516.0,3175,1603,1572,258825,119330,139495,217426164.0,100015001.0,117411163.0,0.8384,0.8409,0.8381,0.8417
2023-09-05 14:45,2795,1417,1378,217512,92023,125489,183068200.0,77517497.0,105550703.0,2711,1381,1330,216254,90316,125938,182690807.0,76709333.0,105981474.0,0.8424,0.8411,0.8493,0.8415
2023-09-05 14:50,1286,706,580,95610,73314,22296,80366938.0,61600707.0,18766231.0,1210,670,540,93079,72218,20861,78146520.0,60585747.0,17560773.0,0.8402,0.8417,0.8389,0.8418
2023-09-05 14:55,1725,1285,440,175253,142452,32801,146966931.0,119373961.0,27592970.0,1666,1257,409,171850,140484,31366,144268485.0,117836110.0,26432374.0,0.838,0.8412,0.8388,0.8427
2023-09-05 15:00,2070,1531,539,183459,154493,28966,154230375.0,129797759.0,24432615.0,1994,1493,501,181699,153393,28306,152657504.0,128776222.0,23881282.0,0.8402,0.8435,0.8395,0.8437
2023-09-05 15:05,1541,1133,408,169991,140225,29766,143180156.0,118012607.0,25167548.0,1448,1085,363,159956,137906,22050,134434560.0,115789194.0,18645366.0,0.8416,0.8455,0.8396,0.8456
2023-09-05 15:10,1274,949,325,109604,99394,10210,92009279.0,83475677.0,8533601.0,1197,907,290,104519,95978,8541,87935040.0,80724336.0,7210704.0,0.8398,0.8358,0.8411,0.8442
2023-09-05 15:15,3102,1783,1319,296556,153654,142902,249234519.0,129186050.0,120048468.0,3004,1732,1272,291622,152232,139390,245433991.0,127962082.0,117471909.0,0.8408,0.8401,0.8406,0.8428
2023-09-05 15:20,2920,1481,1439,252794,87610,165184,212683830.0,73601379.0,139082451.0,2844,1442,1402,248485,86765,161720,209124521.0,72872802.0,136251718.0,0.8401,0.842,0.8399,0.8425
2023-09-05 15:25,2167,1012,1155,169774,82777,86997,142924534.0,69584469.0,73340064.0,2136,999,1137,171085,81590,89495,144014858.0,68565760.0,75449097.0,0.8406,0.843,0.8404,0.8431
2023-09-05 15:30,1180,1012,168,132542,120064,12478,111505065.0,100963745.0,10541320.0,1106,979,127,117042,108652,8390,98430399.0,91335151.0,7095248.0,0.8409,0.8448,0.8406,0.8457
2023-09-05 15:35,406,156,250,29319,16078,13241,24779992.0,13641649.0,11138343.0,343,121,222,23805,13260,10545,20052371.0,11140911.0,8911459.0,0.8485,0.8412,0.8402,0.8451
2023-09-05 15:40,1862,1331,531,188183,153238,34945,158308383.0,128913014.0,29395368.0,1856,1357,499,184295,153777,30518,154946755.0,129199526.0,25747228.0,0.8413,0.8412,0.8402,0.8437
2023-09-05 15:45,1350,889,461,98068,68803,29265,82375354.0,57872410.0,24502944.0,1298,865,433,97851,68831,29020,82252721.0,57751148.0,24501572.0,0.8411,0.8373,0.839,0.8443
2023-09-05 15:50,2758,2388,370,342512,320957,21555,288314334.0,270139847.0,18174486.0,2709,2357,352,338475,317906,20569,284910750.0,267565501.0,17345249.0,0.8417,0.8432,0.8416,0.8433
2023-09-05 15:55,4396,3022,1374,523881,398065,125816,443642593.0,336997629.0,106644964.0,4133,2902,1231,489503,375812,113691,413843886.0,317090780.0,96753105.0,0.8466,0.8476,0.8437,0.851
2023-09-05 16:00,3160,2123,1037,327539,254800,72739,278518671.0,216551889.0,61966781.0,2902,2026,876,310880,248627,62253,264428216.0,211216375.0,53211841.0,0.8499,0.8519,0.8495,0.8548
2023-09-05 16:05,1252,925,327,106409,82653,23756,90407395.0,70121445.0,20285950.0,1168,884,284,101127,80457,20670,85889678.0,68203506.0,17686171.0,0.8484,0.8539,0.8477,0.8556
2023-09-05 16:10,1005,582,423,67006,43539,23467,57079890.0,37144982.0,19934907.0,923,542,381,64311,42003,22308,54753861.0,35684094.0,19069767.0,0.8531,0.8495,0.8496,0.8548
2023-09-05 16:15,2149,1240,909,185940,137310,48630,157976304.0,116535065.0,41441238.0,2075,1209,866,183688,134924,48764,156121553.0,114449599.0,41671953.0,0.8487,0.8522,0.8483,0.8546
2023-09-05 16:20,721,268,453,61747,36414,25333,52403296.0,30856040.0,21547256.0,668,236,432,58960,34114,24846,50080052.0,28878361.0,21201690.0,0.8474,0.8506,0.8465,0.8533
2023-09-05 16:25,3167,1096,2071,357116,80114,277002,302255237.0,67702482.0,234552754.0,2965,979,1986,346379,76637,269742,293858267.0,64697195.0,229161071.0,0.8451,0.8468,0.8442,0.8496
2023-09-05 16:30,2080,1068,1012,197801,78750,119051,167830644.0,66647463.0,101183181.0,2001,1024,977,193825,78030,115795,164401385.0,65989265.0,98412120.0,0.8463,0.8499,0.8457,0.8499
2023-09-05 16:35,2137,701,1436,221649,47009,174640,187960875.0,39728353.0,148232522.0,2061,653,1408,217629,45149,172480,184652876.0,38186718.0,146466158.0,0.8451,0.8488,0.8458,0.8492
2023-09-05 16:40,1349,553,796,112874,31014,81860,95716786.0,26230215.0,69486571.0,1296,522,774,111665,30243,81422,94712043.0,25559626.0,69152417.0,0.8458,0.8488,0.8451,0.8493
2023-09-05 16:45,2855,1057,1798,313164,101799,211365,265470954.0,86030894.0,179440060.0,2792,1020,1772,312016,101710,210306,264488600.0,85922240.0,178566359.0,0.8451,0.849,0.8448,0.8491
2023-09-05 16:50,2535,1595,940,262442,190325,72117,222305791.0,161103586.0,61202205.0,2471,1555,916,259575,187665,71910,219801110.0,158695267.0,61105843.0,0.8465,0.8487,0.8456,0.8498
2023-09-05 16:55,3301,1940,1361,347671,275617,72054,294375928.0,233192799.0,61183129.0,3246,1916,1330,344025,273390,70635,291127414.0,231140393.0,59987020.0,0.8461,0.8491,0.8455,0.8493
2023-09-05 17:00,2925,1284,1641,305243,143980,161263,258370950.0,121709149.0,136661801.0,2867,1256,1611,301214,143122,158092,255179591.0,120980820.0,134198771.0,0.8453,0.8474,0.8453,0.8489
2023-09-05 17:05,3095,1753,1342,323010,187326,135684,273914576.0,158728431.0,115186144.0,3010,1707,1303,314955,182648,132307,266818897.0,154499705.0,112319192.0,0.8473,0.8489,0.8459,0.8489
2023-09-05 17:10,1706,1069,637,163063,113746,49317,138150861.0,96272062.0,41878799.0,1644,1038,606,160098,113298,46800,135643837.0,95865598.0,39778239.0,0.8464,0.8492,0.8461,0.85
2023-09-05 17:15,2007,1567,440,224765,195049,29716,190620140.0,165327289.0,25292850.0,1942,1535,407,220586,192062,28524,187056145.0,162756165.0,24299980.0,0.8476,0.8512,0.8474,0.8519
2023-09-05 17:20,329,196,133,34687,27558,7129,29441575.0,23367529.0,6074046.0,266,165,101,31638,25614,6024,26839905.0,21649531.0,5190374.0,0.8479,0.852,0.8452,0.8616
2023-09-05 17:25,2294,1447,847,212588,160279,52309,180045613.0,135741270.0,44304343.0,2198,1400,798,206381,158461,47920,174847834.0,134099630.0,40748203.0,0.8469,0.847,0.8463,0.8503
2023-09-05 17:30,2919,497,2422,372438,42200,330238,315652106.0,35655249.0,279996856.0,2823,446,2377,367657,40432,327225,311926301.0,34143878.0,277782423.0,0.8449,0.8479,0.8445,0.8489
2023-09-05 17:35,2657,526,2131,354740,50967,303773,300964536.0,43159297.0,257805239.0,2596,490,2106,350547,47779,302768,297406564.0,40332219.0,257074345.0,0.8468,0.8487,0.8441,0.8491
2023-09-05 17:40,2440,403,2037,247732,48207,199525,209808158.0,40712281.0,169095877.0,2381,376,2005,246156,47597,198559,208722658.0,40173628.0,168549030.0,0.8445,0.8475,0.844,0.8489
2023-09-05 17:45,2142,823,1319,195299,66464,128835,165577530.0,56216468.0,109361061.0,2092,797,1295,194271,65760,128511,164650524.0,55543194.0,109107329.0,0.8458,0.8488,0.8446,0.849
2023-09-05 17:50,2536,775,1761,298576,98898,199678,252951262.0,83560597.0,169390665.0,2470,739,1731,294389,96993,197396,249377055.0,81883270.0,167493785.0,0.8449,0.8483,0.8442,0.8485
2023-09-05 17:55,2083,871,1212,279755,97946,181809,237197513.0,82970197.0,154227316.0,2021,837,1184,274025,94798,179227,232400206.0,80240190.0,152160016.0,0.8471,0.8483,0.8464,0.849
2023-09-05 18:00,2701,1156,1545,233217,109777,123440,197697253.0,92980310.0,104716943.0,2625,1103,1522,229728,107735,121993,194798723.0,91195222.0,103603501.0,0.847,0.8483,0.8465,0.8493
2023-09-05 18:05,2947,1065,1882,280571,51342,229229,236577738.0,43387274.0,193190463.0,2788,978,1810,270457,49542,220915,229034802.0,41751146.0,187283656.0,0.8451,0.8428,0.8427,0.8478
2023-09-05 18:10,3752,1346,2406,403733,83014,320719,340565720.0,69942317.0,270623403.0,3602,1260,2342,386519,77224,309295,326557056.0,65044055.0,261513001.0,0.8425,0.8438,0.8423,0.8455
2023-09-05 18:15,3153,1150,2003,323007,113276,209731,273241114.0,95917453.0,177323660.0,3005,1076,1929,303094,101873,201221,256100881.0,85902991.0,170197890.0,0.8468,0.8455,0.8432,0.8458
2023-09-05 18:20,2889,919,1970,294749,36827,257922,249212300.0,31198754.0,218013546.0,2812,873,1939,292830,35205,257625,247462369.0,29684437.0,217777931.0,0.8472,0.8453,0.8432,0.8453
2023-09-05 18:25,2022,1388,634,160670,113155,47515,135615144.0,95484914.0,40130230.0,1963,1357,606,156743,110582,46161,132395758.0,93311417.0,39084341.0,0.8438,0.8446,0.8438,0.8467
2023-09-05 18:30,876,459,417,65497,21826,43671,55364701.0,18421854.0,36942847.0,806,426,380,63413,19715,43698,53653819.0,16619333.0,37034486.0,0.844,0.8459,0.843,0.8475
2023-09-05 18:35,1513,821,692,138878,77535,61343,117473500.0,65554573.0,51918926.0,1418,767,651,133800,74309,59491,113196100.0,62761608.0,50434492.0,0.8455,0.8464,0.8446,0.8478
2023-09-06 10:00,4942,1176,3766,660817,93923,566894,558571128.0,78712218.0,479858909.0,4375,870,3505,621733,70166,551567,526121734.0,59038253.0,467083480.0,0.8381,0.8465,0.8414,0.8468
2023-09-06 10:05,3017,1076,1941,299717,74294,225423,251666219.0,62343417.0,189322802.0,2467,772,1695,258894,63676,195218,217545692.0,53221506.0,164324185.0,0.8391,0.8399,0.8358,0.8417
2023-09-06 10:10,2692,1499,1193,203465,92071,111394,170275791.0,76985852.0,93289938.0,2197,1189,1008,180618,77725,102893,151107520.0,64773796.0,86333723.0,0.8362,0.8375,0.8334,0.8391
2023-09-06 10:15,3898,2552,1346,321712,208678,113034,269575853.0,174901595.0,94674257.0,3439,2242,1197,292233,190907,101326,244729022.0,159668779.0,85060243.0,0.8381,0.8376,0.8364,0.8395
2023-09-06 10:20,1903,1037,866,107808,65779,42029,90388252.0,55123238.0,35265014.0,1630,895,735,100075,60385,39690,84090626.0,50554146.0,33536479.0,0.838,0.8391,0.8372,0.845
2023-09-06 10:25,4852,1337,3515,448977,78859,370118,372759166.0,66131578.0,306627587.0,4159,969,3190,399629,62456,337173,333213644.0,51882517.0,281331126.0,0.8386,0.8285,0.8307,0.8344
2023-09-06 10:30,3610,2030,1580,242498,135269,107229,207470918.0,119432655.0,88038262.0,2778,1493,1285,200934,113178,87756,164728186.0,92445532.0,72282654.0,0.8829,0.821,0.8168,0.8237
2023-09-06 10:35,1268,743,525,134469,55281,79188,115237761.0,49818305.0,65419456.0,995,592,403,122591,49520,73071,113299426.0,52936922.0,60362503.0,0.9012,0.8261,1.069,0.8261
2023-09-06 10:40,3047,831,2216,248720,47535,201185,205888857.0,39235764.0,166653093.0,2804,696,2108,236131,42645,193486,195836282.0,35118413.0,160717869.0,0.8254,0.8284,0.8235,0.8306
2023-09-06 10:45,3319,1420,1899,286142,102358,183784,238207591.0,85033166.0,153174425.0,3076,1287,1789,266644,90626,176018,222051603.0,75260753.0,146790850.0,0.8307,0.8334,0.8305,0.834
2023-09-06 10:50,4295,1521,2774,424889,124975,299914,353489842.0,103858094.0,249631747.0,4058,1395,2663,407449,118921,288528,339321608.0,98741281.0,240580326.0,0.831,0.8323,0.8303,0.8338
2023-09-06 10:55,5430,1821,3609,611546,125188,486358,506681601.0,103732856.0,402948744.0,5121,1618,3503,594473,112441,482032,492442500.0,92795904.0,399646595.0,0.8286,0.8285,0.8253,0.8291
2023-09-06 11:00,5014,3663,1351,537506,475158,62348,446066933.0,394019852.0,52047080.0,4806,3584,1222,533958,477145,56813,442668969.0,395220896.0,47448073.0,0.8292,0.8348,0.8283,0.8352
2023-09-06 11:05,3225,2345,880,322381,285350,37031,267330032.0,236414525.0,30915506.0,3130,2292,838,319523,282978,36545,264884173.0,234341731.0,30542441.0,0.8285,0.8349,0.8281,0.8357
2023-09-06 11:10,3398,2706,692,417877,392231,25646,348371175.0,326909109.0,21462066.0,3190,2623,567,405953,386940,19013,337790851.0,321843099.0,15947752.0,0.8335,0.8369,0.8318,0.8388
2023-09-06 11:15,2788,2270,518,337904,319900,18004,281185402.0,266222508.0,14962894.0,2704,2218,486,333199,318177,15022,277337743.0,264749756.0,12587987.0,0.8322,0.8311,0.8321,0.838
2023-09-06 11:20,2400,1018,1382,204882,58903,145979,175758216.0,53878927.0,121879289.0,2276,941,1335,195466,54459,141007,163233454.0,45273565.0,117959888.0,0.9147,0.8349,0.8313,0.8366
2023-09-06 11:25,1779,464,1315,204366,10329,194037,170792588.0,8653071.0,162139517.0,1666,405,1261,201747,9328,192419,168547835.0,7745377.0,160802458.0,0.8377,0.8356,0.8303,0.8357
2023-09-06 11:30,2984,913,2071,313750,36100,277650,261818672.0,30159670.0,231659002.0,2920,876,2044,310508,34250,276258,259810169.0,29162462.0,230647707.0,0.8354,0.8344,0.8515,0.8349
2023-09-06 11:35,2467,342,2125,278751,9266,269485,232457008.0,7677138.0,224779869.0,2392,299,2093,274199,8223,265976,228689493.0,6796983.0,221892509.0,0.8285,0.8341,0.8266,0.8343
2023-09-06 11:40,3348,1153,2195,420331,76543,343788,354585107.0,68936102.0,285649004.0,3172,1047,2125,407341,69146,338195,343524747.0,61863217.0,281661529.0,0.9006,0.8309,0.8947,0.8328
2023-09-06 11:45,3174,625,2549,241220,39671,201549,201156836.0,33500247.0,167656589.0,3056,565,2491,234633,34774,199859,200706111.0,34389534.0,166316576.0,0.8445,0.8318,0.9889,0.8322
2023-09-06 11:50,3793,1096,2697,309689,51557,258132,260342922.0,45513708.0,214829214.0,3697,1051,2646,308589,53128,255461,256352067.0,43857858.0,212494209.0,0.8828,0.8322,0.8255,0.8318
2023-09-06 11:55,1705,826,879,171814,56278,115536,142483968.0,46560414.0,95923554.0,1589,761,828,169147,55366,113781,140294438.0,45778305.0,94516133.0,0.8273,0.8302,0.8268,0.8307
2023-09-06 12:00,1484,788,696,80640,35675,44965,71390410.0,34029357.0,37361053.0,1372,726,646,73997,35478,38519,64151002.0,32094363.0,32056639.0,0.9539,0.8309,0.9046,0.8322
2023-09-06 12:05,813,473,340,31889,8896,22993,26458444.0,7516358.0,18942086.0,693,414,279,25397,6712,18685,21054185.0,5531537.0,15522647.0,0.8449,0.8238,0.8241,0.8308
2023-09-06 12:10,1177,617,560,92068,19590,72478,75935850.0,16158899.0,59776950.0,1065,554,511,91942,21601,70341,75937643.0,17784438.0,58153204.0,0.8249,0.8248,0.8233,0.8267
2023-09-06 12:15,1236,540,696,121340,40554,80786,100197451.0,33501350.0,66696101.0,1142,488,654,117070,37204,79866,96567418.0,30603862.0,65963555.0,0.8261,0.8256,0.8226,0.8259
2023-09-06 12:20,566,364,202,59348,46789,12559,49015257.0,38624161.0,10391095.0,504,327,177,57903,45285,12618,47734024.0,37282035.0,10451989.0,0.8255,0.8274,0.8233,0.8283
2023-09-06 12:25,708,662,46,59473,56574,2899,49140672.0,46743012.0,2397659.0,646,625,21,58248,55700,2548,48056885.0,45911923.0,2144962.0,0.8262,0.8271,0.8243,0.8418
2023-09-06 12:30,954,886,68,92630,89150,3480,76468323.0,73596977.0,2871345.0,881,846,35,87810,85272,2538,72465213.0,70349212.0,2116001.0,0.8255,0.8251,0.825,0.8337
2023-09-06 12:35,224,100,124,15690,8098,7592,12989447.0,6707705.0,6281741.0,148,71,77,11983,5545,6438,9937476.0,4567941.0,5369535.0,0.8283,0.8274,0.8238,0.834
2023-09-06 12:40,2929,2169,760,304818,253634,51184,257791183.0,211598467.0,46192716.0,2736,2057,679,290429,243662,46767,244837130.0,202857888.0,41979242.0,0.8343,0.9025,0.8325,0.8976
2023-09-06 12:45,1463,737,726,111288,54110,57178,93511196.0,45418999.0,48092196.0,1335,677,658,98634,49196,49438,83093248.0,41076247.0,42017001.0,0.8394,0.8411,0.835,0.8499
2023-09-06 12:50,2852,1368,1484,215787,105766,110021,180182573.0,88271355.0,91911217.0,2748,1305,1443,211576,104655,106921,176811683.0,87298504.0,89513179.0,0.8346,0.8354,0.8342,0.8372
2023-09-06 12:55,1898,1006,892,134806,81430,53376,112532166.0,67887563.0,44644603.0,1859,987,872,133675,80396,53279,111599755.0,67014126.0,44585629.0,0.8337,0.8364,0.8336,0.8368
2023-09-06 13:00,1769,881,888,121639,72401,49238,101529086.0,60351869.0,41177217.0,1724,857,867,120147,72208,47939,100280674.0,60196679.0,40083995.0,0.8336,0.8363,0.8337,0.8361
2023-09-06 13:05,1453,738,715,97065,44166,52899,81006782.0,36798040.0,44208741.0,1406,713,693,96442,43586,52856,80552753.0,36318692.0,44234061.0,0.8332,0.8357,0.8333,0.8369
2023-09-06 13:10,1051,492,559,76222,23759,52463,63627881.0,19802826.0,43825054.0,988,458,530,75325,23810,51515,63622896.0,20511216.0,43111679.0,0.8335,0.8354,0.8615,0.8369
2023-09-06 13:15,462,101,361,45253,3606,41647,37883935.0,3068680.0,34815254.0,404,75,329,43752,2724,41028,36595890.0,2260580.0,34335309.0,0.851,0.836,0.8299,0.8369
2023-09-06 13:20,1392,582,810,114184,19854,94330,95101474.0,16481607.0,78619866.0,1333,555,778,111327,19529,91798,92747297.0,16195472.0,76551824.0,0.8301,0.8335,0.8293,0.8339
2023-09-06 13:25,3456,1066,2390,366317,49930,316387,304950551.0,41963116.0,262987435.0,3329,997,2332,360770,47411,313359,299804203.0,39125309.0,260678894.0,0.8404,0.8312,0.8252,0.8319
2023-09-06 13:30,2543,1608,935,247246,146463,100783,204795193.0,120897499.0,83897694.0,2469,1574,895,245050,145317,99733,202925763.0,119884044.0,83041718.0,0.8254,0.8325,0.825,0.8326
2023-09-06 13:35,2420,1263,1157,206991,109845,97146,171392908.0,90652561.0,80740346.0,2367,1229,1138,205229,108938,96291,169933355.0,89873798.0,80059557.0,0.8253,0.8311,0.825,0.8314
2023-09-06 13:40,3345,1526,1819,288866,114796,174070,239212135.0,94690181.0,144521953.0,3245,1478,1767,285359,113765,171594,236267768.0,93797144.0,142470624.0,0.8249,0.8303,0.8245,0.8303
2023-09-06 13:45,990,329,661,78532,11583,66949,65073074.0,9602045.0,55471029.0,884,266,618,76392,9579,66813,63295341.0,7875823.0,55419518.0,0.829,0.8286,0.8222,0.8295
2023-09-06 13:50,2593,684,1909,238049,19605,218444,197031062.0,16161971.0,180869090.0,2507,635,1872,235558,19217,216341,194985686.0,15827633.0,179158053.0,0.8244,0.828,0.8236,0.8281
2023-09-06 13:55,539,155,384,29505,5922,23583,24436490.0,4891237.0,19545253.0,471,110,361,26342,3438,22904,21813406.0,2825002.0,18988403.0,0.8259,0.8288,0.8217,0.829
2023-09-06 14:00,500,96,404,30854,3778,27076,25536000.0,3119554.0,22416445.0,451,64,387,30613,4168,26445,25345610.0,3417474.0,21928135.0,0.8257,0.8279,0.8199,0.8292
2023-09-06 14:05,1040,369,671,78184,7001,71183,64626884.0,5772519.0,58854365.0,981,342,639,77621,6927,70694,64905951.0,6393591.0,58512359.0,0.8245,0.8268,0.923,0.8277
2023-09-06 14:10,1753,458,1295,129783,15244,114539,107183614.0,12501364.0,94682250.0,1633,386,1247,126632,13135,113497,104664478.0,10762149.0,93902329.0,0.8201,0.8266,0.8193,0.8274
2023-09-06 14:15,1266,666,600,96215,41722,54493,79488201.0,34404390.0,45083810.0,1151,608,543,94951,41151,53800,78371108.0,33839311.0,44531797.0,0.8246,0.8273,0.8223,0.8277
2023-09-06 14:20,780,338,442,54909,33262,21647,45199344.0,27361119.0,17838225.0,710,288,422,51286,30375,20911,42299550.0,24975207.0,17324343.0,0.8226,0.8241,0.8222,0.8285
2023-09-06 14:25,2463,1355,1108,182427,112665,69762,150854183.0,93066065.0,57788117.0,2373,1315,1058,178458,111469,66989,147491521.0,91974059.0,55517461.0,0.826,0.8284,0.8251,0.8288
2023-09-06 14:30,2800,1634,1166,280056,172846,107210,231805165.0,142871331.0,88933834.0,2692,1585,1107,275167,172902,102265,227773000.0,142889750.0,84883249.0,0.8266,0.8295,0.8264,0.83
2023-09-06 14:35,2895,966,1929,289820,74503,215317,239801491.0,61451595.0,178349896.0,2816,914,1902,283745,71902,211843,234959996.0,59287191.0,175672804.0,0.8248,0.8283,0.8246,0.8293
2023-09-06 14:40,3164,612,2552,336387,45222,291165,278710989.0,37297529.0,241413459.0,3112,582,2530,335391,44707,290684,277886927.0,36870001.0,241016925.0,0.8248,0.8291,0.8247,0.8291
2023-09-06 14:45,3023,495,2528,340927,34556,306371,282348748.0,28499419.0,253849329.0,2993,479,2514,339005,33391,305614,280785304.0,27537955.0,253247348.0,0.8247,0.8286,0.8247,0.8287
2023-09-06 14:50,3780,630,3150,493293,20183,473110,408001062.0,16628335.0,391372726.0,3721,593,3128,489039,18695,470344,404641651.0,15392389.0,389249261.0,0.8239,0.8272,0.8233,0.8276
2023-09-06 14:55,2829,597,2232,331444,28092,303352,273989162.0,23294608.0,250694553.0,2697,540,2157,321893,23948,297945,265965385.0,19658413.0,246306971.0,0.8292,0.8264,0.8209,0.8267
2023-09-06 15:00,893,314,579,82328,4563,77765,67956747.0,3790010.0,64166736.0,836,283,553,81186,4609,76577,66967769.0,3764531.0,63203238.0,0.8306,0.8251,0.8168,0.8254
2023-09-06 15:05,465,93,372,49597,2294,47303,40771818.0,1884052.0,38887765.0,397,45,352,45112,797,44315,37193401.0,652556.0,36540845.0,0.8213,0.8221,0.8188,0.8246
2023-09-06 15:10,2021,429,1592,201954,17088,184866,166515900.0,14082564.0,152433336.0,1942,377,1565,197638,15478,182160,162939838.0,12697747.0,150242090.0,0.8241,0.8246,0.8204,0.8248
2023-09-06 15:15,1863,369,1494,211612,19913,191699,174272261.0,16348859.0,157923401.0,1740,305,1435,211552,17549,194003,174416476.0,14389569.0,160026906.0,0.821,0.8238,0.82,0.8249
2023-09-06 15:20,1901,725,1176,146829,17942,128887,120962860.0,14732265.0,106230594.0,1831,684,1147,145655,17111,128544,119990314.0,14020642.0,105969672.0,0.8211,0.8242,0.8194,0.8244
2023-09-06 15:25,1282,457,825,141246,7180,134066,116439893.0,5888020.0,110551873.0,1240,433,807,140347,6495,133852,115715565.0,5323427.0,110392137.0,0.8201,0.8246,0.8196,0.8247
2023-09-06 15:30,1019,473,546,106059,7016,99043,87351663.0,5756044.0,81595619.0,998,463,535,104890,7250,97640,86473079.0,5944569.0,80528510.0,0.8204,0.8238,0.8199,0.8247
2023-09-06 15:35,1424,424,1000,146658,11055,135603,120652027.0,8965529.0,111686497.0,1360,382,978,144993,9640,135353,119368102.0,7880280.0,111487822.0,0.811,0.8236,0.8175,0.8237
2023-09-06 15:40,1558,324,1234,190981,8026,182955,157226739.0,6574146.0,150652593.0,1509,298,1211,189378,7064,182314,155929171.0,5772720.0,150156451.0,0.8191,0.8234,0.8172,0.8236
2023-09-06 15:45,641,79,562,78689,2644,76045,64838063.0,2165322.0,62672741.0,601,56,545,79227,3359,75868,65275876.0,2748257.0,62527618.0,0.819,0.8242,0.8182,0.8242
2023-09-06 15:50,615,112,503,80326,6953,73373,66414626.0,5839749.0,60574877.0,559,84,475,77354,4795,72559,63809510.0,3901750.0,59907760.0,0.8399,0.8256,0.8137,0.8256
2023-09-06 15:55,3160,786,2374,299530,61956,237574,246839848.0,50872273.0,195967575.0,3110,761,2349,292850,61857,230993,241234782.0,50780782.0,190454000.0,0.8211,0.8249,0.8209,0.8245
2023-09-06 16:00,907,399,508,69743,16083,53660,57475983.0,13170111.0,44305871.0,864,376,488,68870,15889,52981,56804318.0,13053589.0,43750729.0,0.8189,0.8257,0.8215,0.8258
2023-09-06 16:05,992,464,528,68331,27682,40649,56311643.0,22750705.0,33560937.0,955,440,515,67620,27624,39996,55734304.0,22691497.0,33042806.0,0.8219,0.8256,0.8214,0.8262
2023-09-06 16:10,634,442,192,27062,13431,13631,22428007.0,11151620.0,11276386.0,588,413,175,24907,11416,13491,20563331.0,9389894.0,11173436.0,0.8303,0.8273,0.8225,0.8282
2023-09-06 16:15,975,387,588,66292,24162,42130,54833605.0,19953982.0,34879623.0,908,342,566,61764,21512,40252,51036096.0,17716149.0,33319947.0,0.8258,0.8279,0.8235,0.8278
2023-09-06 16:20,1176,941,235,118839,106918,11921,98235109.0,88346272.0,9888836.0,1128,914,214,115468,104812,10656,95362936.0,86528293.0,8834643.0,0.8263,0.8295,0.8256,0.8291
2023-09-06 16:25,2439,1509,930,296569,199238,97331,245439757.0,164433591.0,81006165.0,2377,1464,913,294976,197308,97668,243858811.0,162868787.0,80990023.0,0.8253,0.8323,0.8255,0.8292
2023-09-06 16:30,1806,1327,479,179641,138317,41324,148413140.0,114156232.0,34256908.0,1754,1289,465,177333,136901,40432,146509081.0,112976719.0,33532361.0,0.8253,0.829,0.8252,0.8294
2023-09-06 16:35,3067,1917,1150,292186,232393,59793,243829988.0,192767655.0,51062333.0,2973,1877,1096,288964,230538,58426,240973100.0,191061365.0,49911735.0,0.8295,0.854,0.8288,0.8543
2023-09-06 16:40,2220,899,1321,176835,120467,56368,147398518.0,99843844.0,47554674.0,2143,858,1285,174292,119100,55192,145456387.0,98674509.0,46781878.0,0.8288,0.8436,0.8285,0.8476
2023-09-06 16:45,3159,1173,1986,253266,167476,85790,210531731.0,138659796.0,71871934.0,3091,1130,1961,250966,165991,84975,208421796.0,137429751.0,70992044.0,0.8279,0.8378,0.8279,0.8354
2023-09-06 16:50,2375,526,1849,155432,64256,91176,128912537.0,53190298.0,75722238.0,2343,507,1836,154487,64332,90155,128104008.0,53230094.0,74873913.0,0.8278,0.8305,0.8274,0.8305
2023-09-06 16:55,1930,526,1404,138899,51306,87593,115192035.0,42583187.0,72608847.0,2051,698,1353,136032,50647,85385,112796670.0,41847739.0,70948931.0,0.83,0.8289,0.8263,0.8309
2023-09-06 17:00,2229,1548,681,205690,159231,46459,171051864.0,132316249.0,38735615.0,2039,1507,532,193043,157476,35567,160069591.0,130497829.0,29571761.0,0.831,0.8338,0.8287,0.8314
2023-09-06 17:05,1620,1032,588,169722,143185,26537,140701625.0,118678484.0,22023141.0,1589,1020,569,170171,143537,26634,141126277.0,118963635.0,22162641.0,0.8288,0.8299,0.8288,0.8321
2023-09-06 17:10,2344,782,1562,172764,47720,125044,143303125.0,39470581.0,103832543.0,2293,758,1535,171772,47383,124389,142530106.0,39192919.0,103337187.0,0.8271,0.8304,0.8272,0.8308
2023-09-06 17:15,392,211,181,26463,18302,8161,21887959.0,15115784.0,6772174.0,356,187,169,25117,17128,7989,20780484.0,14138683.0,6641800.0,0.8259,0.8298,0.8255,0.8314
2023-09-06 17:20,1726,925,801,139946,43641,96305,116262744.0,36170750.0,80091993.0,1694,904,790,137667,41909,95758,114358122.0,34719711.0,79638411.0,0.8288,0.8316,0.8285,0.8317
2023-09-06 17:25,2141,695,1446,206284,18445,187839,171444602.0,15284950.0,156159652.0,2069,647,1422,205468,18802,186666,170813606.0,15564021.0,155249585.0,0.8287,0.8313,0.8278,0.8317
2023-09-06 17:30,2095,144,1951,284475,4928,279547,236592267.0,4088234.0,232504032.0,2043,101,1942,284210,4547,279663,236360474.0,3761374.0,232599099.0,0.8296,0.8317,0.8272,0.8317
2023-09-06 17:35,2991,332,2659,359028,8596,350432,298654816.0,7153481.0,291501334.0,2953,310,2643,357695,7838,349857,297511272.0,6486262.0,291025009.0,0.8322,0.8318,0.8275,0.8318
2023-09-06 17:40,2231,126,2105,262124,6634,255490,217883570.0,5512720.0,212370850.0,2202,112,2090,260726,6248,254478,216790068.0,5167965.0,211622103.0,0.831,0.8312,0.8271,0.8316
2023-09-06 17:45,1222,154,1068,131096,14603,116493,108887301.0,12053982.0,96833318.0,1199,139,1060,130709,14281,116428,108632659.0,11817124.0,96815534.0,0.8254,0.8312,0.8275,0.8315
2023-09-06 17:50,1158,408,750,131119,40428,90691,108981176.0,33583490.0,75397685.0,1120,392,728,129060,39458,89602,107170567.0,32665273.0,74505294.0,0.8307,0.8314,0.8278,0.8315
2023-09-06 17:55,2444,320,2124,239582,31225,208357,199037441.0,25875379.0,173162062.0,2412,307,2105,238515,30504,208011,198172246.0,25243248.0,172928997.0,0.8287,0.8311,0.8275,0.8313
2023-09-06 18:00,540,141,399,44844,13346,31498,37222617.0,11052835.0,26169781.0,511,128,383,45533,13548,31985,37787520.0,11201122.0,26586397.0,0.8282,0.8308,0.8268,0.8312
2023-09-06 18:05,182,106,76,16451,9190,7261,13691566.0,7653470.0,6038096.0,157,90,67,14129,8589,5540,11717555.0,7107535.0,4610020.0,0.8328,0.8316,0.8275,0.8321
2023-09-06 18:10,991,216,775,99233,17957,81276,82197983.0,14863633.0,67334350.0,957,192,765,96717,17399,79318,80339641.0,14396844.0,65942797.0,0.8277,0.8285,0.8275,0.8314
2023-09-06 18:15,1948,719,1229,181275,41879,139396,150323541.0,34627855.0,115695686.0,1918,698,1220,179075,41041,138034,148501766.0,33932520.0,114569245.0,0.8269,0.83,0.8268,0.83
2023-09-06 18:20,2781,521,2260,268350,36394,231956,222149540.0,30063901.0,192085638.0,2744,495,2249,265142,35199,229943,219707413.0,29068401.0,190639011.0,0.8261,0.8281,0.8258,0.8291
2023-09-06 18:25,4256,1167,3089,431106,46878,384228,357066262.0,38713569.0,318352692.0,4212,1149,3063,430828,46518,384310,356889404.0,38413311.0,318476093.0,0.8258,0.8286,0.8258,0.8287
2023-09-06 18:30,1868,389,1479,142322,10145,132177,117750486.0,8371835.0,109378651.0,1826,365,1461,141115,9739,131376,116824292.0,8035675.0,108788616.0,0.8252,0.8275,0.8251,0.8281
2023-09-06 18:35,3597,497,3100,411285,22934,388351,339549932.0,18885137.0,320664795.0,3532,461,3071,405781,21436,384345,335337495.0,17651136.0,317686358.0,0.8235,0.8257,0.8234,0.8266
2023-09-07 10:00,4279,1155,3124,537931,37282,500649,444517309.0,30368050.0,414149259.0,3732,883,2849,509278,27835,481443,420774298.0,22758484.0,398015814.0,0.8145,0.8272,0.8176,0.8267
2023-09-07 10:05,1512,671,841,108760,26562,82198,89379097.0,21681563.0,67697533.0,1200,460,740,93662,17986,75676,77032545.0,14645053.0,62387491.0,0.8163,0.8236,0.8142,0.8244
2023-09-07 10:10,1740,782,958,135226,22171,113055,111669475.0,18275291.0,93394184.0,1531,673,858,124670,16495,108175,102833982.0,13463820.0,89370162.0,0.8243,0.8261,0.8162,0.8262
2023-09-07 10:15,3044,1437,1607,235008,82692,152316,192747081.0,67534629.0,125212451.0,2740,1301,1439,234026,84858,149168,192141801.0,69287326.0,122854475.0,0.8167,0.8221,0.8165,0.8236
2023-09-07 10:20,1686,604,1082,118307,32504,85803,96851593.0,26551639.0,70299953.0,1558,537,1021,114909,29728,85181,94065692.0,24261032.0,69804660.0,0.8169,0.8193,0.8161,0.8195
2023-09-07 10:25,1150,281,869,50970,8839,42131,41704167.0,7225956.0,34478211.0,1026,221,805,50924,9882,41042,41698901.0,8047676.0,33651224.0,0.8175,0.8184,0.8144,0.8199
2023-09-07 10:30,2537,645,1892,231182,27992,203190,188918560.0,22852438.0,166066121.0,2391,579,1812,225002,26426,198576,184074331.0,21505717.0,162568613.0,0.8164,0.8173,0.8138,0.8187
2023-09-07 10:35,4056,2160,1896,324288,136102,188186,262240106.0,110717751.0,151522354.0,2911,1455,1456,270604,107339,163265,219324613.0,87000307.0,132324305.0,0.8135,0.8052,0.8105,0.8105
2023-09-07 10:40,2147,1086,1061,140152,89152,51000,113257255.0,72065440.0,41191814.0,1714,763,951,124741,82152,42589,100630917.0,66156183.0,34474734.0,0.8083,0.8077,0.8053,0.8095
2023-09-07 10:45,1632,1055,577,132676,102483,30193,108024693.0,83396232.0,24628461.0,1379,881,498,119665,91952,27713,97146862.0,74531980.0,22614882.0,0.8138,0.8157,0.8106,0.816
2023-09-07 10:50,2398,1327,1071,202236,131244,70992,164552506.0,106791336.0,57761170.0,2216,1218,998,195425,129080,66345,158962055.0,104856553.0,54105501.0,0.8137,0.8136,0.8123,0.8155
2023-09-07 10:55,4582,1769,2813,408634,106616,302018,331104810.0,86982645.0,244122165.0,3771,1291,2480,360467,83597,276870,290856229.0,66967855.0,223888373.0,0.8158,0.8083,0.8011,0.8086
2023-09-07 11:00,2601,1352,1249,190337,94085,96252,153676515.0,75524389.0,78152126.0,2164,1088,1076,168217,81008,87209,137230722.0,66185256.0,71045465.0,0.8027,0.812,0.817,0.8147
2023-09-07 11:05,2704,1451,1253,202336,102868,99468,163506207.0,83566516.0,79939690.0,2282,1184,1098,182671,91399,91272,146906516.0,73114789.0,73791727.0,0.8124,0.8037,0.8,0.8085
2023-09-07 11:10,3376,2174,1202,288718,206232,82486,234356109.0,167548196.0,66807913.0,2752,1827,925,250579,185277,65302,202674285.0,149470390.0,53203894.0,0.8124,0.8099,0.8067,0.8147
2023-09-07 11:15,3886,1345,2541,353104,92673,260431,285621531.0,74966705.0,210654825.0,3554,1138,2416,323664,81671,241993,262086224.0,65795717.0,196290507.0,0.8089,0.8089,0.8056,0.8111
2023-09-07 11:20,2892,1664,1228,246257,118665,127592,198492501.0,95734812.0,102757688.0,2675,1536,1139,232780,110488,122292,187511521.0,88816238.0,98695282.0,0.8068,0.8054,0.8039,0.807
2023-09-07 11:25,3417,1186,2231,343026,111266,231760,276105898.0,90418672.0,185687226.0,3056,968,2088,317020,99965,217055,257052769.0,82095273.0,174957496.0,0.8126,0.8012,0.8212,0.8061
2023-09-07 11:30,1736,1104,632,113905,57288,56617,91944359.0,46681267.0,45263092.0,1398,901,497,93436,47807,45629,74722935.0,38095013.0,36627921.0,0.8149,0.7995,0.7969,0.8027
2023-09-07 11:35,1604,1083,521,132425,97140,35285,106056064.0,77772449.0,28283615.0,1438,959,479,119460,89562,29898,95430357.0,71430874.0,23999483.0,0.8006,0.8016,0.7976,0.8027
2023-09-07 11:40,1382,603,779,97559,42558,55001,77965704.0,34012756.0,43952948.0,1259,522,737,93844,41266,52578,75023963.0,32896304.0,42127659.0,0.7992,0.7991,0.7972,0.8012
2023-09-07 11:45,1216,541,675,72309,42935,29374,58139683.0,34605554.0,23534129.0,1092,460,632,67584,39877,27707,54080415.0,31859860.0,22220555.0,0.806,0.8012,0.799,0.802
2023-09-07 11:50,1157,701,456,103020,70262,32758,83205243.0,56687318.0,26517924.0,1009,625,384,93553,63824,29729,75173858.0,51080841.0,24093016.0,0.8068,0.8095,0.8003,0.8104
2023-09-07 11:55,3252,1926,1326,296294,201056,95238,239818237.0,162647964.0,77170273.0,2987,1790,1197,273862,193043,80819,221691245.0,156013392.0,65677852.0,0.809,0.8103,0.8082,0.8127
2023-09-07 12:00,4292,1810,2482,407060,154875,252185,326854240.0,124407875.0,202446365.0,4045,1663,2382,390986,147222,243764,314722812.0,118216797.0,196506015.0,0.8033,0.8028,0.803,0.8061
2023-09-07 12:05,1293,544,749,124803,25384,99419,100066932.0,20376618.0,79690314.0,1047,377,670,112564,18756,93808,90467120.0,14947502.0,75519618.0,0.8027,0.8016,0.7969,0.805
2023-09-07 12:10,386,114,272,59235,1346,57889,47780319.0,1101199.0,46679119.0,308,49,259,61593,2865,58728,49647433.0,2291088.0,47356345.0,0.8181,0.8064,0.7997,0.8064
2023-09-07 12:15,1657,332,1325,215260,7375,207885,173339074.0,5908029.0,167431045.0,1582,292,1290,213500,7724,205776,171960643.0,6180170.0,165780473.0,0.8011,0.8054,0.8001,0.8056
2023-09-07 12:20,2002,779,1223,215745,54436,161309,173646956.0,43739175.0,129907781.0,1900,706,1194,211816,51169,160647,170372564.0,40975946.0,129396618.0,0.8035,0.8053,0.8008,0.8055
2023-09-07 12:25,1098,783,315,84076,69751,14325,67705003.0,56140832.0,11564171.0,994,722,272,82421,68008,14413,66337182.0,54664515.0,11672667.0,0.8049,0.8073,0.8038,0.8099
2023-09-07 12:30,228,98,130,18255,9204,9051,14666839.0,7376093.0,7290745.0,177,76,101,16470,8620,7850,13274898.0,6902982.0,6371915.0,0.8014,0.8055,0.8008,0.8117
2023-09-07 12:35,976,700,276,89174,77219,11955,71610468.0,62036280.0,9574188.0,921,674,247,87170,77373,9797,70057975.0,62129429.0,7928546.0,0.8034,0.8009,0.803,0.8093
2023-09-07 12:40,3006,917,2089,280565,64949,215616,225710611.0,52152355.0,173558255.0,2905,860,2045,276619,63196,213423,222576561.0,50707132.0,171869429.0,0.803,0.8049,0.8024,0.8053
2023-09-07 12:45,4199,1280,2919,379734,101247,278487,305107021.0,81169176.0,223937844.0,4150,1247,2903,377640,100623,277017,303454410.0,80612022.0,222842388.0,0.8017,0.8041,0.8011,0.8044
2023-09-07 12:50,1610,621,989,155408,35441,119967,124559385.0,28362789.0,96196595.0,1549,584,965,148652,31690,116962,119324530.0,25364932.0,93959598.0,0.8003,0.8019,0.8004,0.8033
2023-09-07 12:55,2384,970,1414,250509,31653,218856,201516494.0,25393758.0,176122735.0,2340,940,1400,254659,29929,224730,204872813.0,23970724.0,180902089.0,0.8023,0.8047,0.8009,0.805
2023-09-07 13:00,2296,781,1515,186200,35078,151122,149888475.0,28153071.0,121735403.0,2238,753,1485,183005,34275,148730,147323679.0,27479444.0,119844235.0,0.8026,0.8055,0.8017,0.8058
2023-09-07 13:05,1695,710,985,126478,51919,74559,101786352.0,41722127.0,60064225.0,1627,663,964,122664,49041,73623,98674655.0,39341667.0,59332988.0,0.8036,0.8056,0.8022,0.8059
2023-09-07 13:10,1969,791,1178,167138,70541,96597,134763059.0,56611132.0,78151927.0,1909,765,1144,164727,70184,94543,132919454.0,56271151.0,76648302.0,0.8025,0.8091,0.8018,0.8107
2023-09-07 13:15,2784,1173,1611,264381,74418,189963,211955562.0,59728789.0,152226772.0,2583,1074,1509,251998,69137,182861,202926786.0,55246898.0,147679888.0,0.8026,0.8013,0.7991,0.8076
2023-09-07 13:20,4668,1534,3134,413909,82525,331384,329232668.0,66123706.0,263108962.0,4087,1228,2859,390670,70465,320205,310502886.0,55605812.0,254897073.0,0.8013,0.794,0.7891,0.796
2023-09-07 13:25,4486,2451,2035,398163,216972,181191,310137439.0,169437574.0,140699864.0,3669,2056,1613,346206,192330,153876,270821853.0,149417892.0,121403961.0,0.7809,0.7765,0.7769,0.789
2023-09-07 13:30,4856,3424,1432,456705,358556,98149,358736602.0,281647094.0,77089507.0,4250,3045,1205,413742,334060,79682,323625741.0,260638454.0,62987287.0,0.7855,0.7854,0.7802,0.7905
2023-09-07 13:35,2999,1861,1138,271998,182622,89376,217346575.0,146089397.0,71257177.0,2577,1611,966,239668,165079,74589,190368900.0,130621795.0,59747105.0,0.8,0.7973,0.7913,0.801
2023-09-07 13:40,3482,2265,1217,366712,301781,64931,292214107.0,240422602.0,51791505.0,3302,2170,1132,356746,296192,60554,283646509.0,235278595.0,48367914.0,0.7967,0.7976,0.7943,0.7988
2023-09-07 13:45,3791,1839,1952,354296,163438,190858,279427770.0,129144908.0,150282862.0,3529,1667,1862,318349,145485,172864,252237265.0,114941463.0,137295801.0,0.7902,0.7874,0.7901,0.7942
2023-09-07 13:50,2434,1543,891,203710,159645,44065,159780887.0,125234968.0,34545919.0,2054,1312,742,191014,154202,36812,150488395.0,121471953.0,29016441.0,0.7845,0.784,0.7877,0.7882
2023-09-07 13:55,2142,1369,773,184699,144142,40557,146136797.0,114206836.0,31929961.0,1866,1186,680,173783,138501,35282,136590340.0,108675525.0,27914814.0,0.7923,0.7873,0.7847,0.7912
2023-09-07 14:00,3028,1114,1914,294946,92619,202327,232410875.0,72706150.0,159704725.0,2817,976,1841,284772,85045,199727,224660708.0,66819235.0,157841473.0,0.785,0.7893,0.7857,0.7903
2023-09-07 14:05,2460,832,1628,194195,67248,126947,152539342.0,52910412.0,99628930.0,2172,682,1490,183128,63144,119984,143929162.0,49523181.0,94405981.0,0.7868,0.7848,0.7843,0.7868
2023-09-07 14:10,4404,1909,2495,338829,96389,242440,260598972.0,74311225.0,186287746.0,3572,1419,2153,297660,79879,217781,230404469.0,61841543.0,168562926.0,0.771,0.7684,0.7742,0.774
2023-09-07 14:15,6067,2941,3126,547499,234045,313454,420329267.0,178889551.0,241439715.0,4818,2254,2564,456264,187328,268936,350474102.0,142481047.0,207993054.0,0.7643,0.7703,0.7606,0.7734
2023-09-07 14:20,3773,2200,1573,306485,184894,121591,235626671.0,141924652.0,93702018.0,3233,1889,1344,273275,167410,105865,209842914.0,127932293.0,81910620.0,0.7676,0.7706,0.7642,0.7737
2023-09-07 14:25,3984,2995,989,398405,343368,55037,309258333.0,266296750.0,42961583.0,3458,2669,789,375286,331050,44236,290634255.0,255966027.0,34668227.0,0.7755,0.7806,0.7732,0.7837
2023-09-07 14:30,3820,1991,1829,303526,186722,116804,235427995.0,144557428.0,90870567.0,3487,1799,1688,291166,181580,109586,225587716.0,140260790.0,85326925.0,0.7742,0.778,0.7724,0.7786
2023-09-07 14:35,3035,1923,1112,270385,207122,63263,211188459.0,161719230.0,49469228.0,2757,1753,1004,252315,195272,57043,196436363.0,151801983.0,44634380.0,0.7808,0.782,0.7774,0.7825
2023-09-07 14:40,2936,1665,1271,228172,128419,99753,177306732.0,99735682.0,77571049.0,2648,1516,1132,211800,118773,93027,164826400.0,92241376.0,72585024.0,0.7766,0.7776,0.7766,0.7803
2023-09-07 14:45,1798,985,813,124184,39662,84522,96387456.0,30739126.0,65648330.0,1557,840,717,117290,35866,81424,90909223.0,27588208.0,63321015.0,0.775,0.7767,0.7692,0.7777
2023-09-07 14:50,3772,1574,2198,294448,118206,176242,229156488.0,91998728.0,137157760.0,3553,1481,2072,284156,111313,172843,220691345.0,86154407.0,134536937.0,0.7783,0.7782,0.774,0.7784
2023-09-07 14:55,3250,2732,518,351959,325746,26213,274066404.0,253633348.0,20433056.0,3030,2608,422,336635,317806,18829,261459611.0,246762458.0,14697152.0,0.7786,0.7795,0.7765,0.7806
2023-09-07 15:00,3019,1960,1059,265163,196035,69128,206111541.0,152462116.0,53649425.0,2843,1877,966,255424,191859,63565,198534692.0,148899761.0,49634930.0,0.7777,0.7761,0.7761,0.7809
2023-09-07 15:05,2976,2010,966,311508,235512,75996,241161237.0,181971591.0,59189646.0,3205,2095,1110,286094,216067,70027,222373415.0,167725167.0,54648248.0,0.7727,0.7789,0.7763,0.7804
2023-09-07 15:10,1760,1314,446,170396,144984,25412,133657117.0,113718561.0,19938556.0,1632,1214,418,160506,137597,22909,124940862.0,106998051.0,17942811.0,0.7844,0.7846,0.7776,0.7832
2023-09-07 15:15,1635,837,798,121355,71440,49915,95211598.0,56090179.0,39121418.0,1444,763,681,115555,68254,47301,90368312.0,53257106.0,37111205.0,0.7851,0.7838,0.7803,0.7846
2023-09-07 15:20,1055,794,261,88223,70707,17516,68933844.0,55256833.0,13677011.0,990,762,228,84252,69418,14834,65836524.0,54163016.0,11673507.0,0.7815,0.7808,0.7802,0.7869
2023-09-07 15:25,1478,872,606,89513,56065,33448,70098622.0,43859157.0,26239465.0,1399,836,563,87219,56036,31183,68102291.0,43638783.0,24463508.0,0.7823,0.7845,0.7788,0.7845
2023-09-07 15:30,729,405,324,43682,30841,12841,34124730.0,24074506.0,10050224.0,646,374,272,41762,29925,11837,32653028.0,23358640.0,9294388.0,0.7806,0.7827,0.7806,0.7852
2023-09-07 15:35,2166,998,1168,172865,109194,63671,134487262.0,84847643.0,49639618.0,2062,948,1114,166890,106455,60435,130022446.0,82745930.0,47276516.0,0.777,0.7796,0.7773,0.7823
2023-09-07 15:40,1180,605,575,92397,56844,35553,72010271.0,44241847.0,27768424.0,1088,541,547,88286,54547,33739,68603809.0,42248570.0,26355238.0,0.7783,0.781,0.7745,0.7812
2023-09-07 15:45,2415,1061,1354,222015,74603,147412,171422835.0,57582664.0,113840171.0,2152,895,1257,205858,65754,140104,159251931.0,50659968.0,108591963.0,0.7719,0.7723,0.7704,0.7751
2023-09-07 15:50,3982,1988,1994,369491,180862,188629,287323648.0,140412150.0,146911498.0,3779,1869,1910,362432,178561,183871,281329362.0,137873635.0,143455727.0,0.7763,0.7788,0.7721,0.7802
2023-09-07 15:55,2465,1374,1091,246272,130647,115625,191043599.0,101031134.0,90012465.0,2372,1325,1047,243396,129740,113656,188697348.0,100245677.0,88451671.0,0.7733,0.7785,0.7727,0.7782
2023-09-07 16:00,2290,612,1678,295416,30978,264438,228656654.0,23945380.0,204711274.0,2108,489,1619,281409,25758,255651,217833362.0,19746156.0,198087206.0,0.773,0.7741,0.7666,0.7748
2023-09-07 16:05,2597,1403,1194,234883,141140,93743,181964409.0,109491763.0,72472645.0,2285,1214,1071,213852,128590,85262,164877903.0,98813048.0,66064855.0,0.7758,0.7731,0.7684,0.7748
2023-09-07 16:10,2724,1542,1182,193310,113563,79747,152142741.0,89893650.0,62249091.0,2200,1232,968,154810,85974,68836,120437144.0,66643585.0,53793559.0,0.7916,0.7806,0.7752,0.7815
2023-09-07 16:15,3903,1995,1908,278838,166392,112446,223862812.0,134417063.0,89445749.0,2834,1577,1257,214354,146271,68083,169443959.0,114819314.0,54624644.0,0.8078,0.7955,0.785,0.8023
2023-09-07 16:20,3054,1304,1750,190023,81605,108418,151464107.0,65096789.0,86367317.0,2546,1014,1532,163980,68659,95321,130386863.0,54258393.0,76128470.0,0.7977,0.7966,0.7903,0.7987
2023-09-07 16:25,3039,1558,1481,202208,124480,77728,161727890.0,99646414.0,62081476.0,2666,1381,1285,176096,110869,65227,140720466.0,88224786.0,52495680.0,0.8005,0.7987,0.7958,0.8048
2023-09-07 16:30,3611,1925,1686,321538,150527,171011,255830362.0,119801627.0,136028734.0,3304,1781,1523,305583,146386,159197,243134300.0,116059338.0,127074961.0,0.7959,0.7954,0.7928,0.7982
2023-09-07 16:35,1978,1018,960,145374,71900,73474,114264318.0,56536765.0,57727552.0,1584,788,796,123650,63957,59693,97185505.0,49974672.0,47210833.0,0.7863,0.7857,0.7814,0.7909
2023-09-07 16:40,3958,2401,1557,377718,258392,119326,297903861.0,204067910.0,93835950.0,3568,2178,1390,360713,244806,115907,283829797.0,192317427.0,91512369.0,0.7898,0.7864,0.7856,0.7895
2023-09-07 16:45,4670,2109,2561,441969,173395,268574,347456191.0,136074211.0,211381979.0,4361,1920,2441,421890,161582,260308,331672652.0,126639637.0,205033014.0,0.7848,0.7871,0.7837,0.7877
2023-09-07 16:50,2791,1543,1248,218186,136620,81566,171117200.0,107029806.0,64087394.0,2584,1412,1172,210275,133050,77225,164905268.0,104120575.0,60784692.0,0.7834,0.7857,0.7826,0.7871
2023-09-07 16:55,2390,942,1448,213060,55021,158039,166797334.0,42992332.0,123805002.0,2175,805,1370,201635,48007,153628,158031908.0,37495800.0,120536108.0,0.7814,0.7834,0.781,0.7846
2023-09-07 17:00,2249,1386,863,162205,82029,80176,127491968.0,64455002.0,63036965.0,2150,1338,812,158544,79984,78560,124319386.0,62521931.0,61797454.0,0.7858,0.7862,0.7817,0.7866
2023-09-07 17:05,2540,1072,1468,211033,74903,136130,166125913.0,58922654.0,107203259.0,2414,994,1420,197929,66465,131464,155648489.0,51995097.0,103653392.0,0.7867,0.7875,0.7823,0.7885
2023-09-07 17:10,2323,973,1350,168286,61526,106760,131834000.0,48100387.0,83733612.0,2241,930,1311,166354,62063,104291,130304754.0,48407778.0,81896975.0,0.7818,0.7843,0.78,0.7853
2023-09-07 17:15,3200,1094,2106,342072,53900,288172,266329367.0,41901908.0,224427459.0,2909,908,2001,319485,44518,274967,248904586.0,34427920.0,214476665.0,0.7774,0.7788,0.7733,0.78
2023-09-07 17:20,2699,797,1902,247160,47878,199282,191730055.0,37089188.0,154640867.0,2484,659,1825,234724,40118,194606,182236169.0,30935200.0,151300969.0,0.7747,0.776,0.7711,0.7775
2023-09-07 17:25,3183,933,2250,255756,26639,229117,197227873.0,20389754.0,176838118.0,2936,754,2182,243198,23068,220130,187907295.0,17623525.0,170283769.0,0.7654,0.7718,0.764,0.7736
2023-09-07 17:30,2774,781,1993,269930,60731,209199,208411654.0,47196684.0,161214970.0,2474,649,1825,256759,55141,201618,197797814.0,42151324.0,155646489.0,0.7771,0.7706,0.7644,0.772
2023-09-07 17:35,4113,2028,2085,403994,165936,238058,310417277.0,127679690.0,182737586.0,3614,1744,1870,372553,150701,221852,285936585.0,115229928.0,170706657.0,0.7695,0.7676,0.7646,0.7695
2023-09-07 17:40,2749,2284,465,289644,260404,29240,224447158.0,201702001.0,22745156.0,2552,2181,371,277191,253252,23939,213690742.0,195095818.0,18594923.0,0.7746,0.7779,0.7704,0.7768
2023-09-07 17:45,4633,3097,1536,449123,284945,164178,348546280.0,220939968.0,127606312.0,4357,2956,1401,433400,276814,156586,336160335.0,214195289.0,121965046.0,0.7754,0.7772,0.7738,0.7789
2023-09-07 17:50,3478,1362,2116,274922,105123,169799,212865514.0,81125461.0,131740053.0,3311,1252,2059,266046,99859,166187,206161708.0,77092149.0,129069559.0,0.7717,0.7759,0.772,0.7767
2023-09-07 17:55,3826,2086,1740,358851,166834,192017,278585756.0,129293137.0,149292619.0,3678,2004,1674,349494,160759,188735,271043870.0,124195468.0,146848401.0,0.775,0.7775,0.7726,0.7781
2023-09-07 18:00,1760,747,1013,161986,65532,96454,126449857.0,51213614.0,75236243.0,1638,679,959,156777,61191,95586,122039175.0,47433605.0,74605569.0,0.7815,0.78,0.7752,0.7805
2023-09-07 18:05,1506,961,545,94709,73568,21141,74085971.0,57538354.0,16547616.0,1482,955,527,90425,72176,18249,70529416.0,56200450.0,14328966.0,0.7821,0.7827,0.7787,0.7852
2023-09-07 18:10,1971,1148,823,115039,79745,35294,90044910.0,62337762.0,27707148.0,1771,1066,705,108769,75109,33660,85033139.0,58575378.0,26457760.0,0.7817,0.785,0.7799,0.786
2023-09-07 18:15,3774,2002,1772,270305,130730,139575,213912924.0,103340426.0,110572498.0,3414,1856,1558,253523,125677,127846,200472710.0,98952778.0,101519931.0,0.7905,0.7922,0.7874,0.7941
2023-09-07 18:20,3755,1645,2110,303031,131613,171418,238765186.0,103420468.0,135344718.0,3572,1519,2053,299970,131040,168930,236283859.0,102754482.0,133529377.0,0.7858,0.7896,0.7841,0.7904
2023-09-07 18:25,3253,2082,1171,283469,235459,48010,222828817.0,184941335.0,37887482.0,3150,2021,1129,281393,235789,45604,221195740.0,185152069.0,36043670.0,0.7855,0.7892,0.7852,0.7904
2023-09-07 18:30,1858,1049,809,141901,97611,44290,111273514.0,76436126.0,34837387.0,1770,993,777,138521,97906,40615,108575887.0,76540221.0,32035665.0,0.7831,0.7866,0.7818,0.7888
2023-09-07 18:35,3660,1557,2103,345250,130681,214569,269258970.0,101839498.0,167419471.0,3424,1434,1990,329874,120176,209698,257734174.0,93635061.0,164099113.0,0.7793,0.7803,0.7791,0.7825
2023-09-08 10:00,4098,2439,1659,362218,205526,156692,284931469.0,160724061.0,124207408.0,3381,2164,1217,321779,188535,133244,252663244.0,147459688.0,105203556.0,0.782,0.7927,0.7821,0.7896
2023-09-08 10:05,4789,3414,1375,531020,441332,89688,418946496.0,347783815.0,71162681.0,4317,3220,1097,510466,432602,77864,402349408.0,340430527.0,61918881.0,0.788,0.7934,0.7869,0.7952
2023-09-08 10:10,6781,3672,3109,742283,392963,349320,574836103.0,304355082.0,270481020.0,6016,3206,2810,684761,358893,325868,532038777.0,278241254.0,253797523.0,0.7745,0.7743,0.7753,0.7788
2023-09-08 10:15,4521,1946,2575,399945,140101,259844,308113946.0,107703164.0,200410781.0,4002,1662,2340,371022,128341,242681,286335955.0,98631513.0,187704442.0,0.7688,0.7713,0.7685,0.7735
2023-09-08 10:20,3262,1351,1911,287114,109202,177912,221862216.0,84369054.0,137493162.0,2840,1089,1751,268555,95920,172635,207343538.0,73786491.0,133557047.0,0.7726,0.7728,0.7693,0.7736
2023-09-08 10:25,6157,2288,3869,635686,240594,395092,489643146.0,185308536.0,304334609.0,5779,2093,3686,616021,229506,386515,474641637.0,176306539.0,298335098.0,0.7702,0.7703,0.7682,0.7719
2023-09-08 10:30,3696,1507,2189,317338,102811,214527,244187942.0,79089812.0,165098130.0,3398,1341,2057,299574,93760,205814,230668441.0,71960790.0,158707651.0,0.7693,0.7696,0.7675,0.7711
2023-09-08 10:35,5961,2137,3824,631602,164416,467186,477600914.0,124413540.0,353187374.0,5177,1601,3576,551025,130614,420411,417307335.0,97910812.0,319396523.0,0.7567,0.756,0.7496,0.7597
2023-09-08 10:40,4622,3039,1583,440882,304698,136184,329665594.0,228311314.0,101354280.0,3780,2567,1213,373225,272117,101108,279683248.0,203440402.0,76242845.0,0.7493,0.7442,0.7476,0.7541
2023-09-08 10:45,6041,3350,2691,568854,295562,273292,424776094.0,220907074.0,203869020.0,5195,2820,2375,494025,255586,238439,367975294.0,189420446.0,178554847.0,0.7474,0.746,0.7411,0.7488
2023-09-08 10:50,5640,2964,2676,605203,293932,311271,452443973.0,219772815.0,232671158.0,4814,2440,2374,529081,252462,276619,394761493.0,187767156.0,206994337.0,0.7477,0.7475,0.7437,0.7483
2023-09-08 10:55,3875,1687,2188,380415,118551,261864,284143155.0,89023722.0,195119432.0,3378,1374,2004,350287,102947,247340,261403878.0,77168889.0,184234989.0,0.7509,0.7451,0.7496,0.7449
2023-09-08 11:00,5474,3211,2263,508022,327478,180544,376687254.0,242086380.0,134600873.0,4972,2918,2054,466101,309061,157040,345332211.0,227853970.0,117478240.0,0.7392,0.7455,0.7372,0.7481
2023-09-08 11:05,5228,3342,1886,518870,377148,141722,391934177.0,284938544.0,106995632.0,4526,2982,1544,473484,354467,119017,356686692.0,266557279.0,90129412.0,0.7555,0.755,0.752,0.7573
2023-09-08 11:10,5201,2989,2212,496938,303292,193646,374499628.0,228763758.0,145735869.0,4750,2724,2026,475037,293421,181616,357452585.0,220335017.0,137117567.0,0.7543,0.7526,0.7509,0.755
2023-09-08 11:15,3722,1531,2191,333972,74879,259093,251337951.0,56236097.0,195101853.0,3392,1301,2091,328849,72537,256312,248224749.0,54947952.0,193276797.0,0.751,0.753,0.7575,0.7541
2023-09-08 11:20,3444,2143,1301,302816,217244,85572,228035234.0,163535213.0,64500021.0,3169,1986,1183,293475,211070,82405,220479390.0,158275423.0,62203967.0,0.7528,0.7538,0.7499,0.7549
2023-09-08 11:25,3008,1875,1133,294366,238206,56160,222785812.0,180269390.0,42516422.0,2737,1725,1012,280555,227582,52973,211670755.0,171621633.0,40049122.0,0.7568,0.7571,0.7541,0.756
2023-09-08 11:30,3977,2240,1737,322594,189674,132920,245392254.0,144421367.0,100970887.0,3615,2126,1489,285987,172739,113248,217240251.0,130791988.0,86448262.0,0.7614,0.7596,0.7572,0.7634
2023-09-08 11:35,5160,3637,1523,501519,414662,86857,382831330.0,316422796.0,66408534.0,4570,3328,1242,465402,391881,73521,354308915.0,297974644.0,56334271.0,0.7631,0.7646,0.7604,0.7662
2023-09-08 11:40,3786,2296,1490,327374,253345,74029,252298627.0,195363096.0,56935531.0,3272,2074,1198,299909,237023,62886,230410750.0,181787090.0,48623660.0,0.7711,0.7691,0.767,0.7732
2023-09-08 11:45,2217,1254,963,150118,80229,69889,115354039.0,61648867.0,53705172.0,1881,1129,752,134677,79692,54985,103432295.0,60940539.0,42491755.0,0.7684,0.7684,0.7647,0.7728
2023-09-08 11:50,3216,1871,1345,283347,204279,79068,218348318.0,157732898.0,60615419.0,2829,1644,1185,266179,190931,75248,204502183.0,146518537.0,57983645.0,0.7721,0.7666,0.7674,0.7706
2023-09-08 11:55,2825,2140,685,277189,238957,38232,215237862.0,185522656.0,29715205.0,2472,2009,463,248967,225339,23628,192865034.0,174370837.0,18494197.0,0.7764,0.7772,0.7738,0.7827
2023-09-08 12:00,5518,3314,2204,527559,350055,177504,411433466.0,273205016.0,138228450.0,4965,3095,1870,484155,326801,157354,376992530.0,253892006.0,123100523.0,0.7805,0.7787,0.7769,0.7823
2023-09-08 12:05,4441,2500,1941,430537,285467,145070,337607938.0,224250688.0,113357249.0,3969,2282,1687,399383,265938,133445,313204773.0,208043326.0,105161447.0,0.7856,0.7814,0.7823,0.7881
2023-09-08 12:10,3669,1944,1725,412038,234979,177059,319662495.0,182167782.0,137494713.0,3341,1773,1568,378970,219413,159557,294479719.0,169862784.0,124616934.0,0.7753,0.7765,0.7742,0.781
2023-09-08 12:15,2583,1728,855,241526,181315,60211,187934686.0,140906032.0,47028654.0,2364,1604,760,227454,173085,54369,176766761.0,134181987.0,42584773.0,0.7771,0.7811,0.7752,0.7833
2023-09-08 12:20,2255,1260,995,241452,161066,80386,188246601.0,125482864.0,62763736.0,2085,1182,903,229360,155529,73831,178941442.0,121034345.0,57907096.0,0.7791,0.7808,0.7782,0.7843
2023-09-08 12:25,2182,1112,1070,186932,118596,68336,145240945.0,91964753.0,53276192.0,2031,1039,992,181133,117415,63718,140703142.0,90944033.0,49759109.0,0.7754,0.7796,0.7746,0.7809
2023-09-08 12:30,1745,1006,739,143231,78963,64268,110352925.0,60860451.0,49492474.0,1568,919,649,132349,72091,60258,102342639.0,55620208.0,46722430.0,0.7707,0.7701,0.7715,0.7754
2023-09-08 12:35,3183,1953,1230,339992,239540,100452,261926939.0,184475435.0,77451503.0,2943,1882,1061,329665,234494,95171,253859225.0,180263784.0,73595440.0,0.7701,0.771,0.7687,0.7733
2023-09-08 12:40,2969,1136,1833,243290,68818,174472,187336924.0,52865529.0,134471395.0,2707,1003,1704,237328,64150,173178,182739247.0,49222898.0,133516349.0,0.7682,0.7707,0.7673,0.771
2023-09-08 12:45,2366,764,1602,239868,32820,207048,184510751.0,25050501.0,159460250.0,2233,682,1551,235061,29209,205852,180797003.0,22145128.0,158651874.0,0.7633,0.7702,0.7582,0.7707
2023-09-08 12:50,2026,651,1375,156901,33635,123266,120563100.0,25584595.0,94978505.0,1886,587,1299,149547,27873,121674,115149138.0,21367522.0,93781616.0,0.7607,0.7705,0.7666,0.7708
2023-09-08 12:55,2501,1569,932,265910,211446,54464,205096903.0,162911844.0,42185058.0,2356,1488,868,253500,204617,48883,195308783.0,157477838.0,37830944.0,0.7705,0.7745,0.7696,0.7739
2023-09-08 13:00,1920,1014,906,164235,115103,49132,127810121.0,89631564.0,38178557.0,1751,941,810,151482,109440,42042,117740693.0,84917314.0,32823378.0,0.7787,0.7771,0.7759,0.7807
2023-09-08 13:05,9121,6177,2944,917148,672620,244528,722807875.0,530487870.0,192320004.0,8013,5696,2317,845955,639984,205971,666782818.0,503380109.0,163402709.0,0.7887,0.7865,0.7866,0.7933
2023-09-08 13:10,5938,3861,2077,584337,423343,160994,461244293.0,334149874.0,127094419.0,5390,3633,1757,555272,409010,146262,438204740.0,322270374.0,115934365.0,0.7893,0.7894,0.7879,0.7926
2023-09-08 13:15,4090,2853,1237,380837,334886,45951,300608356.0,264308424.0,36299932.0,3650,2673,977,361800,324817,36983,284502900.0,255192838.0,29310062.0,0.7892,0.79,0.7857,0.7925
2023-09-08 13:20,5112,2209,2903,437247,182877,254370,347493068.0,145335848.0,202157220.0,4481,1950,2531,400078,165190,234888,318276747.0,130908873.0,187367873.0,0.7947,0.7947,0.7925,0.7977
2023-09-08 13:25,3680,1914,1766,356113,217529,138584,281973913.0,171888316.0,110085597.0,3435,1816,1619,333189,203969,129220,263554576.0,160909383.0,102645193.0,0.7902,0.7944,0.7889,0.7943
2023-09-08 13:30,3159,1780,1379,297200,219256,77944,236331682.0,174226118.0,62105564.0,2685,1548,1137,277907,206642,71265,220453205.0,163502924.0,56950281.0,0.7946,0.7968,0.7912,0.7991
2023-09-08 13:35,4051,1958,2093,344631,179034,165597,275486791.0,143573377.0,131913414.0,3329,1647,1682,293674,153672,140002,234527384.0,122257293.0,112270091.0,0.8019,0.7966,0.7956,0.8019
2023-09-08 13:40,3669,2072,1597,347987,213397,134590,278010515.0,170571004.0,107439511.0,3124,1822,1302,312118,197272,114846,249097438.0,156905463.0,92191974.0,0.7993,0.7983,0.7954,0.8027
2023-09-08 13:45,6180,3533,2647,569206,358313,210893,461513485.0,291162618.0,170350866.0,4288,2673,1615,451710,297154,154556,365733508.0,239239223.0,126494284.0,0.8126,0.8078,0.8051,0.8184
2023-09-08 13:50,4028,2129,1899,370669,216766,153903,300261695.0,175784225.0,124477469.0,3422,1810,1612,327977,195545,132432,265716383.0,158105401.0,107610982.0,0.8109,0.8088,0.8085,0.8126
2023-09-08 13:55,5290,2611,2679,476199,265707,210492,388494323.0,216931686.0,171562637.0,4414,2220,2194,409317,225851,183466,333010930.0,183242314.0,149768616.0,0.8164,0.8151,0.8113,0.8163
2023-09-08 14:00,7783,4234,3549,741778,464450,277328,608464384.0,382544987.0,225919396.0,5573,3225,2348,607581,413328,194253,499177461.0,338437436.0,160740025.0,0.8237,0.8146,0.8188,0.8275
2023-09-08 14:05,5302,2219,3083,446146,182227,263919,364113774.0,148989895.0,215123879.0,4205,1781,2424,382992,151211,231781,313710399.0,123208522.0,190501876.0,0.8176,0.8151,0.8148,0.8219
2023-09-08 14:10,4104,1459,2645,396111,102423,293688,322561568.0,84828501.0,237733066.0,3442,1120,2322,349019,83121,265898,285668082.0,68618767.0,217049315.0,0.8282,0.8095,0.8255,0.8163
2023-09-08 14:15,4259,2092,2167,357029,217827,139202,291143654.0,177742222.0,113401432.0,3459,1723,1736,304761,185268,119493,249526080.0,150943716.0,98582364.0,0.816,0.8147,0.8147,0.825
2023-09-08 14:20,5152,2213,2939,473450,199724,273726,382604823.0,161344114.0,221260708.0,4250,1728,2522,399494,163478,236016,324645577.0,131593415.0,193052162.0,0.8078,0.8083,0.805,0.818
2023-09-08 14:25,4855,2749,2106,475016,327200,147816,387637788.0,267206180.0,120431607.0,4123,2409,1714,423956,301612,122344,345110489.0,244881722.0,100228766.0,0.8166,0.8147,0.8119,0.8192
2023-09-08 14:30,6049,3302,2747,549069,370495,178574,453433930.0,307500784.0,145933145.0,4582,2723,1859,446433,316009,130424,367740767.0,259077769.0,108662997.0,0.83,0.8172,0.8198,0.8332
2023-09-08 14:35,7986,4359,3627,714683,425535,289148,595804881.0,356350595.0,239454286.0,6074,3413,2661,568005,345993,222012,474664422.0,287993341.0,186671081.0,0.8374,0.8281,0.8324,0.8408
2023-09-08 14:40,5090,2397,2693,419306,177371,241935,347807927.0,147702082.0,200105844.0,3919,1749,2170,346078,149856,196222,287558528.0,123593432.0,163965096.0,0.8327,0.8271,0.8247,0.8356
2023-09-08 14:45,4740,2429,2311,442436,224439,217997,363878912.0,184990864.0,178888048.0,3697,1810,1887,344951,174550,170401,285102839.0,143081739.0,142021100.0,0.8242,0.8206,0.8197,0.8335
2023-09-08 14:50,4305,2311,1994,385913,220827,165086,321861123.0,183822837.0,138038286.0,3428,1883,1545,318247,184795,133452,264697624.0,152770166.0,111927458.0,0.8324,0.8362,0.8267,0.8387
2023-09-08 14:55,8835,4947,3888,952490,577251,375239,795928247.0,485143890.0,310784357.0,6449,3806,2643,681476,428715,252761,568680404.0,356959523.0,211720881.0,0.8404,0.8282,0.8326,0.8376
2023-09-08 15:00,5975,2785,3190,549919,269866,280053,459850283.0,226639377.0,233210906.0,4298,2172,2126,444698,218090,226608,374330766.0,182661154.0,191669611.0,0.8398,0.8327,0.8375,0.8458
2023-09-08 15:05,4283,2100,2183,394213,185797,208416,328124140.0,154919864.0,173204275.0,3484,1667,1817,351867,167044,184823,294551785.0,139158180.0,155393605.0,0.8338,0.8311,0.8331,0.8408
2023-09-08 15:10,3619,1948,1671,288906,159155,129751,240487444.0,132696735.0,107790708.0,3128,1660,1468,265158,148799,116359,221170622.0,123673600.0,97497022.0,0.8338,0.8308,0.8311,0.8379
2023-09-08 15:15,5146,2813,2333,485727,275328,210399,404917564.0,229904927.0,175012637.0,4216,2373,1843,409413,238429,170984,341323757.0,198106628.0,143217128.0,0.835,0.8318,0.8309,0.8376
2023-09-08 15:20,3390,1628,1762,292452,144537,147915,244086531.0,120589501.0,123497030.0,2790,1249,1541,261629,127661,133968,218713822.0,106136158.0,112577664.0,0.8343,0.8349,0.8314,0.8403
2023-09-08 15:25,3890,1987,1903,363072,185605,177467,302434489.0,154892599.0,147541890.0,3281,1685,1596,294830,165540,129290,246112472.0,137870785.0,108241686.0,0.8345,0.8314,0.8329,0.8372
2023-09-08 15:30,2992,1461,1531,240609,112472,128137,200665602.0,93967455.0,106698147.0,2534,1246,1288,201285,89508,111777,167700099.0,74298046.0,93402053.0,0.8355,0.8327,0.8301,0.8356
2023-09-08 15:35,3652,1634,2018,286601,120134,166467,235887331.0,99625109.0,136262222.0,2950,1243,1707,238016,95614,142402,197763731.0,78997128.0,118766603.0,0.8293,0.8186,0.8262,0.834
2023-09-08 15:40,3324,1280,2044,253296,64444,188852,208742597.0,53418093.0,155324503.0,2650,882,1768,216719,48678,168041,179591613.0,40069244.0,139522369.0,0.8289,0.8225,0.8231,0.8303
2023-09-08 15:45,4278,1941,2337,357707,136033,221674,293044178.0,113784672.0,179259505.0,3382,1416,1966,303851,104182,199669,251265449.0,85827998.0,165437451.0,0.8364,0.8087,0.8238,0.8286
2023-09-08 15:50,2685,1431,1254,188793,111078,77715,159352501.0,95683889.0,63668611.0,2116,1132,984,150938,88416,62522,127779176.0,76030862.0,51748314.0,0.8614,0.8193,0.8599,0.8277
2023-09-08 15:55,2308,1380,928,165092,99388,65704,136718586.0,83122646.0,53595940.0,2032,1264,768,134673,87015,47658,113676703.0,74193894.0,39482808.0,0.8363,0.8157,0.8527,0.8285
2023-09-08 16:00,2208,1393,815,204728,149110,55618,169151108.0,123546188.0,45604920.0,1842,1198,644,170644,128333,42311,140620443.0,105543685.0,35076757.0,0.8286,0.82,0.8224,0.829
2023-09-08 16:05,3414,1813,1601,237076,137840,99236,194388703.0,114447756.0,79940947.0,2643,1452,1191,174975,110658,64317,144658358.0,91097452.0,53560906.0,0.8303,0.8056,0.8232,0.8328
2023-09-08 16:10,4413,1701,2712,405652,141368,264284,331386613.0,115624320.0,215762292.0,3583,1255,2328,334361,106505,227856,274697345.0,86820154.0,187877190.0,0.8179,0.8164,0.8152,0.8245
2023-09-08 16:15,3088,1528,1560,241370,142185,99185,197175736.0,116429265.0,80746471.0,2689,1329,1360,211796,126501,85295,173439813.0,103207222.0,70232591.0,0.8189,0.8141,0.8159,0.8234
2023-09-08 16:20,3507,1569,1938,346337,102469,243868,282021885.0,83416165.0,198605720.0,2979,1275,1704,310138,81770,228368,253496939.0,66354186.0,187142752.0,0.8141,0.8144,0.8115,0.8195
2023-09-08 16:25,3690,1090,2600,363301,72780,290521,295829561.0,59241736.0,236587825.0,3257,806,2451,336838,61253,275585,274844715.0,49519617.0,225325097.0,0.814,0.8144,0.8084,0.8176
2023-09-08 16:30,4012,2156,1856,360198,194823,165375,294352844.0,159323629.0,135029215.0,3552,1951,1601,325000,178033,146967,265673896.0,145085910.0,120587985.0,0.8178,0.8165,0.8149,0.8205
2023-09-08 16:35,2789,1553,1236,230422,122512,107910,188533134.0,100284779.0,88248354.0,2581,1441,1140,225778,120993,104785,184229014.0,98112971.0,86116043.0,0.8186,0.8178,0.8109,0.8218
2023-09-08 16:40,1612,497,1115,123688,25274,98414,100854122.0,20725478.0,80128644.0,1469,427,1042,115030,21590,93440,94377807.0,17615470.0,76762336.0,0.82,0.8142,0.8159,0.8215
2023-09-08 16:45,3656,1211,2445,401607,74094,327513,327955924.0,60464752.0,267491172.0,3455,1085,2370,387045,64699,322346,316286190.0,52637716.0,263648473.0,0.8161,0.8167,0.8136,0.8179
2023-09-08 16:50,2754,1070,1684,228834,69385,159449,186833821.0,56524413.0,130309408.0,2586,984,1602,222847,67635,155212,182034869.0,55043972.0,126990896.0,0.8146,0.8172,0.8138,0.8182
2023-09-08 16:55,2523,926,1597,252450,83981,168469,206108553.0,68455841.0,137652711.0,2372,839,1533,240737,74650,166087,196479911.0,60623215.0,135856696.0,0.8151,0.8171,0.8121,0.818
2023-09-08 17:00,2576,1399,1177,244801,107593,137208,200249118.0,88349690.0,111899427.0,2301,1247,1054,225700,102769,122931,184632358.0,83723449.0,100908908.0,0.8211,0.8155,0.8147,0.8209
2023-09-08 17:05,2343,1088,1255,229075,85725,143350,187302132.0,70075945.0,117226187.0,2200,1024,1176,209562,83772,125790,171456790.0,68328347.0,103128442.0,0.8175,0.8178,0.8156,0.8198
2023-09-08 17:10,1205,474,731,101402,44690,56712,80574768.0,36415930.0,44158837.0,1025,383,642,76409,38601,37808,62320482.0,31372049.0,30948432.0,0.8149,0.7787,0.8127,0.8186
2023-09-08 17:15,2658,1223,1435,211064,93819,117245,171050225.0,76574702.0,94475522.0,1974,876,1098,157472,63795,93677,127722484.0,51553263.0,76169221.0,0.8162,0.8058,0.8081,0.8131
2023-09-08 17:20,2554,1243,1311,206921,122633,84288,167513923.0,99583965.0,67929957.0,2094,1021,1073,182901,113311,69590,148207182.0,91632172.0,56575010.0,0.812,0.8059,0.8087,0.813
2023-09-08 17:25,3723,1685,2038,387635,141104,246531,308659460.0,113416272.0,195243188.0,2592,1023,1569,277682,91209,186473,223732936.0,72866022.0,150866913.0,0.8038,0.792,0.7989,0.8091
2023-09-08 17:30,2220,1113,1107,227698,138680,89018,183046143.0,111830923.0,71215219.0,1752,882,870,203740,127236,76504,163473554.0,101717863.0,61755690.0,0.8064,0.8,0.7994,0.8072
2023-09-08 17:35,1374,949,425,151684,110002,41682,122528722.0,88833829.0,33694893.0,1059,738,321,136857,102115,34742,110242372.0,82090154.0,28152218.0,0.8076,0.8084,0.8039,0.8103
2023-09-08 17:40,1555,958,597,196191,122199,73992,158160221.0,98609416.0,59550805.0,1311,804,507,169785,115291,54494,137066336.0,92884345.0,44181990.0,0.807,0.8048,0.8057,0.8108
2023-09-08 17:45,2366,1276,1090,260228,121080,139148,207235629.0,96729748.0,110505881.0,1765,930,835,224407,97059,127348,179931350.0,77368487.0,102562863.0,0.7989,0.7942,0.7971,0.8054
2023-09-08 17:50,2236,1505,731,257473,194100,63373,206817186.0,155780563.0,51036623.0,1853,1314,539,229406,176745,52661,184106996.0,141583541.0,42523455.0,0.8026,0.8053,0.8011,0.8075
2023-09-08 17:55,1446,878,568,181569,114735,66834,146783320.0,92388389.0,54394930.0,1217,797,420,157298,112701,44597,126349052.0,90357786.0,35991266.0,0.8052,0.8139,0.8017,0.807
2023-09-08 18:00,1818,1005,813,184575,100221,84354,148621629.0,80869923.0,67751705.0,1623,917,706,172679,92285,80394,139078007.0,74169610.0,64908397.0,0.8069,0.8032,0.8037,0.8074
2023-09-08 18:05,2324,1669,655,212230,166214,46016,172400147.0,135113911.0,37286236.0,1860,1464,396,178959,149821,29138,144679452.0,120909842.0,23769610.0,0.8129,0.8103,0.807,0.8158
2023-09-08 18:10,3034,1385,1649,249739,111774,137965,203585763.0,90875326.0,112710437.0,2576,1183,1393,223084,98833,124251,182479827.0,80130468.0,102349358.0,0.813,0.8169,0.8108,0.8237
2023-09-08 18:15,1728,838,890,152541,66560,85981,123531289.0,53865637.0,69665651.0,1562,757,805,147316,63528,83788,119313700.0,51234250.0,68079450.0,0.8093,0.8102,0.8065,0.8125
2023-09-08 18:20,2184,949,1235,169368,50419,118949,136873890.0,40695267.0,96178622.0,2007,852,1155,165285,47627,117658,133819411.0,38393459.0,95425952.0,0.8071,0.8086,0.8061,0.811
2023-09-08 18:25,2590,1285,1305,303250,129401,173849,244027710.0,104211644.0,139816066.0,2387,1108,1279,276715,106204,170511,223221309.0,85138872.0,138082436.0,0.8053,0.8042,0.8017,0.8098
2023-09-08 18:30,3551,2757,794,374394,274667,99727,301405304.0,221116597.0,80288707.0,3390,2647,743,374186,274644,99542,301284827.0,220867256.0,80417571.0,0.805,0.8051,0.8042,0.8079
2023-09-08 18:35,2143,1109,1034,235851,121742,114109,191425360.0,99255308.0,92170051.0,1884,978,906,209814,112582,97232,169648619.0,90798627.0,78849991.0,0.8153,0.8077,0.8065,0.8109
2023-09-11 10:00,11679,6331,5348,1054643,545199,509444,873711796.0,451534221.0,422177575.0,9663,5437,4226,922819,487474,435345,763103767.0,401575568.0,361528198.0,0.8282,0.8287,0.8238,0.8304
2023-09-11 10:05,8825,3177,5648,747427,235940,511487,608684547.0,192071644.0,416612902.0,7637,2622,5015,671549,195571,475978,548394950.0,159165539.0,389229410.0,0.8141,0.8145,0.8139,0.8177
2023-09-11 10:10,7345,3602,3743,577137,255735,321402,470168308.0,207422074.0,262746234.0,6683,3297,3386,535141,231955,303186,435592231.0,187523973.0,248068257.0,0.8111,0.8175,0.8084,0.8182
2023-09-11 10:15,5021,2545,2476,392103,264898,127205,321966903.0,216447586.0,105519317.0,4418,2252,2166,370205,252956,117249,303454743.0,206590116.0,96864627.0,0.8171,0.8295,0.8167,0.8261
2023-09-11 10:20,4798,2775,2023,417210,274600,142610,343252292.0,225812916.0,117439375.0,4115,2489,1626,379583,252778,126805,312247112.0,207452120.0,104794992.0,0.8223,0.8235,0.8207,0.8264
2023-09-11 10:25,5120,3052,2068,449179,297816,151363,370161905.0,245642852.0,124519053.0,4591,2750,1841,414477,279510,134967,341452497.0,229846341.0,111606156.0,0.8248,0.8227,0.8223,0.8269
2023-09-11 10:30,3077,1692,1385,238594,125779,112815,196855812.0,103553336.0,93302475.0,2794,1552,1242,214308,118403,95905,176538315.0,97292568.0,79245747.0,0.8233,0.827,0.8217,0.8263
2023-09-11 10:35,5404,2796,2608,476706,250649,226057,389789594.0,204808438.0,184981156.0,5007,2587,2420,455566,244474,211092,372851712.0,199515272.0,173336439.0,0.8171,0.8183,0.8161,0.8211
2023-09-11 10:40,2960,1306,1654,229388,86896,142492,188523570.0,71127787.0,117395782.0,2659,1161,1498,194343,78124,116219,158832825.0,63663181.0,95169644.0,0.8185,0.8239,0.8149,0.8189
2023-09-11 10:45,3258,2005,1253,264608,171094,93514,216780878.0,139941599.0,76839279.0,3121,1935,1186,260764,171264,89500,213560964.0,140019736.0,73541228.0,0.8179,0.8217,0.8176,0.8217
2023-09-11 10:50,2485,1482,1003,171789,94847,76942,140283211.0,77377133.0,62906077.0,2338,1390,948,163113,90676,72437,133522210.0,73932102.0,59590108.0,0.8158,0.8176,0.8153,0.8226
2023-09-11 10:55,2472,1245,1227,175796,54781,121015,143707410.0,44642724.0,99064686.0,2360,1173,1187,164644,50547,114097,134691048.0,41182311.0,93508736.0,0.8149,0.8186,0.8147,0.8196
2023-09-11 11:00,2194,747,1447,169925,27694,142231,139332780.0,22665074.0,116667705.0,2103,700,1403,184460,25599,158861,151624709.0,20879421.0,130745288.0,0.8184,0.8203,0.8156,0.823
2023-09-11 11:05,2751,1921,830,242424,193901,48523,198732813.0,159027072.0,39705740.0,2653,1863,790,233004,188177,44827,190824901.0,153994432.0,36830468.0,0.8201,0.8183,0.8183,0.8216
2023-09-11 11:10,2815,1346,1469,231473,110716,120757,189300469.0,90744555.0,98555913.0,2642,1241,1401,212324,102196,110128,174496773.0,83501980.0,90994792.0,0.8196,0.8162,0.8171,0.8263
2023-09-11 11:15,3719,749,2970,349841,55664,294177,287179791.0,45295790.0,241884001.0,3566,661,2905,343011,52517,290494,280951422.0,42716466.0,238234956.0,0.8137,0.8222,0.8134,0.8201
2023-09-11 11:20,3379,732,2647,262314,25837,236477,214376144.0,21655300.0,192720843.0,3131,585,2546,249586,25656,223930,204158562.0,20779346.0,183379216.0,0.8382,0.815,0.8099,0.8189
2023-09-11 11:25,2079,909,1170,217454,42780,174674,177393136.0,34681086.0,142712050.0,1918,808,1110,193580,37371,156209,157542424.0,30252625.0,127289799.0,0.8107,0.817,0.8095,0.8149
2023-09-11 11:30,2821,947,1874,266631,62470,204161,217289479.0,50842923.0,166446555.0,2737,911,1826,261771,59944,201827,213221209.0,48547620.0,164673589.0,0.8139,0.8153,0.8099,0.8159
2023-09-11 11:35,2205,675,1530,209582,46483,163099,172755558.0,38356179.0,134399379.0,2087,607,1480,220397,41884,178513,180567415.0,34528406.0,146039008.0,0.8252,0.824,0.8244,0.8181
2023-09-11 11:40,2205,737,1468,178877,54964,123913,146464190.0,44668462.0,101795727.0,2127,694,1433,177984,53236,124748,145125076.0,43207322.0,101917754.0,0.8127,0.8215,0.8116,0.817
2023-09-11 11:45,1637,703,934,129025,49456,79569,105340643.0,40278840.0,65061803.0,1564,672,892,124848,47762,77086,101754491.0,38782682.0,62971808.0,0.8144,0.8177,0.812,0.8169
2023-09-11 11:50,2045,701,1344,182393,49905,132488,148658940.0,40557842.0,108101097.0,2225,711,1514,181985,49056,132929,148340361.0,39800099.0,108540262.0,0.8127,0.8159,0.8113,0.8165
2023-09-11 11:55,3569,2174,1395,430569,310247,120322,352042564.0,252960697.0,99081866.0,3353,2070,1283,402107,302491,99616,328106922.0,246588103.0,81518818.0,0.8154,0.8235,0.8152,0.8183
2023-09-11 12:00,1694,980,714,129492,106875,22617,105783712.0,87172600.0,18611112.0,1519,934,585,119087,104743,14344,97119751.0,85341965.0,11777786.0,0.8157,0.8229,0.8148,0.8211
2023-09-11 12:05,1478,760,718,119032,67311,51721,97206063.0,54609096.0,42596967.0,1408,728,680,118842,67834,51008,97140281.0,54961427.0,42178853.0,0.8113,0.8236,0.8102,0.8269
2023-09-11 12:10,1828,1229,599,199604,173895,25709,162940104.0,141891281.0,21048822.0,1748,1190,558,195056,169626,25430,159066188.0,138215206.0,20850982.0,0.816,0.8187,0.8148,0.8199
2023-09-11 12:15,1581,959,622,143600,127724,15876,118139848.0,104846135.0,13293712.0,1424,865,559,132414,120078,12336,108416680.0,98253334.0,10163346.0,0.8209,0.8373,0.8182,0.8239
2023-09-11 12:20,1592,857,735,102638,65827,36811,84890022.0,54208500.0,30681521.0,1374,772,602,85644,59804,25840,70918150.0,48960105.0,21958044.0,0.8235,0.8335,0.8187,0.8498
2023-09-11 12:25,5085,3516,1569,480537,348185,132352,402726117.0,291617718.0,111108398.0,3676,2738,938,379558,279308,100250,317266366.0,231211351.0,86055015.0,0.8375,0.8395,0.8278,0.8584
2023-09-11 12:30,5571,3193,2378,530085,326925,203160,443749225.0,273802489.0,169946735.0,4711,2807,1904,480114,303845,176269,400684524.0,252938311.0,147746212.0,0.8375,0.8365,0.8325,0.8382
2023-09-11 12:35,4111,1858,2253,368301,134679,233622,306416186.0,112582711.0,193833475.0,3349,1515,1834,319784,111935,207849,268153808.0,93145660.0,175008148.0,0.8359,0.8297,0.8321,0.842
2023-09-11 12:40,3660,1066,2594,296676,58376,238300,245220966.0,48285711.0,196935254.0,3257,834,2423,269239,46234,223005,223800227.0,38224530.0,185575696.0,0.8272,0.8264,0.8268,0.8322
2023-09-11 12:45,3065,1661,1404,243941,145775,98166,202877194.0,121210248.0,81666945.0,2609,1449,1160,221701,134858,86843,184300618.0,111702714.0,72597904.0,0.8315,0.8319,0.8283,0.836
2023-09-11 12:50,3891,1139,2752,385776,72091,313685,318690747.0,59478738.0,259212008.0,3516,903,2613,361365,60748,300617,299844720.0,50029408.0,249815312.0,0.8251,0.8263,0.8236,0.831
2023-09-11 12:55,4200,2344,1856,355502,200057,155445,294399731.0,166246689.0,128153041.0,3656,2076,1580,314567,177631,136936,260296374.0,146752205.0,113544168.0,0.831,0.8244,0.8262,0.8292
2023-09-11 13:00,4405,3055,1350,392501,308625,83876,324947297.0,255432609.0,69514688.0,4147,2954,1193,376734,304724,72010,311924999.0,252009734.0,59915265.0,0.8276,0.8288,0.827,0.832
2023-09-11 13:05,4497,989,3508,433857,55012,378845,358842189.0,45768679.0,313073509.0,4274,866,3408,429149,54192,374957,355279271.0,45033407.0,310245864.0,0.832,0.8264,0.831,0.8274
2023-09-11 13:10,2971,714,2257,300748,36837,263911,247118866.0,30011648.0,217107218.0,2662,558,2104,282558,27373,255185,232810007.0,22244130.0,210565876.0,0.8147,0.8227,0.8126,0.8251
2023-09-11 13:15,3066,1373,1693,286083,132673,153410,234319428.0,108808731.0,125510697.0,2695,1146,1549,259928,120581,139347,213198827.0,98555686.0,114643140.0,0.8201,0.8181,0.8173,0.8227
2023-09-11 13:20,2805,1703,1102,248621,165897,82724,204182139.0,136131276.0,68050862.0,2552,1566,986,224928,152495,72433,184843864.0,125096499.0,59747364.0,0.8206,0.8226,0.8203,0.8249
2023-09-11 13:25,3560,1951,1609,296960,138247,158713,244526150.0,113688712.0,130837438.0,3433,1890,1543,293733,138227,155506,241949582.0,113515026.0,128434555.0,0.8224,0.8244,0.8212,0.8259
2023-09-11 13:30,3531,2124,1407,286797,211242,75555,235998483.0,173747936.0,62250546.0,3367,2045,1322,281424,206737,74687,231443365.0,169745596.0,61697769.0,0.8225,0.8239,0.8211,0.8261
2023-09-11 13:35,2063,1555,508,187403,171126,16277,154285463.0,140841399.0,13444063.0,1895,1450,445,178110,166718,11392,146416438.0,136980150.0,9436288.0,0.823,0.826,0.8216,0.8283
2023-09-11 13:40,2631,1988,643,257032,238226,18806,211849891.0,196245346.0,15604545.0,2409,1901,508,248750,236638,12112,204667248.0,194619359.0,10047889.0,0.8238,0.8298,0.8224,0.8296
2023-09-11 13:45,2717,1822,895,246284,188488,57796,203010997.0,155311853.0,47699143.0,2573,1770,803,237696,184843,52853,196048475.0,152223973.0,43824501.0,0.824,0.8253,0.8235,0.8292
2023-09-11 13:50,2393,1472,921,213525,148849,64676,176267870.0,122802642.0,53465228.0,2281,1416,865,205506,146886,58620,169673436.0,121057944.0,48615491.0,0.825,0.8267,0.8242,0.8293
2023-09-11 13:55,3290,1036,2254,278730,59860,218870,230267130.0,49276514.0,180990615.0,3212,996,2216,272867,56358,216509,225505249.0,46371460.0,179133789.0,0.8232,0.8269,0.8228,0.8274
2023-09-11 14:00,2992,1294,1698,284675,127125,157550,234997048.0,104684711.0,130312337.0,2909,1242,1667,284965,127072,157893,235218327.0,104593153.0,130625174.0,0.8235,0.8271,0.8231,0.8273
2023-09-11 14:05,2518,1457,1061,243244,181110,62134,201212845.0,149606576.0,51606269.0,2407,1396,1011,232918,175291,57627,192459290.0,144631523.0,47827767.0,0.8261,0.8306,0.8251,0.83
2023-09-11 14:10,2847,1844,1003,254705,199152,55553,213066220.0,165817121.0,47249098.0,2489,1683,806,234593,186373,48220,195681230.0,154567290.0,41113940.0,0.8326,0.8505,0.8293,0.8526
2023-09-11 14:15,3999,1952,2047,331068,104306,226762,275423275.0,86517537.0,188905737.0,3710,1792,1918,309778,97298,212480,257749684.0,80574387.0,177175297.0,0.8295,0.8331,0.8281,0.8338
2023-09-11 14:20,2492,1155,1337,248456,52949,195507,205882836.0,43786466.0,162096369.0,2324,1046,1278,244767,51819,192948,202776904.0,42593679.0,160183224.0,0.827,0.8291,0.822,0.8302
2023-09-11 14:25,2787,910,1877,279818,43428,236390,232029733.0,35888384.0,196141348.0,2687,857,1830,275591,40762,234829,228458971.0,33566415.0,194892556.0,0.8264,0.8297,0.8235,0.8299
2023-09-11 14:30,2578,1274,1304,207129,113521,93608,171750842.0,93975580.0,77775262.0,2481,1239,1242,203708,111274,92434,168847199.0,91934735.0,76912463.0,0.8278,0.8309,0.8262,0.8321
2023-09-11 14:35,1995,1268,727,155906,112909,42997,129465404.0,93441187.0,36024216.0,1888,1218,670,141604,110692,30912,117164426.0,91469759.0,25694666.0,0.8276,0.8378,0.8263,0.8312
2023-09-11 14:40,3514,2373,1141,271564,210274,61290,225173046.0,174168030.0,51005016.0,3400,2319,1081,275841,208140,67701,229161802.0,172335357.0,56826444.0,0.8283,0.8322,0.828,0.8394
2023-09-11 14:45,2856,1931,925,214081,172509,41572,177190326.0,142659216.0,34531109.0,2791,1900,891,210698,170843,39855,174435532.0,141257712.0,33177819.0,0.827,0.8306,0.8268,0.8325
2023-09-11 14:50,1210,813,397,107369,94576,12793,89001661.0,78399536.0,10602125.0,1138,784,354,106820,94275,12545,88449306.0,77979651.0,10469655.0,0.829,0.8287,0.8272,0.8346
2023-09-11 14:55,1609,722,887,109038,74396,34642,91079085.0,62015362.0,29063723.0,1428,638,790,101420,69367,32053,84736548.0,57659301.0,27077246.0,0.8336,0.839,0.8312,0.8448
2023-09-11 15:00,2087,1329,758,186634,145273,41361,156089035.0,121602340.0,34486695.0,1860,1224,636,164210,134145,30065,136888120.0,111711013.0,25177106.0,0.8371,0.8338,0.8328,0.8374
2023-09-11 15:05,2218,1075,1143,162651,90323,72328,135092725.0,75115833.0,59976891.0,2030,965,1065,150207,84789,65418,125005085.0,70394809.0,54610276.0,0.8316,0.8292,0.8302,0.8348
2023-09-11 15:10,3302,1938,1364,244687,139983,104704,203162212.0,116103962.0,87058249.0,3171,1867,1304,236023,136692,99331,196151729.0,113334832.0,82816897.0,0.8294,0.8315,0.8291,0.8337
2023-09-11 15:15,2313,1205,1108,175650,79577,96073,146302743.0,66197343.0,80105400.0,2219,1161,1058,174783,74758,100025,145497744.0,62022771.0,83474972.0,0.8319,0.8338,0.8296,0.8345
2023-09-11 15:20,1106,750,356,98607,68740,29867,81898827.0,56873253.0,25025574.0,1027,721,306,83915,61550,22365,69816232.0,51050900.0,18765332.0,0.8274,0.8379,0.8294,0.839
2023-09-11 15:25,833,471,362,83075,61415,21660,69124283.0,50985026.0,18139256.0,779,442,337,82037,60105,21932,68241949.0,49879260.0,18362689.0,0.8302,0.8375,0.8299,0.8373
2023-09-11 15:30,1479,834,645,120590,61733,58857,99846578.0,51341011.0,48505567.0,1366,776,590,118211,57828,60383,98321145.0,47973060.0,50348084.0,0.8317,0.8241,0.8296,0.8338
2023-09-11 15:35,2076,1023,1053,165629,51252,114377,137081412.0,42477626.0,94603786.0,1934,935,999,155598,46024,109574,129131454.0,38051677.0,91079777.0,0.8288,0.8271,0.8268,0.8312
2023-09-11 15:40,2296,1402,894,188370,139492,48878,157857136.0,116661204.0,41195932.0,2235,1377,858,187425,140746,46679,155690958.0,116490173.0,39200785.0,0.8363,0.8428,0.8277,0.8398
2023-09-11 15:45,2097,1638,459,220136,196884,23252,184063761.0,163219165.0,20844596.0,2006,1606,400,214628,193136,21492,179102672.0,160043082.0,19059590.0,0.829,0.8965,0.8287,0.8868
2023-09-11 15:50,2619,1595,1024,215518,134424,81094,178770306.0,111466906.0,67303400.0,2454,1520,934,207381,131709,75672,172854826.0,109835714.0,63019112.0,0.8292,0.8299,0.8339,0.8328
2023-09-11 15:55,2219,1028,1191,180430,55744,124686,150118269.0,46038304.0,104079965.0,2070,949,1121,168486,51626,116860,139755045.0,42649213.0,97105831.0,0.8259,0.8347,0.8261,0.831
2023-09-11 16:00,2017,625,1392,166180,40140,126040,137604639.0,33481800.0,104122839.0,1877,548,1329,156470,36891,119579,129544851.0,30448655.0,99096196.0,0.8341,0.8261,0.8254,0.8287
2023-09-11 16:05,6319,1096,5223,350425,61776,288649,289596190.0,51001042.0,238595147.0,6081,953,5128,329358,58578,270780,271989597.0,48177966.0,223811631.0,0.8256,0.8266,0.8225,0.8265
2023-09-11 16:10,2356,1477,879,199744,151516,48228,164907692.0,125012564.0,39895128.0,2076,1337,739,187284,147659,39625,154468558.0,121614888.0,32853670.0,0.8251,0.8272,0.8236,0.8291
2023-09-11 16:15,3026,992,2034,261752,58307,203445,216062835.0,48042397.0,168020438.0,2874,906,1968,254163,54653,199510,209904125.0,44972680.0,164931445.0,0.824,0.8259,0.8229,0.8267
2023-09-11 16:20,2454,997,1457,200473,74950,125523,165793505.0,62061318.0,103732187.0,2344,939,1405,197654,73309,124345,163439421.0,60648266.0,102791155.0,0.828,0.8264,0.8273,0.8267
2023-09-11 16:25,2350,663,1687,171019,42351,128668,141013556.0,34837545.0,106176011.0,2255,613,1642,169546,43125,126421,139651339.0,35237535.0,104413803.0,0.8226,0.8252,0.8171,0.8259
2023-09-11 16:30,3229,1080,2149,318748,34487,284261,261454944.0,28164818.0,233290125.0,3038,970,2068,304510,27898,276612,250830263.0,22813472.0,228016790.0,0.8167,0.8207,0.8177,0.8243
2023-09-11 16:35,3520,1651,1869,301368,147494,153874,246883893.0,120385928.0,126497964.0,3359,1565,1794,294664,142709,151955,241552203.0,116464453.0,125087749.0,0.8162,0.8221,0.8161,0.8232
2023-09-11 16:40,2424,1553,871,221160,162672,58488,182066168.0,133896401.0,48169767.0,2274,1501,773,213915,157614,56301,175666921.0,129255614.0,46411306.0,0.8231,0.8236,0.8201,0.8243
2023-09-11 16:45,2766,1500,1266,281656,190426,91230,232063831.0,156525819.0,75538012.0,2671,1463,1208,267483,190739,76744,220111738.0,156716404.0,63395334.0,0.822,0.828,0.8216,0.8261
2023-09-11 16:50,1470,1026,444,103998,84669,19329,85560612.0,69638167.0,15922444.0,1402,998,404,110453,83064,27389,91198326.0,68233016.0,22965309.0,0.8225,0.8238,0.8215,0.8385
2023-09-11 16:55,1017,814,203,91035,82475,8560,74735655.0,67699806.0,7035849.0,975,795,180,89532,82290,7242,73487859.0,67509080.0,5978778.0,0.8209,0.8219,0.8204,0.8256
2023-09-11 17:00,1995,771,1224,198168,53224,144944,162373786.0,43581140.0,118792646.0,1886,694,1192,191457,48011,143446,157273103.0,39306830.0,117966272.0,0.8188,0.8196,0.8187,0.8224
2023-09-11 17:05,1922,1249,673,160634,84900,75734,131594008.0,69254078.0,62339930.0,1837,1207,630,158160,83530,74630,129594436.0,68108447.0,61485989.0,0.8157,0.8231,0.8154,0.8239
2023-09-11 17:10,2392,1050,1342,193286,38341,154945,158195355.0,31313216.0,126882138.0,2311,981,1330,189234,37522,151712,155123844.0,30622150.0,124501694.0,0.8167,0.8189,0.8161,0.8206
2023-09-11 17:15,1324,328,996,120317,5158,115159,98567160.0,4248543.0,94318617.0,1236,260,976,119959,6056,113903,98356071.0,4924762.0,93431308.0,0.8237,0.819,0.8132,0.8203
2023-09-11 17:20,2136,1330,806,227754,165722,62032,186742928.0,135561880.0,51181048.0,2038,1281,757,228122,162977,65145,186837607.0,133214003.0,53623603.0,0.818,0.8251,0.8174,0.8231
2023-09-11 17:25,1512,1038,474,154336,127306,27030,126324022.0,104093407.0,22230615.0,1459,1014,445,152382,126496,25886,124562586.0,103277824.0,21284761.0,0.8177,0.8224,0.8165,0.8222
2023-09-11 17:30,1061,859,202,169526,162328,7198,138977487.0,133052392.0,5925094.0,983,827,156,169099,160277,8822,138750843.0,131275736.0,7475107.0,0.8197,0.8232,0.8191,0.8473
2023-09-11 17:35,2061,809,1252,198739,69557,129182,163408708.0,57027884.0,106380824.0,1971,761,1210,193818,67808,126010,159372152.0,55518565.0,103853587.0,0.8199,0.8235,0.8188,0.8242
2023-09-11 17:40,1879,272,1607,284989,27943,257046,233942800.0,22835357.0,211107442.0,1835,238,1597,280776,25769,255007,230964352.0,21053877.0,209910475.0,0.8172,0.8213,0.817,0.8232
2023-09-11 17:45,1713,131,1582,253182,4385,248797,208018179.0,3568607.0,204449572.0,1675,102,1573,251806,3535,248271,206719460.0,2884774.0,203834685.0,0.8138,0.8218,0.8161,0.821
2023-09-11 17:50,1486,283,1203,155086,6010,149076,126792407.0,4876165.0,121916242.0,1274,142,1132,146081,3548,142533,119886865.0,2872033.0,117014832.0,0.8113,0.8178,0.8095,0.821
2023-09-11 17:55,1708,349,1359,199298,6363,192935,162515704.0,5160612.0,157355092.0,1621,285,1336,194098,3414,190684,158358258.0,2744945.0,155613313.0,0.811,0.8156,0.804,0.8161
2023-09-11 18:00,2897,1582,1315,308339,202874,105465,252332277.0,165867323.0,86464954.0,2737,1510,1227,293864,193819,100045,240883304.0,158191661.0,82691643.0,0.8176,0.8198,0.8162,0.8265
2023-09-11 18:05,1461,751,710,93328,39868,53460,76498281.0,32644279.0,43854002.0,1378,708,670,90676,37857,52819,74272251.0,30880056.0,43392194.0,0.8188,0.8203,0.8157,0.8215
2023-09-11 18:10,1238,764,474,99342,72862,26480,81539977.0,59427075.0,22112901.0,1191,748,443,99077,74516,24561,80700785.0,60551029.0,20149756.0,0.8156,0.8351,0.8126,0.8204
2023-09-11 18:15,1395,929,466,129645,103215,26430,105412162.0,83970448.0,21441714.0,1338,903,435,127181,102150,25031,103581404.0,83075575.0,20505829.0,0.8135,0.8113,0.8133,0.8192
2023-09-11 18:20,1967,982,985,177948,79245,98703,144944854.0,64500369.0,80444484.0,1877,929,948,174163,77918,96245,141955590.0,63337831.0,78617758.0,0.8139,0.815,0.8129,0.8169
2023-09-11 18:25,2676,959,1717,298281,98678,199603,244337411.0,81529319.0,162808092.0,2256,734,1522,262836,82616,180220,214533930.0,66614742.0,147919188.0,0.8262,0.8157,0.8063,0.8208
2023-09-11 18:30,1004,541,463,63940,28602,35338,52772545.0,23163249.0,29609296.0,775,423,352,61199,26748,34451,52216490.0,23414077.0,28802413.0,0.8098,0.8379,0.8754,0.836
2023-09-11 18:35,1786,912,874,165699,63968,101731,136348483.0,51704280.0,84644203.0,1633,826,807,158501,60959,97542,130581522.0,49119749.0,81461773.0,0.8083,0.832,0.8058,0.8351
2023-09-12 10:00,4694,1952,2742,384897,132402,252495,319067361.0,108768054.0,210299307.0,4014,1650,2364,338098,108579,229519,278786000.0,88351112.0,190434888.0,0.8215,0.8329,0.8137,0.8297
2023-09-12 10:05,6500,4787,1713,763453,633639,129814,626849599.0,519838853.0,107010746.0,6055,4598,1457,721561,614784,106777,591441788.0,503371320.0,88070468.0,0.8204,0.8243,0.8188,0.8248
2023-09-12 10:10,4311,1743,2568,425299,169031,256268,348018125.0,138303591.0,209714533.0,4032,1591,2441,412250,163648,248602,337843639.0,133791309.0,204052329.0,0.8182,0.8183,0.8176,0.8208
2023-09-12 10:15,3567,2281,1286,317976,189721,128255,261863091.0,156429801.0,105433290.0,3100,2034,1066,271158,161137,110021,222711981.0,132098541.0,90613440.0,0.8245,0.8221,0.8198,0.8236
2023-09-12 10:20,3249,1635,1614,290835,143149,147686,239163206.0,117298510.0,121864696.0,2974,1515,1459,266708,126951,139757,219774179.0,104263605.0,115510573.0,0.8194,0.8252,0.8213,0.8265
2023-09-12 10:25,3628,2078,1550,296303,200951,95352,244788144.0,165984067.0,78804077.0,3281,1918,1363,271237,190570,80667,223691676.0,156822321.0,66869355.0,0.826,0.8265,0.8229,0.829
2023-09-12 10:30,4836,2390,2446,436514,219890,216624,360112404.0,181408531.0,178703873.0,4590,2291,2299,420944,210909,210035,347021630.0,173415277.0,173606352.0,0.825,0.8249,0.8222,0.8266
2023-09-12 10:35,2323,1407,916,155138,89576,65562,128242048.0,74164724.0,54077323.0,2115,1315,800,137439,78867,58572,113629222.0,65055161.0,48574061.0,0.828,0.8248,0.8249,0.8293
2023-09-12 10:40,8290,1196,7094,1231126,66882,1164244,1018956990.0,55160967.0,963796023.0,8090,1094,6996,1214764,61735,1153029,1005982921.0,50842408.0,955140513.0,0.8248,0.8278,0.8236,0.8284
2023-09-12 10:45,2881,1632,1249,260459,169599,90860,214867465.0,139751341.0,75116124.0,2704,1552,1152,255684,164172,91512,210913819.0,135167905.0,75745914.0,0.824,0.8267,0.8233,0.8277
2023-09-12 10:50,2297,835,1462,192206,57219,134987,157776741.0,46919818.0,110856923.0,2101,748,1353,171126,46922,124204,141091965.0,38596064.0,102495901.0,0.82,0.8212,0.8226,0.8252
2023-09-12 10:55,1339,604,735,129101,64281,64820,106294461.0,52874251.0,53420210.0,1238,555,683,126231,62523,63708,103950335.0,51395360.0,52554975.0,0.8225,0.8241,0.822,0.8249
2023-09-12 11:00,1274,442,832,105276,13661,91615,86914929.0,11279004.0,75635925.0,1166,402,764,99761,10051,89710,82450821.0,8264378.0,74186443.0,0.8256,0.8256,0.8222,0.827
2023-09-12 11:05,1757,716,1041,138760,48704,90056,114358719.0,40288184.0,74070535.0,1662,663,999,128302,43642,84660,105808189.0,35900564.0,69907625.0,0.8272,0.8225,0.8226,0.8257
2023-09-12 11:10,1908,625,1283,165905,42512,123393,136771427.0,35165637.0,101605790.0,1807,572,1235,158539,39536,119003,130719251.0,32530191.0,98189059.0,0.8272,0.8234,0.8228,0.8251
2023-09-12 11:15,1698,517,1181,164673,14881,149792,135765014.0,12214969.0,123550044.0,1647,496,1151,163172,14108,149064,134565500.0,11598307.0,122967192.0,0.8208,0.8248,0.8221,0.8249
2023-09-12 11:20,1979,489,1490,174907,13601,161306,143997512.0,11197817.0,132799694.0,1871,415,1456,172276,12646,159630,142055681.0,10380456.0,131675224.0,0.8233,0.8233,0.8208,0.8249
2023-09-12 11:25,1939,729,1210,159895,24085,135810,131591356.0,19772560.0,111818796.0,1822,679,1143,153261,21924,131337,126224961.0,17989828.0,108235132.0,0.8209,0.8233,0.8206,0.8241
2023-09-12 11:30,906,430,476,57685,12231,45454,47551990.0,10051872.0,37500117.0,860,413,447,55906,11844,44062,46039571.0,9722568.0,36317003.0,0.8218,0.825,0.8209,0.8242
2023-09-12 11:35,1986,1067,919,186357,105312,81045,153828154.0,87007618.0,66820536.0,1905,1033,872,177480,99726,77754,146149704.0,82027273.0,64122431.0,0.8262,0.8245,0.8225,0.8247
2023-09-12 11:40,3784,2936,848,443005,401005,42000,365510202.0,330767229.0,34742973.0,3719,2916,803,434534,396385,38149,358235638.0,326524747.0,31710891.0,0.8248,0.8272,0.8238,0.8312
2023-09-12 11:45,3153,1744,1409,317547,169485,148062,261680662.0,139546581.0,122134081.0,3067,1687,1380,313404,168007,145397,258411492.0,138284125.0,120127367.0,0.8234,0.8249,0.8231,0.8262
2023-09-12 11:50,2603,1728,875,241799,188672,53127,199359166.0,155375724.0,43983442.0,2526,1690,836,232213,181437,50776,191341596.0,149349117.0,41992478.0,0.8235,0.8279,0.8231,0.827
2023-09-12 11:55,1795,997,798,146665,81881,64784,120898708.0,67475279.0,53423428.0,1745,970,775,145730,83558,62172,120099451.0,68719945.0,51379506.0,0.8241,0.8246,0.8224,0.8264
2023-09-12 12:00,2728,1266,1462,246418,79144,167274,203039732.0,65044580.0,137995151.0,2665,1234,1431,245085,82075,163010,202059874.0,67502483.0,134557391.0,0.8219,0.825,0.8224,0.8255
2023-09-12 12:05,2986,2227,759,323848,277888,45960,268432438.0,230346362.0,38086075.0,2718,2073,645,308657,266748,41909,255070386.0,220425221.0,34645165.0,0.8289,0.8287,0.8263,0.8267
2023-09-12 12:10,3855,2367,1488,343006,219500,123506,283241733.0,181511693.0,101730039.0,3530,2204,1326,330037,216813,113224,272884290.0,178933997.0,93950292.0,0.8269,0.8237,0.8253,0.8298
2023-09-12 12:15,1917,817,1100,129999,60786,69213,107393934.0,50167013.0,57226921.0,1838,760,1078,125895,57777,68118,104039692.0,47627445.0,56412247.0,0.8253,0.8268,0.8243,0.8282
2023-09-12 12:20,1684,486,1198,142158,11589,130569,117537106.0,9545267.0,107991838.0,1625,458,1167,138286,11495,126791,114369841.0,9442297.0,104927543.0,0.8236,0.8271,0.8214,0.8276
2023-09-12 12:25,817,315,502,62408,14785,47623,51676243.0,12255725.0,39420518.0,741,274,467,56169,11710,44459,46516634.0,9660449.0,36856184.0,0.8289,0.8278,0.825,0.829
2023-09-12 12:30,1032,427,605,75250,17187,58063,62119362.0,14199055.0,47920307.0,987,400,587,71881,15516,56365,59452256.0,12803530.0,46648726.0,0.8262,0.8253,0.8252,0.8276
2023-09-12 12:35,3257,938,2319,343470,58317,285153,283289464.0,48031046.0,235258418.0,3184,904,2280,340225,56936,283289,280889253.0,46837701.0,234051552.0,0.8236,0.825,0.8226,0.8262
2023-09-12 12:40,2988,1120,1868,259683,61741,197942,213287331.0,50708994.0,162578336.0,2927,1089,1838,254568,61514,193054,209709873.0,50412609.0,159297264.0,0.8213,0.8213,0.8195,0.8251
2023-09-12 12:45,2455,1122,1333,272199,82939,189260,224443907.0,68385110.0,156058797.0,2371,1076,1295,261306,78379,182927,215120935.0,64331500.0,150789434.0,0.8245,0.8246,0.8208,0.8243
2023-09-12 12:50,2398,1349,1049,290185,146460,143725,238800117.0,120348875.0,118451241.0,2335,1317,1018,284308,143936,140372,233987498.0,118187516.0,115799982.0,0.8217,0.8242,0.8211,0.825
2023-09-12 12:55,1468,1173,295,173742,153847,19895,142741886.0,126325402.0,16416483.0,1433,1157,276,171329,153150,18179,140744687.0,125743451.0,15001236.0,0.8211,0.8252,0.821,0.8252
2023-09-12 13:00,1271,923,348,163974,131801,32173,134675306.0,108221585.0,26453721.0,1234,907,327,162543,131773,30770,133555839.0,108195293.0,25360545.0,0.8211,0.8222,0.8211,0.8242
2023-09-12 13:05,1405,773,632,114825,61292,53533,93910703.0,50135242.0,43775460.0,1354,727,627,111595,57301,54294,91738583.0,46950770.0,44787813.0,0.818,0.8177,0.8194,0.8249
2023-09-12 13:10,1356,519,837,114018,32474,81544,93188338.0,26143142.0,67045196.0,1274,466,808,104744,24510,80234,85976064.0,19949261.0,66026802.0,0.805,0.8222,0.8139,0.8229
2023-09-12 13:15,1366,720,646,109316,71158,38158,89738282.0,58378129.0,31360153.0,1319,698,621,107105,69821,37284,87818146.0,57170522.0,30647623.0,0.8204,0.8219,0.8188,0.822
2023-09-12 13:20,2724,768,1956,236773,29272,207501,194087984.0,23948880.0,170139104.0,2662,727,1935,230870,26219,204651,189615790.0,21454016.0,168161774.0,0.8181,0.8199,0.8183,0.8217
2023-09-12 13:25,477,268,209,29457,9319,20138,24198785.0,7623627.0,16575158.0,437,246,191,27106,8127,18979,22271078.0,6653187.0,15617891.0,0.8181,0.8231,0.8187,0.8229
2023-09-12 13:30,2542,1699,843,268792,204203,64589,220863041.0,167672906.0,53190135.0,2480,1669,811,264787,201541,63246,217402953.0,165297212.0,52105740.0,0.8211,0.8235,0.8202,0.8239
2023-09-12 13:35,3962,2029,1933,396170,190179,205991,328365353.0,156093783.0,172271570.0,3911,2008,1903,392974,188499,204475,323285158.0,154672023.0,168613135.0,0.8208,0.8363,0.8205,0.8246
2023-09-12 13:40,2784,1203,1581,300930,96482,204448,247604614.0,79129200.0,168475414.0,2752,1193,1559,301301,97332,203969,247942378.0,79776340.0,168166037.0,0.8201,0.8241,0.8196,0.8245
2023-09-12 13:45,1016,546,470,81915,45433,36482,67333582.0,37283857.0,30049725.0,975,522,453,82016,46458,35558,67395282.0,38099517.0,29295765.0,0.8206,0.8237,0.8201,0.8239
2023-09-12 13:50,317,57,260,10803,2042,8761,8829943.0,1675025.0,7154918.0,301,48,253,10259,2119,8140,8446190.0,1737608.0,6708582.0,0.8203,0.8167,0.82,0.8242
2023-09-12 13:55,448,228,220,44350,16673,27677,36481859.0,13680193.0,22801665.0,436,220,216,45129,16477,28652,37128136.0,13518081.0,23610055.0,0.8205,0.8238,0.8204,0.824
2023-09-12 14:00,2773,1403,1370,232418,80297,152121,190678061.0,65789900.0,124888161.0,2728,1380,1348,234292,84276,150016,192190268.0,68803594.0,123386674.0,0.8193,0.821,0.8164,0.8225
2023-09-12 14:05,3341,1509,1832,272521,110742,161779,222605381.0,90448424.0,132156957.0,3150,1402,1748,258989,105685,153304,212282419.0,86325969.0,125956449.0,0.8167,0.8169,0.8168,0.8216
2023-09-12 14:10,3995,2435,1560,280697,185163,95534,230098872.0,151460647.0,78638225.0,3681,2154,1527,277706,183037,94669,227615317.0,149706592.0,77908725.0,0.818,0.8231,0.8179,0.823
2023-09-12 14:15,2251,1262,989,159612,111441,48171,130855470.0,91195711.0,39659759.0,2206,1244,962,159305,111941,47364,130529024.0,91531192.0,38997832.0,0.8183,0.8233,0.8177,0.8234
2023-09-12 14:20,2245,1367,878,170844,113232,57612,140100265.0,92629988.0,47470277.0,2212,1346,866,168153,110943,57210,137935125.0,90753009.0,47182116.0,0.8181,0.824,0.818,0.8247
2023-09-12 14:25,1387,788,599,91213,60821,30392,74827505.0,49816330.0,25011175.0,1356,776,580,89927,60319,29608,73766941.0,49379505.0,24387436.0,0.8191,0.823,0.8186,0.8237
2023-09-12 14:30,1199,550,649,62897,37728,25169,51587995.0,30933062.0,20654932.0,1136,516,620,59361,35416,23945,48693192.0,28989478.0,19703714.0,0.8199,0.8206,0.8185,0.8229
2023-09-12 14:35,2611,1446,1165,184777,124591,60186,151759988.0,102185311.0,49574676.0,2566,1424,1142,183531,124318,59213,150576709.0,101812152.0,48764556.0,0.8202,0.8237,0.819,0.8235
2023-09-12 14:40,870,422,448,53802,37099,16703,44086926.0,30400737.0,13686189.0,842,402,440,52100,36065,16035,42760734.0,29534988.0,13225745.0,0.8194,0.8194,0.8189,0.8248
2023-09-12 14:45,2889,1788,1101,222161,143958,78203,181446693.0,117522956.0,63923736.0,2833,1756,1077,218753,143078,75675,178952400.0,116778671.0,62173729.0,0.8164,0.8174,0.8162,0.8216
2023-09-12 14:50,2410,1572,838,201785,135830,65955,165342794.0,111276564.0,54066229.0,2329,1534,795,193220,131473,61747,158227768.0,107470489.0,50757279.0,0.8192,0.8197,0.8174,0.822
2023-09-12 14:55,1871,1069,802,139248,56275,82973,113870934.0,46045180.0,67825754.0,1814,1022,792,136153,55009,81144,111566162.0,44966463.0,66599699.0,0.8182,0.8174,0.8174,0.8208
2023-09-12 15:00,2188,1160,1028,155453,62225,93228,127205022.0,50841764.0,76363257.0,2131,1130,1001,152936,61668,91268,125231466.0,50377139.0,74854326.0,0.8171,0.8191,0.8169,0.8202
2023-09-12 15:05,1623,915,708,101440,24564,76876,82833811.0,19976986.0,62856825.0,1542,865,677,98503,23969,74534,80555804.0,19519228.0,61036575.0,0.8133,0.8176,0.8144,0.8189
2023-09-12 15:10,2496,1034,1462,198594,49566,149028,160671441.0,40200754.0,120470687.0,2242,844,1398,179231,38224,141007,145806079.0,30963102.0,114842976.0,0.8111,0.8084,0.81,0.8144
2023-09-12 15:15,1798,792,1006,144043,83697,60346,118230951.0,68900033.0,49330918.0,1667,744,923,133948,78780,55168,109202912.0,64049533.0,45153378.0,0.8232,0.8175,0.813,0.8185
2023-09-12 15:20,3908,2120,1788,369842,247353,122489,302093514.0,201684487.0,100409027.0,3803,2072,1731,360422,242991,117431,294429742.0,198076814.0,96352928.0,0.8154,0.8197,0.8152,0.8205
2023-09-12 15:25,1621,875,746,133105,84728,48377,108566403.0,69092696.0,39473707.0,1521,829,692,129848,83392,46456,105960561.0,67878470.0,38082090.0,0.8155,0.816,0.814,0.8197
2023-09-12 15:30,594,226,368,49055,21699,27356,40007569.0,17703777.0,22303792.0,550,201,349,45530,19769,25761,37245701.0,16126253.0,21119447.0,0.8159,0.8153,0.8157,0.8198
2023-09-12 15:35,1255,431,824,105461,32296,73165,86256341.0,26379067.0,59877273.0,1200,400,800,103653,31119,72534,84829789.0,25393137.0,59436651.0,0.8168,0.8184,0.816,0.8194
2023-09-12 15:40,776,606,170,51374,38924,12450,41991564.0,31799557.0,10192007.0,750,596,154,50721,38790,11931,41470719.0,31682323.0,9788396.0,0.817,0.8186,0.8168,0.8204
2023-09-12 15:45,3627,443,3184,413880,32205,381675,338041706.0,26260582.0,311781124.0,3573,419,3154,411761,31310,380451,336428098.0,25526902.0,310901196.0,0.8154,0.8169,0.8153,0.8172
2023-09-12 15:50,1621,447,1174,168415,25540,142875,137647587.0,20797703.0,116849884.0,1593,427,1166,167140,25154,141986,136610376.0,20485346.0,116125029.0,0.8143,0.8178,0.8144,0.8179
2023-09-12 15:55,689,456,233,53513,24474,29039,43740879.0,19941007.0,23799872.0,657,434,223,52375,23313,29062,42801079.0,18992288.0,23808791.0,0.8148,0.8196,0.8147,0.8192
2023-09-12 16:00,217,101,116,16047,8057,7990,13089006.0,6562856.0,6526149.0,202,90,112,15761,7980,7781,12871962.0,6499805.0,6372156.0,0.8146,0.8168,0.8145,0.8189
2023-09-12 16:05,383,187,196,30851,17188,13663,25189203.0,14017084.0,11172118.0,353,170,183,27400,13867,13533,22381789.0,11298538.0,11083251.0,0.8155,0.8177,0.8148,0.819
2023-09-12 16:10,1718,1003,715,179722,121600,58122,147694142.0,99940157.0,47753984.0,1652,976,676,173808,118531,55277,142341318.0,96908446.0,45432871.0,0.8219,0.8216,0.8176,0.8219
2023-09-12 16:15,1169,707,462,85421,58433,26988,69788552.0,47747761.0,22040791.0,1107,674,433,81419,57642,23777,66639951.0,47094319.0,19545632.0,0.8171,0.8167,0.817,0.822
2023-09-12 16:20,1976,1281,695,169512,129765,39747,138572724.0,105999875.0,32572848.0,1951,1261,690,167103,127723,39380,136610045.0,104336550.0,32273495.0,0.8169,0.8195,0.8169,0.8195
2023-09-12 16:25,1895,1014,881,145024,95779,49245,118726920.0,78336109.0,40390811.0,1867,994,873,144378,94979,49399,118194829.0,77655723.0,40539105.0,0.8179,0.8202,0.8176,0.8206
2023-09-12 16:30,1268,864,404,112112,85934,26178,91765328.0,70316580.0,21448747.0,1226,846,380,108561,84939,23622,88861049.0,69454096.0,19406952.0,0.8183,0.8193,0.8177,0.8216
2023-09-12 16:35,1252,949,303,94635,79346,15289,77393265.0,64839781.0,12553484.0,1223,930,293,93443,78310,15133,76409097.0,63978435.0,12430662.0,0.8172,0.8211,0.817,0.8214
2023-09-12 16:40,336,229,107,30347,23003,7344,24899879.0,18850801.0,6049078.0,306,216,90,28611,21890,6721,23426451.0,17881227.0,5545224.0,0.8195,0.8237,0.8169,0.8251
2023-09-12 16:45,315,177,138,29711,22821,6890,24320901.0,18649215.0,5671685.0,298,172,126,28803,22980,5823,23554649.0,18771776.0,4782873.0,0.8172,0.8232,0.8169,0.8214
2023-09-12 16:50,575,469,106,49559,41399,8160,40486099.0,33799032.0,6687066.0,567,466,101,48017,39991,8026,39257103.0,32665832.0,6591271.0,0.8164,0.8195,0.8168,0.8212
2023-09-12 16:55,558,385,173,57148,45838,11310,46693000.0,37425794.0,9267205.0,530,375,155,57142,45922,11220,46697908.0,37493575.0,9204333.0,0.8165,0.8194,0.8165,0.8204
2023-09-12 17:00,724,218,506,45347,27631,17716,37084287.0,22553916.0,14530371.0,706,206,500,45399,27321,18078,37132233.0,22296871.0,14835362.0,0.8163,0.8202,0.8161,0.8206
2023-09-12 17:05,272,140,132,25280,15669,9611,20711268.0,12820833.0,7890435.0,249,121,128,24655,15328,9327,20188289.0,12515036.0,7673253.0,0.8182,0.821,0.8165,0.8227
2023-09-12 17:10,306,162,144,30766,20125,10641,25121014.0,16437116.0,8683898.0,281,142,139,30045,19072,10973,24571377.0,15563733.0,9007643.0,0.8168,0.8161,0.8161,0.8209
2023-09-12 17:15,687,410,277,65624,47644,17980,53685202.0,38971746.0,14713456.0,652,395,257,65444,48282,17162,53518025.0,39424454.0,14093571.0,0.818,0.8183,0.8165,0.8212
2023-09-12 17:20,1239,484,755,105765,54211,51554,86746833.0,44423502.0,42323331.0,1196,459,737,104407,52256,52151,85594183.0,42709948.0,42884235.0,0.8195,0.821,0.8173,0.8223
2023-09-12 17:25,884,502,382,82303,62038,20265,67417103.0,50760054.0,16657048.0,853,488,365,77473,59696,17777,63468039.0,48851862.0,14616176.0,0.8182,0.822,0.8183,0.8222
2023-09-12 17:30,201,91,110,13714,8710,5004,11325274.0,7213456.0,4111817.0,166,76,90,16231,8177,8054,13339039.0,6686256.0,6652783.0,0.8282,0.8217,0.8177,0.826
2023-09-12 17:35,3124,2942,182,423444,411903,11541,347063595.0,337564270.0,9499325.0,3104,2927,177,423743,410566,13177,347300428.0,336439336.0,10861092.0,0.8195,0.8231,0.8195,0.8242
2023-09-12 17:40,692,534,158,84542,70018,14524,69378961.0,57535614.0,11843346.0,642,504,138,81259,69486,11773,66662190.0,56937292.0,9724898.0,0.8217,0.8154,0.8194,0.826
2023-09-12 17:45,643,544,99,39676,35286,4390,32503983.0,28903249.0,3600733.0,347,255,92,39825,35142,4683,32637866.0,28783949.0,3853916.0,0.8191,0.8202,0.8191,0.823
2023-09-12 17:50,200,91,109,22208,15197,7011,18230118.0,12459674.0,5770443.0,191,85,106,22018,14594,7424,18051842.0,11935904.0,6115938.0,0.8199,0.8231,0.8179,0.8238
2023-09-12 17:55,225,136,89,26792,17055,9737,21977772.0,13994685.0,7983086.0,188,119,69,24525,15744,8781,20109930.0,12868982.0,7240947.0,0.8206,0.8199,0.8174,0.8246
2023-09-12 18:00,588,365,223,66619,48645,17974,54766326.0,40258153.0,14508173.0,475,293,182,59643,44581,15062,48973839.0,36534401.0,12439438.0,0.8276,0.8072,0.8195,0.8259
2023-09-12 18:05,886,407,479,88663,28191,60472,72407248.0,23089942.0,49317306.0,796,339,457,83419,25817,57602,68508163.0,21119093.0,47389070.0,0.8191,0.8155,0.818,0.8227
2023-09-12 18:10,976,311,665,124207,26739,97468,101688718.0,21881170.0,79807547.0,942,288,654,124435,27808,96627,101933804.0,22612326.0,79321478.0,0.8183,0.8188,0.8132,0.8209
2023-09-12 18:15,2026,1378,648,171037,111584,59453,140301135.0,91407393.0,48893742.0,1883,1266,617,163682,106678,57004,134182405.0,87274667.0,46907737.0,0.8192,0.8224,0.8181,0.8229
2023-09-12 18:20,915,372,543,69243,27731,41512,56890094.0,22783975.0,34106118.0,851,331,520,66680,26786,39894,54763038.0,21930358.0,32832679.0,0.8216,0.8216,0.8187,0.823
2023-09-12 18:25,364,147,217,26061,8792,17269,21450228.0,7246018.0,14204209.0,331,123,208,25705,8040,17665,21156902.0,6591125.0,14565777.0,0.8242,0.8225,0.8198,0.8246
2023-09-12 18:30,1981,707,1274,170486,62170,108316,139732587.0,50956352.0,88776235.0,1924,671,1253,166010,60234,105776,136246588.0,49300556.0,86946031.0,0.8196,0.8196,0.8185,0.822
2023-09-12 18:35,1231,799,432,91149,57376,33773,75250801.0,47383076.0,27867725.0,1152,749,403,85195,53245,31950,70017745.0,43654734.0,26363011.0,0.8258,0.8251,0.8199,0.8251
2023-09-13 10:00,6790,3896,2894,642474,300121,342353,537068177.0,251418882.0,285649294.0,5071,2714,2357,553574,254075,299499,461854704.0,211400261.0,250454443.0,0.8377,0.8344,0.832,0.8362
2023-09-13 10:05,5079,2637,2442,394729,180465,214264,329753155.0,151273045.0,178480110.0,3464,1724,1740,303288,136927,166361,254270938.0,114484398.0,139786540.0,0.8382,0.833,0.8361,0.8403
2023-09-13 10:10,3650,2302,1348,301459,213046,88413,254217385.0,180120660.0,74096725.0,2612,1649,963,224681,163382,61299,188452422.0,136806011.0,51646411.0,0.8455,0.8381,0.8373,0.8425
2023-09-13 10:15,3582,1790,1792,291850,137748,154102,245113576.0,116187727.0,128925849.0,2767,1352,1415,268401,136442,131959,225475586.0,114310660.0,111164926.0,0.8435,0.8366,0.8378,0.8424
2023-09-13 10:20,2717,1389,1328,219885,85898,133987,182784208.0,71970289.0,110813919.0,2174,1012,1162,171074,65088,105986,143439873.0,54370744.0,89069129.0,0.8379,0.827,0.8353,0.8404
2023-09-13 10:25,1255,621,634,79133,45237,33896,66838081.0,38388979.0,28449102.0,995,441,554,71829,35782,36047,60288751.0,29949613.0,30339137.0,0.8486,0.8393,0.837,0.8417
2023-09-13 10:30,1642,915,727,118906,65910,52996,100127364.0,55522731.0,44604633.0,1361,767,594,98238,53497,44741,82545891.0,44837960.0,37707930.0,0.8424,0.8417,0.8381,0.8428
2023-09-13 10:35,1062,428,634,75613,33157,42456,63143394.0,27746819.0,35396574.0,880,331,549,68454,30862,37592,57364999.0,25727586.0,31637412.0,0.8368,0.8337,0.8336,0.8416
2023-09-13 10:40,1342,617,725,102045,27760,74285,84311596.0,23291697.0,61019899.0,1053,423,630,80469,21838,58631,67394607.0,18196216.0,49198390.0,0.839,0.8214,0.8332,0.8391
2023-09-13 10:45,1437,524,913,141552,26952,114600,118545662.0,22505174.0,96040487.0,1225,392,833,131597,21796,109801,110103485.0,18040607.0,92062878.0,0.835,0.838,0.8277,0.8385
2023-09-13 10:50,803,289,514,57976,27018,30958,48172873.0,22184255.0,25988618.0,656,213,443,42856,15918,26938,35902235.0,13281731.0,22620504.0,0.8211,0.8395,0.8344,0.8397
2023-09-13 10:55,801,256,545,68472,16566,51906,57446990.0,13862162.0,43584827.0,681,184,497,67729,15876,51853,56938021.0,13258074.0,43679946.0,0.8368,0.8397,0.8351,0.8424
2023-09-13 11:00,883,427,456,72722,34558,38164,60777538.0,28900162.0,31877375.0,723,355,368,68407,33567,34840,57228673.0,27981571.0,29247101.0,0.8363,0.8353,0.8336,0.8395
2023-09-13 11:05,913,388,525,68523,22415,46108,57094361.0,18757758.0,38336603.0,745,271,474,60726,19184,41542,50826490.0,16020703.0,34805786.0,0.8368,0.8315,0.8351,0.8378
2023-09-13 11:10,1383,634,749,109739,35840,73899,91462999.0,29882522.0,61580476.0,1195,509,686,98089,32675,65414,81872750.0,27135881.0,54736869.0,0.8338,0.8333,0.8305,0.8368
2023-09-13 11:15,1839,928,911,165800,88042,77758,137500043.0,73084076.0,64415967.0,1483,690,793,141953,73401,68552,117900614.0,60744985.0,57155629.0,0.8301,0.8284,0.8276,0.8338
2023-09-13 11:20,1586,706,880,124690,33805,90885,103512648.0,28063960.0,75448688.0,1366,574,792,117498,30493,87005,97811887.0,25294425.0,72517461.0,0.8302,0.8302,0.8295,0.8335
2023-09-13 11:25,1062,536,526,79666,33899,45767,66267976.0,28164061.0,38103914.0,903,402,501,77399,32416,44983,64358788.0,26875823.0,37482965.0,0.8308,0.8326,0.8291,0.8333
2023-09-13 11:30,2026,1276,750,167838,109881,57957,139693337.0,91477452.0,48215884.0,1871,1181,690,162182,106954,55228,134918010.0,88850292.0,46067717.0,0.8325,0.8319,0.8307,0.8341
2023-09-13 11:35,1716,918,798,128586,48385,80201,106850110.0,40187447.0,66662663.0,1583,826,757,122093,44613,77480,101625917.0,37029126.0,64596790.0,0.8306,0.8312,0.83,0.8337
2023-09-13 11:40,603,288,315,46289,23157,23132,38534381.0,19252130.0,19282251.0,535,257,278,43664,21491,22173,36315672.0,17825426.0,18490246.0,0.8314,0.8336,0.8294,0.8339
2023-09-13 11:45,523,308,215,47376,30988,16388,39418554.0,25734065.0,13684489.0,441,261,180,51438,36673,14765,42209441.0,29888846.0,12320594.0,0.8305,0.835,0.815,0.8344
2023-09-13 11:50,901,415,486,64645,39648,24997,53762727.0,32938909.0,20823817.0,845,377,468,61818,38499,23319,51374905.0,31937332.0,19437573.0,0.8308,0.8331,0.8296,0.8336
2023-09-13 11:55,535,270,265,44465,23123,21342,36980826.0,19273004.0,17707821.0,461,220,241,40702,22374,18328,33872873.0,18570523.0,15302350.0,0.8335,0.8297,0.83,0.8349
2023-09-13 12:00,141,91,50,11899,7240,4659,9851933.0,5969541.0,3882392.0,104,66,38,15670,12022,3648,12543899.0,9499674.0,3044225.0,0.8245,0.8333,0.7902,0.8345
2023-09-13 12:05,900,305,595,68890,16592,52298,57086000.0,13798148.0,43287852.0,811,256,555,65311,14926,50385,54324221.0,12377883.0,41946337.0,0.8316,0.8277,0.8293,0.8325
2023-09-13 12:10,641,182,459,49863,6558,43305,41499284.0,5451354.0,36047929.0,579,147,432,48771,6019,42752,40592253.0,4991917.0,35600335.0,0.8313,0.8324,0.8294,0.8327
2023-09-13 12:15,3101,685,2416,313551,29122,284429,260319602.0,24113608.0,236205993.0,3016,629,2387,309756,27330,282426,257239498.0,22629343.0,234610155.0,0.828,0.8305,0.828,0.8307
2023-09-13 12:20,1738,326,1412,186284,18529,167755,154465885.0,15341004.0,139124881.0,1633,254,1379,181470,16118,165352,150657201.0,13334414.0,137322786.0,0.8279,0.8293,0.8273,0.8305
2023-09-13 12:25,1192,599,593,104796,46221,58575,87120249.0,38413159.0,48707089.0,1129,562,567,102245,43177,59068,84906554.0,35781632.0,49124921.0,0.8311,0.8315,0.8287,0.8317
2023-09-13 12:30,889,405,484,50095,25556,24539,41631934.0,21211383.0,20420551.0,839,379,460,47185,24363,22822,39194014.0,20194196.0,18999818.0,0.83,0.8322,0.8289,0.8325
2023-09-13 12:35,276,148,128,18740,7666,11074,15520882.0,6347013.0,9173868.0,228,101,127,19812,7665,12147,16448569.0,6338227.0,10110341.0,0.8279,0.8284,0.8269,0.8323
2023-09-13 12:40,314,162,152,27901,8509,19392,23226616.0,7107568.0,16119047.0,271,143,128,28037,9213,18824,23285453.0,7623640.0,15661813.0,0.8353,0.8312,0.8275,0.832
2023-09-13 12:45,1349,611,738,144618,43915,100703,120058662.0,36314572.0,83744090.0,1301,581,720,142415,42225,100190,118268970.0,34943693.0,83325277.0,0.8269,0.8316,0.8276,0.8317
2023-09-13 12:50,1169,579,590,99553,33599,65954,82684312.0,27856940.0,54827372.0,1131,553,578,96366,30530,65836,80020180.0,25287766.0,54732414.0,0.8291,0.8313,0.8283,0.8313
2023-09-13 12:55,616,366,250,47762,13923,33839,39683344.0,11571589.0,28111755.0,581,343,238,46791,13469,33322,38885939.0,11171841.0,27714098.0,0.8311,0.8308,0.8294,0.8317
2023-09-13 13:00,913,380,533,72659,12377,60282,60216607.0,10290675.0,49925931.0,834,341,493,69148,10725,58423,57487998.0,8867400.0,48620598.0,0.8314,0.8282,0.8268,0.8322
2023-09-13 13:05,1155,280,875,104923,17593,87330,87246948.0,14658792.0,72588155.0,1109,257,852,102267,16110,86157,84961976.0,13330225.0,71631751.0,0.8332,0.8312,0.8275,0.8314
2023-09-13 13:10,1783,668,1115,188030,51124,136906,155050964.0,42236749.0,112814214.0,1619,563,1056,174757,46078,128679,144797203.0,38044577.0,106752625.0,0.8262,0.824,0.8257,0.8296
2023-09-13 13:15,2454,991,1463,225453,71207,154246,185535861.0,58389764.0,127146097.0,2190,831,1359,207609,59722,147887,171359878.0,49044151.0,122315726.0,0.82,0.8243,0.8212,0.8271
2023-09-13 13:20,3138,1199,1939,296248,87988,208260,244074010.0,72475560.0,171598450.0,2911,1075,1836,283085,84053,199032,233030797.0,68755486.0,164275310.0,0.8237,0.824,0.818,0.8254
2023-09-13 13:25,1463,871,592,108848,63937,44911,89560317.0,52552873.0,37007444.0,1370,823,547,102854,60820,42034,84567251.0,49847123.0,34720128.0,0.8219,0.824,0.8196,0.826
2023-09-13 13:30,3375,1950,1425,347124,221165,125959,286998080.0,182768057.0,104230022.0,3255,1892,1363,336242,216949,119293,277907688.0,179011538.0,98896150.0,0.8264,0.8275,0.8251,0.829
2023-09-13 13:35,3587,1515,2072,346897,144619,202278,287627059.0,119666832.0,167960227.0,3416,1440,1976,331846,137028,194818,274984700.0,113150804.0,161833896.0,0.8275,0.8303,0.8257,0.8307
2023-09-13 13:40,2043,1071,972,195183,104805,90378,161541240.0,86635001.0,74906238.0,1912,1010,902,185137,99446,85691,153477026.0,82244897.0,71232129.0,0.8266,0.8288,0.827,0.8313
2023-09-13 13:45,1154,672,482,101139,48887,52252,83879793.0,40518812.0,43360981.0,1098,645,453,94192,46674,47518,78120548.0,38614012.0,39506535.0,0.8288,0.8298,0.8273,0.8314
2023-09-13 13:50,3283,1164,2119,320693,86632,234061,264961896.0,71527316.0,193434580.0,3146,1085,2061,312008,81777,230231,258209808.0,67451176.0,190758632.0,0.8256,0.8264,0.8248,0.8286
2023-09-13 13:55,1704,733,971,170657,40655,130002,141278309.0,33582698.0,107695611.0,1615,684,931,165894,38900,126994,137240505.0,32021211.0,105219294.0,0.826,0.8284,0.8232,0.8285
2023-09-13 14:00,1800,626,1174,171977,41426,130551,142336597.0,34321277.0,108015320.0,1717,579,1138,168299,39225,129074,139165018.0,32310703.0,106854315.0,0.8285,0.8274,0.8237,0.8279
2023-09-13 14:05,781,386,395,73342,33274,40068,60390500.0,27351047.0,33039453.0,698,336,362,63842,28250,35592,52701708.0,23258785.0,29442922.0,0.822,0.8246,0.8233,0.8272
2023-09-13 14:10,1395,550,845,127750,42370,85380,105645676.0,35050569.0,70595106.0,1335,521,814,122367,40117,82250,101047756.0,33020376.0,68027379.0,0.8272,0.8268,0.8231,0.8271
2023-09-13 14:15,1400,652,748,126961,43053,83908,104900595.0,35561881.0,69338714.0,1319,610,709,121095,41420,79675,99939029.0,34067195.0,65871834.0,0.826,0.8264,0.8225,0.8268
2023-09-13 14:20,1058,294,764,82019,20150,61869,67691868.0,16586071.0,51105797.0,991,257,734,79465,18173,61292,65614518.0,14952275.0,50662242.0,0.8231,0.826,0.8228,0.8266
2023-09-13 14:25,978,452,526,88134,22581,65553,72682885.0,18585444.0,54097441.0,942,434,508,88937,23879,65058,73399382.0,19644445.0,53754937.0,0.8231,0.8252,0.8227,0.8263
2023-09-13 14:30,3272,1617,1655,305500,123119,182381,251158554.0,101081043.0,150077511.0,3191,1566,1625,299505,121085,178420,246609411.0,99386937.0,147222473.0,0.821,0.8229,0.8208,0.8251
2023-09-13 14:35,1385,496,889,143205,30045,113160,117763907.0,24653415.0,93110491.0,1266,410,856,138457,27817,110640,114038694.0,22786791.0,91251902.0,0.8205,0.8228,0.8192,0.8248
2023-09-13 14:40,2218,809,1409,203642,51333,152309,167737047.0,42267633.0,125469414.0,2146,766,1380,200071,48787,151284,164674661.0,39994956.0,124679705.0,0.8234,0.8238,0.8198,0.8241
2023-09-13 14:45,2572,1132,1440,251287,83158,168129,206038397.0,68062038.0,137976358.0,2467,1086,1381,245030,80709,164321,201268196.0,66005434.0,135262761.0,0.8185,0.8207,0.8178,0.8232
2023-09-13 14:50,15110,3973,11137,1862365,397284,1465081,1526491904.0,324332109.0,1202159795.0,14943,3875,11068,1853070,392756,1460314,1518862716.0,320337023.0,1198525693.0,0.8164,0.8205,0.8156,0.8207
2023-09-13 14:55,8936,1426,7510,1002054,106522,895532,822518150.0,87283305.0,735234844.0,8825,1378,7447,997553,104750,892803,818594883.0,85543348.0,733051534.0,0.8194,0.821,0.8166,0.8211
2023-09-13 15:00,1795,637,1158,133000,41445,91555,108475090.0,33662659.0,74812431.0,1621,519,1102,122900,36336,86564,100507938.0,29584519.0,70923418.0,0.8122,0.8171,0.8142,0.8193
2023-09-13 15:05,4234,1543,2691,424566,121625,302941,341801558.0,98216290.0,243585267.0,3663,1201,2462,358163,92762,265401,290904255.0,74987758.0,215916497.0,0.8075,0.8041,0.8084,0.8135
2023-09-13 15:10,6772,3373,3399,606042,282863,323179,487824327.0,228374914.0,259449413.0,5884,2843,3041,548471,246831,301640,440712764.0,197807682.0,242905082.0,0.8074,0.8028,0.8014,0.8053
2023-09-13 15:15,11174,5465,5709,1177026,652161,524865,960713614.0,528620690.0,432092924.0,10465,5126,5339,1130755,626170,504585,916085535.0,505444163.0,410641372.0,0.8106,0.8232,0.8072,0.8138
2023-09-13 15:20,6884,3505,3379,702786,381231,321555,574839641.0,314081466.0,260758175.0,6618,3369,3249,686895,373435,313460,556391787.0,302018268.0,254373519.0,0.8239,0.8109,0.8088,0.8115
2023-09-13 15:25,5376,4086,1290,597534,507096,90438,484185570.0,410466892.0,73718678.0,5159,3979,1180,585541,501404,84137,475285233.0,406712774.0,68572459.0,0.8094,0.8151,0.8111,0.815
2023-09-13 15:30,4472,1016,3456,455511,55162,400349,370062621.0,45957114.0,324105506.0,4175,831,3344,433945,46116,387829,361174981.0,42532947.0,318642034.0,0.8331,0.8096,0.9223,0.8216
2023-09-13 15:35,4680,2700,1980,506474,301815,204659,418234214.0,248309118.0,169925096.0,4455,2603,1852,491418,295652,195766,399587457.0,239951028.0,159636428.0,0.8227,0.8303,0.8116,0.8154
2023-09-13 15:40,2101,957,1144,177575,94004,83571,144920238.0,76603426.0,68316812.0,1940,831,1109,167764,89732,78032,136772235.0,72895653.0,63876582.0,0.8149,0.8175,0.8124,0.8186
2023-09-13 15:45,9018,2481,6537,1070809,219042,851767,869576951.0,178312070.0,691264880.0,8722,2316,6406,1044533,206833,837700,850826556.0,168647120.0,682179436.0,0.8141,0.8116,0.8154,0.8143
2023-09-13 15:50,3417,1852,1565,318079,211057,107022,261605841.0,171207214.0,90398626.0,3157,1779,1378,310763,207546,103217,252260109.0,168111841.0,84148268.0,0.8112,0.8447,0.81,0.8153
2023-09-13 15:55,2715,1148,1567,251450,56778,194672,203099343.0,45738959.0,157360383.0,2560,1038,1522,245082,56612,188470,198364912.0,45559856.0,152805055.0,0.8056,0.8083,0.8048,0.8108
2023-09-13 16:00,3269,1313,1956,308001,87990,220011,252289094.0,71253527.0,181035567.0,3121,1239,1882,298734,83843,214891,242337167.0,67805605.0,174531562.0,0.8098,0.8228,0.8087,0.8122
2023-09-13 16:05,5033,3310,1723,471035,361447,109588,382294351.0,293145404.0,89148946.0,4946,3277,1669,464913,357367,107546,376947344.0,289431446.0,87515898.0,0.811,0.8135,0.8099,0.8138
2023-09-13 16:10,5312,3735,1577,517965,419236,98729,418983835.0,339072287.0,79911548.0,5203,3674,1529,511396,416840,94556,413908710.0,337062691.0,76846018.0,0.8088,0.8094,0.8086,0.8127
2023-09-13 16:15,3360,1103,2257,311546,68949,242597,253952716.0,56823522.0,197129193.0,3160,974,2186,299180,62750,236430,241539516.0,50503696.0,191035820.0,0.8241,0.8126,0.8048,0.808
2023-09-13 16:20,2662,1145,1517,238598,66969,171629,192904385.0,53959410.0,138944974.0,2530,1058,1472,229620,63531,166089,185558401.0,51057425.0,134500976.0,0.8057,0.8096,0.8037,0.8098
2023-09-13 16:25,3815,2230,1585,306999,184810,122189,248140845.0,149121820.0,99019024.0,3663,2153,1510,297632,178866,118766,240509887.0,144243042.0,96266845.0,0.8069,0.8104,0.8064,0.8106
2023-09-13 16:30,2005,1185,820,186347,143217,43130,150916593.0,115834823.0,35081769.0,1964,1168,796,192767,144533,48234,156084238.0,116809186.0,39275051.0,0.8088,0.8134,0.8082,0.8143
2023-09-13 16:35,2583,1674,909,230563,172674,57889,189836382.0,139672157.0,50164224.0,2522,1661,861,228891,173739,55152,185229272.0,140404042.0,44825230.0,0.8089,0.8666,0.8081,0.8128
2023-09-13 16:40,2192,942,1250,173633,59757,113876,141005563.0,48563236.0,92442327.0,2126,899,1227,167824,55597,112227,136047336.0,44920742.0,91126593.0,0.8127,0.8118,0.808,0.812
2023-09-13 16:45,1191,539,652,115816,50588,65228,93949665.0,40925428.0,53024236.0,1144,511,633,109906,44753,65153,89129274.0,36163719.0,52965555.0,0.809,0.8129,0.8081,0.8129
2023-09-13 16:50,2554,1130,1424,242829,125026,117803,200285592.0,101983024.0,98302568.0,2457,1086,1371,234065,119977,114088,200666428.0,97445240.0,103221188.0,0.8157,0.8345,0.8122,0.9048
2023-09-13 16:55,1149,693,456,68133,35414,32719,55550551.0,28882702.0,26667849.0,1091,667,424,64465,33506,30959,52496578.0,27221320.0,25275258.0,0.8156,0.8151,0.8124,0.8164
2023-09-13 17:00,1158,627,531,80166,29348,50818,67380496.0,26115352.0,41265144.0,1080,589,491,76245,27293,48952,62156234.0,22152525.0,40003708.0,0.8899,0.812,0.8117,0.8172
2023-09-13 17:05,1120,500,620,75849,23542,52307,61689750.0,19118768.0,42570981.0,1068,466,602,75393,22609,52784,61299588.0,18318684.0,42980903.0,0.8121,0.8139,0.8102,0.8143
2023-09-13 17:10,2257,1284,973,180904,88884,92020,147631375.0,72614894.0,75016480.0,2214,1260,954,177103,85983,91120,144155676.0,69874018.0,74281658.0,0.817,0.8152,0.8126,0.8152
2023-09-13 17:15,1050,761,289,62781,42359,20422,50883143.0,34440479.0,16442663.0,1000,733,267,58696,39291,19405,47544540.0,31916092.0,15628447.0,0.8131,0.8051,0.8123,0.8054
2023-09-13 17:20,1255,705,550,93043,60714,32329,75960382.0,49598992.0,26361390.0,1189,660,529,89164,56655,32509,72522821.0,45965619.0,26557202.0,0.8169,0.8154,0.8113,0.8169
2023-09-13 17:25,962,586,376,72108,51862,20246,58735592.0,42204735.0,16530856.0,922,565,357,71409,50901,20508,58155849.0,41384411.0,16771438.0,0.8138,0.8165,0.813,0.8178
2023-09-13 17:30,1366,479,887,142131,57128,85003,115547094.0,46450886.0,69096207.0,1323,462,861,137388,56049,81339,111825149.0,45510495.0,66314654.0,0.8131,0.8129,0.812,0.8153
2023-09-13 17:35,3252,829,2423,310951,100759,210192,252808526.0,81934052.0,170874473.0,3190,792,2398,305773,98990,206783,248857379.0,80393491.0,168463888.0,0.8132,0.8129,0.8121,0.8147
2023-09-13 17:40,1569,1042,527,204087,159050,45037,165842699.0,129296621.0,36546078.0,1519,1012,507,198347,155658,42689,161232993.0,126425201.0,34807792.0,0.8129,0.8115,0.8122,0.8154
2023-09-13 17:45,1571,865,706,159382,112776,46606,129964578.0,91880676.0,38083902.0,1511,832,679,154528,109917,44611,125778129.0,89315373.0,36462755.0,0.8147,0.8171,0.8126,0.8173
2023-09-13 17:50,1076,708,368,101440,74867,26573,83539872.0,61792294.0,21747578.0,1008,676,332,98096,72241,25855,82276051.0,61098623.0,21177428.0,0.8254,0.8184,0.8458,0.8191
2023-09-13 17:55,1782,1187,595,144944,108891,36053,121158226.0,91575615.0,29582611.0,1617,1105,512,132759,104310,28449,108517603.0,85144682.0,23372921.0,0.841,0.8205,0.8163,0.8216
2023-09-13 18:00,2148,1204,944,165838,113946,51892,136519727.0,93956040.0,42563687.0,1892,1071,821,153932,108657,45275,126354900.0,88979623.0,37375277.0,0.8246,0.8202,0.8189,0.8255
2023-09-13 18:05,1946,1412,534,154667,125156,29511,126790453.0,102434694.0,24355759.0,1855,1369,486,148765,125151,23614,121823202.0,102326523.0,19496678.0,0.8185,0.8253,0.8176,0.8256
2023-09-13 18:10,1140,869,271,93106,80482,12624,76411667.0,66057307.0,10354359.0,1056,829,227,87233,76451,10782,71500352.0,62605471.0,8894881.0,0.8208,0.8202,0.8189,0.825
2023-09-13 18:15,2211,1160,1051,164517,109006,55511,135852747.0,90167538.0,45685209.0,2056,1088,968,155440,103805,51635,127863773.0,85205107.0,42658666.0,0.8272,0.823,0.8208,0.8262
2023-09-13 18:20,2242,916,1326,179544,50886,128658,147562278.0,41724675.0,105837603.0,2129,850,1279,173689,49481,124208,142923080.0,40553772.0,102369307.0,0.82,0.8226,0.8196,0.8242
2023-09-13 18:25,4734,3308,1426,465956,343305,122651,379738989.0,279961563.0,99777426.0,4574,3216,1358,454527,340534,113993,371262631.0,277571514.0,93691117.0,0.8155,0.8135,0.8151,0.8219
2023-09-13 18:30,8838,5463,3375,1008629,721734,286895,824817213.0,589843548.0,234973665.0,8640,5350,3290,990324,711082,279242,810150054.0,581008920.0,229141134.0,0.8173,0.819,0.8171,0.8206
2023-09-13 18:35,2817,544,2273,261745,23858,237887,214372820.0,19484952.0,194887867.0,2750,518,2232,256973,23160,233813,210464649.0,18892550.0,191572099.0,0.8167,0.8192,0.8157,0.8193
2023-09-14 10:00,21231,16739,4492,1877505,1294054,583451,1519913368.0,1045233805.0,474679563.0,20479,16352,4127,1835269,1271037,564232,1486172441.0,1026902209.0,459270232.0,0.8077,0.8136,0.8079,0.814
2023-09-14 10:05,14515,7978,6537,1346292,562296,783996,1087468748.0,452260495.0,635208252.0,14181,7752,6429,1332396,551922,780474,1076341118.0,443611592.0,632729525.0,0.8043,0.8102,0.8038,0.8107
2023-09-14 10:10,8682,923,7759,986980,71750,915230,800606887.0,58383108.0,742223778.0,8435,818,7617,964401,60924,903477,781751847.0,49224889.0,732526958.0,0.8137,0.811,0.808,0.8108
2023-09-14 10:15,4158,1511,2647,367508,101151,266357,295579645.0,81206572.0,214373073.0,3759,1287,2472,341700,91830,249870,275478702.0,73740900.0,201737801.0,0.8028,0.8048,0.803,0.8074
2023-09-14 10:20,5833,2130,3703,467339,119540,347799,370922720.0,94886532.0,276036187.0,5082,1630,3452,425302,99762,325540,338585331.0,78822467.0,259762863.0,0.7938,0.7937,0.7901,0.7979
2023-09-14 10:25,7827,2757,5070,777973,242034,535939,621991781.0,192784721.0,429207059.0,7248,2437,4811,717312,203130,514182,572843408.0,160764817.0,412078590.0,0.7965,0.8009,0.7914,0.8014
2023-09-14 10:30,8055,5324,2731,846326,568226,278100,681313616.0,457925578.0,223388037.0,7582,5110,2472,807804,547541,260263,648776339.0,439449211.0,209327127.0,0.8059,0.8033,0.8026,0.8043
2023-09-14 10:35,1657,662,995,129865,56994,72871,104121935.0,45554261.0,58567673.0,1466,562,904,118421,53368,65053,95007446.0,42624197.0,52383249.0,0.7993,0.8037,0.7987,0.8052
2023-09-14 10:40,1929,1307,622,164188,128561,35627,132310749.0,103441049.0,28869700.0,1800,1243,557,157899,122801,35098,126791473.0,98344510.0,28446963.0,0.8046,0.8103,0.8008,0.8105
2023-09-14 10:45,1922,1070,852,152068,104394,47674,122110036.0,83831994.0,38278041.0,1788,1007,781,142041,100993,41048,114048018.0,80889353.0,33158664.0,0.803,0.8029,0.8009,0.8078
2023-09-14 10:50,1661,1127,534,165945,120075,45870,134711028.0,97353096.0,37357931.0,1478,1030,448,149784,110577,39207,120805811.0,88983825.0,31821986.0,0.8108,0.8144,0.8047,0.8116
2023-09-14 10:55,1721,866,855,154511,62499,92012,125408089.0,50640740.0,74767348.0,1542,814,728,134051,57518,76533,108680082.0,46467162.0,62212920.0,0.8103,0.8126,0.8079,0.8129
2023-09-14 11:00,4129,1640,2489,385590,118077,267513,309373275.0,94492191.0,214881084.0,3878,1490,2388,368809,109691,259118,296353480.0,87711198.0,208642282.0,0.8003,0.8033,0.7996,0.8052
2023-09-14 11:05,2904,1060,1844,249081,61379,187702,198869911.0,48779213.0,150090698.0,2724,966,1758,241259,58772,182487,192806629.0,46708769.0,146097859.0,0.7947,0.7996,0.7947,0.8006
2023-09-14 11:10,2578,926,1652,223286,55699,167587,177750915.0,44208569.0,133542345.0,2345,793,1552,210572,47952,162620,167779208.0,37938142.0,129841065.0,0.7937,0.7969,0.7912,0.7984
2023-09-14 11:15,1543,972,571,99363,56889,42474,79382099.0,45484370.0,33897729.0,1413,911,502,89138,52983,36155,70979147.0,42052205.0,28926941.0,0.7995,0.7981,0.7937,0.8001
2023-09-14 11:20,1187,692,495,82516,45951,36565,65780641.0,36707727.0,29072914.0,1092,629,463,79344,44718,34626,63267744.0,35531540.0,27736204.0,0.7988,0.7951,0.7946,0.801
2023-09-14 11:25,1591,877,714,101231,39419,61812,80773893.0,31397842.0,49376050.0,1477,823,654,94500,36710,57790,75425236.0,29134342.0,46290893.0,0.7965,0.7988,0.7936,0.801
2023-09-14 11:30,1292,838,454,88502,48345,40157,70635229.0,38453420.0,32181808.0,1192,797,395,78751,43500,35251,62901383.0,34617573.0,28283810.0,0.7954,0.8014,0.7958,0.8024
2023-09-14 11:35,2287,1349,938,177433,104415,73018,141464910.0,83301915.0,58162994.0,2220,1309,911,173189,102536,70653,138052669.0,81559350.0,56493319.0,0.7978,0.7966,0.7954,0.7996
2023-09-14 11:40,1583,723,860,108910,32804,76106,86667351.0,26068153.0,60599197.0,1481,671,810,104892,30974,73918,83593841.0,24596741.0,58997100.0,0.7947,0.7962,0.7941,0.7981
2023-09-14 11:45,1134,500,634,95589,27473,68116,75576883.0,21380716.0,54196166.0,1014,418,596,80121,21249,58872,63714528.0,16789167.0,46925361.0,0.7782,0.7956,0.7901,0.7971
2023-09-14 11:50,1774,604,1170,143175,37603,105572,113296671.0,29678549.0,83618122.0,1629,515,1114,144598,37919,106679,114692954.0,29795051.0,84897902.0,0.7893,0.792,0.7858,0.7958
2023-09-14 11:55,1249,373,876,93136,15306,77830,73929196.0,12234637.0,61694558.0,1135,305,830,87319,12594,74725,69243062.0,9904288.0,59338774.0,0.7993,0.7927,0.7864,0.7941
2023-09-14 12:00,1732,937,795,156667,85075,71592,124232261.0,67431557.0,56800704.0,1646,887,759,154609,86414,68195,122190112.0,67832133.0,54357979.0,0.7926,0.7934,0.785,0.7971
2023-09-14 12:05,1641,1093,548,142297,117013,25284,112209068.0,92306112.0,19902955.0,1523,1019,504,131442,112529,18913,103738029.0,88724920.0,15013109.0,0.7889,0.7872,0.7885,0.7938
2023-09-14 12:10,1786,934,852,131689,53818,77871,103949510.0,42318069.0,61631441.0,1647,841,806,123376,48362,75014,97525785.0,38093277.0,59432508.0,0.7863,0.7915,0.7877,0.7923
2023-09-14 12:15,1343,586,757,116020,26511,89509,91630369.0,20999361.0,70631007.0,1227,518,709,109412,24364,85048,86467368.0,19110451.0,67356917.0,0.7921,0.7891,0.7844,0.792
2023-09-14 12:20,2215,834,1381,182083,45092,136991,141998907.0,35368387.0,106630520.0,1829,585,1244,156532,36465,120067,122920281.0,28402152.0,94518128.0,0.7844,0.7784,0.7789,0.7872
2023-09-14 12:25,2197,939,1258,159348,47002,112346,124865139.0,37246215.0,87618923.0,1933,782,1151,157801,43436,114365,123590764.0,33643798.0,89946966.0,0.7924,0.7799,0.7746,0.7865
2023-09-14 12:30,1084,521,563,71666,34723,36943,55802734.0,26967114.0,28835620.0,919,410,509,62475,30575,31900,48665639.0,23688397.0,24977241.0,0.7766,0.7805,0.7748,0.783
2023-09-14 12:35,1910,569,1341,133579,34702,98877,103831828.0,27398261.0,76433567.0,1639,431,1208,121097,32254,88843,94421936.0,25401216.0,69020720.0,0.7895,0.773,0.7875,0.7769
2023-09-14 12:40,5418,2268,3150,553937,232006,321931,424078364.0,178226423.0,245851940.0,4794,1928,2866,503432,217002,286430,387189049.0,167105973.0,220083076.0,0.7682,0.7637,0.7701,0.7684
2023-09-14 12:45,10297,4836,5461,1072475,485613,586862,788253841.0,357473438.0,430780402.0,8827,3936,4891,920912,424243,496669,677615191.0,311267720.0,366347471.0,0.7361,0.734,0.7337,0.7376
2023-09-14 12:50,7203,2973,4230,965580,318172,647408,664688498.0,219000850.0,445687648.0,5368,1736,3632,716630,221014,495616,493647029.0,148379843.0,345267185.0,0.6883,0.6884,0.6714,0.6966
2023-09-14 12:55,6350,4186,2164,792646,486613,306033,544844308.0,334802318.0,210041990.0,4842,3240,1602,669071,410738,258333,455868589.0,277708361.0,178160228.0,0.688,0.6863,0.6761,0.6897
2023-09-14 13:00,4331,3162,1169,607762,451251,156511,432694480.0,321189539.0,111504940.0,3057,2357,700,429259,332472,96787,300544326.0,231058070.0,69486256.0,0.7118,0.7124,0.695,0.7179
2023-09-14 13:05,6372,4221,2151,825934,520089,305845,586569803.0,368771717.0,217798086.0,5296,3537,1759,726565,467745,258820,513132391.0,328993871.0,184138520.0,0.7091,0.7121,0.7034,0.7115
2023-09-14 13:10,4782,2812,1970,574450,280146,294304,406720489.0,198723578.0,207996910.0,3940,2279,1661,483174,239151,244023,341196667.0,167729268.0,173467398.0,0.7094,0.7067,0.7014,0.7109
2023-09-14 13:15,5469,3930,1539,594847,453196,141651,432286208.0,328953774.0,103332433.0,4326,3230,1096,488825,390473,98352,349550388.0,277633965.0,71916423.0,0.7259,0.7295,0.711,0.7312
2023-09-14 13:20,5189,2491,2698,546130,241384,304746,392970548.0,173780783.0,219189764.0,4549,2061,2488,486756,211553,275203,351357751.0,152257404.0,199100347.0,0.7199,0.7193,0.7197,0.7235
2023-09-14 13:25,4261,2761,1500,433903,283485,150418,319371117.0,209580851.0,109790266.0,3616,2396,1220,384476,255644,128832,278754981.0,184600533.0,94154447.0,0.7393,0.7299,0.7221,0.7308
2023-09-14 13:30,6435,3148,3287,628449,332278,296171,465953235.0,247722394.0,218230841.0,5486,2641,2845,557509,296216,261293,412098051.0,218589036.0,193509015.0,0.7455,0.7368,0.7379,0.7406
2023-09-14 13:35,4490,2623,1867,411852,264779,147073,302098693.0,193219394.0,108879298.0,4057,2369,1688,375466,237350,138116,275879602.0,173401437.0,102478164.0,0.7297,0.7403,0.7306,0.742
2023-09-14 13:40,4710,2738,1972,389062,228619,160443,290517456.0,171472267.0,119045189.0,4094,2381,1713,353880,208774,145106,263045717.0,154517347.0,108528369.0,0.75,0.742,0.7401,0.7479
2023-09-14 13:45,6089,2877,3212,586502,280249,306253,435469477.0,208250944.0,227218532.0,5649,2610,3039,554905,264588,290317,411611662.0,195498290.0,216113372.0,0.7431,0.7419,0.7389,0.7444
2023-09-14 13:50,4068,2923,1145,402417,317033,85384,303190462.0,239223195.0,63967267.0,3517,2654,863,356656,292078,64578,267213726.0,218221914.0,48991812.0,0.7546,0.7492,0.7471,0.7586
2023-09-14 13:55,5334,3482,1852,527407,369794,157613,398180200.0,279952483.0,118227717.0,4906,3207,1699,483577,342814,140763,363977798.0,257744066.0,106233731.0,0.757,0.7501,0.7518,0.7547
2023-09-14 14:00,2486,1452,1034,208591,141772,66819,160336588.0,109034370.0,51302218.0,2014,1166,848,183442,127630,55812,139313085.0,96434699.0,42878386.0,0.7691,0.7678,0.7556,0.7683
2023-09-14 14:05,5329,2018,3311,511409,162224,349185,392225851.0,129187822.0,263038028.0,4408,1459,2949,420368,110342,310026,323140688.0,87132525.0,236008162.0,0.7964,0.7533,0.7897,0.7613
2023-09-14 14:10,3930,1181,2749,394280,96146,298134,297201881.0,72580179.0,224621702.0,3583,1009,2574,365017,85462,279555,275189066.0,64080053.0,211109013.0,0.7549,0.7534,0.7498,0.7552
2023-09-14 14:15,3384,1404,1980,327528,94559,232969,246342054.0,71047751.0,175294302.0,3137,1259,1878,316713,88530,228183,238530718.0,66077427.0,172453291.0,0.7514,0.7524,0.7464,0.7558
2023-09-14 14:20,5275,3048,2227,532991,302231,230760,392619043.0,221703038.0,170916005.0,4580,2654,1926,465556,271359,194197,342681362.0,197389348.0,145292014.0,0.7336,0.7407,0.7274,0.7482
2023-09-14 14:25,3182,2005,1177,307683,212500,95183,233420139.0,158795302.0,74624836.0,2774,1787,987,273128,197495,75633,205876885.0,145791403.0,60085482.0,0.7473,0.784,0.7382,0.7944
2023-09-14 14:30,1940,1160,780,155990,104650,51340,118610447.0,79603884.0,39006562.0,1678,1025,653,140769,101828,38941,105434613.0,75266953.0,30167660.0,0.7607,0.7598,0.7392,0.7747
2023-09-14 14:35,2785,1471,1314,248254,113645,134609,184692458.0,84365971.0,100326487.0,2539,1318,1221,226493,103859,122634,168704054.0,76933982.0,91770072.0,0.7424,0.7453,0.7408,0.7483
2023-09-14 14:40,1896,838,1058,151443,62970,88473,113258473.0,47126864.0,66131608.0,1716,744,972,135715,54704,81011,101082001.0,40504867.0,60577133.0,0.7484,0.7475,0.7404,0.7478
2023-09-14 14:45,1799,875,924,134629,63574,71055,99882574.0,47447059.0,52435514.0,1643,772,871,113900,54954,58946,84817608.0,40751591.0,44066016.0,0.7463,0.738,0.7416,0.7476
2023-09-14 14:50,2495,1295,1200,178677,84260,94417,133712543.0,63770164.0,69942379.0,2263,1163,1100,163426,77739,85687,122445663.0,58575267.0,63870396.0,0.7568,0.7408,0.7535,0.7454
2023-09-14 14:55,1183,441,742,85190,31857,53333,63360974.0,23648802.0,39712172.0,1079,373,706,78269,27876,50393,58318628.0,20564561.0,37754066.0,0.7423,0.7446,0.7377,0.7492
2023-09-14 15:00,2376,992,1384,151072,46220,104852,112196650.0,35290017.0,76906632.0,2022,751,1271,125302,35424,89878,93521906.0,27119954.0,66401952.0,0.7635,0.7335,0.7656,0.7388
2023-09-14 15:05,3367,1939,1428,257544,154813,102731,195275152.0,120476383.0,74798769.0,2962,1682,1280,227184,134407,92777,172403301.0,104340131.0,68063170.0,0.7782,0.7281,0.7763,0.7336
2023-09-14 15:10,3178,2151,1027,259418,210939,48479,190882857.0,155388008.0,35494849.0,2959,1996,963,251695,206802,44893,185258338.0,152133419.0,33124919.0,0.7366,0.7322,0.7356,0.7379
2023-09-14 15:15,4354,2243,2111,379408,194286,185122,282083445.0,144654581.0,137428864.0,3922,2044,1878,337148,174895,162253,250919287.0,130120357.0,120798930.0,0.7445,0.7424,0.744,0.7445
2023-09-14 15:20,2555,1073,1482,237819,89173,148646,174833901.0,65185731.0,109648169.0,2310,947,1363,220721,81587,139134,162787444.0,59719408.0,103068036.0,0.731,0.7376,0.732,0.7408
2023-09-14 15:25,6379,3825,2554,510621,275520,235101,370354274.0,200101725.0,170252549.0,5812,3530,2282,471026,249547,221479,342109799.0,180142068.0,161967731.0,0.7263,0.7242,0.7219,0.7313
2023-09-14 15:30,3112,1402,1710,249291,112116,137175,183921028.0,82696625.0,101224402.0,2830,1253,1577,224240,101294,122946,165732342.0,74900961.0,90831381.0,0.7376,0.7379,0.7394,0.7388
2023-09-14 15:35,2904,1425,1479,245420,114048,131372,181499542.0,84738169.0,96761373.0,2673,1320,1353,227024,104900,122124,167190762.0,76829730.0,90361031.0,0.743,0.7365,0.7324,0.7399
2023-09-14 15:40,2180,1046,1134,174534,70149,104385,128280209.0,51425835.0,76854373.0,1975,920,1055,163195,65247,97948,120012595.0,47585019.0,72427575.0,0.7331,0.7363,0.7293,0.7394
2023-09-14 15:45,2359,1070,1289,168687,52691,115996,126001611.0,40323057.0,85678554.0,2199,982,1217,156559,47871,108688,115595344.0,35109395.0,80485949.0,0.7653,0.7386,0.7334,0.7405
2023-09-14 15:50,1087,382,705,112830,21877,90953,83501058.0,16242226.0,67258832.0,1000,331,669,109093,20872,88221,80548181.0,15283979.0,65264202.0,0.7424,0.7395,0.7323,0.7398
2023-09-14 15:55,1318,435,883,124435,16000,108435,91601798.0,11679859.0,79921938.0,1236,376,860,119222,12816,106406,87939111.0,9338495.0,78600616.0,0.73,0.737,0.7287,0.7387
2023-09-14 16:00,1584,319,1265,163207,17378,145829,120185212.0,12641983.0,107543228.0,1501,278,1223,160768,15535,145233,118920951.0,11280265.0,107640685.0,0.7275,0.7375,0.7261,0.7412
2023-09-14 16:05,2267,1151,1116,210780,99853,110927,155220165.0,74239064.0,80981101.0,1976,958,1018,179532,83352,96180,132301179.0,61696070.0,70605109.0,0.7435,0.73,0.7402,0.7341
2023-09-14 16:10,2814,1524,1290,251132,135868,115264,183729835.0,99720537.0,84009298.0,2486,1325,1161,217128,113386,103742,158095933.0,82141211.0,75954722.0,0.734,0.7288,0.7244,0.7322
2023-09-14 16:15,2846,1569,1277,253680,156499,97181,189194776.0,117787811.0,71406964.0,2551,1416,1135,222404,140770,81634,162788640.0,102752896.0,60035743.0,0.7526,0.7348,0.7299,0.7354
2023-09-14 16:20,5647,3678,1969,446068,325470,120598,334428312.0,244988728.0,89439584.0,5005,3383,1622,404269,305243,99026,301870122.0,227878814.0,73991308.0,0.7527,0.7416,0.7465,0.7472
2023-09-14 16:25,3580,1743,1837,290661,128780,161881,219583493.0,98790254.0,120793239.0,3232,1563,1669,262564,119345,143219,197915535.0,90464946.0,107450589.0,0.7671,0.7462,0.758,0.7503
2023-09-14 16:30,3056,1112,1944,267147,76104,191043,201178311.0,58711914.0,142466396.0,2769,946,1823,243829,65303,178526,183804022.0,50159393.0,133644628.0,0.7715,0.7457,0.7681,0.7486
2023-09-14 16:35,3038,1279,1759,269290,114978,154312,202585336.0,86917603.0,115667733.0,2790,1151,1639,244027,98296,145731,182707981.0,73324358.0,109383622.0,0.7559,0.7496,0.746,0.7506
2023-09-14 16:40,3397,1818,1579,288185,175496,112689,217976588.0,133299711.0,84676877.0,2963,1620,1343,253088,156499,96589,190430653.0,117402746.0,73027906.0,0.7596,0.7514,0.7502,0.7561
2023-09-14 16:45,3192,1615,1577,281680,155529,126151,214882393.0,119728905.0,95153488.0,2783,1414,1369,245130,136971,108159,185344014.0,103225921.0,82118093.0,0.7698,0.7543,0.7536,0.7592
2023-09-14 16:50,5134,3440,1694,574522,403344,171178,437378145.0,307611591.0,129766553.0,4663,3206,1457,514706,368173,146533,391022820.0,278964469.0,112058350.0,0.7627,0.7581,0.7577,0.7647
2023-09-14 16:55,2814,1240,1574,229185,112874,116311,174350883.0,85985349.0,88365534.0,2584,1114,1470,208029,101223,106806,158194388.0,76726081.0,81468306.0,0.7618,0.7597,0.758,0.7628
2023-09-14 17:00,2275,1097,1178,168610,88309,80301,129931936.0,68854610.0,61077326.0,2049,977,1072,153556,80650,72906,118340059.0,62598243.0,55741816.0,0.7797,0.7606,0.7762,0.7646
2023-09-14 17:05,2660,614,2046,236182,34481,201701,178489407.0,26176403.0,152313003.0,2520,544,1976,224557,33657,190900,170584004.0,25366030.0,145217973.0,0.7592,0.7551,0.7537,0.7607
2023-09-14 17:10,6858,4133,2725,668694,372132,296562,507170179.0,285117840.0,222052339.0,6309,3834,2475,622701,348589,274112,473854736.0,267372616.0,206482119.0,0.7662,0.7488,0.767,0.7533
2023-09-14 17:15,3920,2941,979,357722,288144,69578,270435183.0,218128320.0,52306863.0,3618,2781,837,333178,273932,59246,251317388.0,206576005.0,44741382.0,0.757,0.7518,0.7541,0.7552
2023-09-14 17:20,2334,922,1412,206892,76896,129996,155204751.0,57828564.0,97376187.0,2186,825,1361,198397,70822,127575,148985744.0,52892749.0,96092995.0,0.752,0.7491,0.7468,0.7532
2023-09-14 17:25,1261,661,600,95097,41748,53349,71681748.0,31611320.0,40070428.0,1181,609,572,89584,38634,50950,67303490.0,28908576.0,38394913.0,0.7572,0.7511,0.7483,0.7536
2023-09-14 17:30,1552,443,1109,148166,37619,110547,111340663.0,28275415.0,83065247.0,1419,369,1050,141112,34522,106590,106119487.0,25771564.0,80347922.0,0.7516,0.7514,0.7465,0.7538
2023-09-14 17:35,3474,1508,1966,320079,119566,200513,241391899.0,92911863.0,148480035.0,3147,1307,1840,286426,102481,183945,216772815.0,79434974.0,137337841.0,0.7771,0.7405,0.7751,0.7466
2023-09-14 17:40,3206,2132,1074,265287,188427,76860,197564568.0,140479754.0,57084814.0,3002,2028,974,249512,180393,69119,185190079.0,133552449.0,51637630.0,0.7455,0.7427,0.7403,0.7471
2023-09-14 17:45,969,382,587,80040,43331,36709,60161775.0,32668916.0,27492858.0,858,334,524,68736,35566,33170,51300037.0,26431452.0,24868584.0,0.7539,0.7489,0.7432,0.7497
2023-09-14 17:50,1706,785,921,155820,87879,67941,116109444.0,65516320.0,50593124.0,1596,721,875,151006,86001,65005,112745973.0,64028602.0,48717371.0,0.7455,0.7447,0.7445,0.7494
2023-09-14 17:55,3232,1819,1413,294315,177640,116675,226512191.0,135840993.0,90671198.0,3026,1730,1296,282912,174151,108761,215225455.0,131381799.0,83843655.0,0.7647,0.7771,0.7544,0.7709
2023-09-14 18:00,2955,1523,1432,214548,129502,85046,167453155.0,100158136.0,67295018.0,2761,1428,1333,197103,119411,77692,154047145.0,92222188.0,61824956.0,0.7734,0.7913,0.7723,0.7958
2023-09-14 18:05,2553,1288,1265,213693,110784,102909,163488080.0,84426039.0,79062040.0,2394,1226,1168,204749,107048,97701,157107457.0,81399753.0,75707703.0,0.7621,0.7683,0.7604,0.7749
2023-09-14 18:10,2441,1302,1139,208321,117937,90384,157447975.0,89773003.0,67674971.0,2305,1238,1067,197450,113418,84032,150548847.0,86227296.0,64321550.0,0.7612,0.7487,0.7603,0.7654
2023-09-14 18:15,1756,992,764,149535,72605,76930,112419846.0,54507834.0,57912011.0,1682,944,738,144003,70605,73398,108042759.0,52780182.0,55262577.0,0.7507,0.7528,0.7475,0.7529
2023-09-14 18:20,1350,602,748,107525,53519,54006,80563454.0,40195937.0,40367517.0,1263,558,705,99191,50600,48591,74315665.0,37810879.0,36504785.0,0.7511,0.7475,0.7473,0.7513
2023-09-14 18:25,1402,555,847,127751,30890,96861,95318296.0,23055757.0,72262538.0,1295,496,799,121289,27822,93467,92018901.0,21998991.0,70019909.0,0.7464,0.746,0.7907,0.7491
2023-09-14 18:30,2103,1336,767,180520,124143,56377,135672606.0,93197389.0,42475217.0,2019,1310,709,174728,121792,52936,130801476.0,90838240.0,39963236.0,0.7507,0.7534,0.7458,0.7549
2023-09-14 18:35,2566,1113,1453,226753,108920,117833,170274984.0,81883666.0,88391318.0,2410,1036,1374,213514,102654,110860,160297842.0,76815679.0,83482163.0,0.7518,0.7501,0.7483,0.753
2023-09-15 10:00,14152,5843,8309,1517179,563920,953259,1138295082.0,427482849.0,710812232.0,13165,5332,7833,1439337,528957,910380,1078907809.0,399373940.0,679533868.0,0.7581,0.7457,0.755,0.7464
2023-09-15 10:05,4051,2607,1444,312646,222480,90166,232873950.0,165632768.0,67241181.0,3572,2331,1241,290566,207754,82812,215809089.0,153888597.0,61920491.0,0.7445,0.7457,0.7407,0.7477
2023-09-15 10:10,4871,2340,2531,377177,190458,186719,283280563.0,143043643.0,140236920.0,4471,2145,2326,344460,173135,171325,258286444.0,129217061.0,129069383.0,0.7511,0.7511,0.7463,0.7534
2023-09-15 10:15,4556,2472,2084,391790,215973,175817,292664992.0,161053468.0,131611524.0,4158,2239,1919,360909,198507,162402,270047813.0,148003301.0,122044511.0,0.7457,0.7486,0.7456,0.7515
2023-09-15 10:20,3291,1232,2059,316116,93478,222638,234759288.0,68476392.0,166282895.0,3023,1086,1937,285731,73149,212582,213266525.0,53959965.0,159306560.0,0.7325,0.7469,0.7377,0.7494
2023-09-15 10:25,2814,1221,1593,224255,81209,143046,168260380.0,60683919.0,107576460.0,2558,1088,1470,210935,74612,136323,158396708.0,55734182.0,102662525.0,0.7473,0.752,0.747,0.7531
2023-09-15 10:30,3913,2786,1127,303773,219669,84104,227741497.0,164409397.0,63332100.0,3763,2712,1051,289879,210076,79803,217455678.0,157253260.0,60202418.0,0.7484,0.753,0.7486,0.7544
2023-09-15 10:35,2581,1214,1367,248216,110494,137722,183024843.0,80306304.0,102718538.0,2393,1105,1288,218242,88973,129269,162664285.0,65743512.0,96920772.0,0.7268,0.7458,0.7389,0.7498
2023-09-15 10:40,2009,998,1011,170575,73786,96789,127281056.0,54882340.0,72398716.0,1871,935,936,161781,72143,89638,120573083.0,53396415.0,67176667.0,0.7438,0.748,0.7401,0.7494
2023-09-15 10:45,1082,757,325,91066,71960,19106,67819498.0,53473438.0,14346059.0,1008,715,293,87917,69371,18546,65479004.0,51553050.0,13925954.0,0.7431,0.7509,0.7431,0.7509
2023-09-15 10:50,2106,1013,1093,173844,96709,77135,129277376.0,71720705.0,57556671.0,2052,980,1072,169801,94058,75743,126584298.0,69961520.0,56622777.0,0.7416,0.7462,0.7438,0.7476
2023-09-15 10:55,1866,841,1025,148556,94055,54501,111067901.0,70239910.0,40827991.0,1787,801,986,142245,90411,51834,106162247.0,67329276.0,38832970.0,0.7468,0.7491,0.7447,0.7492
2023-09-15 11:00,2153,1066,1087,182035,55050,126985,135708214.0,40934408.0,94773805.0,2026,980,1046,177769,53372,124397,132728409.0,39654411.0,93073997.0,0.7436,0.7463,0.743,0.7482
2023-09-15 11:05,1190,450,740,99683,26590,73093,74741881.0,19990814.0,54751066.0,1130,415,715,95092,22755,72337,71101645.0,16905729.0,54195916.0,0.7518,0.7491,0.7429,0.7492
2023-09-15 11:10,580,325,255,45185,24084,21101,33847829.0,18012864.0,15834964.0,513,289,224,45716,26144,19572,34038018.0,19337791.0,14700227.0,0.7479,0.7504,0.7397,0.7511
2023-09-15 11:15,884,532,352,67033,38182,28851,50109588.0,28485036.0,21624551.0,838,502,336,63890,37351,26539,47773639.0,27869704.0,19903935.0,0.746,0.7495,0.7462,0.75
2023-09-15 11:20,608,315,293,47735,29066,18669,35496404.0,21614564.0,13881840.0,570,292,278,45706,28335,17371,34054909.0,21045875.0,13009033.0,0.7436,0.7436,0.7428,0.7489
2023-09-15 11:25,1127,588,539,92938,55270,37668,69442453.0,41174031.0,28268421.0,1069,554,515,90416,55263,35153,67394475.0,41095807.0,26298667.0,0.745,0.7505,0.7436,0.7481
2023-09-15 11:30,1028,481,547,83116,42785,40331,62153066.0,31988183.0,30164883.0,972,450,522,78640,40377,38263,58688806.0,30043466.0,28645339.0,0.7476,0.7479,0.7441,0.7486
2023-09-15 11:35,787,502,285,43704,27241,16463,32665784.0,20342077.0,12323706.0,745,477,268,44538,25751,18787,33456728.0,19199099.0,14257628.0,0.7467,0.7486,0.7456,0.7589
2023-09-15 11:40,525,351,174,40561,27521,13040,30402441.0,20561382.0,9841058.0,473,315,158,40645,27787,12858,30388534.0,20699199.0,9689335.0,0.7471,0.7547,0.7449,0.7536
2023-09-15 11:45,1371,662,709,90291,47818,42473,67393156.0,35739767.0,31653389.0,1290,619,671,83425,44659,38766,62413368.0,33324107.0,29089261.0,0.7474,0.7453,0.7462,0.7504
2023-09-15 11:50,2829,1088,1741,261373,71365,190008,194398947.0,52819856.0,141579090.0,2675,1002,1673,248795,65749,183046,185290600.0,48653737.0,136636862.0,0.7401,0.7451,0.74,0.7465
2023-09-15 11:55,1170,726,444,113686,82974,30712,84112230.0,61257169.0,22855061.0,1094,678,416,97738,67819,29919,72443165.0,50112278.0,22330887.0,0.7383,0.7442,0.7389,0.7464
2023-09-15 12:00,1625,609,1016,130629,63556,67073,97424586.0,47305019.0,50119566.0,1543,566,977,122575,59362,63213,91349343.0,44099579.0,47249764.0,0.7443,0.7472,0.7429,0.7475
2023-09-15 12:05,627,190,437,41470,15646,25824,30914284.0,11671544.0,19242739.0,551,151,400,37335,14157,23178,27892164.0,10516605.0,17375559.0,0.746,0.7451,0.7429,0.7497
2023-09-15 12:10,1461,957,504,124503,86363,38140,92929243.0,64542212.0,28387031.0,1280,852,428,112171,82519,29652,83727074.0,61447298.0,22279776.0,0.7473,0.7443,0.7446,0.7514
2023-09-15 12:15,1598,814,784,97334,46948,50386,72752890.0,34924505.0,37828385.0,1544,778,766,91683,45641,46042,68455573.0,33973016.0,34482557.0,0.7439,0.7508,0.7444,0.7489
2023-09-15 12:20,1338,789,549,96434,59361,37073,74250950.0,46566129.0,27684821.0,1272,754,518,95552,59349,36203,73573636.0,46531097.0,27042539.0,0.7845,0.7468,0.784,0.747
2023-09-15 12:25,1488,798,690,118454,70602,47852,88008367.0,52369777.0,35638590.0,1400,759,641,112305,67658,44647,83493369.0,50160864.0,33332504.0,0.7418,0.7448,0.7414,0.7466
2023-09-15 12:30,1436,656,780,92836,48872,43964,69192375.0,36317500.0,32874874.0,1406,640,766,92015,50280,41735,68420847.0,37284662.0,31136184.0,0.7431,0.7478,0.7415,0.746
2023-09-15 12:35,730,340,390,49859,31030,18829,36968070.0,23031744.0,13936325.0,676,311,365,44711,26605,18106,33244537.0,19736762.0,13507774.0,0.7422,0.7402,0.7418,0.746
2023-09-15 12:40,635,284,351,40239,13648,26591,29791532.0,10003214.0,19788317.0,602,266,336,40115,14815,25300,29862001.0,10985822.0,18876179.0,0.7329,0.7442,0.7415,0.7461
2023-09-15 12:45,1053,375,678,72361,30752,41609,53724413.0,22784342.0,30940071.0,1016,351,665,70899,28570,42329,52754728.0,21186037.0,31568690.0,0.7409,0.7436,0.7415,0.7458
2023-09-15 12:50,908,457,451,61492,26431,35061,45724650.0,19613596.0,26111054.0,865,433,432,56475,23239,33236,42079288.0,17268295.0,24810993.0,0.7421,0.7447,0.7431,0.7465
2023-09-15 12:55,1415,745,670,101642,69097,32545,75869820.0,51528828.0,24340991.0,1377,727,650,98946,68186,30760,73580994.0,50604947.0,22976047.0,0.7457,0.7479,0.7422,0.7469
2023-09-15 13:00,2393,1527,866,185621,137423,48198,139044096.0,102785308.0,36258787.0,2301,1479,822,180364,135277,45087,134751475.0,100834126.0,33917349.0,0.7479,0.7523,0.7454,0.7523
2023-09-15 13:05,1018,443,575,63121,29350,33771,47204854.0,21977601.0,25227253.0,944,402,542,58242,26790,31452,43567259.0,19962829.0,23604429.0,0.7488,0.747,0.7452,0.7505
2023-09-15 13:10,971,471,500,54589,25054,29535,40877478.0,18678782.0,22198696.0,928,447,481,51320,24506,26814,38381694.0,18264757.0,20116937.0,0.7455,0.7516,0.7453,0.7502
2023-09-15 13:15,1459,916,543,88341,44376,43965,66166437.0,33260718.0,32905719.0,1406,887,519,82739,41190,41549,61883092.0,30708401.0,31174690.0,0.7495,0.7485,0.7455,0.7503
2023-09-15 13:20,2421,1543,878,186787,133829,52958,140130210.0,100368941.0,39761269.0,2299,1489,810,176502,127765,48737,132323249.0,95529594.0,36793655.0,0.75,0.7508,0.7477,0.7549
2023-09-15 13:25,3386,1820,1566,276783,163702,113081,207461549.0,122801750.0,84659799.0,3120,1667,1453,257519,153580,103939,193241432.0,114950196.0,78291235.0,0.7502,0.7487,0.7485,0.7532
2023-09-15 13:30,9585,5828,3757,912037,624619,287418,703039372.0,482096753.0,220942619.0,8614,5431,3183,821389,580875,240514,632266913.0,445879813.0,186387099.0,0.7718,0.7687,0.7676,0.775
2023-09-15 13:35,7497,3201,4296,717879,300077,417802,550081644.0,230116312.0,319965331.0,6782,2815,3967,664999,273393,391606,510161934.0,208647043.0,301514890.0,0.7669,0.7658,0.7632,0.7699
2023-09-15 13:40,6933,2516,4417,718995,229519,489476,550053980.0,175688825.0,374365154.0,6373,2198,4175,660468,210168,450300,505737752.0,159947151.0,345790601.0,0.7655,0.7648,0.761,0.7679
2023-09-15 13:45,4716,3084,1632,505097,378532,126565,383143164.0,287247582.0,95895582.0,4249,2807,1442,455093,347438,107655,344676189.0,262781187.0,81895002.0,0.7588,0.7577,0.7563,0.7607
2023-09-15 13:50,4166,1727,2439,454891,233691,221200,344416109.0,177147490.0,167268619.0,3886,1570,2316,426006,215244,210762,322822329.0,162725224.0,160097104.0,0.758,0.7562,0.756,0.7596
2023-09-15 13:55,3050,1577,1473,284733,151407,133326,215376355.0,114481002.0,100895353.0,2728,1401,1327,265212,139966,125246,200568258.0,105508966.0,95059291.0,0.7561,0.7568,0.7538,0.759
2023-09-15 14:00,1261,491,770,113781,48216,65565,86418439.0,36547401.0,49871038.0,1088,430,658,106306,46969,59337,80712302.0,35458019.0,45254282.0,0.758,0.7606,0.7549,0.7627
2023-09-15 14:05,2511,1272,1239,233387,111409,121978,177753706.0,85019706.0,92734000.0,2184,1124,1060,207251,99965,107286,157594754.0,75760537.0,81834216.0,0.7631,0.7603,0.7579,0.7628
2023-09-15 14:10,3375,2624,751,362977,311048,51929,276456425.0,236910380.0,39546045.0,3207,2517,690,350322,303344,46978,266384703.0,230575755.0,35808948.0,0.7617,0.7615,0.7601,0.7622
2023-09-15 14:15,4770,3638,1132,479278,404625,74653,364731192.0,308049101.0,56682090.0,4640,3567,1073,469512,401475,68037,357322755.0,305371225.0,51951529.0,0.7613,0.7593,0.7606,0.7636
2023-09-15 14:20,2084,1258,826,173612,122635,50977,133053665.0,94010769.0,39042895.0,1720,1053,667,151975,110131,41844,116139571.0,83952835.0,32186735.0,0.7666,0.7659,0.7623,0.7692
2023-09-15 14:25,1756,983,773,131648,75808,55840,100796957.0,58070853.0,42726104.0,1543,847,696,123880,73650,50230,94844303.0,56029841.0,38814462.0,0.766,0.7652,0.7608,0.7727
2023-09-15 14:30,1484,1046,438,128188,84067,44121,99301230.0,65056685.0,34244545.0,1301,948,353,113532,77817,35715,87490066.0,59734440.0,27755625.0,0.7739,0.7762,0.7676,0.7771
2023-09-15 14:35,2114,1432,682,187008,140659,46349,143368504.0,108172550.0,35195954.0,1857,1281,576,165643,130081,35562,127233507.0,99751100.0,27482407.0,0.769,0.7594,0.7668,0.7728
2023-09-15 14:40,1897,1019,878,157592,113546,44046,121244290.0,87319973.0,33924317.0,1773,934,839,153380,111562,41818,117671377.0,85382542.0,32288835.0,0.769,0.7702,0.7653,0.7721
2023-09-15 14:45,1595,765,830,140668,81300,59368,108121830.0,62424942.0,45696887.0,1443,679,764,130923,77906,53017,100350919.0,59424600.0,40926318.0,0.7678,0.7697,0.7628,0.7719
2023-09-15 14:50,3196,1592,1604,285709,130739,154970,219066118.0,100207686.0,118858432.0,2988,1482,1506,270770,123344,147426,207715022.0,94314648.0,113400373.0,0.7665,0.767,0.7646,0.7692
2023-09-15 14:55,1284,632,652,112806,61855,50951,86534086.0,47517380.0,39016705.0,1182,572,610,104946,57429,47517,80552846.0,43949661.0,36603184.0,0.7682,0.7658,0.7653,0.7703
2023-09-15 15:00,1982,1165,817,166031,118661,47370,128424187.0,91886806.0,36537381.0,1792,1061,731,151661,108187,43474,116960748.0,83316396.0,33644352.0,0.7744,0.7713,0.7701,0.7739
2023-09-15 15:05,2021,989,1032,207534,80513,127021,159369099.0,62010634.0,97358464.0,1851,903,948,189140,74292,114848,145934455.0,57125065.0,88809390.0,0.7702,0.7665,0.7689,0.7733
2023-09-15 15:10,1669,964,705,156373,82085,74288,120871926.0,63514044.0,57357882.0,1517,897,620,143389,77622,65767,110381802.0,59517400.0,50864401.0,0.7738,0.7721,0.7668,0.7734
2023-09-15 15:15,1577,1066,511,166952,105426,61526,129175853.0,81114719.0,48061134.0,1498,1025,473,145724,101745,43979,112296098.0,78272596.0,34023502.0,0.7694,0.7812,0.7693,0.7736
2023-09-15 15:20,1546,1083,463,162670,112173,50497,125394314.0,86536772.0,38857542.0,1434,1007,427,150931,105737,45194,116280310.0,81325167.0,34955142.0,0.7715,0.7695,0.7691,0.7734
2023-09-15 15:25,901,692,209,90881,76299,14582,70078048.0,58781573.0,11296474.0,836,663,173,87436,74422,13014,67318679.0,57239074.0,10079605.0,0.7704,0.7747,0.7691,0.7745
2023-09-15 15:30,1111,644,467,103615,75063,28552,80053314.0,57975138.0,22078176.0,1036,609,427,97488,72065,25423,75184797.0,55474105.0,19710691.0,0.7724,0.7733,0.7698,0.7753
2023-09-15 15:35,640,397,243,53523,34136,19387,41136660.0,26197992.0,14938668.0,585,375,210,49839,32590,17249,38398428.0,25041336.0,13357091.0,0.7675,0.7706,0.7684,0.7744
2023-09-15 15:40,1177,509,668,110011,32977,77034,84672730.0,25395177.0,59277553.0,1106,471,635,108161,32634,75527,83413124.0,25090290.0,58322833.0,0.7701,0.7695,0.7688,0.7722
2023-09-15 15:45,1357,569,788,155115,49058,106057,119357964.0,37721474.0,81636490.0,1264,497,767,145761,44433,101328,112321920.0,34111888.0,78210032.0,0.7689,0.7697,0.7677,0.7719
2023-09-15 15:50,999,349,650,88071,41136,46935,67948812.0,31723942.0,36224870.0,953,317,636,85829,39255,46574,66122458.0,30175839.0,35946618.0,0.7712,0.7718,0.7687,0.7718
2023-09-15 15:55,602,228,374,50563,20998,29565,39107036.0,16273710.0,22833325.0,534,198,336,43799,15912,27887,33763818.0,12220608.0,21543209.0,0.775,0.7723,0.768,0.7725
2023-09-15 16:00,733,370,363,40562,13299,27263,31294427.0,10271649.0,21022778.0,692,341,351,42391,16046,26345,32718651.0,12349544.0,20369107.0,0.7724,0.7711,0.7696,0.7732
2023-09-15 16:05,495,290,205,63410,35622,27788,48892070.0,27418256.0,21473814.0,440,264,176,61722,35514,26208,47558011.0,27296667.0,20261343.0,0.7697,0.7728,0.7686,0.7731
2023-09-15 16:10,639,409,230,81238,70021,11217,62539070.0,53987656.0,8551414.0,589,381,208,79001,68155,10846,60863369.0,52440356.0,8423013.0,0.771,0.7624,0.7694,0.7766
2023-09-15 16:15,882,588,294,99167,89338,9829,76412879.0,68834648.0,7578230.0,845,566,279,98506,89032,9474,75891177.0,68551628.0,7339549.0,0.7705,0.771,0.77,0.7747
2023-09-15 16:20,900,500,400,107104,81109,25995,83302782.0,62968676.0,20334106.0,722,409,313,93350,73331,20019,72386990.0,56719543.0,15667447.0,0.7763,0.7822,0.7735,0.7826
2023-09-15 16:25,4169,2286,1883,397750,229936,167814,311210756.0,180090458.0,131120297.0,3565,2038,1527,353033,205879,147154,275920621.0,160303581.0,115617040.0,0.7832,0.7813,0.7786,0.7857
2023-09-15 16:30,1388,570,818,114045,65021,49024,88782139.0,50524313.0,38257826.0,1246,500,746,108410,61898,46512,84447833.0,48029280.0,36418552.0,0.777,0.7804,0.7759,0.783
2023-09-15 16:35,2660,950,1710,241572,57608,183964,188051492.0,44714405.0,143337087.0,2491,844,1647,228102,51588,176514,177807504.0,40032569.0,137774935.0,0.7762,0.7792,0.776,0.7805
2023-09-15 16:40,1772,813,959,142140,52252,89888,110549307.0,40702048.0,69847258.0,1655,740,915,136516,49443,87073,106147555.0,38305917.0,67841638.0,0.779,0.777,0.7747,0.7791
2023-09-15 16:45,2252,1175,1077,178683,109861,68822,139707819.0,85803341.0,53904478.0,2043,1088,955,169058,103532,65526,132027224.0,80587263.0,51439961.0,0.781,0.7832,0.7784,0.785
2023-09-15 16:50,1403,890,513,122977,78185,44792,95864249.0,60737249.0,35126999.0,1307,838,469,115800,74544,41256,90417698.0,57995153.0,32422545.0,0.7768,0.7842,0.778,0.7859
2023-09-15 16:55,1337,657,680,121910,87338,34572,96788143.0,69698577.0,27089566.0,1215,602,613,111511,82670,28841,88172078.0,65463038.0,22709039.0,0.798,0.7836,0.7919,0.7874
2023-09-15 17:00,1067,451,616,77763,38236,39527,60600541.0,29990377.0,30610164.0,938,398,540,69476,36205,33271,54429047.0,28247311.0,26181736.0,0.7843,0.7744,0.7802,0.7869
2023-09-15 17:05,2193,625,1568,183262,58234,125028,142978511.0,45428400.0,97550110.0,2020,526,1494,159050,42083,116967,124527780.0,32674565.0,91853215.0,0.7801,0.7802,0.7764,0.7853
2023-09-15 17:10,1221,528,693,106606,58158,48448,83583173.0,45606892.0,37976281.0,1119,501,618,105845,64435,41410,82947982.0,50345865.0,32602117.0,0.7842,0.7839,0.7813,0.7873
2023-09-15 17:15,1298,659,639,108067,38510,69557,84724649.0,30206440.0,54518209.0,1219,616,603,105114,38014,67100,82624848.0,29740981.0,52883867.0,0.7844,0.7838,0.7824,0.7881
2023-09-15 17:20,926,346,580,124316,21937,102379,98453683.0,17128744.0,81324938.0,876,315,561,101330,20080,81250,79585844.0,15665998.0,63919845.0,0.7808,0.7944,0.7802,0.7867
2023-09-15 17:25,2091,995,1096,181837,69480,112357,141794535.0,54039880.0,87754655.0,1967,907,1060,172832,64739,108093,135136907.0,50332775.0,84804132.0,0.7778,0.781,0.7775,0.7845
2023-09-15 17:30,790,291,499,71764,18128,53636,56219003.0,14187851.0,42031152.0,712,243,469,70426,16618,53808,55212744.0,12871568.0,42341175.0,0.7826,0.7836,0.7746,0.7869
2023-09-15 17:35,660,237,423,65175,18235,46940,50793826.0,14152627.0,36641199.0,594,205,389,60944,16143,44801,47584162.0,12524825.0,35059337.0,0.7761,0.7806,0.7759,0.7826
2023-09-15 17:40,493,175,318,43052,10729,32323,33574481.0,8406016.0,25168465.0,436,140,296,39743,9623,30120,31044797.0,7466355.0,23578442.0,0.7835,0.7787,0.7759,0.7828
2023-09-15 17:45,793,259,534,86012,26687,59325,67199814.0,20789319.0,46410495.0,714,210,504,79821,22785,57036,62354757.0,17684366.0,44670391.0,0.779,0.7823,0.7761,0.7832
2023-09-15 17:50,1146,589,557,97599,16698,80901,76400678.0,13020988.0,63379690.0,1104,563,541,95184,14703,80481,74504313.0,11445026.0,63059286.0,0.7798,0.7834,0.7784,0.7835
2023-09-15 17:55,498,294,204,39119,11495,27624,30523953.0,8929015.0,21594937.0,471,282,189,41172,13979,27193,32129466.0,10852976.0,21276490.0,0.7768,0.7817,0.7764,0.7824
2023-09-15 18:00,1115,467,648,116811,46378,70433,90547578.0,36109464.0,54438113.0,996,387,609,103034,39196,63838,80101767.0,30344463.0,49757304.0,0.7786,0.7729,0.7742,0.7794
2023-09-15 18:05,567,285,282,56557,22984,33573,43880605.0,17866410.0,26014194.0,500,243,257,41167,14930,26237,32028867.0,11555240.0,20473627.0,0.7773,0.7749,0.774,0.7803
2023-09-15 18:10,243,109,134,17900,6990,10910,13956847.0,5442679.0,8514167.0,188,73,115,17995,5399,12596,14033712.0,4183414.0,9850297.0,0.7786,0.7804,0.7748,0.782
2023-09-15 18:15,936,176,760,75843,11202,64641,58820731.0,8736871.0,50083859.0,877,138,739,79243,14615,64628,61492862.0,11294839.0,50198023.0,0.7799,0.7748,0.7728,0.7767
2023-09-15 18:20,1270,445,825,90452,20425,70027,70023382.0,15826050.0,54197332.0,1201,411,790,86988,19675,67313,67520685.0,15230268.0,52290417.0,0.7748,0.7739,0.7741,0.7768
2023-09-15 18:25,973,410,563,106597,46176,60421,82110528.0,35654446.0,46456081.0,871,353,518,101715,42098,59617,78658955.0,32430660.0,46228294.0,0.7721,0.7689,0.7704,0.7754
2023-09-15 18:30,691,383,308,62974,37632,25342,48481258.0,28974371.0,19506887.0,617,333,284,59862,36422,23440,46166062.0,28022800.0,18143261.0,0.7699,0.7697,0.7694,0.774
2023-09-15 18:35,1461,1041,420,108895,66595,42300,83869092.0,51482158.0,32386934.0,1281,913,368,110626,57394,53232,86464556.0,44108928.0,42355628.0,0.7731,0.7656,0.7685,0.7957
2023-09-18 10:00,7312,3530,3782,905260,407963,497297,705312671.0,316132535.0,389180136.0,6660,3292,3368,869766,399506,470260,677382816.0,309969861.0,367412954.0,0.7749,0.7826,0.7759,0.7813
2023-09-18 10:05,8875,5278,3597,1695797,1097617,598180,1318975700.0,852819911.0,466155788.0,8584,5111,3473,1671515,1082387,589128,1299928228.0,840449671.0,459478556.0,0.777,0.7793,0.7765,0.7799
2023-09-18 10:10,7460,3930,3530,1422226,963479,458747,1109505711.0,750239122.0,359266589.0,7128,3732,3396,1411470,961069,450401,1100590926.0,748003520.0,352587406.0,0.7787,0.7831,0.7783,0.7828
2023-09-18 10:15,8630,2380,6250,1918844,575267,1343577,1498811310.0,447894448.0,1050916861.0,8385,2248,6137,1890321,560054,1330267,1476601561.0,435484305.0,1041117256.0,0.7786,0.7822,0.7776,0.7826
2023-09-18 10:20,5273,2257,3016,911964,398037,513927,712970685.0,310235790.0,402734895.0,5060,2171,2889,900972,388933,512039,704229088.0,302960418.0,401268669.0,0.7794,0.7836,0.779,0.7837
2023-09-18 10:25,9033,7189,1844,1612558,1483349,129209,1263121414.0,1161354741.0,101766672.0,8692,7058,1634,1598820,1478651,120169,1252139393.0,1157589490.0,94549902.0,0.7829,0.7876,0.7829,0.7868
2023-09-18 10:30,1329,658,671,155851,58065,97786,121815413.0,45456203.0,76359209.0,1121,563,558,150241,57826,92415,117791689.0,45225752.0,72565937.0,0.7829,0.7809,0.7821,0.7852
2023-09-18 10:35,9333,4005,5328,1730198,542384,1187814,1350516331.0,422216822.0,928299508.0,9118,3883,5235,1713756,531196,1182560,1337930137.0,413391299.0,924538838.0,0.7784,0.7815,0.7782,0.7818
2023-09-18 10:40,7033,4990,2043,1367369,1104323,263046,1067044917.0,860803859.0,206241058.0,6922,4939,1983,1362497,1102422,260075,1063244842.0,859287705.0,203957137.0,0.7795,0.784,0.7795,0.7842
2023-09-18 10:45,3839,2686,1153,782691,598573,184118,610971136.0,466237439.0,144733697.0,3757,2651,1106,780308,597928,182380,609452176.0,465683045.0,143769130.0,0.7789,0.7861,0.7788,0.7883
2023-09-18 10:50,3711,2047,1664,616964,379919,237045,482053332.0,296318857.0,185734475.0,3592,1979,1613,593725,358026,235699,463610529.0,278901411.0,184709118.0,0.78,0.7835,0.779,0.7837
2023-09-18 10:55,1648,306,1342,225379,37316,188063,176827340.0,29294347.0,147532992.0,1495,225,1270,231320,49331,181989,181551235.0,38504572.0,143046662.0,0.785,0.7845,0.7805,0.786
2023-09-18 11:00,4372,2156,2216,812230,371267,440963,636250706.0,289999981.0,346250724.0,4297,2110,2187,799651,359554,440097,626422451.0,280875125.0,345547325.0,0.7811,0.7852,0.7812,0.7852
2023-09-18 11:05,7500,5235,2265,1453987,1043784,410203,1137543137.0,815357369.0,322185768.0,7445,5214,2231,1461152,1052201,408951,1142986489.0,821848363.0,321138126.0,0.7812,0.7854,0.7811,0.7853
2023-09-18 11:10,2200,1424,776,432271,368202,64069,338196658.0,287530591.0,50666066.0,2143,1392,751,431313,367254,64059,337191268.0,286693478.0,50497789.0,0.7809,0.7908,0.7806,0.7883
2023-09-18 11:15,2109,1817,292,354551,337476,17075,278298890.0,264824950.0,13473940.0,1968,1756,212,352555,337069,15486,276610068.0,264347023.0,12263044.0,0.7847,0.7891,0.7843,0.7919
2023-09-18 11:20,2397,1207,1190,336239,223263,112976,263984866.0,175141868.0,88842998.0,2292,1155,1137,331056,223051,108005,259944961.0,174877389.0,85067572.0,0.7845,0.7864,0.784,0.7876
2023-09-18 11:25,1347,587,760,212976,105406,107570,166910570.0,82403217.0,84507353.0,1287,557,730,208795,103594,105201,163682608.0,80959337.0,82723270.0,0.7818,0.7856,0.7815,0.7863
2023-09-18 11:30,1978,682,1296,293966,134181,159785,230494132.0,104895842.0,125598290.0,1917,646,1271,287425,130400,157025,225356827.0,101871933.0,123484893.0,0.7817,0.786,0.7812,0.7864
2023-09-18 11:35,1139,601,538,197873,139049,58824,154850145.0,108589332.0,46260812.0,1072,575,497,192981,139313,53668,150962008.0,108794698.0,42167310.0,0.7809,0.7864,0.7809,0.7857
2023-09-18 11:40,657,341,316,116928,87440,29488,91410119.0,68207549.0,23202569.0,596,318,278,112198,85380,26818,87691219.0,66593414.0,21097805.0,0.78,0.7868,0.78,0.7867
2023-09-18 11:45,2138,835,1303,309973,100689,209284,242200916.0,78474888.0,163726027.0,2069,800,1269,306882,99552,207330,240062090.0,77580751.0,162481339.0,0.7794,0.7823,0.7793,0.7837
2023-09-18 11:50,2659,1142,1517,368816,138915,229901,288496843.0,108373062.0,180123780.0,2583,1095,1488,360688,135094,225594,282304992.0,105361648.0,176943343.0,0.7801,0.7835,0.7799,0.7843
2023-09-18 11:55,561,239,322,82721,9878,72843,64701187.0,7688808.0,57012378.0,524,224,300,78857,10003,68854,61712619.0,7786695.0,53925923.0,0.7784,0.7827,0.7784,0.7832
2023-09-18 12:00,2255,1277,978,308975,119315,189660,241250184.0,92978638.0,148271545.0,2212,1258,954,309151,118466,190685,241364538.0,92252792.0,149111746.0,0.7793,0.7818,0.7787,0.782
2023-09-18 12:05,783,313,470,54655,31263,23392,42627027.0,24370442.0,18256585.0,766,299,467,55388,30620,24768,43212660.0,23848702.0,19363957.0,0.7795,0.7805,0.7789,0.7818
2023-09-18 12:10,4256,944,3312,685599,91910,593689,534996372.0,71543362.0,463453010.0,4156,896,3260,679110,88642,590468,529931495.0,68844992.0,461086503.0,0.7784,0.7806,0.7767,0.7809
2023-09-18 12:15,1929,536,1393,276153,57290,218863,215245937.0,44591578.0,170654358.0,1850,500,1350,271554,54297,217257,211703285.0,42187105.0,169516180.0,0.7783,0.7797,0.777,0.7803
2023-09-18 12:20,4440,1140,3300,541754,88085,453669,421942725.0,68509300.0,353433424.0,4368,1116,3252,537823,86394,451429,419077884.0,67125317.0,351952567.0,0.7778,0.7791,0.777,0.7796
2023-09-18 12:25,4380,1278,3102,585462,161315,424147,455363386.0,125171202.0,330192184.0,4319,1245,3074,579536,157200,422336,450900232.0,121939958.0,328960273.0,0.7759,0.7785,0.7757,0.7789
2023-09-18 12:30,395,90,305,52508,4833,47675,40932474.0,3746965.0,37185509.0,373,79,294,53261,5204,48057,41508614.0,4032044.0,37476570.0,0.7753,0.78,0.7748,0.7798
2023-09-18 12:35,2123,520,1603,285036,26452,258584,222014999.0,20551896.0,201463103.0,2090,506,1584,279792,24225,255567,217987902.0,18802283.0,199185619.0,0.777,0.7791,0.7762,0.7794
2023-09-18 12:40,1988,616,1372,291506,52150,239356,226996560.0,40449111.0,186547448.0,1966,607,1359,292442,54930,237512,227631789.0,42617926.0,185013862.0,0.7756,0.7794,0.7759,0.779
2023-09-18 12:45,1579,341,1238,294165,23335,270830,228615989.0,18046274.0,210569714.0,1501,297,1204,289309,21367,267942,225119992.0,16507188.0,208612803.0,0.7734,0.7775,0.7726,0.7786
2023-09-18 12:50,1843,436,1407,239472,30599,208873,185815878.0,23664114.0,162151764.0,1744,380,1364,233174,27150,206024,180953527.0,20931282.0,160022244.0,0.7734,0.7763,0.7709,0.7767
2023-09-18 12:55,2018,1090,928,169910,52877,117033,131293157.0,40661718.0,90631439.0,1932,1036,896,159669,46293,113376,123736312.0,35731744.0,88004567.0,0.769,0.7744,0.7719,0.7762
2023-09-18 13:00,1106,820,286,90414,70918,19496,70006179.0,54927129.0,15079050.0,1033,784,249,85635,67545,18090,66171626.0,52142439.0,14029187.0,0.7745,0.7734,0.772,0.7755
2023-09-18 13:05,1812,1264,548,213970,177161,36809,165701768.0,137116927.0,28584841.0,1754,1224,530,209135,173506,35629,161699137.0,134018698.0,27680438.0,0.774,0.7766,0.7724,0.7769
2023-09-18 13:10,2486,1493,993,397060,262917,134143,307850958.0,203417017.0,104433940.0,2433,1462,971,394820,261649,133171,306025738.0,202347186.0,103678552.0,0.7737,0.7785,0.7734,0.7785
2023-09-18 13:15,4551,2665,1886,775775,579656,196119,601079593.0,448408956.0,152670636.0,4515,2652,1863,774347,578887,195460,599970369.0,447794039.0,152176329.0,0.7736,0.7785,0.7735,0.7786
2023-09-18 13:20,1110,734,376,132613,110263,22350,102739439.0,85340901.0,17398538.0,1080,722,358,131601,109916,21685,101956842.0,85068616.0,16888225.0,0.774,0.7785,0.7739,0.7788
2023-09-18 13:25,1405,771,634,161518,120838,40680,125110117.0,93517366.0,31592750.0,1378,757,621,160427,120466,39961,124307904.0,93225713.0,31082190.0,0.7739,0.7766,0.7739,0.7778
2023-09-18 13:30,409,120,289,63511,17380,46131,49401027.0,13467078.0,35933949.0,388,111,277,62281,16817,45464,48441957.0,13027612.0,35414344.0,0.7749,0.779,0.7747,0.779
2023-09-18 13:35,431,285,146,28822,10847,17975,22406645.0,8418384.0,13988260.0,408,269,139,27555,9859,17696,21421885.0,7640567.0,13781317.0,0.7761,0.7782,0.775,0.7788
2023-09-18 13:40,1675,705,970,166185,63597,102588,129047478.0,49226103.0,79821375.0,1636,681,955,163318,61556,101762,127032400.0,47761738.0,79270661.0,0.774,0.7781,0.7759,0.779
2023-09-18 13:45,1582,502,1080,208129,47921,160208,162012787.0,37160702.0,124852084.0,1557,484,1073,207528,47633,159895,161539194.0,36923033.0,124616161.0,0.7755,0.7793,0.7752,0.7794
2023-09-18 13:50,1700,788,912,223815,72072,151743,174169436.0,55897109.0,118272326.0,1687,783,904,223333,71936,151397,173792204.0,55787943.0,118004260.0,0.7756,0.7794,0.7755,0.7794
2023-09-18 13:55,749,151,598,101267,8444,92823,78986430.0,6553711.0,72432718.0,737,140,597,102710,8402,94308,80122674.0,6518410.0,73604263.0,0.7761,0.7803,0.7758,0.7805
2023-09-18 14:00,735,343,392,79626,31067,48559,61930074.0,24084683.0,37845390.0,724,337,387,79102,30504,48598,61545778.0,23645287.0,37900491.0,0.7752,0.7794,0.7752,0.7799
2023-09-18 14:05,1970,864,1106,264771,59523,205248,206035468.0,46128243.0,159907225.0,1922,841,1081,261055,58517,202538,203163188.0,45350683.0,157812504.0,0.775,0.7791,0.775,0.7792
2023-09-18 14:10,3990,1361,2629,556263,141347,414916,432350368.0,109367950.0,322982417.0,3936,1328,2608,550512,137715,412797,427954096.0,106574783.0,321379313.0,0.7738,0.7784,0.7739,0.7785
2023-09-18 14:15,1712,398,1314,300686,27301,273385,233899774.0,21139539.0,212760235.0,1671,375,1296,292905,21177,271728,227971268.0,16397599.0,211573669.0,0.7743,0.7782,0.7743,0.7786
2023-09-18 14:20,3292,530,2762,487066,33740,453326,379371571.0,26291479.0,353080091.0,3240,508,2732,483773,32310,451463,376656703.0,25022745.0,351633957.0,0.7792,0.7789,0.7745,0.7789
2023-09-18 14:25,2960,654,2306,468644,25612,443032,364725202.0,19822152.0,344903049.0,2958,654,2304,476878,31917,444961,371424664.0,24673420.0,346751244.0,0.7739,0.7785,0.773,0.7793
2023-09-18 14:30,1321,411,910,157748,31629,126119,122030621.0,24416032.0,97614589.0,1209,342,867,149665,28210,121455,115968002.0,21737954.0,94230047.0,0.772,0.774,0.7706,0.7758
2023-09-18 14:35,1498,575,923,166865,44143,122722,129228811.0,34080091.0,95148719.0,1449,545,904,168216,42598,125618,130399492.0,32852316.0,97547176.0,0.772,0.7753,0.7712,0.7765
2023-09-18 14:40,7260,5367,1893,866708,609236,257472,664187847.0,465416139.0,198771707.0,6996,5215,1781,849581,601019,248562,651473936.0,459075068.0,192398867.0,0.7639,0.772,0.7638,0.774
2023-09-18 14:45,7904,3763,4141,844660,375220,469440,643955095.0,287347757.0,356607338.0,7417,3425,3992,807878,357171,450707,613980432.0,270732920.0,343247512.0,0.7658,0.7596,0.758,0.7616
2023-09-18 14:50,1325,623,702,112612,43319,69293,86001218.0,32996770.0,53004447.0,1171,515,656,101347,35745,65602,77493646.0,27172224.0,50321421.0,0.7617,0.7649,0.7602,0.7671
2023-09-18 14:55,4878,1005,3873,1162653,87065,1075588,886920523.0,65973536.0,820946986.0,4736,932,3804,1152652,85097,1067555,879527527.0,64237874.0,815289652.0,0.7578,0.7633,0.7549,0.7637
2023-09-18 15:00,8168,3223,4945,1533930,471678,1062252,1162734535.0,357682014.0,805052521.0,7710,2917,4793,1498419,450375,1048044,1136065480.0,341140183.0,794925297.0,0.7583,0.7579,0.7575,0.7585
2023-09-18 15:05,10429,8430,1999,1700360,1541482,158878,1290781521.0,1169489545.0,121291975.0,10150,8322,1828,1683012,1532579,150433,1277066782.0,1161985340.0,115081441.0,0.7587,0.7634,0.7582,0.765
2023-09-18 15:10,4572,2194,2378,769716,426763,342953,581653804.0,321163436.0,260490368.0,4419,2103,2316,752509,421457,331052,568852573.0,317193126.0,251659447.0,0.7526,0.7596,0.7526,0.7602
2023-09-18 15:15,4687,2575,2112,966157,783865,182292,726649144.0,588352304.0,138296840.0,4602,2525,2077,950813,768639,182174,716337571.0,578100786.0,138236784.0,0.7506,0.7587,0.7521,0.7588
2023-09-18 15:20,5360,4320,1040,1545962,1459520,86442,1170232322.0,1103592031.0,66640291.0,5206,4270,936,1542647,1455459,87188,1167569147.0,1099921905.0,67647242.0,0.7561,0.7709,0.7557,0.7759
2023-09-18 15:25,5008,3383,1625,988210,748647,239563,749321072.0,566520622.0,182800449.0,4899,3312,1587,978263,744113,234150,741792909.0,563016149.0,178776759.0,0.7567,0.7631,0.7566,0.7635
2023-09-18 15:30,6384,2996,3388,1394555,505804,888751,1055809249.0,381739940.0,674069309.0,6118,2825,3293,1367969,490958,877011,1036597268.0,370599220.0,665998048.0,0.7547,0.7584,0.7548,0.7594
2023-09-18 15:35,1631,654,977,264276,48792,215484,200646553.0,36951709.0,163694844.0,1525,590,935,261425,47061,214364,198331725.0,35416495.0,162915229.0,0.7573,0.7597,0.7526,0.76
2023-09-18 15:40,3547,736,2811,878113,44713,833400,664231603.0,33821936.0,630409667.0,3363,627,2736,874385,38532,835853,662059207.0,28872227.0,633186979.0,0.7564,0.7564,0.7493,0.7575
2023-09-18 15:45,6678,2983,3695,1263563,310305,953258,949509741.0,232742153.0,716767588.0,6310,2739,3571,1231059,289360,941699,925417626.0,216778187.0,708639438.0,0.75,0.7519,0.7492,0.7525
2023-09-18 15:50,5728,3231,2497,946164,390615,555549,713469810.0,293382891.0,420086918.0,5569,3160,2409,930633,381009,549624,702188989.0,286315904.0,415873085.0,0.7511,0.7562,0.7515,0.7567
2023-09-18 15:55,4701,2741,1960,625309,286485,338824,470846994.0,214842530.0,256004464.0,4590,2663,1927,620534,283840,336694,467218620.0,212683260.0,254535360.0,0.7499,0.7556,0.7493,0.756
2023-09-18 16:00,3889,2441,1448,609513,387643,221870,459158984.0,291524814.0,167634169.0,3743,2346,1397,611872,392276,219596,460873604.0,294752675.0,166120928.0,0.752,0.7556,0.7514,0.7565
2023-09-18 16:05,7553,1113,6440,981596,68491,913105,738880047.0,51474313.0,687405733.0,7405,1013,6392,972036,62015,910021,731818442.0,46413017.0,685405425.0,0.7515,0.7528,0.7484,0.7532
2023-09-18 16:10,3972,1646,2326,643895,281357,362538,483658893.0,210745306.0,272913587.0,3830,1560,2270,632455,275047,357408,474961222.0,205695467.0,269265754.0,0.749,0.7528,0.7479,0.7534
2023-09-18 16:15,5802,1052,4750,1239852,99156,1140696,932493864.0,75339470.0,857154393.0,5649,952,4697,1234080,96135,1137945,928254828.0,73002600.0,855252228.0,0.7598,0.7514,0.7594,0.7516
2023-09-18 16:20,5217,2518,2699,966809,525013,441796,725076774.0,393448645.0,331628129.0,5016,2382,2634,945793,512891,432902,707808417.0,382804251.0,325004166.0,0.7494,0.7506,0.7464,0.7508
2023-09-18 16:25,6051,3161,2890,1055616,590006,465610,788431435.0,439690588.0,348740846.0,5951,3088,2863,1051433,586291,465142,785376030.0,436630799.0,348745231.0,0.7452,0.749,0.7447,0.7498
2023-09-18 16:30,2451,1032,1419,285322,136734,148588,213298176.0,101901679.0,111396497.0,2319,934,1385,278339,133643,144696,209425706.0,100842305.0,108583400.0,0.7453,0.7497,0.7546,0.7504
2023-09-18 16:35,7396,4242,3154,1480475,820693,659782,1100801564.0,609070395.0,491731169.0,7098,4036,3062,1459909,808759,651150,1085731616.0,599957530.0,485774085.0,0.7421,0.7453,0.7418,0.746
2023-09-18 16:40,5240,3604,1636,1227828,994367,233461,913043496.0,737929521.0,175113975.0,5182,3565,1617,1223336,993486,229850,909237321.0,737176391.0,172060930.0,0.7421,0.7501,0.742,0.7486
2023-09-18 16:45,7499,6420,1079,2012960,1907032,105928,1500048259.0,1420643003.0,79405256.0,7403,6369,1034,2009470,1907112,102358,1495936368.0,1419180727.0,76755641.0,0.7449,0.7496,0.7442,0.7499
2023-09-18 16:50,7209,4622,2587,1465910,1168346,297564,1092570533.0,869896578.0,222673955.0,7100,4551,2549,1463571,1164407,299164,1092161172.0,868204664.0,223956507.0,0.7446,0.7483,0.7456,0.7486
2023-09-18 16:55,6852,5461,1391,1634588,1491185,143403,1224642052.0,1116932072.0,107709980.0,6695,5402,1293,1617222,1480563,136659,1211070348.0,1108392422.0,102677926.0,0.749,0.7511,0.7486,0.7513
2023-09-18 17:00,5417,2922,2495,1203646,537243,666403,909068520.0,407826465.0,501242054.0,5309,2853,2456,1193861,532100,661761,900791160.0,402855155.0,497936005.0,0.7591,0.7522,0.7571,0.7524
2023-09-18 17:05,5137,2248,2889,891569,377149,514420,672616102.0,285200240.0,387415861.0,5047,2205,2842,883145,375248,507897,667809659.0,285136548.0,382673111.0,0.7562,0.7531,0.7599,0.7534
2023-09-18 17:10,7233,4064,3169,1505211,926180,579031,1128527370.0,692781641.0,435745728.0,7151,4018,3133,1499563,924209,575354,1123794871.0,690884746.0,432910125.0,0.748,0.7525,0.7475,0.7524
2023-09-18 17:15,4434,3613,821,1007783,921829,85954,755311277.0,690484518.0,64826758.0,4428,3593,835,1003925,919592,84333,752396605.0,688718677.0,63677928.0,0.749,0.7542,0.7489,0.7551
2023-09-18 17:20,6293,5284,1009,1500981,1377991,122990,1127042324.0,1034112016.0,92930308.0,6175,5222,953,1495578,1373309,122269,1122732173.0,1030323399.0,92408773.0,0.7504,0.7556,0.7502,0.7558
2023-09-18 17:25,4909,2803,2106,997632,626824,370808,750866947.0,470804368.0,280062579.0,4841,2758,2083,990572,623124,367448,745595215.0,468011041.0,277584173.0,0.7511,0.7553,0.7511,0.7554
2023-09-18 17:30,1113,572,541,159787,128064,31723,121528057.0,96304678.0,25223378.0,1066,547,519,147272,119543,27729,111364648.0,89700724.0,21663924.0,0.752,0.7951,0.7504,0.7813
2023-09-18 17:35,1447,1103,344,225749,197125,28624,170250842.0,148592642.0,21658200.0,1396,1082,314,221767,196220,25547,167130447.0,147744198.0,19386248.0,0.7538,0.7566,0.753,0.7588
2023-09-18 17:40,831,589,242,160640,124166,36474,121478884.0,93555954.0,27922930.0,794,562,232,150531,122383,28148,113541914.0,92184105.0,21357809.0,0.7535,0.7656,0.7532,0.7588
2023-09-18 17:45,1369,1001,368,272967,240222,32745,205789829.0,181024222.0,24765606.0,1345,991,354,271195,239260,31935,204555425.0,180318242.0,24237182.0,0.7536,0.7563,0.7536,0.759
2023-09-18 17:50,3578,1896,1682,669786,384948,284838,505373053.0,289409520.0,215963533.0,3518,1867,1651,665171,385015,280156,501249410.0,289311766.0,211937643.0,0.7518,0.7582,0.7514,0.7565
2023-09-18 17:55,5536,3650,1886,1132215,792359,339856,857518123.0,599228661.0,258289462.0,5441,3609,1832,1121677,784403,337274,846863705.0,591484172.0,255379532.0,0.7563,0.76,0.7541,0.7572
2023-09-18 18:00,3411,1932,1479,582700,425092,157608,442717023.0,322960919.0,119756104.0,3365,1901,1464,577492,421247,156245,438864300.0,320039308.0,118824992.0,0.7597,0.7598,0.7597,0.7605
2023-09-18 18:05,7843,4811,3032,1504277,1146576,357701,1138824005.0,866624214.0,272199791.0,7817,4795,3022,1502019,1145550,356469,1136944616.0,865638072.0,271306543.0,0.7558,0.761,0.7557,0.7611
2023-09-18 18:10,7997,3089,4908,1789172,701853,1087319,1353809373.0,529455523.0,824353850.0,7958,3078,4880,1789626,705429,1084197,1355191702.0,533050117.0,822141584.0,0.7544,0.7582,0.7556,0.7583
2023-09-18 18:15,5826,1196,4630,1351425,246534,1104891,1024501511.0,185272759.0,839228751.0,5792,1182,4610,1348760,246951,1101809,1022325563.0,185524115.0,836801448.0,0.7515,0.7596,0.7513,0.7595
2023-09-18 18:20,5006,888,4118,1480666,204345,1276321,1121276793.0,153499491.0,967777301.0,4986,881,4105,1483084,206065,1277019,1123220191.0,154765861.0,968454330.0,0.7512,0.7583,0.7511,0.7584
2023-09-18 18:25,3868,1066,2802,728797,117961,610836,550493252.0,88308428.0,462184824.0,3776,1021,2755,723911,114398,609513,546893440.0,85584285.0,461309155.0,0.7486,0.7566,0.7481,0.7568
2023-09-18 18:30,6003,1745,4258,1094836,309599,785237,822913364.0,231861142.0,591052221.0,5940,1707,4233,1092702,308335,784367,821248321.0,230839593.0,590408728.0,0.7489,0.7527,0.7487,0.7527
2023-09-18 18:35,2131,749,1382,285824,104967,180857,216071971.0,78790684.0,137281287.0,2093,732,1361,280502,101908,178594,212632387.0,76377843.0,136254543.0,0.7506,0.7591,0.7495,0.7629
2023-09-19 10:00,8393,3338,5055,1427908,457060,970848,1065762485.0,340292366.0,725470118.0,7591,2920,4671,1367101,430672,936429,1019356097.0,319776790.0,699579307.0,0.7445,0.7473,0.7425,0.7471
2023-09-19 10:05,7660,3690,3970,1028468,383993,644475,757215824.0,283054855.0,474160968.0,6870,3133,3737,976728,354181,622547,718519689.0,259311066.0,459208623.0,0.7371,0.7357,0.7321,0.7376
2023-09-19 10:10,8577,5023,3554,1090801,660998,429803,806028186.0,487680899.0,318347286.0,7914,4668,3246,1062203,645082,417121,783830513.0,474645427.0,309185086.0,0.7378,0.7407,0.7358,0.7412
2023-09-19 10:15,5558,2511,3047,802297,232575,569722,595243379.0,172606003.0,422637375.0,5235,2320,2915,771318,219479,551839,572194750.0,163025311.0,409169438.0,0.7422,0.7418,0.7428,0.7415
2023-09-19 10:20,3945,1199,2746,616957,109870,507087,456553920.0,80912449.0,375641470.0,3740,1062,2678,607158,106926,500232,449619285.0,78700293.0,370918992.0,0.7364,0.7408,0.736,0.7415
2023-09-19 10:25,6312,2293,4019,1135457,360891,774566,839107632.0,265799787.0,573307844.0,6159,2198,3961,1127256,355996,771260,832953525.0,262092066.0,570861459.0,0.7365,0.7402,0.7362,0.7402
2023-09-19 10:30,4624,1297,3327,678337,118917,559420,501734249.0,87651187.0,414083062.0,4489,1219,3270,674838,115975,558863,500627338.0,86739104.0,413888234.0,0.7371,0.7402,0.7479,0.7406
2023-09-19 10:35,3837,1124,2713,541803,91135,450668,400717688.0,66921121.0,333796566.0,3760,1076,2684,533467,88290,445177,394407457.0,64833836.0,329573620.0,0.7343,0.7407,0.7343,0.7403
2023-09-19 10:40,2522,498,2024,370180,14979,355201,273638841.0,11033644.0,262605196.0,2419,437,1982,366983,12932,354051,271277951.0,9503966.0,261773985.0,0.7366,0.7393,0.7349,0.7394
2023-09-19 10:45,4943,1066,3877,904719,89770,814949,663994908.0,65400027.0,598594881.0,4686,906,3780,885778,81497,804281,650696430.0,59392361.0,591304068.0,0.7285,0.7345,0.7288,0.7352
2023-09-19 10:50,3624,2347,1277,609446,467056,142390,446220859.0,341620233.0,104600626.0,3465,2275,1190,597983,460059,137924,437694811.0,336295789.0,101399021.0,0.7314,0.7346,0.731,0.7352
2023-09-19 10:55,2555,1019,1536,444937,265608,179329,326640242.0,195246426.0,131393816.0,2313,862,1451,397701,242701,155000,292100097.0,178403691.0,113696406.0,0.7351,0.7327,0.7351,0.7335
2023-09-19 11:00,6734,1063,5671,1616891,86813,1530078,1173756861.0,63598840.0,1110158020.0,6294,726,5568,1587579,72236,1515343,1151876736.0,51957198.0,1099919537.0,0.7326,0.7256,0.7193,0.7259
2023-09-19 11:05,5882,3277,2605,841038,380057,460981,607007286.0,273507397.0,333499888.0,4956,2536,2420,781496,335996,445500,562866467.0,240057370.0,322809097.0,0.7196,0.7235,0.7145,0.7246
2023-09-19 11:10,6113,2489,3624,1470832,334062,1136770,1050202180.0,236662937.0,813539242.0,5575,2099,3476,1453284,310588,1142696,1038270529.0,219905812.0,818364717.0,0.7084,0.7157,0.708,0.7162
2023-09-19 11:15,5949,2808,3141,1141893,421445,720448,815432165.0,301995810.0,513436355.0,5246,2304,2942,1074200,384550,689650,766592411.0,274538921.0,492053489.0,0.7166,0.7127,0.7139,0.7135
2023-09-19 11:20,5640,3717,1923,1234097,993161,240936,878742603.0,706354170.0,172388433.0,5217,3470,1747,1205020,981716,223304,857051818.0,697213027.0,159838791.0,0.7112,0.7155,0.7102,0.7158
2023-09-19 11:25,8977,2958,6019,1443745,442423,1001322,1021256439.0,312163009.0,709093430.0,8695,2857,5838,1395520,414949,980571,987127166.0,292256329.0,694870836.0,0.7056,0.7082,0.7043,0.7086
2023-09-19 11:30,7842,3497,4345,1176557,446371,730186,834692168.0,316352772.0,518339396.0,7361,3218,4143,1142266,433212,709054,809603230.0,306096513.0,503506716.0,0.7087,0.7099,0.7066,0.7101
2023-09-19 11:35,5796,3881,1915,952821,765355,187466,679335202.0,545068527.0,134266675.0,5414,3659,1755,923597,746489,177108,659508807.0,532440489.0,127068318.0,0.7122,0.7162,0.7133,0.7175
2023-09-19 11:40,5513,3108,2405,980939,727205,253734,703321877.0,520645209.0,182676668.0,5011,2861,2150,928964,699950,229014,664662105.0,499287547.0,165374558.0,0.716,0.72,0.7133,0.7221
2023-09-19 11:45,3845,1252,2593,743765,91870,651895,536128955.0,66112055.0,470016900.0,3556,1085,2471,721583,79428,642155,520161840.0,56888203.0,463273637.0,0.7196,0.721,0.7162,0.7214
2023-09-19 11:50,6802,2099,4703,1442150,207375,1234775,1035367785.0,147919499.0,887448286.0,6566,1976,4590,1423146,199646,1223500,1021976033.0,142079644.0,879896388.0,0.7133,0.7187,0.7117,0.7192
2023-09-19 11:55,5240,2952,2288,841410,524567,316843,603926593.0,375463177.0,228463416.0,5084,2857,2227,841697,528866,312831,603773408.0,378154440.0,225618968.0,0.7158,0.7211,0.715,0.7212
2023-09-19 12:00,1978,1008,970,328556,210466,118090,235160245.0,150319159.0,84841085.0,1871,955,916,320425,208394,112031,229445987.0,148783305.0,80662681.0,0.7142,0.7184,0.714,0.72
2023-09-19 12:05,1959,967,992,232015,142847,89168,166754908.0,102444875.0,64310033.0,1876,906,970,228881,139242,89639,164353941.0,99678576.0,64675365.0,0.7172,0.7212,0.7159,0.7215
2023-09-19 12:10,3437,896,2541,682938,142064,540874,490796110.0,101112642.0,389683468.0,3352,843,2509,679006,142283,536723,487880853.0,101000595.0,386880257.0,0.7117,0.7205,0.7099,0.7208
2023-09-19 12:15,4270,1660,2610,836212,203691,632521,601071313.0,145779273.0,455292039.0,4135,1576,2559,826758,197853,628905,594256146.0,141437827.0,452818319.0,0.7157,0.7198,0.7149,0.72
2023-09-19 12:20,6408,1972,4436,1475106,275988,1199118,1060182588.0,197252396.0,862930192.0,6287,1901,4386,1459264,267103,1192161,1048876312.0,190810599.0,858065713.0,0.7147,0.7196,0.7144,0.7198
2023-09-19 12:25,4949,2426,2523,1013392,313505,699887,729248693.0,224877238.0,504371455.0,4809,2347,2462,1007491,309852,697639,724527701.0,221760490.0,502767211.0,0.7173,0.7206,0.7157,0.7207
2023-09-19 12:30,5751,4668,1083,1615405,1537737,77668,1165224545.0,1108872018.0,56352527.0,5442,4530,912,1588046,1523590,64456,1144380720.0,1097542305.0,46838415.0,0.7211,0.7256,0.7204,0.7267
2023-09-19 12:35,6042,2974,3068,1047128,764858,282270,756737612.0,551747455.0,204990156.0,5794,2841,2953,1032542,760597,271945,746030698.0,548318691.0,197712007.0,0.7214,0.7262,0.7209,0.727
2023-09-19 12:40,6263,2660,3603,1282221,415575,866646,926444113.0,298865488.0,627578624.0,6016,2506,3510,1255924,403623,852301,907465286.0,289821631.0,617643655.0,0.7192,0.7241,0.7181,0.7247
2023-09-19 12:45,5898,1507,4391,1594638,133605,1461033,1146551865.0,96651223.0,1049900641.0,5623,1370,4253,1576960,125193,1451767,1134242499.0,90239316.0,1044003183.0,0.7234,0.7186,0.7208,0.7191
2023-09-19 12:50,3087,636,2451,818402,40868,777534,587596415.0,29035041.0,558561373.0,2946,553,2393,805783,34284,771499,579951950.0,25481751.0,554470198.0,0.7105,0.7184,0.7433,0.7187
2023-09-19 12:55,7268,4224,3044,1725493,1153178,572315,1235592631.0,824234195.0,411358436.0,7107,4139,2968,1710061,1144196,565865,1224387626.0,817380355.0,407007270.0,0.7148,0.7188,0.7144,0.7193
2023-09-19 13:00,4673,1500,3173,867076,213448,653628,621375753.0,151933516.0,469442236.0,4546,1425,3121,855559,207813,647746,613251811.0,147833359.0,465418452.0,0.7118,0.7182,0.7114,0.7185
2023-09-19 13:05,6906,3473,3433,1354617,542763,811854,970221850.0,386631689.0,583590160.0,6762,3387,3375,1342512,531625,810887,961133736.0,378207512.0,582926224.0,0.7123,0.7188,0.7114,0.7189
2023-09-19 13:10,6822,2415,4407,1453904,473066,980838,1044771271.0,337445344.0,707325927.0,6644,2312,4332,1430875,459518,971357,1028718706.0,327892384.0,700826322.0,0.7133,0.7211,0.7136,0.7215
2023-09-19 13:15,4974,1648,3326,994405,207965,786440,713519849.0,148515531.0,565004317.0,4871,1575,3296,991501,209150,782351,711214189.0,149103328.0,562110861.0,0.7141,0.7184,0.7129,0.7185
2023-09-19 13:20,3422,2146,1276,513588,365901,147687,368660071.0,262162508.0,106497563.0,3268,2082,1186,505247,361593,143654,362152764.0,258556218.0,103596546.0,0.7165,0.7211,0.715,0.7212
2023-09-19 13:25,2083,884,1199,236322,150422,85900,170142321.0,108087962.0,62054359.0,1954,811,1143,231914,154215,77699,166576624.0,110383431.0,56193193.0,0.7186,0.7224,0.7158,0.7232
2023-09-19 13:30,6432,2582,3850,868163,337701,530462,625649740.0,242304916.0,383344824.0,6309,2510,3799,860437,332683,527754,620040967.0,238388158.0,381652809.0,0.7175,0.7227,0.7166,0.7232
2023-09-19 13:35,5288,2788,2500,794289,489124,305165,572545710.0,351635589.0,220910120.0,5157,2711,2446,788728,484086,304642,568301625.0,347743816.0,220557809.0,0.7189,0.7239,0.7184,0.724
2023-09-19 13:40,12142,8392,3750,2070927,1780067,290860,1494522539.0,1283462040.0,211060499.0,11993,8320,3673,2066899,1777682,289217,1491417349.0,1281437416.0,209979933.0,0.721,0.7256,0.7208,0.726
2023-09-19 13:45,5356,2569,2787,780913,491167,289746,565678014.0,355756184.0,209921830.0,5189,2494,2695,769742,487675,282067,556333718.0,351682807.0,204650910.0,0.7243,0.7245,0.7211,0.7255
2023-09-19 13:50,10133,3138,6995,1525155,481030,1044125,1104057596.0,346324326.0,757733270.0,10011,3064,6947,1513085,472554,1040531,1095401414.0,340058618.0,755342796.0,0.72,0.7257,0.7196,0.7259
2023-09-19 13:55,1347,417,930,221268,70646,150622,160376349.0,51066947.0,109309401.0,1304,403,901,212813,69403,143410,154297943.0,50078223.0,104219720.0,0.7229,0.7257,0.7216,0.7267
2023-09-19 14:00,12514,3241,9273,2199360,371456,1827904,1592921079.0,267690143.0,1325230935.0,12410,3177,9233,2194737,369895,1824842,1589733512.0,266561479.0,1323172032.0,0.7207,0.725,0.7206,0.7251
2023-09-19 14:05,8665,2447,6218,1663927,182224,1481703,1204224856.0,130979863.0,1073244993.0,8575,2386,6189,1658352,178984,1479368,1201414878.0,129729331.0,1071685546.0,0.7188,0.7243,0.7248,0.7244
2023-09-19 14:10,10090,5599,4491,1514803,468942,1045861,1096865778.0,339011473.0,757854305.0,10018,5557,4461,1516332,470690,1045642,1096512112.0,338801588.0,757710523.0,0.7229,0.7246,0.7198,0.7246
2023-09-19 14:15,11997,3603,8394,2304625,335485,1969140,1662628372.0,240857934.0,1421770438.0,11869,3538,8331,2290517,328078,1962439,1652682405.0,235346327.0,1417336078.0,0.7179,0.722,0.7173,0.7222
2023-09-19 14:20,6315,1505,4810,1737479,130727,1606752,1255738116.0,93688533.0,1162049583.0,6258,1499,4759,1735412,132334,1603078,1254354069.0,94801519.0,1159552550.0,0.7167,0.7232,0.7164,0.7233
2023-09-19 14:25,10170,4310,5860,1608467,458503,1149964,1158645444.0,328352937.0,830292507.0,10083,4266,5817,1606786,456902,1149884,1157247777.0,326836218.0,830411559.0,0.7161,0.722,0.7153,0.7222
2023-09-19 14:30,6422,3465,2957,942541,466655,475886,677588229.0,334193120.0,343395109.0,6347,3415,2932,936861,463393,473468,673418776.0,331702290.0,341716485.0,0.7161,0.7216,0.7158,0.7217
2023-09-19 14:35,3417,1434,1983,461429,161863,299566,332785778.0,116312673.0,216473104.0,3351,1395,1956,455655,157829,297826,328562589.0,113293636.0,215268952.0,0.7186,0.7226,0.7178,0.7228
2023-09-19 14:40,3606,1390,2216,505853,222455,283398,364030728.0,159096511.0,204934217.0,3501,1339,2162,500398,219973,280425,360219464.0,157252010.0,202967453.0,0.7152,0.7231,0.7149,0.7238
2023-09-19 14:45,3693,1803,1890,509597,310693,198904,367610098.0,223593804.0,144016293.0,3644,1777,1867,510945,309579,201366,368521992.0,222670837.0,145851154.0,0.7197,0.724,0.7193,0.7243
2023-09-19 14:50,5332,1835,3497,783428,337655,445773,565188257.0,242932894.0,322255362.0,5303,1820,3483,778996,336650,442346,562002908.0,242211865.0,319791043.0,0.7195,0.7229,0.7195,0.7229
2023-09-19 14:55,1513,893,620,304590,235501,69089,219412825.0,169412118.0,50000706.0,1459,871,588,300663,235312,65351,216384668.0,169093609.0,47291059.0,0.7194,0.7237,0.7186,0.7236
2023-09-19 15:00,924,575,349,196787,163983,32804,141800872.0,118070328.0,23730543.0,851,534,317,195244,163986,31258,140447197.0,117773493.0,22673704.0,0.72,0.7234,0.7182,0.7254
2023-09-19 15:05,1414,447,967,234830,117924,116906,169494795.0,84891998.0,84602797.0,1392,433,959,234324,118927,115397,169151077.0,85609564.0,83541513.0,0.7199,0.7237,0.7198,0.7239
2023-09-19 15:10,4080,1275,2805,753424,142862,610562,543612324.0,102678438.0,440933885.0,3981,1225,2756,748715,141366,607349,540300236.0,101538793.0,438761442.0,0.7187,0.7222,0.7183,0.7224
2023-09-19 15:15,1744,708,1036,238278,37050,201228,171793152.0,26666894.0,145126258.0,1667,662,1005,229849,35277,194572,165711293.0,25250264.0,140461029.0,0.7198,0.7212,0.7158,0.7219
2023-09-19 15:20,2087,1011,1076,327448,58899,268549,234033960.0,42107423.0,191926537.0,1927,904,1023,313482,51565,261917,225425845.0,37928598.0,187497247.0,0.7149,0.7147,0.7355,0.7159
2023-09-19 15:25,3343,1787,1556,440693,209308,231385,315913210.0,149909205.0,166004004.0,3163,1688,1475,421157,198718,222439,301472411.0,141798414.0,159673996.0,0.7162,0.7174,0.7136,0.7178
2023-09-19 15:30,3716,1552,2164,428891,145632,283259,306468025.0,103727417.0,202740607.0,3570,1484,2086,410722,138974,271748,293843500.0,98985756.0,194857743.0,0.7123,0.7157,0.7123,0.7171
2023-09-19 15:35,6494,3834,2660,1008082,569114,438968,719667407.0,404922118.0,314745288.0,6321,3726,2595,992986,559195,433791,708754622.0,397613845.0,311140777.0,0.7115,0.717,0.711,0.7173
2023-09-19 15:40,6996,3041,3955,998787,356398,642389,713916758.0,253547352.0,460369405.0,6891,2982,3909,992079,352328,639751,709109538.0,250620151.0,458489386.0,0.7114,0.7167,0.7113,0.7167
2023-09-19 15:45,9639,3811,5828,1507692,536264,971428,1078169429.0,381533738.0,696635690.0,9585,3777,5808,1506043,536753,969290,1076922950.0,381827892.0,695095057.0,0.7115,0.7171,0.7114,0.7171
2023-09-19 15:50,11265,2654,8611,2202211,248215,1953996,1572046207.0,177090137.0,1394956069.0,11101,2546,8555,2192422,241738,1950684,1564043857.0,171164701.0,1392879156.0,0.7135,0.7139,0.7081,0.714
2023-09-19 15:55,10183,6062,4121,1544322,718150,826172,1100414882.0,510088838.0,590326044.0,10057,6006,4051,1529095,708730,820365,1089623336.0,503399211.0,586224125.0,0.7103,0.7145,0.7103,0.7146
2023-09-19 16:00,8730,5458,3272,1292512,937925,354587,923543250.0,668952060.0,254591189.0,8632,5409,3223,1283186,932881,350305,916372392.0,664849201.0,251523190.0,0.7132,0.718,0.7127,0.718
2023-09-19 16:05,10728,5634,5094,1800072,1137059,663013,1284789722.0,810030736.0,474758986.0,10586,5551,5035,1788915,1132824,656091,1276970114.0,806890221.0,470079892.0,0.7124,0.7161,0.7123,0.7165
2023-09-19 16:10,5363,2001,3362,847423,224244,623179,605550752.0,159509424.0,446041327.0,5296,1969,3327,842538,221989,620549,602088448.0,157868208.0,444220240.0,0.7113,0.7158,0.7112,0.7159
2023-09-19 16:15,6058,2806,3252,992396,517182,475214,708667347.0,368333361.0,340333985.0,5963,2752,3211,982887,511035,471852,701728644.0,363759669.0,337968974.0,0.7122,0.7162,0.7118,0.7163
2023-09-19 16:20,5019,2780,2239,801681,620677,181004,572213527.0,442318009.0,129895518.0,4870,2675,2195,794541,618134,176407,567148458.0,440481051.0,126667407.0,0.7126,0.7176,0.7126,0.718
2023-09-19 16:25,13151,9797,3354,2274375,1974048,300327,1627408307.0,1411139608.0,216268698.0,12925,9662,3263,2256296,1963961,292335,1613223719.0,1402693899.0,210529820.0,0.7148,0.7201,0.7142,0.7202
2023-09-19 16:30,7346,4566,2780,1287404,1060770,226634,920778588.0,757839750.0,162938838.0,7171,4420,2751,1281681,1057486,224195,916645624.0,755401264.0,161244360.0,0.7144,0.719,0.7143,0.7192
2023-09-19 16:35,2496,1469,1027,407725,298517,109208,292173111.0,213412757.0,78760353.0,2403,1413,990,403856,295959,107897,289308549.0,211505072.0,77803477.0,0.7149,0.7212,0.7146,0.7211
2023-09-19 16:40,5850,3315,2535,907690,674418,233272,650824796.0,482910614.0,167914182.0,5719,3221,2498,900643,672203,228440,645979778.0,481295684.0,164684094.0,0.716,0.7198,0.716,0.7209
2023-09-19 16:45,3583,2297,1286,539255,384028,155227,387145294.0,275267826.0,111877468.0,3458,2192,1266,533318,380613,152705,382826723.0,272678714.0,110148009.0,0.7168,0.7207,0.7164,0.7213
2023-09-19 16:50,4614,2719,1895,534701,292084,242617,383255061.0,208835357.0,174419703.0,4527,2638,1889,525333,290370,234963,376739606.0,207566377.0,169173229.0,0.715,0.7189,0.7148,0.72
2023-09-19 16:55,3481,1195,2286,600163,56341,543822,429955527.0,40230522.0,389725005.0,3383,1149,2234,597120,57090,540030,427544759.0,40468789.0,387075970.0,0.7141,0.7166,0.7089,0.7168
2023-09-19 17:00,1116,468,648,141862,23570,118292,101798090.0,17014714.0,84783376.0,1052,425,627,135993,18548,117445,97469546.0,13243338.0,84226207.0,0.7219,0.7167,0.714,0.7172
2023-09-19 17:05,1219,804,415,142810,75426,67384,102347423.0,53960357.0,48387065.0,1176,771,405,141335,73736,67599,101284117.0,52741009.0,48543108.0,0.7154,0.7181,0.7153,0.7181
2023-09-19 17:10,1001,619,382,75909,50703,25206,54474761.0,36350202.0,18124558.0,910,540,370,77816,50007,27809,55800262.0,35805850.0,19994411.0,0.7169,0.7191,0.716,0.719
2023-09-19 17:15,2686,485,2201,304782,24246,280536,219399011.0,18536688.0,200862323.0,2645,451,2194,315159,35913,279246,226185290.0,25928754.0,200256536.0,0.7645,0.716,0.722,0.7171
2023-09-19 17:20,3115,409,2706,526577,46986,479591,377516549.0,33338250.0,344178299.0,3096,396,2700,511951,30099,481852,367502240.0,21477705.0,346024534.0,0.7095,0.7176,0.7136,0.7181
2023-09-19 17:25,5348,1328,4020,860033,99514,760519,616505668.0,71014605.0,545491062.0,5302,1308,3994,859079,101811,757268,615828113.0,72606011.0,543222102.0,0.7136,0.7173,0.7131,0.7173
2023-09-19 17:30,4727,1132,3595,806865,104720,702145,578114890.0,74674324.0,503440565.0,4703,1116,3587,803558,103477,700081,575717689.0,73734695.0,501982994.0,0.7131,0.717,0.7126,0.717
2023-09-19 17:35,3438,849,2589,776728,70435,706293,556398189.0,50139489.0,506258700.0,3414,839,2575,777891,72169,705722,557184577.0,51308712.0,505875865.0,0.7119,0.7168,0.711,0.7168
2023-09-19 17:40,3031,558,2473,644478,47134,597344,461052471.0,33495759.0,427556712.0,2937,503,2434,637930,41816,596114,456388055.0,29654425.0,426733629.0,0.7106,0.7158,0.7092,0.7159
2023-09-19 17:45,1238,449,789,208432,51568,156864,148694698.0,36622406.0,112072292.0,1185,418,767,207442,52975,154467,147880464.0,37447282.0,110433182.0,0.7102,0.7145,0.7069,0.7149
2023-09-19 17:50,2736,1638,1098,342420,222023,120397,244207781.0,158195292.0,86012489.0,2671,1599,1072,335300,217779,117521,238855306.0,154871531.0,83983775.0,0.7125,0.7144,0.7111,0.7146
2023-09-19 17:55,1962,1493,469,260905,220060,40845,185855448.0,156633096.0,29222352.0,1912,1467,445,258103,218567,39536,183912743.0,155549160.0,28363582.0,0.7118,0.7154,0.7117,0.7174
2023-09-19 18:00,1075,847,228,143850,125557,18293,102622279.0,89534352.0,13087926.0,1042,824,218,142376,124724,17652,101392737.0,88757786.0,12634950.0,0.7131,0.7155,0.7116,0.7158
2023-09-19 18:05,6658,4772,1886,989293,746437,242856,707507875.0,532643475.0,174864399.0,6589,4732,1857,981242,741085,240157,701702529.0,528792903.0,172909626.0,0.7136,0.72,0.7135,0.72
2023-09-19 18:10,5360,4099,1261,812025,685098,126927,580376149.0,488961925.0,91414224.0,5321,4075,1246,812019,686576,125443,580332859.0,489978141.0,90354718.0,0.7137,0.7202,0.7137,0.7203
2023-09-19 18:15,2192,1356,836,288692,210761,77931,206489007.0,150517939.0,55971067.0,2171,1342,829,288374,210800,77574,206306529.0,150526533.0,55779996.0,0.7142,0.7182,0.7141,0.7191
2023-09-19 18:20,759,484,275,84804,45837,38967,60555683.0,32688782.0,27866901.0,732,471,261,79811,43281,36530,57133290.0,30873460.0,26259829.0,0.7132,0.7151,0.7133,0.7189
2023-09-19 18:25,1119,724,395,185413,110608,74805,132385611.0,78782548.0,53603063.0,1089,705,384,184295,111075,73220,131644145.0,79107904.0,52536240.0,0.7123,0.7166,0.7122,0.7175
2023-09-19 18:30,774,436,338,103644,76393,27251,73995772.0,54520206.0,19475566.0,709,403,306,97863,72527,25336,69781617.0,51622606.0,18159011.0,0.7137,0.7147,0.7118,0.7167
2023-09-19 18:35,1120,492,628,136505,68376,68129,97562261.0,48776111.0,48786150.0,1090,478,612,133913,67062,66851,95715838.0,47750879.0,47964959.0,0.7134,0.7161,0.712,0.7175
2023-09-20 10:00,47310,11819,35491,5922017,1129097,4792920,4174666958.0,791635648.0,3383031309.0,46083,11006,35077,5820019,1073130,4746889,4101971060.0,750596334.0,3351374726.0,0.7011,0.7058,0.6994,0.706
2023-09-20 10:05,9642,3309,6333,1156945,272402,884543,806256487.0,189089729.0,617166758.0,8907,2900,6007,1105302,249325,855977,771115071.0,172316885.0,598798186.0,0.6942,0.6977,0.6911,0.6995
2023-09-20 10:10,39832,9410,30422,4877038,961959,3915079,3353106593.0,662153783.0,2690952810.0,38903,8846,30057,4797268,923301,3873967,3297572794.0,633869352.0,2663703441.0,0.6883,0.6873,0.6865,0.6876
2023-09-20 10:15,21096,13105,7991,2739764,1754989,984775,1885326800.0,1204348050.0,680978749.0,20523,12810,7713,2680754,1724092,956662,1844146751.0,1182809519.0,661337232.0,0.6862,0.6915,0.686,0.6913
2023-09-20 10:20,7118,2762,4356,1052771,281727,771044,724048245.0,193330660.0,530717584.0,6680,2510,4170,1023125,267593,755532,703054519.0,182889190.0,520165329.0,0.6862,0.6883,0.6835,0.6885
2023-09-20 10:25,8375,4098,4277,1362995,835723,527272,941330940.0,576294412.0,365036527.0,7899,3799,4100,1323882,812069,511813,914293528.0,559301959.0,354991569.0,0.6896,0.6923,0.6887,0.6936
2023-09-20 10:30,5031,2236,2795,713197,398920,314277,492023624.0,274286015.0,217737608.0,4790,2083,2707,697061,392797,304264,481009430.0,269939336.0,211070093.0,0.6876,0.6928,0.6872,0.6937
2023-09-20 10:35,11930,5940,5990,1967257,651886,1315371,1350442974.0,445534807.0,904908167.0,11506,5676,5830,1925674,637180,1288494,1323156275.0,434848666.0,888307609.0,0.6835,0.6879,0.6825,0.6894
2023-09-20 10:40,6929,3722,3207,1025258,516011,509247,702830672.0,354843041.0,347987631.0,6412,3405,3007,962530,479791,482739,660366336.0,329644539.0,330721797.0,0.6877,0.6833,0.6871,0.6851
2023-09-20 10:45,4011,2471,1540,707534,510094,197440,481230216.0,346445474.0,134784741.0,3674,2288,1386,670997,492655,178342,456107436.0,334048969.0,122058466.0,0.6792,0.6827,0.6781,0.6844
2023-09-20 10:50,14861,6771,8090,2327956,1036259,1291697,1567304637.0,696039460.0,871265177.0,14238,6406,7832,2255844,1004408,1251436,1519838498.0,673679853.0,846158644.0,0.6717,0.6745,0.6707,0.6762
2023-09-20 10:55,17448,9061,8387,2586312,1093241,1493071,1734891170.0,731555677.0,1003335492.0,16781,8646,8135,2523458,1059323,1464135,1691620988.0,706934990.0,984685998.0,0.6692,0.672,0.6673,0.6725
2023-09-20 11:00,9102,2629,6473,1465244,482413,982831,991586308.0,327662853.0,663923455.0,8715,2397,6318,1439848,470895,968953,974192215.0,319403058.0,654789156.0,0.6792,0.6755,0.6783,0.6758
2023-09-20 11:05,17974,5633,12341,3460849,562436,2898413,2331887129.0,377003196.0,1954883933.0,17665,5449,12216,3440862,553290,2887572,2318602675.0,370537913.0,1948064762.0,0.6703,0.6745,0.6697,0.6746
2023-09-20 11:10,11172,4833,6339,2122382,499624,1622758,1427079302.0,334095948.0,1092983354.0,10871,4624,6247,2105791,482854,1622937,1415828999.0,322484789.0,1093344210.0,0.6687,0.6735,0.6679,0.6737
2023-09-20 11:15,6960,1940,5020,1312750,134835,1177915,883571219.0,90350622.0,793220597.0,6595,1663,4932,1276656,121010,1155646,859452802.0,80762645.0,778690156.0,0.6701,0.6734,0.6674,0.6738
2023-09-20 11:20,6810,4303,2507,1221892,437212,784680,823368127.0,293188915.0,530179211.0,6463,4048,2415,1209481,430023,779458,814640280.0,287927576.0,526712703.0,0.6706,0.6757,0.6696,0.6757
2023-09-20 11:25,21174,8682,12492,4096816,855983,3240833,2764771572.0,574871459.0,2189900113.0,20656,8264,12392,4072849,842178,3230671,2748465695.0,565003814.0,2183461880.0,0.6716,0.6757,0.6709,0.6759
2023-09-20 11:30,17128,3623,13505,2998591,315520,2683071,2008897024.0,210604144.0,1798292880.0,16841,3426,13415,2967408,300764,2666644,1987721273.0,200246958.0,1787474314.0,0.6675,0.6702,0.6658,0.6703
2023-09-20 11:35,7338,3761,3577,1291513,617063,674450,866965978.0,411739927.0,455226050.0,7191,3677,3514,1285985,614366,671619,863285757.0,409822633.0,453463123.0,0.6673,0.675,0.6671,0.6752
2023-09-20 11:40,3606,1252,2354,594673,136585,458088,399104630.0,90993258.0,308111372.0,3467,1156,2311,582148,132815,449333,390477596.0,88478989.0,301998607.0,0.6662,0.6726,0.6662,0.6721
2023-09-20 11:45,4376,2879,1497,683689,522674,161015,460431630.0,349363293.0,111068337.0,4126,2711,1415,665447,509689,155758,446534817.0,340095564.0,106439253.0,0.6684,0.6898,0.6673,0.6834
2023-09-20 11:50,8231,5194,3037,1199365,878387,320978,816424079.0,596140656.0,220283423.0,7744,4932,2812,1138648,853436,285212,771130301.0,575478370.0,195651931.0,0.6787,0.6863,0.6743,0.686
2023-09-20 11:55,5649,2711,2938,789041,477189,311852,539723973.0,325889630.0,213834343.0,5185,2435,2750,748035,447019,301016,510070260.0,304128122.0,205942137.0,0.6829,0.6857,0.6803,0.6842
2023-09-20 12:00,5209,2296,2913,1046430,420114,626316,720016691.0,287383708.0,432632983.0,4836,2057,2779,1017677,403458,614219,701281634.0,276653421.0,424628212.0,0.6841,0.6908,0.6857,0.6913
2023-09-20 12:05,6404,2443,3961,1269418,250286,1019132,871724451.0,170936913.0,700787538.0,6068,2240,3828,1235046,227489,1007557,848326240.0,154996404.0,693329836.0,0.683,0.6876,0.6813,0.6881
2023-09-20 12:10,2890,1541,1349,431258,92317,338941,296997443.0,64228590.0,232768852.0,2657,1346,1311,426590,91473,335117,292416503.0,62189859.0,230226643.0,0.6957,0.6868,0.6799,0.687
2023-09-20 12:15,7549,4865,2684,1322739,858230,464509,911965882.0,590461932.0,321503949.0,7224,4715,2509,1295117,844040,451077,891281328.0,579049715.0,312231613.0,0.688,0.6921,0.686,0.6922
2023-09-20 12:20,9536,4864,4672,1524682,914511,610171,1051996797.0,629026331.0,422970466.0,9243,4702,4541,1495645,898149,597496,1031811190.0,617383982.0,414427208.0,0.6878,0.6932,0.6874,0.6936
2023-09-20 12:25,10579,4406,6173,1721529,799768,921761,1188419970.0,550296269.0,638123700.0,10226,4200,6026,1689003,785940,903063,1165845428.0,540330310.0,625515118.0,0.6881,0.6923,0.6875,0.6927
2023-09-20 12:30,10475,3922,6553,1686516,350128,1336388,1163234427.0,240484055.0,922750372.0,10169,3735,6434,1662857,343135,1319722,1146879395.0,235619320.0,911260075.0,0.6868,0.6905,0.6867,0.6905
2023-09-20 12:35,6241,2453,3788,1160180,322065,838115,799605152.0,220006988.0,579598164.0,6141,2395,3746,1144768,310601,834167,789490286.0,212275339.0,577214946.0,0.6831,0.6915,0.6834,0.692
2023-09-20 12:40,4646,2562,2084,860214,507173,353041,592353059.0,347525535.0,244827524.0,4488,2453,2035,851830,503536,348294,586292851.0,344654946.0,241637905.0,0.6852,0.6935,0.6845,0.6938
2023-09-20 12:45,5659,2835,2824,857070,362206,494864,590916645.0,248404310.0,342512334.0,5528,2766,2762,841368,355149,486219,580049452.0,243459771.0,336589680.0,0.6858,0.6921,0.6855,0.6923
2023-09-20 12:50,6103,4087,2016,1069071,806338,262733,738330628.0,555834895.0,182495733.0,5908,3990,1918,1049899,809339,240560,724274527.0,557200435.0,167074091.0,0.6893,0.6946,0.6885,0.6945
2023-09-20 12:55,3815,1685,2130,652240,427728,224512,451727939.0,295828973.0,155898966.0,3586,1567,2019,623483,409039,214444,431569520.0,282417347.0,149152172.0,0.6916,0.6944,0.6904,0.6955
2023-09-20 13:00,4942,2925,2017,1020428,799802,220626,710765595.0,554764340.0,156001255.0,4683,2751,1932,988702,779529,209173,686393439.0,538815838.0,147577601.0,0.6936,0.7071,0.6912,0.7055
2023-09-20 13:05,5233,2811,2422,953748,595526,358222,660278012.0,411091688.0,249186324.0,4969,2638,2331,900826,564551,336275,625569543.0,390717185.0,234852357.0,0.6903,0.6956,0.6921,0.6984
2023-09-20 13:10,1150,760,390,140645,66280,74365,97379518.0,45864442.0,51515076.0,1035,694,341,131945,61970,69975,91051316.0,42551132.0,48500184.0,0.692,0.6927,0.6866,0.6931
2023-09-20 13:15,4241,1656,2585,768533,125901,642632,529959138.0,86373363.0,443585775.0,4060,1539,2521,751845,116965,634880,518882346.0,80176152.0,438706193.0,0.686,0.6903,0.6855,0.691
2023-09-20 13:20,2573,1003,1570,492526,63676,428850,343548910.0,47649357.0,295899552.0,2432,930,1502,490117,64740,425377,342702902.0,49113880.0,293589022.0,0.7483,0.69,0.7586,0.6902
2023-09-20 13:25,8797,5869,2928,1449792,1057830,391962,995518522.0,725438018.0,270080504.0,8556,5765,2791,1420804,1040608,380196,974184032.0,712023104.0,262160927.0,0.6858,0.689,0.6842,0.6895
2023-09-20 13:30,10929,8714,2215,2263481,2043380,220101,1551683524.0,1399677221.0,152006303.0,10819,8663,2156,2250326,2038114,212212,1542461049.0,1395826955.0,146634094.0,0.685,0.6906,0.6849,0.691
2023-09-20 13:35,5163,3247,1916,1149175,807050,342125,788804241.0,553010256.0,235793984.0,5088,3197,1891,1143662,802581,341081,783961659.0,548813959.0,235147700.0,0.6852,0.6892,0.6838,0.6894
2023-09-20 13:40,6680,4758,1922,1395234,1157681,237553,956607600.0,792845307.0,163762292.0,6576,4714,1862,1387823,1153731,234092,951512464.0,790059977.0,161452486.0,0.6849,0.6894,0.6848,0.6897
2023-09-20 13:45,5598,3654,1944,833696,614292,219404,571909016.0,420765947.0,151143069.0,5530,3621,1909,834064,615581,218483,572161197.0,421601321.0,150559876.0,0.685,0.6889,0.6849,0.6891
2023-09-20 13:50,6918,2207,4711,1222440,376801,845639,839520201.0,257757639.0,581762561.0,6846,2167,4679,1218971,374861,844110,837203575.0,256376944.0,580826631.0,0.6841,0.688,0.6839,0.6881
2023-09-20 13:55,5621,2003,3618,1072748,354391,718357,736599450.0,242320318.0,494279132.0,5571,1974,3597,1064670,347598,717072,731220511.0,237681489.0,493539022.0,0.6838,0.6881,0.6838,0.6883
2023-09-20 14:00,3770,957,2813,711240,120313,590927,488773414.0,82174712.0,406598702.0,3698,915,2783,708253,118194,590059,486799795.0,80768292.0,406031503.0,0.683,0.6881,0.6834,0.6881
2023-09-20 14:05,4854,1157,3697,1045792,153722,892070,718862142.0,105090672.0,613771470.0,4782,1111,3671,1037103,150927,886176,714005823.0,104085686.0,609920137.0,0.6836,0.688,0.6896,0.6883
2023-09-20 14:10,12004,5173,6831,2434342,684820,1749522,1671801391.0,468213610.0,1203587781.0,11884,5104,6780,2423238,678990,1744248,1664269078.0,464080716.0,1200188361.0,0.6837,0.688,0.6835,0.6881
2023-09-20 14:15,3345,1713,1632,656296,224575,431721,451046668.0,153663126.0,297383542.0,3274,1667,1607,652382,222298,430084,448232816.0,151919767.0,296313048.0,0.6842,0.6888,0.6834,0.689
2023-09-20 14:20,3560,2385,1175,609471,371527,237944,418716472.0,254582884.0,164133588.0,3453,2327,1126,600514,366648,233866,412393300.0,251012823.0,161380477.0,0.6852,0.6898,0.6846,0.6901
2023-09-20 14:25,4805,2940,1865,828227,595602,232625,568489224.0,408019321.0,160469903.0,4676,2859,1817,821161,592338,228823,563588158.0,405655233.0,157932925.0,0.6851,0.6898,0.6848,0.6902
2023-09-20 14:30,4203,2118,2085,690473,408622,281851,474651267.0,280229782.0,194421484.0,4145,2088,2057,687271,407411,279860,472451062.0,279360997.0,193090065.0,0.6858,0.6898,0.6857,0.69
2023-09-20 14:35,3419,2138,1281,524773,383666,141107,360612061.0,263257055.0,97355006.0,3347,2098,1249,521478,380384,141094,358194727.0,260856334.0,97338393.0,0.6862,0.6899,0.6858,0.6899
2023-09-20 14:40,7927,4613,3314,1453907,1062653,391254,1006715057.0,734830153.0,271884904.0,7702,4493,3209,1426486,1050012,376474,986441684.0,724729091.0,261712593.0,0.6915,0.6949,0.6902,0.6952
2023-09-20 14:45,4512,3239,1273,912708,809659,103049,631058429.0,559501017.0,71557412.0,4352,3145,1207,903157,803173,99984,624398192.0,554828132.0,69570059.0,0.691,0.6944,0.6908,0.6958
2023-09-20 14:50,2781,1572,1209,479168,342829,136339,331476091.0,236757950.0,94718141.0,2676,1508,1168,469140,339342,129798,324421423.0,234214760.0,90206663.0,0.6906,0.6947,0.6902,0.695
2023-09-20 14:55,4555,1489,3066,778290,194047,584243,537800133.0,133652959.0,404147174.0,4407,1381,3026,756463,179829,576634,522809586.0,123819502.0,398990083.0,0.6888,0.6917,0.6885,0.6919
2023-09-20 15:00,3627,1191,2436,637448,71324,566124,441026352.0,49351062.0,391675290.0,3550,1150,2400,633335,68225,565110,437938603.0,46960740.0,390977863.0,0.6919,0.6919,0.6883,0.6919
2023-09-20 15:05,2099,932,1167,305254,117921,187333,210602325.0,80952140.0,129650185.0,2031,891,1140,298571,112915,185656,206142154.0,77579644.0,128562509.0,0.6865,0.6921,0.6871,0.6925
2023-09-20 15:10,4085,1832,2253,815214,244045,571169,562682323.0,167934764.0,394747558.0,3963,1743,2220,807584,241951,565633,557302538.0,166212835.0,391089702.0,0.6881,0.6911,0.687,0.6914
2023-09-20 15:15,1057,298,759,251163,28567,222596,172700541.0,18933808.0,153766732.0,1033,284,749,250515,27849,222666,172364251.0,18537950.0,153826301.0,0.6628,0.6908,0.6657,0.6908
2023-09-20 15:20,1812,673,1139,371935,32652,339283,257201147.0,22557719.0,234643427.0,1771,643,1128,373037,34263,338774,257724050.0,23435152.0,234288898.0,0.6909,0.6916,0.684,0.6916
2023-09-20 15:25,1542,553,989,281312,54399,226913,194729905.0,37588462.0,157141442.0,1502,523,979,279488,53436,226052,193350676.0,36800930.0,156549746.0,0.691,0.6925,0.6887,0.6925
2023-09-20 15:30,1488,929,559,205289,94556,110733,142238228.0,65373910.0,76864317.0,1412,888,524,200295,90991,109304,138637891.0,62713873.0,75924018.0,0.6914,0.6941,0.6892,0.6946
2023-09-20 15:35,1116,676,440,118839,81173,37666,82323685.0,56180003.0,26143682.0,1023,642,381,115715,79311,36404,80000669.0,54726709.0,25273959.0,0.6921,0.6941,0.69,0.6943
2023-09-20 15:40,2012,950,1062,311913,186823,125090,215580801.0,128793710.0,86787091.0,1977,936,1041,313844,188640,125204,216907440.0,130004820.0,86902620.0,0.6894,0.6938,0.6892,0.6941
2023-09-20 15:45,1856,917,939,338919,224441,114478,233619773.0,154319070.0,79300702.0,1771,876,895,333826,222298,111528,230144241.0,152859423.0,77284818.0,0.6876,0.6927,0.6876,0.693
2023-09-20 15:50,1518,808,710,173679,65465,108214,120006899.0,45123215.0,74883683.0,1455,764,691,172210,64253,107957,118997458.0,44248376.0,74749082.0,0.6893,0.692,0.6887,0.6924
2023-09-20 15:55,2709,863,1846,384330,102874,281456,265674888.0,70863135.0,194811753.0,2680,843,1837,382904,102019,280885,264677825.0,70266418.0,194411407.0,0.6888,0.6922,0.6888,0.6921
2023-09-20 16:00,2060,873,1187,397904,170667,227237,274800856.0,117435593.0,157365262.0,2012,841,1171,395651,169390,226261,273283244.0,116555674.0,156727569.0,0.6881,0.6925,0.6881,0.6927
2023-09-20 16:05,1597,477,1120,293644,111006,182638,203274960.0,76466661.0,126808299.0,1568,460,1108,290437,110676,179761,200847384.0,76229702.0,124617682.0,0.6889,0.6943,0.6888,0.6932
2023-09-20 16:10,1205,500,705,159508,89132,70376,111357581.0,62550536.0,48807044.0,1156,468,688,156217,86636,69581,109229852.0,60962245.0,48267606.0,0.7018,0.6935,0.7037,0.6937
2023-09-20 16:15,1476,1097,379,259900,233837,26063,179911292.0,161809567.0,18101725.0,1378,1039,339,254833,231021,23812,176204936.0,159628970.0,16575965.0,0.692,0.6945,0.691,0.6961
2023-09-20 16:20,2150,906,1244,312958,138027,174931,217219887.0,95767222.0,121452665.0,2050,844,1206,303796,132171,171625,210714338.0,91445476.0,119268862.0,0.6938,0.6943,0.6919,0.6949
2023-09-20 16:25,728,431,297,51254,29231,22023,35630149.0,20357490.0,15272659.0,640,381,259,40685,25434,15251,28249198.0,17603758.0,10645440.0,0.6964,0.6935,0.6921,0.698
2023-09-20 16:30,750,466,284,65985,42941,23044,46147231.0,30114938.0,16032293.0,649,415,234,59709,40313,19396,41594372.0,28029753.0,13564619.0,0.7013,0.6957,0.6953,0.6994
2023-09-20 16:35,3829,2287,1542,636563,463120,173443,448393156.0,324644706.0,123748449.0,3603,2156,1447,615654,449263,166391,432534117.0,314469733.0,118064384.0,0.701,0.7135,0.7,0.7096
2023-09-20 16:40,3454,1573,1881,503029,229217,273812,353982010.0,162290831.0,191691179.0,3219,1442,1777,474495,216706,257789,332951645.0,152145785.0,180805860.0,0.708,0.7001,0.7021,0.7014
2023-09-20 16:45,2788,1500,1288,385538,240165,145373,270570183.0,167627838.0,102942345.0,2697,1443,1254,381246,235484,145762,268388227.0,165106515.0,103281712.0,0.698,0.7081,0.7011,0.7086
2023-09-20 16:50,4032,1353,2679,778210,134955,643255,547074952.0,93856399.0,453218552.0,3972,1326,2646,775407,136148,639259,545150720.0,94575213.0,450575506.0,0.6955,0.7046,0.6947,0.7048
2023-09-20 16:55,3017,916,2101,611704,80367,531337,430637106.0,55844102.0,374793004.0,2960,877,2083,608797,77288,531509,428544834.0,53706170.0,374838664.0,0.6949,0.7054,0.6949,0.7052
2023-09-20 17:00,1879,748,1131,344991,61224,283767,240965086.0,42586840.0,198378246.0,1845,731,1114,341633,61499,280134,238620110.0,42650387.0,195969722.0,0.6956,0.6991,0.6935,0.6996
2023-09-20 17:05,819,438,381,141234,41187,100047,99899061.0,28779856.0,71119205.0,763,403,360,137536,39789,97747,97146663.0,27622924.0,69523739.0,0.6988,0.7109,0.6942,0.7113
2023-09-20 17:10,1122,635,487,167446,68847,98599,120533433.0,47682312.0,72851121.0,1026,573,453,158328,63203,95125,114361878.0,43748211.0,70613666.0,0.6926,0.7389,0.6922,0.7423
2023-09-20 17:15,2242,789,1453,316708,81956,234752,221290882.0,56372281.0,164918600.0,2080,702,1378,288585,63959,224626,204003845.0,44990754.0,159013091.0,0.6878,0.7025,0.7034,0.7079
2023-09-20 17:20,2529,1575,954,311995,168907,143088,217149936.0,117684797.0,99465139.0,2383,1491,892,294394,159378,135016,203859015.0,109925736.0,93933279.0,0.6967,0.6951,0.6897,0.6957
2023-09-20 17:25,1711,665,1046,310171,50531,259640,215529454.0,35019622.0,180509832.0,1655,635,1020,306602,48401,258201,212947080.0,33416354.0,179530726.0,0.693,0.6952,0.6904,0.6953
2023-09-20 17:30,2711,540,2171,529610,51794,477816,367594493.0,35705538.0,331888954.0,2663,525,2138,528521,51419,477102,367026271.0,35401756.0,331624515.0,0.6894,0.6946,0.6885,0.6951
2023-09-20 17:35,2406,628,1778,539918,57536,482382,373957688.0,39732467.0,334225220.0,2354,612,1742,534159,55995,478164,369961123.0,38537406.0,331423716.0,0.6906,0.6929,0.6882,0.6931
2023-09-20 17:40,5070,2536,2534,1056953,311999,744954,730487108.0,214900411.0,515586697.0,5000,2493,2507,1049995,308249,741746,725541247.0,212124738.0,513416508.0,0.6888,0.6921,0.6882,0.6922
2023-09-20 17:45,5229,1798,3431,1211953,142968,1068985,836913064.0,98340198.0,738572865.0,5065,1691,3374,1196325,136981,1059344,826069735.0,93826329.0,732243405.0,0.6878,0.6909,0.685,0.6912
2023-09-20 17:50,507,270,237,37948,15072,22876,26132238.0,10371153.0,15761085.0,432,236,196,33905,14556,19349,23315761.0,9975480.0,13340281.0,0.6881,0.689,0.6853,0.6895
2023-09-20 17:55,1480,376,1104,294824,29760,265064,203643457.0,21288919.0,182354538.0,1447,360,1087,296701,30221,266480,206002853.0,22604728.0,183398125.0,0.7154,0.688,0.748,0.6882
2023-09-20 18:00,10635,2214,8421,2563064,161109,2401955,1768003893.0,110112400.0,1657891493.0,10563,2166,8397,2564398,158229,2406169,1763807405.0,108087540.0,1655719865.0,0.6835,0.6902,0.6831,0.6881
2023-09-20 18:05,5486,2383,3103,1216942,484578,732364,834741224.0,331407271.0,503333953.0,5373,2325,3048,1212818,485445,727373,831864711.0,331761188.0,500103523.0,0.6839,0.6873,0.6834,0.6875
2023-09-20 18:10,1866,1168,698,449995,364534,85461,308202554.0,249336747.0,58865806.0,1836,1153,683,447944,364356,83588,306785398.0,249209063.0,57576335.0,0.684,0.6888,0.684,0.6888
2023-09-20 18:15,1352,985,367,395256,339162,56094,276397904.0,232390160.0,44007744.0,1320,966,354,390136,336174,53962,272404507.0,229825371.0,42579135.0,0.6852,0.7845,0.6837,0.7891
2023-09-20 18:20,1976,1336,640,480240,413877,66363,328550280.0,282966082.0,45584198.0,1950,1326,624,478923,413464,65459,327695094.0,282673004.0,45022089.0,0.6837,0.6869,0.6837,0.6878
2023-09-20 18:25,760,512,248,154593,120788,33805,106349133.0,83055770.0,23293362.0,726,489,237,150985,118471,32514,103375774.0,80972569.0,22403205.0,0.6876,0.6891,0.6835,0.689
2023-09-20 18:30,1597,1169,428,361835,315528,46307,247766708.0,215923258.0,31843449.0,1575,1157,418,357239,314421,42818,249927475.0,215022346.0,34905128.0,0.6843,0.6877,0.6839,0.8152
2023-09-20 18:35,5953,5174,779,895138,844392,50746,612306393.0,577494185.0,34812207.0,5928,5157,771,896471,845106,51365,613212949.0,577912365.0,35300583.0,0.6839,0.686,0.6838,0.6872
2023-09-21 10:00,55246,13038,42208,8695291,1254297,7440994,5930146660.0,850644082.0,5079502577.0,54501,12597,41904,8640997,1227166,7413831,5892536672.0,830944736.0,5061591935.0,0.6782,0.6826,0.6771,0.6827
2023-09-21 10:05,5400,2048,3352,746252,212608,533644,510977586.0,144805871.0,366171714.0,5035,1849,3186,718532,197342,521190,491788477.0,133914355.0,357874121.0,0.6811,0.6862,0.6786,0.6866
2023-09-21 10:10,2099,964,1135,163910,77652,86258,112035882.0,53000308.0,59035574.0,1828,824,1004,141626,68158,73468,96826461.0,46459771.0,50366690.0,0.6825,0.6844,0.6816,0.6856
2023-09-21 10:15,1184,487,697,115395,42337,73058,78618504.0,28769294.0,49849210.0,1101,428,673,109037,39017,70020,74399059.0,26471739.0,47927320.0,0.6795,0.6823,0.6785,0.6845
2023-09-21 10:20,1698,1067,631,279862,228852,51010,190599023.0,155715225.0,34883798.0,1612,1017,595,277384,227805,49579,188930007.0,154979894.0,33950113.0,0.6804,0.6839,0.6803,0.6848
2023-09-21 10:25,3655,1417,2238,466915,168617,298298,317459370.0,114207726.0,203251643.0,3339,1170,2169,455688,162828,292860,310216982.0,110229955.0,199987026.0,0.6773,0.6814,0.677,0.6829
2023-09-21 10:30,1717,987,730,114688,52758,61930,79219639.0,36940028.0,42279610.0,1243,555,688,90549,30772,59777,61724755.0,20846509.0,40878246.0,0.7002,0.6827,0.6775,0.6838
2023-09-21 10:35,3796,1426,2370,567494,132370,435124,388266780.0,90841438.0,297425341.0,3445,1180,2265,541596,123399,418197,371447598.0,85464096.0,285983501.0,0.6863,0.6835,0.6926,0.6838
2023-09-21 10:40,4019,895,3124,819620,107915,711705,559121403.0,73502806.0,485618597.0,3805,764,3041,803021,103544,699477,547929797.0,70412673.0,477517124.0,0.6811,0.6823,0.68,0.6827
2023-09-21 10:45,3332,1009,2323,635785,161093,474692,433846637.0,109675656.0,324170981.0,3142,884,2258,622256,153164,469092,424577201.0,104199601.0,320377599.0,0.6808,0.6829,0.6803,0.683
2023-09-21 10:50,2625,1114,1511,490133,157934,332199,334698895.0,107798234.0,226900660.0,2452,986,1466,480710,150822,329888,328309715.0,102680702.0,225629012.0,0.6826,0.683,0.6808,0.684
2023-09-21 10:55,4281,3141,1140,755626,561258,194368,518358442.0,384847881.0,133510561.0,4082,3021,1061,740962,553440,187522,506849022.0,377964365.0,128884657.0,0.6857,0.6869,0.6829,0.6873
2023-09-21 11:00,2736,1598,1138,442129,217652,224477,302812594.0,148821821.0,153990772.0,2605,1503,1102,434221,214939,219282,297463346.0,146856337.0,150607009.0,0.6838,0.686,0.6832,0.6868
2023-09-21 11:05,2594,694,1900,521512,79527,441985,357666842.0,54156288.0,303510554.0,2462,616,1846,511724,74747,436977,350888917.0,50988562.0,299900355.0,0.681,0.6867,0.6821,0.6863
2023-09-21 11:10,2552,665,1887,561691,65448,496243,385108964.0,44661380.0,340447584.0,2436,582,1854,557757,64199,493558,382493620.0,43807430.0,338686190.0,0.6824,0.6861,0.6824,0.6862
2023-09-21 11:15,2125,583,1542,589290,63313,525977,403952295.0,43181973.0,360770322.0,2060,527,1533,587617,62740,524877,402704840.0,42748507.0,359956333.0,0.682,0.6859,0.6814,0.6858
2023-09-21 11:20,2449,1212,1237,452567,189181,263386,310063956.0,129196930.0,180867026.0,2289,1110,1179,448665,186418,262247,307318122.0,127254148.0,180063974.0,0.6829,0.6867,0.6826,0.6866
2023-09-21 11:25,2140,433,1707,437757,33775,403982,299781207.0,23015370.0,276765837.0,2049,367,1682,428907,32563,396344,293861992.0,22121515.0,271740477.0,0.6814,0.6851,0.6793,0.6856
2023-09-21 11:30,1518,393,1125,315205,26738,288467,215706292.0,18246009.0,197460283.0,1382,335,1047,316793,25086,291707,217733161.0,18018647.0,199714513.0,0.6824,0.6845,0.7183,0.6846
2023-09-21 11:35,4025,2149,1876,1015453,611621,403832,692987789.0,416708507.0,276279282.0,3905,2074,1831,1001315,605658,395657,683126877.0,412391085.0,270735791.0,0.6813,0.6841,0.6809,0.6843
2023-09-21 11:40,2124,1308,816,450326,318491,131835,308200663.0,217934604.0,90266059.0,2059,1268,791,445713,316555,129158,304227848.0,215605336.0,88622511.0,0.6843,0.6847,0.6811,0.6862
2023-09-21 11:45,1733,995,738,281510,178227,103283,192348653.0,121501721.0,70846931.0,1680,961,719,278044,175236,102808,189954268.0,119397587.0,70556680.0,0.6817,0.6859,0.6814,0.6863
2023-09-21 11:50,3248,1989,1259,613262,440062,173200,424013464.0,303728387.0,120285077.0,2953,1816,1137,550934,405395,145539,379991314.0,279323796.0,100667517.0,0.6902,0.6945,0.689,0.6917
2023-09-21 11:55,5592,2916,2676,1062773,492299,570474,737803754.0,340187120.0,397616634.0,5247,2742,2505,1023486,464482,559004,709832667.0,320519089.0,389313577.0,0.691,0.697,0.6901,0.6964
2023-09-21 12:00,3323,1459,1864,694868,214331,480537,485665774.0,148026777.0,337638996.0,3178,1382,1796,680161,202469,477692,474854169.0,139710735.0,335143434.0,0.6906,0.7026,0.69,0.7016
2023-09-21 12:05,1600,561,1039,296458,50424,246034,206909951.0,35326690.0,171583261.0,1486,505,981,289162,48151,241011,201972052.0,33195563.0,168776489.0,0.7006,0.6974,0.6894,0.7003
2023-09-21 12:10,2700,490,2210,507155,40887,466268,352560032.0,28133089.0,324426942.0,2647,464,2183,504252,42892,461360,350492762.0,29315009.0,321177752.0,0.6881,0.6958,0.6835,0.6962
2023-09-21 12:15,1684,911,773,291198,111092,180106,202522410.0,76997044.0,125525365.0,1465,771,694,277819,98946,178873,192998652.0,68289484.0,124709168.0,0.6931,0.697,0.6902,0.6972
2023-09-21 12:20,2063,1073,990,268756,104934,163822,186780180.0,72752922.0,114027258.0,1857,960,897,255465,97844,157621,177565375.0,67596399.0,109968976.0,0.6933,0.696,0.6909,0.6977
2023-09-21 12:25,2768,1937,831,502318,324282,178036,348408763.0,224260694.0,124148069.0,2613,1849,764,492617,317858,174759,341619125.0,219655914.0,121963211.0,0.6916,0.6973,0.6911,0.6979
2023-09-21 12:30,4108,2581,1527,681988,409229,272759,476119079.0,285299683.0,190819395.0,3677,2357,1320,642631,384446,258185,448492490.0,267324187.0,181168302.0,0.6972,0.6996,0.6953,0.7017
2023-09-21 12:35,2342,1140,1202,368118,166242,201876,256897885.0,115591998.0,141305887.0,2065,1040,1025,358045,161044,197001,249807751.0,111698763.0,138108987.0,0.6953,0.7,0.6936,0.7011
2023-09-21 12:40,2747,1382,1365,450060,239917,210143,313928134.0,166958113.0,146970021.0,2562,1286,1276,442984,239564,203420,308593063.0,166240483.0,142352580.0,0.6959,0.6994,0.6939,0.6998
2023-09-21 12:45,2102,1367,735,253970,203663,50307,178005969.0,142659887.0,35346081.0,1872,1236,636,236782,193959,42823,165576711.0,135458768.0,30117943.0,0.7005,0.7026,0.6984,0.7033
2023-09-21 12:50,2592,1518,1074,332440,267391,65049,233896294.0,188115947.0,45780346.0,2133,1343,790,296572,245878,50694,208458890.0,172599197.0,35859692.0,0.7035,0.7038,0.702,0.7074
2023-09-21 12:55,1681,687,994,166337,62697,103640,116573980.0,43977798.0,72596181.0,1396,535,861,152165,53550,98615,107381578.0,37609207.0,69772371.0,0.7014,0.7005,0.7023,0.7075
2023-09-21 13:00,1529,642,887,181753,103322,78431,127695815.0,72454170.0,55241644.0,1423,600,823,175335,101520,73815,123286851.0,71166872.0,52119978.0,0.7012,0.7043,0.701,0.7061
2023-09-21 13:05,2635,1151,1484,372720,198288,174432,261196597.0,139186609.0,122009988.0,2340,992,1348,354904,188729,166175,249149844.0,132219615.0,116930229.0,0.7019,0.6995,0.7006,0.7037
2023-09-21 13:10,2778,1674,1104,522180,363069,159111,366337869.0,254097410.0,112240459.0,2666,1605,1061,513839,359069,154770,361578456.0,252388984.0,109189471.0,0.6999,0.7054,0.7029,0.7055
2023-09-21 13:15,4832,1850,2982,905767,464386,441381,635813936.0,325249634.0,310564301.0,4675,1760,2915,895893,460799,435094,629208451.0,322687829.0,306520622.0,0.7004,0.7036,0.7003,0.7045
2023-09-21 13:20,741,261,480,115397,40558,74839,80898631.0,28220220.0,52678410.0,651,212,439,107802,33039,74763,75840105.0,23158513.0,52681592.0,0.6958,0.7039,0.7009,0.7046
2023-09-21 13:25,713,369,344,77280,27475,49805,54307546.0,19361566.0,34945980.0,651,335,316,72699,26298,46401,51050639.0,18411073.0,32639566.0,0.7047,0.7017,0.7001,0.7034
2023-09-21 13:30,929,426,503,100011,59140,40871,70686296.0,41722448.0,28963848.0,850,373,477,95080,55992,39088,66869605.0,39235430.0,27634175.0,0.7055,0.7087,0.7007,0.707
2023-09-21 13:35,1588,813,775,213287,116523,96764,150300598.0,81967644.0,68332954.0,1517,774,743,207698,115024,92674,146245314.0,80809354.0,65435960.0,0.7034,0.7062,0.7025,0.7061
2023-09-21 13:40,525,238,287,48599,16427,32172,34073592.0,11504161.0,22569431.0,454,203,251,42409,14969,27440,29797910.0,10468389.0,19329520.0,0.7003,0.7015,0.6993,0.7044
2023-09-21 13:45,2455,718,1737,369111,57375,311736,258726153.0,40097690.0,218628462.0,2328,646,1682,361335,50841,310494,253765803.0,35532531.0,218233271.0,0.6989,0.7013,0.6989,0.7029
2023-09-21 13:50,3143,883,2260,535983,124776,411207,375731277.0,86799010.0,288932267.0,3079,850,2229,524334,114563,409771,367993073.0,80045115.0,287947958.0,0.6956,0.7026,0.6987,0.7027
2023-09-21 13:55,3412,1561,1851,482273,240917,241356,337887237.0,168437322.0,169449915.0,3362,1529,1833,485033,243117,241916,339595095.0,169607148.0,169987947.0,0.6992,0.7021,0.6976,0.7027
2023-09-21 14:00,1967,945,1022,333043,140680,192363,233382182.0,98370397.0,135011785.0,1901,905,996,330070,139336,190734,232318065.0,98390635.0,133927430.0,0.6992,0.7019,0.7061,0.7022
2023-09-21 14:05,1404,459,945,220464,123601,96863,154036409.0,86213929.0,67822479.0,1338,417,921,217350,121052,96298,151990779.0,84395978.0,67594800.0,0.6975,0.7002,0.6972,0.7019
2023-09-21 14:10,1668,606,1062,344059,62986,281073,241315543.0,43988217.0,197327326.0,1600,568,1032,340663,60372,280291,239059934.0,42100556.0,196959377.0,0.6984,0.7021,0.6974,0.7027
2023-09-21 14:15,1334,640,694,209959,47425,162534,147405617.0,33179114.0,114226502.0,1261,596,665,208737,47948,160789,146435102.0,33396361.0,113038741.0,0.6996,0.7028,0.6965,0.703
2023-09-21 14:20,2541,1066,1475,636337,119031,517306,447128481.0,83168229.0,363960252.0,2500,1041,1459,632793,116570,516223,444537674.0,81302446.0,363235228.0,0.6987,0.7036,0.6975,0.7036
2023-09-21 14:25,1653,745,908,311029,116201,194828,218295129.0,81250211.0,137044917.0,1610,723,887,316322,123197,193125,221835328.0,85946375.0,135888952.0,0.6992,0.7034,0.6976,0.7036
2023-09-21 14:30,2029,1035,994,373664,196031,177633,261668711.0,137024827.0,124643884.0,1949,978,971,373703,197795,175908,261644780.0,138086787.0,123557993.0,0.699,0.7017,0.6981,0.7024
2023-09-21 14:35,2110,899,1211,392709,202851,189858,275182924.0,141664392.0,133518532.0,2057,869,1188,389684,201136,188548,273173339.0,140451278.0,132722061.0,0.6984,0.7033,0.6983,0.7039
2023-09-21 14:40,5384,1543,3841,1373711,222999,1150712,965458897.0,155755828.0,809703068.0,5268,1482,3786,1365910,219888,1146022,960262076.0,153521375.0,806740700.0,0.6985,0.7037,0.6982,0.7039
2023-09-21 14:45,3991,856,3135,1088956,59978,1028978,761627499.0,41688276.0,719939223.0,3672,665,3007,1056015,43944,1012071,739193083.0,30413411.0,708779672.0,0.6951,0.6997,0.6921,0.7003
2023-09-21 14:50,7734,1032,6702,2983413,69870,2913543,2086443444.0,48483851.0,2037959593.0,7613,962,6651,2976442,67240,2909202,2081719122.0,46522205.0,2035196917.0,0.6939,0.6995,0.6919,0.6996
2023-09-21 14:55,5460,1550,3910,1362417,98627,1263790,950586584.0,68344640.0,882241944.0,5345,1473,3872,1357280,95954,1261326,947004759.0,66373531.0,880631228.0,0.693,0.6981,0.6917,0.6982
2023-09-21 15:00,3312,1657,1655,622890,441748,181142,432675566.0,306469819.0,126205746.0,3186,1603,1583,609673,436703,172970,423274861.0,302572283.0,120702578.0,0.6938,0.6967,0.6929,0.6978
2023-09-21 15:05,3781,1230,2551,727427,185193,542234,506288336.0,128303784.0,377984551.0,3654,1171,2483,718086,182241,535845,500214606.0,126257630.0,373956976.0,0.6928,0.6971,0.6928,0.6979
2023-09-21 15:10,2660,1050,1610,517630,68068,449562,360638208.0,47168979.0,313469229.0,2559,1014,1545,512991,65535,447456,357494184.0,45281064.0,312213119.0,0.693,0.6973,0.6909,0.6978
2023-09-21 15:15,2961,613,2348,684815,47131,637684,477460890.0,32664493.0,444796397.0,2908,585,2323,681296,46244,635052,474977817.0,32008197.0,442969619.0,0.6931,0.6975,0.6922,0.6975
2023-09-21 15:20,1684,471,1213,396453,33056,363397,276023104.0,22985759.0,253037345.0,1616,431,1185,391042,29998,361044,272200456.0,20736040.0,251464416.0,0.6954,0.6963,0.6912,0.6965
2023-09-21 15:25,1195,514,681,147986,49678,98308,102722123.0,34442157.0,68279965.0,1164,503,661,152088,55672,96416,105451152.0,38485519.0,66965633.0,0.6933,0.6946,0.6913,0.6945
2023-09-21 15:30,770,285,485,93844,41265,52579,64979781.0,28547430.0,36432350.0,733,263,470,92646,40955,51691,64207806.0,28313907.0,35893898.0,0.6918,0.6929,0.6913,0.6944
2023-09-21 15:35,802,368,434,86145,32166,53979,59715740.0,22256514.0,37459225.0,768,346,422,86139,31160,54979,59769388.0,21554587.0,38214800.0,0.6919,0.694,0.6917,0.6951
2023-09-21 15:40,2368,608,1760,431665,41011,390654,298785624.0,28296373.0,270489251.0,2323,574,1749,428919,40916,388003,297226017.0,28235086.0,268990931.0,0.69,0.6924,0.6901,0.6933
2023-09-21 15:45,3106,1033,2073,514116,102638,411478,355591812.0,70794233.0,284797579.0,2990,977,2013,496949,92405,404544,343805188.0,63673253.0,280131934.0,0.6897,0.6921,0.6891,0.6925
2023-09-21 15:50,5324,1326,3998,1079096,117505,961591,746884958.0,81045073.0,665839884.0,5235,1268,3967,1072846,114385,958461,742593080.0,78792085.0,663800994.0,0.6897,0.6924,0.6888,0.6926
2023-09-21 15:55,2087,688,1399,408785,35678,373107,282966649.0,24637858.0,258328790.0,2030,647,1383,403500,33533,369967,279367703.0,23079202.0,256288501.0,0.6906,0.6924,0.6883,0.6927
2023-09-21 16:00,1123,348,775,227446,21810,205636,157337467.0,15107922.0,142229544.0,1035,297,738,221998,17428,204570,153598677.0,11968420.0,141630257.0,0.6927,0.6917,0.6867,0.6923
2023-09-21 16:05,3568,2289,1279,738178,609521,128657,510661804.0,420865828.0,89795976.0,3484,2235,1249,732550,608190,124360,506400103.0,419773081.0,86627022.0,0.6905,0.6979,0.6902,0.6966
2023-09-21 16:10,3537,2077,1460,636447,455171,181276,441427141.0,315141216.0,126285924.0,3472,2045,1427,626014,444149,181865,434141807.0,307427887.0,126713919.0,0.6924,0.6966,0.6922,0.6967
2023-09-21 16:15,4120,2371,1749,815628,572761,242867,565226389.0,396390370.0,168836018.0,4004,2299,1705,806984,568754,238230,559402257.0,393479015.0,165923242.0,0.6921,0.6952,0.6918,0.6965
2023-09-21 16:20,2528,792,1736,403218,124197,279021,280193029.0,85877635.0,194315393.0,2472,759,1713,389281,122724,266557,270455233.0,84805469.0,185649764.0,0.6915,0.6964,0.691,0.6965
2023-09-21 16:25,2395,1163,1232,395561,179735,215826,274059503.0,124176323.0,149883179.0,2362,1146,1216,403137,179273,223864,279390246.0,123851155.0,155539091.0,0.6909,0.6945,0.6909,0.6948
2023-09-21 16:30,2475,1307,1168,458985,194349,264636,318874627.0,134481460.0,184393166.0,2437,1266,1171,450826,191528,259298,313023533.0,132412765.0,180610768.0,0.692,0.6968,0.6913,0.6965
2023-09-21 16:35,2362,1474,888,314838,210727,104111,218559751.0,145992146.0,72567604.0,2293,1430,863,310354,208052,102302,215467597.0,144100193.0,71367404.0,0.6928,0.697,0.6926,0.6976
2023-09-21 16:40,1840,1409,431,275228,208783,66445,191112313.0,144808652.0,46303661.0,1769,1373,396,270189,205346,64843,187567637.0,142354929.0,45212707.0,0.6936,0.6969,0.6932,0.6973
2023-09-21 16:45,4172,2317,1855,780646,506191,274455,541870642.0,350735107.0,191135534.0,4140,2308,1832,781105,507653,273452,542225082.0,351741790.0,190483292.0,0.6929,0.6964,0.6929,0.6966
2023-09-21 16:50,3084,1293,1791,568636,282080,286556,394741150.0,195210311.0,199530839.0,3050,1271,1779,577877,291333,286544,401076758.0,201542247.0,199534510.0,0.692,0.6963,0.6918,0.6963
2023-09-21 16:55,4225,2126,2099,798855,447420,351435,554005129.0,309481847.0,244523282.0,4170,2098,2072,794554,445132,349422,551191004.0,307969497.0,243221506.0,0.6917,0.6958,0.6919,0.6961
2023-09-21 17:00,2883,1611,1272,466072,282015,184057,323657561.0,195512408.0,128145152.0,2813,1582,1231,461302,279175,182127,320151466.0,193334291.0,126817175.0,0.6933,0.6962,0.6925,0.6963
2023-09-21 17:05,2373,921,1452,346182,223135,123047,240215153.0,154567161.0,85647991.0,2338,908,1430,343770,221259,122511,238394038.0,153106138.0,85287899.0,0.6927,0.6961,0.692,0.6962
2023-09-21 17:10,146,44,102,15279,3566,11713,10668954.0,2503907.0,8165046.0,122,34,88,9120,2656,6464,6348919.0,1840766.0,4508152.0,0.7022,0.6971,0.6931,0.6974
2023-09-21 17:15,2078,1393,685,369697,301430,68267,256348830.0,209047001.0,47301828.0,2032,1371,661,375981,300059,75922,261025973.0,208059063.0,52966909.0,0.6935,0.6929,0.6934,0.6976
2023-09-21 17:20,1548,687,861,234644,81536,153108,162529199.0,56342374.0,106186824.0,1509,671,838,221417,81359,140058,153484855.0,56194573.0,97290282.0,0.691,0.6935,0.6907,0.6946
2023-09-21 17:25,3300,1315,1985,650469,193783,456686,451035826.0,133868723.0,317167103.0,3249,1284,1965,648482,192723,455759,449626951.0,133102355.0,316524596.0,0.6908,0.6945,0.6906,0.6945
2023-09-21 17:30,1641,652,989,319845,112129,207716,221605866.0,77479228.0,144126637.0,1614,637,977,323750,111108,212642,224298176.0,76692897.0,147605278.0,0.691,0.6939,0.6903,0.6941
2023-09-21 17:35,1981,965,1016,312748,155762,156986,216174358.0,107555349.0,108619009.0,1928,933,995,313977,154820,159157,217392475.0,106893695.0,110498780.0,0.6905,0.6919,0.6904,0.6943
2023-09-21 17:40,987,178,809,266493,16546,249947,183641122.0,11369742.0,172271380.0,914,141,773,252871,10170,242701,175176333.0,6982013.0,168194320.0,0.6872,0.6892,0.6865,0.693
2023-09-21 17:45,2410,659,1751,901029,36814,864215,623881336.0,25338907.0,598542429.0,2346,619,1727,882150,25575,856575,611591954.0,17593246.0,593998707.0,0.6883,0.6926,0.6879,0.6935
2023-09-21 17:50,3673,773,2900,1493466,41437,1452029,1035798499.0,28546962.0,1007251536.0,3632,744,2888,1489230,38704,1450526,1032885903.0,26665825.0,1006220078.0,0.6889,0.6937,0.689,0.6937
2023-09-21 17:55,4589,693,3896,1646232,43159,1603073,1141127181.0,29712451.0,1111414729.0,4544,673,3871,1645851,45241,1600610,1141079406.0,31090574.0,1109988831.0,0.6884,0.6933,0.6872,0.6935
2023-09-21 18:00,3734,616,3118,1211999,41750,1170249,840235165.0,28747541.0,811487623.0,3700,599,3101,1211453,41784,1169669,839847336.0,28742534.0,811104802.0,0.6886,0.6934,0.6879,0.6934
2023-09-21 18:05,4281,456,3825,2255225,42044,2213181,1563774080.0,28882513.0,1534891567.0,4226,436,3790,2240563,35120,2205443,1554095619.0,24127206.0,1529968412.0,0.687,0.6935,0.687,0.6937
2023-09-21 18:10,4206,743,3463,1982944,120608,1862336,1375254421.0,83927156.0,1291327264.0,4146,710,3436,1963906,108972,1854934,1362467254.0,75948242.0,1286519011.0,0.6959,0.6934,0.697,0.6936
2023-09-21 18:15,3481,766,2715,1053139,74500,978639,729916960.0,51454706.0,678462254.0,3445,748,2697,1051298,72679,978619,728508708.0,50022989.0,678485719.0,0.6907,0.6933,0.6883,0.6933
2023-09-21 18:20,5554,1052,4502,2082422,83369,1999053,1443077678.0,57537178.0,1385540500.0,5512,1035,4477,2074174,79424,1994750,1437402454.0,54766432.0,1382636022.0,0.6902,0.6931,0.6895,0.6931
2023-09-21 18:25,5940,2190,3750,1576678,406053,1170625,1090432670.0,280649923.0,809782746.0,5863,2153,3710,1566155,398491,1167664,1082758567.0,275016435.0,807742132.0,0.6912,0.6918,0.6901,0.6918
2023-09-21 18:30,5726,3173,2553,1211037,682003,529034,838524727.0,471030178.0,367494549.0,5679,3150,2529,1209144,682757,526387,837349256.0,471559604.0,365789652.0,0.6907,0.6947,0.6907,0.6949
2023-09-21 18:35,5159,2971,2188,1089643,666908,422735,754556862.0,461008656.0,293548205.0,5105,2949,2156,1086080,663640,422440,752007420.0,458500135.0,293507284.0,0.6913,0.6944,0.6909,0.6948
2023-09-22 10:00,17091,7498,9593,2131139,1069364,1061775,1481928657.0,742136233.0,739792424.0,16480,7157,9323,2086594,1045698,1040896,1450650822.0,724746547.0,725904275.0,0.694,0.6968,0.6931,0.6974
2023-09-22 10:05,11596,6879,4717,1675140,1260048,415092,1155464520.0,868019761.0,287444759.0,11153,6706,4447,1640950,1240121,400829,1131784150.0,853676503.0,278107647.0,0.6889,0.6925,0.6884,0.6938
2023-09-22 10:10,4024,2920,1104,544395,481727,62668,377541907.0,333899219.0,43642688.0,3635,2710,925,522744,469533,53211,362055353.0,324836538.0,37218815.0,0.6931,0.6964,0.6918,0.6995
2023-09-22 10:15,2138,1598,540,209552,174164,35388,145558741.0,120869823.0,24688918.0,1916,1466,450,192800,164664,28136,133901070.0,114197925.0,19703144.0,0.694,0.6977,0.6935,0.7003
2023-09-22 10:20,3767,2584,1183,589704,507512,82192,412173222.0,354433970.0,57739252.0,3236,2328,908,556130,486303,69827,388669780.0,339363441.0,49306338.0,0.6984,0.7025,0.6978,0.7061
2023-09-22 10:25,2039,1509,530,238115,204631,33484,169165342.0,145348188.0,23817154.0,1737,1351,386,219315,195133,24182,154572593.0,137394581.0,17178012.0,0.7103,0.7113,0.7041,0.7104
2023-09-22 10:30,3283,2313,970,474932,407258,67674,337436486.0,289728890.0,47707596.0,2740,2052,688,437414,387332,50082,310443365.0,274813749.0,35629616.0,0.7114,0.705,0.7095,0.7114
2023-09-22 10:35,4049,2434,1615,605667,432551,173116,429060620.0,306389688.0,122670932.0,3586,2242,1344,574643,417129,157514,407288225.0,295062416.0,112225809.0,0.7083,0.7086,0.7074,0.7125
2023-09-22 10:40,4345,1724,2621,838673,269572,569101,592126088.0,189656490.0,402469598.0,4060,1586,2474,791074,237234,553840,559658692.0,167243370.0,392415322.0,0.7035,0.7072,0.705,0.7085
2023-09-22 10:45,3288,1255,2033,570043,111846,458197,403530733.0,79010601.0,324520131.0,3079,1165,1914,557861,109888,447973,394724983.0,77260223.0,317464760.0,0.7064,0.7083,0.7031,0.7087
2023-09-22 10:50,3978,1655,2323,880967,173268,707699,621297161.0,121728712.0,499568449.0,3809,1570,2239,869492,166403,703089,613566670.0,116798378.0,496768291.0,0.7025,0.7059,0.7019,0.7066
2023-09-22 10:55,1881,427,1454,430975,33576,397399,303794935.0,23546163.0,280248772.0,1746,350,1396,417730,26074,391656,294700817.0,18236821.0,276463996.0,0.7013,0.7052,0.6994,0.7059
2023-09-22 11:00,2534,1214,1320,436143,101143,335000,306988449.0,70947809.0,236040640.0,2362,1130,1232,422217,92411,329806,297431630.0,64733503.0,232698127.0,0.7015,0.7046,0.7005,0.7056
2023-09-22 11:05,2418,1230,1188,368304,129490,238814,260779777.0,91409477.0,169370299.0,2260,1167,1093,362789,128206,234583,256559953.0,90245685.0,166314268.0,0.7059,0.7092,0.7039,0.709
2023-09-22 11:10,5197,1231,3966,1400787,100161,1300626,988223710.0,70249826.0,917973884.0,5072,1176,3896,1398508,102274,1296234,986751146.0,71693874.0,915057272.0,0.7014,0.7058,0.701,0.7059
2023-09-22 11:15,3911,884,3027,960068,46037,914031,677106171.0,32388287.0,644717884.0,3816,846,2970,955712,44987,910725,674080644.0,31508141.0,642572502.0,0.7035,0.7054,0.7004,0.7056
2023-09-22 11:20,1978,999,979,240262,77291,162971,168891912.0,54354341.0,114537571.0,1831,932,899,230851,71212,159639,162376991.0,49972947.0,112404044.0,0.7032,0.7028,0.7017,0.7041
2023-09-22 11:25,1310,556,754,167679,83502,84177,117818508.0,58605979.0,59212528.0,1234,512,722,162613,82836,79777,114389924.0,58121680.0,56268244.0,0.7019,0.7034,0.7016,0.7053
2023-09-22 11:30,1092,523,569,166321,69071,97250,118583950.0,48559390.0,70024559.0,1020,477,543,164105,68178,95927,115604026.0,47875104.0,67728921.0,0.703,0.72,0.7022,0.706
2023-09-22 11:35,1351,433,918,270123,48249,221874,191418633.0,33902408.0,157516224.0,1240,363,877,264729,45450,219279,188101661.0,31897379.0,156204281.0,0.7027,0.7099,0.7018,0.7124
2023-09-22 11:40,784,268,516,109828,22849,86979,77128271.0,15986739.0,61141531.0,718,233,485,104845,20981,83864,73704405.0,14670377.0,59034028.0,0.6997,0.7029,0.6992,0.7039
2023-09-22 11:45,4919,1635,3284,1144876,164444,980432,804446767.0,114691823.0,689754943.0,4838,1580,3258,1139522,162709,976813,801030065.0,113412346.0,687617719.0,0.6975,0.7035,0.697,0.7039
2023-09-22 11:50,2875,1392,1483,586376,93632,492744,410318331.0,65071027.0,345247304.0,2669,1260,1409,570702,84583,486119,399600568.0,58714316.0,340886252.0,0.695,0.7007,0.6942,0.7012
2023-09-22 11:55,3122,2134,988,515896,301793,214103,362307880.0,212462350.0,149845529.0,2894,1993,901,501496,293153,208343,353110570.0,207194278.0,145916291.0,0.704,0.6999,0.7068,0.7004
2023-09-22 12:00,3712,1433,2279,922249,152608,769641,644379511.0,106053109.0,538326402.0,3562,1373,2189,914136,148226,765910,638807929.0,102868680.0,535939248.0,0.6949,0.6995,0.694,0.6997
2023-09-22 12:05,1667,972,695,215578,109237,106341,150556257.0,76087598.0,74468658.0,1558,897,661,211797,105561,106236,147897556.0,73424040.0,74473515.0,0.6965,0.7003,0.6956,0.701
2023-09-22 12:10,2111,1109,1002,301712,143780,157932,211092328.0,100323127.0,110769201.0,2047,1075,972,298067,141493,156574,208504785.0,98672398.0,109832386.0,0.6978,0.7014,0.6974,0.7015
2023-09-22 12:15,840,363,477,88551,32285,56266,61895687.0,22567996.0,39327690.0,717,292,425,82179,30093,52086,57541486.0,20985647.0,36555839.0,0.699,0.699,0.6974,0.7018
2023-09-22 12:20,829,512,317,91132,59570,31562,63614306.0,41506422.0,22107884.0,818,514,304,90296,59823,30473,63041125.0,41681174.0,21359951.0,0.6968,0.7005,0.6967,0.7009
2023-09-22 12:25,1922,1216,706,326927,228724,98203,228266243.0,159484497.0,68781746.0,1929,1197,732,328098,230041,98057,229033191.0,160304820.0,68728371.0,0.6973,0.7004,0.6969,0.7009
2023-09-22 12:30,1934,727,1207,299106,139800,159306,208742007.0,97417846.0,111324161.0,1882,706,1176,296020,138292,157728,206671210.0,96321468.0,110349742.0,0.6968,0.6988,0.6965,0.6996
2023-09-22 12:35,2385,752,1633,437761,102921,334840,305705899.0,71727880.0,233978019.0,2303,723,1580,429923,99497,330426,300143598.0,69204176.0,230939421.0,0.6969,0.6988,0.6955,0.6989
2023-09-22 12:40,1218,682,536,241882,143606,98276,168474568.0,99741440.0,68733128.0,1190,668,522,235658,138560,97098,164155896.0,96259178.0,67896718.0,0.6945,0.6994,0.6947,0.6993
2023-09-22 12:45,513,416,97,129564,123602,5962,89852882.0,85695469.0,4157412.0,491,406,85,129714,123570,6144,89957772.0,85667830.0,4289942.0,0.6933,0.6973,0.6933,0.6982
2023-09-22 12:50,359,301,58,81900,74848,7052,56857885.0,51919648.0,4938236.0,339,290,49,79439,74632,4807,55124466.0,51771137.0,3353329.0,0.6937,0.7003,0.6937,0.6976
2023-09-22 12:55,407,236,171,99443,80097,19346,69136730.0,55630810.0,13505920.0,386,227,159,98964,79772,19192,68720574.0,55312223.0,13408351.0,0.6945,0.6981,0.6934,0.6986
2023-09-22 13:00,1706,919,787,346063,225652,120411,242011898.0,157503562.0,84508335.0,1666,904,762,339279,221576,117703,236889991.0,154341813.0,82548177.0,0.698,0.7018,0.6966,0.7013
2023-09-22 13:05,3673,1913,1760,622149,432310,189839,435231968.0,301818829.0,133413139.0,3628,1888,1740,617523,428685,188838,431952526.0,299238817.0,132713709.0,0.6982,0.7028,0.698,0.7028
2023-09-22 13:10,3274,1623,1651,539263,375099,164164,377217396.0,261840412.0,115376983.0,3236,1597,1639,538564,375117,163447,376783254.0,261849925.0,114933329.0,0.6981,0.7028,0.698,0.7032
2023-09-22 13:15,1805,1159,646,236208,174937,61271,165357962.0,122302995.0,43054966.0,1754,1134,620,230883,172143,58740,161568530.0,120238670.0,41329860.0,0.6991,0.7027,0.6985,0.7036
2023-09-22 13:20,1999,1106,893,336550,189773,146777,235891992.0,132603039.0,103288952.0,1965,1094,871,333503,189541,143962,233800084.0,132411303.0,101388780.0,0.6987,0.7037,0.6986,0.7043
2023-09-22 13:25,4845,1461,3384,1027339,128732,898607,720837732.0,89765876.0,631071855.0,4778,1434,3344,1023391,126982,896409,718269782.0,88527494.0,629742288.0,0.6973,0.7023,0.6972,0.7025
2023-09-22 13:30,2485,604,1881,594452,82425,512027,416774127.0,57328181.0,359445945.0,2420,593,1827,593595,82077,511518,416207550.0,57084488.0,359123061.0,0.6955,0.702,0.6955,0.7021
2023-09-22 13:35,1671,277,1394,424116,33045,391071,297432777.0,23021158.0,274411619.0,1637,266,1371,422349,31649,390700,296175148.0,22023126.0,274152021.0,0.6967,0.7017,0.6959,0.7017
2023-09-22 13:40,528,161,367,112005,27238,84767,78478929.0,18972634.0,59506295.0,498,145,353,111003,26285,84718,77764748.0,18299791.0,59464957.0,0.6966,0.702,0.6962,0.7019
2023-09-22 13:45,477,153,324,86346,27894,58452,60501876.0,19450926.0,41050950.0,460,147,313,86474,28407,58067,60599702.0,19810787.0,40788915.0,0.6973,0.7023,0.6974,0.7024
2023-09-22 13:50,1138,492,646,145466,46321,99145,101911314.0,32329558.0,69581756.0,1116,480,636,144526,45783,98743,101238108.0,31938996.0,69299112.0,0.6979,0.7018,0.6976,0.7018
2023-09-22 13:55,851,401,450,93362,33643,59719,65564012.0,23571914.0,41992098.0,812,385,427,97378,38521,58857,67926874.0,26517533.0,41409341.0,0.7006,0.7032,0.6884,0.7036
2023-09-22 14:00,957,580,377,160534,85597,74937,112737767.0,59947881.0,52789885.0,922,567,355,158247,84483,73764,110994442.0,59021176.0,51973266.0,0.7004,0.7045,0.6986,0.7046
2023-09-22 14:05,1170,797,373,180108,122289,57819,126496138.0,85715176.0,40780962.0,1111,769,342,177509,120906,56603,124665203.0,84738151.0,39927052.0,0.7009,0.7053,0.7009,0.7054
2023-09-22 14:10,1247,793,454,262195,218175,44020,184054162.0,153012706.0,31041456.0,1215,773,442,261978,220162,41816,183886993.0,154398581.0,29488412.0,0.7013,0.7052,0.7013,0.7052
2023-09-22 14:15,2403,1052,1351,300523,171364,129159,210906154.0,120084844.0,90821310.0,2352,1024,1328,298001,170995,127006,209186173.0,119823707.0,89362466.0,0.7008,0.7032,0.7007,0.7036
2023-09-22 14:20,525,255,270,64446,44579,19867,45142639.0,31161665.0,13980974.0,515,251,264,63829,44651,19178,44708118.0,31208646.0,13499472.0,0.699,0.7037,0.6989,0.7039
2023-09-22 14:25,1360,726,634,227698,160992,66706,159632877.0,112681699.0,46951178.0,1341,708,633,234328,164641,69687,164239883.0,115146234.0,49093649.0,0.6999,0.7039,0.6994,0.7045
2023-09-22 14:30,1934,1064,870,339886,276177,63709,238007689.0,193166045.0,44841643.0,1897,1044,853,338095,276177,61918,236929756.0,193157977.0,43771778.0,0.6994,0.7039,0.6994,0.7069
2023-09-22 14:35,3082,1890,1192,541709,374442,167267,378718047.0,261579438.0,117138609.0,3009,1838,1171,533714,368450,165264,373529083.0,257379266.0,116149816.0,0.6986,0.7003,0.6985,0.7028
2023-09-22 14:40,1988,922,1066,325068,151203,173865,227741998.0,105493398.0,122248600.0,1914,897,1017,322598,150511,172087,226016483.0,105009074.0,121007409.0,0.6977,0.7031,0.6977,0.7032
2023-09-22 14:45,1368,884,484,185289,116977,68312,129647780.0,81624302.0,48023477.0,1296,852,444,173203,111167,62036,121097185.0,77458499.0,43638685.0,0.6978,0.703,0.6968,0.7034
2023-09-22 14:50,640,352,288,108116,50907,57209,75798274.0,35536643.0,40261631.0,606,335,271,106444,50455,55989,74592205.0,35186536.0,39405669.0,0.6981,0.7038,0.6974,0.7038
2023-09-22 14:55,2028,999,1029,396396,181832,214564,278008746.0,126938330.0,151070416.0,1995,982,1013,397850,182993,214857,279038664.0,127734995.0,151303669.0,0.6981,0.7041,0.698,0.7042
2023-09-22 15:00,1235,1022,213,194315,140038,54277,136145712.0,97887072.0,38258640.0,1227,1015,212,194514,139676,54838,136287416.0,97632074.0,38655342.0,0.699,0.7049,0.699,0.7049
2023-09-22 15:05,1693,1059,634,321317,141586,179731,225747793.0,99040844.0,126706949.0,1664,1035,629,319958,139951,180007,224800602.0,97895137.0,126905465.0,0.6995,0.705,0.6995,0.705
2023-09-22 15:10,637,288,349,88427,41251,47176,62211395.0,28916898.0,33294496.0,591,258,333,86324,40025,46299,60697580.0,28003194.0,32694386.0,0.701,0.7058,0.6996,0.7062
2023-09-22 15:15,1522,730,792,229877,83943,145934,162018886.0,58993211.0,103025675.0,1428,681,747,218268,77416,140852,153765477.0,54251708.0,99513768.0,0.7028,0.706,0.7008,0.7065
2023-09-22 15:20,2469,464,2005,454038,43070,410968,320341515.0,30113352.0,290228163.0,2431,432,1999,451761,41371,410390,318772684.0,28946286.0,289826398.0,0.6992,0.7062,0.6997,0.7062
2023-09-22 15:25,3148,728,2420,810514,80815,729699,570903992.0,56510174.0,514393818.0,3092,683,2409,806104,78288,727816,567943338.0,54729577.0,513213760.0,0.6993,0.7049,0.6991,0.7051
2023-09-22 15:30,5317,2954,2363,1017229,384562,632667,715338940.0,269321542.0,446017397.0,5295,2949,2346,1016208,384053,632155,714588249.0,268926524.0,445661724.0,0.7003,0.705,0.7002,0.705
2023-09-22 15:35,1685,658,1027,314258,70618,243640,221119416.0,49415653.0,171703762.0,1636,622,1014,310979,68940,242039,218863562.0,48227112.0,170636449.0,0.6998,0.7047,0.6996,0.705
2023-09-22 15:40,1385,896,489,195220,120711,74509,138128241.0,85203847.0,52924394.0,1228,832,396,176680,106446,70234,124890552.0,74964379.0,49926173.0,0.7058,0.7103,0.7042,0.7109
2023-09-22 15:45,961,341,620,138377,34501,103876,98598069.0,24523016.0,74075052.0,770,283,487,124403,30309,94094,88818957.0,21511705.0,67307251.0,0.7108,0.7131,0.7097,0.7153
2023-09-22 15:50,899,531,368,134094,82635,51459,95447738.0,58754210.0,36693527.0,843,499,344,135228,82472,52756,96242398.0,58547132.0,37695265.0,0.711,0.7131,0.7099,0.7145
2023-09-22 15:55,398,220,178,73254,44387,28867,51997798.0,31454025.0,20543773.0,331,182,149,68279,42436,25843,48431830.0,29976476.0,18455354.0,0.7086,0.7117,0.7064,0.7141
2023-09-22 16:00,2947,1731,1216,563173,407936,155237,399953607.0,289128755.0,110824852.0,2854,1681,1173,572979,418221,154758,406387924.0,295818230.0,110569693.0,0.7088,0.7139,0.7073,0.7145
2023-09-22 16:05,1546,1070,476,216970,170569,46401,154178804.0,121042998.0,33135806.0,1456,1036,420,211994,168814,43180,150675432.0,119746488.0,30928943.0,0.7096,0.7141,0.7093,0.7163
2023-09-22 16:10,3023,1405,1618,529615,152300,377315,377593464.0,108007710.0,269585754.0,2941,1369,1572,519104,146866,372238,370249293.0,104035880.0,266213412.0,0.7092,0.7145,0.7084,0.7152
2023-09-22 16:15,1913,1138,775,219874,116350,103524,157037783.0,82947614.0,74090169.0,1807,1078,729,219233,117718,101515,156402511.0,83733635.0,72668876.0,0.7129,0.7157,0.7113,0.7158
2023-09-22 16:20,1561,916,645,210986,93847,117139,150454728.0,66701932.0,83752796.0,1511,888,623,210593,94731,115862,150156454.0,67267283.0,82889170.0,0.7108,0.715,0.7101,0.7154
2023-09-22 16:25,1029,545,484,89569,38489,51080,63834788.0,27400331.0,36434456.0,990,521,469,88044,38826,49218,62804885.0,27583901.0,35220984.0,0.7119,0.7133,0.7104,0.7156
2023-09-22 16:30,2640,1963,677,463958,409873,54085,331209745.0,292595895.0,38613849.0,2421,1892,529,451268,403592,47676,322087318.0,287838859.0,34248459.0,0.7139,0.7139,0.7132,0.7184
2023-09-22 16:35,2002,1518,484,285960,199257,86703,204273847.0,142192753.0,62081093.0,1908,1469,439,280588,198008,82580,200596560.0,141212773.0,59383787.0,0.7136,0.716,0.7132,0.7191
2023-09-22 16:40,1840,1203,637,264931,204747,60184,189416483.0,146151331.0,43265152.0,1749,1149,600,260720,201351,59369,186299892.0,143600813.0,42699079.0,0.7138,0.7189,0.7132,0.7192
2023-09-22 16:45,5655,3381,2274,1009994,656102,353892,730532246.0,474707276.0,255824970.0,5141,3166,1975,974992,636594,338398,702620607.0,457378890.0,245241716.0,0.7235,0.7229,0.7185,0.7247
2023-09-22 16:50,4329,1167,3162,689466,173217,516249,498954700.0,124627138.0,374327561.0,4172,1094,3078,681597,170116,511481,493362672.0,122271350.0,371091321.0,0.7195,0.7251,0.7188,0.7255
2023-09-22 16:55,2439,1419,1020,536791,413671,123120,386210519.0,297079491.0,89131028.0,2346,1380,966,529979,410758,119221,381423966.0,294966823.0,86457142.0,0.7182,0.7239,0.7181,0.7252
2023-09-22 17:00,3470,1507,1963,648595,227743,420852,467112545.0,163392027.0,303720517.0,3341,1421,1920,635172,220408,414764,457765582.0,158127918.0,299637663.0,0.7174,0.7217,0.7174,0.7224
2023-09-22 17:05,3894,1503,2391,771916,171931,599985,556694647.0,123089630.0,433605016.0,3844,1483,2361,770194,171724,598470,555439540.0,122916112.0,432523428.0,0.7159,0.7227,0.7158,0.7227
2023-09-22 17:10,2842,746,2096,667215,94528,572687,481224400.0,67634452.0,413589948.0,2803,732,2071,662667,91726,570941,477945014.0,65602064.0,412342950.0,0.7155,0.7222,0.7152,0.7222
2023-09-22 17:15,3881,1528,2353,789825,281233,508592,567579560.0,200871477.0,366708082.0,3827,1503,2324,782133,274882,507251,562181721.0,196410929.0,365770791.0,0.7143,0.721,0.7145,0.7211
2023-09-22 17:20,1979,1106,873,412629,249460,163169,295761120.0,178193093.0,117568026.0,1952,1096,856,419575,257634,161941,300577608.0,183786247.0,116791361.0,0.7143,0.7205,0.7134,0.7212
2023-09-22 17:25,2672,1140,1532,605265,270834,334431,434551059.0,193496759.0,241054300.0,2649,1133,1516,606019,270567,335452,435150923.0,193297662.0,241853261.0,0.7144,0.7208,0.7144,0.721
2023-09-22 17:30,3904,1630,2274,756254,403286,352968,543084151.0,288754309.0,254329841.0,3821,1589,2232,749029,398926,350103,537674525.0,285407470.0,252267055.0,0.716,0.7205,0.7154,0.7206
2023-09-22 17:35,3494,2152,1342,808945,665905,143040,581655870.0,478143614.0,103512256.0,3408,2112,1296,804221,662855,141366,578220159.0,475868159.0,102352000.0,0.718,0.7237,0.7179,0.724
2023-09-22 17:40,2116,1617,499,562595,516149,46446,403648785.0,370106931.0,33541854.0,2082,1605,477,558381,515271,43110,400651663.0,369460438.0,31191225.0,0.7171,0.7222,0.717,0.7235
2023-09-22 17:45,2065,1373,692,419897,368300,51597,302292730.0,264894470.0,37398259.0,2013,1349,664,420934,367990,52944,302985663.0,264593120.0,38392542.0,0.7192,0.7248,0.719,0.7252
2023-09-22 17:50,1826,1276,550,413314,390346,22968,298225551.0,281576918.0,16648633.0,1674,1204,470,405711,385707,20004,292593797.0,278041947.0,14551849.0,0.7214,0.7249,0.7209,0.7274
2023-09-22 17:55,2529,1936,593,533533,457617,75916,384852716.0,329744938.0,55107777.0,2460,1914,546,528182,455876,72306,381049065.0,328468800.0,52580264.0,0.7206,0.7259,0.7205,0.7272
2023-09-22 18:00,2808,1277,1531,514761,209167,305594,373114333.0,151037951.0,222076382.0,2754,1244,1510,513595,208259,305336,372341132.0,150346283.0,221994848.0,0.7221,0.7267,0.7219,0.7271
2023-09-22 18:05,4972,1639,3333,1251766,243640,1008126,907647835.0,175746464.0,731901371.0,4856,1580,3276,1242386,240942,1001444,901121515.0,173722634.0,727398880.0,0.7213,0.726,0.721,0.7264
2023-09-22 18:10,6812,3722,3090,1561105,526967,1034138,1127656928.0,379049850.0,748607077.0,6764,3692,3072,1559093,525074,1034019,1126075009.0,377562836.0,748512172.0,0.7193,0.7239,0.7191,0.7239
2023-09-22 18:15,7241,3613,3628,1406636,573234,833402,1016231949.0,412698599.0,603533350.0,7187,3589,3598,1404720,572883,831837,1014903905.0,412397507.0,602506398.0,0.7199,0.7242,0.7199,0.7243
2023-09-22 18:20,3146,424,2722,309098,26433,282665,223530578.0,19030289.0,204500288.0,3092,399,2693,306758,25006,281752,221951756.0,17984490.0,203967265.0,0.7199,0.7235,0.7192,0.7239
2023-09-22 18:25,4070,1453,2617,612973,126231,486742,443113718.0,90873546.0,352240172.0,4043,1437,2606,611847,124815,487032,442315088.0,89862869.0,352452219.0,0.7199,0.7237,0.72,0.7237
2023-09-22 18:30,4056,1054,3002,667766,90526,577240,482839823.0,65202004.0,417637818.0,4060,1056,3004,661892,86646,575246,478602981.0,62356644.0,416246337.0,0.7203,0.7235,0.7197,0.7236
2023-09-22 18:35,3119,1058,2061,397985,171229,226756,287694427.0,123564424.0,164130003.0,3073,1053,2020,394491,169648,224843,285157893.0,122312321.0,162845572.0,0.7216,0.7238,0.721,0.7243
2023-09-25 10:00,17713,15093,2620,2425670,2141189,284481,1760709063.0,1551894496.0,208814567.0,16644,14614,2030,2352207,2108545,243662,1705677354.0,1526652659.0,179024695.0,0.7248,0.734,0.724,0.7347
2023-09-25 10:05,7528,3998,3530,990709,602896,387813,714539625.0,433921209.0,280618416.0,6906,3657,3249,941700,580394,361306,679461067.0,417167448.0,262293619.0,0.7197,0.7236,0.7188,0.726
2023-09-25 10:10,1473,702,771,118085,53681,64404,84106873.0,38521582.0,45585290.0,1161,505,656,97074,44578,52496,69795410.0,31870570.0,37924839.0,0.7176,0.7078,0.7149,0.7224
2023-09-25 10:15,3454,1355,2099,369767,117591,252176,267061360.0,85412801.0,181648558.0,3033,1126,1907,340626,97581,243045,246512581.0,71009076.0,175503504.0,0.7264,0.7203,0.7277,0.7221
2023-09-25 10:20,4172,1857,2315,361380,210959,150421,261857068.0,152500989.0,109356079.0,3814,1648,2166,343221,200408,142813,248448891.0,144310483.0,104138407.0,0.7229,0.727,0.7201,0.7292
2023-09-25 10:25,5428,1960,3468,477076,235950,241126,347579929.0,171614676.0,175965252.0,5032,1767,3265,450664,222963,227701,327729922.0,161236701.0,166493220.0,0.7273,0.7298,0.7232,0.7312
2023-09-25 10:30,6156,1590,4566,788100,102148,685952,577672373.0,74584020.0,503088353.0,5711,1384,4327,766560,90793,675767,563544635.0,67205089.0,496339546.0,0.7302,0.7334,0.7402,0.7345
2023-09-25 10:35,1890,910,980,117700,52806,64894,85372012.0,37959708.0,47412304.0,1666,787,879,107552,47482,60070,78288721.0,34168824.0,44119897.0,0.7189,0.7306,0.7196,0.7345
2023-09-25 10:40,1545,944,601,105484,70956,34528,77040571.0,51845904.0,25194667.0,1435,901,534,101399,71255,30144,73727243.0,51565452.0,22161790.0,0.7307,0.7297,0.7237,0.7352
2023-09-25 10:45,2238,763,1475,355895,92952,262943,260207420.0,67232878.0,192974542.0,2170,723,1447,346525,86782,259743,253445468.0,62782356.0,190663112.0,0.7233,0.7339,0.7234,0.734
2023-09-25 10:50,2713,852,1861,409144,80345,328799,299317052.0,58399945.0,240917106.0,2606,791,1815,402461,76998,325463,294551118.0,55924543.0,238626574.0,0.7269,0.7327,0.7263,0.7332
2023-09-25 10:55,3133,1334,1799,456643,164876,291767,332433237.0,119115891.0,213317346.0,3034,1290,1744,453220,164707,288513,329809373.0,118737006.0,211072367.0,0.7225,0.7311,0.7209,0.7316
2023-09-25 11:00,4792,1577,3215,779385,152196,627189,567298197.0,110351010.0,456947187.0,4586,1474,3112,763095,145332,617763,555003024.0,104732320.0,450270704.0,0.7251,0.7286,0.7206,0.7289
2023-09-25 11:05,2326,949,1377,227351,84312,143039,165324432.0,61178972.0,104145460.0,2221,906,1315,223413,82135,141278,162485734.0,59550581.0,102935152.0,0.7256,0.7281,0.725,0.7286
2023-09-25 11:10,2223,1113,1110,236182,173117,63065,171546066.0,125596315.0,45949751.0,2144,1075,1069,229587,170104,59483,166738375.0,123333264.0,43405111.0,0.7255,0.7286,0.725,0.7297
2023-09-25 11:15,2297,1266,1031,341246,240204,101042,246718850.0,173326448.0,73392402.0,2230,1235,995,335955,236609,99346,243307549.0,171085706.0,72221843.0,0.7216,0.7264,0.7231,0.727
2023-09-25 11:20,2628,1628,1000,387859,326462,61397,281067195.0,236347339.0,44719855.0,2497,1583,914,380781,322139,58642,275597737.0,232867656.0,42730081.0,0.724,0.7284,0.7229,0.7287
2023-09-25 11:25,2560,1851,709,392037,352439,39598,284367112.0,255476712.0,28890399.0,2413,1788,625,380154,344519,35635,275765086.0,249742516.0,26022570.0,0.7249,0.7296,0.7249,0.7303
2023-09-25 11:30,1968,1249,719,279563,245490,34073,203021401.0,178162006.0,24859394.0,1929,1234,695,278413,245552,32861,202181227.0,178182602.0,23998625.0,0.7257,0.7296,0.7256,0.7303
2023-09-25 11:35,2146,1425,721,333694,296189,37505,242314803.0,215033827.0,27280976.0,2079,1383,696,335694,298480,37214,243521654.0,216352558.0,27169096.0,0.726,0.7274,0.7248,0.7301
2023-09-25 11:40,3064,2209,855,471239,411611,59628,342473639.0,298959218.0,43514420.0,3026,2187,839,469969,411144,58825,341490464.0,298488866.0,43001598.0,0.7263,0.7298,0.726,0.731
2023-09-25 11:45,2382,1082,1300,281359,183811,97548,204238312.0,133057950.0,71180362.0,2297,1043,1254,273107,176913,96194,198631143.0,128350786.0,70280356.0,0.7239,0.7297,0.7255,0.7306
2023-09-25 11:50,1463,773,690,174079,131197,42882,126541109.0,95227767.0,31313342.0,1435,758,677,177351,134478,42873,128802925.0,97468749.0,31334176.0,0.7258,0.7302,0.7248,0.7309
2023-09-25 11:55,2328,1415,913,357308,273750,83558,260194162.0,199012742.0,61181420.0,2244,1381,863,352544,271207,81337,256540857.0,196952108.0,59588749.0,0.727,0.7322,0.7262,0.7326
2023-09-25 12:00,2182,1550,632,257329,221562,35767,187665426.0,161434766.0,26230659.0,2080,1503,577,252858,218649,34209,184241399.0,159154682.0,25086716.0,0.7286,0.7334,0.7279,0.7333
2023-09-25 12:05,1078,770,308,140198,123376,16822,102348081.0,90094752.0,12253329.0,983,720,263,134385,121335,13050,98110797.0,88521648.0,9589148.0,0.7302,0.7284,0.7296,0.7348
2023-09-25 12:10,2467,1653,814,294445,245670,48775,215426163.0,179620942.0,35805221.0,2375,1604,771,289934,244286,45648,212053820.0,178467355.0,33586464.0,0.7311,0.7341,0.7306,0.7358
2023-09-25 12:15,1536,1090,446,225991,200590,25401,164884269.0,146264336.0,18619932.0,1484,1066,418,225348,199672,25676,164410708.0,145552263.0,18858445.0,0.7292,0.733,0.729,0.7345
2023-09-25 12:20,4072,2692,1380,560580,450630,109950,411168870.0,330215972.0,80952897.0,3868,2590,1278,539678,440331,99347,395454467.0,322225053.0,73229413.0,0.7328,0.7363,0.7318,0.7371
2023-09-25 12:25,2763,1874,889,334693,278996,55697,247080340.0,206284844.0,40795496.0,2384,1670,714,309779,264112,45667,228436102.0,194633076.0,33803025.0,0.7394,0.7325,0.7369,0.7402
2023-09-25 12:30,2426,1531,895,237542,172197,65345,176592990.0,128217722.0,48375268.0,2062,1348,714,212201,157249,54952,157533123.0,116605262.0,40927861.0,0.7446,0.7403,0.7415,0.7448
2023-09-25 12:35,2523,1271,1252,248158,108548,139610,186890921.0,83034706.0,103856214.0,2331,1180,1151,232170,103683,128487,172732868.0,76988821.0,95744047.0,0.765,0.7439,0.7425,0.7452
2023-09-25 12:40,3108,1364,1744,348311,132547,215764,258508327.0,98693453.0,159814874.0,2849,1232,1617,328279,125145,203134,243366304.0,92406639.0,150959665.0,0.7446,0.7407,0.7384,0.7432
2023-09-25 12:45,4050,1630,2420,616821,156841,459980,457064171.0,115684724.0,341379447.0,3849,1536,2313,599516,148576,450940,444253026.0,109208232.0,335044793.0,0.7376,0.7422,0.735,0.743
2023-09-25 12:50,1969,791,1178,215397,70423,144974,158910696.0,51713788.0,107196908.0,1880,739,1141,209375,67987,141388,154563666.0,49897726.0,104665940.0,0.7343,0.7394,0.7339,0.7403
2023-09-25 12:55,2760,1123,1637,444639,143989,300650,327078200.0,105109615.0,221968585.0,2595,1030,1565,428558,135181,293377,315385798.0,98601347.0,216784451.0,0.73,0.7383,0.7294,0.7389
2023-09-25 13:00,1339,1065,274,214606,190800,23806,158095355.0,140468283.0,17627072.0,1286,1047,239,209897,189161,20736,154597327.0,139259386.0,15337940.0,0.7362,0.7404,0.7362,0.7397
2023-09-25 13:05,2685,1330,1355,320332,157815,162517,235527411.0,115995293.0,119532117.0,2561,1275,1286,311007,154773,156234,228859654.0,113714614.0,115145040.0,0.735,0.7355,0.7347,0.737
2023-09-25 13:10,4560,3720,840,754404,672875,81529,554524963.0,494443091.0,60081871.0,4488,3689,799,747034,668743,78291,548979400.0,491193492.0,57785908.0,0.7348,0.7369,0.7345,0.7381
2023-09-25 13:15,2425,1161,1264,463095,166615,296480,340058726.0,121740135.0,218318591.0,2340,1115,1225,451975,159071,292904,332326524.0,116388925.0,215937599.0,0.7307,0.7364,0.7317,0.7372
2023-09-25 13:20,2330,867,1463,529438,131600,397838,389107024.0,95833749.0,293273274.0,2261,835,1426,525529,129467,396062,386474089.0,94411444.0,292062644.0,0.7282,0.7372,0.7292,0.7374
2023-09-25 13:25,3925,1240,2685,768655,143307,625348,563416397.0,104213452.0,459202944.0,3783,1172,2611,764754,144735,620019,560385530.0,104595260.0,455790269.0,0.7272,0.7343,0.7227,0.7351
2023-09-25 13:30,3108,1279,1829,434035,121036,312999,318009366.0,88616892.0,229392474.0,2880,1185,1695,414284,110911,303373,303751474.0,80994478.0,222756996.0,0.7322,0.7329,0.7303,0.7343
2023-09-25 13:35,2413,1324,1089,397190,278792,118398,290747789.0,203621621.0,87126167.0,2358,1299,1059,393604,278777,114827,288054818.0,203593484.0,84461333.0,0.7304,0.7359,0.7303,0.7356
2023-09-25 13:40,2672,1084,1588,564021,370521,193500,413141189.0,270864773.0,142276416.0,2634,1065,1569,559595,368660,190935,409761264.0,269308396.0,140452867.0,0.731,0.7353,0.7305,0.7356
2023-09-25 13:45,3214,1898,1316,626252,553687,72565,458255478.0,405028793.0,53226684.0,3158,1875,1283,619913,551049,68864,453625361.0,402971326.0,50654035.0,0.7315,0.7335,0.7313,0.7356
2023-09-25 13:50,1499,875,624,299467,275742,23725,219077630.0,201637839.0,17439790.0,1472,863,609,298610,275014,23596,218422825.0,201068807.0,17354018.0,0.7313,0.7351,0.7311,0.7355
2023-09-25 13:55,1733,959,774,260036,188056,71980,190171663.0,137598678.0,52572984.0,1660,931,729,256531,187222,69309,187835651.0,136932906.0,50902744.0,0.7317,0.7304,0.7314,0.7344
2023-09-25 14:00,1708,1055,653,308683,210227,98456,225912160.0,153638701.0,72273458.0,1652,1023,629,303255,206977,96278,222039876.0,151287374.0,70752501.0,0.7308,0.7341,0.7309,0.7349
2023-09-25 14:05,383,195,188,61747,42559,19188,45192398.0,31096612.0,14095786.0,374,195,179,62547,43377,19170,45751752.0,31648190.0,14103562.0,0.7307,0.7346,0.7296,0.7357
2023-09-25 14:10,966,525,441,163556,111598,51958,119755376.0,81578940.0,38176436.0,952,519,433,163021,111962,51059,119370633.0,81845362.0,37525270.0,0.731,0.7348,0.731,0.7349
2023-09-25 14:15,1101,606,495,209176,133689,75487,152988775.0,97651248.0,55337527.0,1070,587,483,208255,133066,75189,152412248.0,97216530.0,55195718.0,0.7304,0.7331,0.7306,0.7341
2023-09-25 14:20,507,281,226,82280,56532,25748,60360148.0,41434183.0,18925965.0,460,262,198,83492,55755,27737,61174674.0,40751804.0,20422869.0,0.7329,0.735,0.7309,0.7363
2023-09-25 14:25,1192,936,256,247381,211084,36297,181105341.0,154426334.0,26679007.0,1172,917,255,245860,210130,35730,180001070.0,153697234.0,26303836.0,0.7316,0.735,0.7314,0.7362
2023-09-25 14:30,1382,1029,353,234214,205976,28238,171745525.0,150948150.0,20797374.0,1343,1007,336,232013,204441,27572,170061160.0,149751485.0,20309674.0,0.7328,0.7365,0.7325,0.7366
2023-09-25 14:35,557,381,176,96886,82365,14521,71149965.0,60449395.0,10700569.0,532,370,162,96120,82263,13857,70468687.0,60256376.0,10212310.0,0.7339,0.7369,0.7325,0.737
2023-09-25 14:40,578,427,151,86679,74154,12525,63833621.0,54578533.0,9255088.0,528,396,132,83620,71154,12466,61528728.0,52313638.0,9215089.0,0.736,0.7389,0.7352,0.7392
2023-09-25 14:45,687,419,268,111158,82297,28861,81804806.0,60484680.0,21320125.0,645,390,255,110389,81233,29156,81209086.0,59657711.0,21551374.0,0.735,0.7387,0.7344,0.7392
2023-09-25 14:50,747,472,275,129819,80738,49081,96173575.0,59775608.0,36397966.0,675,436,239,123208,76998,46210,91063994.0,56725253.0,34338741.0,0.7404,0.7416,0.7367,0.7431
2023-09-25 14:55,1918,753,1165,327158,99812,227346,242910066.0,73897452.0,169012614.0,1856,724,1132,322574,97448,225126,239339100.0,71963917.0,167375183.0,0.7404,0.7434,0.7385,0.7435
2023-09-25 15:00,1049,455,594,124210,42491,81719,92104204.0,31424132.0,60680072.0,950,400,550,118735,40704,78031,88161445.0,30099636.0,58061809.0,0.7395,0.7425,0.7395,0.7441
2023-09-25 15:05,1155,359,796,142729,19093,123636,105962829.0,14138890.0,91823939.0,1110,339,771,141485,18903,122582,105055456.0,13982461.0,91072995.0,0.7405,0.7427,0.7397,0.743
2023-09-25 15:10,884,341,543,69881,18706,51175,51803571.0,13897786.0,37905785.0,828,314,514,66471,16809,49662,49299585.0,12421379.0,36878206.0,0.743,0.7407,0.739,0.7426
2023-09-25 15:15,720,391,329,131147,91998,39149,96555858.0,67590732.0,28965126.0,694,379,315,132171,94831,37340,97421502.0,69668751.0,27752750.0,0.7347,0.7399,0.7347,0.7432
2023-09-25 15:20,1603,553,1050,241696,97387,144309,178622424.0,71486608.0,107135816.0,1555,525,1030,238697,95718,142979,176427014.0,70258858.0,106168155.0,0.734,0.7424,0.734,0.7425
2023-09-25 15:25,2876,1583,1293,480757,303497,177260,354445399.0,223098894.0,131346505.0,2825,1550,1275,477701,301063,176638,352228686.0,221282105.0,130946581.0,0.7351,0.741,0.735,0.7413
2023-09-25 15:30,1553,909,644,203884,134205,69679,150400643.0,98802155.0,51598488.0,1515,890,625,201452,132994,68458,148668857.0,97903055.0,50765801.0,0.7362,0.7405,0.7361,0.7416
2023-09-25 15:35,1915,619,1296,248302,77891,170411,183274454.0,57283412.0,125991042.0,1866,592,1274,245252,76602,168650,181191439.0,56334980.0,124856459.0,0.7354,0.7393,0.7354,0.7403
2023-09-25 15:40,1643,238,1405,285180,32115,253065,210627587.0,23583199.0,187044388.0,1619,226,1393,282925,31151,251774,209057318.0,22876622.0,186180696.0,0.7343,0.7391,0.7344,0.7395
2023-09-25 15:45,1586,405,1181,221289,36959,184330,163506229.0,27252225.0,136254004.0,1563,394,1169,217805,34729,183076,160908726.0,25537414.0,135371312.0,0.7374,0.7392,0.7353,0.7394
2023-09-25 15:50,2231,334,1897,400967,15987,384980,296297197.0,11779064.0,284518133.0,2208,325,1883,400814,16427,384387,296191036.0,12065358.0,284125678.0,0.7368,0.739,0.7345,0.7392
2023-09-25 15:55,1495,255,1240,273012,21898,251114,201508643.0,16046099.0,185462544.0,1447,237,1210,268414,20282,248132,198246308.0,14857548.0,183388760.0,0.7328,0.7386,0.7325,0.7391
2023-09-25 16:00,3836,1413,2423,523321,99441,423880,385537700.0,72924016.0,312613684.0,3764,1375,2389,519477,98347,421130,382709182.0,72049707.0,310659475.0,0.7333,0.7375,0.7326,0.7377
2023-09-25 16:05,718,227,491,116402,18046,98356,85752730.0,13264438.0,72488291.0,692,217,475,114223,17206,97017,84149539.0,12618941.0,71530597.0,0.735,0.737,0.7334,0.7373
2023-09-25 16:10,1332,897,435,150387,70614,79773,110678278.0,51879486.0,58798792.0,1295,881,414,148097,69767,78330,108950942.0,51215235.0,57735706.0,0.7347,0.7371,0.7341,0.7371
2023-09-25 16:15,859,582,277,157772,121430,36342,115719817.0,88965495.0,26754321.0,836,572,264,157169,121045,36124,115331128.0,88682343.0,26648785.0,0.7326,0.7362,0.7326,0.7377
2023-09-25 16:20,797,603,194,80390,62069,18321,59089599.0,45552885.0,13536714.0,779,594,185,79578,61872,17706,58463346.0,45380520.0,13082825.0,0.7339,0.7389,0.7335,0.7389
2023-09-25 16:25,1801,1352,449,217291,132205,85086,159879141.0,97134020.0,62745121.0,1778,1343,435,216002,131590,84412,158944143.0,96628930.0,62315213.0,0.7347,0.7374,0.7343,0.7382
2023-09-25 16:30,750,267,483,98571,25383,73188,72598308.0,18628214.0,53970093.0,722,252,470,96792,24594,72198,71315537.0,18018131.0,53297406.0,0.7339,0.7374,0.7326,0.7382
2023-09-25 16:35,749,236,513,76509,25185,51324,56290445.0,18466447.0,37823998.0,729,227,502,77904,25880,52024,57360464.0,18975026.0,38385438.0,0.7332,0.737,0.7332,0.7378
2023-09-25 16:40,1379,386,993,152408,44810,107598,112153136.0,32850585.0,79302551.0,1355,376,979,150389,43822,106567,110651960.0,32075995.0,78575964.0,0.7331,0.737,0.732,0.7373
2023-09-25 16:45,1833,558,1275,203514,49482,154032,149432835.0,36260297.0,113172538.0,1770,523,1247,199071,47102,151969,146288671.0,34470484.0,111818186.0,0.7328,0.7347,0.7318,0.7358
2023-09-25 16:50,1986,778,1208,189652,63949,125703,139376367.0,46852973.0,92523393.0,2249,934,1315,186553,63272,123281,137031577.0,46290435.0,90741141.0,0.7327,0.736,0.7316,0.7361
2023-09-25 16:55,1036,449,587,112372,33561,78811,82494840.0,24558269.0,57936571.0,1002,433,569,112075,35518,76557,82259853.0,25923174.0,56336679.0,0.7318,0.7351,0.7299,0.7359
2023-09-25 17:00,1042,351,691,215675,43953,171722,158570866.0,32141337.0,126429528.0,1023,339,684,215937,43378,172559,158799841.0,31719251.0,127080590.0,0.7313,0.7362,0.7312,0.7364
2023-09-25 17:05,1500,617,883,221103,43738,177365,162568752.0,32008077.0,130560675.0,1491,615,876,220807,43648,177159,162326857.0,31916720.0,130410137.0,0.7318,0.7361,0.7312,0.7361
2023-09-25 17:10,614,214,400,98182,19048,79134,72203539.0,13943738.0,58259801.0,584,202,382,97422,18377,79045,71641721.0,13434892.0,58206829.0,0.732,0.7362,0.7311,0.7364
2023-09-25 17:15,1306,450,856,189961,28223,161738,139563458.0,20621505.0,118941953.0,1294,444,850,187899,27055,160844,138098273.0,19772961.0,118325311.0,0.7307,0.7354,0.7308,0.7357
2023-09-25 17:20,1276,318,958,208480,28391,180089,153219362.0,20828999.0,132390362.0,1250,306,944,206844,27011,179833,151945214.0,19736557.0,132208657.0,0.7336,0.7351,0.7307,0.7352
2023-09-25 17:25,1023,481,542,143236,69477,73759,105016673.0,50757756.0,54258916.0,1006,473,533,143588,70018,73570,105235188.0,51095013.0,54140174.0,0.7306,0.7356,0.7297,0.7359
2023-09-25 17:30,424,181,243,69351,31234,38117,50901097.0,22828257.0,28072840.0,398,170,228,66556,29537,37019,48813798.0,21549980.0,27263818.0,0.7309,0.7365,0.7296,0.7365
2023-09-25 17:35,130,36,94,22091,8230,13861,16233879.0,6015785.0,10218094.0,111,30,81,21560,7708,13852,15846487.0,5636563.0,10209923.0,0.731,0.7372,0.7313,0.7371
2023-09-25 17:40,173,25,148,24848,2802,22046,18277115.0,2050302.0,16226812.0,157,23,134,24318,3491,20827,17898812.0,2546065.0,15352746.0,0.7317,0.736,0.7293,0.7372
2023-09-25 17:45,1511,848,663,173164,97374,75790,127167540.0,71400179.0,55767361.0,1488,840,648,172368,97377,74991,126643712.0,71389777.0,55253935.0,0.7333,0.7358,0.7331,0.7368
2023-09-25 17:50,839,407,432,103320,46339,56981,75937232.0,33978125.0,41959107.0,811,396,415,101950,44952,56998,74952359.0,32946132.0,42006226.0,0.7333,0.7364,0.7329,0.737
2023-09-25 17:55,877,315,562,73279,30457,42822,54038852.0,22464239.0,31574613.0,825,298,527,66997,27005,39992,49282021.0,19793950.0,29488071.0,0.7376,0.7373,0.733,0.7373
2023-09-25 18:00,974,528,446,116334,90442,25892,85473590.0,66371424.0,19102166.0,945,517,428,113896,89874,24022,83662470.0,65926503.0,17735966.0,0.7339,0.7378,0.7335,0.7383
2023-09-25 18:05,305,203,102,41468,30469,10999,30480409.0,22364606.0,8115803.0,294,198,96,39898,29971,9927,29311562.0,21981743.0,7329818.0,0.734,0.7379,0.7334,0.7384
2023-09-25 18:10,5664,5202,462,723695,676710,46985,530932845.0,496345797.0,34587048.0,5643,5196,447,722145,677339,44806,529787799.0,496750347.0,33037452.0,0.7335,0.7361,0.7334,0.7373
2023-09-25 18:15,5060,4322,738,787835,732179,55656,577970241.0,537005742.0,40964498.0,5029,4303,726,784227,729859,54368,575337246.0,535279294.0,40057952.0,0.7334,0.736,0.7334,0.7368
2023-09-25 18:20,5091,3897,1194,778613,707954,70659,571206475.0,519168689.0,52037786.0,5071,3889,1182,777473,707481,69992,570344476.0,518775826.0,51568649.0,0.7333,0.7365,0.7333,0.7368
2023-09-25 18:25,5521,4479,1042,930716,845383,85333,683058840.0,620150656.0,62908183.0,5494,4467,1027,930883,845815,85068,683209475.0,620471131.0,62738344.0,0.7336,0.7372,0.7336,0.7375
2023-09-25 18:30,1473,1196,277,208094,193836,14258,152706644.0,142226755.0,10479889.0,1451,1187,264,206401,192842,13559,151382264.0,141380176.0,10002087.0,0.7337,0.735,0.7331,0.7377
2023-09-25 18:35,2468,1418,1050,342603,220500,122103,251434692.0,161858206.0,89576486.0,2433,1400,1033,338899,217740,121159,249036725.0,159820414.0,89216311.0,0.7341,0.7336,0.734,0.7364
2023-09-26 10:00,4701,1862,2839,418028,151574,266454,309391660.0,112454363.0,196937297.0,4084,1552,2532,379787,132762,247025,279071259.0,96949243.0,182122016.0,0.7419,0.7391,0.7302,0.7373
2023-09-26 10:05,2759,1208,1551,251585,91693,159892,184359755.0,66871785.0,117487969.0,2476,1064,1412,233779,81672,152107,171602820.0,59722230.0,111880589.0,0.7293,0.7348,0.7312,0.7355
2023-09-26 10:10,2582,1100,1482,221475,76908,144567,161913853.0,56755086.0,105158766.0,2288,919,1369,199756,65779,133977,146735709.0,48526277.0,98209431.0,0.738,0.7274,0.7377,0.733
2023-09-26 10:15,1851,865,986,140721,40600,100121,102083582.0,29312316.0,72771266.0,1482,627,855,125034,32667,92367,90868517.0,23479763.0,67388753.0,0.722,0.7268,0.7188,0.7296
2023-09-26 10:20,2922,1213,1709,329757,82673,247084,240201102.0,60065115.0,180135987.0,2679,1104,1575,317263,76224,241039,231017365.0,55250432.0,175766932.0,0.7265,0.729,0.7248,0.7292
2023-09-26 10:25,1761,805,956,109749,47555,62194,80120129.0,34716390.0,45403739.0,1581,722,859,99287,41847,57440,72462446.0,30448837.0,42013609.0,0.73,0.73,0.7276,0.7314
2023-09-26 10:30,1221,343,878,88602,11619,76983,64448712.0,8417906.0,56030806.0,1018,235,783,81311,8948,72363,59331940.0,6486321.0,52845619.0,0.7245,0.7278,0.7249,0.7303
2023-09-26 10:35,1735,946,789,125329,62951,62378,91100587.0,45815428.0,45285158.0,1581,875,706,115977,57660,58317,84326853.0,41825417.0,42501435.0,0.7278,0.726,0.7254,0.7288
2023-09-26 10:40,1456,717,739,107937,45443,62494,78309531.0,32964235.0,45345295.0,1329,633,696,97577,39910,57667,70818647.0,28837403.0,41981244.0,0.7254,0.7256,0.7226,0.728
2023-09-26 10:45,1376,1046,330,81763,45467,36296,59285786.0,32905223.0,26380563.0,1319,1012,307,79790,44723,35067,57866394.0,32360427.0,25505967.0,0.7237,0.7268,0.7236,0.7273
2023-09-26 10:50,1287,758,529,96413,35579,60834,70202503.0,25886907.0,44315595.0,1216,715,501,94930,35936,58994,68951968.0,25997106.0,42954861.0,0.7276,0.7285,0.7234,0.7281
2023-09-26 10:55,695,465,230,46404,22155,24249,33778243.0,16106067.0,17672176.0,573,376,197,41896,19518,22378,30544892.0,14166256.0,16378636.0,0.727,0.7288,0.7258,0.7319
2023-09-26 11:00,1591,503,1088,98290,30473,67817,71544501.0,22217905.0,49326596.0,1533,480,1053,94978,29815,65163,69204512.0,21687193.0,47517319.0,0.7291,0.7273,0.7274,0.7292
2023-09-26 11:05,964,262,702,89642,10932,78710,65140821.0,7966081.0,57174740.0,878,205,673,82597,7233,75364,60183098.0,5244106.0,54938992.0,0.7287,0.7264,0.725,0.729
2023-09-26 11:10,1548,408,1140,140925,25924,115001,101871640.0,18760149.0,83111490.0,1435,354,1081,126776,21431,105345,92011366.0,15493476.0,76517890.0,0.7237,0.7227,0.7229,0.7264
2023-09-26 11:15,654,375,279,61386,25046,36340,44496939.0,18109396.0,26387543.0,602,290,312,54109,20098,34011,40389715.0,15658701.0,24731014.0,0.723,0.7261,0.7791,0.7271
2023-09-26 11:20,3421,894,2527,503960,60343,443617,363034395.0,43337111.0,319697284.0,3037,610,2427,474465,47699,426766,342267881.0,34009607.0,308258273.0,0.7182,0.7207,0.713,0.7223
2023-09-26 11:25,2847,1472,1375,360150,199108,161042,259049055.0,142872890.0,116176165.0,2516,1304,1212,338433,188987,149446,243261827.0,135212986.0,108048840.0,0.7176,0.7214,0.7155,0.723
2023-09-26 11:30,3123,1333,1790,272909,80644,192265,196701749.0,58777604.0,137924144.0,2700,1071,1629,242510,59724,182786,174045953.0,42392618.0,131653335.0,0.7289,0.7174,0.7098,0.7203
2023-09-26 11:35,3023,1316,1707,477598,88220,389378,342827840.0,63143422.0,279684418.0,2843,1199,1644,467901,83943,383958,337041109.0,61137455.0,275903654.0,0.7157,0.7183,0.7283,0.7186
2023-09-26 11:40,2866,1263,1603,287178,110328,176850,206773272.0,79457095.0,127316177.0,2688,1191,1497,278285,108079,170206,199712014.0,77010056.0,122701958.0,0.7202,0.7199,0.7125,0.7209
2023-09-26 11:45,1523,712,811,136263,65132,71131,97878613.0,46517692.0,51360920.0,1525,748,777,127202,58386,68816,91549425.0,41815387.0,49734037.0,0.7142,0.7221,0.7162,0.7227
2023-09-26 11:50,1770,1041,729,205885,83555,122330,147799184.0,59791012.0,88008171.0,1648,965,683,200965,82035,118930,144424254.0,58710653.0,85713600.0,0.7156,0.7194,0.7157,0.7207
2023-09-26 11:55,2681,1075,1606,447493,78464,369029,321265597.0,56185054.0,265080542.0,2597,1020,1577,440635,74558,366077,316420024.0,53265970.0,263154054.0,0.7161,0.7183,0.7144,0.7188
2023-09-26 12:00,1916,1230,686,159463,62200,97263,114485576.0,44770031.0,69715545.0,1786,1156,630,154602,59180,95422,110801660.0,42248510.0,68553149.0,0.7198,0.7168,0.7139,0.7184
2023-09-26 12:05,1841,1120,721,221480,130802,90678,158859304.0,93722175.0,65137129.0,1727,1071,656,212095,125257,86838,152060082.0,89546801.0,62513281.0,0.7165,0.7183,0.7149,0.7199
2023-09-26 12:10,2376,1416,960,298042,176503,121539,214767854.0,126820199.0,87947655.0,2329,1405,924,291922,174380,117542,210060601.0,124931907.0,85128693.0,0.7185,0.7236,0.7164,0.7242
2023-09-26 12:15,3189,2219,970,490021,406632,83389,352697285.0,292361819.0,60335466.0,2994,2104,890,478499,400723,77776,344250548.0,287908078.0,56342469.0,0.719,0.7235,0.7185,0.7244
2023-09-26 12:20,1210,552,658,114401,58143,56258,82501120.0,41880194.0,40620926.0,1134,509,625,106987,54921,52066,77214325.0,39535824.0,37678501.0,0.7203,0.722,0.7199,0.7237
2023-09-26 12:25,1537,566,971,241673,33360,208313,174598766.0,24007213.0,150591553.0,1436,518,918,236163,30872,205291,170690321.0,22151563.0,148538757.0,0.7196,0.7229,0.7175,0.7236
2023-09-26 12:30,678,238,440,159470,17050,142420,115282230.0,12313799.0,102968430.0,632,218,414,157465,15680,141785,113808576.0,11238279.0,102570296.0,0.7222,0.723,0.7167,0.7234
2023-09-26 12:35,1592,919,673,227496,122919,104577,164259625.0,88539198.0,75720426.0,1569,911,658,231816,126027,105789,167176279.0,90563840.0,76612438.0,0.7203,0.7241,0.7186,0.7242
2023-09-26 12:40,983,454,529,105900,39443,66457,76189837.0,28064673.0,48125163.0,947,435,512,100148,34466,65682,72400336.0,24828535.0,47571801.0,0.7115,0.7242,0.7204,0.7243
2023-09-26 12:45,2488,883,1605,464148,81989,382159,335048532.0,58568547.0,276479984.0,2385,868,1517,462064,82104,379960,333675757.0,58683628.0,274992128.0,0.7143,0.7235,0.7147,0.7237
2023-09-26 12:50,1611,467,1144,299104,38132,260972,215913243.0,27352861.0,188560381.0,1568,448,1120,295392,36522,258870,213318577.0,26222712.0,187095865.0,0.7173,0.7225,0.718,0.7227
2023-09-26 12:55,990,273,717,224899,40717,184182,162258753.0,29207740.0,133051013.0,961,253,708,222419,39609,182810,160519477.0,28420235.0,132099242.0,0.7173,0.7224,0.7175,0.7226
2023-09-26 13:00,807,157,650,169018,14846,154172,121970039.0,10644294.0,111325745.0,794,149,645,167527,13570,153957,120947650.0,9732456.0,111215193.0,0.717,0.7221,0.7172,0.7224
2023-09-26 13:05,1416,630,786,222944,39682,183262,160478672.0,28276912.0,132201760.0,1375,605,770,216460,35292,181168,156047511.0,25218827.0,130828684.0,0.7126,0.7214,0.7146,0.7221
2023-09-26 13:10,2649,1152,1497,460889,162634,298255,332589813.0,117007892.0,215581921.0,2603,1132,1471,457784,160658,297126,330283733.0,115509744.0,214773989.0,0.7195,0.7228,0.719,0.7228
2023-09-26 13:15,1683,826,857,252795,69705,183090,182511858.0,50136493.0,132375365.0,1669,816,853,252644,69416,183228,182434704.0,49933747.0,132500957.0,0.7193,0.723,0.7193,0.7231
2023-09-26 13:20,1497,976,521,209301,88067,121234,151159043.0,63480891.0,87678152.0,1476,971,505,211424,88593,122831,152593423.0,63729697.0,88863726.0,0.7208,0.7232,0.7194,0.7235
2023-09-26 13:25,1675,790,885,246428,74493,171935,177674725.0,53545576.0,124129148.0,1656,782,874,247331,75051,172280,178408041.0,53947665.0,124460376.0,0.7188,0.722,0.7188,0.7224
2023-09-26 13:30,1262,932,330,154013,115121,38892,110934016.0,82830510.0,28103505.0,1226,915,311,150595,112883,37712,108416833.0,81159580.0,27257252.0,0.7195,0.7226,0.719,0.7228
2023-09-26 13:35,931,617,314,215854,194884,20970,155236530.0,140081568.0,15154962.0,911,605,306,213352,193280,20072,153413695.0,138890016.0,14523679.0,0.7188,0.7227,0.7186,0.7236
2023-09-26 13:40,764,636,128,124162,116236,7926,89614646.0,83840495.0,5774150.0,713,610,103,119279,113577,5702,85888581.0,81740103.0,4148478.0,0.7213,0.7285,0.7197,0.7275
2023-09-26 13:45,1080,722,358,258003,243102,14901,185226424.0,174463284.0,10763140.0,1058,709,349,259649,244541,15108,186449669.0,175511634.0,10938034.0,0.7177,0.7223,0.7177,0.724
2023-09-26 13:50,1141,819,322,130215,103994,26221,93739613.0,74879313.0,18860300.0,1118,804,314,127311,102748,24563,91767590.0,73972968.0,17794622.0,0.72,0.7193,0.7199,0.7244
2023-09-26 13:55,320,199,121,49660,41318,8342,35755102.0,29714402.0,6040699.0,297,187,110,48606,40500,8106,34999360.0,29126289.0,5873070.0,0.7192,0.7241,0.7192,0.7245
2023-09-26 14:00,1249,919,330,319904,288582,31322,230377681.0,207679133.0,22698547.0,1231,910,321,318486,287577,30909,229356495.0,206955744.0,22400751.0,0.7197,0.7247,0.7197,0.7247
2023-09-26 14:05,470,361,109,99571,95659,3912,71783999.0,68954189.0,2829810.0,454,350,104,99248,95529,3719,71465690.0,68774416.0,2691273.0,0.7208,0.7234,0.7199,0.7237
2023-09-26 14:10,2317,1926,391,416182,392480,23702,299910405.0,282744349.0,17166056.0,2272,1901,371,414921,391631,23290,298955685.0,282068750.0,16886935.0,0.7204,0.7242,0.7202,0.7251
2023-09-26 14:15,503,340,163,36795,26449,10346,26603812.0,19091120.0,7512691.0,473,327,146,35278,25599,9679,25505410.0,18477534.0,7027876.0,0.7218,0.7261,0.7218,0.7261
2023-09-26 14:20,1262,804,458,124726,81734,42992,90243502.0,59048024.0,31195478.0,1229,791,438,121056,80149,40907,87595198.0,57895928.0,29699269.0,0.7224,0.7256,0.7224,0.726
2023-09-26 14:25,2698,662,2036,341549,57979,283570,246808619.0,41808176.0,205000442.0,2612,617,1995,331755,51810,279945,239705777.0,37285500.0,202420277.0,0.7211,0.7229,0.7197,0.7231
2023-09-26 14:30,1108,517,591,90189,42565,47624,65079396.0,30632752.0,34446644.0,1085,502,583,91065,43492,47573,65700706.0,31261780.0,34438926.0,0.7197,0.7233,0.7188,0.7239
2023-09-26 14:35,1083,184,899,164297,18768,145529,118632718.0,13478190.0,105154528.0,1048,159,889,162825,18246,144579,117634995.0,13103507.0,104531487.0,0.7181,0.7226,0.7182,0.723
2023-09-26 14:40,664,245,419,67779,23883,43896,48967897.0,17198341.0,31769555.0,628,225,403,66238,23279,42959,47843296.0,16753114.0,31090181.0,0.7201,0.7237,0.7197,0.7237
2023-09-26 14:45,1067,908,159,60386,42961,17425,43566290.0,30997666.0,12568623.0,1052,902,150,57950,42541,15409,41834990.0,30674289.0,11160701.0,0.7215,0.7213,0.7211,0.7243
2023-09-26 14:50,936,373,563,82722,30286,52436,59732869.0,21821717.0,37911152.0,922,367,555,83398,30655,52743,60240927.0,22086552.0,38154375.0,0.7205,0.723,0.7205,0.7234
2023-09-26 14:55,925,258,667,67203,24508,42695,48376439.0,17591150.0,30785289.0,900,252,648,66263,25256,41007,47773122.0,18119944.0,29653177.0,0.7178,0.7211,0.7175,0.7231
2023-09-26 15:00,3032,1420,1612,439015,247255,191760,316183418.0,177567169.0,138616248.0,3018,1415,1603,438995,247001,191994,316121645.0,177330550.0,138791095.0,0.7182,0.7229,0.7179,0.7229
2023-09-26 15:05,390,160,230,57807,19644,38163,41680995.0,14128314.0,27552681.0,361,145,216,56024,18969,37055,40407479.0,13607231.0,26800248.0,0.7192,0.722,0.7173,0.7233
2023-09-26 15:10,388,145,243,62454,19408,43046,45053996.0,13942101.0,31111894.0,350,121,229,61479,18659,42820,44327284.0,13379514.0,30947770.0,0.7184,0.7228,0.7171,0.7227
2023-09-26 15:15,1188,405,783,121716,41647,80069,87811681.0,29945828.0,57865852.0,1171,399,772,119193,40138,79055,85989976.0,28792179.0,57197796.0,0.719,0.7227,0.7173,0.7235
2023-09-26 15:20,822,306,516,173775,52085,121690,125499223.0,37406202.0,88093021.0,803,295,508,172807,51839,120968,124785053.0,37216224.0,87568828.0,0.7182,0.7239,0.7179,0.7239
2023-09-26 15:25,2014,710,1304,270243,111318,158925,195399699.0,80347706.0,115051993.0,1982,691,1291,266964,108980,157984,192728586.0,78359201.0,114369384.0,0.7218,0.7239,0.719,0.7239
2023-09-26 15:30,836,311,525,99937,69204,30733,71977067.0,49755252.0,22221815.0,812,299,513,99026,68879,30147,71335527.0,49484884.0,21850642.0,0.719,0.7231,0.7184,0.7248
2023-09-26 15:35,347,128,219,32199,12111,20088,23331007.0,8758599.0,14572408.0,290,97,193,26844,8578,18266,19427865.0,6164585.0,13263279.0,0.7232,0.7254,0.7187,0.7261
2023-09-26 15:40,258,153,105,30507,19112,11395,22044186.0,13805232.0,8238953.0,229,136,93,29307,18266,11041,21203327.0,13175151.0,8028176.0,0.7223,0.723,0.7213,0.7271
2023-09-26 15:45,1334,505,829,99911,50929,48982,71964663.0,36672380.0,35292282.0,1287,489,798,94228,49342,44886,68040827.0,35513621.0,32527205.0,0.7201,0.7205,0.7197,0.7247
2023-09-26 15:50,1265,547,718,103594,49278,54316,74771512.0,35528482.0,39243030.0,1228,523,705,100746,47755,52991,72719345.0,34358556.0,38360789.0,0.721,0.7225,0.7195,0.7239
2023-09-26 15:55,1731,720,1011,221700,89479,132221,160199246.0,64471556.0,95727690.0,1686,688,998,220569,88564,132005,159334475.0,63744956.0,95589519.0,0.7205,0.724,0.7198,0.7241
2023-09-26 16:00,1933,746,1187,307192,103002,204190,222036959.0,74079334.0,147957625.0,1918,741,1177,307151,103750,203401,222000360.0,74611664.0,147388696.0,0.7192,0.7246,0.7191,0.7246
2023-09-26 16:05,388,275,113,31896,16746,15150,23013311.0,12050063.0,10963247.0,371,266,105,31147,16196,14951,22487056.0,11654593.0,10832462.0,0.7196,0.7236,0.7196,0.7245
2023-09-26 16:10,1764,714,1050,188156,71970,116186,136015066.0,51840743.0,84174322.0,1752,706,1046,188232,71248,116984,136033208.0,51276185.0,84757022.0,0.7203,0.7245,0.7197,0.7245
2023-09-26 16:15,1890,956,934,216699,100543,116156,156683693.0,72487345.0,84196347.0,1867,946,921,214912,99995,114917,155306504.0,72003233.0,83303271.0,0.721,0.7249,0.7201,0.7249
2023-09-26 16:20,3411,2261,1150,486876,397631,89245,351264615.0,286565496.0,64699119.0,3384,2248,1136,485393,396874,88519,350235184.0,285992511.0,64242673.0,0.7207,0.725,0.7206,0.7258
2023-09-26 16:25,1848,1324,524,213575,152612,60963,154164097.0,109958128.0,44205969.0,1830,1313,517,212152,151906,60246,153150448.0,109443902.0,43706546.0,0.7205,0.7251,0.7205,0.7255
2023-09-26 16:30,812,581,231,89961,71001,18960,64974356.0,51211551.0,13762805.0,810,581,229,89678,70754,18924,64766286.0,51029932.0,13736354.0,0.7213,0.7259,0.7212,0.7259
2023-09-26 16:35,1241,638,603,170524,81449,89075,123269057.0,58669996.0,64599060.0,1218,628,590,169025,81326,87699,122222883.0,58582442.0,63640440.0,0.7203,0.7252,0.7203,0.7257
2023-09-26 16:40,403,165,238,56233,16207,40026,40669059.0,11650449.0,29018610.0,381,149,232,54977,15519,39458,39762585.0,11140782.0,28621802.0,0.7189,0.725,0.7179,0.7254
2023-09-26 16:45,827,388,439,104206,26244,77962,75430246.0,18922885.0,56507361.0,802,373,429,102440,25410,77030,74127266.0,18296093.0,55831172.0,0.721,0.7248,0.72,0.7248
2023-09-26 16:50,1155,497,658,178802,65566,113236,129262691.0,47178784.0,82083907.0,1141,491,650,177199,65263,111936,128127518.0,46960194.0,81167323.0,0.7196,0.7249,0.7196,0.7251
2023-09-26 16:55,463,135,328,56556,7325,49231,40941847.0,5295014.0,35646833.0,442,121,321,54410,6271,48139,39378519.0,4516111.0,34862407.0,0.7229,0.7241,0.7202,0.7242
2023-09-26 17:00,478,150,328,69069,16631,52438,49912543.0,11944619.0,37967923.0,456,131,325,68553,16258,52295,49552882.0,11677935.0,37874946.0,0.7182,0.7241,0.7183,0.7243
2023-09-26 17:05,2032,930,1102,237147,124912,112235,171218821.0,89896223.0,81322597.0,2000,912,1088,234550,123365,111185,169279609.0,88714336.0,80565273.0,0.7197,0.7246,0.7191,0.7246
2023-09-26 17:10,1600,1004,596,116654,77454,39200,84323589.0,55919826.0,28403763.0,1552,985,567,111555,76078,35477,80563938.0,54858463.0,25705474.0,0.722,0.7246,0.7211,0.7246
2023-09-26 17:15,1075,346,729,47100,13961,33139,33957183.0,10093815.0,23863368.0,1037,325,712,43982,12685,31297,31768946.0,9149328.0,22619618.0,0.723,0.7201,0.7213,0.7227
2023-09-26 17:20,659,366,293,58867,29411,29456,42709062.0,21367986.0,21341075.0,641,358,283,55985,27732,28253,40438288.0,19987313.0,20450975.0,0.7265,0.7245,0.7207,0.7239
2023-09-26 17:25,595,332,263,53492,29138,24354,38724334.0,21096017.0,17628316.0,557,312,245,49663,27351,22312,35872405.0,19701801.0,16170604.0,0.724,0.7238,0.7203,0.7247
2023-09-26 17:30,8695,8135,560,1562581,1531650,30931,1123908815.0,1101513993.0,22394822.0,8644,8099,545,1560423,1531396,29027,1121683349.0,1100658599.0,21024749.0,0.7192,0.724,0.7187,0.7243
2023-09-26 17:35,937,657,280,101928,81014,20914,73671814.0,58486327.0,15185487.0,893,636,257,99267,80116,19151,71666348.0,57762067.0,13904281.0,0.7219,0.7261,0.721,0.726
2023-09-26 17:40,966,732,234,110285,87302,22983,79554547.0,62953926.0,16600620.0,941,715,226,108255,86194,22061,78130772.0,62139171.0,15991600.0,0.7211,0.7223,0.7209,0.7249
2023-09-26 17:45,1093,709,384,95756,73554,22202,71342336.0,55214966.0,16127370.0,1058,685,373,94208,72509,21699,68736790.0,52956587.0,15780203.0,0.7507,0.7264,0.7303,0.7272
2023-09-26 17:50,592,410,182,58261,47119,11142,42199665.0,34115275.0,8084390.0,560,385,175,56938,45821,11117,41149053.0,33066602.0,8082450.0,0.724,0.7256,0.7216,0.727
2023-09-26 17:55,796,526,270,79012,65036,13976,57163756.0,47039728.0,10124027.0,758,510,248,75250,63252,11998,54385094.0,45676880.0,8708214.0,0.7233,0.7244,0.7221,0.7258
2023-09-26 18:00,548,434,114,81319,66721,14598,58865297.0,48287480.0,10577817.0,527,422,105,82490,66434,16056,59598743.0,47910954.0,11687788.0,0.7237,0.7246,0.7212,0.7279
2023-09-26 18:05,861,723,138,90070,71826,18244,65484597.0,52192604.0,13291993.0,829,703,126,85616,69590,16026,62011308.0,50331287.0,11680020.0,0.7267,0.7286,0.7233,0.7288
2023-09-26 18:10,1473,976,497,182001,137672,44329,131731093.0,99618289.0,32112804.0,1435,958,477,180812,137008,43804,130971149.0,99118375.0,31852774.0,0.7236,0.7244,0.7234,0.7272
2023-09-26 18:15,1631,558,1073,169383,33228,136155,124023212.0,25388665.0,98634547.0,1600,539,1061,167588,32946,134642,124202869.0,26527049.0,97675820.0,0.7641,0.7244,0.8052,0.7254
2023-09-26 18:20,1441,323,1118,222054,14851,207203,161142935.0,10724919.0,150418016.0,1412,310,1102,220752,14252,206500,160198099.0,10288401.0,149909698.0,0.7222,0.7259,0.7219,0.726
2023-09-26 18:25,4261,1166,3095,605596,59404,546192,438338959.0,42884476.0,395454482.0,4230,1151,3079,604155,59125,545030,437438297.0,42666234.0,394772063.0,0.7219,0.724,0.7216,0.7243
2023-09-26 18:30,4167,704,3463,741290,25078,716212,536453732.0,18049879.0,518403853.0,4129,673,3456,738517,24128,714389,534616805.0,17358195.0,517258610.0,0.7197,0.7238,0.7194,0.7241
2023-09-26 18:35,3457,424,3033,805710,24533,781177,582983599.0,17607851.0,565375747.0,3397,375,3022,802885,23264,779621,581040383.0,16688923.0,564351459.0,0.7177,0.7237,0.7174,0.7239
2023-09-27 10:00,7876,5175,2701,883895,611725,272170,643257642.0,444074463.0,199183178.0,7153,4855,2298,828273,585171,243102,601712037.0,424163295.0,177548742.0,0.7259,0.7318,0.7249,0.7303
2023-09-27 10:05,2131,1134,997,151462,98005,53457,111075224.0,72007438.0,39067786.0,1825,996,829,137527,90500,47027,100339271.0,65821492.0,34517779.0,0.7347,0.7308,0.7273,0.734
2023-09-27 10:10,1557,663,894,95816,33351,62465,69742385.0,24314559.0,45427825.0,1325,579,746,73785,24163,49622,53949602.0,17574323.0,36375279.0,0.7291,0.7273,0.7273,0.733
2023-09-27 10:15,770,435,335,58595,32984,25611,42919816.0,24080971.0,18838845.0,663,396,267,54667,31601,23066,39892509.0,22943476.0,16949032.0,0.7301,0.7356,0.726,0.7348
2023-09-27 10:20,1376,691,685,101194,68803,32391,73989104.0,50212614.0,23776490.0,1334,630,704,95369,66545,28824,69645271.0,48470352.0,21174919.0,0.7298,0.734,0.7284,0.7346
2023-09-27 10:25,1410,699,711,105396,58962,46434,77093523.0,43154721.0,33938802.0,1251,635,616,95310,54474,40836,69739332.0,39763969.0,29975363.0,0.7319,0.7309,0.73,0.734
2023-09-27 10:30,1197,657,540,122372,78700,43672,89587195.0,57437332.0,32149862.0,1102,620,482,117936,76765,41171,86278787.0,55950308.0,30328478.0,0.7298,0.7362,0.7289,0.7366
2023-09-27 10:35,913,565,348,41679,23970,17709,30487694.0,17491913.0,12995781.0,859,526,333,39140,22724,16416,28662569.0,16599618.0,12062951.0,0.7297,0.7339,0.7305,0.7348
2023-09-27 10:40,1183,705,478,99799,61717,38082,73261595.0,45183129.0,28078466.0,1102,660,442,94870,59242,35628,69512180.0,43232219.0,26279960.0,0.7321,0.7373,0.7298,0.7376
2023-09-27 10:45,1337,830,507,148148,113254,34894,108168306.0,82657800.0,25510505.0,1274,805,469,145429,112397,33032,106243883.0,82025888.0,24217995.0,0.7298,0.7311,0.7298,0.7332
2023-09-27 10:50,630,270,360,45582,25470,20112,33332257.0,18590558.0,14741699.0,561,248,313,44175,24685,19490,32278508.0,18003046.0,14275461.0,0.7299,0.733,0.7293,0.7325
2023-09-27 10:55,1076,769,307,67988,46620,21368,49658355.0,34033130.0,15625224.0,1002,745,257,65995,45632,20363,48236681.0,33301829.0,14934852.0,0.73,0.7312,0.7298,0.7334
2023-09-27 11:00,1024,568,456,80962,53693,27269,59241125.0,39161663.0,20079462.0,921,553,368,77497,53034,24463,56679637.0,38679459.0,18000178.0,0.7294,0.7363,0.7293,0.7358
2023-09-27 11:05,1006,566,440,79167,53051,26116,57825008.0,38666301.0,19158706.0,970,547,423,79057,53559,25498,57788177.0,39035884.0,18752292.0,0.7289,0.7336,0.7288,0.7354
2023-09-27 11:10,486,130,356,25551,10359,15192,18631253.0,7553394.0,11077858.0,439,104,335,20657,9432,11225,15086621.0,6871174.0,8215447.0,0.7292,0.7292,0.7285,0.7319
2023-09-27 11:15,621,220,401,52963,34461,18502,38521369.0,24991868.0,13529501.0,582,196,386,55439,32024,23415,40554654.0,23294827.0,17259827.0,0.7252,0.7312,0.7274,0.7371
2023-09-27 11:20,704,547,157,38696,27515,11181,28493075.0,20272101.0,8220974.0,634,516,118,30461,23640,6821,22230826.0,17231296.0,4999530.0,0.7368,0.7353,0.7289,0.733
2023-09-27 11:25,607,367,240,46905,33669,13236,34324661.0,24609409.0,9715251.0,566,354,212,45357,32556,12801,33183631.0,23779532.0,9404098.0,0.7309,0.734,0.7304,0.7346
2023-09-27 11:30,794,502,292,70632,54720,15912,51326028.0,39752130.0,11573898.0,765,483,282,69389,52592,16797,50634728.0,38302280.0,12332448.0,0.7265,0.7274,0.7283,0.7342
2023-09-27 11:35,944,690,254,135388,106016,29372,99194446.0,77552069.0,21642377.0,911,677,234,136655,105863,30792,100083822.0,77356853.0,22726968.0,0.7315,0.7368,0.7307,0.7381
2023-09-27 11:40,989,601,388,113497,72685,40812,82640866.0,52696187.0,29944678.0,956,599,357,105455,70018,35437,77062021.0,51056660.0,26005360.0,0.725,0.7337,0.7292,0.7338
2023-09-27 11:45,555,266,289,44408,19603,24805,32382723.0,14292513.0,18090209.0,514,246,268,44379,19055,25324,32426608.0,13886029.0,18540579.0,0.7291,0.7293,0.7287,0.7321
2023-09-27 11:50,737,339,398,41803,18300,23503,30569965.0,13360673.0,17209292.0,710,324,386,41221,18003,23218,30140185.0,13138834.0,17001351.0,0.7301,0.7322,0.7298,0.7322
2023-09-27 11:55,485,195,290,47567,30500,17067,34761653.0,22244710.0,12516942.0,456,182,274,44205,28196,16009,32265176.0,20531526.0,11733650.0,0.7293,0.7334,0.7282,0.7329
2023-09-27 12:00,340,192,148,27490,12573,14917,20130658.0,9173300.0,10957357.0,299,173,126,26151,12525,13626,19099187.0,9100004.0,9999183.0,0.7296,0.7346,0.7265,0.7338
2023-09-27 12:05,679,379,300,73943,41857,32086,54046066.0,30528873.0,23517193.0,636,362,274,72977,42030,30947,53380253.0,30652600.0,22727652.0,0.7294,0.7329,0.7293,0.7344
2023-09-27 12:10,1564,1090,474,180744,139265,41479,132041978.0,101667516.0,30374462.0,1542,1073,469,179122,138597,40525,130844240.0,101136012.0,29708228.0,0.73,0.7323,0.7297,0.7331
2023-09-27 12:15,813,639,174,90971,75792,15179,66460127.0,55315777.0,11144349.0,786,636,150,89047,75765,13282,65025114.0,55279393.0,9745720.0,0.7298,0.7342,0.7296,0.7338
2023-09-27 12:20,1653,1162,491,165429,112697,52732,124597083.0,85606477.0,38990605.0,1415,1031,384,136818,94786,42032,101841382.0,70646084.0,31195297.0,0.7596,0.7394,0.7453,0.7422
2023-09-27 12:25,1173,439,734,74885,29107,45778,55097344.0,21462679.0,33634665.0,1002,355,647,69228,26630,42598,52264342.0,20847846.0,31416495.0,0.7374,0.7347,0.7829,0.7375
2023-09-27 12:30,608,266,342,45923,28204,17719,33637494.0,20645569.0,12991924.0,524,218,306,40511,25481,15030,29681075.0,18609194.0,11071880.0,0.732,0.7332,0.7303,0.7367
2023-09-27 12:35,993,554,439,79469,46295,33174,58770422.0,34190529.0,24579893.0,853,474,379,64941,37997,26944,47888600.0,27939305.0,19949294.0,0.7385,0.7409,0.7353,0.7404
2023-09-27 12:40,996,403,593,74820,36475,38345,55185482.0,26913907.0,28271574.0,895,372,523,70105,35011,35094,51711833.0,25764295.0,25947538.0,0.7379,0.7373,0.7359,0.7394
2023-09-27 12:45,1508,1023,485,157657,109356,48301,116599702.0,80756103.0,35843598.0,1378,957,421,152923,112598,40325,112817617.0,82916613.0,29901004.0,0.7385,0.7421,0.7364,0.7415
2023-09-27 12:50,903,538,365,75904,43359,32545,55790445.0,31875440.0,23915004.0,837,513,324,74577,44798,29779,54519603.0,32530340.0,21989262.0,0.7352,0.7348,0.7262,0.7384
2023-09-27 12:55,414,172,242,26115,8820,17295,19283935.0,6475248.0,12808686.0,376,151,225,24708,9001,15707,18235633.0,6596619.0,11639014.0,0.7342,0.7406,0.7329,0.741
2023-09-27 13:00,646,185,461,76115,22889,53226,55961048.0,16796000.0,39165047.0,616,165,451,74528,21607,52921,54796391.0,15821844.0,38974546.0,0.7338,0.7358,0.7323,0.7365
2023-09-27 13:05,542,234,308,95542,37320,58222,70192143.0,27321714.0,42870429.0,527,229,298,91078,35923,55155,66915864.0,26292930.0,40622934.0,0.7321,0.7363,0.7319,0.7365
2023-09-27 13:10,404,168,236,37609,19378,18231,27573020.0,14176696.0,13396323.0,384,157,227,37253,19024,18229,27324693.0,13919226.0,13405466.0,0.7316,0.7348,0.7317,0.7354
2023-09-27 13:15,559,225,334,46612,17485,29127,34055328.0,12825945.0,21229382.0,503,193,310,42624,15568,27056,31269402.0,11389786.0,19879616.0,0.7335,0.7289,0.7316,0.7348
2023-09-27 13:20,909,651,258,72263,45429,26834,53072544.0,33378374.0,19694170.0,873,636,237,67295,42772,24523,49430345.0,31373752.0,18056593.0,0.7347,0.7339,0.7335,0.7363
2023-09-27 13:25,335,141,194,23603,9648,13955,17268971.0,7069944.0,10199027.0,304,128,176,22901,9016,13885,16823158.0,6605985.0,10217173.0,0.7328,0.7309,0.7327,0.7358
2023-09-27 13:30,326,192,134,26250,15620,10630,19207750.0,11456691.0,7751058.0,300,180,120,24252,14148,10104,17808706.0,10372986.0,7435719.0,0.7335,0.7292,0.7332,0.7359
2023-09-27 13:35,809,365,444,100648,62511,38137,73763887.0,45786912.0,27976974.0,781,348,433,97404,60763,36641,71435082.0,44496545.0,26938537.0,0.7325,0.7336,0.7323,0.7352
2023-09-27 13:40,746,438,308,70029,32745,37284,51267393.0,24034863.0,27232530.0,676,398,278,65767,27649,38118,48348898.0,20213707.0,28135190.0,0.734,0.7304,0.7311,0.7381
2023-09-27 13:45,1103,567,536,109863,64321,45542,80849889.0,47349477.0,33500412.0,1050,540,510,108524,63175,45349,79641411.0,46285477.0,33355933.0,0.7361,0.7356,0.7327,0.7355
2023-09-27 13:50,1733,1128,605,210379,140682,69697,154627245.0,103213058.0,51414187.0,1681,1109,572,207882,139126,68756,152727201.0,102012447.0,50714754.0,0.7337,0.7377,0.7332,0.7376
2023-09-27 13:55,1417,1061,356,126494,85191,41303,92928065.0,62563432.0,30364632.0,1361,1030,331,122315,82670,39645,89945639.0,60699418.0,29246220.0,0.7344,0.7352,0.7342,0.7377
2023-09-27 14:00,348,66,282,21576,7105,14471,15879451.0,5224075.0,10655376.0,325,58,267,19856,6476,13380,14603130.0,4743891.0,9859238.0,0.7353,0.7363,0.7325,0.7369
2023-09-27 14:05,419,138,281,68147,26300,41847,50191559.0,19303900.0,30887659.0,404,129,275,67352,25459,41893,49596064.0,18671552.0,30924512.0,0.734,0.7381,0.7334,0.7382
2023-09-27 14:10,1316,651,665,268606,184495,84111,197300738.0,135296839.0,62003899.0,1293,639,654,266611,184194,82417,195869950.0,135066285.0,60803665.0,0.7333,0.7372,0.7333,0.7378
2023-09-27 14:15,518,119,399,59091,17599,41492,43397807.0,12912152.0,30485654.0,498,110,388,58180,17051,41129,42826141.0,12506897.0,30319243.0,0.7337,0.7347,0.7335,0.7372
2023-09-27 14:20,2746,822,1924,490640,176787,313853,360989923.0,129668639.0,231321283.0,2725,816,1909,490246,176905,313341,360725906.0,129749005.0,230976900.0,0.7335,0.737,0.7334,0.7371
2023-09-27 14:25,2828,841,1987,413467,162182,251285,304016449.0,118940254.0,185076194.0,2823,839,1984,414971,162077,252894,305213076.0,118865367.0,186347709.0,0.7334,0.7365,0.7334,0.7369
2023-09-27 14:30,1687,832,855,224425,103323,121102,165012281.0,75772504.0,89239777.0,1648,808,840,223593,103390,120203,164392137.0,75811401.0,88580735.0,0.7334,0.7369,0.7333,0.7369
2023-09-27 14:35,1172,744,428,147408,88155,59253,108402801.0,64719352.0,43683449.0,1152,731,421,146747,87459,59288,107891495.0,64181819.0,43709676.0,0.7342,0.7372,0.7339,0.7372
2023-09-27 14:40,1040,707,333,192960,174048,18912,141713533.0,127762427.0,13951105.0,1010,692,318,190682,172786,17896,140003153.0,126807483.0,13195669.0,0.7341,0.7377,0.7339,0.7374
2023-09-27 14:45,300,61,239,10654,3275,7379,7847964.0,2409151.0,5438813.0,278,45,233,10396,2985,7411,7656605.0,2193594.0,5463011.0,0.7356,0.7371,0.7349,0.7371
2023-09-27 14:50,468,276,192,49256,35680,13576,36265721.0,26254210.0,10011510.0,436,253,183,47572,33203,14369,34989759.0,24378852.0,10610907.0,0.7358,0.7374,0.7342,0.7385
2023-09-27 14:55,367,162,205,16845,9495,7350,12481158.0,7046657.0,5434501.0,324,142,182,12964,7956,5008,9561744.0,5861018.0,3700726.0,0.7421,0.7394,0.7367,0.739
2023-09-27 15:00,2602,1550,1052,375031,298541,76490,276446734.0,219773121.0,56673613.0,2384,1423,961,362560,290633,71927,266919280.0,213496794.0,53422486.0,0.7362,0.7409,0.7346,0.7427
2023-09-27 15:05,1314,748,566,105119,65091,40028,78916480.0,48882942.0,30033537.0,1026,608,418,80160,52138,28022,59909481.0,39010934.0,20898547.0,0.751,0.7503,0.7482,0.7458
2023-09-27 15:10,2236,1263,973,231499,152417,79082,173107176.0,113773574.0,59333602.0,1876,1087,789,198017,133361,64656,147661190.0,98819614.0,48841575.0,0.7465,0.7503,0.741,0.7554
2023-09-27 15:15,1860,889,971,156078,73753,82325,116014834.0,55039419.0,60975415.0,1649,768,881,137872,62765,75107,102709834.0,46636067.0,56073767.0,0.7463,0.7407,0.743,0.7466
2023-09-27 15:20,1090,547,543,81370,45854,35516,61751988.0,34383401.0,27368587.0,928,464,464,71277,38485,32792,54202025.0,28597609.0,25604415.0,0.7498,0.7706,0.7431,0.7808
2023-09-27 15:25,1119,678,441,100727,61597,39130,75287934.0,46127657.0,29160276.0,964,603,361,86688,53521,33167,64665124.0,39816771.0,24848353.0,0.7489,0.7452,0.7439,0.7492
2023-09-27 15:30,1391,655,736,95298,44816,50482,70676354.0,33402770.0,37273584.0,1264,596,668,86303,40698,45605,64276704.0,30234544.0,34042160.0,0.7453,0.7384,0.7429,0.7465
2023-09-27 15:35,1009,486,523,110252,36335,73917,81940850.0,27073500.0,54867350.0,941,457,484,103277,35661,67616,76938695.0,26490205.0,50448490.0,0.7451,0.7423,0.7428,0.7461
2023-09-27 15:40,532,238,294,56621,24241,32380,42127642.0,18048388.0,24079254.0,479,215,264,53455,22771,30684,39786638.0,16881585.0,22905053.0,0.7445,0.7436,0.7414,0.7465
2023-09-27 15:45,1306,565,741,115643,52742,62901,85609383.0,39118112.0,46491270.0,1204,503,701,105622,48786,56836,78555019.0,36181548.0,42373470.0,0.7417,0.7391,0.7416,0.7455
2023-09-27 15:50,810,467,343,66106,36489,29617,49005488.0,27042015.0,21963473.0,729,419,310,58464,30763,27701,43353271.0,22730508.0,20622763.0,0.7411,0.7416,0.7389,0.7445
2023-09-27 15:55,590,95,495,49764,16866,32898,36938884.0,12524143.0,24414740.0,549,70,479,46427,15182,31245,34550809.0,11263500.0,23287309.0,0.7426,0.7421,0.7419,0.7453
2023-09-27 16:00,214,59,155,24291,11434,12857,17949972.0,8478546.0,9471425.0,192,44,148,23643,11072,12571,17561433.0,8194992.0,9366441.0,0.7415,0.7367,0.7402,0.7451
2023-09-27 16:05,196,98,98,31459,20237,11222,23355875.0,15048134.0,8307741.0,170,88,82,30904,20980,9924,22939564.0,15540294.0,7399269.0,0.7436,0.7403,0.7407,0.7456
2023-09-27 16:10,192,81,111,24625,11461,13164,18310555.0,8504927.0,9805628.0,143,54,89,18154,6549,11605,13515430.0,4854551.0,8660878.0,0.7421,0.7449,0.7413,0.7463
2023-09-27 16:15,445,220,225,32333,19395,12938,24146159.0,14510053.0,9636105.0,418,209,209,34802,22164,12638,25834927.0,16413514.0,9421413.0,0.7481,0.7448,0.7405,0.7455
2023-09-27 16:20,706,451,255,78886,62112,16774,58870673.0,46377852.0,12492821.0,656,417,239,78985,62362,16623,58704897.0,46289514.0,12415382.0,0.7467,0.7448,0.7423,0.7469
2023-09-27 16:25,447,206,241,37267,17598,19669,27699013.0,13088492.0,14610520.0,391,179,212,34194,17967,16227,25446489.0,13329594.0,12116895.0,0.7437,0.7428,0.7419,0.7467
2023-09-27 16:30,423,182,241,41692,9390,32302,31122802.0,6994434.0,24128368.0,354,149,205,36211,7900,28311,27012201.0,5869048.0,21143153.0,0.7449,0.747,0.7429,0.7468
2023-09-27 16:35,2131,724,1407,361803,52977,308826,268866447.0,39290706.0,229575741.0,2035,661,1374,350361,47937,302424,260920302.0,35551597.0,225368705.0,0.7417,0.7434,0.7416,0.7452
2023-09-27 16:40,714,270,444,122624,13787,108837,91262455.0,10204585.0,81057869.0,655,250,405,120926,13324,107602,90054068.0,9873961.0,80180107.0,0.7402,0.7448,0.7411,0.7452
2023-09-27 16:45,258,114,144,61815,6086,55729,46021331.0,4572956.0,41448374.0,208,76,132,59718,4144,55574,44478030.0,3071510.0,41406520.0,0.7514,0.7437,0.7412,0.7451
2023-09-27 16:50,1208,350,858,220974,23262,197712,164755790.0,18519583.0,146236206.0,1079,304,775,209255,18285,190970,155554282.0,13507566.0,142046716.0,0.7961,0.7396,0.7387,0.7438
2023-09-27 16:55,1773,560,1213,290758,30081,260677,215515387.0,22229512.0,193285875.0,1680,508,1172,283142,26974,256168,209880056.0,19892512.0,189987543.0,0.739,0.7415,0.7375,0.7417
2023-09-27 17:00,1573,593,980,317094,28842,288252,235525186.0,21427957.0,214097228.0,1527,575,952,314688,27148,287540,233667471.0,20083585.0,213583886.0,0.7429,0.7427,0.7398,0.7428
2023-09-27 17:05,398,165,233,86413,13082,73331,63753087.0,9365564.0,54387523.0,359,139,220,80905,9523,71382,60064643.0,7025527.0,53039116.0,0.7159,0.7417,0.7377,0.743
2023-09-27 17:10,975,426,549,137141,31216,105925,101329470.0,23049998.0,78279472.0,911,386,525,129264,26395,102869,95702653.0,19421035.0,76281618.0,0.7384,0.739,0.7358,0.7415
2023-09-27 17:15,2309,922,1387,325644,61633,264011,239900560.0,45237114.0,194663446.0,2180,850,1330,311569,53434,258135,229930157.0,39184512.0,190745645.0,0.734,0.7373,0.7333,0.7389
2023-09-27 17:20,1288,473,815,148684,17848,130836,110031337.0,13148966.0,96882370.0,1247,442,805,146570,16642,129928,108436526.0,12229489.0,96207037.0,0.7367,0.7405,0.7349,0.7405
2023-09-27 17:25,400,119,281,62454,6151,56303,46117250.0,4468425.0,41648825.0,370,102,268,58704,3522,55182,43418633.0,2589697.0,40828936.0,0.7265,0.7397,0.7353,0.7399
2023-09-27 17:30,866,408,458,201721,51283,150438,148863423.0,37722199.0,111141223.0,829,388,441,204762,54315,150447,150966285.0,39769536.0,111196749.0,0.7356,0.7388,0.7322,0.7391
2023-09-27 17:35,514,403,111,121868,98608,23260,89806941.0,72592210.0,17214731.0,484,382,102,119061,98190,20871,87591721.0,72125929.0,15465792.0,0.7362,0.7401,0.7346,0.741
2023-09-27 17:40,2019,1525,494,418417,366258,52159,307982301.0,269387051.0,38595249.0,2001,1517,484,416743,365519,51224,306746622.0,268812909.0,37933712.0,0.7355,0.74,0.7354,0.7405
2023-09-27 17:45,1289,1010,279,182274,162835,19439,133631248.0,119386150.0,14245098.0,1234,978,256,179075,161310,17765,131354829.0,118219107.0,13135722.0,0.7332,0.7328,0.7329,0.7394
2023-09-27 17:50,1004,714,290,97060,74592,22468,71511904.0,54868185.0,16643718.0,958,691,267,90715,70521,20194,66638773.0,51675839.0,14962934.0,0.7356,0.7408,0.7328,0.741
2023-09-27 17:55,878,571,307,83272,45942,37330,61549847.0,33885993.0,27663854.0,850,552,298,79070,43403,35667,58490871.0,32004587.0,26486284.0,0.7376,0.7411,0.7374,0.7426
2023-09-27 18:00,549,138,411,69297,16026,53271,51190427.0,11706784.0,39483643.0,526,125,401,68114,16517,51597,50325008.0,12020230.0,38304778.0,0.7305,0.7412,0.7277,0.7424
2023-09-27 18:05,511,285,226,79346,52051,27295,58639838.0,38391381.0,20248457.0,481,272,209,77506,49697,27809,57230851.0,36590058.0,20640793.0,0.7376,0.7418,0.7363,0.7422
2023-09-27 18:10,687,360,327,94369,68129,26240,69461764.0,50178274.0,19283489.0,641,341,300,90725,66933,23792,66930861.0,49275964.0,17654897.0,0.7365,0.7349,0.7362,0.7421
2023-09-27 18:15,806,437,369,138113,102305,35808,101813595.0,75294426.0,26519169.0,774,422,352,135599,101308,34291,99976189.0,74553619.0,25422570.0,0.736,0.7406,0.7359,0.7414
2023-09-27 18:20,1421,1022,399,179098,146438,32660,132054944.0,107839787.0,24215156.0,1399,1017,382,179753,145640,34113,132540767.0,107225193.0,25315573.0,0.7364,0.7414,0.7362,0.7421
2023-09-27 18:25,723,580,143,130349,116856,13493,96044378.0,86025209.0,10019169.0,704,569,135,131132,117280,13852,96624883.0,86336148.0,10288735.0,0.7362,0.7425,0.7362,0.7428
2023-09-27 18:30,1172,566,606,142745,106581,36164,105387839.0,78561790.0,26826048.0,1125,533,592,138968,103820,35148,102547185.0,76456796.0,26090389.0,0.7371,0.7418,0.7364,0.7423
2023-09-27 18:35,2206,1730,476,351279,294493,56786,259632999.0,217477159.0,42155840.0,2191,1730,461,349666,294495,55171,258436894.0,217418211.0,41018683.0,0.7385,0.7424,0.7383,0.7435
2023-09-28 10:00,7998,6112,1886,1006046,852978,153068,750129285.0,635605343.0,114523941.0,7335,5785,1550,962294,829298,132996,715295733.0,616065073.0,99230660.0,0.7452,0.7482,0.7429,0.7461
2023-09-28 10:05,1042,484,558,76524,45238,31286,56962981.0,33610302.0,23352678.0,897,420,477,58041,30184,27857,43174461.0,22391197.0,20783263.0,0.743,0.7464,0.7418,0.7461
2023-09-28 10:10,1125,567,558,68643,35107,33536,50426960.0,25570316.0,24856643.0,901,446,455,64948,34884,30064,48240508.0,25837929.0,22402579.0,0.7284,0.7412,0.7407,0.7452
2023-09-28 10:15,1355,654,701,114322,68132,46190,85077544.0,50662754.0,34414789.0,1278,618,660,109480,65903,43577,81389509.0,48918678.0,32470830.0,0.7436,0.7451,0.7423,0.7451
2023-09-28 10:20,1797,1073,724,139894,104616,35278,104111450.0,77740121.0,26371329.0,1673,1028,645,136482,103540,32942,101552876.0,76971161.0,24581714.0,0.7431,0.7475,0.7434,0.7462
2023-09-28 10:25,1384,769,615,87684,60889,26795,65230234.0,45281777.0,19948457.0,1281,717,564,83929,59706,24223,63758521.0,45677053.0,18081467.0,0.7437,0.7445,0.765,0.7465
2023-09-28 10:30,1286,857,429,79349,49973,29376,59642073.0,37752570.0,21889503.0,1126,768,358,67158,41794,25364,50135218.0,31139557.0,18995660.0,0.7555,0.7451,0.7451,0.7489
2023-09-28 10:35,1293,742,551,83972,52932,31040,62901605.0,39716464.0,23185140.0,1031,606,425,70910,46543,24367,53049332.0,34743552.0,18305780.0,0.7503,0.7469,0.7465,0.7513
2023-09-28 10:40,1479,668,811,91713,44101,47612,68815388.0,33115012.0,35700376.0,1168,562,606,79067,39941,39126,59358280.0,29876880.0,29481399.0,0.7509,0.7498,0.748,0.7535
2023-09-28 10:45,1042,540,502,58956,23312,35644,44242137.0,17497572.0,26744565.0,880,472,408,53169,21774,31395,39625243.0,15979569.0,23645673.0,0.7506,0.7503,0.7339,0.7532
2023-09-28 10:50,696,357,339,36473,16900,19573,27348679.0,12721446.0,14627233.0,550,310,240,33640,15761,17879,25241202.0,11796385.0,13444817.0,0.7527,0.7473,0.7485,0.752
2023-09-28 10:55,931,698,233,56589,44828,11761,41588147.0,32716254.0,8871893.0,860,667,193,48056,39819,8237,35418415.0,29223462.0,6194953.0,0.7298,0.7543,0.7339,0.7521
2023-09-28 11:00,1681,769,912,119787,48266,71521,89619748.0,36173367.0,53446381.0,1517,681,836,106444,43198,63246,79723233.0,32288110.0,47435123.0,0.7495,0.7473,0.7474,0.75
2023-09-28 11:05,1821,855,966,169586,65013,104573,126385623.0,48405485.0,77980138.0,1713,802,911,164065,62650,101415,122504148.0,46639065.0,75865082.0,0.7446,0.7457,0.7444,0.7481
2023-09-28 11:10,1143,663,480,63891,41283,22608,47691957.0,30793049.0,16898908.0,1057,629,428,59887,39045,20842,44614972.0,29011452.0,15603520.0,0.7459,0.7475,0.743,0.7487
2023-09-28 11:15,1836,844,992,146231,76435,69796,109298663.0,57063001.0,52235661.0,1779,811,968,143589,75154,68435,107378311.0,56090719.0,51287592.0,0.7466,0.7484,0.7463,0.7494
2023-09-28 11:20,2185,1008,1177,216990,121135,95855,161908053.0,90099810.0,71808243.0,2091,966,1125,211387,118775,92612,157638807.0,88211194.0,69427613.0,0.7438,0.7491,0.7427,0.7497
2023-09-28 11:25,2427,1021,1406,300046,84938,215108,223541958.0,62828823.0,160713134.0,2345,968,1377,292420,80782,211638,218186726.0,59734807.0,158451919.0,0.7397,0.7471,0.7395,0.7487
2023-09-28 11:30,1832,829,1003,211732,61888,149844,158441355.0,46223652.0,112217703.0,1799,813,986,209574,61038,148536,156790744.0,45514945.0,111275799.0,0.7469,0.7489,0.7457,0.7492
2023-09-28 11:35,1966,684,1282,264084,47681,216403,197268665.0,35511003.0,161757662.0,1938,675,1263,262305,47277,215028,196025078.0,35214917.0,160810161.0,0.7448,0.7475,0.7449,0.7479
2023-09-28 11:40,3115,868,2247,548879,69239,479640,409996109.0,51378986.0,358617122.0,3076,853,2223,545718,67621,478097,407530925.0,50016378.0,357514547.0,0.7421,0.7477,0.7397,0.7478
2023-09-28 11:45,1285,485,800,199799,46893,152906,149106666.0,34955402.0,114151264.0,1259,460,799,199279,47485,151794,148601165.0,35059884.0,113541280.0,0.7454,0.7465,0.7383,0.748
2023-09-28 11:50,3161,1192,1969,411836,105819,306017,307761448.0,78831130.0,228930318.0,3114,1174,1940,408674,104978,303696,305378465.0,78167793.0,227210671.0,0.745,0.7481,0.7446,0.7482
2023-09-28 11:55,288,112,176,24177,9669,14508,18015572.0,7281050.0,10734522.0,234,79,155,19303,7031,12272,14364508.0,5207296.0,9157212.0,0.753,0.7399,0.7406,0.7462
2023-09-28 12:00,404,118,286,30085,4166,25919,22533594.0,3146369.0,19387224.0,370,100,270,28160,2933,25227,21042837.0,2179882.0,18862954.0,0.7552,0.748,0.7432,0.7477
2023-09-28 12:05,953,586,367,71941,39408,32533,53878718.0,29558963.0,24319755.0,922,566,356,69861,37875,31986,52131631.0,28220580.0,23911051.0,0.7501,0.7475,0.7451,0.7475
2023-09-28 12:10,1973,1185,788,212671,105729,106942,158886931.0,78871493.0,80015437.0,1955,1176,779,211557,105393,106164,157989121.0,78557810.0,79431310.0,0.746,0.7482,0.7454,0.7482
2023-09-28 12:15,2218,1373,845,291820,200421,91399,217550933.0,149333065.0,68217867.0,2163,1350,813,289105,200371,88734,215679151.0,149291087.0,66388063.0,0.7451,0.7464,0.7451,0.7482
2023-09-28 12:20,1370,526,844,162236,47788,114448,121139295.0,35653587.0,85485708.0,1323,497,826,159360,45835,113525,118998336.0,34136633.0,84861703.0,0.7461,0.7469,0.7448,0.7475
2023-09-28 12:25,709,384,325,41237,24006,17231,30653982.0,17875786.0,12778196.0,663,354,309,39550,23421,16129,29485315.0,17434226.0,12051089.0,0.7446,0.7416,0.7444,0.7472
2023-09-28 12:30,1219,737,482,164887,70852,94035,123050655.0,52757999.0,70292655.0,1193,726,467,163265,69896,93369,121831251.0,52032706.0,69798545.0,0.7446,0.7475,0.7444,0.7476
2023-09-28 12:35,875,278,597,87817,33533,54284,65322900.0,24932838.0,40390062.0,822,255,567,85132,32838,52294,63465642.0,24417937.0,39047705.0,0.7435,0.7441,0.7436,0.7467
2023-09-28 12:40,1432,429,1003,171872,54020,117852,128127971.0,40212736.0,87915235.0,1396,409,987,169599,52671,116928,126438957.0,39148905.0,87290052.0,0.7444,0.746,0.7433,0.7465
2023-09-28 12:45,834,189,645,145066,14264,130802,108142484.0,10616891.0,97525592.0,813,172,641,141869,11937,129932,105770153.0,8866367.0,96903786.0,0.7443,0.7456,0.7428,0.7458
2023-09-28 12:50,3283,712,2571,523165,80518,442647,390046024.0,59911098.0,330134926.0,3246,696,2550,522207,80528,441679,389325599.0,59882993.0,329442606.0,0.7441,0.7458,0.7436,0.7459
2023-09-28 12:55,2589,598,1991,297517,51453,246064,221729726.0,38266893.0,183462833.0,2568,584,1984,297356,51115,246241,221640002.0,38017635.0,183622367.0,0.7437,0.7456,0.7438,0.7457
2023-09-28 13:00,2330,568,1762,297503,49132,248371,221693762.0,36461808.0,185231953.0,2312,559,1753,298075,49680,248395,222117446.0,36867997.0,185249448.0,0.7421,0.7458,0.7421,0.7458
2023-09-28 13:05,673,243,430,88670,14291,74379,66163047.0,10643923.0,55519124.0,665,239,426,88530,14230,74300,66035361.0,10575837.0,55459524.0,0.7448,0.7464,0.7432,0.7464
2023-09-28 13:10,2669,668,2001,459906,54368,405538,343082969.0,40438172.0,302644797.0,2617,641,1976,457892,52767,405125,341666349.0,39242637.0,302423711.0,0.7438,0.7463,0.7437,0.7465
2023-09-28 13:15,1827,723,1104,195979,39428,156551,146189851.0,29350833.0,116839018.0,1819,716,1103,192588,39203,153385,143759418.0,29148876.0,114610542.0,0.7444,0.7463,0.7435,0.7472
2023-09-28 13:20,2872,1610,1262,339571,172290,167281,252230567.0,127858501.0,124372065.0,2770,1548,1222,333944,168761,165183,248326865.0,125233946.0,123092918.0,0.7421,0.7435,0.7421,0.7452
2023-09-28 13:25,1095,837,258,118233,83209,35024,87820176.0,61826879.0,25993297.0,1062,820,242,113517,81124,32393,84294551.0,60156345.0,24138206.0,0.743,0.7422,0.7415,0.7452
2023-09-28 13:30,1648,960,688,161886,81186,80700,120085434.0,60236972.0,59848461.0,1582,914,668,157714,78129,79585,117244706.0,57951557.0,59293149.0,0.742,0.7416,0.7417,0.745
2023-09-28 13:35,249,191,58,31986,27917,4069,23768125.0,20736035.0,3032090.0,227,174,53,29586,25637,3949,21972247.0,19024951.0,2947295.0,0.7428,0.7452,0.7421,0.7463
2023-09-28 13:40,145,74,71,11422,4435,6987,8525536.0,3305564.0,5219972.0,123,58,65,11845,5123,6722,8822262.0,3803194.0,5019067.0,0.7453,0.7471,0.7424,0.7467
2023-09-28 13:45,1901,945,956,191082,83042,108040,143092624.0,62351282.0,80741341.0,1840,922,918,178992,77167,101825,133589414.0,57498242.0,76091171.0,0.7508,0.7473,0.7451,0.7473
2023-09-28 13:50,1815,1424,391,186748,150848,35900,139610841.0,112712641.0,26898200.0,1786,1418,368,183943,149208,34735,137307145.0,111271434.0,26035711.0,0.7472,0.7493,0.7457,0.7496
2023-09-28 13:55,923,496,427,79720,58715,21005,59508548.0,43806183.0,15702365.0,885,477,408,77736,57311,20425,58033225.0,42748134.0,15285091.0,0.7461,0.7476,0.7459,0.7484
2023-09-28 14:00,1282,643,639,87562,55884,31678,65495047.0,41727136.0,23767911.0,1245,622,623,87307,57063,30244,65235970.0,42558498.0,22677471.0,0.7467,0.7503,0.7458,0.7498
2023-09-28 14:05,1523,876,647,155245,119168,36077,115939889.0,88952248.0,26987641.0,1482,860,622,153342,118400,34942,114576458.0,88368968.0,26207490.0,0.7464,0.7481,0.7464,0.75
2023-09-28 14:10,1317,589,728,111102,69949,41153,83049139.0,52226829.0,30822309.0,1283,572,711,109924,69132,40792,82160736.0,51593407.0,30567329.0,0.7466,0.749,0.7463,0.7493
2023-09-28 14:15,976,471,505,100952,60913,40039,75510153.0,45502053.0,30008100.0,937,450,487,98586,60253,38333,73764108.0,45007503.0,28756604.0,0.747,0.7495,0.747,0.7502
2023-09-28 14:20,2547,1138,1409,307799,181210,126589,229817269.0,135051845.0,94765424.0,2518,1125,1393,305203,180255,124948,227834495.0,134268313.0,93566181.0,0.7453,0.7486,0.7449,0.7488
2023-09-28 14:25,2101,858,1243,273072,176449,96623,203438465.0,131309948.0,72128517.0,2066,843,1223,270640,176067,94573,201762312.0,131014005.0,70748307.0,0.7442,0.7465,0.7441,0.7481
2023-09-28 14:30,1583,650,933,179369,107239,72130,133654447.0,79802005.0,53852442.0,1558,635,923,177428,107029,70399,132276061.0,79637037.0,52639024.0,0.7442,0.7466,0.7441,0.7477
2023-09-28 14:35,1429,518,911,147514,45774,101740,110055267.0,34056974.0,75998293.0,1395,509,886,144679,44804,99875,107954420.0,33332832.0,74621588.0,0.744,0.747,0.744,0.7471
2023-09-28 14:40,1168,443,725,104795,34608,70187,77953299.0,25687698.0,52265601.0,1133,424,709,103209,33230,69979,76815636.0,24677053.0,52138583.0,0.7422,0.7447,0.7426,0.7451
2023-09-28 14:45,2186,598,1588,260860,44809,216051,194065893.0,33221892.0,160844001.0,2114,559,1555,255099,42517,212582,189916252.0,31519350.0,158396902.0,0.7414,0.7445,0.7413,0.7451
2023-09-28 14:50,3442,1232,2210,420601,64807,355794,312278186.0,47916662.0,264361524.0,3310,1152,2158,414163,62159,352004,307725615.0,45921964.0,261803650.0,0.7394,0.743,0.7388,0.7438
2023-09-28 14:55,1818,990,828,218028,108641,109387,161338739.0,80250901.0,81087838.0,1714,931,783,209370,103511,105859,155120644.0,76487137.0,78633507.0,0.7387,0.7413,0.7389,0.7428
2023-09-28 15:00,2654,1269,1385,379448,129185,250263,281040375.0,95316438.0,185723936.0,2578,1227,1351,379376,129852,249524,280905918.0,95705933.0,185199985.0,0.7378,0.7421,0.737,0.7422
2023-09-28 15:05,1304,593,711,185901,59253,126648,137758335.0,43704349.0,94053986.0,1251,564,687,184678,58853,125825,136691292.0,43255750.0,93435541.0,0.7376,0.7426,0.735,0.7426
2023-09-28 15:10,1618,881,737,188546,99985,88561,139441463.0,73747660.0,65693802.0,1574,857,717,184219,98061,86158,136337514.0,72339531.0,63997983.0,0.7376,0.7418,0.7377,0.7428
2023-09-28 15:15,1583,730,853,165261,43815,121446,122241427.0,32300568.0,89940859.0,1544,702,842,164868,42483,122385,121988957.0,31317696.0,90671261.0,0.7372,0.7406,0.7372,0.7409
2023-09-28 15:20,1233,551,682,155367,43266,112101,114962209.0,31921504.0,83040705.0,1205,525,680,153805,41921,111884,113781976.0,30898960.0,82883016.0,0.7378,0.7408,0.7371,0.7408
2023-09-28 15:25,1352,613,739,123056,72216,50840,91001120.0,53322700.0,37678419.0,1323,599,724,121359,70576,50783,89706743.0,52069929.0,37636814.0,0.7384,0.7411,0.7378,0.7411
2023-09-28 15:30,2939,1349,1590,349452,174496,174956,258186858.0,128572583.0,129614275.0,2920,1340,1580,346816,173620,173196,256429513.0,128008597.0,128420915.0,0.7368,0.7408,0.7373,0.7415
2023-09-28 15:35,1007,420,587,100260,20046,80214,73943161.0,14611565.0,59331596.0,939,381,558,95439,17749,77690,70528953.0,12985091.0,57543862.0,0.7289,0.7397,0.7316,0.7407
2023-09-28 15:40,1724,1026,698,120990,61376,59614,89259566.0,45216484.0,44043082.0,1585,959,626,113827,57421,56406,83842729.0,42120204.0,41722525.0,0.7367,0.7388,0.7335,0.7397
2023-09-28 15:45,1933,1242,691,198695,129791,68904,146238962.0,95349650.0,50889311.0,1884,1214,670,197982,129201,68781,145726531.0,94880505.0,50846026.0,0.7346,0.7386,0.7344,0.7392
2023-09-28 15:50,2079,1288,791,247447,176318,71129,182195802.0,129612283.0,52583519.0,2063,1267,796,245145,174496,70649,180488718.0,128255739.0,52232979.0,0.7351,0.7393,0.735,0.7393
2023-09-28 15:55,1770,822,948,238165,148428,89737,175409888.0,109002693.0,66407195.0,1785,812,973,236856,147760,89096,174417861.0,108472451.0,65945410.0,0.7344,0.74,0.7341,0.7402
2023-09-28 16:00,1577,783,794,272320,147260,125060,200723121.0,108249145.0,92473976.0,1568,775,793,272390,146990,125400,200759978.0,108031352.0,92728626.0,0.7351,0.7394,0.735,0.7395
2023-09-28 16:05,2121,1297,824,222839,173503,49336,164429553.0,127899325.0,36530227.0,2056,1259,797,220426,172490,47936,162563116.0,127028730.0,35534386.0,0.7372,0.7404,0.7364,0.7413
2023-09-28 16:10,1247,713,534,137363,102556,34807,101228964.0,75409877.0,25819087.0,1220,694,526,135444,101623,33821,99815769.0,74724815.0,25090954.0,0.7353,0.7418,0.7353,0.7419
2023-09-28 16:15,4369,1294,3075,691742,214974,476768,511367231.0,158049525.0,353317706.0,4345,1282,3063,690487,214956,475531,510541192.0,158025197.0,352515995.0,0.7352,0.7411,0.7352,0.7413
2023-09-28 16:20,1554,479,1075,149223,51293,97930,110243044.0,37749665.0,72493379.0,1536,462,1074,148640,50797,97843,109793342.0,37373594.0,72419748.0,0.736,0.7403,0.7357,0.7402
2023-09-28 16:25,720,202,518,94790,25347,69443,70230291.0,18670171.0,51560119.0,701,193,508,94636,25054,69582,70116802.0,18451109.0,51665693.0,0.7366,0.7425,0.7365,0.7425
2023-09-28 16:30,741,345,396,82431,29140,53291,60925629.0,21455080.0,39470549.0,718,333,385,80110,27951,52159,59212602.0,20578580.0,38634022.0,0.7363,0.7407,0.7362,0.7407
2023-09-28 16:35,644,90,554,57101,10463,46638,42117998.0,7683861.0,34434136.0,621,76,545,55669,9943,45726,41146727.0,7297840.0,33848887.0,0.7344,0.7383,0.734,0.7403
2023-09-28 16:40,89,30,59,10346,3282,7064,7637460.0,2414596.0,5222863.0,78,24,54,10672,3153,7519,7882896.0,2318239.0,5564657.0,0.7357,0.7394,0.7352,0.7401
2023-09-28 16:45,225,109,116,59486,28458,31028,43889747.0,20915286.0,22974460.0,212,102,110,58728,28499,30229,43310191.0,20930052.0,22380139.0,0.735,0.7404,0.7344,0.7404
2023-09-28 16:50,1459,653,806,222509,127979,94530,164005790.0,93995718.0,70010071.0,1454,648,806,222441,127278,95163,163965869.0,93482204.0,70483665.0,0.7345,0.7406,0.7345,0.7407
2023-09-28 16:55,1904,750,1154,243381,127689,115692,179475754.0,93904064.0,85571690.0,1880,732,1148,242926,127515,115411,179122177.0,93756618.0,85365559.0,0.7354,0.7397,0.7353,0.7397
2023-09-28 17:00,1769,790,979,232370,143764,88606,171355880.0,105798336.0,65557543.0,1739,772,967,230909,143066,87843,170262815.0,105271569.0,64991246.0,0.7359,0.7399,0.7358,0.7399
2023-09-28 17:05,388,185,203,24378,9875,14503,18050138.0,7297792.0,10752346.0,360,172,188,23269,9133,14136,17228872.0,6745781.0,10483091.0,0.739,0.7414,0.7386,0.7416
2023-09-28 17:10,768,495,273,93355,63344,30011,68989356.0,46730762.0,22258594.0,743,484,259,93322,63590,29732,68934677.0,46896040.0,22038636.0,0.7377,0.7417,0.7375,0.7412
2023-09-28 17:15,907,514,393,84380,63927,20453,62252966.0,47134383.0,15118583.0,888,504,384,83319,63709,19610,61450044.0,46948509.0,14501535.0,0.7373,0.7392,0.7369,0.7395
2023-09-28 17:20,2220,1164,1056,321408,236637,84771,236972955.0,174302278.0,62670677.0,2203,1153,1050,319745,235892,83853,235797617.0,173755603.0,62042013.0,0.7366,0.7393,0.7366,0.7399
2023-09-28 17:25,2023,1313,710,187173,110441,76732,138468140.0,81593774.0,56874366.0,1983,1288,695,185083,108657,76426,136853734.0,80207572.0,56646161.0,0.7388,0.7412,0.7382,0.7412
2023-09-28 17:30,479,178,301,41863,23922,17941,31046853.0,17769234.0,13277619.0,456,166,290,39693,22333,17360,29365779.0,16483139.0,12882640.0,0.7428,0.7401,0.7381,0.7421
2023-09-28 17:35,1470,704,766,254963,133744,121219,188910341.0,98824120.0,90086220.0,1455,701,754,253765,133488,120277,187967957.0,98581823.0,89386134.0,0.7389,0.7432,0.7385,0.7432
2023-09-28 17:40,1344,687,657,166582,91274,75308,123215024.0,67413341.0,55801682.0,1324,673,651,165058,90420,74638,122135783.0,66766009.0,55369774.0,0.7386,0.741,0.7384,0.7418
2023-09-28 17:45,617,284,333,82070,43018,39052,60786730.0,31790682.0,28996047.0,602,276,326,80658,42507,38151,59737954.0,31411193.0,28326760.0,0.739,0.7425,0.739,0.7425
2023-09-28 17:50,226,96,130,30159,11273,18886,22352525.0,8333144.0,14019380.0,209,86,123,29400,10959,18441,21794566.0,8098518.0,13696047.0,0.7392,0.7423,0.739,0.7427
2023-09-28 17:55,199,149,50,36014,31725,4289,26650907.0,23478873.0,3172033.0,187,142,45,35370,31154,4216,26147562.0,23019983.0,3127578.0,0.7401,0.7396,0.7389,0.7418
2023-09-28 18:00,494,344,150,74388,62280,12108,54953812.0,45970857.0,8982955.0,480,336,144,74831,63298,11533,55259206.0,46699507.0,8559698.0,0.7381,0.7419,0.7378,0.7422
2023-09-28 18:05,453,340,113,42872,35353,7519,31711206.0,26128225.0,5582981.0,442,335,107,41541,34003,7538,30705309.0,25107278.0,5598030.0,0.7391,0.7425,0.7384,0.7426
2023-09-28 18:10,555,318,237,49908,34056,15852,36898985.0,25157199.0,11741786.0,530,306,224,47103,33698,13405,34819112.0,24887404.0,9931707.0,0.7387,0.7407,0.7385,0.7409
2023-09-28 18:15,778,204,574,57250,24418,32832,42291564.0,18013308.0,24278256.0,752,190,562,54746,23128,31618,40503764.0,17061712.0,23442051.0,0.7377,0.7395,0.7377,0.7414
2023-09-28 18:20,540,321,219,129741,97693,32048,95767584.0,72000655.0,23766928.0,535,315,220,130988,97977,33011,96686103.0,72202875.0,24483227.0,0.737,0.7416,0.7369,0.7417
2023-09-28 18:25,4313,2106,2207,680831,370213,310618,503000840.0,273038410.0,229962429.0,4308,2095,2213,679931,369748,310183,502420315.0,272696528.0,229723786.0,0.7375,0.7403,0.7375,0.7406
2023-09-28 18:30,4590,3218,1372,661307,508738,152569,488533192.0,375520938.0,113012253.0,4538,3189,1349,657504,506574,150930,485585590.0,373787652.0,111797938.0,0.7381,0.7407,0.7379,0.7407
2023-09-28 18:35,4043,2850,1193,516716,426279,90437,381339553.0,314538391.0,66801161.0,4017,2831,1186,515125,426091,89034,380290011.0,314379661.0,65910350.0,0.7379,0.7386,0.7378,0.7403
2023-09-29 10:00,3960,1936,2024,343946,206819,137127,256003920.0,153258817.0,102745103.0,3489,1692,1797,316247,191638,124609,234594254.0,141644798.0,92949456.0,0.741,0.7493,0.7391,0.7459
2023-09-29 10:05,2287,1352,935,169593,110246,59347,125310801.0,81331578.0,43979222.0,2107,1246,861,163088,107827,55261,120588042.0,79510755.0,41077287.0,0.7377,0.7411,0.7374,0.7433
2023-09-29 10:10,2137,1287,850,147661,79536,68125,109390496.0,58728016.0,50662480.0,1909,1178,731,144468,77257,67211,107064238.0,57081683.0,49982555.0,0.7384,0.7437,0.7389,0.7437
2023-09-29 10:15,974,568,406,91056,64433,26623,67531061.0,47671875.0,19859186.0,910,532,378,83481,62135,21346,61766048.0,45884482.0,15881566.0,0.7399,0.7459,0.7385,0.744
2023-09-29 10:20,2697,1542,1155,287842,194480,93362,212988260.0,143624175.0,69364085.0,2626,1512,1114,279588,188954,90634,206913842.0,139535401.0,67378440.0,0.7385,0.743,0.7385,0.7434
2023-09-29 10:25,2271,1491,780,180008,132091,47917,133133838.0,97607343.0,35526495.0,2214,1455,759,176673,130684,45989,130739814.0,96580020.0,34159793.0,0.7389,0.7414,0.739,0.7428
2023-09-29 10:30,426,308,118,24425,18317,6108,17998136.0,13541421.0,4456714.0,373,274,99,22515,17476,5039,16635820.0,12902452.0,3733367.0,0.7393,0.7297,0.7383,0.7409
2023-09-29 10:35,831,212,619,53500,11286,42214,39435749.0,8226461.0,31209287.0,744,158,586,50257,9381,40876,37227257.0,6905228.0,30322029.0,0.7289,0.7393,0.7361,0.7418
2023-09-29 10:40,485,265,220,31283,11721,19562,23074140.0,8609793.0,14464347.0,416,220,196,30200,11494,18706,22258608.0,8328586.0,13930021.0,0.7346,0.7394,0.7246,0.7447
2023-09-29 10:45,1279,648,631,106590,48463,58127,78880305.0,35766798.0,43113507.0,1228,610,618,104321,46409,57912,77111220.0,34159175.0,42952045.0,0.738,0.7417,0.736,0.7417
2023-09-29 10:50,1335,771,564,106383,78772,27611,78409926.0,58101586.0,20308340.0,1267,736,531,96145,71590,24555,70915901.0,52709063.0,18206837.0,0.7376,0.7355,0.7363,0.7415
2023-09-29 10:55,1203,653,550,93167,52445,40722,69127592.0,38854212.0,30273379.0,1138,628,510,77491,49124,28367,57261893.0,36221570.0,21040323.0,0.7409,0.7434,0.7373,0.7417
2023-09-29 11:00,3456,1704,1752,304401,170661,133740,224913751.0,125871976.0,99041775.0,3408,1679,1729,309734,168209,141525,228772272.0,123932045.0,104840227.0,0.7376,0.7406,0.7368,0.7408
2023-09-29 11:05,3932,3481,451,515830,489884,25946,379957035.0,360826687.0,19130348.0,3897,3456,441,511285,488401,22884,376613438.0,359729996.0,16883442.0,0.7366,0.7373,0.7365,0.7378
2023-09-29 11:10,1429,626,803,166473,83909,82564,122855585.0,61760611.0,61094974.0,1395,607,788,166371,83568,82803,122768689.0,61487785.0,61280904.0,0.736,0.74,0.7358,0.7401
2023-09-29 11:15,1096,646,450,111326,79447,31879,82123572.0,58520786.0,23602786.0,1037,603,434,105477,74341,31136,77786900.0,54586940.0,23199960.0,0.7366,0.7404,0.7343,0.7451
2023-09-29 11:20,1201,597,604,120828,23577,97251,89054770.0,17314575.0,71740194.0,1115,543,572,116519,22481,94038,86043845.0,16507232.0,69536613.0,0.7344,0.7377,0.7343,0.7395
2023-09-29 11:25,1407,469,938,192632,21916,170716,141956503.0,16019302.0,125937200.0,1346,424,922,187704,20175,167529,138406250.0,14802935.0,123603314.0,0.7309,0.7377,0.7337,0.7378
2023-09-29 11:30,1613,678,935,200374,52535,147839,148961735.0,40134755.0,108826980.0,1525,615,910,196101,49281,146820,144634615.0,36123933.0,108510681.0,0.764,0.7361,0.733,0.7391
2023-09-29 11:35,1232,677,555,88022,52423,35599,66009999.0,39797698.0,26212300.0,1179,652,527,83420,52022,31398,62620406.0,39499407.0,23120999.0,0.7592,0.7363,0.7593,0.7364
2023-09-29 11:40,1542,846,696,125793,34160,91633,92884739.0,25212022.0,67672717.0,1562,839,723,119928,27707,92221,88425269.0,20300731.0,68124538.0,0.7381,0.7385,0.7327,0.7387
2023-09-29 11:45,2038,1227,811,178918,127961,50957,131840668.0,94181421.0,37659246.0,1983,1196,787,174888,125755,49133,128772136.0,92466575.0,36305561.0,0.736,0.739,0.7353,0.7389
2023-09-29 11:50,925,675,250,99949,76287,23662,73568510.0,56092956.0,17475554.0,891,658,233,98359,75604,22755,72421774.0,55577889.0,16843884.0,0.7353,0.7385,0.7351,0.7402
2023-09-29 11:55,1322,685,637,119728,63734,55994,88293897.0,46949893.0,41344004.0,1285,666,619,116703,61504,55199,85972050.0,45193157.0,40778892.0,0.7367,0.7384,0.7348,0.7388
2023-09-29 12:00,1806,1351,455,260068,172377,87691,191479760.0,126699129.0,64780631.0,1795,1345,450,259077,171846,87231,190761838.0,126307772.0,64454066.0,0.735,0.7387,0.735,0.7389
2023-09-29 12:05,1364,949,415,125864,57864,68000,92813846.0,42544299.0,50269547.0,1342,935,407,124561,56993,67568,91792014.0,41841735.0,49950278.0,0.7352,0.7393,0.7342,0.7393
2023-09-29 12:10,1632,803,829,236778,69082,167696,174815375.0,50746979.0,124068396.0,1612,795,817,235293,68655,166638,173786555.0,50432007.0,123354548.0,0.7346,0.7398,0.7346,0.7403
2023-09-29 12:15,1423,648,775,207037,55995,151042,152931171.0,41174220.0,111756951.0,1405,643,762,206552,55700,150852,152558268.0,40937462.0,111620806.0,0.7353,0.7399,0.735,0.7399
2023-09-29 12:20,1304,650,654,140982,56784,84198,103775123.0,41739231.0,62035892.0,1273,630,643,137805,55074,82731,101562087.0,40480135.0,61081952.0,0.7351,0.7368,0.735,0.7383
2023-09-29 12:25,1147,376,771,77782,15181,62601,57154122.0,11160633.0,45993489.0,1105,344,761,75353,14590,60763,55571757.0,10715116.0,44856641.0,0.7352,0.7347,0.7344,0.7382
2023-09-29 12:30,662,241,421,65343,17484,47859,48320434.0,12982379.0,35338055.0,632,226,406,61104,15950,45154,45070099.0,11726482.0,33343617.0,0.7425,0.7384,0.7352,0.7384
2023-09-29 12:35,1842,1423,419,220929,186810,34119,162790423.0,137564461.0,25225961.0,1824,1413,411,219166,186079,33087,161526363.0,137049144.0,24477219.0,0.7364,0.7394,0.7365,0.7398
2023-09-29 12:40,1569,845,724,173763,99870,73893,128247011.0,73487443.0,54759568.0,1538,829,709,172997,99532,73465,127653460.0,73226846.0,54426613.0,0.7358,0.7411,0.7357,0.7409
2023-09-29 12:45,469,333,136,36108,16271,19837,26664406.0,11974953.0,14689452.0,448,323,125,36201,16191,20010,26747138.0,11914872.0,14832265.0,0.736,0.7405,0.7359,0.7412
2023-09-29 12:50,632,571,61,72997,62155,10842,53783869.0,45721945.0,8061924.0,620,567,53,72407,61530,10877,53353008.0,45262845.0,8090163.0,0.7356,0.7436,0.7356,0.7438
2023-09-29 12:55,248,77,171,33566,4103,29463,24807590.0,3015294.0,21792296.0,236,70,166,33242,4738,28504,24570124.0,3482412.0,21087711.0,0.7349,0.7396,0.735,0.7398
2023-09-29 13:00,375,133,242,55808,9257,46551,41289496.0,6819885.0,34469610.0,348,122,226,54598,8491,46107,40377415.0,6246649.0,34130765.0,0.7367,0.7405,0.7357,0.7403
2023-09-29 13:05,1057,615,442,92621,52384,40237,68338835.0,38581958.0,29756876.0,1037,605,432,92313,52158,40155,68124541.0,38414402.0,29710139.0,0.7365,0.7395,0.7365,0.7399
2023-09-29 13:10,364,75,289,19785,2732,17053,14619799.0,2012667.0,12607132.0,342,66,276,19518,2685,16833,14425481.0,1971226.0,12454255.0,0.7367,0.7393,0.7342,0.7399
2023-09-29 13:15,1139,621,518,106399,60510,45889,78603519.0,44492741.0,34110778.0,1065,591,474,101813,59459,42354,74854636.0,43623518.0,31231118.0,0.7353,0.7433,0.7337,0.7374
2023-09-29 13:20,688,361,327,40252,19334,20918,30495744.0,14188757.0,16306987.0,645,334,311,34244,14332,19912,26091186.0,10523734.0,15567451.0,0.7339,0.7796,0.7343,0.7818
2023-09-29 13:25,899,390,509,57439,23554,33885,42286730.0,17300163.0,24986566.0,882,378,504,57413,23868,33545,42258785.0,17523814.0,24734970.0,0.7345,0.7374,0.7342,0.7374
2023-09-29 13:30,504,90,414,53696,5282,48414,39674618.0,3908054.0,35766564.0,475,73,402,52992,5636,47356,39112651.0,4139056.0,34973595.0,0.7399,0.7388,0.7344,0.7385
2023-09-29 13:35,186,88,98,15537,4197,11340,12046513.0,3104549.0,8941963.0,164,76,88,15385,3956,11429,11960303.0,2907845.0,9052458.0,0.7397,0.7885,0.735,0.7921
2023-09-29 13:40,454,226,228,27257,5955,21302,19988293.0,4386511.0,15601781.0,432,210,222,26723,5266,21457,19716820.0,3868967.0,15847852.0,0.7366,0.7324,0.7347,0.7386
2023-09-29 13:45,443,232,211,38880,16762,22118,28517703.0,12407902.0,16109801.0,409,215,194,33415,13989,19426,24562975.0,10257409.0,14305565.0,0.7402,0.7284,0.7332,0.7364
2023-09-29 13:50,260,183,77,11600,6079,5521,8531123.0,4466796.0,4064326.0,240,172,68,10844,5778,5066,7989046.0,4244928.0,3744117.0,0.7348,0.7362,0.7347,0.7391
2023-09-29 13:55,915,162,753,136217,3915,132302,100173652.0,2901380.0,97272272.0,883,143,740,133061,2987,130074,98018866.0,2193639.0,95825227.0,0.7411,0.7352,0.7344,0.7367
2023-09-29 14:00,1026,192,834,160383,22582,137801,118088475.0,16583002.0,101505472.0,1014,180,834,159920,22050,137870,117743059.0,16187319.0,101555740.0,0.7343,0.7366,0.7341,0.7366
2023-09-29 14:05,2177,94,2083,391304,1471,389833,288396168.0,1081726.0,287314442.0,2172,89,2083,390381,1394,388987,287714898.0,1022525.0,286692373.0,0.7354,0.737,0.7335,0.737
2023-09-29 14:10,1188,75,1113,214169,1873,212296,157706662.0,1388495.0,156318167.0,1168,62,1106,213505,1565,211940,157795804.0,1148327.0,156647476.0,0.7413,0.7363,0.7338,0.7391
2023-09-29 14:15,1023,177,846,97008,15336,81672,71417105.0,11266451.0,60150654.0,1009,170,839,99082,15638,83444,72944648.0,11477317.0,61467331.0,0.7346,0.7365,0.7339,0.7366
2023-09-29 14:20,503,131,372,59367,9459,49908,43768395.0,6945613.0,36822781.0,480,115,365,58571,8539,50032,43196753.0,6267589.0,36929164.0,0.7343,0.7378,0.734,0.7381
2023-09-29 14:25,357,103,254,49314,4679,44635,36398445.0,3425423.0,32973022.0,342,92,250,49927,4699,45228,36864134.0,3447957.0,33416176.0,0.7321,0.7387,0.7338,0.7388
2023-09-29 14:30,583,112,471,47098,3410,43688,35823776.0,2537722.0,33286054.0,539,91,448,44052,2621,41431,32452567.0,1918572.0,30533994.0,0.7442,0.7619,0.732,0.737
2023-09-29 14:35,225,141,84,16710,6415,10295,12303376.0,4712324.0,7591052.0,187,113,74,14524,5461,9063,10671530.0,3987722.0,6683808.0,0.7346,0.7374,0.7302,0.7375
2023-09-29 14:40,938,200,738,164688,12684,152004,120902437.0,9259366.0,111643071.0,866,162,704,160239,11939,148300,118407827.0,8700630.0,109707196.0,0.73,0.7345,0.7288,0.7398
2023-09-29 14:45,1621,695,926,222732,44037,178695,163586437.0,32281557.0,131304879.0,1571,662,909,221407,43024,178383,162527082.0,31416193.0,131110889.0,0.7331,0.7348,0.7302,0.735
2023-09-29 14:50,1950,675,1275,304902,59596,245306,224206882.0,43577388.0,180629493.0,1929,657,1272,305371,59310,246061,224548033.0,43365995.0,181182038.0,0.7312,0.7363,0.7312,0.7363
2023-09-29 14:55,1792,758,1034,261238,60655,200583,192131750.0,44403442.0,147728308.0,1759,737,1022,255436,56950,198486,187828468.0,41629185.0,146199283.0,0.7321,0.7365,0.731,0.7366
2023-09-29 15:00,1035,338,697,144151,15155,128996,105930853.0,11050846.0,94880006.0,962,289,673,143135,15476,127659,105231871.0,11272565.0,93959305.0,0.7292,0.7355,0.7284,0.736
2023-09-29 15:05,2878,658,2220,493676,70592,423084,362172034.0,51403098.0,310768936.0,2828,618,2210,491481,68632,422849,360568428.0,49969868.0,310598560.0,0.7282,0.7345,0.7281,0.7345
2023-09-29 15:10,3132,1125,2007,502825,106703,396122,369010971.0,77727274.0,291283697.0,3078,1082,1996,501151,105737,395414,367773918.0,77013933.0,290759985.0,0.7284,0.7353,0.7284,0.7353
2023-09-29 15:15,2148,997,1151,317711,150870,166841,232649200.0,110048292.0,122600907.0,2120,983,1137,317899,151724,166175,232718812.0,110602698.0,122116113.0,0.7294,0.7348,0.729,0.7349
2023-09-29 15:20,1997,641,1356,355203,88275,266928,260526585.0,64377850.0,196148735.0,1963,619,1344,353740,87896,265844,259538474.0,64098522.0,195439952.0,0.7293,0.7348,0.7293,0.7352
2023-09-29 15:25,1860,465,1395,415165,25004,390161,304874649.0,18209271.0,286665377.0,1776,397,1379,411277,23116,388161,302070757.0,16828175.0,285242582.0,0.7283,0.7347,0.728,0.7349
2023-09-29 15:30,660,163,497,72988,9002,63986,53256132.0,6545893.0,46710238.0,593,121,472,66178,5085,61093,48523426.0,3698752.0,44824674.0,0.7272,0.73,0.7274,0.7337
2023-09-29 15:35,1023,478,545,146283,19119,127164,107174216.0,13936048.0,93238168.0,993,458,535,146227,19555,126672,107133549.0,14245334.0,92888215.0,0.7289,0.7332,0.7285,0.7333
2023-09-29 15:40,269,108,161,53302,4568,48734,39137769.0,3335490.0,35802279.0,219,69,150,51927,4091,47836,38131979.0,2973028.0,35158951.0,0.7302,0.7346,0.7267,0.735
2023-09-29 15:45,631,199,432,148086,14721,133365,108551931.0,10689545.0,97862386.0,600,177,423,146495,14042,132453,107409911.0,10197242.0,97212669.0,0.7261,0.7338,0.7262,0.7339
2023-09-29 15:50,535,132,403,80894,6002,74892,59274096.0,4367490.0,54906606.0,485,91,394,83998,5290,78708,61858630.0,3830495.0,58028135.0,0.7277,0.7331,0.7241,0.7373
2023-09-29 15:55,1489,966,523,167909,53959,113950,122844235.0,39472175.0,83372060.0,1434,922,512,165806,51417,114389,121078226.0,37387494.0,83690732.0,0.7315,0.7317,0.7271,0.7316
2023-09-29 16:00,1425,706,719,138544,41138,97406,101180330.0,29928872.0,71251457.0,1394,687,707,136778,40845,95933,99896140.0,29704313.0,70191827.0,0.7275,0.7315,0.7272,0.7317
2023-09-29 16:05,2110,711,1399,359541,44514,315027,262894819.0,32353635.0,230541184.0,2090,700,1390,356791,43194,313597,260829409.0,31386920.0,229442489.0,0.7268,0.7318,0.7266,0.7316
2023-09-29 16:10,592,212,380,60175,9621,50554,43993765.0,6987333.0,37006432.0,568,198,370,56817,8910,47907,41558579.0,6470632.0,35087947.0,0.7263,0.732,0.7262,0.7324
2023-09-29 16:15,151,80,71,20768,5743,15025,15144351.0,4163862.0,10980489.0,126,61,65,20985,5448,15537,15305716.0,3951107.0,11354609.0,0.725,0.7308,0.7252,0.7308
2023-09-29 16:20,1407,475,932,203614,25432,178182,149129425.0,18602996.0,130526429.0,1342,439,903,200948,23034,177914,147071655.0,16727862.0,130343793.0,0.7315,0.7325,0.7262,0.7326
2023-09-29 16:25,1786,729,1057,313172,60163,253009,229443948.0,43722085.0,185721863.0,1762,713,1049,311163,58686,252477,227976373.0,42642093.0,185334280.0,0.7267,0.7341,0.7266,0.7341
2023-09-29 16:30,954,287,667,187414,25117,162297,137486933.0,18257254.0,119229679.0,915,262,653,186963,24926,162037,137152894.0,18113199.0,119039695.0,0.7269,0.7346,0.7267,0.7346
2023-09-29 16:35,1110,465,645,240524,28224,212300,176447175.0,20511000.0,155936175.0,1084,453,631,239410,27949,211461,175642109.0,20312077.0,155330031.0,0.7267,0.7345,0.7268,0.7346
2023-09-29 16:40,819,187,632,203217,13580,189637,149148571.0,9857058.0,139291513.0,802,175,627,203647,13845,189802,149467712.0,10048325.0,139419387.0,0.7259,0.7345,0.7258,0.7346
2023-09-29 16:45,1501,554,947,248385,32333,216052,181878838.0,23539425.0,158339412.0,1466,534,932,246061,30572,215489,180148141.0,22218925.0,157929216.0,0.728,0.7329,0.7268,0.7329
2023-09-29 16:50,845,366,479,126810,35611,91199,92652558.0,25909578.0,66742979.0,833,358,475,126810,35703,91107,92636659.0,25964543.0,66672116.0,0.7276,0.7318,0.7272,0.7318
2023-09-29 16:55,1319,583,736,166921,57120,109801,121953534.0,41555606.0,80397927.0,1291,560,731,165846,56523,109323,121189960.0,41114906.0,80075053.0,0.7275,0.7322,0.7274,0.7325
2023-09-29 17:00,1600,904,696,187580,38381,149199,137562641.0,27984983.0,109577658.0,1573,886,687,186408,37804,148604,136679967.0,27530173.0,109149793.0,0.7291,0.7344,0.7282,0.7345
2023-09-29 17:05,262,145,117,34375,11335,23040,25196531.0,8253284.0,16943247.0,235,128,107,35910,13030,22880,26305335.0,9479718.0,16825616.0,0.7281,0.7354,0.7275,0.7354
2023-09-29 17:10,552,274,278,65384,22193,43191,47845424.0,16162539.0,31682885.0,539,267,272,64666,21840,42826,47303086.0,15884760.0,31418326.0,0.7283,0.7336,0.7273,0.7336
2023-09-29 17:15,1627,755,872,181241,46392,134849,132612912.0,33799935.0,98812977.0,1600,738,862,179414,45723,133691,131302067.0,33299071.0,98002996.0,0.7286,0.7328,0.7283,0.7331
2023-09-29 17:20,638,321,317,56593,16800,39793,41390436.0,12229677.0,29160759.0,618,302,316,54484,15342,39142,39876294.0,11167243.0,28709050.0,0.728,0.7328,0.7279,0.7335
2023-09-29 17:25,755,174,581,116877,13832,103045,85542973.0,10061184.0,75481788.0,716,145,571,114877,12760,102117,84095160.0,9279969.0,74815190.0,0.7274,0.7325,0.7273,0.7326
2023-09-29 17:30,1607,427,1180,232913,40792,192121,170031509.0,29673160.0,140358349.0,1580,416,1164,232332,40948,191384,169602530.0,29751599.0,139850930.0,0.7274,0.7306,0.7266,0.7307
2023-09-29 17:35,1482,258,1224,207498,12683,194815,151663715.0,9234438.0,142429277.0,1461,244,1217,205516,11203,194313,150207054.0,8144095.0,142062958.0,0.7281,0.7311,0.727,0.7311
2023-09-29 17:40,215,84,131,34366,6330,28036,25116219.0,4599176.0,20517042.0,200,72,128,31441,5208,26233,22980145.0,3783045.0,19197099.0,0.7266,0.7318,0.7264,0.7318
2023-09-29 17:45,142,53,89,29649,4580,25069,21693842.0,3330899.0,18362943.0,131,47,84,27918,4005,23913,20454726.0,2900780.0,17553945.0,0.7273,0.7325,0.7243,0.7341
2023-09-29 17:50,360,43,317,82860,5593,77267,60476022.0,4065083.0,56410939.0,342,32,310,81584,4825,76759,59556507.0,3502345.0,56054162.0,0.7268,0.7301,0.7259,0.7303
2023-09-29 17:55,328,163,165,50369,15683,34686,36550474.0,11384313.0,25166161.0,309,150,159,48200,15938,32262,35192044.0,11569189.0,23622855.0,0.7259,0.7255,0.7259,0.7322
2023-09-29 18:00,436,233,203,39895,13933,25962,29049957.0,10113550.0,18936406.0,423,221,202,40105,14107,25998,29221199.0,10227232.0,18993966.0,0.7259,0.7294,0.725,0.7306
2023-09-29 18:05,798,316,482,86195,17447,68748,62235735.0,12615992.0,49619743.0,709,263,446,79368,15209,64159,57747991.0,10994453.0,46753538.0,0.7231,0.7218,0.7229,0.7287
2023-09-29 18:10,2130,724,1406,200664,32026,168638,145941877.0,23248912.0,122692964.0,2018,632,1386,194707,27463,167244,141600675.0,19871341.0,121729334.0,0.7259,0.7276,0.7236,0.7279
2023-09-29 18:15,1311,577,734,151135,27117,124018,109703073.0,19606513.0,90096560.0,1258,544,714,148671,27549,121122,108070928.0,19893015.0,88177913.0,0.723,0.7265,0.7221,0.728
2023-09-29 18:20,1175,501,674,141806,11353,130453,103141961.0,8192298.0,94949663.0,1134,465,669,140237,10247,129990,102005988.0,7390654.0,94615334.0,0.7216,0.7278,0.7213,0.7279
2023-09-29 18:25,3084,1728,1356,483040,114882,368158,351441546.0,83033085.0,268408461.0,3061,1711,1350,481576,114105,367471,350381470.0,82461415.0,267920055.0,0.7228,0.7291,0.7227,0.7291
2023-09-29 18:30,5292,1570,3722,729042,122092,606950,528086985.0,90841197.0,437245788.0,5055,1385,3670,707083,111217,595866,510871671.0,81142948.0,429728722.0,0.744,0.7204,0.7296,0.7212
2023-09-29 18:35,4477,1615,2862,588354,99101,489253,424341849.0,73668194.0,350673655.0,4199,1412,2787,571888,85997,485891,412420194.0,64039517.0,348380676.0,0.7434,0.7168,0.7447,0.717
2023-10-02 10:00,3349,1808,1541,230116,122197,107919,167452033.0,88276864.0,79175169.0,2687,1443,1244,184722,96209,88513,133528114.0,69194147.0,64333967.0,0.7224,0.7337,0.7192,0.7268
2023-10-02 10:05,1329,741,588,85426,43548,41878,61784147.0,31392423.0,30391724.0,1066,594,472,72044,35569,36475,52092387.0,25586534.0,26505853.0,0.7209,0.7257,0.7193,0.7267
2023-10-02 10:10,1264,335,929,64484,15547,48937,46648307.0,11149953.0,35498354.0,1141,281,860,59101,13647,45454,42692079.0,9780726.0,32911353.0,0.7172,0.7254,0.7167,0.7241
2023-10-02 10:15,2059,1331,728,176137,116008,60129,127336876.0,83727556.0,43609320.0,1920,1267,653,162717,108168,54549,117457174.0,77880816.0,39576358.0,0.7217,0.7253,0.72,0.7255
2023-10-02 10:20,1482,631,851,104766,67699,37067,75528658.0,48688688.0,26839970.0,1403,572,831,100014,66171,33843,72090563.0,47569554.0,24521009.0,0.7192,0.7241,0.7189,0.7246
2023-10-02 10:25,632,497,135,47175,36549,10626,34150693.0,26366059.0,7784633.0,574,461,113,45107,34816,10291,32592650.0,25054743.0,7537907.0,0.7214,0.7326,0.7196,0.7325
2023-10-02 10:30,1133,576,557,82004,58491,23513,59379397.0,42329798.0,17049599.0,1072,533,539,77349,55313,22036,55832250.0,39849730.0,15982520.0,0.7237,0.7251,0.7204,0.7253
2023-10-02 10:35,269,131,138,19289,7906,11383,13933537.0,5700632.0,8232905.0,216,100,116,14582,6992,7590,10538033.0,5035210.0,5502822.0,0.7211,0.7233,0.7201,0.725
2023-10-02 10:40,386,271,115,53957,45135,8822,38855423.0,32471828.0,6383594.0,333,241,92,50961,43802,7159,36701173.0,31511839.0,5189334.0,0.7194,0.7236,0.7194,0.7249
2023-10-02 10:45,674,400,274,28215,17306,10909,20388403.0,12489777.0,7898625.0,560,343,217,26976,16187,10789,19505105.0,11689748.0,7815356.0,0.7217,0.724,0.7222,0.7244
2023-10-02 10:50,632,524,108,26715,21754,4961,19332786.0,15733903.0,3598883.0,587,489,98,26490,21547,4943,19158136.0,15573652.0,3584484.0,0.7233,0.7254,0.7228,0.7252
2023-10-02 10:55,868,655,213,81204,62998,18206,58813061.0,45615638.0,13197422.0,784,605,179,77922,60041,17881,56383704.0,43370907.0,13012797.0,0.7241,0.7249,0.7224,0.7277
2023-10-02 11:00,823,519,304,77169,53135,24034,55823650.0,38418264.0,17405386.0,781,498,283,73452,52120,21332,53205666.0,37667893.0,15537772.0,0.723,0.7242,0.7227,0.7284
2023-10-02 11:05,1555,892,663,143439,74059,69380,103809194.0,53467839.0,50341355.0,1516,873,643,141423,73141,68282,102424402.0,52798314.0,49626088.0,0.722,0.7256,0.7219,0.7268
2023-10-02 11:10,979,610,369,143839,52366,91473,104164425.0,37784792.0,66379633.0,943,582,361,142217,51534,90683,103111019.0,37187139.0,65923880.0,0.7216,0.7257,0.7216,0.727
2023-10-02 11:15,1166,704,462,107758,61110,46648,78237642.0,44325571.0,33912071.0,1119,677,442,104142,58343,45799,75482481.0,42150197.0,33332284.0,0.7253,0.727,0.7225,0.7278
2023-10-02 11:20,923,525,398,86327,55092,31235,62565602.0,39833753.0,22731849.0,910,516,394,85128,54588,30540,61683474.0,39456528.0,22226945.0,0.723,0.7278,0.7228,0.7278
2023-10-02 11:25,1107,759,348,139246,65312,73934,101034003.0,47216546.0,53817457.0,1078,745,333,138350,64952,73398,100384782.0,46942603.0,53442179.0,0.7229,0.7279,0.7227,0.7281
2023-10-02 11:30,494,376,118,45708,21234,24474,33187908.0,15369403.0,17818504.0,473,367,106,46151,21144,25007,33508745.0,15296364.0,18212381.0,0.7238,0.7281,0.7234,0.7283
2023-10-02 11:35,1291,702,589,154056,67285,86771,111769216.0,48593474.0,63175741.0,1250,679,571,150367,65895,84472,109084866.0,47590338.0,61494528.0,0.7222,0.7281,0.7222,0.728
2023-10-02 11:40,1872,1166,706,203524,110599,92925,147805660.0,80141283.0,67664377.0,1826,1142,684,199898,108930,90968,145045239.0,78811739.0,66233500.0,0.7246,0.7282,0.7235,0.7281
2023-10-02 11:45,2482,903,1579,283623,71151,212472,205933419.0,51474707.0,154458712.0,2460,890,1570,283300,70979,212321,205703847.0,51339438.0,154364408.0,0.7235,0.727,0.7233,0.727
2023-10-02 11:50,876,295,581,92900,17486,75414,67474855.0,12638115.0,54836740.0,841,272,569,90305,16456,73849,65626670.0,11890396.0,53736274.0,0.7228,0.7271,0.7226,0.7277
2023-10-02 11:55,577,225,352,60234,17821,42413,43789816.0,12902589.0,30887226.0,547,212,335,58532,17305,41227,42548732.0,12521400.0,30027331.0,0.724,0.7282,0.7236,0.7283
2023-10-02 12:00,1170,535,635,136075,34242,101833,99039842.0,24819757.0,74220085.0,1125,518,607,132151,32684,99467,96190914.0,23683826.0,72507087.0,0.7248,0.7288,0.7246,0.729
2023-10-02 12:05,1285,499,786,234455,47058,187397,170726384.0,34123128.0,136603256.0,1272,492,780,232737,45515,187222,169486635.0,33010066.0,136476569.0,0.7251,0.729,0.7253,0.729
2023-10-02 12:10,339,156,183,42091,11261,30830,30664817.0,8176128.0,22488689.0,320,149,171,41736,11992,29744,30396384.0,8683120.0,21713264.0,0.7261,0.7294,0.7241,0.73
2023-10-02 12:15,1300,557,743,235507,47979,187528,171430089.0,34755121.0,136674968.0,1259,537,722,232579,46346,186233,169297592.0,33554642.0,135742949.0,0.7244,0.7288,0.724,0.7289
2023-10-02 12:20,1703,677,1026,251395,58749,192646,182629152.0,42474421.0,140154730.0,1660,648,1012,248694,57516,191178,180717460.0,41583443.0,139134017.0,0.723,0.7275,0.723,0.7278
2023-10-02 12:25,578,169,409,140727,16983,123744,102224616.0,12227077.0,89997538.0,538,138,400,136727,13672,123055,99365952.0,9846363.0,89519589.0,0.72,0.7273,0.7202,0.7275
2023-10-02 12:30,2166,777,1389,333533,56375,277158,242102134.0,40711795.0,201390338.0,2127,758,1369,331015,55755,275260,240471836.0,40264523.0,200207312.0,0.7222,0.7266,0.7222,0.7273
2023-10-02 12:35,1364,319,1045,228908,26750,202158,165897070.0,19241850.0,146655220.0,1292,269,1023,228984,28369,200615,165947869.0,20377412.0,145570456.0,0.7193,0.7254,0.7183,0.7256
2023-10-02 12:40,2151,728,1423,263590,59258,204332,190566078.0,42613337.0,147952741.0,2102,687,1415,262047,58237,203810,189442388.0,41871088.0,147571300.0,0.7191,0.7241,0.719,0.7241
2023-10-02 12:45,2113,602,1511,308917,70406,238511,223437759.0,50674729.0,172763030.0,2097,593,1504,309818,70664,239154,224088223.0,50851997.0,173236225.0,0.7198,0.7243,0.7196,0.7244
2023-10-02 12:50,1118,505,613,194393,60024,134369,140654673.0,43226173.0,97428499.0,1085,486,599,189691,57353,132338,137356480.0,41304216.0,96052264.0,0.7201,0.7251,0.7202,0.7258
2023-10-02 12:55,1376,706,670,160687,56852,103835,116277290.0,40953632.0,75323658.0,1339,686,653,157921,55136,102785,114303073.0,39712707.0,74590365.0,0.7204,0.7254,0.7203,0.7257
2023-10-02 13:00,687,242,445,85612,14745,70867,62244853.0,10711963.0,51532889.0,648,225,423,80543,10435,70108,58535805.0,7531857.0,51003947.0,0.7265,0.7272,0.7218,0.7275
2023-10-02 13:05,843,487,356,122336,29034,93302,88868432.0,21016109.0,67852322.0,805,471,334,114875,22698,92177,83462958.0,16407203.0,67055755.0,0.7238,0.7272,0.7228,0.7275
2023-10-02 13:10,2286,627,1659,343728,45124,298604,250016434.0,32696323.0,217320111.0,2233,602,1631,340095,43199,296896,247346214.0,31253081.0,216093132.0,0.7246,0.7278,0.7235,0.7278
2023-10-02 13:15,2011,1284,727,211874,89037,122837,153958184.0,64489117.0,89469067.0,1968,1270,698,214126,93690,120436,155593338.0,67840244.0,87753093.0,0.7243,0.7284,0.7241,0.7286
2023-10-02 13:20,744,309,435,79477,21767,57710,57733116.0,15777243.0,41955873.0,720,297,423,77080,20551,56529,55996748.0,14870967.0,41125780.0,0.7248,0.727,0.7236,0.7275
2023-10-02 13:25,1656,715,941,155158,35145,120013,112727675.0,25461854.0,87265821.0,1632,697,935,151574,32196,119378,110113887.0,23321860.0,86792026.0,0.7245,0.7271,0.7244,0.727
2023-10-02 13:30,1437,890,547,124928,69970,54958,90710409.0,50767363.0,39943045.0,1408,878,530,125232,71385,53847,90840813.0,51704154.0,39136658.0,0.7256,0.7268,0.7243,0.7268
2023-10-02 13:35,959,641,318,74287,56449,17838,53953223.0,40960070.0,12993153.0,928,630,298,69966,53768,16198,50764604.0,38960513.0,11804091.0,0.7256,0.7284,0.7246,0.7287
2023-10-02 13:40,411,188,223,30639,15834,14805,22279141.0,11485466.0,10793674.0,374,165,209,29301,15082,14219,21302353.0,10918902.0,10383450.0,0.7254,0.7291,0.724,0.7303
2023-10-02 13:45,808,355,453,46520,15532,30988,33880738.0,11293457.0,22587281.0,749,333,416,43676,15727,27949,31814557.0,11422454.0,20392103.0,0.7271,0.7289,0.7263,0.7296
2023-10-02 13:50,458,197,261,27496,11072,16424,20075526.0,8119955.0,11955570.0,384,161,223,23857,9244,14613,17364056.0,6705995.0,10658060.0,0.7334,0.7279,0.7254,0.7294
2023-10-02 13:55,718,377,341,49543,23763,25780,36134187.0,17315970.0,18818217.0,667,334,333,45826,20894,24932,33427682.0,15207133.0,18220549.0,0.7287,0.73,0.7278,0.7308
2023-10-02 14:00,609,347,262,39825,23182,16643,29126043.0,16954623.0,12171420.0,552,321,231,33708,18689,15019,24605413.0,13606978.0,10998434.0,0.7314,0.7313,0.7281,0.7323
2023-10-02 14:05,840,590,250,65742,50522,15220,47991580.0,36944319.0,11047260.0,748,557,191,59699,48738,10961,43580620.0,35547947.0,8032673.0,0.7313,0.7258,0.7294,0.7328
2023-10-02 14:10,843,279,564,66044,23677,42367,47828297.0,17174958.0,30653339.0,784,252,532,58261,20064,38197,42429118.0,14563767.0,27865351.0,0.7254,0.7235,0.7259,0.7295
2023-10-02 14:15,585,221,364,39000,13620,25380,28381364.0,9894873.0,18486491.0,563,204,359,38134,13449,24685,27753219.0,9768390.0,17984828.0,0.7265,0.7284,0.7263,0.7286
2023-10-02 14:20,1995,457,1538,231497,45048,186449,168991644.0,32810902.0,136180741.0,1941,425,1516,227537,41429,186108,166024284.0,30089888.0,135934395.0,0.7284,0.7304,0.7263,0.7304
2023-10-02 14:25,614,411,203,43507,25026,18481,31752478.0,18237533.0,13514944.0,585,405,180,39603,22140,17463,28892428.0,16124231.0,12768197.0,0.7287,0.7313,0.7283,0.7312
2023-10-02 14:30,701,153,548,58900,7163,51737,43036019.0,5240475.0,37795544.0,674,149,525,60036,9392,50644,43826050.0,6814569.0,37011481.0,0.7316,0.7305,0.7256,0.7308
2023-10-02 14:35,359,66,293,22898,3152,19746,16715192.0,2299900.0,14415291.0,323,57,266,21910,2826,19084,15993155.0,2054884.0,13938271.0,0.7297,0.73,0.7271,0.7304
2023-10-02 14:40,139,70,69,7090,2500,4590,5186709.0,1834010.0,3352699.0,111,54,57,5787,1560,4227,4223101.0,1134409.0,3088692.0,0.7336,0.7304,0.7272,0.7307
2023-10-02 14:45,763,220,543,73075,15953,57122,53322187.0,11611646.0,41710540.0,742,207,535,71313,14812,56501,52027926.0,10770470.0,41257456.0,0.7279,0.7302,0.7271,0.7302
2023-10-02 14:50,280,135,145,23929,10547,13382,17459978.0,7689883.0,9770094.0,404,245,159,23030,10181,12849,16783207.0,7397385.0,9385822.0,0.7291,0.7301,0.7266,0.7305
2023-10-02 14:55,395,153,242,30095,12239,17856,21933924.0,8901687.0,13032237.0,380,145,235,30962,12961,18001,22550737.0,9412387.0,13138349.0,0.7273,0.7299,0.7262,0.7299
2023-10-02 15:00,463,170,293,33943,12558,21385,24708778.0,9131762.0,15577015.0,449,167,282,33321,12604,20717,24283017.0,9163428.0,15119589.0,0.7272,0.7284,0.727,0.7298
2023-10-02 15:05,190,98,92,23134,15487,7647,16702321.0,11234176.0,5468145.0,199,94,105,27398,20299,7099,19814047.0,14628282.0,5185765.0,0.7254,0.7151,0.7206,0.7305
2023-10-02 15:10,767,276,491,74754,31970,42784,54259609.0,23211637.0,31047972.0,752,265,487,72848,31374,41474,53032356.0,22778148.0,30254207.0,0.726,0.7257,0.726,0.7295
2023-10-02 15:15,1297,722,575,170803,103154,67649,124235514.0,74905650.0,49329864.0,1281,716,565,170392,102751,67641,123938031.0,74611942.0,49326089.0,0.7262,0.7292,0.7261,0.7292
2023-10-02 15:20,1635,685,950,196879,91772,105107,143249568.0,66619453.0,76630115.0,1598,678,920,197200,92376,104824,143517801.0,67062185.0,76455616.0,0.7259,0.7291,0.726,0.7294
2023-10-02 15:25,3471,1067,2404,422393,73944,348449,307557767.0,53626055.0,253931712.0,3459,1058,2401,421165,73760,347405,306690299.0,53492104.0,253198195.0,0.7252,0.7287,0.7252,0.7288
2023-10-02 15:30,1619,716,903,208969,50863,158106,152224851.0,36933092.0,115291759.0,1556,678,878,207014,49356,157658,150788408.0,35795991.0,114992417.0,0.7261,0.7292,0.7253,0.7294
2023-10-02 15:35,1863,782,1081,249608,69707,179901,181604201.0,50399582.0,131204618.0,1849,779,1070,249601,69600,180001,181601168.0,50319091.0,131282077.0,0.723,0.7293,0.723,0.7293
2023-10-02 15:40,1877,453,1424,233927,31955,201972,170391151.0,23137551.0,147253599.0,1844,429,1415,233150,31848,201302,169829082.0,23049658.0,146779423.0,0.7241,0.7291,0.7237,0.7292
2023-10-02 15:45,1361,500,861,151786,32585,119201,110190596.0,23582860.0,86607736.0,1316,477,839,146778,30923,115855,106796387.0,22368477.0,84427910.0,0.7237,0.7266,0.7234,0.7287
2023-10-02 15:50,1970,877,1093,240607,85845,154762,174922065.0,62125789.0,112796276.0,1898,831,1067,238317,84347,153970,173236196.0,61005175.0,112231021.0,0.7237,0.7288,0.7233,0.7289
2023-10-02 15:55,4042,1763,2279,506271,154008,352263,367598349.0,111417561.0,256180788.0,3985,1740,2245,500658,152316,348342,363882980.0,110228990.0,253653990.0,0.7235,0.7272,0.7237,0.7282
2023-10-02 16:00,465,110,355,60803,7378,53425,44165344.0,5318884.0,38846460.0,429,97,332,58217,7081,51136,42311878.0,5106053.0,37205825.0,0.7209,0.7271,0.7211,0.7276
2023-10-02 16:05,1460,450,1010,120781,21642,99139,87358058.0,15628659.0,71729399.0,1408,421,987,118310,19808,98502,85589957.0,14271112.0,71318844.0,0.7221,0.7235,0.7205,0.724
2023-10-02 16:10,792,571,221,65257,35045,30212,47160406.0,25260450.0,21899955.0,780,564,216,64565,34251,30314,46677144.0,24699170.0,21977973.0,0.7208,0.7249,0.7211,0.725
2023-10-02 16:15,1631,681,950,175780,43284,132496,127017284.0,31176764.0,95840519.0,1584,650,934,173702,41562,132140,125631322.0,29949805.0,95681517.0,0.7203,0.7233,0.7206,0.7241
2023-10-02 16:20,2628,895,1733,291347,66008,225339,210675187.0,47564158.0,163111028.0,2597,880,1717,289910,65628,224282,209659166.0,47291887.0,162367279.0,0.7206,0.7238,0.7206,0.7239
2023-10-02 16:25,1660,631,1029,134195,27641,106554,97030214.0,19930791.0,77099423.0,1633,611,1022,133034,26815,106219,96175778.0,19318308.0,76857470.0,0.7211,0.7236,0.7204,0.7236
2023-10-02 16:30,829,285,544,81072,11705,69367,58703215.0,8455398.0,50247817.0,778,250,528,79300,10907,68393,57406011.0,7853497.0,49552514.0,0.7224,0.7244,0.72,0.7245
2023-10-02 16:35,1063,158,905,112327,12262,100065,81153375.0,8821974.0,72331401.0,1033,139,894,111126,11991,99135,80298066.0,8624470.0,71673595.0,0.7195,0.7228,0.7192,0.723
2023-10-02 16:40,1338,415,923,134339,29015,105324,96632941.0,20759406.0,75873535.0,1297,398,899,125381,22805,102576,90382810.0,16366019.0,74016791.0,0.7155,0.7204,0.7177,0.7216
2023-10-02 16:45,629,157,472,60489,10764,49725,43606014.0,7730241.0,35875773.0,586,122,464,65972,16612,49360,47301106.0,11682576.0,35618530.0,0.7182,0.7215,0.7033,0.7216
2023-10-02 16:50,2296,1008,1288,218779,57460,161319,157874547.0,41324226.0,116550321.0,2263,987,1276,213449,52601,160848,154017449.0,37809608.0,116207840.0,0.7192,0.7225,0.7188,0.7225
2023-10-02 16:55,2679,1432,1247,253477,86007,167470,183101477.0,61895730.0,121205746.0,2661,1418,1243,251879,85782,166097,181884759.0,61690252.0,120194507.0,0.7197,0.7237,0.7192,0.7236
2023-10-02 17:00,1639,961,678,148015,71186,76829,106622083.0,51168451.0,55453631.0,1607,941,666,146820,70557,76263,105790141.0,50704693.0,55085448.0,0.7188,0.7218,0.7186,0.7223
2023-10-02 17:05,1354,593,761,120587,20164,100423,87025249.0,14490638.0,72534611.0,1339,586,753,124426,23881,100545,89767799.0,17146209.0,72621589.0,0.7186,0.7223,0.718,0.7223
2023-10-02 17:10,1020,556,464,77940,20492,57448,56138935.0,14713064.0,41425871.0,1019,540,479,77140,19893,57247,55601613.0,14278753.0,41322859.0,0.718,0.7211,0.7178,0.7218
2023-10-02 17:15,1517,759,758,114355,27317,87038,82547697.0,19699153.0,62848543.0,1475,744,731,111003,24756,86247,80074620.0,17798921.0,62275698.0,0.7211,0.7221,0.719,0.7221
2023-10-02 17:20,602,187,415,47922,12413,35509,34569479.0,8926951.0,25642528.0,638,220,418,47812,13023,34789,34516519.0,9360417.0,25156102.0,0.7192,0.7221,0.7188,0.7231
2023-10-02 17:25,180,84,96,12529,5325,7204,9031225.0,3820341.0,5210883.0,155,75,80,11871,4502,7369,8567989.0,3235631.0,5332357.0,0.7174,0.7233,0.7187,0.7236
2023-10-02 17:30,703,181,522,88249,12925,75324,63754674.0,9276475.0,54478199.0,673,171,502,86708,12520,74188,62648567.0,8985635.0,53662932.0,0.7177,0.7233,0.7177,0.7233
2023-10-02 17:35,665,138,527,86578,9826,76752,62574965.0,7081116.0,55493848.0,645,125,520,84586,8379,76207,61116972.0,6013558.0,55103414.0,0.7207,0.723,0.7177,0.7231
2023-10-02 17:40,903,348,555,92875,16630,76245,67005736.0,11946495.0,55059241.0,870,328,542,90686,14916,75770,65447780.0,10711829.0,54735950.0,0.7184,0.7221,0.7181,0.7224
2023-10-02 17:45,783,123,660,121238,5472,115766,87572440.0,3930613.0,83641827.0,776,118,658,120948,5652,115296,87360359.0,4045116.0,83315243.0,0.7183,0.7225,0.7157,0.7226
2023-10-02 17:50,261,54,207,31335,1541,29794,22643488.0,1108504.0,21534984.0,250,47,203,30404,1474,28930,21973957.0,1060268.0,20913689.0,0.7193,0.7228,0.7193,0.7229
2023-10-02 17:55,480,74,406,74066,3583,70483,53548633.0,2560150.0,50988482.0,461,65,396,73184,3034,70150,52924512.0,2176592.0,50747920.0,0.7145,0.7234,0.7174,0.7234
2023-10-02 18:00,458,249,209,27058,9957,17101,19513069.0,7159555.0,12353513.0,409,204,205,25925,9539,16386,18672930.0,6834011.0,11838919.0,0.719,0.7224,0.7164,0.7225
2023-10-02 18:05,141,72,69,10251,3215,7036,7351201.0,2310051.0,5041149.0,126,61,65,10038,2929,7109,7234194.0,2101680.0,5132514.0,0.7185,0.7165,0.7175,0.722
2023-10-02 18:10,189,78,111,17794,3795,13999,12824148.0,2723502.0,10100645.0,164,75,89,17862,3829,14033,12878385.0,2747258.0,10131126.0,0.7177,0.7215,0.7175,0.722
2023-10-02 18:15,1151,169,982,207532,8038,199494,149766436.0,5772654.0,143993781.0,1154,160,994,204767,7382,197385,147871003.0,5301375.0,142569627.0,0.7182,0.7218,0.7181,0.7223
2023-10-02 18:20,713,132,581,76239,8151,68088,54961963.0,5847946.0,49114017.0,683,129,554,74805,7299,67506,53948478.0,5236651.0,48711827.0,0.7175,0.7213,0.7174,0.7216
2023-10-02 18:25,758,149,609,95097,4715,90382,68526428.0,3375974.0,65150454.0,741,124,617,92762,4001,88761,66849136.0,2863951.0,63985184.0,0.716,0.7208,0.7158,0.7209
2023-10-02 18:30,2687,747,1940,353347,45826,307521,254550942.0,32805166.0,221745776.0,2615,718,1897,348827,44614,304213,251373241.0,31927957.0,219445284.0,0.7159,0.7211,0.7156,0.7214
2023-10-02 18:35,626,363,263,43581,19286,24295,31348730.0,13853290.0,17495439.0,643,373,270,41966,18444,23522,30165341.0,13208339.0,16957001.0,0.7183,0.7201,0.7161,0.7209
2023-10-03 10:00,4775,2593,2182,435700,240840,194860,311192660.0,170732036.0,140460624.0,4105,2299,1806,391588,216421,175167,280332102.0,154621654.0,125710447.0,0.7089,0.7208,0.7144,0.7177
2023-10-03 10:05,2432,1209,1223,210090,72104,137986,150002315.0,51282818.0,98719496.0,2121,994,1127,197526,64832,132694,141129467.0,45978787.0,95150679.0,0.7112,0.7154,0.7092,0.7171
2023-10-03 10:10,1604,711,893,108472,42671,65801,77554164.0,31205716.0,46348448.0,1160,410,750,87944,29982,57962,62332018.0,21088841.0,41243176.0,0.7313,0.7044,0.7034,0.7116
2023-10-03 10:15,3138,1211,1927,277105,77409,199696,195884913.0,54938074.0,140946838.0,2866,1028,1838,261840,69652,192188,184928298.0,48881305.0,136046993.0,0.7097,0.7058,0.7018,0.7079
2023-10-03 10:20,1452,708,744,108210,36032,72178,76251436.0,25056897.0,51194538.0,1190,564,626,99873,30861,69012,70324678.0,21285908.0,49038770.0,0.6954,0.7093,0.6897,0.7106
2023-10-03 10:25,1506,825,681,120316,55698,64618,85022266.0,39296711.0,45725554.0,1405,760,645,115562,52683,62879,81551091.0,37050818.0,44500272.0,0.7055,0.7076,0.7033,0.7077
2023-10-03 10:30,752,529,223,40058,21334,18724,28196427.0,14970735.0,13225692.0,666,488,178,38505,21301,17204,27178207.0,14977953.0,12200253.0,0.7017,0.7063,0.7032,0.7092
2023-10-03 10:35,2313,755,1558,237145,55642,181503,167317562.0,38963552.0,128354010.0,2203,697,1506,229160,51291,177869,161641436.0,35812350.0,125829085.0,0.7003,0.7072,0.6982,0.7074
2023-10-03 10:40,1121,685,436,85252,45954,39298,60435419.0,32607390.0,27828029.0,1016,610,406,79697,41775,37922,56392027.0,29450255.0,26941772.0,0.7096,0.7081,0.705,0.7105
2023-10-03 10:45,1423,1063,360,110524,76890,33634,78267668.0,54327065.0,23940603.0,1339,1007,332,107165,75781,31384,75805787.0,53464859.0,22340927.0,0.7066,0.7118,0.7055,0.7119
2023-10-03 10:50,666,351,315,47951,35463,12488,33843851.0,25062678.0,8781172.0,628,336,292,47449,36735,10714,33486173.0,25903788.0,7582385.0,0.7067,0.7032,0.7052,0.7077
2023-10-03 10:55,834,456,378,63847,23734,40113,45138512.0,16758742.0,28379770.0,795,431,364,63893,22508,41385,45163456.0,15869803.0,29293653.0,0.7061,0.7075,0.7051,0.7078
2023-10-03 11:00,1207,730,477,83541,62925,20616,59237337.0,44609986.0,14627350.0,1138,682,456,80803,60432,20371,57148502.0,42684970.0,14463532.0,0.7089,0.7095,0.7063,0.71
2023-10-03 11:05,976,677,299,96083,64859,31224,68113467.0,45855373.0,22258094.0,928,649,279,90420,63005,27415,64103340.0,44543210.0,19560129.0,0.707,0.7129,0.707,0.7135
2023-10-03 11:10,1463,776,687,168894,90371,78523,119284294.0,63768538.0,55515756.0,1377,722,655,161398,86780,74618,114218981.0,61215407.0,53003573.0,0.7056,0.707,0.7054,0.7103
2023-10-03 11:15,1538,726,812,150694,57789,92905,106933693.0,40858526.0,66075166.0,1491,696,795,150884,57907,92977,107038787.0,40871647.0,66167140.0,0.707,0.7112,0.7058,0.7117
2023-10-03 11:20,1015,458,557,106266,45316,60950,75452997.0,32079645.0,43373352.0,946,434,512,104872,44273,60599,74485660.0,31331543.0,43154116.0,0.7079,0.7116,0.7077,0.7121
2023-10-03 11:25,1319,393,926,162662,65702,96960,115422658.0,46465015.0,68957643.0,1278,371,907,161278,65090,96188,114491278.0,46033311.0,68457967.0,0.7072,0.7112,0.7072,0.7117
2023-10-03 11:30,954,235,719,87590,40277,47313,62052768.0,28414977.0,33637791.0,937,225,712,87987,40644,47343,62344651.0,28680678.0,33663972.0,0.7055,0.711,0.7057,0.7111
2023-10-03 11:35,1270,416,854,126782,43315,83467,89873419.0,30560548.0,59312870.0,1242,397,845,125396,41856,83540,88948775.0,29548682.0,59400093.0,0.7055,0.7106,0.706,0.711
2023-10-03 11:40,297,95,202,36351,12209,24142,25789519.0,8616684.0,17172835.0,278,84,194,34837,11938,22899,24711340.0,8422587.0,16288753.0,0.7058,0.7113,0.7055,0.7113
2023-10-03 11:45,1696,333,1363,185200,26359,158841,130969795.0,18548811.0,112420983.0,1614,285,1329,180249,25777,154472,127299116.0,17921951.0,109377164.0,0.7037,0.7078,0.6953,0.7081
2023-10-03 11:50,1216,377,839,151773,31535,120238,107364302.0,22273759.0,85090543.0,1164,348,816,148724,29736,118988,105135274.0,20926634.0,84208639.0,0.7063,0.7077,0.7037,0.7077
2023-10-03 11:55,1355,538,817,129603,51125,78478,91589475.0,36043708.0,55545767.0,1286,507,779,126806,50401,76405,89636385.0,35500975.0,54135409.0,0.705,0.7078,0.7044,0.7085
2023-10-03 12:00,957,331,626,83755,23923,59832,59134589.0,16841894.0,42292695.0,908,298,610,80320,20434,59886,56858720.0,14385858.0,42472862.0,0.704,0.7069,0.704,0.7092
2023-10-03 12:05,720,533,187,41746,28344,13402,29529577.0,20064884.0,9464693.0,667,499,168,38937,26988,11949,27533800.0,19043276.0,8490524.0,0.7079,0.7062,0.7056,0.7106
2023-10-03 12:10,1878,1193,685,201709,133380,68329,142969115.0,94447909.0,48521205.0,1819,1161,658,196690,129727,66963,139145898.0,91584969.0,47560928.0,0.7081,0.7101,0.706,0.7103
2023-10-03 12:15,2164,1206,958,260918,165185,95733,184164855.0,116483785.0,67681070.0,2102,1160,942,256099,163749,92350,180982345.0,115468330.0,65514014.0,0.7052,0.707,0.7052,0.7094
2023-10-03 12:20,3686,1144,2542,463695,51122,412573,327037788.0,35862011.0,291175776.0,3425,945,2480,451559,43610,407949,318877587.0,30568053.0,288309533.0,0.7015,0.7058,0.7009,0.7067
2023-10-03 12:25,604,336,268,64338,16607,47731,45428089.0,11699532.0,33728556.0,559,317,242,63668,16980,46688,44888759.0,11903840.0,32984919.0,0.7045,0.7066,0.7011,0.7065
2023-10-03 12:30,957,414,543,157244,25410,131834,110769116.0,17818501.0,92950615.0,898,367,531,155972,24364,131608,109881600.0,17080481.0,92801119.0,0.7012,0.7051,0.7011,0.7051
2023-10-03 12:35,1068,482,586,152968,19763,133205,107822039.0,13896308.0,93925731.0,1018,447,571,151065,18824,132241,106461464.0,13194863.0,93266601.0,0.7031,0.7051,0.701,0.7053
2023-10-03 12:40,2203,762,1441,286977,30207,256770,202327529.0,21198968.0,181128560.0,2168,736,1432,285437,29461,255976,201220773.0,20657176.0,180563597.0,0.7018,0.7054,0.7012,0.7054
2023-10-03 12:45,2130,787,1343,267554,32009,235545,188430447.0,22385088.0,166045359.0,2004,710,1294,258419,28343,230076,182240131.0,19848562.0,162391568.0,0.6993,0.7049,0.7003,0.7058
2023-10-03 12:50,1010,479,531,61293,18276,43017,43154291.0,12880799.0,30273491.0,861,354,507,55555,13647,41908,39043754.0,9536337.0,29507417.0,0.7048,0.7038,0.6988,0.7041
2023-10-03 12:55,691,334,357,69900,23973,45927,49245910.0,16820705.0,32425205.0,590,274,316,66510,22884,43626,46844345.0,16013588.0,30830756.0,0.7017,0.706,0.6998,0.7067
2023-10-03 13:00,1302,588,714,117328,35643,81685,82693396.0,25009076.0,57684320.0,1234,568,666,113339,34385,78954,79915466.0,24122617.0,55792849.0,0.7017,0.7062,0.7015,0.7067
2023-10-03 13:05,1564,446,1118,169988,27164,142824,119584834.0,19045879.0,100538955.0,1529,424,1105,166450,24557,141893,117163604.0,17164277.0,99999327.0,0.7011,0.7039,0.699,0.7048
2023-10-03 13:10,1408,510,898,169505,22588,146917,119539148.0,15827645.0,103711503.0,1365,484,881,170543,24241,146302,120258272.0,16976226.0,103282045.0,0.7007,0.7059,0.7003,0.706
2023-10-03 13:15,1303,468,835,193487,28269,165218,136256203.0,19784747.0,116471456.0,1281,453,828,191656,27850,163806,134989958.0,19496044.0,115493913.0,0.6999,0.705,0.7,0.7051
2023-10-03 13:20,1169,388,781,140026,12642,127384,98506765.0,8843306.0,89663459.0,1095,322,773,138086,11265,126821,97151320.0,7884804.0,89266516.0,0.6995,0.7039,0.6999,0.7039
2023-10-03 13:25,919,561,358,66661,19896,46765,47063907.0,14086826.0,32977081.0,873,532,341,63992,17815,46177,45053173.0,12481792.0,32571381.0,0.708,0.7052,0.7006,0.7054
2023-10-03 13:30,479,171,308,58235,8772,49463,40987553.0,6185634.0,34801919.0,447,155,292,56870,8031,48839,40044688.0,5628968.0,34415720.0,0.7052,0.7036,0.7009,0.7047
2023-10-03 13:35,1202,465,737,149150,16325,132825,105071189.0,11460334.0,93610855.0,1162,446,716,148727,16521,132206,104757780.0,11576866.0,93180914.0,0.702,0.7048,0.7007,0.7048
2023-10-03 13:40,679,348,331,72698,24524,48174,51319731.0,17337560.0,33982170.0,655,334,321,69675,22402,47273,49060303.0,15712148.0,33348155.0,0.707,0.7054,0.7014,0.7054
2023-10-03 13:45,1082,723,359,140318,99836,40482,98600177.0,70044934.0,28555243.0,1063,709,354,139731,99092,40639,98177426.0,69507558.0,28669868.0,0.7016,0.7054,0.7014,0.7055
2023-10-03 13:50,707,259,448,85180,28274,56906,59966957.0,19839624.0,40127332.0,680,243,437,84790,28146,56644,59698808.0,19737424.0,39961384.0,0.7017,0.7052,0.7013,0.7055
2023-10-03 13:55,618,134,484,69089,11325,57764,48601286.0,7912119.0,40689167.0,600,126,474,66711,10434,56277,46924633.0,7297623.0,39627010.0,0.6986,0.7044,0.6994,0.7041
2023-10-03 14:00,623,79,544,80720,9053,71667,56798946.0,6345469.0,50453476.0,614,74,540,81300,9161,72139,57210105.0,6420290.0,50789814.0,0.7009,0.704,0.7008,0.7041
2023-10-03 14:05,493,127,366,38491,7084,31407,27095027.0,4977478.0,22117548.0,473,116,357,38077,7098,30979,26795769.0,4973793.0,21821976.0,0.7026,0.7042,0.7007,0.7044
2023-10-03 14:10,190,97,93,15678,7404,8274,11041413.0,5193544.0,5847869.0,176,86,90,16022,7078,8944,11284629.0,4961843.0,6322786.0,0.7015,0.7068,0.701,0.7069
2023-10-03 14:15,283,107,176,23721,6216,17505,16783991.0,4380689.0,12403301.0,262,92,170,23293,6092,17201,16456583.0,4270530.0,12186053.0,0.7047,0.7086,0.701,0.7085
2023-10-03 14:20,861,391,470,61917,34236,27681,43491774.0,24013601.0,19478173.0,845,385,460,61144,34308,26836,42960872.0,24063492.0,18897379.0,0.7014,0.7037,0.7014,0.7042
2023-10-03 14:25,518,191,327,52682,14373,38309,37110554.0,10089853.0,27020701.0,503,178,325,52545,14248,38297,37002833.0,9991673.0,27011159.0,0.702,0.7053,0.7013,0.7053
2023-10-03 14:30,1295,718,577,136300,85991,50309,95768703.0,60304129.0,35464573.0,1259,686,573,135251,85063,50188,95030472.0,59652028.0,35378443.0,0.7013,0.7049,0.7013,0.7049
2023-10-03 14:35,1646,860,786,156502,102128,54374,110064231.0,71696313.0,38367918.0,1611,836,775,155508,101938,53570,109358219.0,71555516.0,37802702.0,0.702,0.7056,0.702,0.7057
2023-10-03 14:40,1013,614,399,119525,94842,24683,83953688.0,66581561.0,17372127.0,977,592,385,118406,94271,24135,83147628.0,66144548.0,17003080.0,0.702,0.7038,0.7016,0.7045
2023-10-03 14:45,364,253,111,58504,46500,12004,41096597.0,32636203.0,8460393.0,357,245,112,57926,46013,11913,40683572.0,32287956.0,8395616.0,0.7019,0.7048,0.7017,0.7047
2023-10-03 14:50,1352,745,607,130727,96515,34212,92171303.0,68032765.0,24138538.0,1312,720,592,127457,93572,33885,89616982.0,65704126.0,23912856.0,0.7049,0.7056,0.7022,0.7057
2023-10-03 14:55,2779,1711,1068,293860,220781,73079,206999993.0,155327204.0,51672789.0,2724,1686,1038,293176,221638,71538,206460798.0,155874332.0,50586466.0,0.7035,0.7071,0.7033,0.7071
2023-10-03 15:00,1009,651,358,108643,90775,17868,76494590.0,63879870.0,12614719.0,967,630,337,106771,90354,16417,75153322.0,63541303.0,11612018.0,0.7037,0.706,0.7032,0.7073
2023-10-03 15:05,182,72,110,13088,7215,5873,9223379.0,5071295.0,4152083.0,170,65,105,13968,7879,6089,9840230.0,5534508.0,4305722.0,0.7029,0.707,0.7024,0.7071
2023-10-03 15:10,286,231,55,11222,9424,1798,7902908.0,6632010.0,1270897.0,268,225,43,11155,9246,1909,7848172.0,6498161.0,1350010.0,0.7037,0.7068,0.7028,0.7072
2023-10-03 15:15,387,188,199,40836,27446,13390,28757682.0,19293487.0,9464195.0,372,177,195,39516,26928,12588,27795313.0,18901307.0,8894006.0,0.703,0.7068,0.7019,0.7065
2023-10-03 15:20,550,355,195,79029,64043,14986,55524067.0,44928203.0,10595864.0,527,349,178,78156,63677,14479,54938684.0,44698582.0,10240102.0,0.7015,0.7071,0.702,0.7072
2023-10-03 15:25,415,199,216,42272,27908,14364,29707480.0,19589689.0,10117790.0,395,193,202,41985,28160,13825,29539081.0,19765100.0,9773980.0,0.7019,0.7044,0.7019,0.707
2023-10-03 15:30,3472,1911,1561,409594,280561,129033,288545623.0,197301584.0,91244039.0,3447,1891,1556,410019,279542,130477,288824027.0,196554518.0,92269509.0,0.7032,0.7071,0.7031,0.7072
2023-10-03 15:35,2486,1306,1180,289266,209487,79779,203316725.0,147041426.0,56275299.0,2457,1289,1168,285139,206942,78197,200722208.0,145461177.0,55261031.0,0.7019,0.7054,0.7029,0.7067
2023-10-03 15:40,2366,821,1545,269801,146221,123580,189870501.0,102685571.0,87184930.0,2345,812,1533,268301,145076,123225,188849773.0,101871996.0,86977777.0,0.7023,0.7055,0.7022,0.7058
2023-10-03 15:45,2250,543,1707,209295,59736,149559,147482822.0,41964557.0,105518265.0,2227,531,1696,208989,59832,149157,147266284.0,42030217.0,105236066.0,0.7025,0.7055,0.7025,0.7055
2023-10-03 15:50,1866,474,1392,166386,56154,110232,117171993.0,39422000.0,77749993.0,1858,471,1387,166476,55742,110734,117239908.0,39132491.0,78107417.0,0.702,0.7053,0.702,0.7054
2023-10-03 15:55,628,230,398,60682,18288,42394,42777729.0,12846294.0,29931435.0,587,217,370,58781,18147,40634,41450998.0,12746009.0,28704989.0,0.7024,0.706,0.7024,0.7064
2023-10-03 16:00,943,271,672,102018,40014,62004,71700119.0,28080087.0,43620032.0,930,261,669,100671,39362,61309,70885733.0,27621541.0,43264192.0,0.7018,0.7035,0.7017,0.7057
2023-10-03 16:05,1580,740,840,169468,91457,78011,119188064.0,64120821.0,55067243.0,1539,720,819,169132,90863,78269,118991419.0,63704504.0,55286915.0,0.7011,0.7059,0.7011,0.7064
2023-10-03 16:10,2268,1087,1181,187564,88417,99147,132171301.0,62148464.0,70022837.0,2209,1064,1145,185183,87861,97322,130406284.0,61676594.0,68729690.0,0.7029,0.7063,0.702,0.7062
2023-10-03 16:15,1447,952,495,151116,132999,18117,106252410.0,93442678.0,12809731.0,1416,933,483,150718,132195,18523,105968535.0,92869676.0,13098858.0,0.7026,0.7071,0.7025,0.7072
2023-10-03 16:20,2248,1173,1075,199697,129299,70398,140925184.0,91084625.0,49840559.0,2176,1138,1038,197607,128150,69457,139383589.0,90186132.0,49197456.0,0.7044,0.708,0.7038,0.7083
2023-10-03 16:25,1639,887,752,143747,99507,44240,101416423.0,70056487.0,31359936.0,1593,864,729,141347,98872,42475,99705903.0,69594584.0,30111318.0,0.704,0.7089,0.7039,0.7089
2023-10-03 16:30,1755,714,1041,190659,92993,97666,134386396.0,65368191.0,69018204.0,1730,706,1024,190280,93251,97029,134100331.0,65530622.0,68569709.0,0.7029,0.7067,0.7027,0.7067
2023-10-03 16:35,1576,535,1041,150020,66848,83172,105741490.0,46970383.0,58771107.0,1540,524,1016,149261,66249,83012,105200611.0,46542709.0,58657902.0,0.7026,0.7066,0.7025,0.7066
2023-10-03 16:40,1108,665,443,105477,72225,33252,74288763.0,50776790.0,23511973.0,1051,652,399,103765,71226,32539,73070268.0,50065976.0,23004292.0,0.703,0.7071,0.7029,0.707
2023-10-03 16:45,1472,1030,442,166961,118431,48530,117514998.0,83207551.0,34307446.0,1445,1019,426,163733,115506,48227,115247679.0,81139059.0,34108620.0,0.7026,0.7069,0.7025,0.7073
2023-10-03 16:50,1719,844,875,177940,116421,61519,125200899.0,81767815.0,43433084.0,1665,826,839,176602,115589,61013,124288536.0,81175487.0,43113048.0,0.7023,0.706,0.7023,0.7066
2023-10-03 16:55,1242,758,484,153070,106078,46992,107776681.0,74498445.0,33278236.0,1218,751,467,151430,105731,45699,106555717.0,74260668.0,32295048.0,0.7023,0.7082,0.7024,0.7067
2023-10-03 17:00,2249,1156,1093,202076,121785,80291,142338329.0,85585679.0,56752649.0,2217,1140,1077,201792,121382,80410,142135204.0,85291968.0,56843236.0,0.7028,0.7068,0.7027,0.7069
2023-10-03 17:05,2045,1007,1038,201164,120360,80804,141704705.0,84573544.0,57131160.0,2013,991,1022,202347,122022,80325,142523208.0,85728787.0,56794421.0,0.7027,0.707,0.7026,0.7071
2023-10-03 17:10,1543,709,834,150315,102631,47684,106008319.0,72232679.0,33775639.0,1494,695,799,146315,99353,46962,103123757.0,69863025.0,33260732.0,0.7038,0.7083,0.7032,0.7082
2023-10-03 17:15,3005,1397,1608,288303,129159,159144,203273699.0,90831484.0,112442214.0,2957,1369,1588,287095,128352,158743,202599593.0,90251499.0,112348093.0,0.7033,0.7065,0.7032,0.7077
2023-10-03 17:20,1007,506,501,118657,63426,55231,83664037.0,44588627.0,39075410.0,966,489,477,119939,65681,54258,84555360.0,46152491.0,38402869.0,0.703,0.7075,0.7027,0.7078
2023-10-03 17:25,2133,929,1204,216675,100237,116438,152720218.0,70441587.0,82278631.0,2112,926,1186,216787,100262,116525,152803206.0,70439301.0,82363904.0,0.7028,0.7066,0.7026,0.7068
2023-10-03 17:30,1066,448,618,149793,57978,91815,105597518.0,40704364.0,64893154.0,1045,441,604,153994,62579,91415,108183174.0,43570744.0,64612430.0,0.7021,0.7068,0.6963,0.7068
2023-10-03 17:35,1341,597,744,215667,84357,131310,151999635.0,59214450.0,92785185.0,1302,577,725,214244,83134,131110,151014074.0,58315066.0,92699008.0,0.702,0.7066,0.7015,0.707
2023-10-03 17:40,1129,509,620,142197,45256,96941,100321442.0,31781210.0,68540232.0,1098,490,608,141132,45077,96055,99572534.0,31653191.0,67919342.0,0.7023,0.707,0.7022,0.7071
2023-10-03 17:45,1509,609,900,133646,49009,84637,94101864.0,34398514.0,59703350.0,1474,590,884,132688,48134,84554,93428217.0,33784563.0,59643653.0,0.7019,0.7054,0.7019,0.7054
2023-10-03 17:50,951,365,586,106868,46854,60014,75271473.0,32892793.0,42378680.0,932,352,580,106401,46467,59934,74950100.0,32622678.0,42327422.0,0.702,0.7061,0.7021,0.7062
2023-10-03 17:55,1216,418,798,146028,53046,92982,102853318.0,37239742.0,65613576.0,1196,412,784,146473,53226,93247,103214342.0,37365152.0,65849189.0,0.702,0.7057,0.702,0.7062
2023-10-03 18:00,2407,602,1805,306480,74097,232383,216208072.0,52054087.0,164153984.0,2390,593,1797,309531,74826,234705,218559591.0,52551920.0,166007671.0,0.7025,0.7064,0.7023,0.7073
2023-10-03 18:05,1538,415,1123,180685,56427,124258,127415828.0,39630543.0,87785285.0,1528,413,1115,179965,56251,123714,126906464.0,39506982.0,87399482.0,0.7023,0.7065,0.7023,0.7065
2023-10-03 18:10,3363,1924,1439,455951,201613,254338,321457765.0,141650690.0,179807074.0,3364,1926,1438,457211,201915,255296,322334698.0,141845021.0,180489676.0,0.7026,0.707,0.7025,0.707
2023-10-03 18:15,3491,1418,2073,435342,160040,275302,307006074.0,112424516.0,194581558.0,3478,1407,2071,434412,159192,275220,306347650.0,111824701.0,194522948.0,0.7025,0.7068,0.7025,0.7068
2023-10-03 18:20,1493,135,1358,198140,14461,183679,140065611.0,10182187.0,129883423.0,1476,120,1356,197879,14270,183609,139852434.0,10018293.0,129834140.0,0.7041,0.7071,0.7021,0.7071
2023-10-03 18:25,2015,776,1239,244596,90489,154107,172596113.0,63658881.0,108937232.0,1993,762,1231,241919,89776,152143,170709224.0,63156872.0,107552352.0,0.7035,0.7069,0.7035,0.7069
2023-10-03 18:30,1265,673,592,128197,69557,58640,90305080.0,48886427.0,41418653.0,1247,665,582,127591,69988,57603,89867015.0,49164867.0,40702147.0,0.7028,0.7063,0.7025,0.7066
2023-10-03 18:35,4211,1592,2619,593328,173446,419882,418615836.0,121908430.0,296707406.0,4196,1586,2610,592641,173067,419574,418135165.0,121640375.0,296494789.0,0.7029,0.7066,0.7029,0.7067
2023-10-04 10:00,4155,1997,2158,367414,184897,182517,259201078.0,129437328.0,129763749.0,3654,1764,1890,339868,172728,167140,239573900.0,121301674.0,118272225.0,0.7001,0.711,0.7023,0.7076
2023-10-04 10:05,1285,732,553,82150,27176,54974,57806938.0,19059675.0,38747262.0,1153,638,515,76648,23787,52861,54028790.0,16706508.0,37322281.0,0.7013,0.7048,0.7023,0.706
2023-10-04 10:10,1689,725,964,136858,28019,108839,96523499.0,19685513.0,76837986.0,1519,640,879,127117,24749,102368,89632357.0,17375578.0,72256779.0,0.7026,0.706,0.7021,0.7059
2023-10-04 10:15,1273,668,605,76221,45956,30265,54315624.0,32950423.0,21365200.0,1178,605,573,72409,42865,29544,50966796.0,30111001.0,20855795.0,0.717,0.7059,0.7025,0.7059
2023-10-04 10:20,1068,589,479,78126,44122,34004,55278559.0,31143883.0,24134676.0,956,525,431,68700,37078,31622,48495139.0,26105943.0,22389196.0,0.7059,0.7098,0.7041,0.708
2023-10-04 10:25,904,632,272,47900,31984,15916,33997028.0,22673925.0,11323102.0,904,626,278,45154,30442,14712,31984335.0,21517932.0,10466403.0,0.7089,0.7114,0.7069,0.7114
2023-10-04 10:30,1314,608,706,78404,32403,46001,55593634.0,22933019.0,32660615.0,1215,529,686,76488,31483,45005,54232833.0,22245330.0,31987503.0,0.7077,0.71,0.7066,0.7108
2023-10-04 10:35,2100,1294,806,145697,74100,71597,103619195.0,52557216.0,51061979.0,1989,1228,761,138969,71167,67802,98670459.0,50372773.0,48297686.0,0.7093,0.7132,0.7078,0.7123
2023-10-04 10:40,1600,1016,584,111495,68206,43289,79090946.0,48246119.0,30844826.0,1533,992,541,108740,67164,41576,77133734.0,47497993.0,29635740.0,0.7074,0.7125,0.7072,0.7128
2023-10-04 10:45,1159,648,511,72423,43847,28576,51352654.0,31044662.0,20307992.0,1120,623,497,70531,42741,27790,50057661.0,30259822.0,19797838.0,0.708,0.7107,0.708,0.7124
2023-10-04 10:50,1065,572,493,69246,35784,33462,49167750.0,25343442.0,23824308.0,1018,554,464,67103,34854,32249,47653185.0,24684769.0,22968415.0,0.7082,0.712,0.7082,0.7122
2023-10-04 10:55,1122,713,409,82327,55412,26915,58355681.0,39215848.0,19139832.0,1098,705,393,82657,56568,26089,58586140.0,40024201.0,18561938.0,0.7077,0.7111,0.7075,0.7115
2023-10-04 11:00,872,430,442,54260,30152,24108,38443942.0,21296800.0,17147142.0,845,413,432,53520,29292,24228,37903395.0,20671954.0,17231440.0,0.7063,0.7113,0.7057,0.7112
2023-10-04 11:05,752,226,526,41243,14743,26500,29219250.0,10407449.0,18811801.0,723,210,513,40271,14433,25838,28539492.0,10161341.0,18378150.0,0.7059,0.7099,0.704,0.7113
2023-10-04 11:10,629,167,462,41969,15764,26205,29753793.0,11134560.0,18619232.0,583,135,448,37711,15007,22704,26723195.0,10588110.0,16135084.0,0.7063,0.7105,0.7055,0.7107
2023-10-04 11:15,672,504,168,78040,61585,16455,55302033.0,43579407.0,11722626.0,649,489,160,76028,60746,15282,53811148.0,42928765.0,10882383.0,0.7076,0.7124,0.7067,0.7121
2023-10-04 11:20,1113,789,324,115924,94189,21735,82166404.0,66687000.0,15479403.0,1089,772,317,114795,93516,21279,81345427.0,66192234.0,15153193.0,0.708,0.7122,0.7078,0.7121
2023-10-04 11:25,511,396,115,39491,30153,9338,28018232.0,21366413.0,6651819.0,482,385,97,38728,29873,8855,27477261.0,21163627.0,6313633.0,0.7086,0.7123,0.7085,0.713
2023-10-04 11:30,878,290,588,72658,45420,27238,51506824.0,32137536.0,19369287.0,861,281,580,72109,45046,27063,51112595.0,31861530.0,19251065.0,0.7076,0.7111,0.7073,0.7113
2023-10-04 11:35,726,213,513,52712,21373,31339,37423379.0,15144998.0,22278381.0,693,187,506,49222,20104,29118,34957599.0,14231707.0,20725891.0,0.7086,0.7109,0.7079,0.7118
2023-10-04 11:40,300,167,133,23499,14919,8580,16689124.0,10595139.0,6093985.0,285,158,127,22412,14012,8400,15869237.0,9902506.0,5966731.0,0.7102,0.7103,0.7067,0.7103
2023-10-04 11:45,908,352,556,76670,33848,42822,54287953.0,23919846.0,30368106.0,854,331,523,73765,33282,40483,52251620.0,23508405.0,28743215.0,0.7067,0.7092,0.7063,0.71
2023-10-04 11:50,1184,340,844,91386,29828,61558,64643634.0,21051355.0,43592279.0,1110,304,806,88790,27582,61208,62835246.0,19443462.0,43391783.0,0.7058,0.7081,0.7049,0.7089
2023-10-04 11:55,683,284,399,56158,23907,32251,39738014.0,16872817.0,22865197.0,662,272,390,53844,22775,31069,38116273.0,16069213.0,22047060.0,0.7058,0.709,0.7056,0.7096
2023-10-04 12:00,406,164,242,26586,11637,14949,18813098.0,8219244.0,10593854.0,382,147,235,25524,11269,14255,18055242.0,7952091.0,10103150.0,0.7063,0.7087,0.7057,0.7087
2023-10-04 12:05,179,92,87,13986,6974,7012,9880071.0,4913809.0,4966261.0,153,79,74,10710,6159,4551,7561709.0,4334663.0,3227045.0,0.7046,0.7083,0.7038,0.7091
2023-10-04 12:10,465,143,322,35550,13933,21617,25015653.0,9803045.0,15212607.0,427,120,307,33363,12971,20392,23543753.0,9128052.0,14415700.0,0.7036,0.7037,0.7037,0.7069
2023-10-04 12:15,155,66,89,12481,6679,5802,8799964.0,4700053.0,4099911.0,141,56,85,12921,6021,6900,9127344.0,4231475.0,4895868.0,0.7037,0.7066,0.7028,0.7095
2023-10-04 12:20,675,311,364,42043,19136,22907,29687696.0,13496685.0,16191011.0,653,295,358,39534,15741,23793,27923575.0,11090198.0,16833377.0,0.7053,0.7068,0.7045,0.7075
2023-10-04 12:25,625,354,271,42529,18506,24023,30037656.0,13050058.0,16987598.0,609,341,268,42452,17944,24508,29987758.0,12646388.0,17341370.0,0.7052,0.7071,0.7048,0.7076
2023-10-04 12:30,474,350,124,39025,27842,11183,27559912.0,19644059.0,7915852.0,462,345,117,38521,27571,10950,27187773.0,19436833.0,7750940.0,0.7056,0.7078,0.705,0.7078
2023-10-04 12:35,641,504,137,48864,36700,12164,34573921.0,25961106.0,8612814.0,625,496,129,49799,38231,11568,35138503.0,26948341.0,8190161.0,0.7074,0.7081,0.7049,0.708
2023-10-04 12:40,810,491,319,73095,45862,27233,51575882.0,32358849.0,19217033.0,775,471,304,70719,44938,25781,49919904.0,31669792.0,18250111.0,0.7056,0.7057,0.7047,0.7079
2023-10-04 12:45,670,458,212,48011,30666,17345,33865549.0,21594242.0,12271306.0,650,449,201,47491,30492,16999,33500835.0,21471389.0,12029445.0,0.7042,0.7075,0.7042,0.7077
2023-10-04 12:50,625,202,423,54575,26274,28301,38453164.0,18480410.0,19972754.0,605,189,416,53255,25402,27853,37547598.0,17855141.0,19692457.0,0.7034,0.7057,0.7029,0.707
2023-10-04 12:55,93,41,52,9976,5336,4640,7036109.0,3755847.0,3280262.0,75,30,45,8901,4702,4199,6275853.0,3304602.0,2971250.0,0.7039,0.707,0.7028,0.7076
2023-10-04 13:00,576,428,148,57277,40840,16437,40317732.0,28734938.0,11582794.0,549,414,135,55989,40276,15713,39443148.0,28323634.0,11119514.0,0.7036,0.7047,0.7032,0.7077
2023-10-04 13:05,295,256,39,32952,28061,4891,23198919.0,19749581.0,3449338.0,274,240,34,32009,27494,4515,22482129.0,19296161.0,3185967.0,0.7038,0.7052,0.7018,0.7056
2023-10-04 13:10,1055,413,642,104384,48511,55873,72709004.0,33795216.0,38913787.0,978,358,620,93036,42074,50962,65454767.0,29530906.0,35923860.0,0.6967,0.6965,0.7019,0.7049
2023-10-04 13:15,392,191,201,19362,6216,13146,13628573.0,4357043.0,9271529.0,342,155,187,17391,5330,12061,12242984.0,3737851.0,8505132.0,0.7009,0.7053,0.7013,0.7052
2023-10-04 13:20,578,427,151,26472,14381,12091,18643601.0,10085560.0,8558041.0,557,407,150,25569,13304,12265,18026161.0,9342766.0,8683395.0,0.7013,0.7078,0.7023,0.708
2023-10-04 13:25,581,394,187,29329,13701,15628,20646363.0,9623172.0,11023191.0,563,382,181,30219,13423,16796,21283295.0,9426779.0,11856516.0,0.7024,0.7053,0.7023,0.7059
2023-10-04 13:30,446,232,214,33419,7826,25593,23539216.0,5496858.0,18042358.0,401,194,207,32380,7753,24627,22813956.0,5443038.0,17370918.0,0.7024,0.705,0.7021,0.7054
2023-10-04 13:35,137,50,87,11454,2394,9060,8021490.0,1680947.0,6340542.0,115,29,86,10086,1813,8273,7105360.0,1270079.0,5835281.0,0.7022,0.6998,0.7005,0.7053
2023-10-04 13:40,184,81,103,16743,2134,14609,11804355.0,1498290.0,10306065.0,161,57,104,16681,1714,14967,11762697.0,1201124.0,10561573.0,0.7021,0.7055,0.7008,0.7057
2023-10-04 13:45,374,144,230,28287,6750,21537,19939120.0,4739358.0,15199762.0,362,137,225,27725,6299,21426,19523793.0,4404902.0,15118891.0,0.7021,0.7058,0.6993,0.7056
2023-10-04 13:50,997,585,412,76962,23001,53961,54235031.0,16174265.0,38060765.0,966,564,402,75509,22689,52820,53202640.0,15941518.0,37261122.0,0.7032,0.7053,0.7026,0.7054
2023-10-04 13:55,173,56,117,14320,4110,10210,10053006.0,2886563.0,7166442.0,151,42,109,13291,3419,9872,9358506.0,2397538.0,6960968.0,0.7023,0.7019,0.7012,0.7051
2023-10-04 14:00,193,142,51,10977,5984,4993,7813274.0,4283638.0,3529636.0,183,134,49,10906,5296,5610,7685978.0,3720642.0,3965336.0,0.7158,0.7069,0.7025,0.7068
2023-10-04 14:05,351,211,140,19123,10727,8396,13471726.0,7538185.0,5933541.0,337,205,132,18322,10690,7632,12904407.0,7511894.0,5392513.0,0.7027,0.7067,0.7027,0.7066
2023-10-04 14:10,206,106,100,19369,9773,9596,13620887.0,6859319.0,6761567.0,187,99,88,18570,9387,9183,13065055.0,6588686.0,6476368.0,0.7019,0.7046,0.7019,0.7053
2023-10-04 14:15,199,72,127,18506,4936,13570,13019807.0,3464564.0,9555242.0,177,59,118,17859,4606,13253,12580011.0,3228195.0,9351816.0,0.7019,0.7041,0.7009,0.7056
2023-10-04 14:20,433,66,367,28182,2501,25681,19864659.0,1758253.0,18106405.0,405,52,353,26605,1737,24868,18750144.0,1217580.0,17532563.0,0.703,0.7051,0.701,0.705
2023-10-04 14:25,290,113,177,27597,3810,23787,19464101.0,2674908.0,16789193.0,283,110,173,27964,4040,23924,19725076.0,2836764.0,16888311.0,0.7021,0.7058,0.7022,0.7059
2023-10-04 14:30,294,115,179,25607,5556,20051,18009392.0,3899103.0,14110289.0,285,112,173,25283,5491,19792,17803802.0,3851318.0,13952483.0,0.7018,0.7037,0.7014,0.705
2023-10-04 14:35,274,108,166,36637,6702,29935,25789639.0,4700979.0,21088660.0,261,97,164,36197,6389,29808,25483952.0,4481282.0,21002669.0,0.7014,0.7045,0.7014,0.7046
2023-10-04 14:40,445,104,341,48911,6927,41984,34410548.0,4855475.0,29555072.0,423,87,336,48160,6698,41462,33881554.0,4694613.0,29186941.0,0.7009,0.704,0.7009,0.7039
2023-10-04 14:45,300,61,239,15660,2833,12827,11017665.0,1990279.0,9027386.0,283,45,238,15285,2682,12603,10751892.0,1881276.0,8870615.0,0.7025,0.7038,0.7014,0.7038
2023-10-04 14:50,691,69,622,88435,3021,85414,62241598.0,2123692.0,60117905.0,682,62,620,88843,3138,85705,62522415.0,2199650.0,60322765.0,0.703,0.7038,0.701,0.7038
2023-10-04 14:55,92,33,59,10096,2683,7413,7106286.0,1892766.0,5213519.0,76,25,51,9072,2292,6780,6381139.0,1606842.0,4774296.0,0.7055,0.7033,0.7011,0.7042
2023-10-04 15:00,251,67,184,21162,2416,18746,14896259.0,1698081.0,13198177.0,239,59,180,21711,2700,19011,15277800.0,1892342.0,13385457.0,0.7028,0.7041,0.7009,0.7041
2023-10-04 15:05,99,35,64,11418,2993,8425,8035402.0,2098738.0,5936664.0,91,29,62,10334,2226,8108,7273298.0,1560255.0,5713042.0,0.7012,0.7046,0.7009,0.7046
2023-10-04 15:10,183,51,132,22797,3111,19686,16008813.0,2184728.0,13824084.0,169,41,128,22257,2857,19400,15673424.0,2002611.0,13670813.0,0.7023,0.7022,0.7009,0.7047
2023-10-04 15:15,275,76,199,26051,2440,23611,18297832.0,1732077.0,16565754.0,254,64,190,25545,2192,23353,17982428.0,1537451.0,16444977.0,0.7099,0.7016,0.7014,0.7042
2023-10-04 15:20,570,127,443,31273,3631,27642,21998053.0,2548753.0,19449299.0,552,119,433,30976,3610,27366,21791460.0,2532688.0,19258771.0,0.7019,0.7036,0.7016,0.7037
2023-10-04 15:25,226,96,130,14274,3405,10869,10032657.0,2389343.0,7643314.0,209,84,125,14122,3260,10862,9928997.0,2285781.0,7643216.0,0.7017,0.7032,0.7012,0.7037
2023-10-04 15:30,399,80,319,26483,2389,24094,18586173.0,1657672.0,16928500.0,382,70,312,26198,2166,24032,18428139.0,1518817.0,16909321.0,0.6939,0.7026,0.7012,0.7036
2023-10-04 15:35,628,88,540,33941,7705,26236,23413091.0,5070460.0,18342630.0,555,54,501,27146,2032,25114,19080131.0,1422404.0,17657726.0,0.6581,0.6991,0.7,0.7031
2023-10-04 15:40,511,197,314,38246,7149,31097,26870824.0,5034450.0,21836374.0,470,179,291,35315,5541,29774,24805467.0,3858286.0,20947181.0,0.7042,0.7022,0.6963,0.7035
2023-10-04 15:45,275,73,202,10124,2284,7840,7104054.0,1597829.0,5506225.0,253,62,191,9721,1796,7925,6830388.0,1258379.0,5572009.0,0.6996,0.7023,0.7007,0.7031
2023-10-04 15:50,716,129,587,74011,5610,68401,52007825.0,3928070.0,48079755.0,684,110,574,73475,5274,68201,51651104.0,3692345.0,47958759.0,0.7002,0.7029,0.7001,0.7032
2023-10-04 15:55,546,118,428,69570,5462,64108,48883114.0,3821904.0,45061210.0,532,111,421,69512,5437,64075,48851154.0,3805332.0,45045822.0,0.6997,0.7029,0.6999,0.703
2023-10-04 16:00,577,218,359,41532,6946,34586,29186732.0,4890332.0,24296399.0,561,206,355,40998,6550,34448,28811573.0,4584726.0,24226846.0,0.7041,0.7025,0.7,0.7033
2023-10-04 16:05,374,85,289,42812,4187,38625,30113461.0,2941614.0,27171847.0,353,75,278,44031,5619,38412,30946272.0,3921188.0,27025083.0,0.7026,0.7035,0.6978,0.7036
2023-10-04 16:10,564,266,298,31053,4782,26271,21710163.0,3339547.0,18370616.0,516,238,278,29015,4539,24476,20375253.0,3172214.0,17203038.0,0.6984,0.6993,0.6989,0.7029
2023-10-04 16:15,831,260,571,56478,7318,49160,39538175.0,5114066.0,34424109.0,781,233,548,54892,6780,48112,38488643.0,4736144.0,33752498.0,0.6988,0.7002,0.6985,0.7015
2023-10-04 16:20,1045,461,584,71006,16637,54369,49774179.0,11637284.0,38136895.0,956,434,522,70218,15929,54289,49204442.0,11116164.0,38088277.0,0.6995,0.7014,0.6979,0.7016
2023-10-04 16:25,895,378,517,49643,13391,36252,34863752.0,9375980.0,25487772.0,857,353,504,47660,11524,36136,33466839.0,8061068.0,25405771.0,0.7002,0.7031,0.6995,0.7031
2023-10-04 16:30,501,129,372,36191,7779,28412,25406236.0,5441557.0,19964678.0,492,127,365,36193,7903,28290,25404864.0,5525399.0,19879465.0,0.6995,0.7027,0.6992,0.7027
2023-10-04 16:35,236,141,95,14288,5512,8776,10026093.0,3858096.0,6167997.0,212,129,83,12772,4887,7885,8962652.0,3416456.0,5546196.0,0.6999,0.7028,0.6991,0.7034
2023-10-04 16:40,1022,148,874,111625,12596,99029,78290092.0,8778588.0,69511503.0,991,127,864,113722,14518,99204,79449841.0,9811750.0,69638090.0,0.6969,0.7019,0.6758,0.702
2023-10-04 16:45,833,287,546,69455,13342,56113,48552105.0,9274442.0,39277662.0,788,257,531,65496,11614,53882,45913909.0,8100606.0,37813303.0,0.6951,0.7,0.6975,0.7018
2023-10-04 16:50,1341,708,633,116696,31764,84932,81502457.0,21923253.0,59579204.0,1304,687,617,111161,28038,83123,77895512.0,19582469.0,58313042.0,0.6902,0.7015,0.6984,0.7015
2023-10-04 16:55,466,311,155,34907,13240,21667,24487640.0,9252631.0,15235008.0,460,304,156,35625,12778,22847,24994415.0,8929466.0,16064949.0,0.6988,0.7031,0.6988,0.7032
2023-10-04 17:00,907,602,305,67278,24085,43193,47115819.0,16830603.0,30285215.0,887,593,294,66358,23561,42797,46474917.0,16464447.0,30010470.0,0.6988,0.7012,0.6988,0.7012
2023-10-04 17:05,449,113,336,39541,3264,36277,27702354.0,2281454.0,25420900.0,418,96,322,38868,3022,35846,27253893.0,2110127.0,25143765.0,0.699,0.7007,0.6983,0.7014
2023-10-04 17:10,280,70,210,27548,2125,25423,19311301.0,1488788.0,17822513.0,253,51,202,26465,1972,24493,18543220.0,1374465.0,17168755.0,0.7006,0.701,0.697,0.701
2023-10-04 17:15,782,270,512,61737,9403,52334,43264778.0,6573974.0,36690804.0,770,262,508,61899,9412,52487,43381087.0,6577078.0,36804009.0,0.6991,0.7011,0.6988,0.7012
2023-10-04 17:20,606,435,171,26331,10343,15988,18422280.0,7230267.0,11192012.0,581,421,160,29533,12670,16863,20402626.0,8583961.0,11818664.0,0.699,0.7,0.6775,0.7009
2023-10-04 17:25,361,272,89,16760,6445,10315,11772152.0,4517046.0,7255106.0,333,255,78,16758,6342,10416,11741801.0,4416498.0,7325303.0,0.7009,0.7034,0.6964,0.7033
2023-10-04 17:30,892,76,816,64969,6068,58901,45505302.0,4262405.0,41242897.0,832,49,783,60663,4822,55841,42502588.0,3360518.0,39142070.0,0.7024,0.7002,0.6969,0.701
2023-10-04 17:35,1499,437,1062,146141,39763,106378,101554728.0,27317084.0,74237644.0,1398,376,1022,139444,35083,104361,97128794.0,24171813.0,72956981.0,0.687,0.6979,0.689,0.6991
2023-10-04 17:40,999,609,390,69826,33314,36512,48930881.0,23264228.0,25666652.0,958,583,375,66641,31600,35041,46680393.0,22050786.0,24629606.0,0.6983,0.703,0.6978,0.7029
2023-10-04 17:45,1255,668,587,84997,40610,44387,59524512.0,28380286.0,31144226.0,1226,657,569,84616,40423,44193,59244340.0,28207113.0,31037227.0,0.6988,0.7017,0.6978,0.7023
2023-10-04 17:50,925,466,459,98622,43060,55562,69078887.0,30057175.0,39021712.0,905,458,447,98413,43213,55200,68921362.0,30157929.0,38763432.0,0.698,0.7023,0.6979,0.7022
2023-10-04 17:55,496,144,352,27409,8559,18850,19169011.0,5971033.0,13197977.0,481,137,344,26409,8564,17845,18483176.0,5975598.0,12507577.0,0.6976,0.7002,0.6978,0.7009
2023-10-04 18:00,444,328,116,27757,17013,10744,19389982.0,11871850.0,7518132.0,431,319,112,28188,17582,10606,19664464.0,12241675.0,7422789.0,0.6978,0.6998,0.6963,0.6999
2023-10-04 18:05,268,226,42,23653,20999,2654,16515291.0,14653384.0,1861907.0,250,218,32,23098,20809,2289,16114107.0,14506179.0,1607928.0,0.6978,0.7015,0.6971,0.7025
2023-10-04 18:10,1112,603,509,124077,48048,76029,87065048.0,33610597.0,53454451.0,1092,591,501,123061,46730,76331,86325413.0,32656835.0,53668578.0,0.6995,0.7031,0.6988,0.7031
2023-10-04 18:15,517,221,296,42853,11766,31087,30061364.0,8237265.0,21824098.0,500,213,287,41780,11037,30743,29348712.0,7722651.0,21626060.0,0.7001,0.702,0.6997,0.7034
2023-10-04 18:20,337,50,287,32722,1188,31534,23064170.0,845749.0,22218420.0,322,39,283,32053,1125,30928,22563169.0,766764.0,21796405.0,0.7119,0.7046,0.6816,0.7047
2023-10-04 18:25,172,25,147,16604,840,15764,11693905.0,587412.0,11106493.0,165,24,141,16867,1373,15494,11878476.0,961943.0,10916532.0,0.6993,0.7045,0.7006,0.7046
2023-10-04 18:30,452,141,311,31794,15688,16106,22273869.0,10978479.0,11295389.0,449,141,308,30451,15513,14938,21338415.0,10832457.0,10505957.0,0.6998,0.7013,0.6983,0.7033
2023-10-04 18:35,1398,859,539,95795,64023,31772,67147107.0,44821096.0,22326010.0,1381,846,535,96214,63941,32273,67415902.0,44734124.0,22681778.0,0.7001,0.7027,0.6996,0.7028
2023-10-05 10:00,8187,5459,2728,908378,608344,300034,638140724.0,426105880.0,212034844.0,7774,5276,2498,886911,597795,289116,623046995.0,419252060.0,203794935.0,0.7004,0.7067,0.7013,0.7049
2023-10-05 10:05,2042,1000,1042,180461,80075,100386,126956131.0,56019321.0,70936809.0,1915,936,979,169493,75486,94007,119124021.0,52841924.0,66282096.0,0.6996,0.7066,0.7,0.7051
2023-10-05 10:10,818,515,303,38142,21128,17014,27320683.0,15375275.0,11945408.0,735,458,277,34399,20107,14292,24067887.0,14030378.0,10037509.0,0.7277,0.7021,0.6978,0.7023
2023-10-05 10:15,401,256,145,19019,10707,8312,13253866.0,7469477.0,5784388.0,310,211,99,17158,8942,8216,11998334.0,6234496.0,5763838.0,0.6976,0.6959,0.6972,0.7015
2023-10-05 10:20,1048,522,526,61833,24536,37297,43006176.0,17055853.0,25950323.0,867,421,446,56869,22389,34480,39692739.0,15571509.0,24121230.0,0.6951,0.6958,0.6955,0.6996
2023-10-05 10:25,752,347,405,55294,20229,35065,38449860.0,13871315.0,24578544.0,698,318,380,49299,15623,33676,34491584.0,10886389.0,23605194.0,0.6857,0.7009,0.6968,0.701
2023-10-05 10:30,641,470,171,46294,24941,21353,31957049.0,16987330.0,14969718.0,603,447,156,42854,22002,20852,29774674.0,15163187.0,14611487.0,0.6811,0.7011,0.6892,0.7007
2023-10-05 10:35,1146,520,626,102366,37395,64971,71183190.0,25867141.0,45316049.0,1014,442,572,88402,30695,57707,61749426.0,21347609.0,40401816.0,0.6917,0.6975,0.6955,0.7001
2023-10-05 10:40,1211,714,497,99532,33360,66172,69336043.0,23207083.0,46128960.0,1104,643,461,90922,30176,60746,63349682.0,20972540.0,42377142.0,0.6957,0.6971,0.695,0.6976
2023-10-05 10:45,318,248,70,22591,16022,6569,15734321.0,11155414.0,4578906.0,249,195,54,23977,14878,9099,16687133.0,10339766.0,6347366.0,0.6963,0.697,0.695,0.6976
2023-10-05 10:50,205,159,46,14281,9655,4626,10002365.0,6785473.0,3216891.0,172,142,30,12711,8404,4307,8845662.0,5840521.0,3005140.0,0.7028,0.6954,0.695,0.6977
2023-10-05 10:55,249,221,28,5869,3726,2143,4067552.0,2565306.0,1502245.0,110,96,14,3873,2114,1759,2699513.0,1471506.0,1228007.0,0.6885,0.701,0.6961,0.6981
2023-10-05 11:00,316,225,91,14493,7477,7016,10099510.0,5203330.0,4896179.0,247,171,76,14210,7369,6841,9911448.0,5131539.0,4779909.0,0.6959,0.6979,0.6964,0.6987
2023-10-05 11:05,372,324,48,15152,9055,6097,10555100.0,6299943.0,4255157.0,305,265,40,14820,9019,5801,10323622.0,6273887.0,4049734.0,0.6957,0.6979,0.6956,0.6981
2023-10-05 11:10,310,227,83,31204,19843,11361,21425810.0,13493661.0,7932149.0,286,206,80,28683,16160,12523,19991796.0,11241473.0,8750322.0,0.68,0.6982,0.6956,0.6987
2023-10-05 11:15,1043,264,779,72092,27949,44143,50015703.0,19282656.0,30733047.0,990,231,759,67055,25224,41831,46752653.0,17533106.0,29219547.0,0.6899,0.6962,0.6951,0.6985
2023-10-05 11:20,924,335,589,84838,28000,56838,59248732.0,19544668.0,39704064.0,887,310,577,82267,26400,55867,57400358.0,18370415.0,39029943.0,0.698,0.6985,0.6958,0.6986
2023-10-05 11:25,1061,469,592,93426,34163,59263,65085742.0,23693945.0,41391796.0,1032,450,582,92016,33143,58873,64173244.0,23047576.0,41125668.0,0.6936,0.6984,0.6954,0.6985
2023-10-05 11:30,1523,675,848,138296,38715,99581,96621180.0,27059777.0,69561402.0,1489,653,836,136686,37163,99523,95391066.0,25868605.0,69522460.0,0.6989,0.6985,0.6961,0.6986
2023-10-05 11:35,1825,559,1266,150460,42214,108246,104924727.0,29354197.0,75570530.0,1803,550,1253,150279,42372,107907,104817641.0,29460809.0,75356832.0,0.6954,0.6981,0.6953,0.6983
2023-10-05 11:40,833,233,600,48590,15161,33429,33884277.0,10541167.0,23343110.0,827,226,601,49225,14233,34992,34334592.0,9900042.0,24434550.0,0.6953,0.6983,0.6956,0.6983
2023-10-05 11:45,1451,856,595,134958,83109,51849,94331352.0,58040874.0,36290477.0,1394,828,566,131059,80791,50268,91458016.0,56275010.0,35183005.0,0.6984,0.6999,0.6966,0.6999
2023-10-05 11:50,939,397,542,81492,45921,35571,56880977.0,31978591.0,24902386.0,929,392,537,81084,45669,35415,56591864.0,31805616.0,24786248.0,0.6964,0.7001,0.6964,0.6999
2023-10-05 11:55,502,327,175,42288,25682,16606,29484473.0,17868345.0,11616128.0,491,320,171,41064,25522,15542,28633926.0,17759512.0,10874413.0,0.6958,0.6995,0.6959,0.6997
2023-10-05 12:00,361,211,150,36800,23213,13587,25663730.0,16182458.0,9481271.0,327,193,134,34012,21233,12779,23737463.0,14786221.0,8951242.0,0.6971,0.6978,0.6964,0.7005
2023-10-05 12:05,552,172,380,38379,18641,19738,26787456.0,12969986.0,13817470.0,527,161,366,37843,18406,19437,26417658.0,12805253.0,13612405.0,0.6958,0.7,0.6957,0.7003
2023-10-05 12:10,570,280,290,43899,24528,19371,30671693.0,17102745.0,13568948.0,547,260,287,43167,23988,19179,30160935.0,16722782.0,13438153.0,0.6973,0.7005,0.6971,0.7007
2023-10-05 12:15,1292,672,620,90503,47291,43212,63277305.0,33000164.0,30277141.0,1273,659,614,90433,47282,43151,63209824.0,32975123.0,30234701.0,0.6978,0.7007,0.6974,0.7007
2023-10-05 12:20,539,295,244,31012,17541,13471,21706915.0,12262395.0,9444520.0,502,273,229,30322,16982,13340,21190541.0,11830432.0,9360109.0,0.6991,0.7011,0.6966,0.7017
2023-10-05 12:25,490,349,141,24702,17142,7560,17309243.0,11971541.0,5337702.0,470,338,132,23534,16617,6917,16463053.0,11604164.0,4858889.0,0.6984,0.706,0.6983,0.7025
2023-10-05 12:30,572,412,160,32432,21234,11198,22705597.0,14825994.0,7879603.0,546,404,142,30779,20912,9867,21533560.0,14599672.0,6933888.0,0.6982,0.7037,0.6981,0.7027
2023-10-05 12:35,655,251,404,33341,19760,13581,23240344.0,13788769.0,9451575.0,633,240,393,31475,19381,12094,22000440.0,13522337.0,8478102.0,0.6978,0.6959,0.6977,0.701
2023-10-05 12:40,498,173,325,25104,6684,18420,17600019.0,4664170.0,12935849.0,477,159,318,23990,6213,17777,16790467.0,4333839.0,12456627.0,0.6978,0.7023,0.6975,0.7007
2023-10-05 12:45,403,229,174,30019,16224,13795,20997857.0,11329006.0,9668850.0,383,213,170,29952,15912,14040,20980140.0,11092835.0,9887305.0,0.6983,0.7009,0.6971,0.7042
2023-10-05 12:50,93,62,31,4748,3259,1489,3309909.0,2260544.0,1049365.0,73,56,17,4625,3254,1371,3223707.0,2261383.0,962324.0,0.6936,0.7047,0.695,0.7019
2023-10-05 12:55,267,142,125,22668,10828,11840,15857848.0,7556441.0,8301406.0,239,133,106,22243,10487,11756,15563491.0,7320634.0,8242856.0,0.6979,0.7011,0.6981,0.7012
2023-10-05 13:00,317,189,128,26153,12122,14031,18303083.0,8462243.0,9840839.0,306,183,123,25909,12121,13788,18129888.0,8459638.0,9670250.0,0.6981,0.7014,0.6979,0.7014
2023-10-05 13:05,399,324,75,25653,19318,6335,17934606.0,13486320.0,4448285.0,386,318,68,25593,19304,6289,17888128.0,13472978.0,4415150.0,0.6981,0.7022,0.6979,0.702
2023-10-05 13:10,284,138,146,24023,8878,15145,16812167.0,6201962.0,10610205.0,273,132,141,23856,8637,15219,16716451.0,6035089.0,10681362.0,0.6986,0.7006,0.6987,0.7018
2023-10-05 13:15,463,298,165,26081,15039,11042,18251171.0,10519401.0,7731770.0,438,284,154,23896,13386,10510,16747129.0,9366419.0,7380710.0,0.6995,0.7002,0.6997,0.7023
2023-10-05 13:20,192,74,118,11454,4271,7183,8046644.0,3011277.0,5035366.0,182,72,110,11420,4403,7017,8000490.0,3077764.0,4922726.0,0.7051,0.701,0.699,0.7015
2023-10-05 13:25,788,443,345,30270,13818,16452,21206187.0,9665061.0,11541126.0,780,436,344,30770,14134,16636,21559925.0,9889644.0,11670281.0,0.6995,0.7015,0.6997,0.7015
2023-10-05 13:30,615,316,299,17383,9134,8249,12151181.0,6366142.0,5785039.0,600,309,291,17069,9186,7883,11935122.0,6400562.0,5534560.0,0.697,0.7013,0.6968,0.7021
2023-10-05 13:35,239,179,60,16225,12268,3957,11369261.0,8587669.0,2781592.0,216,168,48,14960,11328,3632,10451333.0,7896132.0,2555201.0,0.7,0.703,0.697,0.7035
2023-10-05 13:40,454,368,86,20352,15486,4866,14248247.0,10824674.0,3423572.0,424,356,68,19694,15312,4382,13774620.0,10694131.0,3080488.0,0.699,0.7036,0.6984,0.703
2023-10-05 13:45,776,641,135,32834,27916,4918,22672632.0,19229493.0,3443139.0,755,626,129,32075,27742,4333,22133308.0,19086058.0,3047250.0,0.6888,0.7001,0.688,0.7033
2023-10-05 13:50,372,275,97,22330,12451,9879,15679533.0,8729595.0,6949937.0,353,263,90,21071,11631,9440,14784996.0,8146007.0,6638989.0,0.7011,0.7035,0.7004,0.7033
2023-10-05 13:55,487,264,223,34221,15189,19032,24002490.0,10610672.0,13391818.0,459,256,203,34123,15227,18896,23928916.0,10630757.0,13298159.0,0.6986,0.7036,0.6982,0.7038
2023-10-05 14:00,611,494,117,38554,23168,15386,27034058.0,16200837.0,10833220.0,593,484,109,34880,22522,12358,24442325.0,15747378.0,8694947.0,0.6993,0.7041,0.6992,0.7036
2023-10-05 14:05,351,77,274,15239,4782,10457,10690368.0,3345050.0,7345317.0,335,71,264,15928,4598,11330,11182997.0,3215097.0,7967900.0,0.6995,0.7024,0.6992,0.7033
2023-10-05 14:10,574,245,329,21537,8986,12551,15123834.0,6299529.0,8824304.0,552,231,321,23172,10827,12345,16133046.0,7452000.0,8681046.0,0.701,0.7031,0.6883,0.7032
2023-10-05 14:15,165,99,66,10484,6655,3829,7355111.0,4662483.0,2692627.0,151,96,55,10929,7245,3684,7630290.0,5038185.0,2592105.0,0.7006,0.7032,0.6954,0.7036
2023-10-05 14:20,888,460,428,53741,39203,14538,37541685.0,27339729.0,10201956.0,880,458,422,53004,38746,14258,37053368.0,27039088.0,10014279.0,0.6974,0.7017,0.6979,0.7024
2023-10-05 14:25,460,331,129,23989,19866,4123,16757278.0,13861586.0,2895691.0,446,325,121,24134,19830,4304,16859098.0,13836482.0,3022616.0,0.6978,0.7023,0.6978,0.7023
2023-10-05 14:30,718,636,82,37407,32696,4711,26189184.0,22849284.0,3339899.0,716,634,82,36457,32228,4229,25495073.0,22521487.0,2973586.0,0.6988,0.709,0.6988,0.7031
2023-10-05 14:35,594,333,261,20399,13399,7000,14302872.0,9387008.0,4915863.0,585,329,256,20313,13631,6682,14228408.0,9535597.0,4692811.0,0.7006,0.7023,0.6996,0.7023
2023-10-05 14:40,372,128,244,12442,7538,4904,8712772.0,5275577.0,3437195.0,353,120,233,12217,7405,4812,8559691.0,5181685.0,3378006.0,0.6999,0.7009,0.6998,0.702
2023-10-05 14:45,735,552,183,31613,20892,10721,22155408.0,14623897.0,7531510.0,729,552,177,29934,20819,9115,20983275.0,14573682.0,6409593.0,0.7,0.7025,0.7,0.7032
2023-10-05 14:50,64,40,24,4136,2675,1461,2885442.0,1861173.0,1024269.0,57,35,22,3361,1946,1415,2353300.0,1356573.0,996726.0,0.6958,0.7011,0.6971,0.7044
2023-10-05 14:55,311,288,23,18509,13652,4857,12915252.0,9536562.0,3378689.0,302,288,14,14881,13867,1014,10386613.0,9674056.0,712557.0,0.6985,0.6956,0.6976,0.7027
2023-10-05 15:00,94,68,26,11671,8144,3527,8137745.0,5681456.0,2456288.0,88,66,22,9053,7827,1226,6322819.0,5461730.0,861089.0,0.6976,0.6964,0.6978,0.7024
2023-10-05 15:05,100,73,27,8357,6098,2259,5873409.0,4283223.0,1590186.0,94,69,25,8719,6242,2477,6104926.0,4361263.0,1743663.0,0.7024,0.7039,0.6987,0.7039
2023-10-05 15:10,244,225,19,13974,11813,2161,9766033.0,8245718.0,1520315.0,237,221,16,13367,11766,1601,9337872.0,8209524.0,1128348.0,0.698,0.7035,0.6977,0.7048
2023-10-05 15:15,393,348,45,20771,17681,3090,14536422.0,12363054.0,2173367.0,382,344,38,22826,19878,2948,15741205.0,13667542.0,2073663.0,0.6992,0.7034,0.6876,0.7034
2023-10-05 15:20,123,111,12,6243,5383,860,4370076.0,3765776.0,604300.0,117,106,11,5825,5192,633,4077369.0,3632062.0,445306.0,0.6996,0.7027,0.6995,0.7035
2023-10-05 15:25,155,146,9,12645,12234,411,8852109.0,8559400.0,292708.0,141,136,5,11798,11446,352,8237109.0,7990070.0,247038.0,0.6996,0.7122,0.6981,0.7018
2023-10-05 15:30,574,561,13,21226,8041,13185,16335718.0,5631989.0,10703729.0,570,559,11,13958,7866,6092,9795174.0,5507252.0,4287921.0,0.7004,0.8118,0.7001,0.7039
2023-10-05 15:35,201,185,16,15180,13067,2113,10608280.0,9133093.0,1475186.0,194,180,14,14756,13427,1329,10317784.0,9383614.0,934170.0,0.6989,0.6981,0.6989,0.7029
2023-10-05 15:40,200,175,25,14380,11995,2385,10045481.0,8371864.0,1673616.0,195,174,21,14364,12043,2321,10032953.0,8403677.0,1629276.0,0.6979,0.7017,0.6978,0.702
2023-10-05 15:45,197,143,54,16692,10178,6514,11672645.0,7105487.0,4567158.0,190,141,49,29016,9802,19214,21788225.0,6843326.0,14944898.0,0.6981,0.7011,0.6982,0.7778
2023-10-05 15:50,214,142,72,16335,10463,5872,11408893.0,7305871.0,4103021.0,201,143,58,15806,10554,5252,11053239.0,7369167.0,3684072.0,0.6983,0.6987,0.6982,0.7015
2023-10-05 15:55,459,223,236,36118,19937,16181,25238673.0,13907663.0,11331009.0,441,217,224,36197,20205,15992,25292448.0,14092824.0,11199624.0,0.6976,0.7003,0.6975,0.7003
2023-10-05 16:00,415,135,280,19717,10124,9593,13800735.0,7079432.0,6721302.0,401,126,275,19200,9481,9719,13430146.0,6618909.0,6811237.0,0.6993,0.7006,0.6981,0.7008
2023-10-05 16:05,281,153,128,24244,11890,12354,16943546.0,8290226.0,8653320.0,274,146,128,25741,12113,13628,17996978.0,8445424.0,9551553.0,0.6972,0.7004,0.6972,0.7009
2023-10-05 16:10,122,57,65,7817,3868,3949,5460259.0,2694341.0,2765918.0,108,54,54,7672,3833,3839,5361156.0,2670766.0,2690389.0,0.6966,0.7004,0.6968,0.7008
2023-10-05 16:15,478,337,141,53418,33401,20017,37337552.0,23315949.0,14021602.0,466,330,136,52985,33169,19816,37043772.0,23153338.0,13890434.0,0.6981,0.7005,0.698,0.701
2023-10-05 16:20,544,430,114,57293,43062,14231,40039781.0,30066037.0,9973744.0,534,426,108,57000,42901,14099,39834841.0,29953239.0,9881602.0,0.6982,0.7008,0.6982,0.7009
2023-10-05 16:25,874,507,367,56305,47037,9268,39296615.0,32817181.0,6479434.0,864,504,360,56442,47165,9277,39400113.0,32906186.0,6493926.0,0.6977,0.6991,0.6977,0.7
2023-10-05 16:30,560,310,250,44358,31785,12573,30965417.0,22163711.0,8801705.0,552,304,248,43745,31378,12367,30538500.0,21880134.0,8658365.0,0.6973,0.7,0.6973,0.7001
2023-10-05 16:35,696,573,123,56651,40276,16375,39692771.0,28215852.0,11476918.0,684,566,118,55614,39632,15982,38853309.0,27648628.0,11204681.0,0.7006,0.7009,0.6976,0.7011
2023-10-05 16:40,1079,830,249,98763,74128,24635,68943593.0,51666938.0,17276655.0,1073,827,246,99287,74541,24746,69272209.0,51917614.0,17354595.0,0.697,0.7013,0.6965,0.7013
2023-10-05 16:45,1005,582,423,105643,69557,36086,73820075.0,48562825.0,25257249.0,972,565,407,104113,68866,35247,72763426.0,48071268.0,24692157.0,0.6982,0.6999,0.698,0.7005
2023-10-05 16:50,304,203,101,31760,22692,9068,22169983.0,15812210.0,6357773.0,293,196,97,31816,22750,9066,22216654.0,15856860.0,6359794.0,0.6968,0.7011,0.697,0.7015
2023-10-05 16:55,102,68,34,7987,4893,3094,5581386.0,3412898.0,2168487.0,96,62,34,7544,4653,2891,5272350.0,3246209.0,2026141.0,0.6975,0.7009,0.6977,0.7008
2023-10-05 17:00,293,54,239,10875,2721,8154,7616569.0,1900504.0,5716065.0,279,44,235,10476,2251,8225,7336492.0,1570923.0,5765569.0,0.6985,0.701,0.6979,0.701
2023-10-05 17:05,294,141,153,14449,8307,6142,10105598.0,5804730.0,4300868.0,287,138,149,14631,8570,6061,10233426.0,5985388.0,4248038.0,0.6988,0.7002,0.6984,0.7009
2023-10-05 17:10,202,172,30,18294,14269,4025,12783073.0,9962259.0,2820814.0,194,168,26,18100,14086,4014,12649442.0,9836000.0,2813442.0,0.6982,0.7008,0.6983,0.7009
2023-10-05 17:15,519,337,182,28556,12750,15806,19987393.0,8912458.0,11074935.0,513,331,182,28516,12684,15832,19959546.0,8866295.0,11093250.0,0.699,0.7007,0.699,0.7007
2023-10-05 17:20,395,307,88,16400,8639,7761,11473314.0,6031655.0,5441659.0,391,307,84,16573,8731,7842,11593934.0,6092862.0,5501071.0,0.6982,0.7012,0.6978,0.7015
2023-10-05 17:25,267,205,62,20791,13370,7421,14546164.0,9342247.0,5203916.0,263,203,60,19641,13585,6056,13733002.0,9485462.0,4247540.0,0.6987,0.7012,0.6982,0.7014
2023-10-05 17:30,569,298,271,48117,25169,22948,33449707.0,17552699.0,15897008.0,538,281,257,44467,23854,20613,31074766.0,16637313.0,14437453.0,0.6974,0.6927,0.6975,0.7004
2023-10-05 17:35,609,427,182,52618,42164,10454,36694196.0,29382621.0,7311575.0,596,421,175,51280,42203,9077,35741256.0,29391416.0,6349839.0,0.6969,0.6994,0.6964,0.6996
2023-10-05 17:40,649,606,43,33033,30647,2386,23157675.0,21486098.0,1671577.0,631,599,32,31641,29036,2605,22086528.0,20261741.0,1824786.0,0.7011,0.7006,0.6978,0.7005
2023-10-05 17:45,257,235,22,6401,5889,512,4461513.0,4102513.0,359000.0,243,224,19,6009,5586,423,4189270.0,3892193.0,297077.0,0.6966,0.7012,0.6968,0.7023
2023-10-05 17:50,146,117,29,8013,6629,1384,5591120.0,4621750.0,969370.0,139,114,25,10528,9473,1055,7073212.0,6334101.0,739110.0,0.6972,0.7004,0.6686,0.7006
2023-10-05 17:55,353,138,215,29563,11469,18094,20627170.0,7979033.0,12648136.0,342,131,211,29434,10739,18695,20549183.0,7461955.0,13087227.0,0.6957,0.699,0.6948,0.7
2023-10-05 18:00,895,342,553,63452,23113,40339,44221376.0,16106411.0,28114965.0,878,335,543,62625,23141,39484,43729106.0,16096533.0,27632573.0,0.6969,0.697,0.6956,0.6998
2023-10-05 18:05,480,129,351,41577,10285,31292,29077460.0,7165893.0,21911566.0,469,119,350,40340,9341,30999,28205464.0,6499011.0,21706453.0,0.6967,0.7002,0.6958,0.7002
2023-10-05 18:10,1902,941,961,223339,139241,84098,156007272.0,97163736.0,58843536.0,1907,945,962,226010,142077,83933,157794954.0,99022398.0,58772555.0,0.6978,0.6997,0.697,0.7002
2023-10-05 18:15,1223,601,622,176547,98403,78144,123539692.0,68786925.0,54752767.0,1189,580,609,173694,96476,77218,121383588.0,67274319.0,54109268.0,0.699,0.7007,0.6973,0.7007
2023-10-05 18:20,293,251,42,23074,17657,5417,16136729.0,12336855.0,3799874.0,280,239,41,23051,17594,5457,16110703.0,12278428.0,3832275.0,0.6987,0.7015,0.6979,0.7023
2023-10-05 18:25,824,742,82,92253,86079,6174,64404160.0,60071811.0,4332349.0,813,738,75,91271,85678,5593,63716035.0,59790528.0,3925506.0,0.6979,0.7017,0.6979,0.7019
2023-10-05 18:30,225,174,51,28135,23187,4948,19679742.0,16204732.0,3475009.0,203,165,38,25888,21788,4100,18104691.0,15224785.0,2879906.0,0.6989,0.7023,0.6988,0.7024
2023-10-05 18:35,1932,1445,487,263128,213732,49396,183849932.0,149349669.0,34500263.0,1887,1428,459,257999,212126,45873,180467739.0,148212208.0,32255531.0,0.6988,0.6984,0.6987,0.7031
2023-10-06 10:00,2899,1590,1309,237911,118301,119610,167573649.0,82693177.0,84880472.0,2506,1420,1086,218518,109905,108613,153348330.0,76902756.0,76445574.0,0.699,0.7096,0.6997,0.7038
2023-10-06 10:05,394,259,135,18731,10956,7775,13092706.0,7666198.0,5426507.0,276,178,98,16571,10197,6374,11624749.0,7140922.0,4483827.0,0.6997,0.6979,0.7003,0.7035
2023-10-06 10:10,721,512,209,37678,23559,14119,26301319.0,16385189.0,9916130.0,579,438,141,34518,21988,12530,24188980.0,15385847.0,8803133.0,0.6955,0.7023,0.6997,0.7026
2023-10-06 10:15,551,396,155,28904,13643,15261,20285376.0,9532983.0,10752393.0,399,266,133,25242,12338,12904,17688904.0,8626364.0,9062540.0,0.6987,0.7046,0.6992,0.7023
2023-10-06 10:20,894,456,438,79870,28865,51005,55868900.0,20143254.0,35725646.0,851,424,427,77139,26906,50233,54031243.0,18785646.0,35245596.0,0.6978,0.7004,0.6982,0.7016
2023-10-06 10:25,1698,423,1275,140953,30288,110665,98633106.0,21104893.0,77528212.0,1636,389,1247,138247,28499,109748,96820797.0,19863906.0,76956890.0,0.6968,0.7006,0.697,0.7012
2023-10-06 10:30,1021,208,813,84073,14649,69424,58734244.0,10197375.0,48536868.0,970,173,797,81043,13141,67902,56750100.0,9158715.0,47591385.0,0.6961,0.6991,0.697,0.7009
2023-10-06 10:35,477,243,234,39198,10584,28614,27431353.0,7385715.0,20045638.0,445,219,226,38355,9769,28586,26842772.0,6811619.0,20031153.0,0.6978,0.7006,0.6973,0.7007
2023-10-06 10:40,1552,477,1075,146794,23914,122880,102817032.0,16681548.0,86135484.0,1527,460,1067,146598,23650,122948,102678850.0,16494375.0,86184475.0,0.6976,0.701,0.6974,0.701
2023-10-06 10:45,219,144,75,10111,3013,7098,7074721.0,2108934.0,4965787.0,180,117,63,8900,2975,5925,6239615.0,2072940.0,4166675.0,0.6999,0.6996,0.6968,0.7032
2023-10-06 10:50,171,122,49,7056,3178,3878,4982238.0,2217868.0,2764370.0,143,103,40,6183,2905,3278,4340763.0,2028222.0,2312541.0,0.6979,0.7128,0.6982,0.7055
2023-10-06 10:55,364,181,183,20898,6760,14138,14660360.0,4731485.0,9928874.0,341,169,172,19274,5038,14236,13518856.0,3518856.0,10000000.0,0.6999,0.7023,0.6985,0.7024
2023-10-06 11:00,826,178,648,44739,4695,40044,31259553.0,3259902.0,27999651.0,807,174,633,43477,4945,38532,30468168.0,3443678.0,27024490.0,0.6943,0.6992,0.6964,0.7014
2023-10-06 11:05,451,123,328,32604,4925,27679,22828853.0,3431240.0,19397613.0,396,72,324,31844,4418,27426,22307728.0,3078859.0,19228869.0,0.6967,0.7008,0.6969,0.7011
2023-10-06 11:10,1005,350,655,66537,9543,56994,46537275.0,6650503.0,39886772.0,954,319,635,66211,9352,56859,46343324.0,6514177.0,39829146.0,0.6969,0.6998,0.6966,0.7005
2023-10-06 11:15,151,112,39,10843,7122,3721,7547520.0,4945035.0,2602484.0,118,86,32,5931,3502,2429,4137980.0,2435164.0,1702815.0,0.6943,0.6994,0.6954,0.701
2023-10-06 11:20,86,52,34,6157,3393,2764,4294595.0,2361631.0,1932963.0,74,44,30,5883,3116,2767,4102059.0,2167171.0,1934887.0,0.696,0.6993,0.6955,0.6993
2023-10-06 11:25,226,104,122,21751,9305,12446,15096575.0,6428389.0,8668185.0,176,71,105,18344,7630,10714,12794839.0,5297666.0,7497173.0,0.6909,0.6965,0.6943,0.6998
2023-10-06 11:30,816,322,494,108617,12458,96159,75891704.0,8645273.0,67246431.0,786,302,484,107181,11436,95745,74932364.0,7951554.0,66980810.0,0.694,0.6993,0.6953,0.6996
2023-10-06 11:35,393,173,220,40865,5643,35222,28547430.0,3944979.0,24602450.0,354,146,208,39747,5245,34502,27747438.0,3645021.0,24102416.0,0.6991,0.6985,0.695,0.6986
2023-10-06 11:40,302,143,159,27194,5494,21700,19015481.0,3818645.0,15196836.0,284,137,147,27177,5444,21733,19012370.0,3783000.0,15229370.0,0.6951,0.7003,0.6949,0.7007
2023-10-06 11:45,528,209,319,32530,6982,25548,22599665.0,4849847.0,17749817.0,472,165,307,33696,8962,24734,23518289.0,6221429.0,17296860.0,0.6946,0.6948,0.6942,0.6993
2023-10-06 11:50,1179,393,786,87198,23660,63538,60390728.0,16397229.0,43993499.0,1049,325,724,78435,21307,57128,54504167.0,14765790.0,39738377.0,0.693,0.6924,0.693,0.6956
2023-10-06 11:55,687,267,420,50144,15382,34762,34707951.0,10616010.0,24091941.0,578,191,387,44098,10532,33566,30623184.0,7276870.0,23346314.0,0.6902,0.6931,0.6909,0.6955
2023-10-06 12:00,1737,810,927,143213,26995,116218,99260614.0,18649353.0,80611260.0,1629,727,902,142657,27017,115640,98884147.0,18640744.0,80243402.0,0.6908,0.6936,0.69,0.6939
2023-10-06 12:05,1870,1210,660,176489,108661,67828,122462711.0,75320631.0,47142079.0,1804,1162,642,171953,104816,67137,119141180.0,72467761.0,46673419.0,0.6932,0.695,0.6914,0.6952
2023-10-06 12:10,702,368,334,37029,18345,18684,25612440.0,12650620.0,12961820.0,654,332,322,36645,18998,17647,25345722.0,13103647.0,12242075.0,0.6896,0.6937,0.6897,0.6937
2023-10-06 12:15,556,318,238,25915,14381,11534,17947305.0,9926903.0,8020402.0,513,288,225,24364,12834,11530,16888472.0,8863137.0,8025334.0,0.6903,0.6954,0.6906,0.696
2023-10-06 12:20,353,236,117,13275,7589,5686,9202572.0,5252266.0,3950305.0,332,224,108,12618,7580,5038,8744188.0,5244315.0,3499873.0,0.6921,0.6947,0.6919,0.6947
2023-10-06 12:25,249,146,103,13911,8110,5801,9609567.0,5584902.0,4024665.0,219,126,93,12141,6793,5348,8395560.0,4679811.0,3715748.0,0.6886,0.6938,0.6889,0.6948
2023-10-06 12:30,374,75,299,17406,4020,13386,11907728.0,2770071.0,9137656.0,348,58,290,15650,3680,11970,10833946.0,2533683.0,8300263.0,0.6891,0.6826,0.6885,0.6934
2023-10-06 12:35,769,597,172,32754,17084,15670,22723854.0,11819988.0,10903866.0,734,571,163,30187,15560,14627,20928203.0,10761912.0,10166290.0,0.6919,0.6958,0.6916,0.695
2023-10-06 12:40,183,115,68,9211,4361,4850,6370078.0,3017812.0,3352266.0,153,96,57,6947,2942,4005,4820469.0,2034825.0,2785644.0,0.692,0.6912,0.6916,0.6955
2023-10-06 12:45,441,183,258,23945,7751,16194,18938540.0,7706267.0,11232272.0,420,174,246,22449,6859,15590,16728180.0,5911133.0,10817046.0,0.9942,0.6936,0.8618,0.6938
2023-10-06 12:50,249,136,113,12961,4245,8716,8986750.0,2937784.0,6048966.0,230,124,106,12561,3904,8657,8711567.0,2701241.0,6010325.0,0.6921,0.694,0.6919,0.6943
2023-10-06 12:55,222,114,108,11571,2962,8609,8023153.0,2053209.0,5969944.0,211,107,104,11912,3400,8512,8255618.0,2352580.0,5903038.0,0.6932,0.6935,0.6919,0.6935
2023-10-06 13:00,118,59,59,7896,2017,5879,5481761.0,1407135.0,4074626.0,105,50,55,8394,2254,6140,5818696.0,1558574.0,4260121.0,0.6976,0.6931,0.6915,0.6938
2023-10-06 13:05,286,226,60,11536,6483,5053,7987937.0,4500090.0,3487846.0,273,218,55,11155,6400,4755,7726639.0,4428585.0,3298053.0,0.6941,0.6903,0.692,0.6936
2023-10-06 13:10,213,75,138,17626,2406,15220,12237385.0,1662157.0,10575228.0,196,61,135,17357,2252,15105,12050519.0,1557917.0,10492602.0,0.6908,0.6948,0.6918,0.6946
2023-10-06 13:15,171,96,75,13942,6847,7095,9674201.0,4740079.0,4934122.0,163,89,74,11500,4532,6968,7982817.0,3136804.0,4846013.0,0.6923,0.6954,0.6921,0.6955
2023-10-06 13:20,192,99,93,13407,6858,6549,9283852.0,4747092.0,4536760.0,166,85,81,12475,7110,5365,8617069.0,4889561.0,3727507.0,0.6922,0.6927,0.6877,0.6948
2023-10-06 13:25,958,617,341,41562,15831,25731,28837546.0,10956792.0,17880753.0,943,604,339,40238,14446,25792,27932577.0,10002999.0,17929578.0,0.6921,0.6949,0.6924,0.6952
2023-10-06 13:30,516,149,367,27638,7013,20625,19163988.0,4853808.0,14310180.0,496,140,356,27467,6835,20632,19065204.0,4730322.0,14334882.0,0.6921,0.6938,0.6921,0.6948
2023-10-06 13:35,476,177,299,30566,7401,23165,21247809.0,5139045.0,16108764.0,458,167,291,29470,6928,22542,20458364.0,4795993.0,15662371.0,0.6944,0.6954,0.6923,0.6948
2023-10-06 13:40,458,208,250,34360,4785,29575,23853561.0,3309980.0,20543581.0,440,196,244,33738,4423,29315,23430958.0,3061042.0,20369915.0,0.6917,0.6946,0.6921,0.6949
2023-10-06 13:45,595,141,454,29353,5210,24143,20403221.0,3638994.0,16764226.0,576,130,446,27511,4154,23357,19094892.0,2875440.0,16219452.0,0.6985,0.6944,0.6922,0.6944
2023-10-06 13:50,351,95,256,22622,9439,13183,15710623.0,6541281.0,9169342.0,333,85,248,23660,11233,12427,16410965.0,7768633.0,8642332.0,0.693,0.6955,0.6916,0.6954
2023-10-06 13:55,168,95,73,14625,4247,10378,10162797.0,2960668.0,7202128.0,153,84,69,14337,4401,9936,9969584.0,3049562.0,6920022.0,0.6971,0.694,0.6929,0.6965
2023-10-06 14:00,133,51,82,13389,3932,9457,9279161.0,2697102.0,6582059.0,127,49,78,12586,3334,9252,8735101.0,2294216.0,6440885.0,0.6859,0.696,0.6881,0.6962
2023-10-06 14:05,385,212,173,26378,13299,13079,18287520.0,9201127.0,9086392.0,364,202,162,24444,12417,12027,16946884.0,8589325.0,8357559.0,0.6919,0.6947,0.6917,0.6949
2023-10-06 14:10,323,180,143,16786,8245,8541,11648397.0,5712406.0,5935991.0,307,165,142,16288,7148,9140,11308690.0,4951453.0,6357236.0,0.6928,0.695,0.6927,0.6955
2023-10-06 14:15,546,450,96,22352,14519,7833,15503593.0,10066660.0,5436933.0,526,443,83,20871,14459,6412,14487918.0,10024080.0,4463838.0,0.6933,0.6941,0.6933,0.6962
2023-10-06 14:20,526,476,50,14287,9564,4723,9885067.0,6603625.0,3281442.0,516,468,48,13531,8635,4896,9387404.0,5980340.0,3407064.0,0.6905,0.6948,0.6926,0.6959
2023-10-06 14:25,83,55,28,4725,1931,2794,3283040.0,1340204.0,1942836.0,71,46,25,4509,1751,2758,3130946.0,1213023.0,1917923.0,0.694,0.6954,0.6928,0.6954
2023-10-06 14:30,130,68,62,8244,3034,5210,5732073.0,2111479.0,3620594.0,114,61,53,7767,2943,4824,5389554.0,2035720.0,3353834.0,0.6959,0.6949,0.6917,0.6952
2023-10-06 14:35,485,240,245,16385,6857,9528,11366364.0,4754261.0,6612103.0,474,232,242,16394,6970,9424,11377669.0,4831203.0,6546466.0,0.6933,0.694,0.6931,0.6947
2023-10-06 14:40,284,175,109,8713,4742,3971,6049057.0,3288553.0,2760504.0,269,165,104,8315,4570,3745,5769014.0,3166302.0,2602712.0,0.6935,0.6952,0.6928,0.695
2023-10-06 14:45,385,276,109,16346,5903,10443,11363713.0,4093602.0,7270110.0,362,260,102,15893,5619,10274,11049496.0,3895198.0,7154298.0,0.6935,0.6962,0.6932,0.6963
2023-10-06 14:50,174,102,72,14036,3892,10144,9761568.0,2704973.0,7056595.0,153,92,61,14934,4764,10170,10373533.0,3296980.0,7076553.0,0.695,0.6956,0.6921,0.6958
2023-10-06 14:55,618,495,123,31023,17686,13337,21621131.0,12323603.0,9297528.0,595,479,116,28425,16105,12320,19753688.0,11168570.0,8585117.0,0.6968,0.6971,0.6935,0.6968
2023-10-06 15:00,1084,718,366,70914,42158,28756,49321588.0,29269064.0,20052524.0,1067,709,358,70095,41252,28843,48752154.0,28634273.0,20117881.0,0.6943,0.6973,0.6941,0.6975
2023-10-06 15:05,630,239,391,53013,19624,33389,36857366.0,13612613.0,23244753.0,625,238,387,52572,19662,32910,36556996.0,13639230.0,22917766.0,0.6937,0.6962,0.6937,0.6964
2023-10-06 15:10,237,173,64,18943,13371,5572,13140751.0,9265367.0,3875384.0,224,164,60,17214,11824,5390,11952150.0,8198968.0,3753182.0,0.6929,0.6955,0.6934,0.6963
2023-10-06 15:15,709,371,338,62594,38965,23629,43480374.0,27027097.0,16453277.0,699,363,336,62504,38844,23660,43418377.0,26942367.0,16476009.0,0.6936,0.6963,0.6936,0.6964
2023-10-06 15:20,415,190,225,25721,9909,15812,17638593.0,6657812.0,10980781.0,399,186,213,21942,6084,15858,15260076.0,4216861.0,11043214.0,0.6719,0.6945,0.6931,0.6964
2023-10-06 15:25,471,107,364,32062,5052,27010,22262904.0,3497696.0,18765208.0,449,91,358,31559,5298,26261,21902530.0,3652614.0,18249916.0,0.6923,0.6948,0.6894,0.6949
2023-10-06 15:30,146,84,62,11258,4358,6900,7808226.0,3015768.0,4792458.0,134,74,60,9243,3710,5533,6416182.0,2566480.0,3849701.0,0.692,0.6946,0.6918,0.6958
2023-10-06 15:35,275,140,135,12760,5201,7559,8848668.0,3604348.0,5244320.0,265,130,135,13161,5177,7984,9122313.0,3583172.0,5539141.0,0.693,0.6938,0.6921,0.6938
2023-10-06 15:40,167,79,88,14209,7660,6549,9811043.0,5266570.0,4544473.0,157,73,84,13017,6797,6220,9021750.0,4704635.0,4317114.0,0.6875,0.6939,0.6922,0.6941
2023-10-06 15:45,254,120,134,26956,16367,10589,18667486.0,11321905.0,7345581.0,247,114,133,27818,17234,10584,19267085.0,11920866.0,7346219.0,0.6918,0.6937,0.6917,0.6941
2023-10-06 15:50,132,41,91,12289,2612,9677,8517826.0,1805106.0,6712720.0,125,37,88,11226,1861,9365,7785771.0,1286461.0,6499310.0,0.6911,0.6937,0.6913,0.694
2023-10-06 15:55,431,111,320,24359,7698,16661,16944243.0,5356304.0,11587939.0,419,101,318,23514,6907,16607,16325415.0,4776774.0,11548641.0,0.6958,0.6955,0.6916,0.6954
2023-10-06 16:00,2095,1360,735,200555,108996,91559,139456234.0,75628545.0,63827689.0,2049,1337,712,193493,105030,88463,134509761.0,72852774.0,61656987.0,0.6939,0.6971,0.6936,0.697
2023-10-06 16:05,1225,701,524,106464,54117,52347,74031133.0,37558589.0,36472544.0,1206,694,512,105516,53843,51673,73369184.0,37365113.0,36004071.0,0.694,0.6967,0.694,0.6968
2023-10-06 16:10,429,303,126,46937,31399,15538,32630086.0,21796284.0,10833802.0,411,300,111,46774,31726,15048,32516081.0,22023169.0,10492911.0,0.6942,0.6972,0.6942,0.6973
2023-10-06 16:15,1524,943,581,136589,76678,59911,95013055.0,53272038.0,41741017.0,1489,924,565,134981,76334,58647,93868123.0,52977226.0,40890897.0,0.6947,0.6967,0.694,0.6972
2023-10-06 16:20,531,321,210,51532,32060,19472,35828595.0,22249102.0,13579493.0,517,320,197,51584,32208,19376,35863259.0,22350991.0,13512268.0,0.694,0.6974,0.694,0.6974
2023-10-06 16:25,1171,782,389,136779,67316,69463,95203453.0,46735943.0,48467509.0,1160,774,386,136137,66683,69454,94755300.0,46295578.0,48459722.0,0.6943,0.6977,0.6943,0.6977
2023-10-06 16:30,351,226,125,35602,20477,15125,24785234.0,14228232.0,10557001.0,325,211,114,34948,20293,14655,24332472.0,14099178.0,10233294.0,0.6948,0.698,0.6948,0.6983
2023-10-06 16:35,459,330,129,45212,38118,7094,31470412.0,26517911.0,4952501.0,429,312,117,45041,37946,7095,31334232.0,26375472.0,4958759.0,0.6957,0.6981,0.6951,0.6989
2023-10-06 16:40,1071,521,550,106380,57872,48508,74111697.0,40214578.0,33897119.0,1047,512,535,105467,57305,48162,73482561.0,39822495.0,33660065.0,0.6949,0.6988,0.6949,0.6989
2023-10-06 16:45,523,381,142,32691,19279,13412,22776198.0,13412895.0,9363303.0,504,377,127,35918,23234,12684,24824300.0,15956276.0,8868024.0,0.6957,0.6981,0.6868,0.6992
2023-10-06 16:50,491,268,223,70097,43755,26342,48757115.0,30377398.0,18379717.0,491,265,226,69811,43334,26477,48563419.0,30085489.0,18477930.0,0.6943,0.6977,0.6943,0.6979
2023-10-06 16:55,389,319,70,29730,22093,7637,20622584.0,15332720.0,5289864.0,373,313,60,29279,22169,7110,20345542.0,15385461.0,4960080.0,0.694,0.6927,0.694,0.6976
2023-10-06 17:00,274,169,105,30279,16267,14012,20887476.0,11114633.0,9772842.0,257,155,102,27938,13834,14104,19432037.0,9594381.0,9837655.0,0.6833,0.6975,0.6935,0.6975
2023-10-06 17:05,110,50,60,17456,7613,9843,12147852.0,5280981.0,6866871.0,103,47,56,17899,8047,9852,12453904.0,5579496.0,6874407.0,0.6937,0.6976,0.6934,0.6978
2023-10-06 17:10,341,182,159,40709,23187,17522,28224350.0,16083503.0,12140846.0,325,172,153,39378,22446,16932,27376277.0,15567575.0,11808702.0,0.6936,0.6929,0.6936,0.6974
2023-10-06 17:15,759,327,432,53462,23998,29464,37157546.0,16642486.0,20515060.0,749,321,428,55019,25946,29073,38079195.0,17818592.0,20260602.0,0.6935,0.6963,0.6868,0.6969
2023-10-06 17:20,540,259,281,42427,21708,20719,29484630.0,15053633.0,14430997.0,530,254,276,41991,21530,20461,29188044.0,14930063.0,14257980.0,0.6935,0.6965,0.6935,0.6968
2023-10-06 17:25,133,50,83,13244,2204,11040,9241259.0,1548673.0,7692586.0,124,42,82,12681,1871,10810,8831813.0,1297901.0,7533911.0,0.7027,0.6968,0.6937,0.6969
2023-10-06 17:30,526,327,199,47511,17002,30509,33070262.0,11801579.0,21268683.0,530,329,201,48168,17379,30789,34721131.0,13239433.0,21481698.0,0.6941,0.6971,0.7618,0.6977
2023-10-06 17:35,748,413,335,90052,46583,43469,62632638.0,32330374.0,30302263.0,729,401,328,89239,46146,43093,62067094.0,32026263.0,30040831.0,0.694,0.6971,0.694,0.6971
2023-10-06 17:40,55,37,18,3094,1504,1590,2164054.0,1057064.0,1106990.0,47,30,17,3012,1446,1566,2095792.0,1003466.0,1092326.0,0.7028,0.6962,0.694,0.6975
2023-10-06 17:45,285,148,137,33978,18655,15323,23683405.0,12979330.0,10704075.0,279,146,133,33561,18463,15098,23370021.0,12826978.0,10543043.0,0.6958,0.6986,0.6947,0.6983
2023-10-06 17:50,406,332,74,22376,16813,5563,15580818.0,11693256.0,3887562.0,393,324,69,22060,16500,5560,15357787.0,11472923.0,3884864.0,0.6955,0.6988,0.6953,0.6987
2023-10-06 17:55,148,42,106,9745,1979,7766,6802468.0,1372368.0,5430100.0,135,35,100,10191,1708,8483,7116327.0,1184892.0,5931435.0,0.6935,0.6992,0.6937,0.6992
2023-10-06 18:00,885,641,244,78035,48852,29183,54420867.0,34001268.0,20419599.0,863,629,234,78249,49856,28393,54531393.0,34664901.0,19866492.0,0.696,0.6997,0.6953,0.6997
2023-10-06 18:05,5077,4204,873,678603,583260,95343,472217078.0,405547925.0,66669153.0,5072,4197,875,679380,583152,96228,472757700.0,405462808.0,67294892.0,0.6953,0.6993,0.6953,0.6993
2023-10-06 18:10,2380,1618,762,242142,200057,42085,168528181.0,139110515.0,29417666.0,2363,1609,754,240560,199326,41234,167424281.0,138598458.0,28825823.0,0.6954,0.699,0.6953,0.6991
2023-10-06 18:15,3345,2486,859,362523,283767,78756,252723854.0,197585522.0,55138332.0,3333,2480,853,361978,283203,78775,252268834.0,197114492.0,55154341.0,0.6963,0.7001,0.696,0.7002
2023-10-06 18:20,4921,3797,1124,516120,427900,88220,359641543.0,297857902.0,61783640.0,4852,3744,1108,515135,427575,87560,358955033.0,297629300.0,61325733.0,0.6961,0.7003,0.6961,0.7004
2023-10-06 18:25,4011,3067,944,419730,334300,85430,292741387.0,232917273.0,59824113.0,3971,3049,922,417945,333890,84055,291492009.0,232622487.0,58869522.0,0.6967,0.7003,0.6967,0.7004
2023-10-06 18:30,4164,3182,982,506725,455803,50922,353439015.0,317759240.0,35679775.0,4120,3164,956,503201,453269,49932,350958989.0,315984154.0,34974835.0,0.6971,0.7007,0.6971,0.7004
2023-10-06 18:35,4136,3028,1108,512248,469322,42926,357088998.0,327096582.0,29992415.0,4102,3012,1090,511330,469297,42033,356511500.0,327067981.0,29443518.0,0.697,0.6987,0.6969,0.7005
2023-10-09 10:00,5164,3266,1898,483059,350205,132854,339751101.0,244988857.0,94762244.0,4617,3077,1540,455176,340694,114482,319740025.0,238697728.0,81042297.0,0.6996,0.7133,0.7006,0.7079
2023-10-09 10:05,1147,670,477,51896,38014,13882,36424560.0,26659469.0,9765091.0,887,560,327,47283,35692,11591,33264455.0,25078476.0,8185979.0,0.7013,0.7034,0.7026,0.7062
2023-10-09 10:10,1404,782,622,105556,72001,33555,74073362.0,50554961.0,23518400.0,1302,739,563,98326,68294,30032,69133914.0,47918320.0,21215594.0,0.7021,0.7009,0.7016,0.7064
2023-10-09 10:15,1810,1083,727,116158,67372,48786,81613958.0,47266315.0,34347642.0,1706,1034,672,111892,63880,48012,78616238.0,44794826.0,33821411.0,0.7016,0.704,0.7012,0.7044
2023-10-09 10:20,1201,423,778,44318,22909,21409,31145202.0,16079672.0,15065529.0,1135,382,753,43701,23088,20613,30702767.0,16195840.0,14506927.0,0.7019,0.7037,0.7015,0.7038
2023-10-09 10:25,973,485,488,56499,38221,18278,40700316.0,27845840.0,12854475.0,918,457,461,45472,29548,15924,32606071.0,21372057.0,11234013.0,0.7285,0.7033,0.7233,0.7055
2023-10-09 10:30,2691,1687,1004,229440,153026,76414,165940873.0,111603999.0,54336874.0,2262,1498,764,199734,136391,63343,143886368.0,98839423.0,45046945.0,0.7293,0.7111,0.7247,0.7112
2023-10-09 10:35,1618,910,708,101906,65105,36801,72561109.0,46474637.0,26086471.0,1331,803,528,90365,58581,31784,64286447.0,41540394.0,22746053.0,0.7138,0.7089,0.7091,0.7156
2023-10-09 10:40,1988,1252,736,124041,87989,36052,88279703.0,62644217.0,25635486.0,1624,1069,555,109041,80762,28279,77500872.0,57281432.0,20219439.0,0.712,0.7111,0.7093,0.715
2023-10-09 10:45,507,274,233,29154,20794,8360,21089459.0,15181475.0,5907983.0,405,226,179,27273,20732,6541,19367915.0,14697289.0,4670626.0,0.7301,0.7067,0.7089,0.7141
2023-10-09 10:50,905,320,585,44947,20032,24915,31894240.0,14239282.0,17654957.0,782,259,523,40630,18047,22583,28905011.0,12789815.0,16115195.0,0.7108,0.7086,0.7087,0.7136
2023-10-09 10:55,1619,608,1011,139917,52677,87240,99423928.0,37345675.0,62078252.0,1475,529,946,133206,49449,83757,94734000.0,35028340.0,59705660.0,0.709,0.7116,0.7084,0.7128
2023-10-09 11:00,1440,506,934,121257,31509,89748,86297475.0,22385592.0,63911883.0,1356,457,899,116282,30535,85747,82720352.0,21649476.0,61070876.0,0.7105,0.7121,0.709,0.7122
2023-10-09 11:05,725,356,369,54154,24601,29553,38398338.0,17493552.0,20904786.0,660,323,337,50475,23521,26954,35876123.0,16671547.0,19204575.0,0.7111,0.7074,0.7088,0.7125
2023-10-09 11:10,1705,796,909,127260,48390,78870,90420084.0,34413643.0,56006441.0,1628,758,870,128988,52419,76569,91205765.0,36716820.0,54488945.0,0.7112,0.7101,0.7004,0.7116
2023-10-09 11:15,683,331,352,51607,28466,23141,36638722.0,20172839.0,16465882.0,651,314,337,49561,28703,20858,35176997.0,20327773.0,14849224.0,0.7087,0.7115,0.7082,0.7119
2023-10-09 11:20,492,337,155,25303,16127,9176,17927633.0,11478962.0,6448670.0,433,310,123,22028,14503,7525,15651040.0,10279451.0,5371588.0,0.7118,0.7028,0.7088,0.7138
2023-10-09 11:25,370,128,242,18476,10421,8055,13087506.0,7359176.0,5728330.0,339,110,229,14468,6990,7478,10271240.0,4951181.0,5320058.0,0.7062,0.7112,0.7083,0.7114
2023-10-09 11:30,395,181,214,22421,11545,10876,15944231.0,8188637.0,7755593.0,372,168,204,24343,11644,12699,17307370.0,8254583.0,9052787.0,0.7093,0.7131,0.7089,0.7129
2023-10-09 11:35,323,200,123,30576,20648,9928,21703956.0,14621321.0,7082635.0,281,179,102,29917,20253,9664,21213166.0,14320106.0,6893060.0,0.7081,0.7134,0.7071,0.7133
2023-10-09 11:40,264,150,114,20045,14791,5254,14238593.0,10484911.0,3753682.0,225,132,93,18959,14235,4724,13453202.0,10082349.0,3370853.0,0.7089,0.7144,0.7083,0.7136
2023-10-09 11:45,466,392,74,18590,13708,4882,13210776.0,9728863.0,3481913.0,440,380,60,17893,13422,4471,12714330.0,9524979.0,3189351.0,0.7097,0.7132,0.7097,0.7133
2023-10-09 11:50,571,427,144,30134,21686,8448,21485436.0,15450440.0,6034996.0,536,411,125,29318,21135,8183,20840145.0,14998305.0,5841840.0,0.7125,0.7144,0.7096,0.7139
2023-10-09 11:55,727,504,223,57573,50394,7179,41267603.0,36149138.0,5118464.0,630,472,158,51272,46373,4899,36496316.0,32984540.0,3511776.0,0.7173,0.713,0.7113,0.7168
2023-10-09 12:00,616,317,299,43698,33200,10498,31045410.0,23618010.0,7427400.0,563,285,278,41406,31915,9491,29474506.0,22688497.0,6786008.0,0.7114,0.7075,0.7109,0.715
2023-10-09 12:05,674,291,383,32903,14105,18798,23444931.0,10042963.0,13401968.0,618,254,364,31600,13980,17620,23782774.0,11194543.0,12588230.0,0.712,0.7129,0.8008,0.7144
2023-10-09 12:10,632,378,254,30432,21775,8657,21715789.0,15529896.0,6185893.0,586,360,226,28473,20371,8102,20282042.0,14488377.0,5793665.0,0.7132,0.7146,0.7112,0.7151
2023-10-09 12:15,141,86,55,7200,3918,3282,5131421.0,2784438.0,2346982.0,117,76,41,6119,3891,2228,4354828.0,2759797.0,1595031.0,0.7107,0.7151,0.7093,0.7159
2023-10-09 12:20,414,238,176,25872,17451,8421,18471597.0,12454733.0,6016863.0,370,208,162,24743,16592,8151,17639712.0,11806092.0,5833620.0,0.7137,0.7145,0.7116,0.7157
2023-10-09 12:25,1197,593,604,81747,55978,25769,58276817.0,39943495.0,18333322.0,1125,562,563,77821,53633,24188,55487926.0,38182712.0,17305214.0,0.7136,0.7114,0.7119,0.7154
2023-10-09 12:30,940,427,513,63831,29341,34490,45391556.0,20882688.0,24508868.0,863,387,476,59337,27570,31767,42319188.0,19618401.0,22700786.0,0.7117,0.7106,0.7116,0.7146
2023-10-09 12:35,1549,752,797,157906,80478,77428,112280558.0,57171238.0,55109319.0,1477,707,770,151289,77247,74042,107681795.0,54834896.0,52846899.0,0.7104,0.7117,0.7099,0.7137
2023-10-09 12:40,1090,514,576,113354,54603,58751,80812036.0,38832781.0,41979255.0,1047,490,557,112256,53988,58268,79952009.0,38309370.0,41642639.0,0.7112,0.7145,0.7096,0.7147
2023-10-09 12:45,464,187,277,37678,16882,20796,26821923.0,11972482.0,14849441.0,425,175,250,35517,15221,20296,25299585.0,10793271.0,14506314.0,0.7092,0.7141,0.7091,0.7147
2023-10-09 12:50,1140,651,489,76240,41775,34465,54107817.0,29602547.0,24505269.0,1117,637,480,74437,41210,33227,53002939.0,29268629.0,23734310.0,0.7086,0.711,0.7102,0.7143
2023-10-09 12:55,854,314,540,67082,22916,44166,47761357.0,16259445.0,31501912.0,817,295,522,64865,21778,43087,46201948.0,15437712.0,30764236.0,0.7095,0.7133,0.7089,0.714
2023-10-09 13:00,1334,508,826,89419,23687,65732,63666376.0,16783674.0,46882701.0,1317,497,820,89021,23536,65485,63407967.0,16692876.0,46715091.0,0.7086,0.7132,0.7092,0.7134
2023-10-09 13:05,1042,356,686,98662,25619,73043,69928057.0,18171066.0,51756991.0,994,325,669,94330,24016,70314,67144060.0,17036009.0,50108051.0,0.7093,0.7086,0.7094,0.7126
2023-10-09 13:10,840,429,411,63175,17360,45815,44993442.0,12362701.0,32630740.0,789,393,396,60964,15933,45031,43393806.0,11302452.0,32091353.0,0.7121,0.7122,0.7094,0.7127
2023-10-09 13:15,633,377,256,38611,16544,22067,27517377.0,11767848.0,15749528.0,608,363,245,37839,16103,21736,26935512.0,11432864.0,15502648.0,0.7113,0.7137,0.71,0.7132
2023-10-09 13:20,261,82,179,30997,3944,27053,22093412.0,2794269.0,19299143.0,248,74,174,30902,4251,26651,22030834.0,3014467.0,19016366.0,0.7085,0.7134,0.7091,0.7135
2023-10-09 13:25,520,136,384,31385,6864,24521,22391677.0,4895305.0,17496372.0,498,120,378,31123,6326,24797,22186490.0,4494333.0,17692157.0,0.7132,0.7135,0.7105,0.7135
2023-10-09 13:30,729,249,480,37251,13853,23398,26515835.0,9854355.0,16661480.0,718,244,474,38328,15281,23047,27275076.0,10821266.0,16453809.0,0.7114,0.7121,0.7082,0.7139
2023-10-09 13:35,632,201,431,43308,10157,33151,30901051.0,7227073.0,23673978.0,609,192,417,42060,10025,32035,30011414.0,7129842.0,22881572.0,0.7115,0.7141,0.7112,0.7143
2023-10-09 13:40,437,320,117,21286,8287,12999,15161787.0,5887883.0,9273903.0,422,310,112,21225,8007,13218,15122422.0,5691451.0,9430970.0,0.7105,0.7134,0.7108,0.7135
2023-10-09 13:45,253,121,132,33321,7246,26075,24336813.0,5147829.0,19188983.0,230,110,120,18993,6089,12904,13538085.0,4326279.0,9211806.0,0.7104,0.7359,0.7105,0.7139
2023-10-09 13:50,655,142,513,58216,11725,46491,41135813.0,8329570.0,32806243.0,598,100,498,53250,9390,43860,37930667.0,6664239.0,31266427.0,0.7104,0.7056,0.7097,0.7129
2023-10-09 13:55,588,304,284,38773,8705,30068,27625349.0,6185007.0,21440342.0,543,277,266,51412,8967,42445,37248819.0,6365419.0,30883399.0,0.7105,0.7131,0.7099,0.7276
2023-10-09 14:00,438,169,269,27145,3754,23391,19330016.0,2669715.0,16660300.0,397,147,250,26494,3587,22907,18870547.0,2541483.0,16329064.0,0.7112,0.7123,0.7085,0.7128
2023-10-09 14:05,1226,537,689,94810,37784,57026,67850089.0,27166274.0,40683815.0,1150,491,659,89327,34133,55194,63637698.0,24251713.0,39385985.0,0.719,0.7134,0.7105,0.7136
2023-10-09 14:10,1460,898,562,127471,91419,36052,90980030.0,65184740.0,25795290.0,1363,859,504,121276,88243,33033,86515202.0,62877486.0,23637716.0,0.713,0.7155,0.7125,0.7156
2023-10-09 14:15,361,148,213,13913,7062,6851,9950468.0,5065866.0,4884602.0,246,129,117,9940,4994,4946,7109056.0,3561025.0,3548031.0,0.7173,0.713,0.7131,0.7174
2023-10-09 14:20,358,205,153,14932,10675,4257,10658193.0,7642156.0,3016037.0,318,181,137,13640,10064,3576,9734693.0,7170476.0,2564216.0,0.7159,0.7085,0.7125,0.7171
2023-10-09 14:25,1724,997,727,125534,64656,60878,89421319.0,46138695.0,43282624.0,1657,963,694,117871,62053,55818,84208806.0,44252711.0,39956095.0,0.7136,0.711,0.7131,0.7158
2023-10-09 14:30,874,273,601,77598,19730,57868,55497872.0,14091883.0,41405989.0,838,261,577,76179,19019,57160,54460530.0,13545429.0,40915100.0,0.7142,0.7155,0.7122,0.7158
2023-10-09 14:35,1244,528,716,79324,40210,39114,56584447.0,28620788.0,27963659.0,1222,511,711,78851,40153,38698,56246835.0,28579866.0,27666969.0,0.7118,0.7149,0.7118,0.7149
2023-10-09 14:40,934,648,286,77660,56324,21336,55319676.0,40069516.0,15250159.0,916,639,277,77218,56227,20991,55004374.0,40000217.0,15004156.0,0.7114,0.7148,0.7114,0.7148
2023-10-09 14:45,878,455,423,80717,37659,43058,57530076.0,26781582.0,30748494.0,858,450,408,80733,37855,42878,57547097.0,26912512.0,30634584.0,0.7112,0.7141,0.7109,0.7145
2023-10-09 14:50,1147,577,570,110615,45227,65388,78881008.0,32174245.0,46706763.0,1112,555,557,108254,43793,64461,77189954.0,31138260.0,46051693.0,0.7114,0.7143,0.711,0.7144
2023-10-09 14:55,790,416,374,65424,29390,36034,46685302.0,20938059.0,25747243.0,785,414,371,68377,29289,39088,48870830.0,20838698.0,28032131.0,0.7124,0.7145,0.7115,0.7172
2023-10-09 15:00,1234,189,1045,74198,8885,65313,53016289.0,6345234.0,46671054.0,1218,177,1041,73684,8579,65105,52631501.0,6109131.0,46522370.0,0.7142,0.7146,0.7121,0.7146
2023-10-09 15:05,1418,704,714,110809,38063,72746,79068826.0,27080372.0,51988454.0,1391,688,703,108975,37271,71704,77748200.0,26518250.0,51229950.0,0.7115,0.7147,0.7115,0.7145
2023-10-09 15:10,968,427,541,86019,25074,60945,61264824.0,17855719.0,43409105.0,924,398,526,83182,23676,59506,59314546.0,16839154.0,42475392.0,0.7121,0.7123,0.7112,0.7138
2023-10-09 15:15,150,59,91,14318,3751,10567,10211510.0,2668252.0,7543258.0,141,57,84,13928,3631,10297,9933953.0,2581898.0,7352054.0,0.7113,0.7139,0.7111,0.714
2023-10-09 15:20,845,214,631,85747,16289,69458,61142148.0,11577094.0,49565054.0,837,205,632,85492,16248,69244,60964865.0,11547026.0,49417839.0,0.7107,0.7136,0.7107,0.7137
2023-10-09 15:25,506,140,366,76290,11204,65086,54417292.0,7962684.0,46454607.0,497,135,362,75559,10701,64858,53896728.0,7604629.0,46292099.0,0.7107,0.7137,0.7106,0.7137
2023-10-09 15:30,1439,626,813,103868,29966,73902,74137264.0,21364649.0,52772615.0,1425,618,807,103100,29066,74034,73547670.0,20683484.0,52864186.0,0.713,0.7141,0.7116,0.7141
2023-10-09 15:35,716,205,511,45193,14158,31035,32151949.0,10072454.0,22079494.0,682,190,492,42644,13260,29384,30400119.0,9427095.0,20973024.0,0.7114,0.7114,0.7109,0.7138
2023-10-09 15:40,749,98,651,49171,4113,45058,35053994.0,2905195.0,32148799.0,732,86,646,47069,2131,44938,33577977.0,1514449.0,32063527.0,0.7063,0.7135,0.7107,0.7135
2023-10-09 15:45,631,127,504,60783,8331,52452,43348662.0,5918377.0,37430284.0,622,124,498,60492,8227,52265,43141551.0,5843976.0,37297575.0,0.7104,0.7136,0.7103,0.7136
2023-10-09 15:50,1095,425,670,88940,28143,60797,63311426.0,19963357.0,43348069.0,1038,389,649,85447,27488,57959,60840738.0,19501480.0,41339257.0,0.7094,0.713,0.7095,0.7133
2023-10-09 15:55,222,85,137,21534,6519,15015,15317280.0,4625074.0,10692205.0,196,69,127,19455,4833,14622,13852617.0,3426984.0,10425633.0,0.7095,0.7121,0.7091,0.713
2023-10-09 16:00,358,110,248,30405,6717,23688,21612817.0,4777548.0,16835268.0,339,92,247,29255,5454,23801,20801952.0,3854223.0,16947729.0,0.7113,0.7107,0.7067,0.7121
2023-10-09 16:05,969,189,780,91492,12583,78909,65100594.0,8918713.0,56181880.0,936,170,766,90351,11726,78625,64315208.0,8307637.0,56007571.0,0.7088,0.712,0.7085,0.7123
2023-10-09 16:10,1190,335,855,98115,14579,83536,69809284.0,10333349.0,59475935.0,1177,328,849,97008,14229,82779,69047605.0,10085896.0,58961709.0,0.7088,0.712,0.7088,0.7123
2023-10-09 16:15,737,110,627,78843,5989,72854,56123762.0,4228420.0,51895342.0,723,93,630,73496,5749,67747,52308946.0,4058596.0,48250349.0,0.706,0.7123,0.706,0.7122
2023-10-09 16:20,400,126,274,33970,6047,27923,24078573.0,4275862.0,19802710.0,364,103,261,31882,5181,26701,22645060.0,3659152.0,18985908.0,0.7071,0.7092,0.7063,0.7111
2023-10-09 16:25,915,387,528,54675,18970,35705,38859777.0,13456161.0,25403616.0,891,369,522,59484,18295,41189,42288991.0,12953340.0,29335650.0,0.7093,0.7115,0.708,0.7122
2023-10-09 16:30,439,122,317,47524,5130,42394,34429022.0,3635161.0,30793861.0,415,113,302,34519,4787,29732,24542467.0,3385573.0,21156894.0,0.7086,0.7264,0.7072,0.7116
2023-10-09 16:35,1597,745,852,141967,45249,96718,101488474.0,32076127.0,69412347.0,1555,719,836,138422,43986,94436,98445497.0,31176693.0,67268804.0,0.7089,0.7177,0.7088,0.7123
2023-10-09 16:40,1623,934,689,133042,71671,61371,94762108.0,51037718.0,43724390.0,1581,914,667,130205,70445,59760,92533737.0,49954043.0,42579693.0,0.7121,0.7125,0.7091,0.7125
2023-10-09 16:45,873,616,257,51793,27963,23830,36769953.0,19811761.0,16958191.0,850,598,252,51348,27549,23799,36453859.0,19517527.0,16936332.0,0.7085,0.7116,0.7085,0.7116
2023-10-09 16:50,718,495,223,41177,18774,22403,29258973.0,13310107.0,15948866.0,704,484,220,41033,18676,22357,29152718.0,13237133.0,15915584.0,0.709,0.7119,0.7088,0.7119
2023-10-09 16:55,619,330,289,48682,15123,33559,34640432.0,10733619.0,23906812.0,612,325,287,48804,15363,33441,34721677.0,10899374.0,23822303.0,0.7098,0.7124,0.7095,0.7124
2023-10-09 17:00,984,445,539,74505,30132,44373,52884391.0,21321376.0,31563015.0,957,428,529,72367,28621,43746,51372788.0,20253184.0,31119604.0,0.7076,0.7113,0.7076,0.7114
2023-10-09 17:05,90,47,43,5257,3297,1960,3622188.0,2228412.0,1393776.0,74,34,40,5329,3627,1702,3672812.0,2462127.0,1210684.0,0.6759,0.7111,0.6788,0.7113
2023-10-09 17:10,292,104,188,22374,5276,17098,15880745.0,3727407.0,12153338.0,286,106,180,23132,6103,17029,16425853.0,4311401.0,12114452.0,0.7065,0.7108,0.7064,0.7114
2023-10-09 17:15,255,124,131,24638,7887,16751,17473191.0,5587647.0,11885544.0,230,111,119,23269,7001,16268,16515294.0,4943277.0,11572017.0,0.7085,0.7095,0.7061,0.7113
2023-10-09 17:20,248,104,144,25855,4171,21684,18340345.0,2957406.0,15382938.0,224,92,132,25222,3699,21523,17931039.0,2621574.0,15309464.0,0.709,0.7094,0.7087,0.7113
2023-10-09 17:25,374,121,253,34418,5036,29382,24475644.0,3566150.0,20909494.0,362,113,249,34118,4805,29313,24257896.0,3397969.0,20859927.0,0.7081,0.7116,0.7072,0.7116
2023-10-09 17:30,281,76,205,14305,4191,10114,10188871.0,2993197.0,7195674.0,269,70,199,14260,4358,9902,10134167.0,3088660.0,7045506.0,0.7142,0.7115,0.7087,0.7115
2023-10-09 17:35,225,69,156,8559,1648,6911,6100153.0,1180312.0,4919840.0,212,59,153,8333,1528,6805,5929320.0,1084693.0,4844626.0,0.7162,0.7119,0.7099,0.7119
2023-10-09 17:40,444,94,350,24491,4295,20196,17430237.0,3053529.0,14376708.0,421,84,337,23728,3701,20027,16889521.0,2626113.0,14263408.0,0.7109,0.7119,0.7096,0.7122
2023-10-09 17:45,355,230,125,19601,9787,9814,13880955.0,6937415.0,6943540.0,341,225,116,18512,9394,9118,13147880.0,6657711.0,6490169.0,0.7088,0.7075,0.7087,0.7118
2023-10-09 17:50,580,109,471,34029,7907,26122,23888278.0,5594062.0,18294216.0,545,92,453,29562,6279,23283,21008013.0,4440774.0,16567239.0,0.7075,0.7003,0.7072,0.7116
2023-10-09 17:55,170,58,112,14052,6708,7344,9921951.0,4736621.0,5185329.0,146,48,98,12371,5640,6731,8776237.0,3992187.0,4784049.0,0.7061,0.7061,0.7078,0.7107
2023-10-09 18:00,820,378,442,55243,27441,27802,38988815.0,19360379.0,19628436.0,781,349,432,54131,27207,26924,38269786.0,19159723.0,19110063.0,0.7055,0.706,0.7042,0.7098
2023-10-09 18:05,2054,956,1098,181398,59568,121830,128708196.0,42159748.0,86548448.0,2037,941,1096,181705,59756,121949,128903209.0,42270165.0,86633043.0,0.7078,0.7104,0.7074,0.7104
2023-10-09 18:10,763,298,465,69096,31820,37276,48977873.0,22496628.0,26481244.0,742,288,454,68703,31436,37267,48709602.0,22223731.0,26485871.0,0.707,0.7104,0.707,0.7107
2023-10-09 18:15,1222,348,874,125431,22972,102459,88886707.0,16198656.0,72688051.0,1285,382,903,124844,23436,101408,88478428.0,16521548.0,71956880.0,0.7051,0.7094,0.705,0.7096
2023-10-09 18:20,5381,2243,3138,517949,172026,345923,364791479.0,120459485.0,244331994.0,5248,2158,3090,502259,160412,341847,354600762.0,112781184.0,241819577.0,0.7002,0.7063,0.7031,0.7074
2023-10-09 18:25,3663,1190,2473,337046,59364,277682,238190613.0,41811619.0,196378994.0,3583,1148,2435,334313,58010,276303,236278498.0,40823778.0,195454719.0,0.7043,0.7072,0.7037,0.7074
2023-10-09 18:30,2385,574,1811,187767,31469,156298,132673350.0,22197019.0,110476331.0,2353,557,1796,186549,31437,155112,131880210.0,22142964.0,109737245.0,0.7054,0.7068,0.7044,0.7075
2023-10-09 18:35,3335,1220,2115,324770,84418,240352,229276613.0,59474671.0,169801942.0,3298,1197,2101,336533,83379,253154,238885655.0,58716954.0,180168701.0,0.7045,0.7065,0.7042,0.7117
2023-10-10 10:00,5263,2935,2328,491811,301045,190766,346296909.0,210750694.0,135546214.0,4810,2753,2057,467889,292641,175248,329237506.0,205328363.0,123909143.0,0.7001,0.7105,0.7016,0.7071
2023-10-10 10:05,2593,1230,1363,215475,99735,115740,151902289.0,70150624.0,81751664.0,2435,1107,1328,210217,95373,114844,148001419.0,66880161.0,81121257.0,0.7034,0.7063,0.7012,0.7064
2023-10-10 10:10,1214,437,777,87528,23694,63834,61818660.0,16632124.0,45186535.0,1126,404,722,86931,23286,63645,61401769.0,16353682.0,45048087.0,0.702,0.7079,0.7023,0.7078
2023-10-10 10:15,1321,700,621,82113,43366,38747,57898736.0,30526679.0,27372057.0,1237,642,595,78985,42258,36727,55693185.0,29711025.0,25982160.0,0.7039,0.7064,0.7031,0.7074
2023-10-10 10:20,2204,1145,1059,168907,88476,80431,119235331.0,62256512.0,56978819.0,2125,1090,1035,171725,92461,79264,120800769.0,64685359.0,56115409.0,0.7037,0.7084,0.6996,0.708
2023-10-10 10:25,655,453,202,35902,24135,11767,25325563.0,16996181.0,8329381.0,626,437,189,34900,23841,11059,24609762.0,16768257.0,7841504.0,0.7042,0.7079,0.7033,0.7091
2023-10-10 10:30,599,344,255,30943,20218,10725,21846937.0,14245571.0,7601366.0,571,325,246,30305,19843,10462,21400962.0,13984196.0,7416766.0,0.7046,0.7088,0.7047,0.7089
2023-10-10 10:35,1499,627,872,91225,46215,45010,65042107.0,33082932.0,31959175.0,1407,588,819,83234,42279,40955,58903698.0,29823719.0,29079979.0,0.7158,0.71,0.7054,0.71
2023-10-10 10:40,1437,623,814,83945,33789,50156,59497662.0,23882878.0,35614783.0,1378,593,785,81528,32698,48830,57796787.0,23111954.0,34684832.0,0.7068,0.7101,0.7068,0.7103
2023-10-10 10:45,395,160,235,26409,9404,17005,18660905.0,6637892.0,12023013.0,351,131,220,22686,7370,15316,16078381.0,5205604.0,10872777.0,0.7059,0.707,0.7063,0.7099
2023-10-10 10:50,1008,383,625,84475,31450,53025,59819576.0,22199811.0,37619764.0,972,357,615,83707,30597,53110,59277263.0,21598332.0,37678930.0,0.7059,0.7095,0.7059,0.7095
2023-10-10 10:55,1310,367,943,92383,23930,68453,65416273.0,16875617.0,48540655.0,1295,363,932,91884,24109,67775,65063096.0,17001836.0,48061260.0,0.7052,0.7091,0.7052,0.7091
2023-10-10 11:00,957,340,617,67468,19673,47795,47869805.0,13956971.0,33912834.0,935,326,609,66834,18833,48001,47345868.0,13286560.0,34059308.0,0.7094,0.7095,0.7055,0.7096
2023-10-10 11:05,540,259,281,30587,12864,17723,21687796.0,9109241.0,12578555.0,510,239,271,29631,12391,17240,21004606.0,8763808.0,12240798.0,0.7081,0.7097,0.7073,0.71
2023-10-10 11:10,388,108,280,13462,4705,8757,9550719.0,3335650.0,6215069.0,360,92,268,12923,4407,8516,9152428.0,3115347.0,6037081.0,0.709,0.7097,0.7069,0.7089
2023-10-10 11:15,397,271,126,16524,9258,7266,11680819.0,6543854.0,5136965.0,375,261,114,15557,9081,6476,11007737.0,6416374.0,4591363.0,0.7068,0.707,0.7066,0.709
2023-10-10 11:20,117,63,54,6498,2799,3699,4593663.0,1973520.0,2620143.0,101,52,49,6220,2610,3610,4401821.0,1841633.0,2560187.0,0.7051,0.7083,0.7056,0.7092
2023-10-10 11:25,920,459,461,41489,21102,20387,29468031.0,15005016.0,14463015.0,892,443,449,39268,19592,19676,27800271.0,13849886.0,13950384.0,0.7111,0.7094,0.7069,0.709
2023-10-10 11:30,836,311,525,37541,16321,21220,26576685.0,11528657.0,15048028.0,815,299,516,36667,15898,20769,25958561.0,11227182.0,14731378.0,0.7064,0.7091,0.7062,0.7093
2023-10-10 11:35,588,101,487,21340,5069,16271,15113484.0,3579849.0,11533634.0,576,94,482,21019,5169,15850,14883605.0,3650543.0,11233062.0,0.7062,0.7088,0.7062,0.7087
2023-10-10 11:40,276,35,241,8949,2126,6823,6330747.0,1498142.0,4832605.0,269,29,240,8679,1909,6770,6142247.0,1346122.0,4796124.0,0.7047,0.7083,0.7051,0.7084
2023-10-10 11:45,83,49,34,4753,2898,1855,3343347.0,2045124.0,1298223.0,69,42,27,4287,2480,1807,3040849.0,1749579.0,1291270.0,0.7057,0.6999,0.7055,0.7146
2023-10-10 11:50,224,96,128,14477,5399,9078,10250642.0,3816022.0,6434620.0,196,78,118,14041,5225,8816,9937840.0,3686717.0,6251123.0,0.7068,0.7088,0.7056,0.7091
2023-10-10 11:55,219,104,115,18304,7974,10330,12953063.0,5627632.0,7325430.0,220,103,117,18347,7922,10425,12982233.0,5588628.0,7393605.0,0.7057,0.7091,0.7055,0.7092
2023-10-10 12:00,538,249,289,29067,14747,14320,20584895.0,10419327.0,10165568.0,464,243,221,27871,14366,13505,19732353.0,10147974.0,9584379.0,0.7065,0.7099,0.7064,0.7097
2023-10-10 12:05,278,116,162,19838,5921,13917,14172445.0,4290903.0,9881542.0,261,108,153,17922,4734,13188,12711320.0,3346661.0,9364659.0,0.7247,0.71,0.7069,0.7101
2023-10-10 12:10,930,365,565,68904,16667,52237,48898162.0,11792741.0,37105421.0,917,360,557,68526,16410,52116,48635736.0,11611150.0,37024586.0,0.7076,0.7103,0.7076,0.7104
2023-10-10 12:15,227,123,104,9994,4539,5455,7074510.0,3209343.0,3865167.0,212,115,97,9263,4172,5091,6564793.0,2949381.0,3615412.0,0.7071,0.7086,0.7069,0.7102
2023-10-10 12:20,797,135,662,39010,11005,28005,27651529.0,7780995.0,19870534.0,786,131,655,38646,10870,27776,27394417.0,7684916.0,19709500.0,0.707,0.7095,0.707,0.7096
2023-10-10 12:25,212,76,136,14377,5609,8768,10188483.0,3965648.0,6222835.0,201,69,132,13086,5175,7911,9276252.0,3659395.0,5616857.0,0.707,0.7097,0.7071,0.71
2023-10-10 12:30,285,86,199,15983,6478,9505,11312757.0,4575213.0,6737544.0,272,78,194,16117,6281,9836,11408708.0,4436260.0,6972448.0,0.7063,0.7088,0.7063,0.7089
2023-10-10 12:35,360,154,206,15316,7191,8125,10837229.0,5078081.0,5759148.0,356,151,205,15501,7454,8047,10961469.0,5257526.0,5703942.0,0.7062,0.7088,0.7053,0.7088
2023-10-10 12:40,809,271,538,27988,10325,17663,19820459.0,7299750.0,12520709.0,797,264,533,28213,10338,17875,19972743.0,7304066.0,12668676.0,0.707,0.7089,0.7065,0.7087
2023-10-10 12:45,236,127,109,16578,9057,7521,11728108.0,6397585.0,5330522.0,221,122,99,15902,8788,7114,11258098.0,6210339.0,5047758.0,0.7064,0.7088,0.7067,0.7096
2023-10-10 12:50,105,56,49,8984,5810,3174,6360440.0,4106639.0,2253801.0,100,54,46,7366,4337,3029,5213720.0,3063384.0,2150336.0,0.7068,0.7101,0.7063,0.7099
2023-10-10 12:55,1025,430,595,50332,25887,24445,35720764.0,18369045.0,17351718.0,1013,419,594,51663,26994,24669,36612713.0,19099851.0,17512862.0,0.7096,0.7098,0.7076,0.7099
2023-10-10 13:00,266,172,94,20546,14470,6076,14557156.0,10241641.0,4315514.0,247,161,86,19838,14187,5651,14044930.0,10030318.0,4014611.0,0.7078,0.7103,0.707,0.7104
2023-10-10 13:05,523,319,204,24864,15939,8925,17669631.0,11333162.0,6336469.0,497,306,191,21727,13338,8389,15396614.0,9440284.0,5956330.0,0.711,0.71,0.7078,0.71
2023-10-10 13:10,314,177,137,18945,11800,7145,13445760.0,8370507.0,5075253.0,289,162,127,17912,10966,6946,12704269.0,7767443.0,4936825.0,0.7094,0.7103,0.7083,0.7107
2023-10-10 13:15,785,403,382,32635,16506,16129,23221835.0,11731202.0,11490632.0,769,397,372,32678,17945,14733,23186593.0,12713501.0,10473092.0,0.7107,0.7124,0.7085,0.7109
2023-10-10 13:20,1024,553,471,51533,36846,14687,36512035.0,26082811.0,10429223.0,991,537,454,50491,36235,14256,35773199.0,25649888.0,10123310.0,0.7079,0.7101,0.7079,0.7101
2023-10-10 13:25,588,209,379,26140,15011,11129,18532681.0,10625092.0,7907589.0,579,205,374,25466,14691,10775,18058035.0,10403737.0,7654298.0,0.7078,0.7105,0.7082,0.7104
2023-10-10 13:30,647,253,394,17492,7373,10119,12387375.0,5223700.0,7163674.0,644,249,395,16590,6517,10073,11774963.0,4620194.0,7154769.0,0.7085,0.7079,0.7089,0.7103
2023-10-10 13:35,73,32,41,2532,1716,816,1797205.0,1216113.0,581092.0,68,29,39,2067,1329,738,1467642.0,941889.0,525752.0,0.7087,0.7121,0.7087,0.7124
2023-10-10 13:40,29,18,11,587,330,257,419311.0,236021.0,183289.0,24,14,10,717,479,238,509061.0,339264.0,169796.0,0.7152,0.7132,0.7083,0.7134
2023-10-10 13:45,387,293,94,12168,9977,2191,8655229.0,7094924.0,1560305.0,368,286,82,10949,8955,1994,7783521.0,6352607.0,1430913.0,0.7111,0.7121,0.7094,0.7176
2023-10-10 13:50,74,41,33,1197,777,420,850930.0,551338.0,299592.0,62,36,26,1484,1284,200,1029738.0,886329.0,143409.0,0.7096,0.7133,0.6903,0.717
2023-10-10 13:55,368,131,237,11379,4814,6565,8086684.0,3410655.0,4676029.0,361,129,232,9763,3922,5841,6930879.0,2776282.0,4154597.0,0.7085,0.7123,0.7079,0.7113
2023-10-10 14:00,420,126,294,18990,7732,11258,13457417.0,5483027.0,7974390.0,399,116,283,18343,7399,10944,13036875.0,5247036.0,7789838.0,0.7091,0.7083,0.7092,0.7118
2023-10-10 14:05,1300,637,663,88091,42544,45547,62796163.0,30322789.0,32473374.0,1260,615,645,85853,40958,44895,61089495.0,29081129.0,32008366.0,0.7127,0.713,0.71,0.713
2023-10-10 14:10,1782,725,1057,127274,69133,58141,90594786.0,49122091.0,41472695.0,1747,716,1031,125647,68164,57483,89410108.0,48400611.0,41009496.0,0.7105,0.7133,0.7101,0.7134
2023-10-10 14:15,1735,876,859,147484,96375,51109,105846099.0,69363154.0,36482944.0,1668,851,817,145613,95565,50048,104406541.0,68653931.0,35752609.0,0.7197,0.7138,0.7184,0.7144
2023-10-10 14:20,1130,422,708,77218,43161,34057,54946841.0,30666714.0,24280126.0,1077,397,680,75946,42158,33788,54069286.0,29944984.0,24124301.0,0.7105,0.7129,0.7103,0.714
2023-10-10 14:25,880,466,414,56688,34790,21898,40353887.0,24740231.0,15613656.0,841,456,385,56245,34803,21442,40029703.0,24714699.0,15315004.0,0.7111,0.713,0.7101,0.7143
2023-10-10 14:30,496,280,216,47604,33949,13655,34173964.0,24490300.0,9683663.0,473,268,205,45753,33050,12703,32917904.0,23858124.0,9059779.0,0.7214,0.7092,0.7219,0.7132
2023-10-10 14:35,1261,702,559,57018,41371,15647,40499715.0,29352614.0,11147101.0,1234,680,554,55695,40375,15320,39558985.0,28640773.0,10918212.0,0.7095,0.7124,0.7094,0.7127
2023-10-10 14:40,439,297,142,31519,23059,8460,22417732.0,16381140.0,6036592.0,425,291,134,31320,22962,8358,22276470.0,16312818.0,5963652.0,0.7104,0.7135,0.7104,0.7135
2023-10-10 14:45,994,624,370,70814,53846,16968,50321936.0,38257603.0,12064333.0,966,611,355,69474,53295,16179,49373329.0,37830262.0,11543067.0,0.7105,0.711,0.7098,0.7135
2023-10-10 14:50,392,237,155,33420,25771,7649,23666213.0,18213155.0,5453057.0,380,234,146,32415,25123,7292,23038848.0,17838774.0,5200073.0,0.7067,0.7129,0.7101,0.7131
2023-10-10 14:55,556,351,205,34693,23605,11088,24698490.0,16787987.0,7910502.0,538,342,196,33142,22177,10965,23572899.0,15751541.0,7821357.0,0.7112,0.7134,0.7103,0.7133
2023-10-10 15:00,530,68,462,13606,1442,12164,9698788.0,1022608.0,8676180.0,520,61,459,12673,1078,11595,9037828.0,766453.0,8271375.0,0.7092,0.7133,0.711,0.7134
2023-10-10 15:05,383,204,179,19473,12386,7087,13849086.0,8792314.0,5056772.0,369,198,171,20287,13148,7139,14426434.0,9334224.0,5092209.0,0.7099,0.7135,0.7099,0.7133
2023-10-10 15:10,621,347,274,31142,17758,13384,22157315.0,12612870.0,9544445.0,611,342,269,30959,17631,13328,22034553.0,12519330.0,9515223.0,0.7103,0.7131,0.7101,0.7139
2023-10-10 15:15,455,229,226,33991,22553,11438,24281630.0,16140375.0,8141254.0,414,203,211,28115,19247,8868,19973517.0,13639996.0,6333521.0,0.7157,0.7118,0.7087,0.7142
2023-10-10 15:20,1704,1068,636,117854,82211,35643,84952825.0,59427088.0,25525737.0,1464,964,500,105403,75963,29440,76106627.0,54991438.0,21115189.0,0.7229,0.7162,0.7239,0.7172
2023-10-10 15:25,788,398,390,28791,15524,13267,20668567.0,11179871.0,9488696.0,695,337,358,26138,12315,13823,18676079.0,8775426.0,9900653.0,0.7202,0.7152,0.7126,0.7162
2023-10-10 15:30,577,376,201,23166,13609,9557,16586242.0,9747016.0,6839226.0,484,339,145,21159,12844,8315,15150418.0,9182712.0,5967705.0,0.7162,0.7156,0.7149,0.7177
2023-10-10 15:35,754,568,186,44287,34361,9926,31954624.0,24804569.0,7150055.0,634,512,122,39847,31859,7988,28513347.0,22767612.0,5745734.0,0.7219,0.7203,0.7146,0.7193
2023-10-10 15:40,519,171,348,25254,9669,15585,18014648.0,6881566.0,11133081.0,456,144,312,21414,7379,14035,15365330.0,5274413.0,10090916.0,0.7117,0.7143,0.7148,0.719
2023-10-10 15:45,648,489,159,50704,37547,13157,36232048.0,26866675.0,9365373.0,612,476,136,47814,36371,11443,34225312.0,26004916.0,8220396.0,0.7155,0.7118,0.715,0.7184
2023-10-10 15:50,421,376,45,30350,27739,2611,21683819.0,19800306.0,1883513.0,390,365,25,29384,27731,1653,20986327.0,19791291.0,1195035.0,0.7138,0.7214,0.7137,0.7229
2023-10-10 15:55,538,232,306,28306,19602,8704,20657781.0,14442435.0,6215345.0,475,213,262,26893,18732,8161,19686932.0,13821145.0,5865787.0,0.7368,0.7141,0.7378,0.7188
2023-10-10 16:00,585,208,377,28734,17331,11403,20562702.0,12370895.0,8191807.0,488,190,298,28590,17132,11458,20454404.0,12228086.0,8226317.0,0.7138,0.7184,0.7138,0.718
2023-10-10 16:05,798,308,490,63228,44805,18423,45196298.0,32008338.0,13187960.0,751,288,463,61214,43474,17740,43752868.0,31030433.0,12722434.0,0.7144,0.7158,0.7138,0.7172
2023-10-10 16:10,167,111,56,15131,11441,3690,10785984.0,8161543.0,2624440.0,147,101,46,14993,11656,3337,10680388.0,8284580.0,2395808.0,0.7134,0.7112,0.7108,0.718
2023-10-10 16:15,192,103,89,10649,7167,3482,7608090.0,5114126.0,2493964.0,169,91,78,9444,6791,2653,6748933.0,4845175.0,1903758.0,0.7136,0.7162,0.7135,0.7176
2023-10-10 16:20,204,122,82,16217,11677,4540,11572635.0,8326742.0,3245893.0,190,111,79,15728,11458,4270,11232454.0,8168946.0,3063508.0,0.7131,0.715,0.7129,0.7174
2023-10-10 16:25,1003,395,608,52529,25020,27509,37485650.0,17837430.0,19648219.0,952,366,586,48546,23551,24995,34703357.0,16797072.0,17906285.0,0.7129,0.7142,0.7132,0.7164
2023-10-10 16:30,945,257,688,41410,19139,22271,29550462.0,13658118.0,15892343.0,912,244,668,39492,18541,20951,28207797.0,13211763.0,14996034.0,0.7136,0.7136,0.7126,0.7158
2023-10-10 16:35,526,173,353,43328,16660,26668,30959677.0,11894939.0,19064737.0,495,152,343,41960,15748,26212,30017026.0,11229796.0,18787229.0,0.714,0.7149,0.7131,0.7167
2023-10-10 16:40,132,73,59,12935,9163,3772,9246594.0,6542933.0,2703661.0,127,75,52,12933,9327,3606,9243501.0,6659082.0,2584419.0,0.7141,0.7168,0.714,0.7167
2023-10-10 16:45,183,99,84,16976,10789,6187,12133338.0,7711673.0,4421664.0,165,91,74,16788,10558,6230,12006403.0,7538253.0,4468150.0,0.7148,0.7147,0.714,0.7172
2023-10-10 16:50,636,399,237,32706,22687,10019,23389347.0,16206845.0,7182501.0,622,391,231,32812,22787,10025,23461364.0,16273757.0,7187606.0,0.7144,0.7169,0.7142,0.717
2023-10-10 16:55,742,471,271,39157,22819,16338,28423018.0,16713970.0,11709048.0,734,469,265,38674,22496,16178,28091201.0,16489492.0,11601709.0,0.7325,0.7167,0.733,0.7171
2023-10-10 17:00,402,208,194,19714,12534,7180,14126581.0,8975924.0,5150656.0,396,203,193,19531,12237,7294,13970035.0,8737873.0,5232162.0,0.7161,0.7174,0.7141,0.7173
2023-10-10 17:05,220,94,126,11150,3733,7417,7969078.0,2668569.0,5300508.0,202,84,118,10698,3588,7110,7662153.0,2561740.0,5100413.0,0.7149,0.7146,0.714,0.7174
2023-10-10 17:10,762,414,348,31021,17400,13621,22230718.0,12455889.0,9774829.0,812,419,393,30611,17429,13182,21925416.0,12469080.0,9456336.0,0.7159,0.7176,0.7154,0.7174
2023-10-10 17:15,610,406,204,25023,18878,6145,17929778.0,13524278.0,4405499.0,576,395,181,24639,18478,6161,17648286.0,13225332.0,4422954.0,0.7164,0.7169,0.7157,0.7179
2023-10-10 17:20,459,267,192,31104,28068,3036,22282311.0,20104230.0,2178081.0,425,258,167,30846,27658,3188,22095511.0,19801440.0,2294071.0,0.7163,0.7174,0.7159,0.7196
2023-10-10 17:25,185,124,61,17637,15772,1865,12604780.0,11264787.0,1339993.0,173,119,54,17089,15535,1554,12211902.0,11094701.0,1117200.0,0.7142,0.7185,0.7142,0.7189
2023-10-10 17:30,650,550,100,29266,25958,3308,20971849.0,18580774.0,2391075.0,614,536,78,27855,25472,2383,19946325.0,18224057.0,1722268.0,0.7158,0.7228,0.7155,0.7227
2023-10-10 17:35,579,408,171,37892,31683,6209,27180882.0,22716655.0,4464226.0,543,388,155,35661,30350,5311,25540297.0,21720122.0,3820175.0,0.717,0.719,0.7157,0.7193
2023-10-10 17:40,842,694,148,60540,55384,5156,43404426.0,39692069.0,3712357.0,799,672,127,60060,54904,5156,43452929.0,39736932.0,3715997.0,0.7167,0.72,0.7238,0.7207
2023-10-10 17:45,552,456,96,48521,44191,4330,34766899.0,31656895.0,3110004.0,526,444,82,47276,43436,3840,33867929.0,31097736.0,2770192.0,0.7164,0.7182,0.7159,0.7214
2023-10-10 17:50,658,542,116,45714,39654,6060,32789988.0,28432542.0,4357446.0,622,523,99,44324,39642,4682,31778388.0,28406306.0,3372082.0,0.717,0.7191,0.7166,0.7202
2023-10-10 17:55,1302,850,452,91181,64295,26886,65869539.0,46434032.0,19435507.0,1192,779,413,85740,59908,25832,61672708.0,43000308.0,18672399.0,0.7222,0.7229,0.7178,0.7228
2023-10-10 18:00,1175,454,721,69669,31206,38463,50204266.0,22498985.0,27705281.0,1068,409,659,66337,30757,35580,47862045.0,22104963.0,25757082.0,0.721,0.7203,0.7187,0.7239
2023-10-10 18:05,4403,2108,2295,371229,197769,173460,266879033.0,141907918.0,124971114.0,4260,2036,2224,366731,196589,170142,263675298.0,140923625.0,122751673.0,0.7175,0.7205,0.7168,0.7215
2023-10-10 18:10,639,449,190,59103,46442,12661,42444761.0,33302880.0,9141881.0,605,432,173,58409,45900,12509,41952564.0,32906045.0,9046518.0,0.7171,0.7221,0.7169,0.7232
2023-10-10 18:15,469,259,210,29317,12614,16703,21182806.0,9105182.0,12077623.0,412,233,179,28109,11998,16111,20293219.0,8638723.0,11654495.0,0.7218,0.7231,0.72,0.7234
2023-10-10 18:20,1346,1040,306,94500,78346,16154,68364042.0,56672382.0,11691660.0,1248,1000,248,91720,76211,15509,66192663.0,54941121.0,11251541.0,0.7234,0.7238,0.7209,0.7255
2023-10-10 18:25,1736,1280,456,136521,105492,31029,98683376.0,76235861.0,22447515.0,1603,1237,366,131866,104152,27714,95272892.0,75148933.0,20123959.0,0.7227,0.7234,0.7215,0.7261
2023-10-10 18:30,2322,1055,1267,210372,59832,150540,152706180.0,43382921.0,109323259.0,2208,998,1210,209329,59532,149797,151722941.0,42868313.0,108854628.0,0.7251,0.7262,0.7201,0.7267
2023-10-10 18:35,2311,1205,1106,203449,54088,149361,147499376.0,39065902.0,108433474.0,2251,1166,1085,201265,53244,148021,145915082.0,38432725.0,107482357.0,0.7223,0.726,0.7218,0.7261
2023-10-11 10:00,12090,7182,4908,1199811,666990,532821,880067237.0,488158279.0,391908957.0,11085,6759,4326,1138292,637078,501214,834264870.0,466009391.0,368255479.0,0.7319,0.7355,0.7315,0.7347
2023-10-11 10:05,2527,984,1543,172898,71107,101791,126990111.0,52234622.0,74755489.0,2093,817,1276,156581,62758,93823,114792035.0,45798223.0,68993811.0,0.7346,0.7344,0.7298,0.7354
2023-10-11 10:10,3245,2050,1195,249599,154453,95146,186679938.0,115509906.0,71170032.0,2330,1666,664,192856,125382,67474,143372316.0,92963917.0,50408398.0,0.7479,0.748,0.7414,0.7471
2023-10-11 10:15,2785,1279,1506,216952,107005,109947,161122116.0,79797909.0,81324207.0,2047,977,1070,169439,76682,92757,125876478.0,56620616.0,69255862.0,0.7457,0.7397,0.7384,0.7466
2023-10-11 10:20,2186,954,1232,150092,58820,91272,111094108.0,43384465.0,67709643.0,1771,763,1008,132770,56253,76517,98681358.0,41660808.0,57020550.0,0.7376,0.7418,0.7406,0.7452
2023-10-11 10:25,885,330,555,63608,24005,39603,46968128.0,17686109.0,29282018.0,741,256,485,58298,21622,36676,43139271.0,15874314.0,27264956.0,0.7368,0.7394,0.7342,0.7434
2023-10-11 10:30,2248,831,1417,173763,50982,122781,127631999.0,37509269.0,90122729.0,1803,603,1200,146807,39267,107540,108401957.0,28779708.0,79622249.0,0.7357,0.734,0.7329,0.7404
2023-10-11 10:35,1375,856,519,91143,53446,37697,67142321.0,39388731.0,27753590.0,1167,712,455,83040,47869,35171,61146054.0,35142698.0,26003356.0,0.737,0.7362,0.7341,0.7393
2023-10-11 10:40,1215,710,505,73783,43957,29826,54127571.0,32214778.0,21912793.0,1047,592,455,67377,40303,27074,49441806.0,29474791.0,19967015.0,0.7329,0.7347,0.7313,0.7375
2023-10-11 10:45,1087,751,336,66089,42360,23729,48650504.0,31199953.0,17450550.0,981,710,271,62169,39852,22317,45683378.0,29231790.0,16451588.0,0.7365,0.7354,0.7335,0.7372
2023-10-11 10:50,943,474,469,46717,22821,23896,34389095.0,16757794.0,17631301.0,837,436,401,46781,23438,23343,34447390.0,17210771.0,17236618.0,0.7343,0.7378,0.7343,0.7384
2023-10-11 10:55,991,380,611,88045,38049,49996,65867803.0,29115320.0,36752483.0,884,302,582,85086,38050,47036,62565071.0,27892600.0,34672471.0,0.7652,0.7351,0.7331,0.7371
2023-10-11 11:00,507,270,237,41875,15014,26861,31165591.0,11011783.0,20153807.0,391,201,190,30241,12758,17483,22232195.0,9340579.0,12891615.0,0.7334,0.7503,0.7321,0.7374
2023-10-11 11:05,834,602,232,39420,24251,15169,29054461.0,17921251.0,11133210.0,762,561,201,35196,21069,14127,25847883.0,15443370.0,10404513.0,0.739,0.7339,0.733,0.7365
2023-10-11 11:10,373,175,198,20802,9657,11145,15334025.0,7086941.0,8247083.0,288,152,136,17283,8665,8618,12703560.0,6348822.0,6354738.0,0.7339,0.74,0.7327,0.7374
2023-10-11 11:15,396,281,115,16162,9825,6337,11853981.0,7204503.0,4649478.0,382,271,111,15489,9628,5861,11369492.0,7059704.0,4309787.0,0.7333,0.7337,0.7332,0.7353
2023-10-11 11:20,582,177,405,28988,8761,20227,21332275.0,6449832.0,14882443.0,516,152,364,33110,7844,25266,24795285.0,5745095.0,19050189.0,0.7362,0.7358,0.7324,0.754
2023-10-11 11:25,398,183,215,30339,19565,10774,22231061.0,14322991.0,7908070.0,367,168,199,28930,18770,10160,21205384.0,13733200.0,7472183.0,0.7321,0.734,0.7317,0.7355
2023-10-11 11:30,399,290,109,16537,8648,7889,12164292.0,6360974.0,5803317.0,362,274,88,15704,8582,7122,11502073.0,6270995.0,5231077.0,0.7355,0.7356,0.7307,0.7345
2023-10-11 11:35,925,444,481,54135,17662,36473,39587476.0,12901243.0,26686233.0,854,392,462,51030,16231,34799,37417490.0,11855563.0,25561927.0,0.7305,0.7317,0.7304,0.7346
2023-10-11 11:40,724,389,335,53412,13126,40286,39642843.0,10046525.0,29596318.0,677,363,314,52217,12402,39815,38749679.0,9489479.0,29260200.0,0.7654,0.7347,0.7652,0.7349
2023-10-11 11:45,821,339,482,57868,14778,43090,42816900.0,11257488.0,31559412.0,750,287,463,55700,13647,42053,41320408.0,10395252.0,30925156.0,0.7618,0.7324,0.7617,0.7354
2023-10-11 11:50,623,354,269,55228,14895,40333,40603241.0,10928726.0,29674515.0,596,337,259,53832,14318,39514,39556147.0,10474278.0,29081868.0,0.7337,0.7357,0.7315,0.736
2023-10-11 11:55,1247,491,756,107619,25507,82112,78765618.0,18650002.0,60115615.0,1193,454,739,105667,25226,80441,77345148.0,18202473.0,59142675.0,0.7312,0.7321,0.7216,0.7352
2023-10-11 12:00,265,120,145,17259,5531,11728,12661040.0,4044306.0,8616733.0,239,106,133,16097,4861,11236,11806501.0,3551321.0,8255180.0,0.7312,0.7347,0.7306,0.7347
2023-10-11 12:05,609,317,292,44588,21649,22939,32701963.0,15848053.0,16853909.0,577,297,280,43355,21123,22232,31781784.0,15441857.0,16339927.0,0.732,0.7347,0.731,0.735
2023-10-11 12:10,400,94,306,28029,4728,23301,20672473.0,3501943.0,17170529.0,374,82,292,26693,4336,22357,19624633.0,3159142.0,16465490.0,0.7407,0.7369,0.7286,0.7365
2023-10-11 12:15,771,463,308,38301,11051,27250,28123490.0,8092348.0,20031141.0,749,451,298,38745,12038,26707,28446205.0,8797325.0,19648879.0,0.7323,0.7351,0.7308,0.7357
2023-10-11 12:20,593,135,458,63517,3599,59918,46734390.0,2652132.0,44082258.0,562,115,447,61924,2632,59292,45546854.0,1922906.0,43623947.0,0.7369,0.7357,0.7306,0.7357
2023-10-11 12:25,355,211,144,25018,7078,17940,18539133.0,5312334.0,13226799.0,311,191,120,22809,6606,16203,16788491.0,4838322.0,11950168.0,0.7505,0.7373,0.7324,0.7375
2023-10-11 12:30,1083,475,608,52176,15839,36337,39262059.0,12099764.0,27162294.0,1010,429,581,47731,12523,35208,35561705.0,9616267.0,25945438.0,0.7639,0.7475,0.7679,0.7369
2023-10-11 12:35,1541,785,756,65384,29638,35746,47882699.0,21787870.0,26094829.0,1422,720,702,60758,28442,32316,44696286.0,20884824.0,23811462.0,0.7351,0.73,0.7343,0.7368
2023-10-11 12:40,861,593,268,56135,32382,23753,41320320.0,23798908.0,17521412.0,802,569,233,53398,31207,22191,39296906.0,22917404.0,16379502.0,0.7349,0.7377,0.7344,0.7381
2023-10-11 12:45,267,176,91,12240,6844,5396,9000494.0,5027930.0,3972564.0,237,160,77,11758,6486,5272,8634858.0,4748284.0,3886573.0,0.7346,0.7362,0.7321,0.7372
2023-10-11 12:50,796,464,332,46327,20956,25371,34032821.0,15366708.0,18666113.0,762,450,312,44160,19476,24684,32479541.0,14271310.0,18208231.0,0.7333,0.7357,0.7328,0.7377
2023-10-11 12:55,1295,892,403,91012,61790,29222,67070966.0,45483268.0,21587698.0,1231,864,367,86932,59028,27904,63992051.0,43343628.0,20648422.0,0.7361,0.7387,0.7343,0.74
2023-10-11 13:00,249,141,108,17771,9546,8225,12997849.0,7023470.0,5974378.0,210,138,72,15212,10209,5003,11197118.0,7491576.0,3705542.0,0.7358,0.7264,0.7338,0.7407
2023-10-11 13:05,771,323,448,45413,28975,16438,33259733.0,21202946.0,12056787.0,728,301,427,42580,27572,15008,31244237.0,20177148.0,11067089.0,0.7318,0.7335,0.7318,0.7374
2023-10-11 13:10,768,486,282,40769,21651,19118,29898611.0,15863187.0,14035424.0,717,458,259,36626,20294,16332,26901313.0,14862116.0,12039197.0,0.7327,0.7341,0.7323,0.7372
2023-10-11 13:15,999,649,350,69611,31176,38435,50877094.0,22898333.0,27978760.0,920,599,321,63766,28700,35066,46801961.0,21009704.0,25792257.0,0.7345,0.728,0.732,0.7355
2023-10-11 13:20,1509,452,1057,117195,24758,92437,86276005.0,18167455.0,68108549.0,1595,487,1108,117367,24837,92530,86362542.0,18188686.0,68173856.0,0.7338,0.7368,0.7323,0.7368
2023-10-11 13:25,851,437,414,65141,22333,42808,47866278.0,16366095.0,31500183.0,830,428,402,64330,21847,42483,47271204.0,15974244.0,31296959.0,0.7328,0.7358,0.7312,0.7367
2023-10-11 13:30,310,192,118,23867,11516,12351,17548854.0,8449652.0,9099201.0,298,188,110,23598,11430,12168,17329959.0,8367282.0,8962676.0,0.7337,0.7367,0.732,0.7366
2023-10-11 13:35,1208,476,732,106067,32716,73351,78022589.0,23957406.0,54065183.0,1191,470,721,105650,32479,73171,77705343.0,23771066.0,53934277.0,0.7323,0.7371,0.7319,0.7371
2023-10-11 13:40,1956,969,987,174440,56986,117454,128358472.0,41797534.0,86560938.0,1947,956,991,172611,56053,116558,127020175.0,41109794.0,85910381.0,0.7335,0.737,0.7334,0.7371
2023-10-11 13:45,723,225,498,37558,13797,23761,27675599.0,10165853.0,17509745.0,688,212,476,36616,13078,23538,26929409.0,9584939.0,17344470.0,0.7368,0.7369,0.7329,0.7369
2023-10-11 13:50,995,356,639,55779,12840,42939,41145123.0,9476219.0,31668904.0,976,344,632,55049,12273,42776,40580452.0,9017280.0,31563171.0,0.738,0.7375,0.7347,0.7379
2023-10-11 13:55,550,82,468,65967,6884,59083,48569167.0,5057215.0,43511952.0,522,71,451,65755,6319,59436,48497954.0,4642702.0,43855252.0,0.7346,0.7365,0.7347,0.7379
2023-10-11 14:00,567,138,429,38815,7200,31615,28668549.0,5333766.0,23334783.0,545,125,420,37299,6628,30671,27503781.0,4866984.0,22636796.0,0.7408,0.7381,0.7343,0.7381
2023-10-11 14:05,885,532,353,55112,25445,29667,40497668.0,18680163.0,21817505.0,854,521,333,53969,25045,28924,39715335.0,18385959.0,21329376.0,0.7341,0.7354,0.7341,0.7374
2023-10-11 14:10,1779,614,1165,156183,59891,96292,114998397.0,43988892.0,71009505.0,1762,606,1156,155619,59553,96066,114584368.0,43739058.0,70845309.0,0.7345,0.7374,0.7345,0.7375
2023-10-11 14:15,1749,755,994,147681,61032,86649,108523526.0,44766085.0,63757440.0,1712,738,974,144537,60318,84219,106282862.0,44228563.0,62054298.0,0.7335,0.7358,0.7333,0.7368
2023-10-11 14:20,3228,1245,1983,318062,85703,232359,233757885.0,62816421.0,170941463.0,3193,1225,1968,317085,85423,231662,233033983.0,62603901.0,170430082.0,0.733,0.7357,0.7329,0.7357
2023-10-11 14:25,905,409,496,67522,13026,54496,49646681.0,9544739.0,40101941.0,893,402,491,66954,12675,54279,49237629.0,9290330.0,39947299.0,0.7327,0.7359,0.733,0.736
2023-10-11 14:30,1107,639,468,81423,20220,61203,59922854.0,14862014.0,45060840.0,1081,625,456,80666,19834,60832,59331257.0,14536963.0,44794294.0,0.735,0.7363,0.7329,0.7364
2023-10-11 14:35,335,46,289,18232,3681,14551,13390753.0,2688216.0,10702536.0,326,43,283,17905,3459,14446,13154545.0,2525216.0,10629328.0,0.7303,0.7355,0.73,0.7358
2023-10-11 14:40,415,89,326,25839,5934,19905,18958907.0,4340508.0,14618399.0,404,84,320,26056,6079,19977,19132649.0,4445121.0,14687527.0,0.7315,0.7344,0.7312,0.7352
2023-10-11 14:45,478,126,352,23791,6129,17662,17411443.0,4474871.0,12936572.0,466,118,348,23163,5923,17240,16995686.0,4323338.0,12672348.0,0.7301,0.7325,0.7299,0.7351
2023-10-11 14:50,1746,972,774,115745,43792,71953,84851765.0,32045736.0,52806029.0,1718,954,764,113718,42867,70851,83431371.0,31367899.0,52063472.0,0.7318,0.7339,0.7317,0.7348
2023-10-11 14:55,1097,613,484,94675,35195,59480,69410420.0,25747924.0,43662496.0,1080,602,478,95017,34043,60974,69729727.0,24906168.0,44823559.0,0.7316,0.7341,0.7316,0.7351
2023-10-11 15:00,583,111,472,69375,3482,65893,50950806.0,2543757.0,48407048.0,563,97,466,68669,3403,65266,50432524.0,2485440.0,47947083.0,0.7305,0.7346,0.7304,0.7346
2023-10-11 15:05,447,177,270,37214,9574,27640,27317876.0,7077990.0,20239885.0,388,151,237,34234,7660,26574,25103506.0,5586995.0,19516511.0,0.7393,0.7323,0.7294,0.7344
2023-10-11 15:10,541,71,470,54468,3698,50770,39907692.0,2697671.0,37210021.0,534,69,465,53742,3703,50039,39442360.0,2701993.0,36740367.0,0.7295,0.7329,0.7297,0.7342
2023-10-11 15:15,403,120,283,46684,5844,40840,34277628.0,4281336.0,29996292.0,378,105,273,47201,6573,40628,34627256.0,4785292.0,29841963.0,0.7326,0.7345,0.728,0.7345
2023-10-11 15:20,212,104,108,34125,7850,26275,25816691.0,5710946.0,20105745.0,204,103,101,19220,6225,12995,14071130.0,4538262.0,9532867.0,0.7275,0.7652,0.729,0.7336
2023-10-11 15:25,45,13,32,4516,542,3974,3304475.0,395158.0,2909317.0,36,11,25,4163,534,3629,3051232.0,388670.0,2662562.0,0.7291,0.7321,0.7278,0.7337
2023-10-11 15:30,576,212,364,43892,14845,29047,32451032.0,11094693.0,21356338.0,519,189,330,37501,11422,26079,27515558.0,8351593.0,19163964.0,0.7474,0.7352,0.7312,0.7348
2023-10-11 15:35,726,280,446,45675,26437,19238,33409340.0,19338379.0,14070960.0,709,272,437,43601,25316,18285,31953326.0,18516931.0,13436394.0,0.7315,0.7314,0.7314,0.7348
2023-10-11 15:40,76,37,39,5072,3003,2069,3717142.0,2196512.0,1520630.0,75,37,38,6429,4360,2069,4708818.0,3187189.0,1521629.0,0.7314,0.735,0.731,0.7354
2023-10-11 15:45,102,53,49,7836,3969,3867,5894890.0,2903592.0,2991297.0,93,49,44,7447,3862,3585,5609905.0,2822191.0,2787714.0,0.7316,0.7735,0.7308,0.7776
2023-10-11 15:50,76,38,38,8533,5551,2982,6249866.0,4063558.0,2186308.0,71,35,36,6714,3879,2835,4918243.0,2833450.0,2084793.0,0.732,0.7332,0.7305,0.7354
2023-10-11 15:55,228,120,108,17915,10795,7120,13182276.0,7937379.0,5244897.0,187,88,99,14253,7699,6554,10471022.0,5642709.0,4828313.0,0.7353,0.7366,0.7329,0.7367
2023-10-11 16:00,266,123,143,17985,10699,7286,13237859.0,7865778.0,5372081.0,215,98,117,14775,8626,6149,10871240.0,6336758.0,4534482.0,0.7352,0.7373,0.7346,0.7374
2023-10-11 16:05,29,7,22,886,452,434,637357.0,332171.0,305185.0,19,9,10,7241,948,6293,5408922.0,689906.0,4719016.0,0.7349,0.7032,0.7277,0.7499
2023-10-11 16:10,282,28,254,13805,2317,11488,10150869.0,1699867.0,8451002.0,273,27,246,13509,2370,11139,9960404.0,1738450.0,8221954.0,0.7336,0.7356,0.7335,0.7381
2023-10-11 16:15,105,36,69,9593,2707,6886,7046413.0,1998831.0,5047582.0,96,33,63,9227,2747,6480,6802124.0,2018587.0,4783537.0,0.7384,0.733,0.7348,0.7382
2023-10-11 16:20,148,93,55,13582,6854,6728,10025729.0,5062047.0,4963682.0,136,88,48,12305,6336,5969,9061249.0,4653944.0,4407305.0,0.7386,0.7378,0.7345,0.7384
2023-10-11 16:25,682,303,379,44649,18420,26229,32869005.0,13543459.0,19325546.0,663,293,370,42061,17867,24194,30945125.0,13120580.0,17824545.0,0.7353,0.7368,0.7343,0.7367
2023-10-11 16:30,172,67,105,13196,6563,6633,9706866.0,4826229.0,4880637.0,157,60,97,12527,5987,6540,9219999.0,4397354.0,4822645.0,0.7354,0.7358,0.7345,0.7374
2023-10-11 16:35,211,85,126,20043,6435,13608,14745223.0,4721499.0,10023723.0,200,79,121,18129,6381,11748,13339265.0,4682520.0,8656745.0,0.7337,0.7366,0.7338,0.7369
2023-10-11 16:40,459,113,346,33532,9176,24356,24658246.0,6730765.0,17927481.0,448,106,342,35170,9211,25959,25862777.0,6751431.0,19111346.0,0.7335,0.7361,0.733,0.7362
2023-10-11 16:45,538,167,371,42687,11694,30993,31344197.0,8583408.0,22760788.0,525,161,364,40668,11539,29129,29928772.0,8468216.0,21460556.0,0.734,0.7344,0.7339,0.7367
2023-10-11 16:50,603,75,528,48309,6795,41514,35527227.0,4978150.0,30549076.0,592,68,524,49424,8439,40985,36349493.0,6186851.0,30162642.0,0.7326,0.7359,0.7331,0.7359
2023-10-11 16:55,314,49,265,21019,3839,17180,15658334.0,2812436.0,12845898.0,305,46,259,19878,4330,15548,14607589.0,3173279.0,11434310.0,0.7326,0.7477,0.7329,0.7354
2023-10-11 17:00,532,212,320,38961,11856,27105,28667245.0,8708159.0,19959086.0,495,192,303,35829,9437,26392,26355967.0,6921343.0,19434623.0,0.7345,0.7364,0.7334,0.7364
2023-10-11 17:05,338,137,201,15846,4931,10915,11669927.0,3629218.0,8040708.0,316,125,191,15217,4843,10374,11209197.0,3561237.0,7647959.0,0.736,0.7367,0.7353,0.7372
2023-10-11 17:10,98,56,42,3196,1540,1656,2350698.0,1135290.0,1215408.0,77,42,35,3322,1723,1599,2452245.0,1265486.0,1186759.0,0.7372,0.7339,0.7345,0.7422
2023-10-11 17:15,329,126,203,25385,6924,18461,18683296.0,5085792.0,13597504.0,315,119,196,25290,7224,18066,18633131.0,5299975.0,13333155.0,0.7345,0.7366,0.7337,0.738
2023-10-11 17:20,73,22,51,5725,1164,4561,4226930.0,859946.0,3366983.0,67,16,51,6117,1240,4877,4509410.0,909243.0,3600167.0,0.7388,0.7382,0.7333,0.7382
2023-10-11 17:25,1196,396,800,97582,29870,67712,71703462.0,21884789.0,49818672.0,1161,376,785,95864,28636,67228,70489389.0,20979851.0,49509538.0,0.7327,0.7357,0.7326,0.7364
2023-10-11 17:30,519,103,416,45505,13279,32226,33411899.0,9716300.0,23695598.0,504,96,408,44938,13088,31850,33001475.0,9577621.0,23423854.0,0.7317,0.7353,0.7318,0.7354
2023-10-11 17:35,1019,252,767,112042,30901,81141,82210674.0,22598692.0,59611982.0,1001,243,758,110733,30275,80458,81296365.0,22144505.0,59151860.0,0.7313,0.7347,0.7314,0.7352
2023-10-11 17:40,964,552,412,58983,26352,32631,43199911.0,19285723.0,23914188.0,946,540,406,58109,25933,32176,42633076.0,18973641.0,23659434.0,0.7319,0.7329,0.7316,0.7353
2023-10-11 17:45,1098,457,641,119759,38000,81759,87835677.0,27768979.0,60066698.0,1084,447,637,119165,37881,81284,87403324.0,27682240.0,59721084.0,0.7308,0.7347,0.7308,0.7347
2023-10-11 17:50,653,386,267,40704,26670,14034,29763457.0,19492037.0,10271420.0,643,379,264,40479,26680,13799,29622045.0,19494622.0,10127423.0,0.7309,0.7319,0.7307,0.7339
2023-10-11 17:55,866,642,224,50798,29918,20880,37202097.0,21865941.0,15336156.0,825,616,209,49525,29529,19996,36279138.0,21575884.0,14703254.0,0.7309,0.7345,0.7307,0.7353
2023-10-11 18:00,1109,555,554,62431,21625,40806,45768844.0,15792487.0,29976357.0,1103,552,551,63184,22352,40832,46290077.0,16290730.0,29999346.0,0.7303,0.7346,0.7288,0.7347
2023-10-11 18:05,1777,535,1242,150828,37191,113637,110638874.0,27083758.0,83555115.0,1695,493,1202,147667,35975,111692,108492493.0,26202146.0,82290346.0,0.7282,0.7353,0.7283,0.7368
2023-10-11 18:10,3219,1477,1742,311937,117613,194324,228092524.0,85577676.0,142514848.0,3142,1427,1715,309880,116307,193573,226590144.0,84618415.0,141971728.0,0.7276,0.7334,0.7275,0.7334
2023-10-11 18:15,1540,592,948,118764,35323,83441,86814643.0,25718361.0,61096281.0,1507,572,935,115318,34927,80391,84296048.0,25419103.0,58876945.0,0.7281,0.7322,0.7278,0.7324
2023-10-11 18:20,166,103,63,9032,5123,3909,6599169.0,3761500.0,2837669.0,141,90,51,7747,4432,3315,5642102.0,3222233.0,2419869.0,0.7342,0.7259,0.727,0.73
2023-10-11 18:25,117,74,43,4794,2990,1804,3462080.0,2148711.0,1313369.0,104,64,40,4500,2486,2014,3282460.0,1807053.0,1475407.0,0.7186,0.728,0.7269,0.7326
2023-10-11 18:30,927,435,492,73657,14742,58915,53865561.0,10789116.0,43076444.0,901,416,485,72896,13684,59212,53245350.0,9953374.0,43291975.0,0.7319,0.7312,0.7274,0.7311
2023-10-11 18:35,1631,397,1234,203829,17881,185948,148872366.0,13004814.0,135867552.0,1629,393,1236,204488,18269,186219,149360030.0,13282950.0,136077079.0,0.7273,0.7307,0.7271,0.7307
2023-10-12 10:00,6352,1880,4472,600074,175224,424850,428070760.0,123985475.0,304085285.0,5547,1416,4131,542116,144431,397685,386673469.0,102464485.0,284208984.0,0.7076,0.7157,0.7094,0.7147
2023-10-12 10:05,1466,844,622,98861,50181,48680,71580854.0,36218088.0,35362766.0,1234,704,530,91817,48802,43015,66295009.0,35001415.0,31293594.0,0.7217,0.7264,0.7172,0.7275
2023-10-12 10:10,1015,674,341,53747,27176,26571,39892425.0,19730484.0,20161941.0,861,555,306,46194,22483,23711,34378181.0,16179408.0,18198772.0,0.726,0.7588,0.7196,0.7675
2023-10-12 10:15,1202,433,769,87165,28173,58992,63365058.0,20504923.0,42860135.0,1052,338,714,78715,23304,55411,57180332.0,16717274.0,40463057.0,0.7278,0.7265,0.7174,0.7302
2023-10-12 10:20,814,347,467,39964,17066,22898,28774475.0,12253561.0,16520914.0,704,285,419,38503,16323,22180,27739467.0,11723224.0,16016242.0,0.718,0.7215,0.7182,0.7221
2023-10-12 10:25,1449,856,593,100303,59251,41052,72368564.0,42688480.0,29680083.0,1377,813,564,97496,58048,39448,70246382.0,41694384.0,28551997.0,0.7205,0.723,0.7183,0.7238
2023-10-12 10:30,1281,945,336,93690,62296,31394,68001471.0,45185191.0,22816280.0,1196,894,302,90970,61327,29643,65718983.0,44191481.0,21527501.0,0.7253,0.7268,0.7206,0.7262
2023-10-12 10:35,1067,542,525,88697,43786,44911,64055596.0,31532836.0,32522760.0,998,509,489,86871,44011,42860,62778009.0,31671683.0,31106326.0,0.7202,0.7242,0.7196,0.7258
2023-10-12 10:40,1844,927,917,160073,86788,73285,115533882.0,62481065.0,53052817.0,1785,895,890,157178,85789,71389,113446693.0,61735003.0,51711689.0,0.7199,0.7239,0.7196,0.7244
2023-10-12 10:45,606,182,424,35048,9807,25241,25295120.0,7034760.0,18260360.0,552,153,399,34274,9471,24803,24745842.0,6800204.0,17945638.0,0.7173,0.7234,0.718,0.7235
2023-10-12 10:50,1004,620,384,64247,34716,29531,47397744.0,26171860.0,21225884.0,954,578,376,58507,32425,26082,42103196.0,23259194.0,18844002.0,0.7539,0.7188,0.7173,0.7225
2023-10-12 10:55,940,558,382,72168,44844,27324,51887023.0,32173739.0,19713284.0,886,521,365,72445,44194,28251,52091951.0,31692904.0,20399047.0,0.7175,0.7215,0.7171,0.7221
2023-10-12 11:00,321,121,200,24336,8053,16283,17569609.0,5784937.0,11784672.0,275,106,169,23963,7794,16169,17305907.0,5599346.0,11706561.0,0.7184,0.7237,0.7184,0.724
2023-10-12 11:05,433,192,241,34909,10567,24342,25238172.0,7612283.0,17625889.0,397,182,215,34444,10671,23773,24880976.0,7666564.0,17214411.0,0.7204,0.7241,0.7184,0.7241
2023-10-12 11:10,838,380,458,57705,20827,36878,41637463.0,14984979.0,26652484.0,800,362,438,55769,20068,35701,40248344.0,14429047.0,25819297.0,0.7195,0.7227,0.719,0.7232
2023-10-12 11:15,815,506,309,49559,26760,22799,35909022.0,19390572.0,16518449.0,769,488,281,47451,25775,21676,34248947.0,18549491.0,15699456.0,0.7246,0.7245,0.7197,0.7243
2023-10-12 11:20,732,312,420,48981,21676,27305,35293289.0,15639756.0,19653533.0,684,283,401,40205,14762,25443,29071735.0,10634014.0,18437721.0,0.7215,0.7198,0.7204,0.7247
2023-10-12 11:25,1055,141,914,53728,5915,47813,38838773.0,4249342.0,34589430.0,1024,119,905,57883,10616,47267,41868958.0,7652460.0,34216498.0,0.7184,0.7234,0.7208,0.7239
2023-10-12 11:30,917,341,576,49777,12006,37771,36001638.0,8660402.0,27341236.0,899,332,567,49367,11642,37725,35713784.0,8398803.0,27314980.0,0.7213,0.7239,0.7214,0.7241
2023-10-12 11:35,422,111,311,34466,10333,24133,24976602.0,7431265.0,17545337.0,404,96,308,33031,10342,22689,23905607.0,7437739.0,16467867.0,0.7192,0.727,0.7192,0.7258
2023-10-12 11:40,1033,476,557,89406,38190,51216,64665753.0,27561995.0,37103758.0,1015,469,546,87080,37176,49904,62973607.0,26790082.0,36183525.0,0.7217,0.7245,0.7206,0.7251
2023-10-12 11:45,740,259,481,49661,10530,39131,35943135.0,7599824.0,28343311.0,719,251,468,48401,10098,38303,35027133.0,7281887.0,27745245.0,0.7217,0.7243,0.7211,0.7244
2023-10-12 11:50,108,57,51,7744,4432,3312,5590040.0,3195140.0,2394900.0,103,50,53,8037,4152,3885,5807178.0,2990622.0,2816556.0,0.7209,0.7231,0.7203,0.725
2023-10-12 11:55,1022,789,233,60429,42939,17490,43663086.0,31035698.0,12627387.0,959,754,205,55973,41665,14308,40487166.0,30106524.0,10380641.0,0.7228,0.722,0.7226,0.7255
2023-10-12 12:00,962,704,258,54791,37981,16810,39665365.0,27464904.0,12200461.0,925,682,243,51623,36491,15132,37333688.0,26363811.0,10969877.0,0.7231,0.7258,0.7225,0.7249
2023-10-12 12:05,796,314,482,28140,14052,14088,20345138.0,10145603.0,10199535.0,792,316,476,28932,14147,14785,20939485.0,10213998.0,10725487.0,0.722,0.724,0.722,0.7254
2023-10-12 12:10,605,159,446,24030,7935,16095,17369218.0,5725915.0,11643303.0,578,139,439,21678,6845,14833,15669044.0,4936670.0,10732373.0,0.7216,0.7234,0.7212,0.7235
2023-10-12 12:15,589,391,198,16635,8751,7884,12041326.0,6346585.0,5694740.0,562,373,189,16201,8729,7472,11701871.0,6292867.0,5409004.0,0.7252,0.7223,0.7209,0.7239
2023-10-12 12:20,340,96,244,16913,10541,6372,12145443.0,7540227.0,4605216.0,319,79,240,16726,10216,6510,12003541.0,7296051.0,4707489.0,0.7153,0.7227,0.7142,0.7231
2023-10-12 12:25,484,158,326,33539,17314,16225,24130349.0,12431522.0,11698827.0,458,140,318,31456,15776,15680,22668665.0,11325148.0,11343517.0,0.718,0.721,0.7179,0.7234
2023-10-12 12:30,274,134,140,24305,9798,14507,17561517.0,7062978.0,10498539.0,258,124,134,24165,10004,14161,17451781.0,7202997.0,10248784.0,0.7209,0.7237,0.72,0.7237
2023-10-12 12:35,574,291,283,32892,15476,17416,23721009.0,11142436.0,12578572.0,544,274,270,32371,15349,17022,23359336.0,11041526.0,12317809.0,0.72,0.7222,0.7194,0.7236
2023-10-12 12:40,54,28,26,4655,2241,2414,3361841.0,1615460.0,1746381.0,47,25,22,4474,2208,2266,3229821.0,1587811.0,1642010.0,0.7209,0.7234,0.7191,0.7246
2023-10-12 12:45,670,411,259,27379,16314,11065,19705363.0,11738995.0,7966368.0,646,400,246,26277,15628,10649,18948925.0,11243606.0,7705318.0,0.7196,0.72,0.7195,0.7236
2023-10-12 12:50,113,47,66,6639,2827,3812,4805290.0,2051871.0,2753419.0,98,42,56,7088,3141,3947,5115828.0,2258605.0,2857223.0,0.7258,0.7223,0.7191,0.7239
2023-10-12 12:55,245,138,107,13331,7464,5867,9616537.0,5386918.0,4229619.0,204,109,95,12273,6888,5385,8850990.0,4955766.0,3895224.0,0.7217,0.7209,0.7195,0.7233
2023-10-12 13:00,1794,825,969,112722,62228,50494,80532376.0,44477630.0,36054745.0,1685,757,928,99473,54417,45056,71428899.0,38913736.0,32515162.0,0.7148,0.714,0.7151,0.7217
2023-10-12 13:05,2016,969,1047,133666,68141,65525,95332703.0,48652507.0,46680196.0,1757,821,936,120062,57506,62556,85957047.0,40978251.0,44978795.0,0.714,0.7124,0.7126,0.719
2023-10-12 13:10,706,425,281,42072,18856,23216,30200259.0,13487773.0,16712486.0,658,400,258,40405,18787,21618,28995087.0,13422562.0,15572525.0,0.7153,0.7199,0.7145,0.7203
2023-10-12 13:15,1219,691,528,64197,31181,33016,46027994.0,22308201.0,23719793.0,1170,659,511,62556,32360,30196,44829132.0,23133029.0,21696102.0,0.7154,0.7184,0.7149,0.7185
2023-10-12 13:20,888,497,391,57440,38064,19376,41153668.0,27233357.0,13920311.0,849,483,366,55841,37887,17954,40018784.0,27109965.0,12908818.0,0.7155,0.7184,0.7155,0.719
2023-10-12 13:25,1387,1102,285,85262,64605,20657,61122366.0,46289149.0,14833217.0,1345,1076,269,84559,64618,19941,60630026.0,46288796.0,14341230.0,0.7165,0.7181,0.7163,0.7192
2023-10-12 13:30,540,343,197,46957,28383,18574,33620494.0,20275022.0,13345471.0,523,331,192,45537,27148,18389,32616112.0,19401948.0,13214164.0,0.7143,0.7185,0.7147,0.7186
2023-10-12 13:35,588,336,252,47266,25219,22047,33865072.0,18022924.0,15842148.0,559,321,238,46753,24902,21851,33509804.0,17800588.0,15709216.0,0.7147,0.7186,0.7148,0.7189
2023-10-12 13:40,1543,914,629,98324,54250,44074,70339364.0,38770966.0,31568398.0,1499,890,609,96297,53525,42772,68969610.0,38245929.0,30723680.0,0.7147,0.7163,0.7145,0.7183
2023-10-12 13:45,361,108,253,20079,8187,11892,14385236.0,5853390.0,8531845.0,340,98,242,19310,7703,11607,13841979.0,5503110.0,8338869.0,0.715,0.7174,0.7144,0.7184
2023-10-12 13:50,1104,762,342,68186,42672,25514,48621141.0,30425500.0,18195640.0,1007,689,318,58085,37836,20249,41489027.0,26973207.0,14515820.0,0.713,0.7132,0.7129,0.7169
2023-10-12 13:55,1813,1020,793,152433,94581,57852,109865070.0,68273805.0,41591265.0,1666,941,725,137372,83504,53868,98359396.0,59608382.0,38751013.0,0.7219,0.7189,0.7138,0.7194
2023-10-12 14:00,1764,625,1139,135476,61444,74032,97278867.0,43979348.0,53299518.0,1696,590,1106,134269,62191,72078,96456220.0,44500924.0,51955296.0,0.7158,0.72,0.7156,0.7208
2023-10-12 14:05,1259,679,580,114441,61678,52763,82196543.0,44141395.0,38055147.0,1237,669,568,114105,61453,52652,81963806.0,43975230.0,37988576.0,0.7157,0.7212,0.7156,0.7215
2023-10-12 14:10,822,554,268,59657,40335,19322,42827346.0,28885913.0,13941432.0,800,538,262,59155,40059,19096,42461684.0,28682432.0,13779252.0,0.7162,0.7215,0.716,0.7216
2023-10-12 14:15,767,490,277,51544,29553,21991,37049899.0,21176019.0,15873879.0,755,483,272,49981,28294,21687,35917057.0,20261990.0,15655066.0,0.7165,0.7218,0.7161,0.7219
2023-10-12 14:20,1040,686,354,63531,37406,26125,45692300.0,26824128.0,18868171.0,1045,686,359,63637,37349,26288,45769810.0,26783342.0,18986468.0,0.7171,0.7222,0.7171,0.7222
2023-10-12 14:25,1214,780,434,79581,47539,32042,57243372.0,34113759.0,23129612.0,1207,775,432,79105,47151,31954,56879522.0,33815537.0,23063984.0,0.7176,0.7219,0.7172,0.7218
2023-10-12 14:30,647,359,288,57455,30996,26459,41332842.0,22223466.0,19109376.0,637,351,286,56839,30806,26033,40882596.0,22082561.0,18800035.0,0.717,0.7222,0.7168,0.7222
2023-10-12 14:35,797,226,571,46808,14002,32806,33751029.0,10059566.0,23691463.0,775,217,558,45225,12860,32365,32590874.0,9219492.0,23371382.0,0.7184,0.7222,0.7169,0.7221
2023-10-12 14:40,1159,326,833,61798,18331,43467,44502600.0,13113898.0,31388701.0,1138,312,826,61339,18084,43255,44179063.0,12940476.0,31238587.0,0.7154,0.7221,0.7156,0.7222
2023-10-12 14:45,444,145,299,43466,8944,34522,31359533.0,6412247.0,24947286.0,430,133,297,43378,8915,34463,31296176.0,6391293.0,24904882.0,0.7169,0.7226,0.7169,0.7227
2023-10-12 14:50,719,301,418,60053,25460,34593,43181816.0,18258805.0,24923011.0,693,290,403,58079,25240,32839,41787348.0,18101439.0,23685909.0,0.7172,0.7205,0.7172,0.7213
2023-10-12 14:55,909,548,361,84018,45628,38390,60329637.0,32686947.0,27642690.0,885,533,352,82840,45117,37723,59522600.0,32317799.0,27204801.0,0.7164,0.72,0.7163,0.7212
2023-10-12 15:00,172,76,96,23093,9043,14050,16624903.0,6468969.0,10155934.0,164,69,95,22902,9076,13826,16487468.0,6490892.0,9996576.0,0.7154,0.7228,0.7152,0.723
2023-10-12 15:05,1261,921,340,98610,62372,36238,70771752.0,44641411.0,26130340.0,1213,883,330,96818,61382,35436,69486014.0,43925122.0,25560892.0,0.7157,0.7211,0.7156,0.7213
2023-10-12 15:10,272,200,72,27069,15826,11243,19396708.0,11312311.0,8084396.0,241,173,68,22181,14209,7972,15890997.0,10145788.0,5745208.0,0.7148,0.7191,0.714,0.7207
2023-10-12 15:15,561,436,125,41093,24716,16377,29380593.0,17632620.0,11747973.0,533,411,122,40235,24008,16227,28772457.0,17127323.0,11645133.0,0.7134,0.7173,0.7134,0.7176
2023-10-12 15:20,1585,978,607,147310,77071,70239,105475680.0,55024807.0,50450872.0,1536,937,599,144324,74377,69947,103326205.0,53082243.0,50243962.0,0.7139,0.7183,0.7137,0.7183
2023-10-12 15:25,405,326,79,25425,17562,7863,18229800.0,12613607.0,5616193.0,373,298,75,22288,16739,5549,15912700.0,11937281.0,3975418.0,0.7182,0.7143,0.7131,0.7164
2023-10-12 15:30,1002,580,422,89447,51139,38308,64103135.0,36572231.0,27530903.0,965,560,405,89165,48684,40481,63877942.0,34794668.0,29083274.0,0.7152,0.7187,0.7147,0.7184
2023-10-12 15:35,2568,1383,1185,222128,130742,91386,159121176.0,93433959.0,65687217.0,2545,1384,1161,221723,131659,90064,158835336.0,94092824.0,64742512.0,0.7146,0.7188,0.7147,0.7189
2023-10-12 15:40,1802,1334,468,144583,104071,40512,103434852.0,74344526.0,29090325.0,1789,1326,463,143791,103772,40019,102871917.0,74132250.0,28739666.0,0.7144,0.7181,0.7144,0.7182
2023-10-12 15:45,680,408,272,51438,29193,22245,36809862.0,20850255.0,15959607.0,646,383,263,48942,27271,21671,35028704.0,19478510.0,15550193.0,0.7142,0.7174,0.7143,0.7176
2023-10-12 15:50,202,114,88,14317,6273,8044,10262226.0,4481283.0,5780943.0,179,96,83,13890,5805,8085,9962382.0,4147233.0,5815149.0,0.7144,0.7187,0.7144,0.7193
2023-10-12 15:55,797,509,288,51291,29999,21292,36727810.0,21439198.0,15288612.0,806,517,289,50625,29491,21134,36249986.0,21076402.0,15173584.0,0.7147,0.718,0.7147,0.718
2023-10-12 16:00,885,491,394,62734,39677,23057,45000092.0,28425140.0,16574951.0,856,479,377,61294,38922,22372,43920654.0,27837959.0,16082695.0,0.7164,0.7189,0.7152,0.7189
2023-10-12 16:05,335,289,46,21245,16463,4782,15215461.0,11778302.0,3437159.0,331,287,44,21335,16545,4790,15282143.0,11837633.0,3444510.0,0.7154,0.7188,0.7155,0.7191
2023-10-12 16:10,467,286,181,34393,22499,11894,24647768.0,16095436.0,8552332.0,470,288,182,34950,22374,12576,25049421.0,16004618.0,9044802.0,0.7154,0.719,0.7153,0.7192
2023-10-12 16:15,366,115,251,23931,12091,11840,17160259.0,8647151.0,8513108.0,344,106,238,22876,11835,11041,16401575.0,8462987.0,7938588.0,0.7152,0.719,0.7151,0.719
2023-10-12 16:20,556,506,50,29150,25054,4096,20875403.0,17930264.0,2945139.0,566,510,56,28838,25035,3803,20652014.0,17915729.0,2736284.0,0.7157,0.719,0.7156,0.7195
2023-10-12 16:25,211,127,84,18326,8137,10189,13198568.0,5840478.0,7358089.0,199,117,82,18319,8015,10304,13174062.0,5732994.0,7441068.0,0.7178,0.7222,0.7153,0.7222
2023-10-12 16:30,143,88,55,9551,5199,4352,6861813.0,3718816.0,3142997.0,135,79,56,10139,5253,4886,7285129.0,3756049.0,3529080.0,0.7153,0.7222,0.715,0.7223
2023-10-12 16:35,187,118,69,17178,9756,7422,12325315.0,6976576.0,5348738.0,176,113,63,15387,8430,6957,11040275.0,6029624.0,5010650.0,0.7151,0.7207,0.7153,0.7202
2023-10-12 16:40,173,95,78,15223,7045,8178,10928050.0,5038970.0,5889079.0,147,78,69,14323,7102,7221,10284701.0,5079025.0,5205675.0,0.7153,0.7201,0.7152,0.7209
2023-10-12 16:45,135,81,54,10542,5102,5440,7542719.0,3649806.0,3892912.0,132,77,55,11052,5024,6028,7936072.0,3592185.0,4343886.0,0.7154,0.7156,0.715,0.7206
2023-10-12 16:50,471,344,127,32743,14645,18098,23528507.0,10487010.0,13041497.0,464,340,124,32351,14794,17557,23242898.0,10591855.0,12651043.0,0.7161,0.7206,0.716,0.7206
2023-10-12 16:55,204,112,92,15982,4810,11172,11489214.0,3442122.0,8047091.0,196,108,88,15512,4885,10627,11155715.0,3495540.0,7660175.0,0.7156,0.7203,0.7156,0.7208
2023-10-12 17:00,77,54,23,5641,3250,2391,4049332.0,2324513.0,1724818.0,71,51,20,5799,3251,2548,4162002.0,2324750.0,1837252.0,0.7152,0.7214,0.7151,0.7211
2023-10-12 17:05,268,99,169,13163,3703,9460,9428256.0,2647628.0,6780628.0,254,88,166,12166,3235,8931,8729268.0,2314079.0,6415189.0,0.715,0.7168,0.7153,0.7183
2023-10-12 17:10,133,37,96,13254,1792,11462,9523423.0,1278199.0,8245223.0,117,27,90,13220,1670,11550,9511374.0,1192396.0,8318978.0,0.7133,0.7194,0.714,0.7203
2023-10-12 17:15,258,97,161,18343,5091,13252,13166561.0,3632200.0,9534361.0,244,85,159,17853,4359,13494,12823313.0,3112004.0,9711309.0,0.7135,0.7195,0.7139,0.7197
2023-10-12 17:20,165,64,101,12872,2807,10065,9240851.0,2002828.0,7238023.0,157,59,98,12426,2608,9818,8924564.0,1862641.0,7061923.0,0.7135,0.7191,0.7142,0.7193
2023-10-12 17:25,78,46,32,4513,2506,2007,3228305.0,1788590.0,1439715.0,66,39,27,4372,2423,1949,3127410.0,1727038.0,1400371.0,0.7137,0.7173,0.7128,0.7185
2023-10-12 17:30,88,32,56,7674,1860,5814,5403309.0,1326210.0,4077099.0,75,27,48,6463,1951,4512,4634300.0,1389498.0,3244802.0,0.713,0.7013,0.7122,0.7191
2023-10-12 17:35,224,70,154,15888,3387,12501,11444610.0,2458164.0,8986446.0,197,51,146,14360,2631,11729,10324699.0,1874253.0,8450445.0,0.7258,0.7189,0.7124,0.7205
2023-10-12 17:40,224,98,126,13968,4008,9960,10025851.0,2858941.0,7166909.0,211,87,124,14591,4487,10104,10452002.0,3180270.0,7271731.0,0.7133,0.7196,0.7088,0.7197
2023-10-12 17:45,62,44,18,3218,1456,1762,2306583.0,1040819.0,1265763.0,51,34,17,3059,1254,1805,2193148.0,894421.0,1298726.0,0.7148,0.7184,0.7133,0.7195
2023-10-12 17:50,538,406,132,29784,16870,12914,21298507.0,12036284.0,9262222.0,513,388,125,27636,16311,11325,19772600.0,11640197.0,8132402.0,0.7135,0.7172,0.7136,0.7181
2023-10-12 17:55,460,315,145,27984,12468,15516,20031756.0,8876768.0,11154987.0,442,302,140,27364,11874,15490,19582967.0,8442330.0,11140636.0,0.712,0.7189,0.711,0.7192
2023-10-12 18:00,426,240,186,24804,10095,14709,17773739.0,7196079.0,10577660.0,404,223,181,22397,9389,13008,16049603.0,6690783.0,9358819.0,0.7128,0.7191,0.7126,0.7195
2023-10-12 18:05,268,157,111,14099,5001,9098,10105525.0,3565201.0,6540324.0,247,140,107,13076,4362,8714,9375560.0,3109241.0,6266319.0,0.7129,0.7189,0.7128,0.7191
2023-10-12 18:10,106,60,46,6033,2208,3825,4313337.0,1572656.0,2740680.0,78,41,37,4650,1863,2787,3329654.0,1326823.0,2002831.0,0.7123,0.7165,0.7122,0.7186
2023-10-12 18:15,667,122,545,31771,6983,24788,22700568.0,4970863.0,17729705.0,637,94,543,31025,5694,25331,22174763.0,4051920.0,18122843.0,0.7119,0.7153,0.7116,0.7154
2023-10-12 18:20,590,343,247,35750,14301,21449,25555457.0,10189847.0,15365609.0,572,329,243,35468,14565,20903,25348349.0,10364342.0,14984007.0,0.7125,0.7164,0.7116,0.7168
2023-10-12 18:25,660,403,257,40353,19737,20616,28870990.0,14090677.0,14780313.0,622,385,237,37783,18307,19476,27005140.0,13041654.0,13963485.0,0.7139,0.7169,0.7124,0.717
2023-10-12 18:30,658,484,174,31428,17372,14056,22477172.0,12407914.0,10069258.0,640,472,168,30313,16976,13337,21662035.0,12106324.0,9555710.0,0.7142,0.7164,0.7131,0.7165
2023-10-12 18:35,336,235,101,24858,14398,10460,17791528.0,10301747.0,7489781.0,331,229,102,25540,14893,10647,18239187.0,10608062.0,7631125.0,0.7155,0.716,0.7123,0.7167
2023-10-13 10:00,4497,2466,2031,414781,277574,137207,298823598.0,199256074.0,99567523.0,4019,2224,1795,381020,258935,122085,273511226.0,185540526.0,87970700.0,0.7178,0.7257,0.7166,0.7206
2023-10-13 10:05,1118,668,450,55965,32065,23900,40148972.0,22948465.0,17200507.0,953,589,364,52326,29710,22616,37617488.0,21316626.0,16300862.0,0.7157,0.7197,0.7175,0.7208
2023-10-13 10:10,480,216,264,35791,15789,20002,25727921.0,11313784.0,14414136.0,417,186,231,34604,15472,19132,24867576.0,11070444.0,13797132.0,0.7166,0.7206,0.7155,0.7212
2023-10-13 10:15,1357,601,756,79790,40549,39241,57237636.0,29089273.0,28148362.0,1270,558,712,71654,36112,35542,51476788.0,25884639.0,25592148.0,0.7174,0.7173,0.7168,0.7201
2023-10-13 10:20,1359,679,680,85547,52565,32982,61098757.0,37701797.0,23396960.0,1253,611,642,78262,49704,28558,56209877.0,35639618.0,20570259.0,0.7172,0.7094,0.717,0.7203
2023-10-13 10:25,906,674,232,62631,49577,13054,44737844.0,35493111.0,9244732.0,860,635,225,60134,48502,11632,43079382.0,34713652.0,8365729.0,0.7159,0.7082,0.7157,0.7192
2023-10-13 10:30,399,183,216,23795,9112,14683,17049695.0,6481801.0,10567893.0,364,159,205,21509,7246,14263,15455551.0,5187738.0,10267813.0,0.7113,0.7197,0.7159,0.7199
2023-10-13 10:35,554,356,198,37477,22210,15267,26872918.0,15897793.0,10975124.0,504,328,176,34048,20568,13480,24415518.0,14704415.0,9711103.0,0.7158,0.7189,0.7149,0.7204
2023-10-13 10:40,149,74,75,8999,4219,4780,6466210.0,3023609.0,3442601.0,128,63,65,8552,4742,3810,6146830.0,3393489.0,2753341.0,0.7167,0.7202,0.7156,0.7227
2023-10-13 10:45,582,200,382,37369,12758,24611,26840081.0,9122839.0,17717242.0,554,185,369,34974,11411,23563,25116063.0,8152814.0,16963248.0,0.7151,0.7199,0.7145,0.7199
2023-10-13 10:50,352,179,173,27972,15690,12282,20083019.0,11240703.0,8842316.0,296,150,146,26441,14702,11739,18962300.0,10509294.0,8453006.0,0.7164,0.7199,0.7148,0.7201
2023-10-13 10:55,1627,810,817,141380,87256,54124,100961928.0,62308474.0,38653454.0,1521,753,768,133833,83104,50729,95778153.0,59323677.0,36454476.0,0.7141,0.7142,0.7138,0.7186
2023-10-13 11:00,1278,586,692,79797,41412,38385,57199758.0,29629246.0,27570512.0,1252,583,669,79346,41678,37668,56863097.0,29807218.0,27055879.0,0.7155,0.7183,0.7152,0.7183
2023-10-13 11:05,1152,735,417,92819,60829,31990,66496011.0,43506758.0,22989252.0,1128,717,411,91695,60204,31491,65682956.0,43056164.0,22626792.0,0.7152,0.7186,0.7152,0.7185
2023-10-13 11:10,574,320,254,33648,18826,14822,24179645.0,13490065.0,10689579.0,556,312,244,32435,18564,13871,23252559.0,13280410.0,9972148.0,0.7166,0.7212,0.7154,0.7189
2023-10-13 11:15,148,64,84,10327,4450,5877,7416914.0,3187974.0,4228940.0,106,46,60,7282,2720,4562,5256796.0,1945239.0,3311557.0,0.7164,0.7196,0.7152,0.7259
2023-10-13 11:20,254,122,132,21933,11562,10371,15755739.0,8299134.0,7456604.0,218,101,117,19173,9368,9805,13758264.0,6705055.0,7053209.0,0.7178,0.719,0.7157,0.7193
2023-10-13 11:25,282,239,43,14696,8452,6244,10615824.0,6064897.0,4550926.0,258,228,30,12351,8651,3700,8865869.0,6203146.0,2662723.0,0.7176,0.7288,0.717,0.7197
2023-10-13 11:30,215,127,88,17714,8381,9333,12731631.0,6027217.0,6704414.0,165,102,63,13059,4845,8214,9400197.0,3472631.0,5927566.0,0.7192,0.7184,0.7167,0.7216
2023-10-13 11:35,579,357,222,40857,22940,17917,29398629.0,16489468.0,12909160.0,554,361,193,41630,25462,16168,29962163.0,18294003.0,11668160.0,0.7188,0.7205,0.7185,0.7217
2023-10-13 11:40,790,519,271,48673,27244,21429,35134164.0,19658999.0,15475165.0,751,494,257,46725,23800,22925,33660877.0,17057827.0,16603050.0,0.7216,0.7222,0.7167,0.7242
2023-10-13 11:45,515,348,167,49829,32784,17045,36095302.0,23755302.0,12340000.0,453,318,135,46651,31137,15514,33650056.0,22419510.0,11230546.0,0.7246,0.724,0.72,0.7239
2023-10-13 11:50,83,54,29,7874,7404,470,5374167.0,5064350.0,309817.0,56,37,19,3300,3151,149,2372099.0,2263794.0,108305.0,0.684,0.6592,0.7184,0.7269
2023-10-13 11:55,154,71,83,10544,5953,4591,7602826.0,4289686.0,3313140.0,126,61,65,9622,6268,3354,6937294.0,4508993.0,2428301.0,0.7206,0.7217,0.7194,0.724
2023-10-13 12:00,155,91,64,6517,4355,2162,4703362.0,3137314.0,1566048.0,132,82,50,5323,3602,1721,3838043.0,2593001.0,1245041.0,0.7204,0.7244,0.7199,0.7234
2023-10-13 12:05,622,292,330,44275,28352,15923,31675928.0,20323580.0,11352347.0,581,279,302,47023,32860,14163,33521119.0,23306799.0,10214319.0,0.7168,0.713,0.7093,0.7212
2023-10-13 12:10,895,528,367,43888,28534,15354,31388552.0,20441098.0,10947453.0,871,510,361,41914,27894,14020,30068935.0,19971289.0,10097646.0,0.7164,0.713,0.716,0.7202
2023-10-13 12:15,831,352,479,60670,40772,19898,43552941.0,29236723.0,14316217.0,771,309,462,56641,38009,18632,40649289.0,27239305.0,13409984.0,0.7171,0.7195,0.7167,0.7197
2023-10-13 12:20,1621,776,845,125261,87703,37558,89813149.0,62805123.0,27008025.0,1573,744,829,123701,87234,36467,88700730.0,62473325.0,26227405.0,0.7161,0.7191,0.7162,0.7192
2023-10-13 12:25,317,165,152,30008,19934,10074,21535782.0,14291558.0,7244224.0,289,147,142,28878,19398,9480,20720350.0,13893293.0,6827057.0,0.7169,0.7191,0.7162,0.7202
2023-10-13 12:30,567,375,192,43563,32828,10735,32383015.0,24718588.0,7664427.0,543,359,184,41962,31684,10278,31330119.0,23933179.0,7396940.0,0.753,0.714,0.7554,0.7197
2023-10-13 12:35,237,132,105,26540,18173,8367,19042161.0,13012520.0,6029641.0,218,119,99,26617,18636,7981,19093088.0,13342688.0,5750399.0,0.716,0.7206,0.716,0.7205
2023-10-13 12:40,433,163,270,28602,17526,11076,20524862.0,12560179.0,7964682.0,423,158,265,27856,17322,10534,19983992.0,12406291.0,7577701.0,0.7167,0.7191,0.7162,0.7194
2023-10-13 12:45,779,364,415,48369,30330,18039,34669160.0,21705556.0,12963604.0,755,352,403,47872,29866,18006,34319680.0,21376675.0,12943005.0,0.7156,0.7186,0.7158,0.7188
2023-10-13 12:50,192,88,104,12951,8087,4864,9258632.0,5764750.0,3493882.0,167,73,94,11843,7464,4379,8486685.0,5340580.0,3146104.0,0.7128,0.7183,0.7155,0.7185
2023-10-13 12:55,740,549,191,64378,48029,16349,46254014.0,34499955.0,11754058.0,723,538,185,61832,46173,15659,44317162.0,33058850.0,11258312.0,0.7183,0.7189,0.716,0.719
2023-10-13 13:00,277,153,124,21305,11508,9797,15272700.0,8240613.0,7032086.0,255,141,114,19634,10958,8676,14081628.0,7844720.0,6236908.0,0.7161,0.7178,0.7159,0.7189
2023-10-13 13:05,256,115,141,22218,10627,11591,15933719.0,7605963.0,8327756.0,230,99,131,21806,10374,11432,15639831.0,7423625.0,8216206.0,0.7157,0.7185,0.7156,0.7187
2023-10-13 13:10,326,272,54,14872,11542,3330,10668367.0,8269248.0,2399119.0,316,266,50,14434,11145,3289,10349589.0,7983523.0,2366065.0,0.7164,0.7205,0.7163,0.7194
2023-10-13 13:15,402,115,287,22961,11787,11174,16474286.0,8443252.0,8031033.0,388,110,278,23214,11883,11331,16652500.0,8509851.0,8142648.0,0.7163,0.7187,0.7161,0.7186
2023-10-13 13:20,574,161,413,27636,10200,17436,19792925.0,7298255.0,12494670.0,552,142,410,26201,9054,17147,18806502.0,6478463.0,12328039.0,0.7155,0.7166,0.7155,0.719
2023-10-13 13:25,120,43,77,6858,3143,3715,4920865.0,2251226.0,2669638.0,115,42,73,7041,3353,3688,5053762.0,2400126.0,2653636.0,0.7163,0.7186,0.7158,0.7195
2023-10-13 13:30,508,378,130,60255,41555,18700,44206530.0,29783026.0,14423504.0,493,366,127,47171,41438,5733,33829177.0,29698761.0,4130416.0,0.7167,0.7713,0.7167,0.7205
2023-10-13 13:35,402,340,62,20758,16183,4575,14927972.0,11635956.0,3292015.0,392,335,57,20155,16093,4062,14462221.0,11538769.0,2923451.0,0.719,0.7196,0.717,0.7197
2023-10-13 13:40,689,517,172,51430,37301,14129,36772633.0,26744066.0,10028566.0,666,510,156,49087,36660,12427,35223969.0,26284900.0,8939069.0,0.717,0.7098,0.717,0.7193
2023-10-13 13:45,727,200,527,35037,7350,27687,25163401.0,5266749.0,19896651.0,720,194,526,35000,7517,27483,25139951.0,5386146.0,19753804.0,0.7166,0.7186,0.7165,0.7188
2023-10-13 13:50,132,83,49,8305,3895,4410,5959630.0,2789765.0,3169864.0,116,72,44,8217,3494,4723,5902100.0,2502127.0,3399973.0,0.7162,0.7188,0.7161,0.7199
2023-10-13 13:55,109,72,37,6311,4037,2274,4495013.0,2884505.0,1610507.0,85,55,30,5301,3600,1701,3800718.0,2577079.0,1223639.0,0.7145,0.7082,0.7159,0.7194
2023-10-13 14:00,141,53,88,10987,4878,6109,7876617.0,3488601.0,4388015.0,126,41,85,9040,3555,5485,6484388.0,2543139.0,3941248.0,0.7152,0.7183,0.7154,0.7186
2023-10-13 14:05,140,70,70,9526,5642,3884,6793234.0,4037649.0,2755585.0,122,60,62,8550,5693,2857,6126613.0,4073459.0,2053154.0,0.7156,0.7095,0.7155,0.7186
2023-10-13 14:10,129,61,68,9136,3666,5470,6534360.0,2630881.0,3903479.0,110,51,59,6670,3107,3563,4779456.0,2219852.0,2559604.0,0.7176,0.7136,0.7145,0.7184
2023-10-13 14:15,496,36,460,16040,1135,14905,11501989.0,818679.0,10683310.0,491,26,465,30407,1083,29324,22794027.0,773432.0,22020595.0,0.7213,0.7168,0.7142,0.7509
2023-10-13 14:20,136,43,93,12208,4883,7325,8516130.0,3241768.0,5274362.0,121,36,85,8790,1956,6834,6320276.0,1396046.0,4924229.0,0.6639,0.72,0.7137,0.7205
2023-10-13 14:25,718,322,396,36807,15036,21771,26334270.0,10742338.0,15591931.0,692,304,388,34117,12060,22057,24423177.0,8612786.0,15810391.0,0.7144,0.7162,0.7142,0.7168
2023-10-13 14:30,788,583,205,34449,23304,11145,24687727.0,16681129.0,8006598.0,766,571,195,32478,21952,10526,23270150.0,15709632.0,7560517.0,0.7158,0.7184,0.7156,0.7183
2023-10-13 14:35,753,520,233,59052,44743,14309,42308107.0,32031788.0,10276318.0,733,511,222,58143,44035,14108,41651219.0,31516570.0,10134649.0,0.7159,0.7182,0.7157,0.7184
2023-10-13 14:40,1183,910,273,90308,74579,15729,64743263.0,53437862.0,11305401.0,1172,909,263,89915,75067,14848,64428094.0,53752290.0,10675804.0,0.7165,0.7188,0.7161,0.719
2023-10-13 14:45,1050,351,699,85246,31174,54072,61151098.0,22326941.0,38824157.0,1039,343,696,84867,30987,53880,60896754.0,22183348.0,38713405.0,0.7162,0.718,0.7159,0.7185
2023-10-13 14:50,532,269,263,50267,23883,26384,36054594.0,17098649.0,18955945.0,526,269,257,49772,23705,26067,35699446.0,16971154.0,18728292.0,0.7159,0.7185,0.7159,0.7185
2023-10-13 14:55,555,257,298,53819,22104,31715,38598953.0,15820299.0,22778654.0,545,249,296,53047,21527,31520,38047411.0,15407731.0,22639679.0,0.7157,0.7182,0.7157,0.7183
2023-10-13 15:00,644,398,246,69116,37601,31515,49556330.0,26916241.0,22640088.0,627,385,242,68313,36507,31806,48984326.0,26132054.0,22852272.0,0.7158,0.7184,0.7158,0.7185
2023-10-13 15:05,248,105,143,16130,4459,11671,11578219.0,3195211.0,8383007.0,236,100,136,16487,5438,11049,11829945.0,3890162.0,7939783.0,0.7166,0.7183,0.7154,0.7186
2023-10-13 15:10,1102,535,567,118237,49341,68896,84863200.0,35336271.0,49526929.0,1079,520,559,117801,49008,68793,84538490.0,35082876.0,49455614.0,0.7162,0.7189,0.7159,0.7189
2023-10-13 15:15,202,79,123,25984,8513,17471,18660715.0,6091284.0,12569431.0,201,77,124,26340,8544,17796,18920062.0,6113217.0,12806844.0,0.7155,0.7194,0.7155,0.7196
2023-10-13 15:20,97,48,49,7595,3449,4146,5448974.0,2465174.0,2983799.0,84,40,44,7349,3442,3907,5273404.0,2461901.0,2811502.0,0.7148,0.7197,0.7153,0.7196
2023-10-13 15:25,834,329,505,52999,22915,30084,38028485.0,16409982.0,21618502.0,822,319,503,52879,22936,29943,37939756.0,16422109.0,21517647.0,0.7161,0.7186,0.716,0.7186
2023-10-13 15:30,623,204,419,45512,24498,21014,32636789.0,17536568.0,15100221.0,605,197,408,44895,24170,20725,32192884.0,17300393.0,14892490.0,0.7158,0.7186,0.7158,0.7186
2023-10-13 15:35,578,230,348,33518,20542,12976,24032225.0,14707005.0,9325220.0,571,221,350,33988,20800,13188,24367666.0,14888735.0,9478931.0,0.7159,0.7187,0.7158,0.7188
2023-10-13 15:40,437,264,173,29846,19767,10079,21401955.0,14154541.0,7247414.0,430,262,168,28922,19718,9204,20733800.0,14117339.0,6616461.0,0.7161,0.7191,0.716,0.7189
2023-10-13 15:45,467,93,374,65763,10404,55359,47269747.0,7475218.0,39794528.0,436,78,358,64738,10039,54699,46516203.0,7186540.0,39329662.0,0.7185,0.7188,0.7159,0.719
2023-10-13 15:50,562,430,132,35711,26187,9524,25604940.0,18756339.0,6848600.0,552,424,128,35746,25991,9755,25627656.0,18613770.0,7013886.0,0.7162,0.7191,0.7162,0.719
2023-10-13 15:55,438,250,188,46212,31204,15008,33105348.0,22350011.0,10755336.0,425,230,195,45615,31264,14351,32678552.0,22347829.0,10330723.0,0.7163,0.7166,0.7148,0.7199
2023-10-13 16:00,517,266,251,44167,22461,21706,31695955.0,16084357.0,15611598.0,493,250,243,46943,25044,21899,33431792.0,17684601.0,15747190.0,0.7161,0.7192,0.7061,0.7191
2023-10-13 16:05,686,360,326,54196,25171,29025,38866128.0,18024052.0,20842075.0,664,345,319,52200,23643,28557,37452692.0,16926526.0,20526165.0,0.7161,0.7181,0.7159,0.7188
2023-10-13 16:10,654,415,239,37976,21344,16632,27239248.0,15300465.0,11938782.0,645,400,245,38028,21742,16286,27267392.0,15567124.0,11700268.0,0.7169,0.7178,0.716,0.7184
2023-10-13 16:15,390,285,105,14730,11255,3475,10550939.0,8055410.0,2495528.0,379,278,101,14052,10575,3477,11269968.0,8772705.0,2497263.0,0.7157,0.7181,0.8296,0.7182
2023-10-13 16:20,996,327,669,76944,36952,39992,55157240.0,26449747.0,28707492.0,977,318,659,76708,36868,39840,54994041.0,26388160.0,28605881.0,0.7158,0.7178,0.7157,0.718
2023-10-13 16:25,1094,424,670,59290,19993,39297,42115259.0,14275011.0,27840248.0,1069,408,661,55134,18947,36187,39505010.0,13531331.0,25973678.0,0.714,0.7085,0.7142,0.7178
2023-10-13 16:30,665,269,396,46711,15923,30788,33485781.0,11408444.0,22077337.0,637,261,376,44105,15411,28694,31584970.0,11002983.0,20581987.0,0.7165,0.7171,0.714,0.7173
2023-10-13 16:35,1338,680,658,76802,35287,41515,54984358.0,25232956.0,29751402.0,1331,672,659,76343,35147,41196,54674037.0,25130508.0,29543529.0,0.7151,0.7166,0.715,0.7171
2023-10-13 16:40,681,399,282,32040,19446,12594,22925231.0,13893406.0,9031825.0,672,392,280,31044,19085,11959,22214794.0,13638219.0,8576575.0,0.7145,0.7172,0.7146,0.7172
2023-10-13 16:45,1008,183,825,37367,15289,22078,26744319.0,10931782.0,15812537.0,999,176,823,37365,15225,22140,26755696.0,10882152.0,15873544.0,0.715,0.7162,0.7148,0.717
2023-10-13 16:50,760,661,99,26052,20866,5186,18652210.0,14924008.0,3728202.0,755,660,95,25770,21056,4714,18444854.0,15055453.0,3389401.0,0.7152,0.7189,0.715,0.719
2023-10-13 16:55,475,316,159,23941,17260,6681,17137010.0,12340515.0,4796494.0,462,308,154,23847,17239,6608,17068734.0,12324053.0,4744681.0,0.715,0.7179,0.7149,0.718
2023-10-13 17:00,128,98,30,8790,6444,2346,6298162.0,4612113.0,1686048.0,118,94,24,8826,6536,2290,6317780.0,4671753.0,1646027.0,0.7157,0.7187,0.7148,0.7188
2023-10-13 17:05,95,64,31,8739,7214,1525,6252470.0,5157844.0,1094626.0,87,61,26,8479,7083,1396,6066531.0,5063769.0,1002762.0,0.715,0.7178,0.7149,0.7183
2023-10-13 17:10,103,74,29,7967,4220,3747,5744355.0,3041408.0,2702946.0,92,68,24,5414,3822,1592,3877712.0,2732391.0,1145321.0,0.7207,0.7214,0.7149,0.7194
2023-10-13 17:15,360,333,27,20078,18794,1284,14377901.0,13455396.0,922505.0,362,330,32,20103,18852,1251,14383261.0,13484082.0,899179.0,0.7159,0.7185,0.7153,0.7188
2023-10-13 17:20,342,81,261,17143,5543,11600,12290193.0,3962557.0,8327636.0,331,75,256,17168,5621,11547,12310512.0,4017737.0,8292775.0,0.7149,0.7179,0.7148,0.7182
2023-10-13 17:25,199,137,62,13856,10533,3323,9891815.0,7530320.0,2361494.0,176,122,54,12932,9961,2971,9257621.0,7121439.0,2136181.0,0.7149,0.7107,0.7149,0.719
2023-10-13 17:30,90,43,47,7695,5161,2534,5510996.0,3690059.0,1820936.0,88,41,47,8027,5387,2640,5749068.0,3851346.0,1897722.0,0.715,0.7186,0.7149,0.7188
2023-10-13 17:35,180,131,49,21829,18222,3607,15610312.0,13025943.0,2584368.0,175,128,47,21762,18297,3465,15566746.0,13079321.0,2487425.0,0.7148,0.7165,0.7148,0.7179
2023-10-13 17:40,210,104,106,15665,9839,5826,11216688.0,7033170.0,4183517.0,198,98,100,15029,9196,5833,10762922.0,6572534.0,4190387.0,0.7148,0.7181,0.7147,0.7184
2023-10-13 17:45,41,14,27,3708,1229,2479,2655732.0,878260.0,1777471.0,34,12,22,3587,1209,2378,2572161.0,863940.0,1708221.0,0.7146,0.717,0.7146,0.7183
2023-10-13 17:50,117,65,52,7318,2594,4724,5248385.0,1855950.0,3392434.0,114,65,49,6889,2479,4410,4945486.0,1773729.0,3171756.0,0.7155,0.7181,0.7155,0.7192
2023-10-13 17:55,172,93,79,13304,5005,8299,9552451.0,3589749.0,5962702.0,158,82,76,13386,4766,8620,9601953.0,3408479.0,6193473.0,0.7172,0.7185,0.7152,0.7185
2023-10-13 18:00,395,306,89,25094,13121,11973,17977176.0,9380911.0,8596264.0,392,304,88,25831,14105,11726,18482377.0,10058123.0,8424254.0,0.715,0.718,0.7131,0.7184
2023-10-13 18:05,235,157,78,20662,8056,12606,14805423.0,5758004.0,9047419.0,225,152,73,20247,8106,12141,14507198.0,5792583.0,8714615.0,0.7147,0.7177,0.7146,0.7178
2023-10-13 18:10,92,67,25,6795,3440,3355,4872527.0,2460781.0,2411745.0,80,59,21,6684,3382,3302,4790147.0,2415874.0,2374272.0,0.7153,0.7189,0.7143,0.719
2023-10-13 18:15,152,105,47,14042,6488,7554,10084582.0,4658729.0,5425853.0,146,101,45,13410,6001,7409,9609290.0,4286556.0,5322734.0,0.7181,0.7183,0.7143,0.7184
2023-10-13 18:20,577,251,326,60185,13866,46319,43200472.0,9956155.0,33244317.0,567,239,328,61258,13796,47462,43932329.0,9857563.0,34074765.0,0.718,0.7177,0.7145,0.7179
2023-10-13 18:25,460,230,230,47848,13878,33970,34299985.0,9915764.0,24384221.0,434,211,223,46955,13663,33292,33663035.0,9761272.0,23901763.0,0.7145,0.7178,0.7144,0.7179
2023-10-13 18:30,71,44,27,5743,2482,3261,4104932.0,1770744.0,2334188.0,63,43,20,3024,2358,666,2160161.0,1681644.0,478516.0,0.7134,0.7158,0.7132,0.7185
2023-10-13 18:35,534,477,57,22737,21061,1676,16236368.0,15050757.0,1185611.0,513,466,47,22154,20789,1365,15840556.0,14853906.0,986649.0,0.7146,0.7074,0.7145,0.7228
2023-10-16 10:00,4689,2324,2365,438358,190163,248195,315840718.0,135778479.0,180062239.0,4305,2160,2145,409243,176352,232891,295024032.0,126529576.0,168494455.0,0.714,0.7255,0.7175,0.7235
2023-10-16 10:05,845,481,364,62907,35536,27371,45180260.0,25450324.0,19729935.0,744,434,310,58523,32336,26187,42091866.0,23196385.0,18895481.0,0.7162,0.7208,0.7174,0.7216
2023-10-16 10:10,2233,1127,1106,186493,93753,92740,133517612.0,67135505.0,66382106.0,2054,1020,1034,177071,88573,88498,127049952.0,63397483.0,63652469.0,0.7161,0.7158,0.7158,0.7193
2023-10-16 10:15,508,288,220,39247,24118,15129,28085582.0,17217704.0,10867878.0,450,251,199,34641,20558,14083,24856205.0,14728237.0,10127968.0,0.7139,0.7183,0.7164,0.7192
2023-10-16 10:20,227,117,110,16156,8005,8151,11963087.0,5950632.0,6012455.0,185,96,89,14429,6752,7677,10367303.0,4839091.0,5528212.0,0.7434,0.7376,0.7167,0.7201
2023-10-16 10:25,1244,630,614,83201,42584,40617,60072789.0,30747578.0,29325210.0,1187,603,584,79990,40896,39094,57582260.0,29384868.0,28197391.0,0.722,0.722,0.7185,0.7213
2023-10-16 10:30,206,96,110,13204,6238,6966,9555045.0,4491556.0,5063489.0,173,81,92,11194,4799,6395,8065741.0,3442518.0,4623223.0,0.72,0.7269,0.7173,0.7229
2023-10-16 10:35,624,462,162,41601,31437,10164,30249901.0,22887191.0,7362710.0,579,442,137,35172,28290,6882,25348883.0,20368307.0,4980575.0,0.728,0.7244,0.72,0.7237
2023-10-16 10:40,774,538,236,37833,29094,8739,27320064.0,21000612.0,6319452.0,726,510,216,36323,28386,7937,26201618.0,20466309.0,5735309.0,0.7218,0.7231,0.721,0.7226
2023-10-16 10:45,1017,519,498,110577,75122,35455,80089911.0,54361885.0,25728026.0,831,422,409,84740,57048,27692,61314019.0,41190246.0,20123773.0,0.7236,0.7257,0.722,0.7267
2023-10-16 10:50,772,447,325,59563,36909,22654,43226587.0,26766745.0,16459842.0,674,386,288,63509,42423,21086,45953703.0,30624992.0,15328710.0,0.7252,0.7266,0.7219,0.727
2023-10-16 10:55,703,353,350,48403,30297,18106,35054999.0,21945111.0,13109888.0,547,267,280,40722,27325,13397,29463462.0,19742348.0,9721114.0,0.7243,0.7241,0.7225,0.7256
2023-10-16 11:00,1186,397,789,62819,29549,33270,45630678.0,21453748.0,24176930.0,1092,347,745,61754,29140,32614,44792948.0,21088018.0,23704929.0,0.726,0.7267,0.7237,0.7268
2023-10-16 11:05,569,286,283,26465,15072,11393,19230015.0,10961355.0,8268659.0,510,252,258,23896,13808,10088,17333490.0,9996838.0,7336651.0,0.7273,0.7258,0.724,0.7273
2023-10-16 11:10,1444,612,832,75745,37024,38721,55129209.0,26984251.0,28144957.0,1338,561,777,67554,32094,35460,49105581.0,23279545.0,25826035.0,0.7288,0.7269,0.7254,0.7283
2023-10-16 11:15,1120,264,856,64307,17550,46757,46565340.0,12710658.0,33854681.0,1043,229,814,61375,17003,44372,44598853.0,12311340.0,32287513.0,0.7243,0.7241,0.7241,0.7277
2023-10-16 11:20,867,386,481,45146,15678,29468,32835925.0,11398738.0,21437186.0,823,364,459,42327,13659,28668,30728092.0,9872671.0,20855421.0,0.7271,0.7275,0.7228,0.7275
2023-10-16 11:25,697,201,496,30136,6618,23518,21840440.0,4824221.0,17016219.0,656,190,466,29390,6713,22677,21366188.0,4864574.0,16501614.0,0.729,0.7235,0.7246,0.7277
2023-10-16 11:30,351,194,157,10399,4335,6064,7552139.0,3148240.0,4403899.0,311,175,136,9600,3719,5881,6969757.0,2694606.0,4275151.0,0.7262,0.7262,0.7246,0.7269
2023-10-16 11:35,1114,753,361,67864,45128,22736,49399499.0,32818621.0,16580877.0,963,692,271,54850,37704,17146,39899844.0,27367573.0,12532271.0,0.7272,0.7293,0.7259,0.7309
2023-10-16 11:40,757,426,331,44992,23369,21623,33056273.0,17224118.0,15832154.0,654,401,253,39655,20390,19265,28950596.0,14817305.0,14133290.0,0.737,0.7322,0.7267,0.7336
2023-10-16 11:45,1800,689,1111,88521,37820,50701,64594064.0,27542393.0,37051670.0,1702,655,1047,85896,37078,48818,62716268.0,26982921.0,35733346.0,0.7282,0.7308,0.7277,0.732
2023-10-16 11:50,639,211,428,30614,9840,20774,22357796.0,7152196.0,15205599.0,593,198,395,26276,9602,16674,19156275.0,6977397.0,12178878.0,0.7268,0.732,0.7267,0.7304
2023-10-16 11:55,732,327,405,26570,13687,12883,19364347.0,9963261.0,9401085.0,707,310,397,26089,13279,12810,19015648.0,9664790.0,9350858.0,0.7279,0.7297,0.7278,0.73
2023-10-16 12:00,1043,575,468,43413,20807,22606,31692508.0,15194725.0,16497783.0,1005,556,449,42356,20233,22123,30893256.0,14719813.0,16173442.0,0.7303,0.7298,0.7275,0.7311
2023-10-16 12:05,1088,263,825,57625,19186,38439,41245792.0,13916129.0,27329663.0,1013,215,798,47998,16287,31711,34943888.0,11807314.0,23136574.0,0.7253,0.711,0.725,0.7296
2023-10-16 12:10,842,661,181,37549,21220,16329,27374687.0,15448809.0,11925878.0,819,655,164,37196,21653,15543,27093736.0,15740297.0,11353439.0,0.728,0.7303,0.7269,0.7305
2023-10-16 12:15,850,479,371,83347,59505,23842,60731855.0,43311086.0,17420769.0,814,460,354,82393,59582,22811,60014920.0,43340374.0,16674546.0,0.7279,0.7307,0.7274,0.731
2023-10-16 12:20,1293,773,520,109570,83430,26140,80382312.0,61268606.0,19113706.0,1181,718,463,99500,75707,23793,72533784.0,55126584.0,17407200.0,0.7344,0.7312,0.7282,0.7316
2023-10-16 12:25,1485,715,770,106608,71770,34838,77988411.0,52598308.0,25390102.0,1347,653,694,91933,66336,25597,67198586.0,48401480.0,18797106.0,0.7329,0.7288,0.7296,0.7343
2023-10-16 12:30,1467,941,526,120356,88979,31377,88684490.0,65582655.0,23101835.0,1128,794,334,88345,67300,21045,64762497.0,49245492.0,15517005.0,0.7371,0.7363,0.7317,0.7373
2023-10-16 12:35,2062,933,1129,164314,96199,68115,120998921.0,71302643.0,49696278.0,1578,777,801,129203,79864,49339,95471760.0,58861042.0,36610717.0,0.7412,0.7296,0.737,0.742
2023-10-16 12:40,961,376,585,64274,26599,37675,47466038.0,19656059.0,27809979.0,843,309,534,58618,25896,32722,43302401.0,19080220.0,24222180.0,0.739,0.7382,0.7368,0.7402
2023-10-16 12:45,1218,429,789,110257,37345,72912,80943330.0,27448195.0,53495135.0,1072,359,713,90619,29335,61284,66815514.0,21527142.0,45288372.0,0.735,0.7337,0.7338,0.739
2023-10-16 12:50,557,135,422,31001,9549,21452,22868270.0,7040733.0,15827537.0,496,112,384,27900,6686,21214,20574202.0,4905764.0,15668438.0,0.7373,0.7378,0.7337,0.7386
2023-10-16 12:55,1188,421,767,97648,41308,56340,72272339.0,30596691.0,41675648.0,1081,376,705,89643,38525,51118,66248896.0,28376986.0,37871910.0,0.7407,0.7397,0.7366,0.7409
2023-10-16 13:00,669,328,341,72546,43036,29510,53957733.0,32139859.0,21817874.0,566,286,280,55317,32413,22904,40901522.0,23889165.0,17012357.0,0.7468,0.7393,0.737,0.7428
2023-10-16 13:05,877,454,423,87217,47129,40088,64268724.0,34874026.0,29394697.0,741,398,343,76266,43301,32965,56437880.0,31976841.0,24461038.0,0.74,0.7333,0.7385,0.742
2023-10-16 13:10,987,503,484,72738,40896,31842,53829778.0,30266481.0,23563297.0,910,464,446,65877,38547,27330,48691579.0,28441115.0,20250463.0,0.7401,0.74,0.7378,0.741
2023-10-16 13:15,789,456,333,49743,20371,29372,36555326.0,14980456.0,21574870.0,705,415,290,44835,17958,26877,33124668.0,13218470.0,19906197.0,0.7354,0.7345,0.7361,0.7406
2023-10-16 13:20,681,446,235,48025,28491,19534,35540879.0,21091716.0,14449162.0,634,416,218,47349,27724,19625,34939230.0,20423293.0,14515937.0,0.7403,0.7397,0.7367,0.7397
2023-10-16 13:25,719,463,256,33572,15438,18134,24552170.0,11367009.0,13185160.0,665,440,225,31317,15623,15694,23104723.0,11502092.0,11602631.0,0.7363,0.7271,0.7362,0.7393
2023-10-16 13:30,895,465,430,51785,23189,28596,38255440.0,17087928.0,21167511.0,849,442,407,46841,21218,25623,34589500.0,15632137.0,18957362.0,0.7369,0.7402,0.7367,0.7399
2023-10-16 13:35,978,324,654,88440,17888,70552,63944222.0,13099059.0,50845163.0,845,251,594,73420,12869,60551,54031348.0,9410768.0,44620579.0,0.7323,0.7207,0.7313,0.7369
2023-10-16 13:40,506,232,274,38449,20856,17593,28236769.0,15334630.0,12902139.0,438,192,246,34431,17633,16798,25248350.0,12881315.0,12367035.0,0.7353,0.7334,0.7305,0.7362
2023-10-16 13:45,706,261,445,50830,20281,30549,37361385.0,14898258.0,22463127.0,651,237,414,47621,17534,30087,35029508.0,12855583.0,22173925.0,0.7346,0.7353,0.7332,0.737
2023-10-16 13:50,870,341,529,62394,19551,42843,45918898.0,14363100.0,31555798.0,829,313,516,62367,19594,42773,45892253.0,14365835.0,31526417.0,0.7346,0.7365,0.7332,0.7371
2023-10-16 13:55,586,197,389,70505,15401,55104,52000387.0,11334588.0,40665799.0,548,180,368,68342,12514,55828,50398889.0,9183259.0,41215630.0,0.736,0.738,0.7338,0.7383
2023-10-16 14:00,1525,791,734,122020,67707,54313,90105911.0,50068143.0,40037768.0,1430,755,675,116278,64447,51831,85620096.0,47339496.0,38280599.0,0.7395,0.7372,0.7345,0.7386
2023-10-16 14:05,747,522,225,65603,52978,12625,48389376.0,38997790.0,9391586.0,700,504,196,62028,51318,10710,45757576.0,37743080.0,8014496.0,0.7361,0.7439,0.7355,0.7483
2023-10-16 14:10,569,339,230,61809,48715,13094,45489410.0,35807621.0,9681789.0,525,322,203,60614,48179,12435,44614193.0,35399074.0,9215119.0,0.735,0.7394,0.7347,0.7411
2023-10-16 14:15,1386,791,595,127082,88917,38165,93429648.0,65280417.0,28149231.0,1373,790,583,130494,93504,36990,95939435.0,68612331.0,27327104.0,0.7342,0.7376,0.7338,0.7388
2023-10-16 14:20,759,412,347,56295,32890,23405,41499529.0,24209878.0,17289651.0,712,389,323,51873,31465,20408,38187927.0,23122623.0,15065304.0,0.7361,0.7387,0.7349,0.7382
2023-10-16 14:25,1871,1000,871,140964,73568,67396,103714186.0,54059917.0,49654269.0,1829,971,858,139882,72604,67278,102992170.0,53344768.0,49647401.0,0.7348,0.7368,0.7347,0.7379
2023-10-16 14:30,1628,769,859,135411,68575,66836,99713238.0,50352454.0,49360784.0,1601,758,843,133433,67461,65972,98280303.0,49527309.0,48752994.0,0.7343,0.7385,0.7342,0.739
2023-10-16 14:35,1085,615,470,70499,40500,29999,51695761.0,29790782.0,21904979.0,1035,592,443,64674,36785,27889,47632527.0,27013257.0,20619269.0,0.7356,0.7302,0.7344,0.7393
2023-10-16 14:40,1100,492,608,83124,30208,52916,61060583.0,22150615.0,38909968.0,1054,468,586,81528,30810,50718,60020749.0,22588005.0,37432743.0,0.7333,0.7353,0.7331,0.7381
2023-10-16 14:45,795,430,365,63997,16781,47216,47126224.0,12305125.0,34821099.0,756,406,350,62124,15594,46530,45755195.0,11413048.0,34342147.0,0.7333,0.7375,0.7319,0.7381
2023-10-16 14:50,234,104,130,30242,7318,22924,22283135.0,5361394.0,16921741.0,222,95,127,29922,7100,22822,22054850.0,5195596.0,16859254.0,0.7326,0.7382,0.7318,0.7387
2023-10-16 14:55,602,253,349,48887,10922,37965,36056222.0,8040475.0,28015747.0,572,241,331,47395,9803,37592,34957500.0,7184372.0,27773127.0,0.7362,0.7379,0.7329,0.7388
2023-10-16 15:00,489,190,299,45447,13714,31733,33277931.0,10038142.0,23239789.0,409,143,266,36633,10912,25721,26887310.0,7962915.0,18924395.0,0.732,0.7324,0.7297,0.7358
2023-10-16 15:05,758,304,454,58565,24588,33977,43021274.0,18066216.0,24955057.0,733,288,445,61008,23109,37899,44741071.0,16917931.0,27823140.0,0.7348,0.7345,0.7321,0.7341
2023-10-16 15:10,576,348,228,58535,29169,29366,42900565.0,21401630.0,21498934.0,543,330,213,54484,27835,26649,40027764.0,20403251.0,19624512.0,0.7337,0.7321,0.733,0.7364
2023-10-16 15:15,1016,721,295,104438,61087,43351,76788408.0,44847808.0,31940599.0,956,681,275,92450,52092,40358,67917449.0,38163827.0,29753622.0,0.7342,0.7368,0.7326,0.7372
2023-10-16 15:20,1572,705,867,118065,37836,80229,86938593.0,27917899.0,59020694.0,1514,684,830,119524,41596,77928,87887967.0,30504537.0,57383429.0,0.7379,0.7357,0.7334,0.7364
2023-10-16 15:25,784,361,423,60662,22144,38518,44723303.0,16334112.0,28389190.0,760,346,414,59116,20625,38491,43524916.0,15153644.0,28371272.0,0.7376,0.737,0.7347,0.7371
2023-10-16 15:30,1106,664,442,87986,47182,40804,64753946.0,34633860.0,30120086.0,1080,651,429,86468,46285,40183,63638372.0,33972986.0,29665386.0,0.734,0.7382,0.734,0.7383
2023-10-16 15:35,580,341,239,43009,19628,23381,31611205.0,14427716.0,17183488.0,561,328,233,41904,19157,22747,30849215.0,14058952.0,16790262.0,0.7351,0.7349,0.7339,0.7381
2023-10-16 15:40,492,199,293,44993,17249,27744,32863180.0,12668856.0,20194324.0,462,180,282,42939,16601,26338,31586274.0,12178096.0,19408178.0,0.7345,0.7279,0.7336,0.7369
2023-10-16 15:45,2968,1709,1259,311055,208068,102987,228864490.0,152978710.0,75885780.0,2922,1691,1231,305456,204898,100558,224552675.0,150453733.0,74098942.0,0.7352,0.7368,0.7343,0.7369
2023-10-16 15:50,1961,861,1100,179294,114655,64639,132230296.0,84517271.0,47713024.0,1873,829,1044,174397,112272,62125,128302727.0,82438424.0,45864303.0,0.7371,0.7381,0.7343,0.7383
2023-10-16 15:55,886,434,452,73366,53038,20328,53774596.0,38881485.0,14893111.0,853,425,428,71773,52611,19162,52676351.0,38552204.0,14124146.0,0.7331,0.7326,0.7328,0.7371
2023-10-16 16:00,623,374,249,67002,51065,15937,49179670.0,37456116.0,11723554.0,596,359,237,64926,50627,14299,47661139.0,37129047.0,10532091.0,0.7335,0.7356,0.7334,0.7366
2023-10-16 16:05,1230,423,807,101617,55340,46277,74672799.0,40603603.0,34069196.0,1209,411,798,101144,54621,46523,74324167.0,40066059.0,34258107.0,0.7337,0.7362,0.7335,0.7364
2023-10-16 16:10,1438,500,938,101657,60893,40764,74677480.0,44679728.0,29997752.0,1418,492,926,100256,60112,40144,73658567.0,44109387.0,29549180.0,0.7337,0.7359,0.7338,0.7361
2023-10-16 16:15,80,53,27,10747,8288,2459,7889375.0,6078367.0,1811007.0,72,47,25,10519,7809,2710,7718854.0,5722837.0,1996017.0,0.7334,0.7365,0.7329,0.7365
2023-10-16 16:20,573,470,103,55703,45065,10638,40936030.0,33095698.0,7840331.0,553,463,90,54516,44599,9917,40042862.0,32732825.0,7310036.0,0.7344,0.737,0.7339,0.7371
2023-10-16 16:25,68,35,33,5423,3150,2273,4012245.0,2337113.0,1675132.0,58,30,28,4391,2135,2256,3234213.0,1565649.0,1668563.0,0.7419,0.737,0.7333,0.7396
2023-10-16 16:30,514,214,300,24109,9574,14535,17734221.0,7027702.0,10706518.0,510,212,298,24146,9716,14430,17761696.0,7132446.0,10629250.0,0.734,0.7366,0.7341,0.7366
2023-10-16 16:35,253,180,73,32857,24659,8198,24132959.0,18093258.0,6039700.0,241,175,66,32448,24596,7852,23834011.0,18046135.0,5787876.0,0.7337,0.7367,0.7337,0.7371
2023-10-16 16:40,89,52,37,11216,8794,2422,8206902.0,6449274.0,1757628.0,88,48,40,9548,7548,2000,7012832.0,5537501.0,1475330.0,0.7334,0.7257,0.7336,0.7377
2023-10-16 16:45,103,61,42,11038,7168,3870,8052269.0,5260129.0,2792139.0,91,52,39,11995,8220,3775,8776495.0,5994495.0,2782000.0,0.7338,0.7215,0.7293,0.737
2023-10-16 16:50,269,47,222,13967,5172,8795,10275756.0,3799784.0,6475971.0,255,33,222,13657,4862,8795,10042905.0,3566264.0,6476640.0,0.7347,0.7363,0.7335,0.7364
2023-10-16 16:55,372,208,164,35398,22308,13090,26007267.0,16376124.0,9631143.0,349,195,154,34399,22256,12143,25279304.0,16333548.0,8945756.0,0.7341,0.7358,0.7339,0.7367
2023-10-16 17:00,153,97,56,14146,8410,5736,10400551.0,6172176.0,4228374.0,148,93,55,12950,7262,5688,9520630.0,5328534.0,4192096.0,0.7339,0.7372,0.7338,0.737
2023-10-16 17:05,312,224,88,18492,10506,7986,13596128.0,7717643.0,5878485.0,296,218,78,18876,10915,7961,13875579.0,8010542.0,5865037.0,0.7346,0.7361,0.7339,0.7367
2023-10-16 17:10,455,123,332,30480,6966,23514,22480222.0,5124324.0,17355897.0,427,108,319,29217,6931,22286,21538344.0,5088516.0,16449828.0,0.7356,0.7381,0.7342,0.7381
2023-10-16 17:15,377,155,222,32552,13675,18877,23898344.0,10029573.0,13868770.0,360,149,211,31862,13756,18106,23419279.0,10089820.0,13329459.0,0.7334,0.7347,0.7335,0.7362
2023-10-16 17:20,430,40,390,25540,2303,23237,18699817.0,1687140.0,17012677.0,416,30,386,24574,2260,22314,18061758.0,1655019.0,16406738.0,0.7326,0.7321,0.7323,0.7353
2023-10-16 17:25,154,43,111,8516,2749,5767,6266635.0,2028706.0,4237929.0,134,30,104,7278,1602,5676,5346448.0,1173488.0,4172960.0,0.738,0.7349,0.7325,0.7352
2023-10-16 17:30,276,33,243,15676,3688,11988,11517826.0,2700328.0,8817498.0,272,31,241,16123,3306,12817,11864755.0,2419618.0,9445137.0,0.7322,0.7355,0.7319,0.7369
2023-10-16 17:35,387,62,325,26732,7015,19717,19608010.0,5142323.0,14465686.0,363,52,311,25434,6993,18441,18681525.0,5125064.0,13556460.0,0.733,0.7337,0.7329,0.7351
2023-10-16 17:40,68,33,35,5176,2768,2408,3780090.0,2026372.0,1753718.0,55,26,29,4008,2264,1744,2941065.0,1656699.0,1284366.0,0.7321,0.7283,0.7318,0.7364
2023-10-16 17:45,85,46,39,6760,3968,2792,4951129.0,2908540.0,2042589.0,71,41,30,5773,3378,2395,4238182.0,2475080.0,1763102.0,0.733,0.7316,0.7327,0.7362
2023-10-16 17:50,178,76,102,16337,8183,8154,11994708.0,5995287.0,5999421.0,169,69,100,16562,8251,8311,12166953.0,6042761.0,6124192.0,0.7327,0.7358,0.7324,0.7369
2023-10-16 17:55,135,86,49,12485,7827,4658,9149485.0,5738910.0,3410574.0,123,86,37,12045,8055,3990,8852405.0,5904629.0,2947776.0,0.7332,0.7322,0.733,0.7388
2023-10-16 18:00,542,217,325,39757,14862,24895,29255670.0,10918849.0,18336820.0,514,199,315,41197,14619,26578,30279728.0,10682048.0,19597679.0,0.7347,0.7366,0.7307,0.7374
2023-10-16 18:05,1210,542,668,97629,48465,49164,71766810.0,35584559.0,36182251.0,1181,527,654,95534,47098,48436,70231282.0,34563860.0,35667421.0,0.7342,0.736,0.7339,0.7364
2023-10-16 18:10,615,277,338,41533,15432,26101,30565281.0,11337331.0,19227949.0,579,254,325,39448,14424,25024,29016446.0,10582426.0,18434019.0,0.7347,0.7367,0.7337,0.7367
2023-10-16 18:15,1020,291,729,42434,10441,31993,31212290.0,7668651.0,23543639.0,1003,285,718,40223,10077,30146,29583680.0,7399595.0,22184085.0,0.7345,0.7359,0.7343,0.7359
2023-10-16 18:20,1047,240,807,89209,21659,67550,65670618.0,15907429.0,49763188.0,1045,235,810,90073,21862,68211,66302203.0,16044219.0,50257984.0,0.7344,0.7367,0.7339,0.7368
2023-10-16 18:25,734,310,424,42112,12890,29222,31008596.0,9475648.0,21532947.0,709,299,410,40813,12704,28109,30052063.0,9332952.0,20719111.0,0.7351,0.7369,0.7346,0.7371
2023-10-16 18:30,1438,893,545,208630,154326,54304,153505804.0,113460691.0,40045113.0,1393,864,529,206418,152547,53871,151806797.0,112063601.0,39743195.0,0.7352,0.7374,0.7346,0.7377
2023-10-16 18:35,674,342,332,90486,62694,27792,66579675.0,46069934.0,20509740.0,659,338,321,91260,63133,28127,67130427.0,46363684.0,20766743.0,0.7348,0.738,0.7344,0.7383
2023-10-17 10:00,6050,3472,2578,575047,396764,178283,424442749.0,291825834.0,132616914.0,5553,3232,2321,545279,381966,163313,402780651.0,281556843.0,121223807.0,0.7355,0.7439,0.7371,0.7423
2023-10-17 10:05,3571,1956,1615,315643,237529,78114,234361007.0,176646080.0,57714927.0,3312,1835,1477,305947,232483,73464,225561528.0,171137788.0,54423739.0,0.7437,0.7389,0.7361,0.7408
2023-10-17 10:10,2157,1086,1071,156281,85476,70805,115113777.0,62776138.0,52337639.0,2066,1045,1021,153536,84650,68886,113163194.0,62157282.0,51005911.0,0.7344,0.7392,0.7343,0.7404
2023-10-17 10:15,2857,2135,722,285322,245407,39915,210585223.0,181015994.0,29569229.0,2761,2086,675,277821,240817,37004,204860852.0,177451887.0,27408964.0,0.7376,0.7408,0.7369,0.7407
2023-10-17 10:20,1223,445,778,104716,37965,66751,77406803.0,27937846.0,49468957.0,1172,428,744,103251,37650,65601,76309993.0,27666860.0,48643133.0,0.7359,0.7411,0.7348,0.7415
2023-10-17 10:25,1203,850,353,98495,71880,26615,72651941.0,52945541.0,19706400.0,1157,834,323,94991,71186,23805,70087035.0,52455964.0,17631070.0,0.7366,0.7404,0.7369,0.7406
2023-10-17 10:30,1429,922,507,161666,134443,27223,119032353.0,98911191.0,20121162.0,1379,906,473,157823,133750,24073,116201031.0,98382388.0,17818643.0,0.7357,0.7391,0.7356,0.7402
2023-10-17 10:35,210,137,73,19740,15369,4371,14520729.0,11286281.0,3234448.0,193,124,69,20491,14745,5746,15110787.0,10841377.0,4269409.0,0.7344,0.74,0.7353,0.743
2023-10-17 10:40,1400,666,734,119557,68468,51089,87946746.0,50214895.0,37731851.0,1348,642,706,117297,67454,49843,86338183.0,49460253.0,36877930.0,0.7334,0.7386,0.7332,0.7399
2023-10-17 10:45,488,289,199,32568,22794,9774,23960782.0,16806129.0,7154653.0,455,274,181,30520,21357,9163,22476973.0,15699701.0,6777272.0,0.7373,0.732,0.7351,0.7396
2023-10-17 10:50,380,272,108,29593,24448,5145,21763903.0,17959399.0,3804504.0,366,264,102,29744,24688,5056,21873708.0,18135361.0,3738346.0,0.7346,0.7395,0.7346,0.7394
2023-10-17 10:55,1269,821,448,65475,49147,16328,48342523.0,36269754.0,12072769.0,1228,793,435,57579,41951,15628,42481909.0,30912835.0,11569074.0,0.738,0.7394,0.7369,0.7403
2023-10-17 11:00,549,281,268,26839,13775,13064,19870840.0,10178528.0,9692312.0,495,253,242,25314,13153,12161,18731706.0,9705431.0,9026275.0,0.7389,0.7419,0.7379,0.7422
2023-10-17 11:05,488,200,288,25628,14690,10938,18902421.0,10825493.0,8076927.0,451,186,265,24023,13996,10027,17739915.0,10311502.0,7428412.0,0.7369,0.7384,0.7367,0.7408
2023-10-17 11:10,1012,812,200,42128,29807,12321,31230380.0,22102292.0,9128088.0,965,787,178,41660,29768,11892,30789839.0,21972369.0,8817470.0,0.7415,0.7409,0.7381,0.7415
2023-10-17 11:15,650,337,313,43284,34367,8917,31979398.0,25381754.0,6597644.0,596,308,288,42101,34010,8091,31080727.0,25079964.0,6000763.0,0.7386,0.7399,0.7374,0.7417
2023-10-17 11:20,1180,995,185,98421,89267,9154,72740635.0,65948299.0,6792335.0,1130,971,159,97828,88919,8909,72299701.0,65688805.0,6610895.0,0.7388,0.742,0.7387,0.742
2023-10-17 11:25,826,652,174,58368,46055,12313,43083019.0,33953987.0,9129031.0,793,625,168,57640,45483,12157,42557357.0,33529858.0,9027498.0,0.7372,0.7414,0.7372,0.7426
2023-10-17 11:30,1064,419,645,62080,44735,17345,45872668.0,33021708.0,12850960.0,1046,408,638,61589,44622,16967,45505852.0,32933412.0,12572439.0,0.7382,0.7409,0.7381,0.741
2023-10-17 11:35,863,527,336,70993,60534,10459,52863722.0,45100861.0,7762861.0,844,513,331,72120,60466,11654,53692981.0,45032150.0,8660830.0,0.7451,0.7422,0.7448,0.7432
2023-10-17 11:40,1671,837,834,113583,64375,49208,85232315.0,48631919.0,36600395.0,1506,758,748,103037,59017,44020,76856459.0,44078978.0,32777480.0,0.7554,0.7438,0.7469,0.7446
2023-10-17 11:45,925,592,333,46453,30306,16147,34582420.0,22533498.0,12048922.0,831,551,280,41357,26932,14425,30688508.0,19925494.0,10763014.0,0.7435,0.7462,0.7398,0.7461
2023-10-17 11:50,1307,644,663,76454,43355,33099,57279587.0,32624836.0,24654751.0,1101,575,526,64634,36763,27871,48195993.0,27265116.0,20930877.0,0.7525,0.7449,0.7416,0.751
2023-10-17 11:55,992,489,503,64624,30120,34504,48389856.0,22705426.0,25684429.0,913,440,473,61931,28924,33007,46692750.0,22084513.0,24608237.0,0.7538,0.7444,0.7635,0.7455
2023-10-17 12:00,580,257,323,30468,12657,17811,22881162.0,9379303.0,13501858.0,536,236,300,28102,11973,16129,21103539.0,8858426.0,12245112.0,0.741,0.7581,0.7399,0.7592
2023-10-17 12:05,753,345,408,42793,19981,22812,32007373.0,14807689.0,17199684.0,727,331,396,44127,19797,24330,33151142.0,14669497.0,18481645.0,0.7411,0.754,0.741,0.7596
2023-10-17 12:10,1353,434,919,75050,34976,40074,56315230.0,26474445.0,29840784.0,1306,402,904,71716,33839,37877,54035254.0,25642610.0,28392644.0,0.7569,0.7446,0.7578,0.7496
2023-10-17 12:15,713,552,161,55954,43645,12309,41426277.0,32383262.0,9043014.0,612,482,130,50620,40601,10019,37483212.0,30019396.0,7463816.0,0.742,0.7347,0.7394,0.745
2023-10-17 12:20,901,454,447,62591,35481,27110,46084435.0,26196591.0,19887844.0,868,451,417,59064,34441,24623,43728134.0,25426031.0,18302102.0,0.7383,0.7336,0.7382,0.7433
2023-10-17 12:25,727,407,320,54311,29354,24957,40494462.0,22199910.0,18294551.0,622,336,286,49637,27838,21799,37284790.0,21088512.0,16196278.0,0.7563,0.733,0.7575,0.743
2023-10-17 12:30,1967,996,971,156498,85806,70692,115622780.0,63233171.0,52389609.0,1893,949,944,151568,82592,68976,112007573.0,60862334.0,51145239.0,0.7369,0.7411,0.7369,0.7415
2023-10-17 12:35,980,606,374,48743,34087,14656,35970436.0,25113093.0,10857343.0,950,590,360,49392,35116,14276,36440785.0,25861578.0,10579207.0,0.7367,0.7408,0.7365,0.741
2023-10-17 12:40,674,517,157,26450,17434,9016,19527569.0,12863738.0,6663830.0,665,523,142,26516,18040,8476,19583914.0,13300913.0,6283000.0,0.7379,0.7391,0.7373,0.7413
2023-10-17 12:45,178,98,80,11002,5072,5930,8171512.0,3751530.0,4419981.0,157,85,72,9558,4118,5440,7071128.0,3034750.0,4036377.0,0.7397,0.7454,0.7369,0.742
2023-10-17 12:50,143,56,87,11388,1872,9516,8443988.0,1397516.0,7046471.0,126,50,76,10337,1517,8820,7667182.0,1120207.0,6546975.0,0.7465,0.7405,0.7384,0.7423
2023-10-17 12:55,1519,940,579,102809,71984,30825,75801006.0,52993603.0,22807403.0,1489,916,573,100998,71313,29685,74493854.0,52502986.0,21990868.0,0.7362,0.7399,0.7362,0.7408
2023-10-17 13:00,873,713,160,27551,19206,8345,20365051.0,14173556.0,6191495.0,849,697,152,26376,18993,7383,19488644.0,14011776.0,5476867.0,0.738,0.7419,0.7377,0.7418
2023-10-17 13:05,488,268,220,24987,9620,15367,18481413.0,7087796.0,11393616.0,459,247,212,23478,8946,14532,17379427.0,6592365.0,10787062.0,0.7368,0.7414,0.7369,0.7423
2023-10-17 13:10,259,98,161,17072,6294,10778,12629745.0,4625911.0,8003834.0,240,83,157,16263,5904,10359,12012648.0,4339234.0,7673414.0,0.735,0.7426,0.735,0.7407
2023-10-17 13:15,620,337,283,27492,12578,14914,20320372.0,9267949.0,11052423.0,612,334,278,27409,12807,14602,20256228.0,9435656.0,10820571.0,0.7368,0.7411,0.7368,0.741
2023-10-17 13:20,651,277,374,56068,25525,30543,41419357.0,18794501.0,22624856.0,622,259,363,57167,25221,31946,42243321.0,18568089.0,23675232.0,0.7363,0.7408,0.7362,0.7411
2023-10-17 13:25,207,114,93,15984,6969,9015,11785765.0,5127349.0,6658416.0,173,91,82,15489,7017,8472,11433939.0,5157531.0,6276408.0,0.7357,0.7386,0.735,0.7408
2023-10-17 13:30,349,138,211,20239,8163,12076,14948747.0,6002554.0,8946193.0,330,123,207,19317,7338,11979,14265553.0,5391544.0,8874009.0,0.7353,0.7408,0.7347,0.7408
2023-10-17 13:35,592,398,194,33085,17891,15194,24446672.0,13201889.0,11244782.0,568,381,187,29654,14832,14822,21915043.0,10938938.0,10976105.0,0.7379,0.7401,0.7375,0.7405
2023-10-17 13:40,439,219,220,25857,13720,12137,19105008.0,10101779.0,9003229.0,414,203,211,27823,16102,11721,20559903.0,11864567.0,8695335.0,0.7363,0.7418,0.7368,0.7419
2023-10-17 13:45,189,145,44,5936,2786,3150,4381554.0,2050036.0,2331518.0,183,143,40,5905,3043,2862,4361038.0,2237069.0,2123968.0,0.7358,0.7402,0.7352,0.7421
2023-10-17 13:50,193,122,71,9773,2826,6947,7237647.0,2086342.0,5151305.0,178,114,64,10041,2916,7125,7436912.0,2151668.0,5285244.0,0.7383,0.7415,0.7379,0.7418
2023-10-17 13:55,332,212,120,27186,12880,14306,20102542.0,9500135.0,10602406.0,307,197,110,26369,12516,13853,19497705.0,9230710.0,10266995.0,0.7376,0.7411,0.7375,0.7411
2023-10-17 14:00,179,117,62,10818,4340,6478,8001636.0,3203234.0,4798402.0,171,112,59,10706,4259,6447,7926029.0,3143106.0,4782923.0,0.7381,0.7407,0.738,0.7419
2023-10-17 14:05,629,412,217,48875,25077,23798,36227247.0,18558539.0,17668708.0,613,400,213,48400,24392,24008,35838367.0,18016126.0,17822241.0,0.7401,0.7424,0.7386,0.7423
2023-10-17 14:10,1175,518,657,104235,61077,43158,77138045.0,45081651.0,32056394.0,1127,494,633,101035,58838,42197,74761117.0,43417930.0,31343187.0,0.7381,0.7428,0.7379,0.7428
2023-10-17 14:15,911,615,296,55707,37245,18462,41215701.0,27516747.0,13698954.0,868,593,275,51450,36941,14509,38052527.0,27276250.0,10776276.0,0.7388,0.742,0.7384,0.7427
2023-10-17 14:20,779,576,203,57818,51035,6783,42675323.0,37644681.0,5030642.0,762,562,200,57616,50967,6649,42520521.0,37589021.0,4931500.0,0.7376,0.7417,0.7375,0.7417
2023-10-17 14:25,1378,880,498,100203,76070,24133,74077712.0,56208781.0,17868931.0,1335,849,486,97594,74967,22627,72163853.0,55388615.0,16775238.0,0.7389,0.7404,0.7388,0.7414
2023-10-17 14:30,124,38,86,6075,2127,3948,4508624.0,1572080.0,2936543.0,98,30,68,4755,1952,2803,3522659.0,1442372.0,2080287.0,0.7391,0.7438,0.7389,0.7422
2023-10-17 14:35,135,83,52,9393,7650,1743,6951991.0,5659762.0,1292229.0,126,80,46,9360,7784,1576,6919552.0,5750754.0,1168798.0,0.7398,0.7414,0.7388,0.7416
2023-10-17 14:40,82,23,59,3426,787,2639,2506607.0,581157.0,1925449.0,69,17,52,3004,761,2243,2226515.0,562081.0,1664434.0,0.7384,0.7296,0.7386,0.7421
2023-10-17 14:45,457,111,346,26633,5629,21004,19725712.0,4152425.0,15573287.0,442,105,337,26462,5794,20668,19599809.0,4273864.0,15325945.0,0.7377,0.7414,0.7376,0.7415
2023-10-17 14:50,367,128,239,20569,9799,10770,15187342.0,7240458.0,7946884.0,343,111,232,19771,9303,10468,14632980.0,6873334.0,7759646.0,0.7389,0.7379,0.7388,0.7413
2023-10-17 14:55,678,344,334,33208,13537,19671,24596237.0,10016866.0,14579370.0,664,334,330,32757,13271,19486,24257829.0,9809127.0,14448701.0,0.74,0.7412,0.7391,0.7415
2023-10-17 15:00,442,111,331,28557,14987,13570,21066541.0,11039521.0,10027020.0,423,104,319,28185,14739,13446,20821721.0,10857668.0,9964052.0,0.7366,0.7389,0.7367,0.741
2023-10-17 15:05,172,72,100,18693,8498,10195,13816317.0,6265436.0,7550881.0,160,66,94,17967,8619,9348,13281609.0,6352943.0,6928665.0,0.7373,0.7406,0.7371,0.7412
2023-10-17 15:10,417,88,329,34690,13348,21342,25592676.0,9840466.0,15752209.0,402,80,322,33704,12684,21020,24917789.0,9352175.0,15565614.0,0.7372,0.7381,0.7373,0.7405
2023-10-17 15:15,1012,523,489,70458,39484,30974,52066757.0,29124556.0,22942200.0,1002,519,483,70183,39314,30869,51871761.0,28998198.0,22873562.0,0.7376,0.7407,0.7376,0.741
2023-10-17 15:20,926,419,507,56167,28067,28100,41255624.0,20640022.0,20615601.0,861,385,476,52083,26422,25661,38420276.0,19433028.0,18987248.0,0.7354,0.7337,0.7355,0.7399
2023-10-17 15:25,340,150,190,36742,19718,17024,27044767.0,14529758.0,12515008.0,288,123,165,33629,18238,15391,24806296.0,13413768.0,11392528.0,0.7369,0.7351,0.7355,0.7402
2023-10-17 15:30,922,516,406,43685,14167,29518,32575095.0,11003907.0,21571188.0,828,475,353,38216,12100,26116,28758429.0,9482836.0,19275593.0,0.7767,0.7308,0.7837,0.7381
2023-10-17 15:35,1151,590,561,105277,57220,48057,77686301.0,42349591.0,35336709.0,1065,547,518,97425,53299,44126,71691177.0,39119154.0,32572022.0,0.7401,0.7353,0.734,0.7382
2023-10-17 15:40,775,465,310,86294,65765,20529,63493744.0,48345600.0,15148143.0,765,458,307,86628,65222,21406,63753527.0,47935968.0,15817559.0,0.7351,0.7379,0.735,0.7389
2023-10-17 15:45,724,485,239,67531,43741,23790,49723826.0,32148490.0,17575336.0,718,483,235,67054,43358,23696,49373389.0,31866912.0,17506477.0,0.735,0.7388,0.735,0.7388
2023-10-17 15:50,422,215,207,39976,21212,18764,29445358.0,15586753.0,13858604.0,410,209,201,39861,21458,18403,29364780.0,15767177.0,13597603.0,0.7348,0.7386,0.7348,0.7389
2023-10-17 15:55,503,222,281,44488,28122,16366,32781457.0,20689995.0,12091462.0,492,214,278,46902,27936,18966,34559939.0,20535014.0,14024924.0,0.7357,0.7388,0.7351,0.7395
2023-10-17 16:00,1366,960,406,119463,84888,34575,87999256.0,62445605.0,25553650.0,1358,956,402,119170,85512,33658,87744076.0,62870472.0,24873604.0,0.7356,0.7391,0.7352,0.739
2023-10-17 16:05,520,358,162,33699,24084,9615,24758573.0,17679409.0,7079164.0,500,347,153,32263,22961,9302,23749078.0,16878880.0,6870197.0,0.7341,0.7363,0.7351,0.7386
2023-10-17 16:10,508,190,318,47055,19255,27800,34641118.0,14140728.0,20500390.0,482,170,312,44918,18209,26709,33088585.0,13373669.0,19714915.0,0.7344,0.7374,0.7345,0.7381
2023-10-17 16:15,332,110,222,31233,13362,17871,23006965.0,9812734.0,13194230.0,314,95,219,29413,11727,17686,21669751.0,8611017.0,13058734.0,0.7344,0.7383,0.7343,0.7384
2023-10-17 16:20,535,286,249,54051,31609,22442,39800938.0,23238506.0,16562432.0,524,279,245,54900,32225,22675,40443994.0,23689815.0,16754178.0,0.7352,0.738,0.7351,0.7389
2023-10-17 16:25,249,136,113,20343,9850,10493,15008730.0,7244233.0,7764496.0,243,127,116,20933,9700,11233,15446252.0,7132996.0,8313256.0,0.7355,0.74,0.7354,0.7401
2023-10-17 16:30,513,213,300,47242,14538,32704,34732273.0,10662401.0,24069872.0,480,195,285,45094,13381,31713,33253517.0,9823325.0,23430191.0,0.7334,0.736,0.7341,0.7388
2023-10-17 16:35,245,74,171,22399,4639,17760,16501025.0,3400215.0,13100810.0,208,53,155,20936,4461,16475,15425203.0,3264743.0,12160460.0,0.733,0.7377,0.7318,0.7381
2023-10-17 16:40,75,29,46,6306,645,5661,4654631.0,473588.0,4181043.0,65,24,41,6084,629,5455,4481191.0,461568.0,4019623.0,0.7342,0.7386,0.7338,0.7369
2023-10-17 16:45,159,53,106,13031,1424,11607,9551703.0,1045078.0,8506624.0,146,44,102,11959,968,10991,8817492.0,710510.0,8106982.0,0.7339,0.7329,0.734,0.7376
2023-10-17 16:50,90,34,56,8203,1218,6985,6034233.0,886282.0,5147951.0,80,29,51,13608,6019,7589,9989640.0,4392698.0,5596941.0,0.7277,0.737,0.7298,0.7375
2023-10-17 16:55,249,15,234,7884,868,7016,5794513.0,636720.0,5157792.0,235,10,225,7370,386,6984,5417206.0,282643.0,5134563.0,0.7335,0.7351,0.7322,0.7352
2023-10-17 17:00,166,55,111,12849,3019,9830,9492247.0,2236890.0,7255356.0,145,40,105,11801,2912,8889,8681078.0,2120861.0,6560217.0,0.7409,0.7381,0.7283,0.738
2023-10-17 17:05,862,452,410,66713,30634,36079,49251356.0,22616682.0,26634673.0,830,434,396,63834,28666,35168,47033037.0,21069092.0,25963944.0,0.7383,0.7382,0.735,0.7383
2023-10-17 17:10,709,348,361,52923,20175,32748,38854396.0,14777238.0,24077158.0,668,326,342,49448,19431,30017,36356124.0,14234461.0,22121662.0,0.7325,0.7352,0.7326,0.737
2023-10-17 17:15,260,70,190,24941,4136,20805,18356470.0,3029181.0,15327288.0,257,67,190,25236,4291,20945,18569854.0,3139392.0,15430462.0,0.7324,0.7367,0.7316,0.7367
2023-10-17 17:20,238,93,145,25497,3556,21941,18784648.0,2607931.0,16176717.0,221,86,135,25788,3665,22123,19001528.0,2686521.0,16315007.0,0.7334,0.7373,0.733,0.7375
2023-10-17 17:25,117,55,62,7463,2423,5040,5489059.0,1776328.0,3712731.0,118,55,63,7727,2381,5346,5684724.0,1745448.0,3939276.0,0.7331,0.7367,0.7331,0.7369
2023-10-17 17:30,44,15,29,3064,606,2458,2260889.0,445194.0,1815694.0,36,11,25,2837,462,2375,2107878.0,339338.0,1768540.0,0.7346,0.7387,0.7345,0.7446
2023-10-17 17:35,368,64,304,24404,4059,20345,17964878.0,2979687.0,14985191.0,359,59,300,25117,4097,21020,18490926.0,3007608.0,15483318.0,0.7341,0.7366,0.7341,0.7366
2023-10-17 17:40,72,9,63,8349,911,7438,6142414.0,661827.0,5480586.0,69,9,60,8274,880,7394,6087602.0,639098.0,5448504.0,0.7265,0.7368,0.7262,0.7369
2023-10-17 17:45,88,30,58,9510,2682,6828,7029967.0,1999038.0,5030929.0,79,24,55,9258,2359,6899,6810992.0,1727308.0,5083683.0,0.7454,0.7368,0.7322,0.7369
2023-10-17 17:50,74,30,44,5757,1940,3817,4241590.0,1427350.0,2814240.0,63,24,39,5277,1728,3549,3884714.0,1268799.0,2615914.0,0.7357,0.7373,0.7343,0.7371
2023-10-17 17:55,221,96,125,17944,6297,11647,13255558.0,4664998.0,8590559.0,203,87,116,17036,5642,11394,12561681.0,4144930.0,8416751.0,0.7408,0.7376,0.7347,0.7387
2023-10-17 18:00,93,33,60,7207,2425,4782,5307904.0,1778258.0,3529646.0,89,30,59,7660,3223,4437,5614561.0,2339615.0,3274946.0,0.7333,0.7381,0.7259,0.7381
2023-10-17 18:05,45,22,23,3601,639,2962,2654140.0,469649.0,2184491.0,41,20,21,4106,1110,2996,3026255.0,815043.0,2211212.0,0.735,0.7375,0.7343,0.7381
2023-10-17 18:10,186,52,134,21222,5028,16194,15315327.0,3679588.0,11635738.0,162,37,125,19312,4143,15169,14241869.0,3033438.0,11208430.0,0.7318,0.7185,0.7322,0.7389
2023-10-17 18:15,1125,523,602,113196,54212,58984,82433575.0,39451337.0,42982238.0,1028,462,566,104979,50621,54358,76815022.0,36843932.0,39971090.0,0.7277,0.7287,0.7278,0.7353
2023-10-17 18:20,807,294,513,68764,10131,58633,51776141.0,8670647.0,43105494.0,785,274,511,66129,7068,59061,49926178.0,6505405.0,43420772.0,0.8559,0.7352,0.9204,0.7352
2023-10-17 18:25,1193,269,924,76718,22313,54405,55814342.0,16160017.0,39654325.0,1085,205,880,67467,16066,51401,49380468.0,11658909.0,37721559.0,0.7242,0.7289,0.7257,0.7339
2023-10-17 18:30,703,369,334,48504,17715,30789,35437438.0,12898839.0,22538598.0,660,339,321,46725,16143,30582,34197057.0,11746952.0,22450105.0,0.7281,0.732,0.7277,0.7341
2023-10-17 18:35,166,77,89,7640,2043,5597,5602984.0,1491816.0,4111167.0,154,65,89,7769,1814,5955,5695438.0,1320795.0,4374643.0,0.7302,0.7345,0.7281,0.7346
2023-10-18 10:00,10457,2677,7780,1188382,281309,907073,871253730.0,204234790.0,667018940.0,10119,2509,7610,1166507,268354,898153,855055770.0,194851683.0,660204086.0,0.726,0.7354,0.7261,0.7351
2023-10-18 10:05,612,354,258,56952,25861,31091,42633604.0,19614350.0,23019253.0,495,295,200,52235,23208,29027,39049140.0,17627555.0,21421584.0,0.7585,0.7404,0.7595,0.738
2023-10-18 10:10,760,514,246,32622,21333,11289,24617703.0,16292901.0,8324801.0,605,433,172,30208,20686,9522,22868374.0,15828619.0,7039754.0,0.7637,0.7374,0.7652,0.7393
2023-10-18 10:15,541,309,232,34441,13834,20607,25414192.0,10176652.0,15237540.0,458,262,196,31799,12780,19019,23419558.0,9381648.0,14037910.0,0.7356,0.7394,0.7341,0.7381
2023-10-18 10:20,837,496,341,44154,21135,23019,33116602.0,16172639.0,16943963.0,782,473,309,41441,19918,21523,31157927.0,15276442.0,15881485.0,0.7652,0.7361,0.767,0.7379
2023-10-18 10:25,654,423,231,33719,19741,13978,24824332.0,14519844.0,10304488.0,583,392,191,32314,18659,13655,23763180.0,13690855.0,10072324.0,0.7355,0.7372,0.7337,0.7376
2023-10-18 10:30,1442,777,665,94068,60070,33998,68900992.0,43836059.0,25064933.0,1380,759,621,88381,56757,31624,64960588.0,41634188.0,23326400.0,0.7297,0.7372,0.7336,0.7376
2023-10-18 10:35,959,269,690,64251,18628,45623,47087448.0,13637412.0,33450036.0,895,245,650,58598,17506,41092,43084593.0,12824315.0,30260278.0,0.7321,0.7332,0.7326,0.7364
2023-10-18 10:40,508,255,253,19614,10766,8848,14396226.0,7894284.0,6501942.0,459,225,234,19083,10523,8560,13986335.0,7694419.0,6291915.0,0.7333,0.7348,0.7312,0.735
2023-10-18 10:45,408,121,287,36040,6054,29986,26479379.0,4455516.0,22023863.0,381,107,274,34771,5398,29373,25525396.0,3947168.0,21578227.0,0.736,0.7345,0.7312,0.7346
2023-10-18 10:50,226,92,134,20981,8617,12364,16027905.0,6944464.0,9083440.0,184,65,119,17536,5890,11646,13525641.0,4952638.0,8573003.0,0.8059,0.7347,0.8409,0.7361
2023-10-18 10:55,351,107,244,19624,7033,12591,14404107.0,5143746.0,9260360.0,324,88,236,19218,6200,13018,14111776.0,4533187.0,9578588.0,0.7314,0.7355,0.7312,0.7358
2023-10-18 11:00,1025,279,746,60609,21947,38662,44537865.0,16080480.0,28457384.0,1009,273,736,64791,24033,40758,47366827.0,17363416.0,30003410.0,0.7327,0.7361,0.7225,0.7361
2023-10-18 11:05,952,406,546,84977,38152,46825,62409375.0,27931331.0,34478044.0,940,404,536,83995,37719,46276,61689098.0,27618656.0,34070442.0,0.7321,0.7363,0.7322,0.7362
2023-10-18 11:10,895,307,588,69468,22812,46656,51033336.0,16700451.0,34332885.0,873,297,576,69148,22676,46472,50773653.0,16577666.0,34195986.0,0.7321,0.7359,0.7311,0.7358
2023-10-18 11:15,1191,378,813,92335,40133,52202,67736465.0,29349412.0,38387052.0,1170,369,801,92270,40201,52069,67688119.0,29397455.0,38290664.0,0.7313,0.7354,0.7313,0.7354
2023-10-18 11:20,739,475,264,49993,27931,22062,36650424.0,20423578.0,16226845.0,721,465,256,49354,27586,21768,36181218.0,20170382.0,16010836.0,0.7312,0.7355,0.7312,0.7355
2023-10-18 11:25,224,143,81,14548,9529,5019,10650302.0,6964277.0,3686024.0,203,134,69,13755,9236,4519,10076727.0,6752447.0,3324280.0,0.7309,0.7344,0.7311,0.7356
2023-10-18 11:30,1039,451,588,58198,22502,35696,42569196.0,16401301.0,26167894.0,950,408,542,55995,21931,34064,41005108.0,15993315.0,25011792.0,0.7289,0.7331,0.7293,0.7343
2023-10-18 11:35,1391,855,536,139995,105190,34805,102980988.0,77430056.0,25550932.0,1316,816,500,129809,98150,31659,94943970.0,71662472.0,23281498.0,0.7361,0.7341,0.7301,0.7354
2023-10-18 11:40,579,333,246,56373,35165,21208,41224546.0,25647083.0,15577462.0,556,321,235,55585,34570,21015,40662362.0,25216906.0,15445455.0,0.7293,0.7345,0.7294,0.735
2023-10-18 11:45,442,321,121,30536,25450,5086,22319106.0,18584217.0,3734888.0,428,316,112,30071,25227,4844,21980952.0,18422338.0,3558613.0,0.7302,0.7343,0.7303,0.7346
2023-10-18 11:50,1493,802,691,162038,90596,71442,116670359.0,65562439.0,51107920.0,1155,602,553,129416,72555,56861,94201469.0,52552194.0,41649275.0,0.7237,0.7154,0.7243,0.7325
2023-10-18 11:55,6531,3963,2568,744586,524986,219600,546066069.0,384488661.0,161577408.0,6350,3874,2476,728575,515661,212914,533576843.0,376854498.0,156722344.0,0.7324,0.7358,0.7308,0.7361
2023-10-18 12:00,3285,2341,944,389349,310664,78685,285814946.0,227810624.0,58004322.0,3247,2327,920,395070,315197,79873,289869213.0,230968496.0,58900717.0,0.7333,0.7372,0.7328,0.7374
2023-10-18 12:05,3696,2235,1461,407359,289479,117880,299044098.0,212159568.0,86884529.0,3661,2214,1447,406984,288908,118076,298767004.0,211726664.0,87040339.0,0.7329,0.7371,0.7329,0.7372
2023-10-18 12:10,837,253,584,65388,39025,26363,47820934.0,28419662.0,19401272.0,832,256,576,66089,39678,26411,48332357.0,28888511.0,19443846.0,0.7282,0.7359,0.7281,0.7362
2023-10-18 12:15,330,188,142,30027,22065,7962,21983682.0,16124583.0,5859098.0,312,178,134,29115,21286,7829,21320699.0,15557389.0,5763309.0,0.7308,0.7359,0.7309,0.7361
2023-10-18 12:20,442,170,272,42006,25534,16472,30706628.0,18574727.0,12131900.0,430,163,267,41927,25564,16363,30649177.0,18595456.0,12053721.0,0.7275,0.7365,0.7274,0.7366
2023-10-18 12:25,832,549,283,105016,79855,25161,76944165.0,58396589.0,18547575.0,824,544,280,105530,79852,25678,77320131.0,58385355.0,18934776.0,0.7313,0.7372,0.7312,0.7374
2023-10-18 12:30,286,196,90,26346,18737,7609,19284303.0,13686949.0,5597354.0,261,182,79,24330,18574,5756,17797608.0,13554370.0,4243238.0,0.7305,0.7356,0.7297,0.7372
2023-10-18 12:35,293,263,30,14104,10092,4012,10351658.0,7389791.0,2961866.0,284,254,30,13827,9815,4012,10148477.0,7186706.0,2961770.0,0.7322,0.7383,0.7322,0.7382
2023-10-18 12:40,430,305,125,50745,43081,7664,37103451.0,31463914.0,5639536.0,410,292,118,50080,42523,7557,36623390.0,31056146.0,5567243.0,0.7303,0.7358,0.7303,0.7367
2023-10-18 12:45,415,369,46,44569,40398,4171,32657504.0,29583531.0,3073973.0,399,359,40,44535,40425,4110,32615949.0,29585927.0,3030021.0,0.7323,0.737,0.7319,0.7372
2023-10-18 12:50,465,295,170,52649,43794,8855,38541615.0,32001334.0,6540280.0,458,292,166,51884,43379,8505,37923153.0,31666685.0,6256467.0,0.7307,0.7386,0.73,0.7356
2023-10-18 12:55,875,469,406,69381,46323,23058,50962031.0,33972734.0,16989297.0,847,458,389,67873,45814,22059,49785575.0,33531734.0,16253840.0,0.7334,0.7368,0.7319,0.7368
2023-10-18 13:00,812,424,388,58470,29451,29019,42948151.0,21605927.0,21342224.0,783,406,377,55465,28647,26818,40759035.0,20992307.0,19766727.0,0.7336,0.7355,0.7328,0.7371
2023-10-18 13:05,291,180,111,23834,16377,7457,17508582.0,12016818.0,5491763.0,271,174,97,24441,17165,7276,17892920.0,12532828.0,5360092.0,0.7338,0.7365,0.7301,0.7367
2023-10-18 13:10,522,318,204,42268,22817,19451,31037537.0,16709532.0,14328005.0,509,310,199,41316,22234,19082,30331608.0,16275715.0,14055892.0,0.7323,0.7366,0.732,0.7366
2023-10-18 13:15,120,59,61,8022,4919,3103,5893670.0,3608166.0,2285504.0,114,55,59,7602,4598,3004,5581171.0,3366452.0,2214718.0,0.7335,0.7365,0.7322,0.7373
2023-10-18 13:20,30,14,16,1118,921,197,820210.0,674558.0,145651.0,21,12,9,922,759,163,675740.0,555167.0,120572.0,0.7324,0.7393,0.7314,0.7397
2023-10-18 13:25,71,49,22,5363,4455,908,3951231.0,3281530.0,669700.0,53,41,12,5272,4674,598,3866755.0,3426487.0,440268.0,0.7366,0.7376,0.7331,0.7362
2023-10-18 13:30,235,144,91,17429,11291,6138,12803876.0,8287949.0,4515927.0,222,140,82,19630,11871,7759,14424506.0,8703280.0,5721225.0,0.734,0.7357,0.7332,0.7374
2023-10-18 13:35,325,265,60,24421,20618,3803,17919051.0,15115167.0,2803884.0,311,259,52,23934,20353,3581,17555540.0,14913931.0,2641609.0,0.7331,0.7373,0.7328,0.7377
2023-10-18 13:40,355,288,67,18782,13251,5531,13802598.0,9726346.0,4076252.0,336,279,57,16772,11782,4990,12322461.0,8644740.0,3677721.0,0.734,0.737,0.7337,0.737
2023-10-18 13:45,187,106,81,15593,8278,7315,11437313.0,6050089.0,5387224.0,180,104,76,15068,7735,7333,11056240.0,5653792.0,5402448.0,0.7309,0.7365,0.7309,0.7367
2023-10-18 13:50,570,310,260,47140,26644,20496,34641393.0,19553421.0,15087971.0,559,306,253,46891,26555,20336,34446172.0,19468111.0,14978060.0,0.7339,0.7361,0.7331,0.7365
2023-10-18 13:55,187,90,97,19182,11804,7378,14069219.0,8647646.0,5421572.0,172,81,91,20370,12997,7373,14931798.0,9500902.0,5430895.0,0.7326,0.7348,0.731,0.7366
2023-10-18 14:00,133,65,68,13181,8638,4543,9665183.0,6325933.0,3339250.0,124,64,60,12585,8589,3996,9233940.0,6288894.0,2945046.0,0.7323,0.735,0.7322,0.737
2023-10-18 14:05,108,69,39,9780,6227,3553,7177226.0,4562110.0,2615115.0,102,65,37,9873,6154,3719,7248171.0,4508095.0,2740076.0,0.7326,0.736,0.7325,0.7368
2023-10-18 14:10,167,92,75,14650,7334,7316,10732309.0,5360395.0,5371914.0,145,83,62,13492,6602,6890,9911187.0,4831973.0,5079214.0,0.7309,0.7343,0.7319,0.7372
2023-10-18 14:15,401,155,246,21482,10650,10832,15759185.0,7797894.0,7961291.0,397,155,242,21917,11148,10769,16064492.0,8148388.0,7916104.0,0.7322,0.735,0.7309,0.7351
2023-10-18 14:20,586,248,338,26907,14150,12757,19681505.0,10302543.0,9378961.0,572,240,332,26798,14085,12713,19598410.0,10251198.0,9347212.0,0.7281,0.7352,0.7278,0.7352
2023-10-18 14:25,486,184,302,30830,22921,7909,22421466.0,16623754.0,5797712.0,472,173,299,30575,22824,7751,22253539.0,16553665.0,5699873.0,0.7253,0.7331,0.7253,0.7354
2023-10-18 14:30,104,63,41,10467,6768,3699,7677866.0,4960976.0,2716889.0,98,62,36,10178,6773,3405,7460755.0,4956702.0,2504053.0,0.733,0.7345,0.7318,0.7354
2023-10-18 14:35,195,66,129,12385,4561,7824,9083169.0,3335291.0,5747877.0,184,62,122,11496,4026,7470,8446676.0,2947217.0,5499459.0,0.7313,0.7346,0.732,0.7362
2023-10-18 14:40,353,125,228,24596,12396,12200,18026351.0,9033877.0,8992474.0,351,123,228,24691,12521,12170,18080717.0,9124337.0,8956379.0,0.7288,0.7371,0.7287,0.7359
2023-10-18 14:45,224,79,145,17818,8967,8851,13072921.0,6561329.0,6511591.0,220,78,142,18145,9018,9127,13300396.0,6583099.0,6717296.0,0.7317,0.7357,0.73,0.736
2023-10-18 14:50,128,55,73,12875,6119,6756,9452056.0,4482883.0,4969172.0,115,49,66,12644,5925,6719,9292020.0,4340715.0,4951305.0,0.7326,0.7355,0.7326,0.7369
2023-10-18 14:55,311,171,140,33591,22170,11421,24620524.0,16212764.0,8407760.0,297,163,134,32321,21721,10600,23691147.0,15888080.0,7803067.0,0.7313,0.7362,0.7315,0.7361
2023-10-18 15:00,194,95,99,28586,10287,18299,21855415.0,7506675.0,14348740.0,180,93,87,13964,9738,4226,10193795.0,7081967.0,3111828.0,0.7297,0.7841,0.7273,0.7364
2023-10-18 15:05,253,111,142,22120,16102,6018,16154183.0,11749694.0,4404488.0,247,111,136,24273,17769,6504,17726096.0,12919389.0,4806707.0,0.7297,0.7319,0.7271,0.739
2023-10-18 15:10,164,51,113,12654,5640,7014,9269401.0,4115428.0,5153972.0,158,51,107,12222,5723,6499,8943878.0,4166623.0,4777254.0,0.7297,0.7348,0.728,0.7351
2023-10-18 15:15,177,109,68,18760,15047,3713,13730938.0,10999535.0,2731403.0,171,103,68,16770,12379,4391,12274377.0,9041974.0,3232403.0,0.731,0.7356,0.7304,0.7361
2023-10-18 15:20,93,43,50,9228,5323,3905,6763475.0,3892186.0,2871289.0,84,40,44,8344,4986,3358,6118940.0,3646075.0,2472865.0,0.7312,0.7353,0.7313,0.7364
2023-10-18 15:25,34,16,18,3340,1463,1877,2450988.0,1071804.0,1379184.0,31,16,15,3387,1498,1889,2490202.0,1096451.0,1393750.0,0.7326,0.7348,0.7319,0.7378
2023-10-18 15:30,200,52,148,10918,3482,7436,8018185.0,2549844.0,5468341.0,196,49,147,24102,3701,20401,18604376.0,2709535.0,15894840.0,0.7323,0.7354,0.7321,0.7791
2023-10-18 15:35,243,185,58,16826,10239,6587,12336444.0,7489108.0,4847335.0,237,182,55,15984,9408,6576,11729196.0,6889845.0,4839351.0,0.7314,0.7359,0.7323,0.7359
2023-10-18 15:40,73,35,38,6761,3929,2832,4961619.0,2877192.0,2084426.0,70,34,36,7060,3945,3115,5182442.0,2889198.0,2293244.0,0.7323,0.736,0.7324,0.7362
2023-10-18 15:45,924,379,545,71650,23296,48354,52489345.0,16976383.0,35512961.0,915,374,541,70987,23060,47927,52008095.0,16808292.0,35199802.0,0.7287,0.7344,0.7289,0.7344
2023-10-18 15:50,219,92,127,16677,6243,10434,12821048.0,5193652.0,7627396.0,207,92,115,15456,6117,9339,11978948.0,5110351.0,6868597.0,0.8319,0.731,0.8354,0.7355
2023-10-18 15:55,15,8,7,970,718,252,709216.0,524262.0,184953.0,12,7,5,911,601,310,669068.0,440165.0,228902.0,0.7302,0.7339,0.7324,0.7384
2023-10-18 16:00,679,454,225,55232,31281,23951,40324794.0,22773854.0,17550940.0,658,445,213,53481,31080,22401,39061208.0,22636238.0,16424969.0,0.728,0.7328,0.7283,0.7332
2023-10-18 16:05,867,433,434,68059,30918,37141,49436752.0,22396058.0,27040693.0,823,416,407,64489,28447,36042,47006734.0,20649349.0,26357385.0,0.7244,0.7281,0.7259,0.7313
2023-10-18 16:10,3085,1917,1168,313069,232374,80695,227490754.0,168607341.0,58883413.0,2990,1860,1130,310768,230854,79914,225811895.0,167463179.0,58348716.0,0.7256,0.7297,0.7254,0.7301
2023-10-18 16:15,744,539,205,49937,37699,12238,36313796.0,27394625.0,8919170.0,722,530,192,47781,35836,11945,34772824.0,26037553.0,8735270.0,0.7267,0.7288,0.7266,0.7313
2023-10-18 16:20,403,167,236,40515,22670,17845,29460251.0,16412926.0,13047325.0,393,163,230,40992,23765,17227,29832723.0,17230718.0,12602005.0,0.724,0.7311,0.725,0.7315
2023-10-18 16:25,665,410,255,36757,19455,17302,26872210.0,14191198.0,12681012.0,645,400,245,36369,19106,17263,26585832.0,13934809.0,12651023.0,0.7294,0.7329,0.7293,0.7328
2023-10-18 16:30,395,198,197,40364,21860,18504,29462491.0,15911860.0,13550630.0,386,196,190,40407,21953,18454,29492591.0,15978409.0,13514182.0,0.7279,0.7323,0.7278,0.7323
2023-10-18 16:35,355,138,217,32541,19503,13038,23693004.0,14158425.0,9534578.0,344,132,212,31886,19418,12468,23226505.0,14095481.0,9131024.0,0.726,0.7313,0.7259,0.7324
2023-10-18 16:40,630,224,406,35929,19460,16469,26184305.0,14134956.0,12049348.0,618,216,402,35978,19598,16380,26215237.0,14223903.0,11991333.0,0.7264,0.7316,0.7258,0.7321
2023-10-18 16:45,395,208,187,35615,21446,14169,25924887.0,15562942.0,10361945.0,389,204,185,35527,21394,14133,25862584.0,15524776.0,10337808.0,0.7257,0.7313,0.7257,0.7315
2023-10-18 16:50,559,223,336,43229,25383,17846,31539333.0,18476660.0,13062673.0,549,216,333,43107,25521,17586,31445670.0,18573115.0,12872555.0,0.7279,0.732,0.7278,0.732
2023-10-18 16:55,78,41,37,5123,1531,3592,3750356.0,1114807.0,2635549.0,74,36,38,7819,3991,3828,5670660.0,2862097.0,2808562.0,0.7282,0.7337,0.7171,0.7337
2023-10-18 17:00,512,311,201,48152,32112,16040,35060237.0,23329956.0,11730281.0,499,300,199,45636,32077,13559,33218980.0,23294521.0,9924458.0,0.7265,0.7313,0.7262,0.7319
2023-10-18 17:05,486,175,311,26242,15625,10617,19123957.0,11361060.0,7762896.0,479,169,310,26694,13690,13004,19471799.0,9964767.0,9507031.0,0.7271,0.7312,0.7279,0.7311
2023-10-18 17:10,862,328,534,72884,33271,39613,53282762.0,24261254.0,29021507.0,850,319,531,72659,33194,39465,53116293.0,24203876.0,28912416.0,0.7292,0.7326,0.7292,0.7326
2023-10-18 17:15,605,258,347,45946,23061,22885,33574076.0,16811436.0,16762640.0,588,249,339,45421,23038,22383,33194610.0,16793356.0,16401254.0,0.729,0.7325,0.7289,0.7328
2023-10-18 17:20,339,180,159,30464,19608,10856,22213109.0,14259282.0,7953827.0,328,173,155,30158,19433,10725,21983864.0,14125401.0,7858462.0,0.7272,0.7327,0.7269,0.7327
2023-10-18 17:25,297,200,97,25182,18360,6822,18366344.0,13367863.0,4998481.0,296,199,97,25528,18483,7045,18619202.0,13456479.0,5162723.0,0.7281,0.7327,0.728,0.7328
2023-10-18 17:30,629,294,335,54885,33838,21047,40116563.0,24682586.0,15433977.0,620,289,331,54315,33251,21064,39667460.0,24220033.0,15447426.0,0.7294,0.7333,0.7284,0.7334
2023-10-18 17:35,1164,611,553,101486,66635,34851,74049695.0,48568451.0,25481243.0,1137,594,543,100009,66066,33943,73045652.0,48153630.0,24892021.0,0.7289,0.7311,0.7289,0.7333
2023-10-18 17:40,238,112,126,22177,14789,7388,16186524.0,10775589.0,5410934.0,227,108,119,20629,14498,6131,15058607.0,10563697.0,4494909.0,0.7286,0.7324,0.7286,0.7331
2023-10-18 17:45,212,98,114,19198,11435,7763,14030702.0,8340890.0,5689812.0,206,95,111,19251,11597,7654,14068149.0,8457533.0,5610616.0,0.7294,0.7329,0.7293,0.733
2023-10-18 17:50,149,84,65,15782,10949,4833,11517821.0,7979155.0,3538666.0,136,75,61,14065,10089,3976,10263220.0,7351214.0,2912006.0,0.7288,0.7322,0.7286,0.7324
2023-10-18 17:55,776,198,578,57745,29354,28391,42205912.0,21408301.0,20797610.0,775,193,582,58258,29326,28932,42587024.0,21387209.0,21199814.0,0.7293,0.7325,0.7293,0.7327
2023-10-18 18:00,631,298,333,62445,40849,21596,45549229.0,29735092.0,15814137.0,629,296,333,63145,41466,21679,46040122.0,30164937.0,15875185.0,0.7279,0.7323,0.7275,0.7323
2023-10-18 18:05,77,48,29,9285,7136,2149,6774238.0,5202751.0,1571487.0,75,47,28,9211,7006,2205,6719690.0,5104280.0,1615409.0,0.7291,0.7313,0.7286,0.7326
2023-10-18 18:10,232,108,124,23048,13971,9077,16815313.0,10169524.0,6645789.0,224,103,121,23210,14063,9147,16935526.0,10237639.0,6697887.0,0.7279,0.7322,0.728,0.7322
2023-10-18 18:15,176,52,124,13015,8310,4705,9466077.0,6030978.0,3435098.0,165,49,116,10909,6588,4321,7941149.0,4781303.0,3159845.0,0.7257,0.7301,0.7258,0.7313
2023-10-18 18:20,732,225,507,67901,43509,24392,49507022.0,31658305.0,17848716.0,740,230,510,69984,44383,25601,51040546.0,32292506.0,18748039.0,0.7276,0.7317,0.7276,0.7323
2023-10-18 18:25,792,399,393,110731,84466,26265,80681768.0,61424967.0,19256800.0,788,395,393,110205,84010,26195,80296627.0,61090928.0,19205699.0,0.7272,0.7332,0.7272,0.7332
2023-10-18 18:30,457,149,308,52012,33476,18536,37897911.0,24311746.0,13586164.0,457,149,308,51999,33467,18532,37887929.0,24304717.0,13583212.0,0.7262,0.733,0.7262,0.733
2023-10-18 18:35,364,216,148,54741,43806,10935,39860791.0,31848266.0,8012524.0,357,214,143,54532,43888,10644,39688482.0,31889137.0,7799344.0,0.727,0.7327,0.7266,0.7327
2023-10-19 10:00,3408,1805,1603,309127,197570,111557,224220458.0,142623341.0,81597116.0,3077,1628,1449,286158,181327,104831,208079884.0,131570038.0,76509846.0,0.7219,0.7314,0.7256,0.7298
2023-10-19 10:05,407,145,262,27337,8780,18557,19857040.0,6328394.0,13528646.0,336,112,224,25757,7950,17807,18732075.0,5751877.0,12980198.0,0.7208,0.729,0.7235,0.7289
2023-10-19 10:10,1236,613,623,100857,60666,40191,73390446.0,43974351.0,29416095.0,1172,573,599,98033,58577,39456,71357561.0,42518872.0,28838688.0,0.7249,0.7319,0.7259,0.7309
2023-10-19 10:15,2664,1582,1082,274678,188272,86406,200457984.0,137168116.0,63289868.0,2507,1508,999,269986,186275,83711,196975194.0,135701547.0,61273647.0,0.7286,0.7325,0.7285,0.732
2023-10-19 10:20,1061,720,341,80474,55070,25404,58287245.0,40010421.0,18276824.0,1009,689,320,74222,51608,22614,54069499.0,37543872.0,16525626.0,0.7265,0.7194,0.7275,0.7308
2023-10-19 10:25,1062,583,479,81993,47093,34900,59665373.0,34218491.0,25446881.0,1021,558,463,80282,46084,34198,58376656.0,33413021.0,24963635.0,0.7266,0.7291,0.725,0.73
2023-10-19 10:30,750,421,329,58196,40934,17262,42289496.0,29685654.0,12603842.0,711,398,313,53383,36203,17180,38902344.0,26343387.0,12558957.0,0.7252,0.7301,0.7277,0.731
2023-10-19 10:35,932,521,411,76042,55082,20960,55420343.0,40104628.0,15315715.0,900,503,397,74586,54164,20422,54356700.0,39418947.0,14937753.0,0.7281,0.7307,0.7278,0.7315
2023-10-19 10:40,704,524,180,56564,47517,9047,41153445.0,34552619.0,6600825.0,682,514,168,56626,48094,8532,41230101.0,34979414.0,6250687.0,0.7272,0.7296,0.7273,0.7326
2023-10-19 10:45,538,362,176,30314,15945,14369,22034231.0,11549506.0,10484724.0,512,351,161,29249,15782,13467,21264538.0,11437111.0,9827426.0,0.7243,0.7297,0.7247,0.7297
2023-10-19 10:50,188,115,73,10425,7432,2993,7533274.0,5375426.0,2157848.0,167,105,62,10042,7247,2795,7278145.0,5237476.0,2040668.0,0.7233,0.721,0.7227,0.7301
2023-10-19 10:55,329,262,67,15706,11211,4495,11416229.0,8135038.0,3281191.0,314,254,60,15341,11151,4190,11149225.0,8093438.0,3055786.0,0.7256,0.73,0.7258,0.7293
2023-10-19 11:00,220,109,111,15059,6225,8834,10952086.0,4522822.0,6429263.0,195,97,98,13564,5318,8246,9871603.0,3857041.0,6014562.0,0.7266,0.7278,0.7253,0.7294
2023-10-19 11:05,142,54,88,14594,3653,10941,10613797.0,2650077.0,7963720.0,121,43,78,13269,3683,9586,9656274.0,2669733.0,6986541.0,0.7255,0.7279,0.7249,0.7288
2023-10-19 11:10,446,276,170,41705,25893,15812,30273704.0,18749662.0,11524041.0,415,262,153,40741,25579,15162,29547102.0,18494448.0,11052653.0,0.7241,0.7288,0.723,0.729
2023-10-19 11:15,278,182,96,19787,13673,6114,14351726.0,9897795.0,4453930.0,234,148,86,18634,12407,6227,13522542.0,8981525.0,4541016.0,0.7239,0.7285,0.7239,0.7292
2023-10-19 11:20,355,132,223,26009,9649,16360,18915317.0,6990512.0,11924805.0,329,110,219,25133,9647,15486,18271221.0,6983901.0,11287319.0,0.7245,0.7289,0.7239,0.7289
2023-10-19 11:25,527,175,352,32472,17117,15355,23635321.0,12451712.0,11183609.0,496,157,339,31841,16570,15271,23153506.0,12031455.0,11122050.0,0.7274,0.7283,0.7261,0.7283
2023-10-19 11:30,879,359,520,47331,22016,25315,34447894.0,15984883.0,18463011.0,859,347,512,46580,21286,25294,33905766.0,15455746.0,18450020.0,0.7261,0.7293,0.7261,0.7294
2023-10-19 11:35,297,168,129,24131,17830,6301,17548548.0,12948360.0,4600187.0,289,161,128,24473,18064,6409,17798968.0,13120971.0,4677997.0,0.7262,0.7301,0.7264,0.7299
2023-10-19 11:40,295,140,155,22749,11850,10899,16566662.0,8609660.0,7957001.0,287,135,152,22385,11555,10830,16302344.0,8394932.0,7907411.0,0.7266,0.7301,0.7265,0.7301
2023-10-19 11:45,251,60,191,30215,8245,21970,21793345.0,5777606.0,16015738.0,238,54,184,29915,7410,22505,21739111.0,5333988.0,16405123.0,0.7007,0.729,0.7198,0.729
2023-10-19 11:50,465,130,335,27678,9723,17955,20130336.0,7046175.0,13084160.0,458,124,334,27312,9372,17940,19861270.0,6787254.0,13074015.0,0.7247,0.7287,0.7242,0.7288
2023-10-19 11:55,477,55,422,17001,6491,10510,12415730.0,4714338.0,7701392.0,464,48,416,15930,6623,9307,11582225.0,4807242.0,6774983.0,0.7263,0.7328,0.7258,0.7279
2023-10-19 12:00,410,209,201,17318,11765,5553,12602512.0,8544343.0,4058169.0,403,205,198,16797,11459,5338,12211003.0,8321043.0,3889960.0,0.7263,0.7308,0.7262,0.7287
2023-10-19 12:05,463,347,116,24262,14965,9297,17650007.0,10870658.0,6779349.0,449,343,106,24069,15146,8923,17510522.0,11002331.0,6508190.0,0.7264,0.7292,0.7264,0.7294
2023-10-19 12:10,70,39,31,4767,2702,2065,3496066.0,1983260.0,1512805.0,65,38,27,4689,2658,2031,3420946.0,1932107.0,1488839.0,0.734,0.7326,0.7269,0.7331
2023-10-19 12:15,400,129,271,19818,12105,7713,14370795.0,8804496.0,5566298.0,380,114,266,17975,10955,7020,13087759.0,7966265.0,5121494.0,0.7273,0.7217,0.7272,0.7296
2023-10-19 12:20,822,357,465,77904,59879,18025,56492208.0,43335497.0,13156710.0,813,352,461,77948,59832,18116,56524208.0,43301188.0,13223020.0,0.7237,0.7299,0.7237,0.7299
2023-10-19 12:25,242,144,98,22734,18421,4313,16533311.0,13380923.0,3152387.0,231,137,94,20345,16077,4268,14798810.0,11681024.0,3117786.0,0.7264,0.7309,0.7266,0.7305
2023-10-19 12:30,294,189,105,16908,13605,3303,12324572.0,9908090.0,2416481.0,274,173,101,15424,12459,2965,11229885.0,9061266.0,2168618.0,0.7283,0.7316,0.7273,0.7314
2023-10-19 12:35,135,61,74,10098,4776,5322,7362493.0,3479297.0,3883195.0,121,53,68,10298,5328,4970,7472809.0,3837667.0,3635142.0,0.7285,0.7296,0.7203,0.7314
2023-10-19 12:40,434,146,288,25020,9554,15466,18303111.0,6988058.0,11315052.0,389,112,277,21531,6839,14692,15734068.0,4985102.0,10748966.0,0.7314,0.7316,0.7289,0.7316
2023-10-19 12:45,389,213,176,25395,13918,11477,18859012.0,10455405.0,8403606.0,358,193,165,24219,13534,10685,17975420.0,10147159.0,7828261.0,0.7512,0.7322,0.7498,0.7326
2023-10-19 12:50,230,130,100,16983,6122,10861,12820382.0,4517454.0,8302928.0,200,112,88,16051,5856,10195,11752694.0,4275139.0,7477554.0,0.7379,0.7645,0.73,0.7335
2023-10-19 12:55,150,100,50,14188,8413,5775,10463827.0,6228117.0,4235710.0,144,96,48,15726,10184,5542,11298714.0,7233471.0,4065242.0,0.7403,0.7335,0.7103,0.7335
2023-10-19 13:00,555,224,331,46059,17077,28982,33726030.0,12479744.0,21246285.0,529,218,311,43627,16350,27277,31944614.0,11942259.0,20002355.0,0.7308,0.7331,0.7304,0.7333
2023-10-19 13:05,69,30,39,4636,2249,2387,3387679.0,1634319.0,1753359.0,63,27,36,3734,1808,1926,2717531.0,1306138.0,1411393.0,0.7267,0.7345,0.7224,0.7328
2023-10-19 13:10,705,371,334,58787,42643,16144,42968262.0,31150632.0,11817630.0,693,369,324,58109,42902,15207,42465921.0,31337589.0,11128332.0,0.7305,0.732,0.7304,0.7318
2023-10-19 13:15,285,149,136,29483,21422,8061,21550382.0,15643360.0,5907022.0,273,143,130,26775,19172,7603,19562377.0,13994656.0,5567721.0,0.7302,0.7328,0.73,0.7323
2023-10-19 13:20,608,352,256,51743,37291,14452,37908629.0,27176913.0,10731715.0,588,334,254,50591,35381,15210,37154192.0,25849581.0,11304611.0,0.7288,0.7426,0.7306,0.7432
2023-10-19 13:25,315,188,127,32041,25851,6190,23422076.0,18888384.0,4533692.0,304,182,122,31839,25736,6103,23274978.0,18801731.0,4473247.0,0.7307,0.7324,0.7306,0.733
2023-10-19 13:30,170,106,64,11543,8360,3183,8436334.0,6108477.0,2327857.0,157,102,55,11568,8497,3071,8461472.0,6208556.0,2252916.0,0.7307,0.7313,0.7307,0.7336
2023-10-19 13:35,411,253,158,38186,29773,8413,27990783.0,21831515.0,6159268.0,394,246,148,37137,29096,8041,27167321.0,21268448.0,5898873.0,0.7333,0.7321,0.731,0.7336
2023-10-19 13:40,173,93,80,18152,14015,4137,13287727.0,10248000.0,3039727.0,163,91,72,19002,14728,4274,13878188.0,10738053.0,3140134.0,0.7312,0.7348,0.7291,0.7347
2023-10-19 13:45,639,383,256,54641,32072,22569,40814408.0,23489377.0,17325030.0,596,356,240,51445,30262,21183,38450238.0,22142725.0,16307512.0,0.7324,0.7676,0.7317,0.7698
2023-10-19 13:50,424,242,182,48150,38387,9763,35252912.0,28077621.0,7175290.0,405,230,175,46955,37655,9300,34367921.0,27532277.0,6835644.0,0.7314,0.7349,0.7312,0.735
2023-10-19 13:55,762,380,382,53021,31029,21992,38924884.0,22840697.0,16084186.0,715,358,357,50403,29593,20810,36969036.0,21654717.0,15314318.0,0.7361,0.7314,0.7318,0.7359
2023-10-19 14:00,598,323,275,52806,36794,16012,38706102.0,26932409.0,11773692.0,574,310,264,55157,39215,15942,40400669.0,28675468.0,11725200.0,0.732,0.7353,0.7312,0.7355
2023-10-19 14:05,1237,631,606,109613,68365,41248,80307149.0,50004153.0,30302996.0,1193,610,583,105782,67287,38495,77491562.0,49216792.0,28274770.0,0.7314,0.7347,0.7314,0.7345
2023-10-19 14:10,546,289,257,54712,34199,20513,40040536.0,24983666.0,15056870.0,530,277,253,54406,33877,20529,39819561.0,24754623.0,15064938.0,0.7305,0.734,0.7307,0.7338
2023-10-19 14:15,1122,292,830,80082,21126,58956,58685601.0,15442368.0,43243233.0,1092,278,814,79232,20851,58381,58082375.0,15235034.0,42847341.0,0.731,0.7335,0.7307,0.7339
2023-10-19 14:20,528,191,337,26929,8601,18328,19659732.0,6286080.0,13373651.0,499,171,328,25579,7677,17902,18730431.0,5604760.0,13125670.0,0.7309,0.7297,0.7301,0.7332
2023-10-19 14:25,535,335,200,29721,15002,14719,21738177.0,10963543.0,10774634.0,523,324,199,28902,14457,14445,21159340.0,10563774.0,10595565.0,0.7308,0.732,0.7307,0.7335
2023-10-19 14:30,355,95,260,20071,9117,10954,14635628.0,6633830.0,8001798.0,353,92,261,20473,8819,11654,14994431.0,6442189.0,8552241.0,0.7276,0.7305,0.7305,0.7338
2023-10-19 14:35,450,217,233,18263,10708,7555,13360838.0,7827845.0,5532993.0,445,213,232,18172,10490,7682,13293740.0,7668223.0,5625516.0,0.731,0.7324,0.731,0.7323
2023-10-19 14:40,277,125,152,19987,7436,12551,14624325.0,5437124.0,9187201.0,253,109,144,19231,7084,12147,14076266.0,5173116.0,8903150.0,0.7312,0.732,0.7303,0.733
2023-10-19 14:45,592,156,436,38419,10606,27813,28158021.0,7750011.0,20408009.0,588,152,436,38560,10460,28100,28260591.0,7641916.0,20618674.0,0.7307,0.7338,0.7306,0.7338
2023-10-19 14:50,509,143,366,37563,16921,20642,27489036.0,12362773.0,15126262.0,501,143,358,36803,16670,20133,26942557.0,12179446.0,14763110.0,0.7306,0.7328,0.7306,0.7333
2023-10-19 14:55,183,114,69,15680,11073,4607,11463992.0,8088808.0,3375183.0,164,100,64,15493,10873,4620,11329542.0,7941903.0,3387639.0,0.7305,0.7326,0.7304,0.7333
2023-10-19 15:00,126,46,80,7858,2561,5297,5757339.0,1871477.0,3885861.0,119,42,77,7626,2398,5228,5587070.0,1751905.0,3835164.0,0.7308,0.7336,0.7306,0.7336
2023-10-19 15:05,56,27,29,2394,1411,983,1751420.0,1032628.0,718791.0,47,20,27,2189,1390,799,1601835.0,1015729.0,586106.0,0.7318,0.7312,0.7307,0.7335
2023-10-19 15:10,447,200,247,36847,14372,22475,27082859.0,10582943.0,16499916.0,432,193,239,35692,13687,22005,26159439.0,10004573.0,16154866.0,0.7364,0.7341,0.731,0.7341
2023-10-19 15:15,363,151,212,27187,10777,16410,19907985.0,7883936.0,12024048.0,357,152,205,26100,10403,15697,19133577.0,7607035.0,11526542.0,0.7316,0.7327,0.7312,0.7343
2023-10-19 15:20,857,351,506,46523,16646,29877,34075652.0,12188222.0,21887429.0,792,296,496,44856,15471,29385,32862555.0,11308491.0,21554064.0,0.7322,0.7326,0.7309,0.7335
2023-10-19 15:25,954,426,528,61311,35332,25979,45156868.0,26054097.0,19102771.0,894,385,509,58644,33848,24796,42935588.0,24702786.0,18232801.0,0.7374,0.7353,0.7298,0.7353
2023-10-19 15:30,807,461,346,55456,41847,13609,40696902.0,30681529.0,10015373.0,777,450,327,56357,43762,12595,41343865.0,32071502.0,9272362.0,0.7332,0.7359,0.7329,0.7362
2023-10-19 15:35,247,167,80,14472,9267,5205,10622668.0,6792250.0,3830417.0,227,154,73,14341,10120,4221,10517774.0,7409500.0,3108274.0,0.733,0.7359,0.7322,0.7364
2023-10-19 15:40,1525,1093,432,106321,90121,16200,78064753.0,66141868.0,11922885.0,1497,1074,423,103861,89556,14305,76178223.0,65641801.0,10536421.0,0.7339,0.736,0.733,0.7366
2023-10-19 15:45,344,219,125,25451,19316,6135,18613103.0,14062093.0,4551010.0,321,209,112,22730,17293,5437,16693024.0,12687213.0,4005811.0,0.728,0.7418,0.7337,0.7368
2023-10-19 15:50,952,630,322,90799,74369,16430,66621642.0,54543235.0,12078407.0,927,618,309,89526,73885,15641,65715265.0,54186198.0,11529067.0,0.7334,0.7351,0.7334,0.7371
2023-10-19 15:55,826,634,192,69635,58612,11023,51116156.0,42998862.0,8117293.0,803,619,184,67329,56848,10481,49423915.0,41701593.0,7722321.0,0.7336,0.7364,0.7336,0.7368
2023-10-19 16:00,260,159,101,15928,10674,5254,11783038.0,7902909.0,3880129.0,228,134,94,15006,10045,4961,11023576.0,7365922.0,3657654.0,0.7404,0.7385,0.7333,0.7373
2023-10-19 16:05,2400,1171,1229,190192,109362,80830,142376778.0,82388668.0,59988109.0,1932,1004,928,165696,94673,71023,122686666.0,69871732.0,52814934.0,0.7534,0.7422,0.738,0.7436
2023-10-19 16:10,1281,754,527,119786,89146,30640,89277920.0,65960076.0,23317843.0,1131,680,451,110719,87728,22991,82002427.0,64825626.0,17176800.0,0.7399,0.761,0.7389,0.7471
2023-10-19 16:15,825,471,354,45327,32411,12916,33512877.0,23974615.0,9538262.0,728,421,307,40735,28939,11796,30140955.0,21378925.0,8762030.0,0.7397,0.7385,0.7388,0.7428
2023-10-19 16:20,1928,1345,583,150103,124001,26102,113518909.0,92141648.0,21377261.0,1671,1171,500,138714,116850,21864,104817277.0,86510995.0,18306282.0,0.7431,0.819,0.7404,0.8373
2023-10-19 16:25,1642,1036,606,120353,97684,22669,89468558.0,72574732.0,16893826.0,1378,893,485,111310,91231,20079,82598774.0,67612963.0,14985810.0,0.743,0.7452,0.7411,0.7463
2023-10-19 16:30,1578,1180,398,141855,119124,22731,105602510.0,88737056.0,16865454.0,1334,1073,261,125152,109651,15501,93047669.0,81436419.0,11611250.0,0.7449,0.742,0.7427,0.7491
2023-10-19 16:35,836,307,529,52301,19673,32628,38862123.0,14609739.0,24252383.0,764,268,496,50267,21522,28745,37408924.0,15953837.0,21455087.0,0.7426,0.7433,0.7413,0.7464
2023-10-19 16:40,1130,370,760,81800,20288,61512,61322337.0,15663725.0,45658611.0,992,285,707,73030,15434,57596,54192982.0,11301458.0,42891523.0,0.7721,0.7423,0.7322,0.7447
2023-10-19 16:45,878,308,570,49985,17541,32444,37265894.0,13084522.0,24181371.0,778,256,522,48036,16939,31097,35713112.0,12524296.0,23188816.0,0.7459,0.7453,0.7394,0.7457
2023-10-19 16:50,1226,520,706,84928,32649,52279,63342360.0,24343348.0,38999012.0,1118,467,651,74970,30043,44927,55808516.0,22241539.0,33566977.0,0.7456,0.746,0.7403,0.7471
2023-10-19 16:55,492,258,234,27455,14443,13012,20275829.0,10711278.0,9564551.0,440,224,216,27272,12585,14687,20291648.0,9330622.0,10961026.0,0.7416,0.7351,0.7414,0.7463
2023-10-19 17:00,811,547,264,40740,28186,12554,30270722.0,20946779.0,9323942.0,762,522,240,41948,30875,11073,31138385.0,22885657.0,8252727.0,0.7432,0.7427,0.7412,0.7453
2023-10-19 17:05,495,186,309,39982,13071,26911,29756577.0,9766743.0,19989834.0,446,163,283,35625,10806,24819,26475716.0,7992161.0,18483555.0,0.7472,0.7428,0.7396,0.7447
2023-10-19 17:10,1508,975,533,93560,54259,39301,69980716.0,40641956.0,29338759.0,1258,812,446,79246,44227,35019,59048691.0,32843269.0,26205421.0,0.749,0.7465,0.7426,0.7483
2023-10-19 17:15,1458,656,802,112676,47495,65181,83590014.0,35588977.0,48001037.0,1183,518,665,88862,36630,52232,66337950.0,27192898.0,39145052.0,0.7493,0.7364,0.7424,0.7494
2023-10-19 17:20,1060,493,567,72134,25583,46551,53805437.0,19094733.0,34710704.0,937,420,517,68201,24628,43573,50840791.0,18294102.0,32546688.0,0.7464,0.7456,0.7428,0.7469
2023-10-19 17:25,804,400,404,58448,20223,38225,43434807.0,15010919.0,28423888.0,697,323,374,53910,17136,36774,40130520.0,12679300.0,27451219.0,0.7423,0.7436,0.7399,0.7465
2023-10-19 17:30,1005,336,669,77806,21431,56375,57908245.0,15978166.0,41930079.0,919,291,628,73193,18589,54604,54505961.0,13788929.0,40717031.0,0.7456,0.7438,0.7418,0.7457
2023-10-19 17:35,462,75,387,17297,4633,12664,12969605.0,3488761.0,9480844.0,427,50,377,15929,3904,12025,11864719.0,2899955.0,8964764.0,0.753,0.7486,0.7428,0.7455
2023-10-19 17:40,672,394,278,14410,5191,9219,10717372.0,3871747.0,6845625.0,620,364,256,13473,4752,8721,10023692.0,3521648.0,6502043.0,0.7459,0.7426,0.7411,0.7456
2023-10-19 17:45,256,129,127,14768,8169,6599,10966664.0,6041756.0,4924908.0,226,111,115,12810,7454,5356,9513700.0,5515387.0,3998313.0,0.7396,0.7463,0.7399,0.7465
2023-10-19 17:50,282,191,91,7639,4705,2934,5674671.0,3488609.0,2186061.0,260,182,78,6713,4032,2681,4980127.0,2980766.0,1999361.0,0.7415,0.7451,0.7393,0.7458
2023-10-19 17:55,75,39,36,4910,3560,1350,3678311.0,2667461.0,1010849.0,52,28,24,3855,3121,734,2858624.0,2309732.0,548892.0,0.7493,0.7488,0.7401,0.7478
2023-10-19 18:00,671,112,559,70891,13235,57656,51871677.0,9798153.0,42073524.0,589,54,535,53580,7034,46546,39793018.0,5157791.0,34635227.0,0.7403,0.7297,0.7333,0.7441
2023-10-19 18:05,391,113,278,32781,5730,27051,24348851.0,4248541.0,20100310.0,317,77,240,30781,5072,25709,22858017.0,3738450.0,19119567.0,0.7415,0.7431,0.7371,0.7437
2023-10-19 18:10,276,100,176,19349,5869,13480,14570483.0,4562796.0,10007687.0,222,66,156,16570,3516,13054,12315889.0,2600178.0,9715711.0,0.7774,0.7424,0.7395,0.7443
2023-10-19 18:15,319,134,185,19557,8637,10920,14528530.0,6403172.0,8125358.0,299,121,178,17669,8068,9601,13115817.0,5974214.0,7141602.0,0.7414,0.7441,0.7405,0.7438
2023-10-19 18:20,1513,798,715,127390,76816,50574,94700930.0,57089887.0,37611043.0,1488,786,702,125710,75532,50178,93350655.0,56005597.0,37345057.0,0.7432,0.7437,0.7415,0.7443
2023-10-19 18:25,429,248,181,59475,48213,11262,44114906.0,35724577.0,8390328.0,409,234,175,49449,38103,11346,36686835.0,28231925.0,8454910.0,0.741,0.745,0.7409,0.7452
2023-10-19 18:30,232,104,128,15179,6635,8544,11323704.0,4949679.0,6374024.0,180,72,108,12747,5022,7725,9498579.0,3730566.0,5768013.0,0.746,0.746,0.7428,0.7467
2023-10-19 18:35,533,180,353,39621,17066,22555,29445999.0,12697696.0,16748302.0,495,168,327,47564,27090,20474,35341928.0,20066297.0,15275630.0,0.744,0.7426,0.7407,0.7461
2023-10-20 10:00,1404,790,614,100349,57924,42425,75645988.0,43651884.0,31994104.0,945,536,409,73019,43063,29956,54358955.0,31940403.0,22418551.0,0.7536,0.7541,0.7417,0.7484
2023-10-20 10:05,1074,443,631,85007,36376,48631,63120533.0,26907442.0,36213091.0,956,382,574,79189,33255,45934,58867550.0,24622034.0,34245515.0,0.7397,0.7447,0.7404,0.7455
2023-10-20 10:10,1436,564,872,118070,41511,76559,87761307.0,30739996.0,57021311.0,1350,526,824,117617,42110,75507,87437740.0,31179792.0,56257948.0,0.7405,0.7448,0.7404,0.7451
2023-10-20 10:15,1260,401,859,101785,26478,75307,75714238.0,19588431.0,56125807.0,1107,324,783,99470,25347,74123,73997890.0,18767493.0,55230397.0,0.7398,0.7453,0.7404,0.7451
2023-10-20 10:20,1090,552,538,83864,34994,48870,62415367.0,25997644.0,36417722.0,1019,511,508,80860,33025,47835,60143814.0,24473516.0,35670297.0,0.7429,0.7452,0.7411,0.7457
2023-10-20 10:25,568,273,295,39152,13513,25639,29157650.0,10022143.0,19135507.0,529,254,275,38178,13310,24868,28426911.0,9865008.0,18561903.0,0.7417,0.7463,0.7412,0.7464
2023-10-20 10:30,873,586,287,43098,10572,32526,32136590.0,7829647.0,24306943.0,833,567,266,41587,10143,31444,31017990.0,7510779.0,23507210.0,0.7406,0.7473,0.7405,0.7476
2023-10-20 10:35,252,87,165,19691,7750,11941,14534877.0,5740366.0,8794510.0,213,77,136,17951,7286,10665,13310824.0,5374228.0,7936595.0,0.7407,0.7365,0.7376,0.7442
2023-10-20 10:40,870,517,353,69288,41783,27505,51534837.0,31027578.0,20507259.0,763,462,301,64489,39105,25384,47970086.0,28971600.0,18998486.0,0.7426,0.7456,0.7409,0.7484
2023-10-20 10:45,4194,1848,2346,306758,172014,134744,232652782.0,131490613.0,101162168.0,3009,1371,1638,229617,129262,100355,173862834.0,98048063.0,75814771.0,0.7644,0.7508,0.7585,0.7555
2023-10-20 10:50,2342,1059,1283,145377,71659,73718,109338858.0,54059663.0,55279194.0,2045,921,1124,134054,67763,66291,100800094.0,50767876.0,50032218.0,0.7544,0.7499,0.7492,0.7547
2023-10-20 10:55,1809,1011,798,108491,69668,38823,81945242.0,52465651.0,29479591.0,1495,835,660,86282,57326,28956,66241005.0,44314836.0,21926168.0,0.7531,0.7593,0.773,0.7572
2023-10-20 11:00,1559,589,970,94837,37465,57372,71971162.0,28840047.0,43131114.0,1299,478,821,83880,34696,49184,63923150.0,26687140.0,37236010.0,0.7698,0.7518,0.7692,0.7571
2023-10-20 11:05,1690,961,729,137970,102621,35349,104276913.0,77577731.0,26699181.0,1539,888,651,130159,97771,32388,98092393.0,73601643.0,24490750.0,0.756,0.7553,0.7528,0.7562
2023-10-20 11:10,1442,842,600,106662,78323,28339,80171548.0,58901058.0,21270490.0,1324,775,549,100990,76061,24929,75994995.0,57176561.0,18818433.0,0.752,0.7506,0.7517,0.7549
2023-10-20 11:15,414,255,159,19664,10023,9641,14750298.0,7492616.0,7257681.0,357,244,113,17326,11030,6296,13017883.0,8238688.0,4779195.0,0.7475,0.7528,0.7469,0.7591
2023-10-20 11:20,266,148,118,14742,8421,6321,11094312.0,6315943.0,4778369.0,193,117,76,12951,8369,4582,9709170.0,6255819.0,3453351.0,0.75,0.756,0.7475,0.7537
2023-10-20 11:25,245,109,136,16629,9824,6805,12506086.0,7380483.0,5125602.0,174,78,96,13531,7370,6161,10150156.0,5505122.0,4645034.0,0.7513,0.7532,0.747,0.7539
2023-10-20 11:30,533,137,396,27687,12936,14751,20874000.0,9746062.0,11127938.0,466,103,363,22196,10727,11469,16722761.0,8059041.0,8663720.0,0.7534,0.7544,0.7513,0.7554
2023-10-20 11:35,448,130,318,23004,11077,11927,17364908.0,8364373.0,9000535.0,389,105,284,20158,8865,11293,15179711.0,6644916.0,8534795.0,0.7551,0.7546,0.7496,0.7558
2023-10-20 11:40,548,248,300,36273,19572,16701,27243986.0,14712876.0,12531110.0,474,217,257,35633,20799,14834,26824111.0,15600890.0,11223221.0,0.7517,0.7503,0.7501,0.7566
2023-10-20 11:45,325,149,176,22909,11706,11203,17283821.0,8806720.0,8477101.0,279,126,153,21491,11832,9659,16186123.0,8891515.0,7294608.0,0.7523,0.7567,0.7515,0.7552
2023-10-20 11:50,520,269,251,41350,26678,14672,31331832.0,20238374.0,11093457.0,433,234,199,35969,23510,12459,27091742.0,17672641.0,9419101.0,0.7586,0.7561,0.7517,0.756
2023-10-20 11:55,1336,801,535,113456,88355,25101,85365973.0,66512150.0,18853822.0,1234,757,477,108127,85950,22177,81390416.0,64607896.0,16782520.0,0.7528,0.7511,0.7517,0.7568
2023-10-20 12:00,1897,1216,681,155473,115312,40161,118393677.0,87881684.0,30511992.0,1524,1037,487,123968,95040,28928,93713781.0,71673949.0,22039831.0,0.7621,0.7597,0.7541,0.7619
2023-10-20 12:05,2373,1253,1120,189803,98558,91245,143623267.0,74418969.0,69204298.0,2123,1115,1008,176403,92869,83534,133646774.0,70027537.0,63619237.0,0.7551,0.7584,0.754,0.7616
2023-10-20 12:10,1644,853,791,125640,66266,59374,94834485.0,50004645.0,44829839.0,1545,794,751,122526,65633,56893,92690975.0,49478132.0,43212843.0,0.7546,0.755,0.7539,0.7595
2023-10-20 12:15,1635,538,1097,120416,35446,84970,90861508.0,26639382.0,64222126.0,1472,457,1015,110726,30428,80298,83682458.0,22869354.0,60813103.0,0.7515,0.7558,0.7516,0.7573
2023-10-20 12:20,1048,343,705,101454,27663,73791,76397394.0,20796567.0,55600826.0,941,282,659,91189,23030,68159,68862313.0,17290779.0,51571533.0,0.7518,0.7535,0.7508,0.7566
2023-10-20 12:25,1103,559,544,72830,13132,59698,54846773.0,9861525.0,44985248.0,1055,543,512,65283,15826,49457,49181451.0,11855116.0,37326335.0,0.751,0.7535,0.7491,0.7547
2023-10-20 12:30,459,103,356,24291,8742,15549,18258442.0,6557771.0,11700671.0,415,83,332,21937,8150,13787,16505232.0,6109618.0,10395613.0,0.7501,0.7525,0.7496,0.754
2023-10-20 12:35,943,459,484,64469,35751,28718,48610130.0,27030484.0,21579646.0,872,423,449,60270,33490,26780,45413655.0,25194776.0,20218878.0,0.7561,0.7514,0.7523,0.755
2023-10-20 12:40,1187,349,838,57954,20021,37933,43216915.0,14969518.0,28247396.0,1037,285,752,50524,17435,33089,37931107.0,13025036.0,24906070.0,0.7477,0.7447,0.7471,0.7527
2023-10-20 12:45,708,419,289,19368,9353,10015,14421775.0,6974410.0,7447365.0,660,393,267,18032,8692,9340,13508883.0,6491884.0,7016998.0,0.7457,0.7436,0.7469,0.7513
2023-10-20 12:50,1020,554,466,102356,81402,20954,76732689.0,60985476.0,15747213.0,974,521,453,99976,78987,20989,74943114.0,59152590.0,15790523.0,0.7492,0.7515,0.7489,0.7523
2023-10-20 12:55,1102,527,575,85020,61590,23430,63840490.0,46153428.0,17687061.0,1052,507,545,81914,61102,20812,61424430.0,45723391.0,15701039.0,0.7494,0.7549,0.7483,0.7544
2023-10-20 13:00,1351,748,603,109985,84574,25411,82385111.0,63312931.0,19072179.0,1288,730,558,108129,83663,24466,81069319.0,62623237.0,18446081.0,0.7486,0.7505,0.7485,0.7539
2023-10-20 13:05,1208,534,674,76938,49808,27130,57647507.0,37297432.0,20350075.0,1174,516,658,77960,49413,28547,58481244.0,37001460.0,21479784.0,0.7488,0.7501,0.7488,0.7524
2023-10-20 13:10,1011,472,539,84525,59972,24553,63322381.0,44902232.0,18420148.0,948,442,506,81965,58537,23428,61426652.0,43816857.0,17609795.0,0.7487,0.7502,0.7485,0.7517
2023-10-20 13:15,769,415,354,71014,45693,25321,53354456.0,34425581.0,18928875.0,689,374,315,66145,43470,22675,49607279.0,32549311.0,17057968.0,0.7534,0.7476,0.7488,0.7523
2023-10-20 13:20,657,378,279,45938,32285,13653,34440556.0,24179029.0,10261526.0,607,356,251,44408,31487,12921,33294345.0,23578587.0,9715757.0,0.7489,0.7516,0.7488,0.7519
2023-10-20 13:25,1059,710,349,67234,51446,15788,50425409.0,38599402.0,11826007.0,1029,684,345,66162,50869,15293,49624282.0,38119087.0,11505195.0,0.7503,0.7491,0.7494,0.7523
2023-10-20 13:30,252,143,109,18271,13718,4553,13751636.0,10317952.0,3433684.0,211,117,94,15556,11451,4105,11674060.0,8579175.0,3094885.0,0.7521,0.7542,0.7492,0.7539
2023-10-20 13:35,683,414,269,81619,67280,14339,61159098.0,50453442.0,10705655.0,659,403,256,80678,67111,13567,60523184.0,50305060.0,10218124.0,0.7499,0.7466,0.7496,0.7532
2023-10-20 13:40,434,140,294,31784,19091,12693,23924994.0,14386827.0,9538167.0,410,128,282,29234,17708,11526,21949740.0,13270584.0,8679155.0,0.7536,0.7515,0.7494,0.753
2023-10-20 13:45,416,254,162,51402,44173,7229,38535960.0,33106306.0,5429654.0,388,238,150,50256,44070,6186,37675425.0,33024812.0,4650612.0,0.7495,0.7511,0.7494,0.7518
2023-10-20 13:50,549,315,234,63433,52750,10683,47513839.0,39489345.0,8024494.0,531,306,225,62946,52677,10269,47159646.0,39443698.0,7715948.0,0.7486,0.7511,0.7488,0.7514
2023-10-20 13:55,258,148,110,23577,18362,5215,17662005.0,13779242.0,3882763.0,229,134,95,23943,18686,5257,17987346.0,13979792.0,4007554.0,0.7504,0.7445,0.7481,0.7623
2023-10-20 14:00,114,62,52,8103,4628,3475,6006705.0,3455498.0,2551207.0,97,56,41,6788,4501,2287,5076745.0,3356068.0,1720677.0,0.7467,0.7342,0.7456,0.7524
2023-10-20 14:05,239,85,154,14871,9322,5549,11132796.0,6968054.0,4164742.0,219,79,140,13221,7921,5300,9897072.0,5918316.0,3978756.0,0.7475,0.7505,0.7472,0.7507
2023-10-20 14:10,257,110,147,14674,9482,5192,10993608.0,7096282.0,3897325.0,235,99,136,16489,10888,5601,12354118.0,8137631.0,4216486.0,0.7484,0.7506,0.7474,0.7528
2023-10-20 14:15,410,265,145,24675,18001,6674,18529651.0,13512780.0,5016870.0,383,251,132,23983,17603,6380,17980883.0,13183386.0,4797496.0,0.7507,0.7517,0.7489,0.752
2023-10-20 14:20,381,216,165,34548,23757,10791,25953274.0,17805741.0,8147533.0,371,211,160,33510,23572,9938,25165659.0,17663603.0,7502055.0,0.7495,0.755,0.7493,0.7549
2023-10-20 14:25,736,456,280,81763,65788,15975,61292763.0,49275153.0,12017609.0,724,452,272,78847,65777,13070,59095043.0,49267316.0,9827726.0,0.749,0.7523,0.749,0.7519
2023-10-20 14:30,143,100,43,13391,11467,1924,10024348.0,8579514.0,1444834.0,124,86,38,15244,10729,4515,11433423.0,8029017.0,3404406.0,0.7482,0.751,0.7483,0.754
2023-10-20 14:35,275,102,173,20436,9466,10970,15466395.0,7085658.0,8380736.0,276,106,170,18267,9839,8428,13710544.0,7361911.0,6348632.0,0.7485,0.764,0.7482,0.7533
2023-10-20 14:40,554,151,403,33158,14306,18852,24872053.0,10710112.0,14161940.0,543,145,398,31767,13266,18501,23833379.0,9929397.0,13903981.0,0.7486,0.7512,0.7485,0.7515
2023-10-20 14:45,85,19,66,6314,1226,5088,4720275.0,914239.0,3806036.0,74,13,61,5900,981,4919,4428966.0,731427.0,3697539.0,0.7457,0.748,0.7456,0.7517
2023-10-20 14:50,651,168,483,47414,12243,35171,35508914.0,9159256.0,26349658.0,606,146,460,44028,11498,32530,33050844.0,8597638.0,24453205.0,0.7481,0.7492,0.7478,0.7517
2023-10-20 14:55,675,254,421,45721,17188,28533,34283137.0,12892385.0,21390751.0,638,235,403,43480,15939,27541,32615015.0,11920774.0,20694241.0,0.7501,0.7497,0.7479,0.7514
2023-10-20 15:00,301,129,172,16337,7685,8652,12179043.0,5714097.0,6464946.0,265,113,152,13819,6396,7423,10345133.0,4774663.0,5570470.0,0.7435,0.7472,0.7465,0.7504
2023-10-20 15:05,433,169,264,27050,12787,14263,20030840.0,9525763.0,10505076.0,335,117,218,21608,9116,12492,16160009.0,6781286.0,9378722.0,0.745,0.7365,0.7439,0.7508
2023-10-20 15:10,229,101,128,13668,7129,6539,10144585.0,5330248.0,4814337.0,185,71,114,11456,5927,5529,8536771.0,4404166.0,4132604.0,0.7477,0.7362,0.7431,0.7474
2023-10-20 15:15,110,54,56,5283,2717,2566,3944893.0,2022696.0,1922196.0,89,43,46,5759,3390,2369,4293039.0,2518200.0,1774838.0,0.7445,0.7491,0.7428,0.7492
2023-10-20 15:20,99,52,47,6094,3525,2569,4560792.0,2639279.0,1921513.0,82,44,38,5943,3645,2298,4434811.0,2714905.0,1719906.0,0.7487,0.748,0.7448,0.7484
2023-10-20 15:25,338,69,269,17201,6354,10847,12919259.0,4744888.0,8174371.0,321,62,259,16292,6320,9972,12169022.0,4711630.0,7457391.0,0.7468,0.7536,0.7455,0.7478
2023-10-20 15:30,542,317,225,22333,12567,9766,16640381.0,9370141.0,7270240.0,517,302,215,22600,12269,10331,16882697.0,9147079.0,7735617.0,0.7456,0.7444,0.7455,0.7488
2023-10-20 15:35,483,274,209,24878,14989,9889,18492734.0,11159242.0,7333492.0,463,262,201,23774,14641,9133,17728855.0,10898633.0,6830222.0,0.7445,0.7416,0.7444,0.7479
2023-10-20 15:40,375,281,94,10382,3576,6806,7748865.0,2664579.0,5084286.0,353,267,86,9683,3112,6571,7219179.0,2309642.0,4909537.0,0.7451,0.747,0.7422,0.7472
2023-10-20 15:45,161,117,44,4322,1830,2492,3231521.0,1368365.0,1863156.0,147,107,40,3962,1613,2349,2956790.0,1199647.0,1757143.0,0.7477,0.7477,0.7437,0.748
2023-10-20 15:50,101,62,39,3993,2365,1628,2982817.0,1767363.0,1215454.0,95,58,37,3303,1570,1733,2465128.0,1169797.0,1295331.0,0.7473,0.7466,0.7451,0.7475
2023-10-20 15:55,133,66,67,7307,2805,4502,5460292.0,2090773.0,3369518.0,118,58,60,5635,1793,3842,4212520.0,1335622.0,2876897.0,0.7454,0.7484,0.7449,0.7488
2023-10-20 16:00,225,154,71,10163,5620,4543,7599559.0,4197272.0,3402287.0,211,144,67,11246,6171,5075,8391317.0,4585158.0,3806158.0,0.7468,0.7489,0.743,0.75
2023-10-20 16:05,201,100,101,10028,4295,5733,7491901.0,3204681.0,4287220.0,196,98,98,9878,4284,5594,7382783.0,3196618.0,4186165.0,0.7461,0.7478,0.7462,0.7483
2023-10-20 16:10,77,53,24,3123,2184,939,2313748.0,1629857.0,683891.0,67,47,20,2761,1847,914,2063200.0,1376960.0,686240.0,0.7463,0.7283,0.7455,0.7508
2023-10-20 16:15,167,66,101,10161,2216,7945,7601488.0,1652348.0,5949140.0,161,62,99,9897,2104,7793,7404745.0,1569079.0,5835665.0,0.7456,0.7488,0.7458,0.7488
2023-10-20 16:20,125,72,53,5369,1606,3763,4027002.0,1211053.0,2815949.0,118,69,49,5072,1423,3649,3788975.0,1058204.0,2730771.0,0.7541,0.7483,0.7436,0.7484
2023-10-20 16:25,75,27,48,3238,842,2396,2406947.0,626470.0,1780477.0,67,25,42,3176,796,2380,2374346.0,592279.0,1782066.0,0.744,0.7431,0.7441,0.7488
2023-10-20 16:30,156,48,108,8513,1917,6596,6336119.0,1430239.0,4905879.0,142,42,100,7885,1715,6170,5891105.0,1276654.0,4614451.0,0.7461,0.7438,0.7444,0.7479
2023-10-20 16:35,115,51,64,6871,2093,4778,5062433.0,1556591.0,3505841.0,102,43,59,6256,1815,4441,4669455.0,1349578.0,3319877.0,0.7437,0.7337,0.7436,0.7476
2023-10-20 16:40,186,88,98,10166,3337,6829,7517252.0,2497231.0,5020021.0,166,77,89,9346,3266,6080,6972345.0,2427503.0,4544841.0,0.7483,0.7351,0.7433,0.7475
2023-10-20 16:45,93,51,42,4335,1911,2424,3177253.0,1362088.0,1815165.0,64,30,34,2549,606,1943,1909554.0,451278.0,1458276.0,0.7128,0.7488,0.7447,0.7505
2023-10-20 16:50,174,49,125,6045,2001,4044,4486270.0,1474790.0,3011480.0,156,37,119,5578,2016,3562,4102135.0,1445289.0,2656846.0,0.737,0.7447,0.7169,0.7459
2023-10-20 16:55,144,49,95,5887,1569,4318,4373452.0,1167023.0,3206429.0,137,46,91,5369,1397,3972,4003113.0,1039807.0,2963306.0,0.7438,0.7426,0.7443,0.746
2023-10-20 17:00,76,32,44,2857,882,1975,2128986.0,655985.0,1473001.0,67,25,42,3095,849,2246,2306496.0,631449.0,1675047.0,0.7437,0.7458,0.7438,0.7458
2023-10-20 17:05,359,76,283,14500,4116,10384,10716443.0,3057977.0,7658466.0,329,63,266,12021,3198,8823,8949962.0,2375584.0,6574378.0,0.7429,0.7375,0.7428,0.7451
2023-10-20 17:10,70,47,23,4711,3378,1333,3493452.0,2509507.0,983945.0,57,39,18,4246,3062,1184,3160303.0,2273601.0,886702.0,0.7429,0.7381,0.7425,0.7489
2023-10-20 17:15,154,90,64,10491,5243,5248,7963704.0,4003103.0,3960600.0,139,79,60,7798,3603,4195,5810335.0,2677229.0,3133105.0,0.7635,0.7547,0.7431,0.7469
2023-10-20 17:20,395,248,147,17944,9425,8519,13401949.0,7031762.0,6370186.0,381,236,145,17796,9207,8589,13273438.0,6851733.0,6421704.0,0.7461,0.7478,0.7442,0.7477
2023-10-20 17:25,528,399,129,22584,12676,9908,16912833.0,9445899.0,7466934.0,502,385,117,21560,12318,9242,16234693.0,9179111.0,7055582.0,0.7452,0.7536,0.7452,0.7634
2023-10-20 17:30,308,116,192,19158,8748,10410,14200842.0,6508011.0,7692831.0,243,102,141,16383,8331,8052,12200726.0,6186568.0,6014157.0,0.7439,0.739,0.7426,0.7469
2023-10-20 17:35,763,417,346,41900,26690,15210,30911028.0,19800451.0,11110576.0,672,370,302,38405,25362,13043,28532140.0,18812678.0,9719462.0,0.7419,0.7305,0.7418,0.7452
2023-10-20 17:40,407,157,250,22713,6486,16227,16892916.0,4821206.0,12071709.0,365,141,224,19756,6140,13616,14711434.0,4553995.0,10157438.0,0.7433,0.7439,0.7417,0.746
2023-10-20 17:45,529,340,189,17019,7051,9968,12525980.0,5227663.0,7298317.0,489,319,170,16391,6278,10113,12239137.0,4653665.0,7585471.0,0.7414,0.7322,0.7413,0.7501
2023-10-20 17:50,316,133,183,15521,6277,9244,11499005.0,4660756.0,6838248.0,276,107,169,15541,6325,9216,11561928.0,4688066.0,6873862.0,0.7425,0.7397,0.7412,0.7459
2023-10-20 17:55,736,446,290,47587,29158,18429,35341286.0,21645907.0,13695379.0,666,414,252,41712,26267,15445,31022038.0,19488658.0,11533379.0,0.7424,0.7431,0.7419,0.7467
2023-10-20 18:00,172,106,66,10030,6110,3920,7487639.0,4558837.0,2928802.0,152,98,54,9792,6285,3507,7271618.0,4641997.0,2629620.0,0.7461,0.7471,0.7386,0.7498
2023-10-20 18:05,151,73,78,8391,4574,3817,6251477.0,3406723.0,2844753.0,132,64,68,7855,4323,3532,5845073.0,3210255.0,2634818.0,0.7448,0.7453,0.7426,0.746
2023-10-20 18:10,625,384,241,50887,37641,13246,37710345.0,27946057.0,9764288.0,608,374,234,49848,37386,12462,37058022.0,27747639.0,9310383.0,0.7424,0.7371,0.7422,0.7471
2023-10-20 18:15,671,286,385,30387,17177,13210,22530743.0,12746451.0,9784292.0,663,280,383,30767,17164,13603,22873561.0,12736886.0,10136675.0,0.7421,0.7407,0.7421,0.7452
2023-10-20 18:20,1094,392,702,52168,9372,42796,38778434.0,6946019.0,31832415.0,1074,378,696,53549,9455,44094,39874233.0,7005669.0,32868563.0,0.7411,0.7438,0.7409,0.7454
2023-10-20 18:25,713,216,497,55075,11534,43541,41137031.0,9100767.0,32036264.0,614,164,450,48205,9312,38893,36419671.0,7459639.0,28960032.0,0.789,0.7358,0.8011,0.7446
2023-10-20 18:30,2500,1488,1012,215003,149888,65115,159355035.0,110907087.0,48447948.0,2398,1422,976,212555,148880,63675,157426518.0,110039761.0,47386757.0,0.7399,0.744,0.7391,0.7442
2023-10-20 18:35,946,646,300,70119,57118,13001,51874903.0,42218218.0,9656684.0,919,631,288,68564,56111,12453,50716822.0,41454791.0,9262031.0,0.7391,0.7428,0.7388,0.7438
2023-10-23 10:00,20726,18537,2189,2685683,2497345,188338,2010938882.0,1869006864.0,141932018.0,20296,18333,1963,2657937,2482743,175194,1989848582.0,1857988590.0,131859992.0,0.7484,0.7536,0.7484,0.7527
2023-10-23 10:05,1829,1068,761,110916,59038,51878,83398462.0,44239473.0,39158988.0,1508,902,606,96679,52804,43875,72640234.0,39553395.0,33086839.0,0.7493,0.7548,0.7491,0.7541
2023-10-23 10:10,1832,1065,767,133231,83542,49689,100058312.0,62663660.0,37394651.0,1607,967,640,121081,78766,42315,90980879.0,59071154.0,31909725.0,0.7501,0.7526,0.75,0.7541
2023-10-23 10:15,1929,1137,792,133194,74120,59074,100093654.0,55832415.0,44261239.0,1582,947,635,118947,65342,53605,89530853.0,49039529.0,40491324.0,0.7533,0.7493,0.7505,0.7554
2023-10-23 10:20,1163,601,562,66648,41349,25299,50445493.0,31365691.0,19079801.0,956,486,470,52655,31669,20986,39627932.0,23797274.0,15830658.0,0.7586,0.7542,0.7514,0.7543
2023-10-23 10:25,2297,1562,735,203096,155754,47342,153559177.0,117711702.0,35847475.0,1920,1373,547,186580,146300,40280,140795614.0,110261994.0,30533620.0,0.7558,0.7572,0.7537,0.758
2023-10-23 10:30,3133,1557,1576,259873,149784,110089,197249084.0,113909773.0,83339310.0,2520,1279,1241,228562,133424,95138,173518187.0,101036228.0,72481959.0,0.7605,0.757,0.7573,0.7619
2023-10-23 10:35,1557,722,835,121806,44324,77482,92219640.0,33649555.0,58570084.0,1349,638,711,105243,39003,66240,79633672.0,29380021.0,50253651.0,0.7592,0.7559,0.7533,0.7587
2023-10-23 10:40,2213,1440,773,203682,158958,44724,155143208.0,121148677.0,33994531.0,1879,1298,581,173894,140905,32989,131847576.0,106731250.0,25116326.0,0.7621,0.7601,0.7575,0.7614
2023-10-23 10:45,3250,2033,1217,243772,181225,62547,186396584.0,138823661.0,47572923.0,2529,1751,778,205972,165036,40936,157269359.0,125822960.0,31446398.0,0.766,0.7606,0.7624,0.7682
2023-10-23 10:50,1814,928,886,125890,53770,72120,95337012.0,40959877.0,54377134.0,1503,780,723,112001,49237,62764,85331008.0,37352585.0,47978423.0,0.7618,0.754,0.7586,0.7644
2023-10-23 10:55,1408,735,673,101000,49040,51960,77340791.0,37056751.0,40284040.0,1268,680,588,77884,33993,43891,59411293.0,25849078.0,33562215.0,0.7556,0.7753,0.7604,0.7647
2023-10-23 11:00,1871,777,1094,118539,37512,81027,90244088.0,28611445.0,61632642.0,1662,663,999,121379,42648,78731,92490305.0,32386770.0,60103534.0,0.7627,0.7606,0.7594,0.7634
2023-10-23 11:05,2253,1176,1077,167599,84333,83266,126853900.0,63988518.0,62865381.0,2012,1046,966,152466,78941,73525,115518418.0,59477275.0,56041143.0,0.7588,0.755,0.7534,0.7622
2023-10-23 11:10,1313,505,808,73286,31387,41899,55628453.0,23809444.0,31819009.0,1220,464,756,70559,30141,40418,53565313.0,22808114.0,30757199.0,0.7586,0.7594,0.7567,0.761
2023-10-23 11:15,567,327,240,51216,23566,27650,39338940.0,17831148.0,21507792.0,491,290,201,40965,21468,19497,31085477.0,16227221.0,14858256.0,0.7566,0.7779,0.7559,0.7621
2023-10-23 11:20,477,222,255,31582,10547,21035,23981705.0,7980361.0,16001344.0,403,192,211,29957,10051,19906,22778365.0,7605605.0,15172759.0,0.7566,0.7607,0.7567,0.7622
2023-10-23 11:25,485,228,257,29760,11309,18451,22485691.0,8546196.0,13939495.0,441,200,241,30566,11945,18621,23180024.0,9016850.0,14163173.0,0.7557,0.7555,0.7549,0.7606
2023-10-23 11:30,1249,623,626,88399,30135,58264,67019176.0,22760789.0,44258386.0,1181,593,588,81466,27952,53514,61784158.0,21130265.0,40653893.0,0.7553,0.7596,0.7559,0.7597
2023-10-23 11:35,2426,1276,1150,228590,107817,120773,172089899.0,81397059.0,90692840.0,2161,1117,1044,205164,94816,110348,155203617.0,71522353.0,83681264.0,0.755,0.7509,0.7543,0.7583
2023-10-23 11:40,1266,630,636,64290,33978,30312,48543519.0,25626994.0,22916525.0,1202,602,600,62985,33529,29456,47619408.0,25294384.0,22325023.0,0.7542,0.756,0.7544,0.7579
2023-10-23 11:45,1382,594,788,80378,43463,36915,60594606.0,32740827.0,27853778.0,1351,571,780,79028,42588,36440,59668000.0,32073393.0,27594606.0,0.7533,0.7545,0.7531,0.7573
2023-10-23 11:50,3254,1543,1711,310100,128863,181237,233925758.0,97588916.0,136336842.0,2945,1368,1577,292668,112714,179954,222005258.0,84766499.0,137238759.0,0.7573,0.7523,0.752,0.7626
2023-10-23 11:55,723,316,407,58679,26649,32030,44349430.0,20117592.0,24231838.0,682,294,388,54998,22921,32077,41553818.0,17257511.0,24296307.0,0.7549,0.7565,0.7529,0.7574
2023-10-23 12:00,1177,821,356,94867,59328,35539,71640027.0,44767222.0,26872805.0,1109,782,327,91523,58195,33328,69099178.0,43842826.0,25256352.0,0.7546,0.7561,0.7534,0.7578
2023-10-23 12:05,1091,529,562,69679,30031,39648,52667707.0,22670148.0,29997559.0,1027,498,529,66690,28287,38403,50411833.0,21330408.0,29081425.0,0.7549,0.7566,0.7541,0.7573
2023-10-23 12:10,1337,717,620,102367,66793,35574,78063711.0,51100436.0,26963275.0,1177,647,530,89075,58815,30260,67335760.0,44319124.0,23016635.0,0.7651,0.7579,0.7535,0.7606
2023-10-23 12:15,1020,411,609,52771,20874,31897,39802150.0,15690890.0,24111260.0,893,340,553,47537,18568,28969,36071955.0,14043190.0,22028764.0,0.7517,0.7559,0.7563,0.7604
2023-10-23 12:20,809,471,338,41707,22541,19166,31649595.0,17094046.0,14555549.0,703,417,286,36201,19447,16754,27448531.0,14710703.0,12737828.0,0.7584,0.7594,0.7565,0.7603
2023-10-23 12:25,694,356,338,51907,23810,28097,39255900.0,17995691.0,21260209.0,630,310,320,48601,22304,26297,36824170.0,16849727.0,19974443.0,0.7558,0.7567,0.7555,0.7596
2023-10-23 12:30,591,289,302,37254,13521,23733,28222611.0,10247496.0,17975115.0,561,275,286,36980,13687,23293,28003715.0,10332026.0,17671688.0,0.7579,0.7574,0.7549,0.7587
2023-10-23 12:35,787,187,600,56124,13500,42624,42449157.0,10176529.0,32272628.0,745,172,573,53042,12169,40873,40186356.0,9188673.0,30997682.0,0.7538,0.7571,0.7551,0.7584
2023-10-23 12:40,535,199,336,34431,11719,22712,26089072.0,8852049.0,17237022.0,498,183,315,32371,11585,20786,24500898.0,8742384.0,15758513.0,0.7554,0.7589,0.7546,0.7581
2023-10-23 12:45,425,175,250,23863,9160,14703,18012514.0,6911556.0,11100957.0,390,154,236,22569,8570,13999,17077206.0,6466351.0,10610855.0,0.7545,0.755,0.7545,0.758
2023-10-23 12:50,723,332,391,64645,25790,38855,48972215.0,19485567.0,29486648.0,673,307,366,63751,24996,38755,48295397.0,18870830.0,29424567.0,0.7555,0.7589,0.755,0.7592
2023-10-23 12:55,675,197,478,41237,13005,28232,31167563.0,9815030.0,21352533.0,660,185,475,39087,11737,27350,29616700.0,8854318.0,20762382.0,0.7547,0.7563,0.7544,0.7591
2023-10-23 13:00,602,175,427,52544,8643,43901,39828546.0,6515822.0,33312724.0,585,167,418,51558,8184,43374,39088590.0,6170640.0,32917949.0,0.7539,0.7588,0.754,0.7589
2023-10-23 13:05,1192,440,752,97617,27547,70070,73671365.0,20757794.0,52913571.0,1142,420,722,94704,27288,67416,71671487.0,20554971.0,51116516.0,0.7535,0.7552,0.7533,0.7582
2023-10-23 13:10,1693,759,934,181955,44586,137369,138348634.0,34327416.0,104021217.0,1664,747,917,180042,43273,136769,136899231.0,33268033.0,103631198.0,0.7699,0.7572,0.7688,0.7577
2023-10-23 13:15,1487,678,809,135378,38592,96786,102455085.0,29092604.0,73362480.0,1459,657,802,132648,36140,96508,100406964.0,27243307.0,73163657.0,0.7539,0.758,0.7538,0.7581
2023-10-23 13:20,851,343,508,88497,24502,63995,66987674.0,18483006.0,48504667.0,823,330,493,88079,24723,63356,66687789.0,18643562.0,48044227.0,0.7543,0.7579,0.7541,0.7583
2023-10-23 13:25,822,366,456,71419,18570,52849,54061948.0,14002504.0,40059443.0,804,350,454,71618,18480,53138,54219772.0,13929039.0,40290733.0,0.754,0.758,0.7537,0.7582
2023-10-23 13:30,623,311,312,62911,26469,36442,47574885.0,19956934.0,27617950.0,601,301,300,62244,26319,35925,47082538.0,19843045.0,27239493.0,0.754,0.7579,0.7539,0.7582
2023-10-23 13:35,600,288,312,71748,28556,43192,54273678.0,21538656.0,32735022.0,581,274,307,70942,28201,42741,53658157.0,21251533.0,32406624.0,0.7543,0.7579,0.7536,0.7582
2023-10-23 13:40,588,180,408,35998,13666,22332,27247567.0,10328392.0,16919175.0,559,157,402,33721,12478,21243,25519762.0,9414184.0,16105578.0,0.7558,0.7576,0.7545,0.7582
2023-10-23 13:45,334,144,190,23634,7002,16632,17907842.0,5297414.0,12610428.0,315,132,183,23916,6891,17025,18117400.0,5200908.0,12916492.0,0.7566,0.7582,0.7547,0.7587
2023-10-23 13:50,1001,497,504,64993,17015,47978,49266199.0,12868521.0,36397677.0,957,458,499,64270,16019,48251,48714382.0,12097533.0,36616848.0,0.7563,0.7586,0.7552,0.7589
2023-10-23 13:55,435,296,139,26260,11698,14562,19911024.0,8862074.0,11048949.0,414,287,127,25299,11658,13641,19174604.0,8816511.0,10358093.0,0.7576,0.7588,0.7563,0.7593
2023-10-23 14:00,364,184,180,25324,8945,16379,19234559.0,6793218.0,12441341.0,350,177,173,25073,8654,16419,19017058.0,6542366.0,12474692.0,0.7594,0.7596,0.756,0.7598
2023-10-23 14:05,366,220,146,19898,10373,9525,15138615.0,7897967.0,7240648.0,341,204,137,19096,9720,9376,14481037.0,7353182.0,7127854.0,0.7614,0.7602,0.7565,0.7602
2023-10-23 14:10,424,212,212,30530,13063,17467,23158118.0,9882881.0,13275236.0,386,196,190,29507,12793,16714,22375465.0,9665698.0,12709767.0,0.7566,0.76,0.7555,0.7604
2023-10-23 14:15,328,155,173,20900,10834,10066,15862386.0,8269759.0,7592627.0,292,129,163,17593,8671,8922,13339293.0,6554828.0,6784465.0,0.7633,0.7543,0.7559,0.7604
2023-10-23 14:20,1067,432,635,109921,36460,73461,83088659.0,27589114.0,55499545.0,998,387,611,103687,33213,70474,78585484.0,25089269.0,53496214.0,0.7567,0.7555,0.7554,0.7591
2023-10-23 14:25,633,242,391,86491,18692,67799,65585407.0,14119413.0,51465993.0,615,237,378,86283,18929,67354,65433179.0,14297534.0,51135645.0,0.7554,0.7591,0.7553,0.7592
2023-10-23 14:30,838,379,459,56137,25957,30180,42477853.0,19618411.0,22859442.0,826,369,457,55343,25618,29725,41916678.0,19361769.0,22554909.0,0.7558,0.7574,0.7558,0.7588
2023-10-23 14:35,849,389,460,76785,19638,57147,58169506.0,14816484.0,43353022.0,832,383,449,76674,19798,56876,58085546.0,14934983.0,43150562.0,0.7545,0.7586,0.7544,0.7587
2023-10-23 14:40,1095,358,737,124601,22082,102519,94187573.0,16671354.0,77516218.0,1032,316,716,120665,19637,101028,91317748.0,14797429.0,76520319.0,0.755,0.7561,0.7535,0.7574
2023-10-23 14:45,581,236,345,50896,12348,38548,38525057.0,9324475.0,29200581.0,549,213,336,49768,11449,38319,37656515.0,8623505.0,29033010.0,0.7551,0.7575,0.7532,0.7577
2023-10-23 14:50,365,153,212,37852,8099,29753,28692464.0,6145386.0,22547077.0,344,140,204,36595,7595,29000,27704112.0,5719127.0,21984985.0,0.7588,0.7578,0.753,0.7581
2023-10-23 14:55,384,89,295,23119,5344,17775,17487973.0,4030606.0,13457366.0,375,83,292,22857,5100,17757,17292147.0,3846404.0,13445743.0,0.7542,0.7571,0.7542,0.7572
2023-10-23 15:00,243,129,114,19532,9861,9671,14710922.0,7452608.0,7258314.0,193,102,91,16644,8622,8022,12574428.0,6497491.0,6076936.0,0.7558,0.7505,0.7536,0.7575
2023-10-23 15:05,227,81,146,16115,5213,10902,12154405.0,3905960.0,8248444.0,222,85,137,16643,6240,10403,12561766.0,4685684.0,7876082.0,0.7493,0.7566,0.7509,0.7571
2023-10-23 15:10,248,95,153,28796,10421,18375,21759885.0,7841115.0,13918769.0,235,83,152,27793,9592,18201,21008639.0,7220198.0,13788440.0,0.7524,0.7575,0.7527,0.7576
2023-10-23 15:15,151,78,73,11909,3525,8384,8988807.0,2656257.0,6332549.0,144,77,67,11780,3700,8080,8906926.0,2783617.0,6123309.0,0.7535,0.7553,0.7523,0.7578
2023-10-23 15:20,338,167,171,27403,10693,16710,20787919.0,8134057.0,12653861.0,312,151,161,26029,9991,16038,19680383.0,7534061.0,12146322.0,0.7607,0.7573,0.7541,0.7573
2023-10-23 15:25,395,171,224,36625,14073,22552,27695423.0,10620075.0,17075348.0,385,167,218,37742,15474,22268,28521364.0,11658443.0,16862921.0,0.7546,0.7572,0.7534,0.7573
2023-10-23 15:30,256,98,158,25184,6518,18666,19067742.0,4920357.0,14147385.0,241,87,154,23487,4415,19072,17783574.0,3330428.0,14453146.0,0.7549,0.7579,0.7543,0.7578
2023-10-23 15:35,186,87,99,14121,4124,9997,10698094.0,3119329.0,7578765.0,166,75,91,13135,3718,9417,9939418.0,2802976.0,7136442.0,0.7564,0.7581,0.7539,0.7578
2023-10-23 15:40,171,81,90,13472,7141,6331,10194434.0,5395508.0,4798926.0,159,74,85,12931,7090,5841,9752124.0,5325056.0,4427068.0,0.7556,0.758,0.7511,0.7579
2023-10-23 15:45,459,290,169,22148,12148,10000,16714230.0,9173363.0,7540867.0,446,281,165,23452,13011,10441,17737828.0,9814467.0,7923360.0,0.7551,0.7541,0.7543,0.7589
2023-10-23 15:50,360,214,146,25229,15287,9942,19065571.0,11547808.0,7517763.0,340,205,135,23650,15085,8565,17888188.0,11395539.0,6492649.0,0.7554,0.7562,0.7554,0.758
2023-10-23 15:55,420,263,157,18754,9518,9236,14188415.0,7192775.0,6995640.0,409,257,152,18550,9443,9107,14034523.0,7132910.0,6901613.0,0.7557,0.7574,0.7554,0.7578
2023-10-23 16:00,96,48,48,5164,2300,2864,3921526.0,1751113.0,2170412.0,75,38,37,3910,1508,2402,2959180.0,1138725.0,1820454.0,0.7614,0.7578,0.7551,0.7579
2023-10-23 16:05,308,175,133,22456,10521,11935,17016126.0,7946439.0,9069686.0,282,167,115,21223,10333,10890,16077638.0,7804127.0,8273510.0,0.7553,0.7599,0.7553,0.7597
2023-10-23 16:10,174,98,76,14210,8364,5846,10770068.0,6327068.0,4443000.0,164,89,75,14935,8963,5972,11310001.0,6770938.0,4539063.0,0.7565,0.76,0.7554,0.7601
2023-10-23 16:15,330,171,159,30337,16159,14178,22985378.0,12226261.0,10759117.0,311,162,149,27864,14834,13030,21090946.0,11202557.0,9888389.0,0.7566,0.7589,0.7552,0.7589
2023-10-23 16:20,602,358,244,44690,21819,22871,33746404.0,16486131.0,17260272.0,595,352,243,43687,21132,22555,33067594.0,15965910.0,17101684.0,0.7556,0.7547,0.7555,0.7582
2023-10-23 16:25,717,523,194,48337,32222,16115,36626307.0,24408776.0,12217531.0,694,509,185,46335,31285,15050,35050976.0,23641140.0,11409835.0,0.7575,0.7581,0.7557,0.7581
2023-10-23 16:30,267,175,92,18694,12796,5898,14107239.0,9669414.0,4437824.0,246,160,86,18528,12572,5956,14017311.0,9500184.0,4517127.0,0.7557,0.7524,0.7557,0.7584
2023-10-23 16:35,304,131,173,25687,9355,16332,19448512.0,7075236.0,12373275.0,285,127,158,26315,10640,15675,19916270.0,8031728.0,11884542.0,0.7563,0.7576,0.7549,0.7582
2023-10-23 16:40,571,177,394,52823,8731,44092,39911534.0,6582138.0,33329396.0,535,163,372,52898,9284,43614,39995185.0,6996703.0,32998482.0,0.7539,0.7559,0.7536,0.7566
2023-10-23 16:45,334,162,172,40380,9304,31076,29936984.0,7015165.0,22921819.0,321,150,171,34266,8445,25821,25922130.0,6361289.0,19560840.0,0.754,0.7376,0.7533,0.7576
2023-10-23 16:50,893,320,573,68430,24967,43463,51976467.0,19095780.0,32880687.0,849,295,554,60511,18668,41843,45774063.0,14089655.0,31684407.0,0.7648,0.7565,0.7547,0.7572
2023-10-23 16:55,905,369,536,71186,22732,48454,53943933.0,17176391.0,36767542.0,891,360,531,70515,25184,45331,53369865.0,19029620.0,34340245.0,0.7556,0.7588,0.7556,0.7575
2023-10-23 17:00,720,227,493,58568,19426,39142,44279192.0,14668175.0,29611016.0,693,210,483,55193,16385,38808,41741797.0,12367181.0,29374615.0,0.7551,0.7565,0.7548,0.7569
2023-10-23 17:05,523,203,320,40020,17760,22260,30256603.0,13415558.0,16841045.0,512,200,312,39615,17697,21918,29964099.0,13367791.0,16596307.0,0.7554,0.7566,0.7554,0.7572
2023-10-23 17:10,292,127,165,17988,8143,9845,13552165.0,6144012.0,7408153.0,282,124,158,20542,11007,9535,15523186.0,8304571.0,7218615.0,0.7545,0.7525,0.7545,0.7571
2023-10-23 17:15,630,194,436,51885,14781,37104,39308647.0,11224948.0,28083699.0,591,176,415,45982,10664,35318,34776423.0,8043998.0,26732425.0,0.7594,0.7569,0.7543,0.7569
2023-10-23 17:20,904,378,526,72226,31628,40598,54779031.0,24001429.0,30777602.0,861,356,505,72804,32770,40034,55108638.0,24754316.0,30354322.0,0.7589,0.7581,0.7554,0.7582
2023-10-23 17:25,607,493,114,71509,63416,8093,54129126.0,47985182.0,6143944.0,580,478,102,70833,62914,7919,53580179.0,47563130.0,6017049.0,0.7567,0.7592,0.756,0.7598
2023-10-23 17:30,613,272,341,62393,32324,30069,47290020.0,24443887.0,22846132.0,588,257,331,64272,31476,32796,48795361.0,23796278.0,24999083.0,0.7562,0.7598,0.756,0.7623
2023-10-23 17:35,1222,513,709,125815,89429,36386,95390758.0,67745693.0,27645065.0,1200,499,701,124888,88906,35982,94645439.0,67308883.0,27336556.0,0.7575,0.7598,0.7571,0.7597
2023-10-23 17:40,2066,1171,895,190562,124377,66185,145942188.0,96316581.0,49625607.0,1768,995,773,149288,98748,50540,113616909.0,75035783.0,38581125.0,0.7744,0.7498,0.7599,0.7634
2023-10-23 17:45,490,331,159,43152,30049,13103,33144529.0,23159536.0,9984993.0,354,260,94,44212,36078,8134,33751586.0,27447758.0,6303828.0,0.7707,0.762,0.7608,0.775
2023-10-23 17:50,982,473,509,61494,28692,32802,46865635.0,21928928.0,24936706.0,874,419,455,56463,27037,29426,43237883.0,20601052.0,22636831.0,0.7643,0.7602,0.762,0.7693
2023-10-23 17:55,616,307,309,35244,11936,23308,26982308.0,9152666.0,17829642.0,556,270,286,32925,9888,23037,26507803.0,8881173.0,17626630.0,0.7668,0.765,0.8982,0.7651
2023-10-23 18:00,1069,662,407,74962,49231,25731,57368914.0,37659806.0,19709107.0,983,616,367,73815,49183,24632,56349211.0,37473708.0,18875503.0,0.765,0.766,0.7619,0.7663
2023-10-23 18:05,971,472,499,70049,40516,29533,53370506.0,30879666.0,22490840.0,898,428,470,66403,39345,27058,50697943.0,29986055.0,20711888.0,0.7622,0.7615,0.7621,0.7655
2023-10-23 18:10,314,150,164,15517,6305,9212,11846099.0,4808982.0,7037117.0,282,135,147,15955,6089,9866,12194409.0,4641532.0,7552876.0,0.7627,0.7639,0.7623,0.7655
2023-10-23 18:15,1352,439,913,90088,25222,64866,68802017.0,19254248.0,49547769.0,1308,418,890,89488,24807,64681,68365733.0,18889655.0,49476077.0,0.7634,0.7638,0.7615,0.7649
2023-10-23 18:20,2257,1191,1066,161913,72890,89023,123690672.0,55585308.0,68105364.0,2233,1179,1054,161900,72967,88933,123687799.0,55644601.0,68043198.0,0.7626,0.765,0.7626,0.7651
2023-10-23 18:25,1449,544,905,98414,32782,65632,75147947.0,25007885.0,50140062.0,1380,526,854,95357,30767,64590,72856588.0,23447343.0,49409244.0,0.7629,0.764,0.7621,0.765
2023-10-23 18:30,410,227,183,25284,13465,11819,19026909.0,10260680.0,8766229.0,346,202,144,23102,13664,9438,17618470.0,10393010.0,7225459.0,0.762,0.7417,0.7606,0.7656
2023-10-23 18:35,1257,611,646,62217,24475,37742,47356041.0,18693165.0,28662876.0,1180,578,602,57767,23191,34576,44112929.0,17674831.0,26438098.0,0.7638,0.7594,0.7621,0.7646
2023-10-24 10:00,3373,1709,1664,302824,166559,136265,230708781.0,126941920.0,103766861.0,2833,1413,1420,259595,139003,120592,197225831.0,105207927.0,92017904.0,0.7621,0.7615,0.7569,0.7631
2023-10-24 10:05,1992,1152,840,131700,74649,57051,99390207.0,56259175.0,43131031.0,1744,1026,718,123204,70253,52951,93114948.0,52955221.0,40159727.0,0.7536,0.756,0.7538,0.7584
2023-10-24 10:10,2243,1367,876,182487,111558,70929,138885613.0,84907287.0,53978326.0,2067,1275,792,171144,104957,66187,129829368.0,79457016.0,50372351.0,0.7611,0.761,0.757,0.7611
2023-10-24 10:15,1433,691,742,75257,44163,31094,56911776.0,33404301.0,23507475.0,1256,596,660,72797,43671,29126,55176447.0,33021342.0,22155104.0,0.7564,0.756,0.7561,0.7607
2023-10-24 10:20,764,454,310,58599,33363,25236,44634381.0,25380977.0,19253404.0,684,407,277,54471,31898,22573,41392992.0,24177669.0,17215322.0,0.7608,0.7629,0.758,0.7627
2023-10-24 10:25,966,609,357,71483,36130,35353,54232240.0,27442790.0,26789450.0,882,564,318,64681,32851,31830,49144683.0,24893644.0,24251038.0,0.7596,0.7578,0.7578,0.7619
2023-10-24 10:30,645,325,320,44442,24782,19660,33525032.0,18753845.0,14771186.0,567,282,285,35758,22349,13409,27099041.0,16902198.0,10196843.0,0.7568,0.7513,0.7563,0.7604
2023-10-24 10:35,587,215,372,26915,11889,15026,20327363.0,8971332.0,11356030.0,513,177,336,24362,10769,13593,18448954.0,8128975.0,10319979.0,0.7546,0.7558,0.7548,0.7592
2023-10-24 10:40,1464,699,765,123919,58053,65866,94350730.0,44282895.0,50067834.0,1375,648,727,120425,53786,66639,91443227.0,40747718.0,50695509.0,0.7628,0.7601,0.7576,0.7607
2023-10-24 10:45,336,178,158,25141,13473,11668,18882408.0,10161601.0,8720807.0,282,151,131,17080,9626,7454,12931422.0,7255563.0,5675858.0,0.7542,0.7474,0.7537,0.7615
2023-10-24 10:50,884,404,480,81624,33534,48090,61776499.0,25457708.0,36318791.0,837,373,464,76138,30837,45301,57815167.0,23354155.0,34461011.0,0.7592,0.7552,0.7573,0.7607
2023-10-24 10:55,1008,538,470,97650,60632,37018,77233656.0,49051195.0,28182461.0,975,519,456,98051,56639,41412,77263341.0,45688923.0,31574418.0,0.809,0.7613,0.8067,0.7624
2023-10-24 11:00,2511,1513,998,271425,159650,111775,208117181.0,122682547.0,85434633.0,2445,1481,964,265315,159142,106173,203454597.0,122290998.0,81163598.0,0.7684,0.7643,0.7684,0.7644
2023-10-24 11:05,1097,466,631,99768,48285,51483,77702652.0,38364846.0,39337805.0,1045,435,610,85158,33669,51489,64954403.0,25612977.0,39341426.0,0.7945,0.7641,0.7607,0.7641
2023-10-24 11:10,376,148,228,32637,26285,6352,26417679.0,21563312.0,4854367.0,342,132,210,15751,10295,5456,16071179.0,11906498.0,4164681.0,0.8204,0.7642,1.1565,0.7633
2023-10-24 11:15,487,168,319,27409,9657,17752,20949665.0,7395082.0,13554582.0,435,144,291,26056,8883,17173,19876423.0,6754748.0,13121675.0,0.7658,0.7636,0.7604,0.7641
2023-10-24 11:20,228,133,95,12747,7179,5568,9685534.0,5454515.0,4231019.0,191,108,83,11428,6427,5001,8699210.0,4879621.0,3819589.0,0.7598,0.7599,0.7592,0.7638
2023-10-24 11:25,876,591,285,44090,26247,17843,33812123.0,20232436.0,13579687.0,778,536,242,41442,21796,19646,31662091.0,16606872.0,15055218.0,0.7708,0.7611,0.7619,0.7663
2023-10-24 11:30,1847,1127,720,167856,129744,38112,129450294.0,100241151.0,29209143.0,1453,917,536,144474,120753,23721,110641121.0,92395776.0,18245344.0,0.7726,0.7664,0.7652,0.7692
2023-10-24 11:35,724,353,371,36650,24007,12643,28977445.0,19245213.0,9732232.0,624,323,301,52664,43454,9210,40893119.0,33763057.0,7130062.0,0.8017,0.7698,0.777,0.7742
2023-10-24 11:40,632,185,447,28471,10778,17693,22389024.0,9086489.0,13302535.0,584,161,423,24655,9863,14792,19727866.0,8379800.0,11348066.0,0.8431,0.7519,0.8496,0.7672
2023-10-24 11:45,464,209,255,24578,8858,15720,18685267.0,6793083.0,11892183.0,415,181,234,17560,7366,10194,13446050.0,5623935.0,7822115.0,0.7669,0.7565,0.7635,0.7673
2023-10-24 11:50,255,146,109,22232,11232,11000,17035462.0,8589049.0,8446413.0,218,131,87,21123,12620,8503,16093124.0,9566273.0,6526851.0,0.7647,0.7679,0.758,0.7676
2023-10-24 11:55,451,184,267,17757,9010,8747,13617796.0,6915788.0,6702008.0,419,170,249,17482,8697,8785,13393611.0,6654638.0,6738972.0,0.7676,0.7662,0.7652,0.7671
2023-10-24 12:00,348,253,95,16574,9715,6859,12688807.0,7437024.0,5251783.0,314,238,76,15458,9416,6042,11845753.0,7204392.0,4641361.0,0.7655,0.7657,0.7651,0.7682
2023-10-24 12:05,333,167,166,15886,8055,7831,13367504.0,6743388.0,6624116.0,300,160,140,14287,7818,6469,11784088.0,6820397.0,4963690.0,0.8372,0.8459,0.8724,0.7673
2023-10-24 12:10,403,209,194,34400,18319,16081,26159864.0,13972472.0,12187391.0,356,184,172,29118,17028,12090,23499006.0,13579793.0,9919213.0,0.7627,0.7579,0.7975,0.8204
2023-10-24 12:15,753,400,353,63353,38521,24832,48098968.0,29310400.0,18788568.0,689,357,332,60268,37612,22656,46639019.0,29313651.0,17325367.0,0.7609,0.7566,0.7794,0.7647
2023-10-24 12:20,1353,546,807,104734,51914,52820,79974702.0,39580833.0,40393869.0,1320,524,796,104223,52139,52084,79581723.0,39748723.0,39833000.0,0.7624,0.7647,0.7624,0.7648
2023-10-24 12:25,288,155,133,20395,10435,9960,15579408.0,7958358.0,7621050.0,271,150,121,20139,9962,10177,15381449.0,7594143.0,7787305.0,0.7627,0.7652,0.7623,0.7652
2023-10-24 12:30,140,104,36,10196,6532,3664,7767343.0,4979738.0,2787605.0,128,100,28,9438,6632,2806,7201529.0,5054106.0,2147423.0,0.7624,0.7608,0.7621,0.7653
2023-10-24 12:35,260,134,126,20539,9097,11442,15734927.0,6963017.0,8771910.0,239,127,112,20169,8869,11300,15415512.0,6763679.0,8651833.0,0.7654,0.7666,0.7626,0.7656
2023-10-24 12:40,703,376,327,59624,35697,23927,45630382.0,27361736.0,18268646.0,643,348,295,56141,33809,22332,42890210.0,25786609.0,17103601.0,0.7665,0.7635,0.7627,0.7659
2023-10-24 12:45,218,100,118,14955,8901,6054,11412390.0,6781407.0,4630983.0,204,94,110,16062,8419,7643,12268093.0,6412663.0,5855429.0,0.7619,0.7649,0.7617,0.7661
2023-10-24 12:50,208,131,77,19245,14481,4764,14686945.0,11038378.0,3648567.0,195,125,70,19349,14827,4522,14760303.0,11298816.0,3461486.0,0.7623,0.7659,0.762,0.7655
2023-10-24 12:55,201,120,81,14780,9230,5550,11307178.0,7056083.0,4251095.0,177,111,66,12943,8309,4634,9888660.0,6332464.0,3556196.0,0.7645,0.766,0.7621,0.7674
2023-10-24 13:00,182,105,77,11955,7823,4132,9125651.0,5970444.0,3155206.0,169,100,69,11692,7959,3733,8930375.0,6072397.0,2857977.0,0.7632,0.7636,0.763,0.7656
2023-10-24 13:05,333,219,114,77125,42630,34495,60604395.0,32518653.0,28085742.0,320,211,109,61038,42005,19033,46615854.0,32038955.0,14576899.0,0.7628,0.8142,0.7627,0.7659
2023-10-24 13:10,487,313,174,83053,57141,25912,63343209.0,43574177.0,19769032.0,478,309,169,82650,57142,25508,63105498.0,43574634.0,19530863.0,0.7626,0.7629,0.7626,0.7657
2023-10-24 13:15,763,380,383,39518,23926,15592,30161903.0,18236530.0,11925373.0,741,365,376,40366,25180,15186,30803158.0,19188316.0,11614842.0,0.7622,0.7648,0.762,0.7648
2023-10-24 13:20,359,138,221,19839,11070,8769,15132977.0,8425530.0,6707447.0,350,135,215,18493,9654,8839,14118511.0,7357277.0,6761234.0,0.7611,0.7649,0.7621,0.7649
2023-10-24 13:25,206,103,103,10700,6723,3977,8222682.0,5181301.0,3041381.0,181,89,92,9175,5278,3897,7009622.0,4026257.0,2983365.0,0.7707,0.7647,0.7628,0.7656
2023-10-24 13:30,410,194,216,29881,16965,12916,22756637.0,12933086.0,9823551.0,379,179,200,28143,16160,11983,21484722.0,12315089.0,9169633.0,0.7623,0.7606,0.7621,0.7652
2023-10-24 13:35,380,169,211,36425,25019,11406,27776013.0,19057656.0,8718356.0,389,175,214,35915,25115,10800,27387827.0,19130935.0,8256892.0,0.7617,0.7644,0.7617,0.7645
2023-10-24 13:40,427,231,196,35010,25828,9182,26707461.0,19693172.0,7014288.0,410,224,186,34514,25507,9007,26326632.0,19438397.0,6888235.0,0.7625,0.7639,0.7621,0.7648
2023-10-24 13:45,351,168,183,27296,12505,14791,20838921.0,9528447.0,11310473.0,340,165,175,27960,13387,14573,21316200.0,10171739.0,11144461.0,0.762,0.7647,0.7598,0.7647
2023-10-24 13:50,323,120,203,21110,10607,10503,16123394.0,8091717.0,8031677.0,316,114,202,22153,11261,10892,16910691.0,8575700.0,8334990.0,0.7629,0.7647,0.7615,0.7652
2023-10-24 13:55,392,241,151,31874,18999,12875,24286006.0,14469695.0,9816310.0,378,235,143,31467,18973,12494,24001175.0,14450149.0,9551026.0,0.7616,0.7624,0.7616,0.7644
2023-10-24 14:00,508,342,166,56785,36523,20262,43151393.0,27812712.0,15338681.0,461,321,140,67630,35377,32253,53290208.0,26929632.0,26360576.0,0.7615,0.757,0.7612,0.8173
2023-10-24 14:05,413,219,194,30336,20056,10280,23127623.0,15272251.0,7855372.0,395,207,188,30938,19244,11694,23591267.0,14652869.0,8938397.0,0.7615,0.7641,0.7614,0.7644
2023-10-24 14:10,664,255,409,45048,25806,19242,34333785.0,19659290.0,14674494.0,635,245,390,43529,25195,18334,33209132.0,19190900.0,14018231.0,0.7618,0.7626,0.7617,0.7646
2023-10-24 14:15,660,279,381,45118,27805,17313,34413515.0,21185855.0,13227660.0,641,271,370,44910,27922,16988,34259706.0,21269771.0,12989934.0,0.7619,0.764,0.7618,0.7647
2023-10-24 14:20,480,196,284,35604,21710,13894,27131690.0,16588460.0,10543230.0,452,179,273,34183,21021,13162,26060443.0,16007453.0,10052990.0,0.7641,0.7588,0.7615,0.7638
2023-10-24 14:25,224,81,143,14685,6557,8128,11167839.0,4993594.0,6174244.0,200,66,134,15534,4714,10820,11851923.0,3584106.0,8267816.0,0.7616,0.7596,0.7603,0.7641
2023-10-24 14:30,198,62,136,12391,4062,8329,9476294.0,3116401.0,6359893.0,177,56,121,10932,3313,7619,8340976.0,2520981.0,5819995.0,0.7672,0.7636,0.7609,0.7639
2023-10-24 14:35,1001,516,485,74400,39531,34869,57048461.0,30365973.0,26682488.0,967,497,470,71383,38310,33073,54532136.0,29224764.0,25307372.0,0.7682,0.7652,0.7628,0.7652
2023-10-24 14:40,457,197,260,47395,22952,24443,36177658.0,17498741.0,18678917.0,434,192,242,45783,22599,23184,34966177.0,17228925.0,17737252.0,0.7624,0.7642,0.7624,0.7651
2023-10-24 14:45,568,278,290,61113,26952,34161,46680971.0,20551925.0,26129046.0,543,266,277,59201,26794,32407,45214890.0,20425715.0,24789175.0,0.7625,0.7649,0.7623,0.7649
2023-10-24 14:50,316,124,192,32611,9958,22653,24895203.0,7582719.0,17312484.0,294,114,180,33125,10864,22261,25274015.0,8256189.0,17017825.0,0.7615,0.7642,0.76,0.7645
2023-10-24 14:55,600,479,121,27129,16728,10401,20706514.0,12751430.0,7955083.0,582,467,115,26744,16275,10469,20411335.0,12403536.0,8007798.0,0.7623,0.7648,0.7621,0.7649
2023-10-24 15:00,457,253,204,37535,17004,20531,28651664.0,12976942.0,15674721.0,428,241,187,35006,16416,18590,26730162.0,12514765.0,14215397.0,0.7632,0.7635,0.7624,0.7647
2023-10-24 15:05,352,158,194,35905,8976,26929,27397216.0,6842040.0,20555176.0,330,142,188,34959,8501,26458,26712055.0,6478813.0,20233242.0,0.7623,0.7633,0.7621,0.7647
2023-10-24 15:10,655,351,304,52405,33569,18836,40009784.0,25613754.0,14396030.0,629,340,289,50486,32449,18037,38528992.0,24742467.0,13786525.0,0.763,0.7643,0.7625,0.7643
2023-10-24 15:15,424,333,91,52284,38610,13674,39928280.0,29454042.0,10474237.0,406,326,80,50663,37333,13330,38682525.0,28474921.0,10207603.0,0.7629,0.766,0.7627,0.7658
2023-10-24 15:20,336,232,104,43000,29345,13655,32842358.0,22388818.0,10453539.0,326,227,99,43414,29769,13645,33164001.0,22716726.0,10447274.0,0.763,0.7655,0.7631,0.7656
2023-10-24 15:25,599,466,133,83989,64319,19670,64156606.0,49093835.0,15062771.0,579,455,124,83335,63858,19477,63657305.0,48741041.0,14916263.0,0.7633,0.7658,0.7633,0.7658
2023-10-24 15:30,1411,740,671,139572,58659,80913,106664903.0,44745981.0,61918922.0,1406,738,668,139616,58863,80753,106700633.0,44902023.0,61798610.0,0.7628,0.7653,0.7628,0.7653
2023-10-24 15:35,395,270,125,31536,17793,13743,24091856.0,13578088.0,10513768.0,382,267,115,29772,16904,12868,22738517.0,12891151.0,9847365.0,0.7631,0.765,0.7626,0.7653
2023-10-24 15:40,476,263,213,50200,33891,16309,38325786.0,25846887.0,12478899.0,460,259,201,48920,33035,15885,37347202.0,25190263.0,12156939.0,0.7626,0.7652,0.7625,0.7653
2023-10-24 15:45,550,412,138,70944,58976,11968,54117937.0,44972838.0,9145098.0,534,403,131,70307,59105,11202,53645455.0,45071367.0,8574088.0,0.7626,0.7641,0.7626,0.7654
2023-10-24 15:50,528,200,328,43830,25529,18301,33463818.0,19468906.0,13994911.0,517,192,325,37912,24317,13595,28940017.0,18539601.0,10400416.0,0.7626,0.7647,0.7624,0.765
2023-10-24 15:55,451,301,150,42495,35802,6693,32397663.0,27290082.0,5107581.0,433,292,141,42683,36343,6340,32552335.0,27701767.0,4850567.0,0.7623,0.7631,0.7622,0.7651
2023-10-24 16:00,786,491,295,70283,53354,16929,53660809.0,40704834.0,12955974.0,774,485,289,70498,53671,16827,53801861.0,40924137.0,12877724.0,0.7629,0.7653,0.7625,0.7653
2023-10-24 16:05,972,575,397,82695,61631,21064,63131268.0,47011176.0,16120092.0,959,568,391,81794,61109,20685,62444261.0,46613881.0,15830380.0,0.7628,0.7653,0.7628,0.7653
2023-10-24 16:10,227,180,47,20826,17146,3680,15887061.0,13072692.0,2814368.0,224,181,43,21189,17552,3637,16165728.0,13379917.0,2785811.0,0.7624,0.7648,0.7623,0.766
2023-10-24 16:15,202,127,75,16136,6628,9508,12324743.0,5052824.0,7271919.0,196,123,73,16097,6713,9384,12292473.0,5113603.0,7178869.0,0.7623,0.7648,0.7617,0.765
2023-10-24 16:20,166,75,91,10991,4313,6678,8397369.0,3293243.0,5104126.0,153,69,84,11133,4474,6659,8500512.0,3410010.0,5090501.0,0.7636,0.7643,0.7622,0.7645
2023-10-24 16:25,422,236,186,32098,12801,19297,24470994.0,9753462.0,14717531.0,401,224,177,29398,11917,17481,22434689.0,9077964.0,13356725.0,0.7619,0.7627,0.7618,0.7641
2023-10-24 16:30,793,359,434,74196,28593,45603,56656250.0,21795016.0,34861234.0,776,349,427,74419,27861,46558,56821603.0,21232919.0,35588684.0,0.7623,0.7645,0.7621,0.7644
2023-10-24 16:35,1261,319,942,103875,40916,62959,78909076.0,31089678.0,47819398.0,1221,298,923,98150,38270,59880,74829080.0,29086990.0,45742089.0,0.7598,0.7595,0.76,0.7639
2023-10-24 16:40,807,291,516,62659,18553,44106,47802179.0,14122828.0,33679351.0,797,290,507,63308,19648,43660,48290458.0,14943823.0,33346635.0,0.7612,0.7636,0.7606,0.7638
2023-10-24 16:45,592,387,205,61822,34331,27491,47121354.0,26128409.0,20992944.0,582,380,202,61827,34041,27786,47137132.0,25907977.0,21229154.0,0.7611,0.7636,0.7611,0.764
2023-10-24 16:50,487,307,180,59192,32306,26886,45124102.0,24585746.0,20538356.0,478,302,176,58648,31910,26738,44717153.0,24284754.0,20432399.0,0.761,0.7639,0.761,0.7642
2023-10-24 16:55,456,334,122,42075,26754,15321,32074107.0,20368164.0,11705943.0,445,329,116,41705,26587,15118,31796082.0,20241223.0,11554858.0,0.7613,0.764,0.7613,0.7643
2023-10-24 17:00,421,233,188,33220,18637,14583,25324114.0,14197599.0,11126514.0,382,210,172,32401,17686,14715,24698634.0,13460074.0,11238560.0,0.7618,0.763,0.7611,0.7637
2023-10-24 17:05,96,38,58,9054,919,8135,6912468.0,699897.0,6212571.0,90,34,56,8118,906,7212,6200367.0,689985.0,5510382.0,0.7616,0.7637,0.7616,0.7641
2023-10-24 17:10,502,338,164,53919,38256,15663,40899059.0,28988772.0,11910286.0,469,321,148,51860,37196,14664,39387223.0,28185707.0,11201515.0,0.7578,0.7604,0.7578,0.7639
2023-10-24 17:15,803,436,367,63911,40791,23120,48457274.0,30874883.0,17582390.0,780,424,356,63372,40562,22810,48083983.0,30700053.0,17383930.0,0.7569,0.7605,0.7569,0.7621
2023-10-24 17:20,326,179,147,24549,15425,9124,18653424.0,11701918.0,6951506.0,310,169,141,23635,14819,8816,17961574.0,11239546.0,6722027.0,0.7586,0.7619,0.7585,0.7625
2023-10-24 17:25,95,62,33,6809,2597,4212,5191597.0,1973200.0,3218397.0,90,59,31,6516,3320,3196,4959234.0,2514174.0,2445059.0,0.7598,0.7641,0.7573,0.765
2023-10-24 17:30,369,220,149,23608,14084,9524,17970602.0,10698251.0,7272351.0,357,213,144,23118,13489,9629,17597317.0,10240919.0,7356398.0,0.7596,0.7636,0.7592,0.764
2023-10-24 17:35,275,153,122,17272,10947,6325,13122926.0,8314112.0,4808814.0,255,140,115,18178,11127,7051,13852661.0,8445335.0,5407326.0,0.7595,0.7603,0.759,0.7669
2023-10-24 17:40,148,74,74,6757,3687,3070,5144665.0,2806519.0,2338146.0,140,68,72,6786,3600,3186,5162288.0,2736050.0,2426237.0,0.7612,0.7616,0.76,0.7615
2023-10-24 17:45,270,170,100,18913,12371,6542,14356761.0,9371681.0,4985079.0,255,158,97,18111,11619,6492,13751746.0,8794440.0,4957305.0,0.7576,0.762,0.7569,0.7636
2023-10-24 17:50,100,76,24,5360,4116,1244,4077984.0,3130163.0,947821.0,84,63,21,5505,4160,1345,4190870.0,3162726.0,1028143.0,0.7605,0.7619,0.7603,0.7644
2023-10-24 17:55,130,79,51,8580,3250,5330,6485561.0,2432043.0,4053518.0,102,61,41,6604,1943,4661,5040762.0,1472643.0,3568119.0,0.7483,0.7605,0.7579,0.7655
2023-10-24 18:00,135,97,38,7306,4978,2328,5533834.0,3782431.0,1751403.0,118,87,31,7098,5135,1963,5375859.0,3881238.0,1494620.0,0.7598,0.7523,0.7558,0.7614
2023-10-24 18:05,433,208,225,36922,15353,21569,27815248.0,11680395.0,16134852.0,365,168,197,33599,13696,19903,25538230.0,10379667.0,15158562.0,0.7608,0.7481,0.7579,0.7616
2023-10-24 18:10,505,242,263,35171,18416,16755,26496100.0,13911703.0,12584396.0,455,204,251,31796,16265,15531,24123631.0,12315570.0,11808060.0,0.7554,0.7511,0.7572,0.7603
2023-10-24 18:15,549,390,159,42274,31017,11257,31999003.0,23503718.0,8495284.0,480,344,136,37836,29769,8067,28673529.0,22545850.0,6127679.0,0.7578,0.7547,0.7574,0.7596
2023-10-24 18:20,848,268,580,64633,19332,45301,49057113.0,14640209.0,34416903.0,817,246,571,62753,19137,43616,47641959.0,14488133.0,33153826.0,0.7573,0.7597,0.7571,0.7601
2023-10-24 18:25,1132,306,826,74845,20400,54445,56793010.0,15470871.0,41322139.0,1102,292,810,74198,20264,53934,56304747.0,15331582.0,40973165.0,0.7584,0.759,0.7566,0.7597
2023-10-24 18:30,792,125,667,51122,6789,44333,38800148.0,5136930.0,33663218.0,768,107,661,50346,5971,44375,38215143.0,4517594.0,33697549.0,0.7567,0.7593,0.7566,0.7594
2023-10-24 18:35,1222,325,897,79579,15902,63677,60345465.0,12036681.0,48308783.0,1204,314,890,77933,15043,62890,59140551.0,11384089.0,47756462.0,0.7569,0.7587,0.7568,0.7594
2023-10-25 10:00,1834,670,1164,122767,51901,70866,92781732.0,38544702.0,54237029.0,1456,476,980,100552,39085,61467,76213136.0,29509463.0,46703673.0,0.7427,0.7653,0.755,0.7598
2023-10-25 10:05,2082,1032,1050,167352,90596,76756,126395423.0,68276987.0,58118435.0,1945,957,988,159352,86918,72434,120605556.0,65623299.0,54982256.0,0.7536,0.7572,0.755,0.7591
2023-10-25 10:10,1776,871,905,128123,68689,59434,97259391.0,52031154.0,45228237.0,1700,830,870,126641,67251,59390,96064283.0,50873674.0,45190609.0,0.7575,0.761,0.7565,0.7609
2023-10-25 10:15,543,351,192,43749,29601,14148,33226064.0,22404058.0,10822005.0,490,325,165,32887,20390,12497,25318955.0,15801349.0,9517606.0,0.7569,0.7649,0.775,0.7616
2023-10-25 10:20,1223,687,536,71736,27266,44470,54362543.0,20693532.0,33669011.0,1138,657,481,67506,25718,41788,51177002.0,19448687.0,31728314.0,0.759,0.7571,0.7562,0.7593
2023-10-25 10:25,510,314,196,31889,15104,16785,24255662.0,11455291.0,12800370.0,363,238,125,26538,11028,15510,20165534.0,8346445.0,11819089.0,0.7584,0.7626,0.7568,0.762
2023-10-25 10:30,418,282,136,25957,14185,11772,19825725.0,10886579.0,8939145.0,381,270,111,23828,13515,10313,18087700.0,10235409.0,7852291.0,0.7675,0.7594,0.7573,0.7614
2023-10-25 10:35,189,116,73,13326,7463,5863,10108026.0,5661681.0,4446345.0,151,88,63,11232,6401,4831,8524605.0,4851338.0,3673266.0,0.7586,0.7584,0.7579,0.7604
2023-10-25 10:40,158,77,81,11279,5711,5568,8666385.0,4409395.0,4256989.0,116,49,67,7724,3233,4491,5876528.0,2449876.0,3426652.0,0.7721,0.7645,0.7578,0.763
2023-10-25 10:45,460,108,352,19280,2881,16399,14696250.0,2187145.0,12509105.0,424,88,336,18273,2545,15728,13922677.0,1927334.0,11995342.0,0.7592,0.7628,0.7573,0.7627
2023-10-25 10:50,410,104,306,23424,5171,18253,17903141.0,4010663.0,13892477.0,374,85,289,21634,4012,17622,16456605.0,3040981.0,13415624.0,0.7756,0.7611,0.758,0.7613
2023-10-25 10:55,261,68,193,16726,3416,13310,12621741.0,2602203.0,10019538.0,226,52,174,14603,2929,11674,11102125.0,2219705.0,8882420.0,0.7618,0.7528,0.7578,0.7609
2023-10-25 11:00,215,103,112,13359,5579,7780,10075687.0,4227052.0,5848634.0,189,101,88,12087,5320,6767,9196972.0,4033166.0,5163805.0,0.7577,0.7518,0.7581,0.7631
2023-10-25 11:05,315,211,104,24353,13472,10881,18566585.0,10256667.0,8309918.0,293,196,97,21718,12861,8857,16520053.0,9757489.0,6762563.0,0.7613,0.7637,0.7587,0.7635
2023-10-25 11:10,175,121,54,13927,11280,2647,10526763.0,8516659.0,2010104.0,154,108,46,10383,8207,2176,7881021.0,6225051.0,1655970.0,0.755,0.7594,0.7585,0.761
2023-10-25 11:15,187,100,87,11074,5795,5279,8419830.0,4409589.0,4010241.0,170,99,71,10418,5558,4860,7919780.0,4214927.0,3704853.0,0.7609,0.7597,0.7584,0.7623
2023-10-25 11:20,103,47,56,5682,3144,2538,4308963.0,2384820.0,1924143.0,76,42,34,5335,3085,2250,4052667.0,2339810.0,1712857.0,0.7585,0.7581,0.7584,0.7613
2023-10-25 11:25,267,156,111,18816,10358,8458,14170705.0,7858629.0,6312075.0,237,147,90,17022,9635,7387,12933617.0,7307696.0,5625920.0,0.7587,0.7463,0.7585,0.7616
2023-10-25 11:30,321,190,131,22753,13443,9310,17277913.0,10189910.0,7088002.0,303,179,124,22473,13632,8841,17061443.0,10335900.0,6725542.0,0.758,0.7613,0.7582,0.7607
2023-10-25 11:35,420,195,225,30618,12350,18268,23188551.0,9360817.0,13827734.0,389,179,210,29069,11592,17477,22087471.0,8789154.0,13298317.0,0.758,0.7569,0.7582,0.7609
2023-10-25 11:40,200,73,127,10231,3585,6646,7734838.0,2715337.0,5019500.0,181,63,118,9418,3107,6311,7157606.0,2353150.0,4804455.0,0.7574,0.7553,0.7574,0.7613
2023-10-25 11:45,232,149,83,14371,4757,9614,10899957.0,3603593.0,7296363.0,210,139,71,10594,4839,5755,8044034.0,3662932.0,4381102.0,0.7575,0.7589,0.757,0.7613
2023-10-25 11:50,181,105,76,11315,4784,6531,8651443.0,3688804.0,4962638.0,163,97,66,9866,3967,5899,7491846.0,3006804.0,4485042.0,0.7711,0.7599,0.758,0.7603
2023-10-25 11:55,223,101,122,13901,2898,11003,10551673.0,2194319.0,8357353.0,201,90,111,13114,2876,10238,9954224.0,2177923.0,7776300.0,0.7572,0.7596,0.7573,0.7596
2023-10-25 12:00,217,122,95,15015,4074,10941,11389211.0,3057456.0,8331754.0,193,107,86,13196,3246,9950,10034303.0,2457216.0,7577086.0,0.7505,0.7615,0.757,0.7615
2023-10-25 12:05,316,154,162,27303,5021,22282,20759069.0,3813504.0,16945564.0,294,136,158,31019,4975,26044,23567146.0,3766968.0,19800177.0,0.7595,0.7605,0.7572,0.7603
2023-10-25 12:10,282,145,137,20297,4780,15517,15516388.0,3619613.0,11896775.0,267,136,131,18578,4606,13972,14102526.0,3487421.0,10615104.0,0.7572,0.7667,0.7571,0.7597
2023-10-25 12:15,334,199,135,23277,10164,13113,17695563.0,7728038.0,9967524.0,318,192,126,22698,9843,12855,17230300.0,7459259.0,9771041.0,0.7603,0.7601,0.7578,0.7601
2023-10-25 12:20,386,186,200,28531,14416,14115,21686064.0,10945405.0,10740659.0,363,176,187,26194,12617,13577,19895698.0,9563990.0,10331708.0,0.7593,0.7609,0.758,0.761
2023-10-25 12:25,392,84,308,20347,6025,14322,15463815.0,4568473.0,10895342.0,382,79,303,19868,5807,14061,15101106.0,4403483.0,10697622.0,0.7583,0.7607,0.7583,0.7608
2023-10-25 12:30,479,140,339,33373,9341,24032,25185805.0,7081885.0,18103920.0,460,132,328,27253,8618,18635,20703924.0,6531310.0,14172614.0,0.7582,0.7533,0.7579,0.7605
2023-10-25 12:35,617,176,441,62973,6481,56492,47886704.0,4920189.0,42966515.0,600,165,435,60183,6111,54072,45709321.0,4625126.0,41084194.0,0.7592,0.7606,0.7569,0.7598
2023-10-25 12:40,282,156,126,26609,8459,18150,20242986.0,6402006.0,13840979.0,264,147,117,25927,8425,17502,19670384.0,6376252.0,13294132.0,0.7568,0.7626,0.7568,0.7596
2023-10-25 12:45,122,66,56,9068,2185,6883,6890521.0,1652259.0,5238261.0,116,63,53,10691,1886,8805,8119514.0,1426168.0,6693346.0,0.7562,0.761,0.7562,0.7602
2023-10-25 12:50,113,73,40,7882,1681,6201,5982988.0,1281750.0,4701238.0,102,62,40,7535,1596,5939,5745802.0,1208067.0,4537735.0,0.7625,0.7581,0.7569,0.7641
2023-10-25 12:55,236,69,167,22733,2024,20709,17234931.0,1531711.0,15703219.0,216,57,159,22063,1733,20330,16761199.0,1310191.0,15451007.0,0.7568,0.7583,0.756,0.76
2023-10-25 13:00,1156,347,809,80606,17454,63152,60333336.0,13162634.0,47170702.0,1069,285,784,75384,16502,58882,57162204.0,12440795.0,44721408.0,0.7541,0.7469,0.7539,0.7595
2023-10-25 13:05,384,100,284,30046,4101,25945,22762375.0,3092256.0,19670118.0,370,92,278,29777,4142,25635,22582192.0,3123669.0,19458523.0,0.754,0.7581,0.7541,0.7591
2023-10-25 13:10,647,314,333,49892,12268,37624,37879872.0,9285021.0,28594850.0,604,294,310,48418,11512,36906,36759467.0,8700643.0,28058823.0,0.7568,0.76,0.7558,0.7603
2023-10-25 13:15,647,247,400,50647,10507,40140,38294521.0,7915763.0,30378757.0,588,214,374,54502,15233,39269,41294344.0,11484419.0,29809925.0,0.7534,0.7568,0.7539,0.7591
2023-10-25 13:20,645,339,306,33704,14681,19023,25450018.0,11059429.0,14390588.0,616,322,294,31804,13516,18288,24021382.0,10178324.0,13843057.0,0.7533,0.7565,0.7531,0.7569
2023-10-25 13:25,861,175,686,49582,6961,42621,37528310.0,5250187.0,32278123.0,837,160,677,48339,6395,41944,36585884.0,4815914.0,31769969.0,0.7542,0.7573,0.7531,0.7574
2023-10-25 13:30,329,150,179,23789,5675,18114,18001834.0,4268097.0,13733736.0,307,137,170,24466,6065,18401,18516121.0,4561065.0,13955056.0,0.7521,0.7582,0.752,0.7584
2023-10-25 13:35,308,101,207,22150,3636,18514,16767390.0,2740962.0,14026427.0,300,98,202,21230,3516,17714,16073703.0,2647335.0,13426368.0,0.7538,0.7576,0.7529,0.758
2023-10-25 13:40,947,382,565,71238,28359,42879,53325573.0,21264705.0,32060867.0,739,246,493,56015,19923,36092,42167303.0,14900876.0,27266427.0,0.7498,0.7477,0.7479,0.7555
2023-10-25 13:45,266,131,135,13781,7764,6017,10390780.0,5862458.0,4528321.0,244,124,120,14866,9387,5479,11140868.0,7007634.0,4133234.0,0.7551,0.7526,0.7465,0.7544
2023-10-25 13:50,418,132,286,16563,4803,11760,12459402.0,3593438.0,8865964.0,380,116,264,15788,4629,11159,11897212.0,3464156.0,8433056.0,0.7482,0.7539,0.7484,0.7557
2023-10-25 13:55,146,43,103,8366,2477,5889,6294297.0,1854646.0,4439650.0,122,28,94,7158,1541,5617,5391383.0,1155537.0,4235846.0,0.7487,0.7539,0.7499,0.7541
2023-10-25 14:00,284,130,154,16828,5815,11013,12658458.0,4366244.0,8292213.0,246,114,132,15720,5493,10227,11833982.0,4118888.0,7715094.0,0.7509,0.7529,0.7498,0.7544
2023-10-25 14:05,201,95,106,11189,5425,5764,8402720.0,4068524.0,4334195.0,180,82,98,12677,5167,7510,9581419.0,3873216.0,5708203.0,0.75,0.7519,0.7496,0.7601
2023-10-25 14:10,252,116,136,15221,7395,7826,11435308.0,5550323.0,5884985.0,242,110,132,15052,7502,7550,11302670.0,5624103.0,5678566.0,0.7506,0.752,0.7497,0.7521
2023-10-25 14:15,240,120,120,13299,7567,5732,9983116.0,5677945.0,4305171.0,228,115,113,12864,7386,5478,9660628.0,5541266.0,4119362.0,0.7504,0.7511,0.7502,0.752
2023-10-25 14:20,829,416,413,51216,20914,30302,38231361.0,15651763.0,22579598.0,709,338,371,45456,16645,28811,34167955.0,12458309.0,21709645.0,0.7484,0.7452,0.7485,0.7535
2023-10-25 14:25,1081,490,591,72020,28082,43938,54228722.0,21275176.0,32953546.0,977,412,565,70276,27559,42717,52626218.0,20527322.0,32098896.0,0.7576,0.75,0.7449,0.7514
2023-10-25 14:30,1358,746,612,78235,31267,46968,58728186.0,23392782.0,35335404.0,1265,679,586,75830,29887,45943,56926005.0,22300546.0,34625459.0,0.7482,0.7523,0.7462,0.7537
2023-10-25 14:35,340,228,112,17728,9841,7887,13194869.0,7265147.0,5929722.0,304,206,98,16577,9340,7237,12344527.0,6906441.0,5438085.0,0.7383,0.7518,0.7394,0.7514
2023-10-25 14:40,271,129,142,17038,6756,10282,12718485.0,4978559.0,7739926.0,233,100,133,14669,4794,9875,10911499.0,3479098.0,7432401.0,0.7369,0.7528,0.7257,0.7526
2023-10-25 14:45,308,155,153,23524,7659,15865,18367484.0,6392814.0,11974670.0,261,127,134,22298,7431,14867,17317735.0,6096876.0,11220858.0,0.8347,0.7548,0.8205,0.7547
2023-10-25 14:50,241,121,120,15160,5968,9192,11799300.0,4867453.0,6931846.0,221,112,109,14826,6062,8764,11452352.0,4843056.0,6609296.0,0.8156,0.7541,0.7989,0.7541
2023-10-25 14:55,1809,756,1053,144847,60648,84199,110091772.0,46280741.0,63811031.0,1732,720,1012,138966,57138,81828,105221547.0,43302546.0,61919000.0,0.7631,0.7579,0.7579,0.7567
2023-10-25 15:00,546,221,325,44773,17088,27685,33962005.0,12872223.0,21089782.0,517,197,320,43800,16559,27241,33246240.0,12472664.0,20773576.0,0.7533,0.7618,0.7532,0.7626
2023-10-25 15:05,759,560,199,39326,28407,10919,29880370.0,21402234.0,8478135.0,741,556,185,38362,28272,10090,29068633.0,21277037.0,7791595.0,0.7534,0.7765,0.7526,0.7722
2023-10-25 15:10,812,442,370,58559,36107,22452,44129002.0,27160087.0,16968915.0,790,429,361,58104,35641,22463,43788325.0,26810196.0,16978129.0,0.7522,0.7558,0.7522,0.7558
2023-10-25 15:15,631,477,154,49846,39986,9860,37540851.0,30079718.0,7461132.0,617,465,152,49383,39569,9814,37188097.0,29760388.0,7427708.0,0.7523,0.7567,0.7521,0.7568
2023-10-25 15:20,325,134,191,25165,8413,16752,18985734.0,6333402.0,12652331.0,315,128,187,25206,8626,16580,19030943.0,6488670.0,12542273.0,0.7528,0.7553,0.7522,0.7565
2023-10-25 15:25,277,201,76,22148,17337,4811,16671337.0,13038754.0,3632583.0,253,188,65,21131,16603,4528,15913465.0,12484845.0,3428620.0,0.7521,0.7551,0.752,0.7572
2023-10-25 15:30,173,78,95,9482,3000,6482,7170534.0,2272542.0,4897992.0,157,67,90,8941,2753,6188,6751260.0,2071160.0,4680100.0,0.7575,0.7556,0.7523,0.7563
2023-10-25 15:35,140,80,60,9077,4262,4815,6722428.0,3207765.0,3514663.0,123,72,51,6824,3590,3234,5144573.0,2700889.0,2443684.0,0.7526,0.7299,0.7523,0.7556
2023-10-25 15:40,480,392,88,34598,29009,5589,26037175.0,21817402.0,4219772.0,465,385,80,34317,28672,5645,25819341.0,21556245.0,4263096.0,0.7521,0.755,0.7518,0.7552
2023-10-25 15:45,392,308,84,21943,16357,5586,16514005.0,12300525.0,4213479.0,382,302,80,21880,16319,5561,16466681.0,12270848.0,4195832.0,0.752,0.7543,0.7519,0.7545
2023-10-25 15:50,211,110,101,14444,7654,6790,10870342.0,5750522.0,5119820.0,200,106,94,13120,7604,5516,9874151.0,5713707.0,4160443.0,0.7513,0.754,0.7514,0.7543
2023-10-25 15:55,162,81,81,14175,7358,6817,10657619.0,5525817.0,5131801.0,150,75,75,14372,6915,7457,10833803.0,5194330.0,5639472.0,0.751,0.7528,0.7512,0.7563
2023-10-25 16:00,137,68,69,9157,3866,5291,6877189.0,2916150.0,3961038.0,129,66,63,8748,3723,5025,6575987.0,2792155.0,3783832.0,0.7543,0.7486,0.75,0.753
2023-10-25 16:05,472,303,169,38082,24493,13589,28703607.0,18413021.0,10290586.0,453,291,162,37250,24134,13116,28060190.0,18125298.0,9934891.0,0.7518,0.7573,0.751,0.7575
2023-10-25 16:10,266,173,93,21994,16592,5402,16546896.0,12482251.0,4064644.0,257,164,93,20143,14634,5509,15191167.0,11008182.0,4182984.0,0.7523,0.7524,0.7522,0.7593
2023-10-25 16:15,569,199,370,36865,19465,17400,27930666.0,14760715.0,13169951.0,490,134,356,31847,15498,16349,24134688.0,11691308.0,12443379.0,0.7583,0.7569,0.7544,0.7611
2023-10-25 16:20,999,382,617,54276,23374,30902,41505360.0,17767155.0,23738205.0,863,281,582,46289,18557,27732,35342077.0,14009024.0,21333053.0,0.7601,0.7682,0.7549,0.7693
2023-10-25 16:25,463,377,86,26744,19634,7110,20321507.0,14834599.0,5486908.0,422,347,75,24073,17568,6505,18300502.0,13273075.0,5027426.0,0.7556,0.7717,0.7555,0.7729
2023-10-25 16:30,850,324,526,70849,24794,46055,53176868.0,18670539.0,34506329.0,803,290,513,65151,22376,42775,49245190.0,16847551.0,32397638.0,0.753,0.7492,0.7529,0.7574
2023-10-25 16:35,505,169,336,44472,14506,29966,33559357.0,10916115.0,22643242.0,486,154,332,43149,12901,30248,32572834.0,9703239.0,22869595.0,0.7525,0.7556,0.7521,0.7561
2023-10-25 16:40,610,189,421,60273,13054,47219,45506795.0,9829714.0,35677080.0,584,173,411,59566,12856,46710,44972067.0,9677126.0,35294940.0,0.753,0.7556,0.7527,0.7556
2023-10-25 16:45,598,332,266,59781,27508,32273,45084595.0,20712681.0,24371914.0,578,320,258,58579,27213,31366,44188396.0,20486062.0,23702334.0,0.753,0.7552,0.7528,0.7557
2023-10-25 16:50,256,126,130,18722,7578,11144,14123180.0,5721152.0,8402028.0,228,106,122,18430,7244,11186,13908061.0,5451457.0,8456604.0,0.755,0.754,0.7525,0.756
2023-10-25 16:55,203,118,85,13514,8954,4560,10182699.0,6743829.0,3438870.0,190,110,80,13087,8493,4594,9863103.0,6392409.0,3470694.0,0.7532,0.7541,0.7527,0.7555
2023-10-25 17:00,194,121,73,14499,8620,5879,10904634.0,6488656.0,4415978.0,161,93,68,13022,7790,5232,9811450.0,5857989.0,3953461.0,0.7527,0.7511,0.752,0.7556
2023-10-25 17:05,575,267,308,23711,8467,15244,17856550.0,6361448.0,11495102.0,563,257,306,22578,7252,15326,17012279.0,5454120.0,11558158.0,0.7513,0.7541,0.7521,0.7542
2023-10-25 17:10,233,124,109,13994,7274,6720,10488941.0,5463247.0,5025693.0,215,106,109,14174,6915,7259,10682415.0,5191804.0,5490611.0,0.7511,0.7479,0.7508,0.7564
2023-10-25 17:15,522,239,283,16860,3604,13256,12721045.0,2721124.0,9999920.0,488,215,273,15986,3504,12482,12078373.0,2635781.0,9442591.0,0.755,0.7544,0.7522,0.7565
2023-10-25 17:20,380,183,197,21899,8507,13392,16582402.0,6463794.0,10118607.0,357,166,191,22058,8125,13933,16628651.0,6093095.0,10535556.0,0.7598,0.7556,0.7499,0.7562
2023-10-25 17:25,110,55,55,8060,3222,4838,6092871.0,2425396.0,3667474.0,88,42,46,6084,2569,3515,4599088.0,1931811.0,2667277.0,0.7528,0.7581,0.752,0.7588
2023-10-25 17:30,255,130,125,17710,5992,11718,13352087.0,4507481.0,8844605.0,241,123,118,17276,6005,11271,13056411.0,4520271.0,8536139.0,0.7522,0.7548,0.7528,0.7574
2023-10-25 17:35,297,89,208,17737,4688,13049,13392710.0,3532427.0,9860283.0,283,87,196,17226,4571,12655,13004813.0,3440458.0,9564354.0,0.7535,0.7556,0.7527,0.7558
2023-10-25 17:40,263,168,95,22265,14218,8047,16836062.0,10739594.0,6096468.0,246,155,91,21914,13669,8245,16540190.0,10294244.0,6245945.0,0.7554,0.7576,0.7531,0.7575
2023-10-25 17:45,750,382,368,53008,18547,34461,40042420.0,13969532.0,26072887.0,729,368,361,51220,17608,33612,38688295.0,13259820.0,25428474.0,0.7532,0.7566,0.7531,0.7565
2023-10-25 17:50,368,71,297,17702,3703,13999,13410289.0,2830973.0,10579316.0,347,61,286,16779,3332,13447,12693578.0,2510831.0,10182747.0,0.7645,0.7557,0.7536,0.7573
2023-10-25 17:55,290,122,168,18776,8800,9976,14133977.0,6632566.0,7501410.0,284,119,165,19531,8495,11036,14763253.0,6399377.0,8363875.0,0.7537,0.7519,0.7533,0.7579
2023-10-25 18:00,558,172,386,35974,14251,21723,27177506.0,10733275.0,16444231.0,539,158,381,33971,13627,20344,25637598.0,10235968.0,15401629.0,0.7532,0.757,0.7512,0.7571
2023-10-25 18:05,178,79,99,16361,6672,9689,12340834.0,5023245.0,7317589.0,166,71,95,19427,9906,9521,14618388.0,7411423.0,7206964.0,0.7529,0.7552,0.7482,0.757
2023-10-25 18:10,458,114,344,25690,6018,19672,19410720.0,4533854.0,14876865.0,442,104,338,25490,5944,19546,19257049.0,4476015.0,14781033.0,0.7534,0.7562,0.753,0.7562
2023-10-25 18:15,334,42,292,11843,1124,10719,8954677.0,847699.0,8106978.0,322,33,289,11469,834,10635,8671724.0,627278.0,8044446.0,0.7542,0.7563,0.7521,0.7564
2023-10-25 18:20,818,165,653,84258,6893,77365,63758099.0,5193442.0,58564657.0,827,169,658,85286,7345,77941,64534402.0,5532282.0,59002119.0,0.7534,0.757,0.7532,0.757
2023-10-25 18:25,1335,321,1014,104885,12150,92735,79404064.0,9188231.0,70215832.0,1318,310,1008,104158,11870,92288,78841347.0,8950655.0,69890692.0,0.7562,0.7572,0.7541,0.7573
2023-10-25 18:30,297,89,208,24596,3168,21428,18623459.0,2398405.0,16225053.0,294,86,208,24711,3156,21555,18714846.0,2363661.0,16351184.0,0.7571,0.7572,0.7489,0.7586
2023-10-25 18:35,1385,519,866,106498,39609,66889,80889999.0,30080629.0,50809369.0,1362,512,850,105517,39744,65773,79901937.0,29959321.0,49942615.0,0.7594,0.7596,0.7538,0.7593
2023-10-26 10:00,1968,1012,956,121406,61310,60096,91630847.0,45527484.0,46103362.0,1504,771,733,92568,42023,50545,70221975.0,31746906.0,38475068.0,0.7426,0.7672,0.7555,0.7612
2023-10-26 10:05,1247,631,616,87903,48070,39833,65390142.0,35198675.0,30191467.0,1119,571,548,75177,38051,37126,56382692.0,28199690.0,28183002.0,0.7322,0.758,0.7411,0.7591
2023-10-26 10:10,618,356,262,41299,19832,21467,31159302.0,14854357.0,16304945.0,545,309,236,36483,16592,19891,27606183.0,12515998.0,15090184.0,0.749,0.7595,0.7543,0.7586
2023-10-26 10:15,922,501,421,53817,19136,34681,40639055.0,14443313.0,26195742.0,753,418,335,52195,20148,32047,39302331.0,15011681.0,24290649.0,0.7548,0.7553,0.7451,0.758
2023-10-26 10:20,605,374,231,42409,13047,29362,32310698.0,10136515.0,22174183.0,574,358,216,39431,11454,27977,29857864.0,8650697.0,21207166.0,0.7769,0.7552,0.7553,0.758
2023-10-26 10:25,710,426,284,45971,7856,38115,34797818.0,5935724.0,28862093.0,666,414,252,44303,7545,36758,33572266.0,5697984.0,27874281.0,0.7556,0.7572,0.7552,0.7583
2023-10-26 10:30,1926,677,1249,152679,51028,101651,115616725.0,39014480.0,76602244.0,1824,608,1216,144568,47581,96987,109510308.0,36113184.0,73397124.0,0.7646,0.7536,0.759,0.7568
2023-10-26 10:35,1301,628,673,96227,37762,58465,72899836.0,28649236.0,44250600.0,1244,602,642,95323,38181,57142,71994575.0,28737012.0,43257562.0,0.7587,0.7569,0.7527,0.757
2023-10-26 10:40,689,434,255,47200,23355,23845,35677753.0,17621533.0,18056220.0,675,427,248,46879,23147,23732,35450249.0,17460590.0,17989658.0,0.7545,0.7572,0.7543,0.758
2023-10-26 10:45,1490,448,1042,118130,32033,86097,89252956.0,24132272.0,65120683.0,1447,429,1018,116619,31636,84983,88166433.0,23831520.0,64334912.0,0.7534,0.7564,0.7533,0.757
2023-10-26 10:50,678,280,398,55351,25584,29767,41721364.0,19240108.0,22481255.0,655,271,384,54096,25168,28928,40775739.0,18926832.0,21848907.0,0.752,0.7552,0.752,0.7553
2023-10-26 10:55,629,276,353,35949,21479,14470,27075777.0,16166331.0,10909446.0,601,261,340,35323,20982,14341,26608134.0,15784481.0,10823653.0,0.7527,0.7539,0.7523,0.7547
2023-10-26 11:00,395,265,130,27815,19926,7889,20937641.0,14986269.0,5951371.0,388,261,127,27877,20207,7670,20981306.0,15189771.0,5791535.0,0.7521,0.7544,0.7517,0.7551
2023-10-26 11:05,230,152,78,18218,13834,4384,13657340.0,10345891.0,3311448.0,206,139,67,16602,12188,4414,12491030.0,9155823.0,3335207.0,0.7479,0.7553,0.7512,0.7556
2023-10-26 11:10,84,54,30,7014,4658,2356,5280123.0,3502059.0,1778063.0,71,47,24,7154,4707,2447,5397061.0,3545808.0,1851253.0,0.7518,0.7547,0.7533,0.7565
2023-10-26 11:15,214,114,100,11586,5287,6299,9031899.0,4269478.0,4762421.0,200,107,93,10972,4926,6046,8575046.0,4001652.0,4573393.0,0.8075,0.7561,0.8124,0.7564
2023-10-26 11:20,470,232,238,33275,15466,17809,25221460.0,11782024.0,13439436.0,450,222,228,31103,14733,16370,23480330.0,11098922.0,12381407.0,0.7618,0.7546,0.7533,0.7563
2023-10-26 11:25,490,250,240,31929,15775,16154,24137032.0,11908862.0,12228170.0,462,238,224,31602,15647,15955,23873855.0,11796451.0,12077404.0,0.7549,0.757,0.7539,0.757
2023-10-26 11:30,775,305,470,34889,20612,14277,26392015.0,15582921.0,10809094.0,762,300,462,33930,20136,13794,25629110.0,15189383.0,10439727.0,0.756,0.7571,0.7543,0.7568
2023-10-26 11:35,323,155,168,20022,10500,9522,15139729.0,7918087.0,7221641.0,298,142,156,18439,9888,8551,13934878.0,7460936.0,6473942.0,0.7541,0.7584,0.7545,0.7571
2023-10-26 11:40,1241,736,505,126723,89278,37445,96515168.0,68045115.0,28470053.0,1056,625,431,95600,65876,29724,72484408.0,49875945.0,22608463.0,0.7622,0.7603,0.7571,0.7606
2023-10-26 11:45,2059,1309,750,156970,109055,47915,119351759.0,82927545.0,36424214.0,1617,998,619,153869,115439,38430,116765353.0,87474878.0,29290475.0,0.7604,0.7602,0.7578,0.7622
2023-10-26 11:50,1054,654,400,66543,45112,21431,50766321.0,34483598.0,16282722.0,767,428,339,64005,45701,18304,48000471.0,34050121.0,13950349.0,0.7644,0.7598,0.7451,0.7621
2023-10-26 11:55,1233,766,467,89729,67232,22497,68499781.0,51370277.0,17129503.0,1120,706,414,79442,61228,18214,60380372.0,46477986.0,13902385.0,0.7641,0.7614,0.7591,0.7633
2023-10-26 12:00,505,328,177,43326,32339,10987,32887318.0,24542598.0,8344720.0,445,304,141,36544,31758,4786,27743591.0,24088318.0,3655272.0,0.7589,0.7595,0.7585,0.7637
2023-10-26 12:05,379,223,156,26567,17734,8833,19976970.0,13442115.0,6534855.0,311,191,120,22397,16600,5797,16987837.0,12567616.0,4420221.0,0.758,0.7398,0.7571,0.7625
2023-10-26 12:10,300,194,106,17049,11634,5415,12917200.0,8798634.0,4118566.0,273,177,96,16181,10560,5621,12290561.0,8007421.0,4283139.0,0.7563,0.7606,0.7583,0.762
2023-10-26 12:15,832,410,422,74906,42438,32468,56797365.0,32234739.0,24562626.0,762,380,382,71293,40761,30532,54141690.0,30906161.0,23235529.0,0.7596,0.7565,0.7582,0.761
2023-10-26 12:20,529,362,167,29004,20546,8458,21970556.0,15593873.0,6376683.0,481,334,147,27201,19597,7604,20643114.0,14855706.0,5787407.0,0.759,0.7539,0.7581,0.7611
2023-10-26 12:25,273,138,135,24444,10891,13553,18464974.0,8262408.0,10202565.0,219,109,110,21287,10320,10967,16173101.0,7817906.0,8355195.0,0.7586,0.7528,0.7575,0.7618
2023-10-26 12:30,347,73,274,37305,5370,31935,28355576.0,4083364.0,24272211.0,332,66,266,36768,5033,31735,27938358.0,3811957.0,24126401.0,0.7604,0.7601,0.7574,0.7602
2023-10-26 12:35,291,203,88,16958,12090,4868,12928334.0,9238193.0,3690140.0,256,178,78,15766,11197,4569,11962579.0,8488693.0,3473885.0,0.7641,0.758,0.7581,0.7603
2023-10-26 12:40,377,241,136,20014,11739,8275,15218923.0,8975679.0,6243244.0,309,213,96,18217,10676,7541,13839104.0,8088075.0,5751028.0,0.7646,0.7545,0.7576,0.7626
2023-10-26 12:45,180,120,60,9088,5799,3289,6882063.0,4392497.0,2489565.0,154,103,51,8371,5181,3190,6351606.0,3925996.0,2425610.0,0.7575,0.7569,0.7578,0.7604
2023-10-26 12:50,162,117,45,8195,5874,2321,6221626.0,4485170.0,1736455.0,136,106,30,6904,5389,1515,5235086.0,4082303.0,1152782.0,0.7636,0.7481,0.7575,0.7609
2023-10-26 12:55,149,97,52,9399,5252,4147,7160035.0,4012831.0,3147204.0,128,90,38,7074,5059,2015,5367798.0,3834812.0,1532985.0,0.7641,0.7589,0.758,0.7608
2023-10-26 13:00,189,145,44,11009,9800,1209,8341696.0,7425992.0,915703.0,141,116,25,9002,8423,579,6827194.0,6386882.0,440312.0,0.7578,0.7574,0.7583,0.7605
2023-10-26 13:05,63,38,25,3076,2374,702,2319957.0,1811848.0,508109.0,47,30,17,2297,1933,364,1739731.0,1462473.0,277257.0,0.7632,0.7238,0.7566,0.7617
2023-10-26 13:10,87,70,17,6636,6039,597,5029115.0,4575856.0,453258.0,68,57,11,6551,6102,449,4964386.0,4622347.0,342038.0,0.7577,0.7592,0.7575,0.7618
2023-10-26 13:15,94,62,32,6161,3649,2512,4667707.0,2761910.0,1905797.0,90,62,28,5023,3596,1427,3809698.0,2722126.0,1087572.0,0.7569,0.7587,0.757,0.7621
2023-10-26 13:20,128,78,50,10170,7953,2217,7855318.0,6174318.0,1681000.0,110,72,38,6521,4880,1641,4944997.0,3695807.0,1249190.0,0.7764,0.7582,0.7573,0.7612
2023-10-26 13:25,56,24,32,1585,893,692,1211891.0,686387.0,525504.0,38,15,23,2017,1397,620,1526444.0,1055040.0,471404.0,0.7686,0.7594,0.7552,0.7603
2023-10-26 13:30,135,83,52,12274,9429,2845,9291851.0,7129544.0,2162307.0,111,73,38,10380,7804,2576,7856722.0,5895147.0,1961575.0,0.7561,0.76,0.7554,0.7615
2023-10-26 13:35,165,107,58,11517,7486,4031,8890498.0,5823228.0,3067270.0,138,95,43,10286,7317,2969,7806012.0,5545029.0,2260983.0,0.7779,0.7609,0.7578,0.7615
2023-10-26 13:40,173,103,70,11996,6084,5912,9110439.0,4636237.0,4474201.0,144,92,52,10359,5457,4902,7865807.0,4137486.0,3728320.0,0.762,0.7568,0.7582,0.7606
2023-10-26 13:45,251,175,76,25277,20216,5061,19352177.0,15528345.0,3823832.0,217,165,52,23146,18767,4379,17502040.0,14170348.0,3331691.0,0.7681,0.7555,0.7551,0.7608
2023-10-26 13:50,2144,1333,811,162881,91085,71796,124501680.0,70014568.0,54487111.0,1737,1047,690,132332,71373,60959,100473710.0,54041972.0,46431738.0,0.7687,0.7589,0.7572,0.7617
2023-10-26 13:55,1421,668,753,114544,36271,78273,87115593.0,27691978.0,59423615.0,1224,518,706,105727,32039,73688,80412497.0,24282261.0,56130236.0,0.7635,0.7592,0.7579,0.7617
2023-10-26 14:00,1070,842,228,58724,46391,12333,45105264.0,35702406.0,9402858.0,846,702,144,49151,40653,8498,37403908.0,30896261.0,6507646.0,0.7696,0.7624,0.76,0.7658
2023-10-26 14:05,1963,1069,894,128290,68079,60211,97617416.0,52083384.0,45534031.0,1646,919,727,106732,59827,46905,81357445.0,45447919.0,35909525.0,0.765,0.7562,0.7597,0.7656
2023-10-26 14:10,2637,965,1672,230361,48521,181840,174969384.0,36993291.0,137976092.0,2380,812,1568,218475,41043,177432,166455686.0,31143815.0,135311871.0,0.7624,0.7588,0.7588,0.7626
2023-10-26 14:15,2935,1652,1283,217246,148151,69095,167525657.0,114476692.0,53048965.0,2216,1454,762,177856,124200,53656,136091636.0,94773650.0,41317985.0,0.7727,0.7678,0.7631,0.7701
2023-10-26 14:20,4392,2489,1903,362396,234314,128082,279644981.0,181332279.0,98312702.0,3016,1953,1063,263678,179760,83918,203892454.0,138631676.0,65260778.0,0.7739,0.7676,0.7712,0.7777
2023-10-26 14:25,3960,1915,2045,319540,146354,173186,246447834.0,113525042.0,132922791.0,3206,1558,1648,279486,127832,151654,215678632.0,97958011.0,117720621.0,0.7757,0.7675,0.7663,0.7762
2023-10-26 14:30,2699,1208,1491,192848,86223,106625,150034590.0,67676698.0,82357892.0,2285,988,1297,164276,72827,91449,127059272.0,56180895.0,70878377.0,0.7849,0.7724,0.7714,0.7751
2023-10-26 14:35,3913,2107,1806,338115,191313,146802,264181735.0,149729908.0,114451826.0,3078,1711,1367,280720,161243,119477,218681283.0,125177368.0,93503914.0,0.7826,0.7796,0.7763,0.7826
2023-10-26 14:40,4532,2828,1704,371428,235536,135892,291733676.0,186356715.0,105376961.0,3399,2242,1157,298841,195909,102932,233566568.0,152622242.0,80944326.0,0.7912,0.7754,0.779,0.7864
2023-10-26 14:45,3104,1981,1123,292308,221168,71140,229868680.0,174112913.0,55755766.0,2515,1713,802,248792,197555,51237,194870219.0,154592694.0,40277524.0,0.7872,0.7837,0.7825,0.7861
2023-10-26 14:50,2731,1190,1541,228919,94150,134769,177939969.0,73446444.0,104493524.0,2065,924,1141,168120,68250,99870,131859382.0,53263462.0,78595919.0,0.7801,0.7754,0.7804,0.787
2023-10-26 14:55,2572,1429,1143,200123,93043,107080,156938487.0,73152932.0,83785555.0,2136,1249,887,167935,76253,91682,131699988.0,59437839.0,72262148.0,0.7862,0.7825,0.7795,0.7882
2023-10-26 15:00,3056,1306,1750,262828,95680,167148,205293348.0,75828229.0,129465119.0,2538,1044,1494,213705,84183,129522,168010312.0,66594439.0,101415872.0,0.7925,0.7746,0.7911,0.783
2023-10-26 15:05,2309,1122,1187,154356,71394,82962,121344010.0,56983034.0,64360976.0,1891,932,959,136067,62845,73222,107170604.0,50072683.0,57097921.0,0.7981,0.7758,0.7968,0.7798
2023-10-26 15:10,1470,930,540,137057,95254,41803,106907649.0,74407230.0,32500419.0,1260,864,396,115039,82148,32891,89428358.0,63710839.0,25717519.0,0.7811,0.7775,0.7756,0.7819
2023-10-26 15:15,1216,699,517,86539,52483,34056,67422727.0,40976951.0,26445776.0,1073,625,448,78086,51701,26385,60786401.0,40141405.0,20644995.0,0.7808,0.7765,0.7764,0.7825
2023-10-26 15:20,2164,882,1282,182904,44648,138256,140881608.0,34527796.0,106353811.0,1839,704,1135,167814,40979,126835,130567851.0,31759831.0,98808020.0,0.7733,0.7693,0.775,0.779
2023-10-26 15:25,1031,534,497,69721,35939,33782,53764691.0,27853001.0,25911690.0,822,416,406,62788,34131,28657,47992613.0,25716347.0,22276266.0,0.775,0.767,0.7535,0.7773
2023-10-26 15:30,1781,865,916,122874,44975,77899,93607742.0,34583825.0,59023916.0,1377,618,759,89528,32090,57438,69189883.0,24670437.0,44519446.0,0.769,0.7577,0.7688,0.7751
2023-10-26 15:35,1626,1023,603,90689,50416,40273,71364174.0,40369268.0,30994905.0,1257,771,486,85128,48870,36258,66853380.0,38825671.0,28027708.0,0.8007,0.7696,0.7945,0.773
2023-10-26 15:40,1661,800,861,128099,51596,76503,98248078.0,39878111.0,58369967.0,1379,637,742,113778,45130,68648,87487484.0,34514635.0,52972848.0,0.7729,0.763,0.7648,0.7717
2023-10-26 15:45,1344,561,783,113017,41635,71382,87088247.0,32119357.0,54968890.0,1273,505,768,106216,37842,68374,81757554.0,28990183.0,52767370.0,0.7715,0.7701,0.7661,0.7717
2023-10-26 15:50,2335,973,1362,217249,78632,138617,166223215.0,60702819.0,105520395.0,1987,780,1207,187233,63248,123985,144184353.0,48838641.0,95345712.0,0.772,0.7612,0.7722,0.769
2023-10-26 15:55,1851,970,881,171114,92400,78714,132958820.0,72490555.0,60468265.0,1607,856,751,159793,91026,68767,124171337.0,71093444.0,53077893.0,0.7845,0.7682,0.781,0.7719
2023-10-26 16:00,1452,1027,425,108858,75512,33346,84365362.0,58501390.0,25863971.0,1237,914,323,96667,67404,29263,74544887.0,51840579.0,22704308.0,0.7747,0.7756,0.7691,0.7759
2023-10-26 16:05,1621,798,823,105811,55536,50275,81875448.0,43048958.0,38826490.0,1445,710,735,95116,51393,43723,74937924.0,40989293.0,33948630.0,0.7752,0.7723,0.7976,0.7764
2023-10-26 16:10,545,292,253,35625,19068,16557,27599566.0,14750725.0,12848840.0,472,252,220,34248,18499,15749,26497347.0,14262347.0,12235000.0,0.7736,0.776,0.771,0.7769
2023-10-26 16:15,902,544,358,60395,31996,28399,46665363.0,24795481.0,21869882.0,803,488,315,56463,30108,26355,43718181.0,23271740.0,20446440.0,0.775,0.7701,0.7729,0.7758
2023-10-26 16:20,604,248,356,39353,15610,23743,30436178.0,12035993.0,18400184.0,538,208,330,38428,14118,24310,29764342.0,10861057.0,18903285.0,0.771,0.775,0.7693,0.7776
2023-10-26 16:25,259,123,136,19871,9619,10252,15301888.0,7373850.0,7928037.0,205,100,105,14192,7204,6988,10951784.0,5513546.0,5438237.0,0.7666,0.7733,0.7653,0.7782
2023-10-26 16:30,243,165,78,12986,9604,3382,10041445.0,7449238.0,2592207.0,152,88,64,10549,7807,2742,8134559.0,6007563.0,2126995.0,0.7756,0.7665,0.7695,0.7757
2023-10-26 16:35,796,325,471,70451,33228,37223,53915097.0,25546158.0,28368939.0,696,260,436,62421,30019,32402,48146999.0,23071111.0,25075888.0,0.7688,0.7621,0.7686,0.7739
2023-10-26 16:40,1159,713,446,67644,35786,31858,52154474.0,27552435.0,24602038.0,963,540,423,65164,33383,31781,50287708.0,25690749.0,24596958.0,0.7699,0.7722,0.7696,0.774
2023-10-26 16:45,589,442,147,27718,18115,9603,21458789.0,14000828.0,7457961.0,520,403,117,29280,20617,8663,22601874.0,15868024.0,6733849.0,0.7729,0.7766,0.7697,0.7773
2023-10-26 16:50,429,138,291,26794,15347,11447,20651055.0,11820333.0,8830722.0,385,115,270,25931,14758,11173,19994711.0,11342750.0,8651961.0,0.7702,0.7714,0.7686,0.7744
2023-10-26 16:55,2125,1294,831,209266,119823,89443,162702065.0,93153399.0,69548666.0,1769,1092,677,174471,99105,75366,135239989.0,76554433.0,58685555.0,0.7774,0.7776,0.7725,0.7787
2023-10-26 17:00,1176,620,556,96460,57754,38706,74741458.0,44718163.0,30023295.0,1059,570,489,93175,57503,35672,72225221.0,44400942.0,27824278.0,0.7743,0.7757,0.7722,0.78
2023-10-26 17:05,1070,539,531,68701,31996,36705,53404667.0,24945265.0,28459401.0,993,496,497,63932,29109,34823,49658279.0,22527773.0,27130506.0,0.7796,0.7754,0.7739,0.7791
2023-10-26 17:10,838,569,269,51139,35784,15355,39820371.0,27826420.0,11993950.0,758,536,222,47073,35356,11717,36514197.0,27371405.0,9142791.0,0.7776,0.7811,0.7742,0.7803
2023-10-26 17:15,1698,617,1081,109715,49209,60506,84949474.0,38057330.0,46892144.0,1569,552,1017,101915,45717,56198,79085975.0,35354075.0,43731899.0,0.7734,0.775,0.7733,0.7782
2023-10-26 17:20,1008,446,562,73157,36523,36634,55745612.0,27451960.0,28293651.0,879,366,513,58911,27895,31016,45512614.0,21451490.0,24061123.0,0.7516,0.7723,0.769,0.7758
2023-10-26 17:25,1770,940,830,142682,72767,69915,109112838.0,55704623.0,53408215.0,1513,788,725,115490,57924,57566,88737453.0,44362883.0,44374569.0,0.7655,0.7639,0.7659,0.7708
2023-10-26 17:30,1947,1027,920,142430,73989,68441,109669495.0,56937385.0,52732110.0,1765,935,830,134269,70724,63545,103107889.0,54129222.0,48978666.0,0.7695,0.7705,0.7654,0.7708
2023-10-26 17:35,755,374,381,55633,23963,31670,42893698.0,18413018.0,24480680.0,693,350,343,52159,22706,29453,40224919.0,17436201.0,22788717.0,0.7684,0.773,0.7679,0.7737
2023-10-26 17:40,803,363,440,59910,29119,30791,45990265.0,22363227.0,23627038.0,733,323,410,57159,27661,29498,43992022.0,21228366.0,22763656.0,0.768,0.7673,0.7674,0.7717
2023-10-26 17:45,546,232,314,34497,17081,17416,26370423.0,13119037.0,13251385.0,481,192,289,31269,15418,15851,24049063.0,11818252.0,12230810.0,0.768,0.7609,0.7665,0.7716
2023-10-26 17:50,1127,284,843,53954,12567,41387,41476123.0,9656155.0,31819968.0,1065,246,819,50500,10951,39549,38847366.0,8391344.0,30456021.0,0.7684,0.7688,0.7663,0.7701
2023-10-26 17:55,740,391,349,52560,26263,26297,40057675.0,20042534.0,20015141.0,688,358,330,49799,24620,25179,38191431.0,18780162.0,19411269.0,0.7631,0.7611,0.7628,0.7709
2023-10-26 18:00,995,556,439,71872,37075,34797,55246704.0,28472348.0,26774355.0,958,537,421,71514,36984,34530,54991639.0,28344131.0,26647508.0,0.768,0.7694,0.7664,0.7717
2023-10-26 18:05,840,389,451,58358,22171,36187,44772276.0,17031194.0,27741082.0,765,345,420,52914,20239,32675,40647904.0,15500613.0,25147291.0,0.7682,0.7666,0.7659,0.7696
2023-10-26 18:10,608,188,420,41945,10870,31075,32218537.0,8380310.0,23838227.0,543,144,399,37634,7198,30436,28889824.0,5480509.0,23409315.0,0.771,0.7671,0.7614,0.7691
2023-10-26 18:15,15362,5866,9496,1741949,635230,1106719,1357203712.0,495339145.0,861864567.0,14308,5443,8865,1602856,565507,1037349,1245607148.0,437231391.0,808375756.0,0.7798,0.7788,0.7732,0.7793
2023-10-26 18:20,3449,2069,1380,337387,223295,114092,264201313.0,175039398.0,89161914.0,2911,1853,1058,294088,197252,96836,229849684.0,153645774.0,76203910.0,0.7839,0.7815,0.7789,0.7869
2023-10-26 18:25,1464,640,824,96651,51235,45416,75917159.0,40773746.0,35143413.0,1114,532,582,77539,37599,39940,61080282.0,29452031.0,31628250.0,0.7958,0.7738,0.7833,0.7919
2023-10-26 18:30,3696,2119,1577,424094,254411,169683,331657783.0,199239677.0,132418106.0,3298,1965,1333,383554,237299,146255,300893329.0,185637967.0,115255362.0,0.7831,0.7804,0.7823,0.788
2023-10-26 18:35,1652,1089,563,134076,90104,43972,105964942.0,70972885.0,34992057.0,1467,1034,433,119716,85153,34563,94689807.0,66636098.0,28053709.0,0.7877,0.7958,0.7825,0.8117
2023-10-27 10:00,8195,5451,2744,702618,520908,181710,558375902.0,414446011.0,143929890.0,6759,4775,1984,604432,474117,130315,478467715.0,375002131.0,103465583.0,0.7956,0.7921,0.7909,0.794
2023-10-27 10:05,2407,1183,1224,176029,86933,89096,138167247.0,68523407.0,69643839.0,1856,932,924,143740,72041,71699,113196153.0,56525498.0,56670654.0,0.7882,0.7817,0.7846,0.7904
2023-10-27 10:10,2934,1377,1557,217586,93801,123785,168232278.0,73083601.0,95148676.0,2286,999,1287,174169,70086,104083,136012676.0,54463896.0,81548780.0,0.7791,0.7687,0.7771,0.7835
2023-10-27 10:15,866,464,402,58538,30295,28243,45508931.0,23526731.0,21982199.0,672,360,312,46715,21531,25184,36417287.0,16667445.0,19749841.0,0.7766,0.7783,0.7741,0.7842
2023-10-27 10:20,1422,611,811,89148,31119,58029,69492129.0,24166458.0,45325671.0,1179,467,712,82790,28331,54459,64566635.0,21935535.0,42631100.0,0.7766,0.7811,0.7743,0.7828
2023-10-27 10:25,1797,926,871,122124,47902,74222,95542748.0,37459199.0,58083549.0,1599,804,795,110498,39527,70971,86286296.0,30714197.0,55572098.0,0.782,0.7826,0.777,0.783
2023-10-27 10:30,1759,1076,683,113156,68790,44366,88166773.0,53573894.0,34592879.0,1624,1008,616,108322,67665,40657,84509831.0,52658345.0,31851486.0,0.7788,0.7797,0.7782,0.7834
2023-10-27 10:35,978,518,460,66999,25986,41013,52601651.0,20362418.0,32239233.0,893,469,424,60227,22454,37773,47033853.0,17415171.0,29618682.0,0.7836,0.7861,0.7756,0.7841
2023-10-27 10:40,1434,1123,311,93299,68310,24989,72940099.0,53210457.0,19729642.0,1353,1084,269,87051,65926,21125,67879785.0,51337198.0,16542586.0,0.779,0.7895,0.7787,0.7831
2023-10-27 10:45,1074,773,301,66042,45635,20407,51782252.0,35756944.0,16025308.0,1011,737,274,62376,42650,19726,48712959.0,33220379.0,15492580.0,0.7835,0.7853,0.7789,0.7854
2023-10-27 10:50,1684,1125,559,134215,90554,43661,105076327.0,70747070.0,34329257.0,1633,1110,523,130154,87897,42257,101829906.0,68596315.0,33233591.0,0.7813,0.7863,0.7804,0.7865
2023-10-27 10:55,2482,1317,1165,169290,83170,86120,132199446.0,64888038.0,67311408.0,2361,1253,1108,163703,81384,82319,127922175.0,63428113.0,64494062.0,0.7802,0.7816,0.7794,0.7835
2023-10-27 11:00,2398,1286,1112,169204,84359,84845,131557564.0,65608337.0,65949227.0,2238,1173,1065,164930,81283,83647,128613001.0,63180933.0,65432068.0,0.7777,0.7773,0.7773,0.7822
2023-10-27 11:05,2459,1344,1115,206638,125444,81194,161705796.0,98156822.0,63548974.0,2374,1308,1066,193471,116536,76935,151263724.0,90894121.0,60369603.0,0.7825,0.7827,0.78,0.7847
2023-10-27 11:10,1444,684,760,105278,48758,56520,82003358.0,37840277.0,44163081.0,1392,659,733,102370,47329,55041,79926350.0,36826191.0,43100158.0,0.7761,0.7814,0.7781,0.7831
2023-10-27 11:15,1208,613,595,81269,42285,38984,63395698.0,32899509.0,30496189.0,1143,570,573,78795,40899,37896,61490883.0,31836877.0,29654005.0,0.778,0.7823,0.7784,0.7825
2023-10-27 11:20,1763,700,1063,118382,58473,59909,92693200.0,45757304.0,46935896.0,1702,668,1034,115905,56848,59057,90624162.0,44344068.0,46280094.0,0.7825,0.7835,0.78,0.7837
2023-10-27 11:25,744,261,483,44322,19271,25051,34660912.0,15050117.0,19610795.0,717,249,468,44928,20178,24750,35067294.0,15685320.0,19381973.0,0.781,0.7828,0.7773,0.7831
2023-10-27 11:30,927,454,473,61686,27443,34243,48174423.0,21403369.0,26771054.0,892,435,457,61875,29906,31969,48334121.0,23316339.0,25017782.0,0.7799,0.7818,0.7797,0.7826
2023-10-27 11:35,268,109,159,18642,7671,10971,14395959.0,5995230.0,8400728.0,235,90,145,15920,6517,9403,12409669.0,5059758.0,7349911.0,0.7815,0.7657,0.7764,0.7817
2023-10-27 11:40,450,318,132,24259,16313,7946,18862527.0,12669163.0,6193364.0,419,297,122,18442,11284,7158,14363399.0,8770633.0,5592765.0,0.7766,0.7794,0.7773,0.7813
2023-10-27 11:45,455,280,175,24315,10018,14297,18959681.0,7776992.0,11182689.0,436,273,163,23445,9457,13988,18279545.0,7349892.0,10929652.0,0.7763,0.7822,0.7772,0.7814
2023-10-27 11:50,535,195,340,46402,17100,29302,36112575.0,13299796.0,22812779.0,496,175,321,43773,15656,28117,34167298.0,12177957.0,21989341.0,0.7778,0.7785,0.7778,0.7821
2023-10-27 11:55,288,160,128,21131,10370,10761,16381059.0,8082931.0,8298127.0,260,149,111,19439,9566,9873,15154619.0,7437572.0,7717047.0,0.7795,0.7711,0.7775,0.7816
2023-10-27 12:00,658,204,454,44176,11903,32273,34354138.0,9260526.0,25093612.0,631,190,441,42889,11473,31416,33445514.0,8921113.0,24524401.0,0.778,0.7775,0.7776,0.7806
2023-10-27 12:05,369,192,177,24696,11050,13646,19149950.0,8506401.0,10643549.0,337,173,164,22285,8414,13871,17336160.0,6502964.0,10833195.0,0.7698,0.78,0.7729,0.781
2023-10-27 12:10,352,160,192,22132,6333,15799,17073325.0,4888632.0,12184692.0,324,141,183,19582,4939,14643,15274598.0,3840460.0,11434137.0,0.7719,0.7712,0.7776,0.7809
2023-10-27 12:15,574,348,226,21363,11185,10178,16657233.0,8721195.0,7936038.0,528,317,211,19560,9646,9914,15246664.0,7505054.0,7741610.0,0.7797,0.7797,0.778,0.7809
2023-10-27 12:20,328,170,158,17434,8012,9422,13559334.0,6212119.0,7347214.0,302,156,146,13658,4325,9333,10652373.0,3364321.0,7288052.0,0.7754,0.7798,0.7779,0.7809
2023-10-27 12:25,573,210,363,36831,11930,24901,28709887.0,9251290.0,19458597.0,542,192,350,35001,10497,24504,27256597.0,8107044.0,19149552.0,0.7755,0.7814,0.7723,0.7815
2023-10-27 12:30,196,74,122,12050,2905,9145,9420820.0,2271408.0,7149412.0,170,60,110,11613,2059,9554,9084086.0,1599172.0,7484914.0,0.7819,0.7818,0.7767,0.7834
2023-10-27 12:35,402,114,288,26947,5340,21607,21515274.0,4165384.0,17349890.0,380,104,276,23684,4443,19241,18740473.0,3458957.0,15281516.0,0.78,0.803,0.7785,0.7942
2023-10-27 12:40,535,92,443,15113,2543,12570,11766675.0,1980338.0,9786336.0,509,82,427,15060,2630,12430,11766846.0,2045071.0,9721774.0,0.7787,0.7785,0.7776,0.7821
2023-10-27 12:45,273,89,184,15018,4643,10375,11782690.0,3686323.0,8096367.0,237,73,164,13260,3438,9822,10360073.0,2678889.0,7681184.0,0.794,0.7804,0.7792,0.782
2023-10-27 12:50,683,383,300,39739,23733,16006,31115357.0,18584975.0,12530381.0,636,352,284,37739,22236,15503,29483252.0,17339437.0,12143814.0,0.7831,0.7829,0.7798,0.7833
2023-10-27 12:55,873,419,454,48273,27378,20895,38064628.0,21674212.0,16390416.0,753,354,399,42305,23143,19162,33137568.0,18089741.0,15047826.0,0.7917,0.7844,0.7817,0.7853
2023-10-27 13:00,669,471,198,43846,29232,14614,34631557.0,23186225.0,11445331.0,598,439,159,39229,28552,10677,30758776.0,22351828.0,8406948.0,0.7932,0.7832,0.7828,0.7874
2023-10-27 13:05,757,369,388,56064,31441,24623,43821460.0,24588864.0,19232595.0,693,331,362,52826,30250,22576,41391175.0,23648187.0,17742987.0,0.7821,0.7811,0.7818,0.7859
2023-10-27 13:10,467,259,208,34786,18791,15995,27188818.0,14676984.0,12511834.0,429,237,192,33287,17762,15525,26059392.0,13874014.0,12185378.0,0.7811,0.7822,0.7811,0.7849
2023-10-27 13:15,1516,686,830,109707,66428,43279,86014891.0,52044130.0,33970760.0,1481,672,809,109548,66257,43291,85803461.0,51814642.0,33988819.0,0.7835,0.7849,0.782,0.7851
2023-10-27 13:20,494,108,386,21036,6650,14386,16543743.0,5232748.0,11310995.0,459,94,365,20629,6542,14087,16201879.0,5121341.0,11080537.0,0.7869,0.7863,0.7828,0.7866
2023-10-27 13:25,332,175,157,36318,18979,17339,28692687.0,14872286.0,13820401.0,295,157,138,23204,13903,9301,18207592.0,10885953.0,7321638.0,0.7836,0.7971,0.783,0.7872
2023-10-27 13:30,4725,2416,2309,444184,226470,217714,345010196.0,177310052.0,167700143.0,4286,2179,2107,408798,216155,192643,319489743.0,168951167.0,150538576.0,0.7829,0.7703,0.7816,0.7814
2023-10-27 13:35,3344,1363,1981,325194,87776,237418,251079062.0,67964689.0,183114373.0,2999,1170,1829,299793,75458,224335,232004302.0,58070058.0,173934244.0,0.7743,0.7713,0.7696,0.7753
2023-10-27 13:40,2237,1083,1154,183725,83629,100096,143607394.0,65765927.0,77841467.0,1889,873,1016,154009,67834,86175,119593811.0,52821553.0,66772258.0,0.7864,0.7777,0.7787,0.7748
2023-10-27 13:45,1909,1136,773,156830,107802,49028,125255567.0,83881520.0,41374047.0,1755,1077,678,154821,109342,45479,122656232.0,84526984.0,38129247.0,0.7781,0.8439,0.7731,0.8384
2023-10-27 13:50,953,564,389,86362,62601,23761,68103832.0,48225311.0,19878520.0,856,513,343,78026,56706,21320,62735948.0,43795696.0,18940252.0,0.7704,0.8366,0.7723,0.8884
2023-10-27 13:55,1829,1120,709,158217,117020,41197,123263779.0,90415485.0,32848294.0,1762,1091,671,151725,112081,39644,118381984.0,86625571.0,31756413.0,0.7726,0.7973,0.7729,0.801
2023-10-27 14:00,1680,656,1024,126912,66153,60759,98690350.0,50927719.0,47762630.0,1584,614,970,124022,65402,58620,96730935.0,50336665.0,46394270.0,0.7698,0.7861,0.7697,0.7914
2023-10-27 14:05,1454,720,734,101235,48786,52449,78759385.0,37791444.0,40967941.0,1341,659,682,95676,46082,49594,74382667.0,35498038.0,38884629.0,0.7746,0.7811,0.7703,0.7841
2023-10-27 14:10,1909,1093,816,129085,84484,44601,99746531.0,65308265.0,34438265.0,1796,1037,759,122295,80479,41816,94547034.0,62104811.0,32442222.0,0.773,0.7721,0.7717,0.7758
2023-10-27 14:15,3022,1809,1213,270082,209959,60123,210664299.0,163727724.0,46936575.0,2848,1737,1111,251733,197954,53779,195653142.0,153652103.0,42001039.0,0.7798,0.7807,0.7762,0.781
2023-10-27 14:20,1781,1025,756,121569,97198,24371,94513427.0,75567801.0,18945626.0,1696,981,715,117720,95522,22198,91520816.0,74169341.0,17351474.0,0.7775,0.7774,0.7765,0.7817
2023-10-27 14:25,1214,965,249,92603,83846,8757,71986593.0,65256641.0,6729952.0,1144,936,208,90997,83212,7785,70849653.0,64732941.0,6116712.0,0.7783,0.7685,0.7779,0.7857
2023-10-27 14:30,1181,630,551,91379,77748,13631,70942388.0,60298295.0,10644093.0,1128,596,532,90175,76948,13227,70029035.0,59693938.0,10335096.0,0.7756,0.7809,0.7758,0.7814
2023-10-27 14:35,4141,1712,2429,449802,157115,292687,348608902.0,121543288.0,227065613.0,3961,1607,2354,428799,145863,282936,333079198.0,112883891.0,220195306.0,0.7736,0.7758,0.7739,0.7783
2023-10-27 14:40,842,345,497,93008,26837,66171,72246636.0,20722611.0,51524025.0,788,322,466,86817,22477,64340,67510099.0,17351040.0,50159059.0,0.7722,0.7786,0.7719,0.7796
2023-10-27 14:45,524,299,225,41376,17044,24332,32021397.0,13098242.0,18923155.0,486,290,196,42680,21192,21488,33010530.0,16271007.0,16739523.0,0.7685,0.7777,0.7678,0.779
2023-10-27 14:50,904,441,463,80215,26713,53502,62310716.0,20679650.0,41631066.0,881,428,453,82026,27154,54872,63706911.0,21000417.0,42706494.0,0.7741,0.7781,0.7734,0.7783
2023-10-27 14:55,901,546,355,76910,33235,43675,59728933.0,25732919.0,33996013.0,871,530,341,75833,32607,43226,58882779.0,25233840.0,33648939.0,0.7743,0.7784,0.7739,0.7784
2023-10-27 15:00,1093,421,672,130578,29822,100756,101555451.0,23062012.0,78493439.0,1050,403,647,127842,27980,99862,99473551.0,21632181.0,77841370.0,0.7733,0.779,0.7731,0.7795
2023-10-27 15:05,730,316,414,62041,23556,38485,48112725.0,18172887.0,29939838.0,708,305,403,57347,19291,38056,44529272.0,14919943.0,29609329.0,0.7715,0.778,0.7734,0.778
2023-10-27 15:10,1611,1010,601,121869,67741,54128,94737917.0,52568561.0,42169356.0,1561,990,571,122448,69735,52713,94955809.0,53885615.0,41070194.0,0.776,0.7791,0.7727,0.7791
2023-10-27 15:15,687,342,345,46651,19358,27293,36332514.0,15037624.0,21294889.0,640,317,323,46771,19892,26879,36389093.0,15411135.0,20977958.0,0.7768,0.7802,0.7747,0.7805
2023-10-27 15:20,804,370,434,40608,18165,22443,31616516.0,14125885.0,17490631.0,753,337,416,44163,21596,22567,34290709.0,16605101.0,17685608.0,0.7776,0.7793,0.7689,0.7837
2023-10-27 15:25,1702,799,903,114124,48608,65516,88924024.0,37773289.0,51150735.0,1668,771,897,112641,47025,65616,87796607.0,36554281.0,51242325.0,0.7771,0.7807,0.7773,0.7809
2023-10-27 15:30,507,273,234,30163,15519,14644,23536793.0,12052045.0,11484748.0,479,257,222,26666,14224,12442,20812374.0,11047385.0,9764988.0,0.7766,0.7843,0.7767,0.7848
2023-10-27 15:35,455,290,165,28331,19312,9019,21994361.0,15019399.0,6974962.0,424,269,155,26184,18086,8098,20390229.0,14052950.0,6337278.0,0.7777,0.7734,0.777,0.7826
2023-10-27 15:40,643,278,365,30192,15038,15154,23533152.0,11697446.0,11835705.0,625,266,359,29627,14919,14708,23110496.0,11603368.0,11507128.0,0.7779,0.781,0.7778,0.7824
2023-10-27 15:45,790,512,278,49274,30327,18947,38547186.0,23715339.0,14831847.0,757,495,262,46901,28357,18544,36580687.0,22047793.0,14532894.0,0.782,0.7828,0.7775,0.7837
2023-10-27 15:50,443,353,90,22333,14001,8332,17440174.0,10912051.0,6528123.0,441,358,83,22304,15144,7160,17403192.0,11788595.0,5614597.0,0.7794,0.7835,0.7784,0.7842
2023-10-27 15:55,1360,613,747,110934,56346,54588,86259523.0,43782296.0,42477226.0,1310,586,724,107243,53334,53909,83552172.0,41456133.0,42096039.0,0.777,0.7781,0.7773,0.7809
2023-10-27 16:00,407,58,349,8056,2233,5823,6269824.0,1751810.0,4518014.0,389,51,338,7571,2192,5379,5901485.0,1701360.0,4200124.0,0.7845,0.7759,0.7762,0.7808
2023-10-27 16:05,912,320,592,46172,19184,26988,36125601.0,15035043.0,21090557.0,884,305,579,44044,17722,26322,34335598.0,13765054.0,20570544.0,0.7837,0.7815,0.7767,0.7815
2023-10-27 16:10,739,499,240,60039,35468,24571,47099525.0,27837259.0,19262266.0,661,440,221,54977,32893,22084,42897220.0,25566125.0,17331094.0,0.7849,0.7839,0.7773,0.7848
2023-10-27 16:15,619,386,233,31051,20117,10934,24300030.0,15713915.0,8586115.0,548,345,203,28998,20438,8560,22654990.0,15924574.0,6730416.0,0.7811,0.7853,0.7792,0.7863
2023-10-27 16:20,1433,621,812,105534,44360,61174,82471766.0,34650395.0,47821371.0,1370,580,790,102662,42924,59738,80244601.0,33468883.0,46775718.0,0.7811,0.7817,0.7797,0.783
2023-10-27 16:25,912,513,399,73578,38763,34815,57591645.0,30313932.0,27277712.0,882,504,378,69439,36371,33068,54270475.0,28358520.0,25911955.0,0.782,0.7835,0.7797,0.7836
2023-10-27 16:30,631,379,252,51083,34623,16460,39899856.0,27019023.0,12880833.0,618,372,246,50816,34769,16047,39680263.0,27120096.0,12560167.0,0.7804,0.7826,0.78,0.7827
2023-10-27 16:35,445,250,195,37743,23964,13779,29503320.0,18699641.0,10803679.0,422,235,187,36708,22897,13811,28707996.0,17866265.0,10841731.0,0.7803,0.7841,0.7803,0.785
2023-10-27 16:40,128,73,55,13878,8032,5846,10848356.0,6260191.0,4588165.0,125,74,51,15436,9321,6115,12061899.0,7258761.0,4803138.0,0.7794,0.7848,0.7788,0.7855
2023-10-27 16:45,103,71,32,7305,5305,2000,5702332.0,4138245.0,1564087.0,76,59,17,5399,4059,1340,4217460.0,3166673.0,1050786.0,0.7801,0.782,0.7802,0.7842
2023-10-27 16:50,296,194,102,28247,22226,6021,22092499.0,17384873.0,4707626.0,275,185,90,27117,21541,5576,21187343.0,16820313.0,4367030.0,0.7822,0.7819,0.7809,0.7832
2023-10-27 16:55,123,75,48,8384,4866,3518,6545809.0,3806543.0,2739265.0,99,61,38,7058,4569,2489,5520663.0,3567568.0,1953095.0,0.7823,0.7786,0.7808,0.7847
2023-10-27 17:00,266,123,143,14269,8545,5724,11159361.0,6714860.0,4444501.0,239,105,134,13116,7503,5613,10254105.0,5859317.0,4394788.0,0.7858,0.7765,0.7809,0.783
2023-10-27 17:05,407,139,268,25629,12199,13430,20155578.0,9621383.0,10534195.0,369,120,249,23413,10683,12730,18306122.0,8322023.0,9984098.0,0.7887,0.7844,0.779,0.7843
2023-10-27 17:10,858,276,582,63128,8748,54380,49443708.0,6848688.0,42595019.0,844,271,573,62807,8759,54048,49186986.0,6849876.0,42337110.0,0.7829,0.7833,0.782,0.7833
2023-10-27 17:15,566,400,166,36994,17017,19977,28941365.0,13290782.0,15650582.0,553,394,159,36357,16954,19403,28445270.0,13243398.0,15201872.0,0.781,0.7834,0.7811,0.7835
2023-10-27 17:20,981,374,607,62883,14811,48072,49194690.0,11585939.0,37608751.0,960,361,599,62618,14677,47941,48983172.0,11464839.0,37518333.0,0.7823,0.7823,0.7811,0.7826
2023-10-27 17:25,634,88,546,37666,5702,31964,29506850.0,4460564.0,25046286.0,615,73,542,36136,4658,31478,28303350.0,3637378.0,24665971.0,0.7823,0.7836,0.7809,0.7836
2023-10-27 17:30,290,166,124,25699,12027,13672,20104667.0,9400582.0,10704084.0,264,146,118,25585,11633,13952,20016166.0,9083535.0,10932631.0,0.7816,0.7829,0.7808,0.7836
2023-10-27 17:35,475,142,333,23505,11332,12173,18410129.0,8870270.0,9539859.0,446,124,322,22254,11162,11092,17394699.0,8709085.0,8685614.0,0.7828,0.7837,0.7802,0.7831
2023-10-27 17:40,241,126,115,14850,10116,4734,11631846.0,7913259.0,3718587.0,205,104,101,13811,9411,4400,10806253.0,7353678.0,3452574.0,0.7823,0.7855,0.7814,0.7847
2023-10-27 17:45,196,135,61,11360,9219,2141,8911531.0,7229647.0,1681883.0,163,109,54,10960,8960,2000,8571264.0,7000907.0,1570357.0,0.7842,0.7856,0.7814,0.7852
2023-10-27 17:50,125,85,40,11912,8190,3722,9324060.0,6402337.0,2921723.0,108,78,30,11649,8119,3530,9119896.0,6337619.0,2782276.0,0.7817,0.785,0.7806,0.7882
2023-10-27 17:55,323,165,158,26393,18302,8091,20647429.0,14306262.0,6341166.0,302,151,151,25979,18174,7805,20293824.0,14173592.0,6120232.0,0.7817,0.7837,0.7799,0.7841
2023-10-27 18:00,182,126,56,17005,15337,1668,13286370.0,11993774.0,1292595.0,164,115,49,17258,15759,1499,13467766.0,12285971.0,1181795.0,0.782,0.7749,0.7796,0.7884
2023-10-27 18:05,310,153,157,24452,18290,6162,19124112.0,14299191.0,4824921.0,297,150,147,23918,18347,5571,18715713.0,14335235.0,4380478.0,0.7818,0.783,0.7813,0.7863
2023-10-27 18:10,119,58,61,11363,7154,4209,8905718.0,5602162.0,3303556.0,98,46,52,10836,5618,5218,8502689.0,4390468.0,4112220.0,0.7831,0.7849,0.7815,0.7881
2023-10-27 18:15,194,120,74,17135,12549,4586,13365240.0,9808496.0,3556744.0,166,111,55,15983,12460,3523,12510683.0,9737905.0,2772777.0,0.7816,0.7756,0.7815,0.7871
2023-10-27 18:20,621,375,246,29037,17772,11265,22591233.0,13877401.0,8713831.0,615,367,248,30164,18964,11200,23575870.0,14803729.0,8772141.0,0.7809,0.7735,0.7806,0.7832
2023-10-27 18:25,310,72,238,15632,4842,10790,12397338.0,3993725.0,8403613.0,270,50,220,13226,2943,10283,10338056.0,2283191.0,8054865.0,0.8248,0.7788,0.7758,0.7833
2023-10-27 18:30,458,207,251,33766,10178,23588,26496458.0,8010496.0,18485962.0,415,182,233,30572,8576,21996,23937268.0,6697779.0,17239488.0,0.787,0.7837,0.781,0.7838
2023-10-27 18:35,3378,1393,1985,434520,170097,264423,337979547.0,132006543.0,205973004.0,3271,1344,1927,424453,166732,257721,330551023.0,129299802.0,201251220.0,0.7761,0.779,0.7755,0.7809
2023-10-30 10:00,5821,3209,2612,660395,409519,250876,514985352.0,317491095.0,197494257.0,5397,2968,2429,630892,390627,240265,493193945.0,303915907.0,189278038.0,0.7753,0.7872,0.778,0.7878
2023-10-30 10:05,7080,2658,4422,766850,221568,545282,597644881.0,172162533.0,425482347.0,6904,2562,4342,755144,212513,542631,588743749.0,165057717.0,423686032.0,0.777,0.7803,0.7767,0.7808
2023-10-30 10:10,1391,616,775,117422,30719,86703,92091175.0,24069144.0,68022031.0,1257,541,716,110289,27889,82400,86378340.0,21739452.0,64638887.0,0.7835,0.7845,0.7795,0.7845
2023-10-30 10:15,2926,2031,895,309849,213184,96665,242837567.0,166782127.0,76055440.0,2695,1912,783,284211,192160,92051,222837709.0,150416026.0,72421683.0,0.7823,0.7868,0.7828,0.7868
2023-10-30 10:20,4861,2864,1997,462232,327579,134653,366619975.0,259487639.0,107132336.0,4038,2610,1428,419125,313416,105709,330775810.0,246882482.0,83893328.0,0.7921,0.7956,0.7877,0.7936
2023-10-30 10:25,2166,1160,1006,142942,82353,60589,113482933.0,65314033.0,48168900.0,1948,1098,850,138145,85385,52760,109646297.0,67422176.0,42224121.0,0.7931,0.795,0.7896,0.8003
2023-10-30 10:30,1705,824,881,121041,36133,84908,95927432.0,28644304.0,67283128.0,1505,721,784,106830,29262,77568,84939524.0,23148057.0,61791466.0,0.7927,0.7924,0.7911,0.7966
2023-10-30 10:35,1271,797,474,104359,58406,45953,82951504.0,46381125.0,36570378.0,1127,728,399,99303,57175,42128,78665551.0,45135181.0,33530370.0,0.7941,0.7958,0.7894,0.7959
2023-10-30 10:40,719,537,182,38260,29738,8522,30582907.0,23839074.0,6743833.0,632,498,134,31550,25979,5571,24999626.0,20563118.0,4436508.0,0.8016,0.7913,0.7915,0.7964
2023-10-30 10:45,865,563,302,50113,36522,13591,40083690.0,29277469.0,10806220.0,798,536,262,49698,35319,14379,39405400.0,27944613.0,11460787.0,0.8016,0.7951,0.7912,0.7971
2023-10-30 10:50,593,286,307,39521,20864,18657,31355911.0,16586062.0,14769848.0,530,250,280,33105,16436,16669,26313244.0,13026499.0,13286745.0,0.795,0.7917,0.7926,0.7971
2023-10-30 10:55,1806,906,900,121787,70716,51071,97308325.0,56654266.0,40654059.0,1199,769,430,89131,57306,31825,70909388.0,45440440.0,25468948.0,0.8012,0.796,0.7929,0.8003
2023-10-30 11:00,1561,960,601,93690,62320,31370,75229535.0,50125236.0,25104299.0,1180,760,420,75734,51019,24715,60460305.0,40623033.0,19837272.0,0.8043,0.8003,0.7962,0.8026
2023-10-30 11:05,2155,1185,970,127389,82106,45283,102505283.0,66241420.0,36263862.0,1703,991,712,102189,70401,31788,81807720.0,56255878.0,25551842.0,0.8068,0.8008,0.7991,0.8038
2023-10-30 11:10,1082,587,495,75509,35918,39591,60045201.0,28603564.0,31441636.0,928,523,405,68843,32905,35938,54978581.0,26154214.0,28824367.0,0.7964,0.7942,0.7948,0.8021
2023-10-30 11:15,1154,629,525,72739,39912,32827,57965938.0,31799361.0,26166576.0,957,530,427,66692,37589,29103,53212567.0,29869557.0,23343010.0,0.7967,0.7971,0.7946,0.8021
2023-10-30 11:20,524,314,210,25645,13271,12374,20268974.0,10562351.0,9706622.0,421,286,135,22878,12861,10017,18205039.0,10204933.0,8000106.0,0.7959,0.7844,0.7935,0.7987
2023-10-30 11:25,832,439,393,63565,24111,39454,50682724.0,19267779.0,31414945.0,726,382,344,59215,19989,39226,47211461.0,15881130.0,31330330.0,0.7991,0.7962,0.7945,0.7987
2023-10-30 11:30,614,239,375,57421,13194,44227,45807753.0,10499451.0,35308302.0,528,201,327,51964,12256,39708,41436348.0,9741512.0,31694836.0,0.7958,0.7983,0.7948,0.7982
2023-10-30 11:35,1259,462,797,103136,30400,72736,81885570.0,24011583.0,57873987.0,1189,432,757,97645,25741,71904,77843070.0,20461700.0,57381370.0,0.7899,0.7957,0.7949,0.798
2023-10-30 11:40,1224,446,778,88192,29148,59044,70214207.0,23168677.0,47045529.0,1152,401,751,80015,22082,57933,63784032.0,17560468.0,46223563.0,0.7949,0.7968,0.7952,0.7979
2023-10-30 11:45,635,253,382,47285,13245,34040,37760080.0,10629214.0,27130866.0,565,218,347,44286,11866,32420,35311061.0,9426131.0,25884929.0,0.8025,0.797,0.7944,0.7984
2023-10-30 11:50,643,313,330,52237,17123,35114,41347931.0,13615369.0,27732561.0,559,255,304,58260,26675,31585,46272602.0,21070163.0,25202439.0,0.7952,0.7898,0.7899,0.7979
2023-10-30 11:55,442,143,299,36167,6671,29496,28858980.0,5352378.0,23506602.0,387,118,269,33234,5904,27330,26466438.0,4680468.0,21785969.0,0.8023,0.7969,0.7928,0.7971
2023-10-30 12:00,622,390,232,42184,20831,21353,33472309.0,16539290.0,16933018.0,568,370,198,36768,19452,17316,29229327.0,15435436.0,13793891.0,0.794,0.793,0.7935,0.7966
2023-10-30 12:05,964,472,492,73924,32800,41124,57498448.0,25952409.0,31546039.0,796,379,417,56487,28092,28395,44762275.0,22199679.0,22562595.0,0.7912,0.7671,0.7902,0.7946
2023-10-30 12:10,1383,837,546,94138,53553,40585,73778294.0,42108317.0,31669976.0,1235,737,498,79917,45552,34365,62983432.0,35802170.0,27181261.0,0.7863,0.7803,0.786,0.791
2023-10-30 12:15,738,372,366,66285,33871,32414,52474357.0,26835915.0,25638442.0,614,305,309,59431,25446,33985,47026416.0,20053035.0,26973381.0,0.7923,0.791,0.7881,0.7937
2023-10-30 12:20,1429,843,586,122734,55072,67662,96584880.0,43458508.0,53126371.0,1339,802,537,111772,56354,55418,88310694.0,44428812.0,43881881.0,0.7891,0.7852,0.7884,0.7918
2023-10-30 12:25,813,467,346,68422,34708,33714,53597648.0,27130438.0,26467209.0,726,420,306,62674,29740,32934,49281229.0,23277732.0,26003496.0,0.7817,0.7851,0.7827,0.7896
2023-10-30 12:30,2859,1705,1154,289149,195068,94081,229402125.0,154785865.0,74616260.0,2741,1648,1093,275679,185085,90594,217867541.0,146014525.0,71853016.0,0.7935,0.7931,0.7889,0.7931
2023-10-30 12:35,640,389,251,39300,24329,14971,31057746.0,19181208.0,11876537.0,626,378,248,40063,24127,15936,31673766.0,19016710.0,12657056.0,0.7884,0.7933,0.7882,0.7942
2023-10-30 12:40,2275,1474,801,228193,165471,62722,180406993.0,130669764.0,49737229.0,2230,1460,770,225551,164346,61205,178111225.0,129574549.0,48536675.0,0.7897,0.793,0.7884,0.793
2023-10-30 12:45,601,316,285,41974,22982,18992,33190268.0,18114312.0,15075956.0,574,294,280,41768,22660,19108,33020485.0,17853980.0,15166504.0,0.7882,0.7938,0.7879,0.7937
2023-10-30 12:50,1455,661,794,92471,44627,47844,73056597.0,35350685.0,37705912.0,1376,625,751,86716,42500,44216,68608799.0,33500951.0,35107847.0,0.7921,0.7881,0.7883,0.794
2023-10-30 12:55,853,545,308,102294,82455,19839,80455470.0,64731275.0,15724195.0,843,537,306,100565,80838,19727,79101707.0,63470125.0,15631582.0,0.785,0.7926,0.7852,0.7924
2023-10-30 13:00,1729,796,933,146200,85606,60594,115294106.0,67507782.0,47786323.0,1648,759,889,139434,81979,57455,110118031.0,64598910.0,45519121.0,0.7886,0.7886,0.788,0.7923
2023-10-30 13:05,1630,826,804,155501,105700,49801,122484701.0,83202963.0,39281737.0,1589,810,779,154707,106225,48482,121958839.0,83585977.0,38372861.0,0.7872,0.7888,0.7869,0.7915
2023-10-30 13:10,1578,1021,557,153804,112883,40921,121326731.0,89035872.0,32290858.0,1511,984,527,144267,108675,35592,113624062.0,85502809.0,28121253.0,0.7887,0.7891,0.7868,0.7901
2023-10-30 13:15,109,64,45,6740,4845,1895,5241676.0,3806371.0,1435304.0,88,50,38,5324,4006,1318,4190995.0,3147454.0,1043541.0,0.7856,0.7574,0.7857,0.7918
2023-10-30 13:20,636,440,196,53429,31241,22188,41852546.0,24575685.0,17276861.0,595,417,178,42858,29096,13762,33746629.0,22879556.0,10867073.0,0.7866,0.7787,0.7863,0.7896
2023-10-30 13:25,249,118,131,23020,12128,10892,18203969.0,9649811.0,8554157.0,204,100,104,22841,9610,13231,18006686.0,7547702.0,10458983.0,0.7957,0.7854,0.7854,0.7905
2023-10-30 13:30,337,149,188,24927,10410,14517,19481570.0,8220201.0,11261368.0,294,133,161,19449,8904,10545,15296363.0,6964780.0,8331583.0,0.7896,0.7757,0.7822,0.7901
2023-10-30 13:35,984,337,647,62691,25735,36956,49092707.0,20203973.0,28888733.0,907,292,615,58309,23190,35119,45869916.0,18186563.0,27683353.0,0.7851,0.7817,0.7842,0.7883
2023-10-30 13:40,350,196,154,22246,9198,13048,17403763.0,7230692.0,10173070.0,314,176,138,23001,10757,12244,18089763.0,8432051.0,9657712.0,0.7861,0.7797,0.7839,0.7888
2023-10-30 13:45,378,87,291,23118,9889,13229,18199549.0,7840055.0,10359493.0,344,68,276,18447,3923,14524,14544507.0,3047464.0,11497042.0,0.7928,0.7831,0.7768,0.7916
2023-10-30 13:50,1073,446,627,81423,43882,37541,63789110.0,34503448.0,29285662.0,988,396,592,79424,44318,35106,62334511.0,34706607.0,27627903.0,0.7863,0.7801,0.7831,0.787
2023-10-30 13:55,579,217,362,47051,16082,30969,36799350.0,12604974.0,24194376.0,536,191,345,45858,16554,29304,36025375.0,12965264.0,23060110.0,0.7838,0.7812,0.7832,0.7869
2023-10-30 14:00,277,112,165,12391,2180,10211,9742829.0,1710957.0,8031871.0,254,92,162,12028,2087,9941,9455053.0,1633500.0,7821552.0,0.7848,0.7866,0.7827,0.7868
2023-10-30 14:05,415,138,277,31535,7637,23898,24646760.0,5980320.0,18666440.0,381,114,267,28423,5831,22592,22331140.0,4553080.0,17778060.0,0.7831,0.7811,0.7808,0.7869
2023-10-30 14:10,547,125,422,46289,4126,42163,36378272.0,3258808.0,33119464.0,511,97,414,44971,3110,41861,35351784.0,2432704.0,32919080.0,0.7898,0.7855,0.7822,0.7864
2023-10-30 14:15,1488,846,642,149956,99715,50241,118646565.0,79030635.0,39615930.0,1354,773,581,130057,86526,43531,102310425.0,67967126.0,34343299.0,0.7926,0.7885,0.7855,0.7889
2023-10-30 14:20,153,57,96,10644,3604,7040,8392768.0,2831590.0,5561178.0,149,62,87,9971,4687,5284,7855885.0,3680364.0,4175521.0,0.7857,0.7899,0.7852,0.7902
2023-10-30 14:25,1191,771,420,100390,50486,49904,78600357.0,39683966.0,38916391.0,1144,748,396,96217,49812,46405,75740183.0,39148615.0,36591568.0,0.786,0.7798,0.7859,0.7885
2023-10-30 14:30,864,370,494,83709,19573,64136,65927058.0,15369694.0,50557364.0,829,347,482,83639,19076,64563,65879573.0,14978109.0,50901464.0,0.7852,0.7883,0.7852,0.7884
2023-10-30 14:35,450,143,307,48563,8487,40076,38265160.0,6665345.0,31599815.0,430,137,293,47612,7966,39646,37516026.0,6255309.0,31260717.0,0.7854,0.7885,0.7853,0.7885
2023-10-30 14:40,471,216,255,48135,10341,37794,37945947.0,8130416.0,29815531.0,449,204,245,47259,10178,37081,37252163.0,7998488.0,29253674.0,0.7862,0.7889,0.7859,0.7889
2023-10-30 14:45,707,436,271,67734,22576,45158,53375421.0,17750558.0,35624862.0,688,426,262,67218,22147,45071,52952076.0,17400552.0,35551523.0,0.7863,0.7889,0.7857,0.7888
2023-10-30 14:50,1498,842,656,148489,55937,92552,116808801.0,43914240.0,72894560.0,1487,837,650,148014,55859,92155,116457669.0,43854211.0,72603457.0,0.7851,0.7876,0.7851,0.7878
2023-10-30 14:55,996,412,584,99609,26637,72972,78314499.0,20885123.0,57429376.0,968,404,564,99896,27717,72179,78523498.0,21699852.0,56823646.0,0.7841,0.787,0.7829,0.7873
2023-10-30 15:00,599,305,294,65377,16704,48673,51773243.0,13434380.0,38338863.0,590,303,287,66066,17026,49040,52291102.0,13663203.0,38627899.0,0.8043,0.7877,0.8025,0.7877
2023-10-30 15:05,809,278,531,69901,13057,56844,55095611.0,10259050.0,44836560.0,782,263,519,67509,12055,55454,53210858.0,9469222.0,43741635.0,0.7857,0.7888,0.7855,0.7888
2023-10-30 15:10,889,221,668,76397,12077,64320,60185149.0,9483827.0,50701322.0,887,224,663,77176,12734,64442,60800859.0,10001670.0,50799188.0,0.7853,0.7883,0.7854,0.7883
2023-10-30 15:15,1684,359,1325,166496,24719,141777,131217573.0,19417493.0,111800080.0,1666,341,1325,145356,23491,121865,114491295.0,18450760.0,96040534.0,0.7855,0.7886,0.7854,0.7881
2023-10-30 15:20,1498,629,869,134925,40514,94411,106684580.0,32301886.0,74382694.0,1423,593,830,144904,35006,109898,114359762.0,27547532.0,86812230.0,0.7973,0.7879,0.7869,0.7899
2023-10-30 15:25,769,273,496,43512,12037,31475,34331704.0,9467862.0,24863841.0,751,267,484,42142,10930,31212,33257988.0,8598257.0,24659731.0,0.7866,0.79,0.7867,0.7901
2023-10-30 15:30,734,158,576,50986,6285,44701,40178251.0,4945439.0,35232811.0,707,146,561,50014,5776,44238,39483433.0,4544643.0,34938790.0,0.7869,0.7882,0.7868,0.7898
2023-10-30 15:35,847,339,508,78089,25133,52956,61692948.0,19923960.0,41768988.0,793,313,480,73572,22415,51157,58071939.0,17641311.0,40430628.0,0.7927,0.7887,0.787,0.7903
2023-10-30 15:40,986,354,632,76236,13964,62272,60006919.0,10935782.0,49071136.0,968,339,629,76301,14583,61718,60191343.0,11423694.0,48767649.0,0.7831,0.788,0.7834,0.7902
2023-10-30 15:45,822,355,467,79236,21424,57812,62675501.0,16927364.0,45748137.0,781,339,442,75578,19511,56067,59730655.0,15365578.0,44365076.0,0.7901,0.7913,0.7875,0.7913
2023-10-30 15:50,1519,667,852,114054,47843,66211,89980625.0,37719482.0,52261142.0,1471,640,831,111641,47351,64290,88172095.0,37324732.0,50847363.0,0.7884,0.7893,0.7883,0.7909
2023-10-30 15:55,1368,734,634,91798,48966,42832,72643712.0,38747864.0,33895847.0,1201,586,615,88608,46652,41956,69969119.0,36770137.0,33198982.0,0.7913,0.7914,0.7882,0.7913
2023-10-30 16:00,1007,501,506,81123,50602,30521,63940497.0,39906239.0,24034257.0,972,482,490,76156,48919,27237,60115142.0,38559826.0,21555316.0,0.7886,0.7875,0.7882,0.7914
2023-10-30 16:05,349,189,160,27056,16496,10560,21468836.0,13092230.0,8376606.0,318,174,144,24433,14857,9576,19281323.0,11671949.0,7609374.0,0.7937,0.7932,0.7856,0.7946
2023-10-30 16:10,1096,516,580,66860,40979,25881,52763725.0,32308916.0,20454809.0,1057,494,563,65311,39878,25433,51561643.0,31436953.0,20124690.0,0.7884,0.7903,0.7883,0.7913
2023-10-30 16:15,1073,556,517,69474,41589,27885,54696830.0,32775393.0,21921436.0,1037,534,503,66859,40516,26343,52764395.0,31932750.0,20831645.0,0.7881,0.7861,0.7882,0.7908
2023-10-30 16:20,575,202,373,40093,11526,28567,31634914.0,9070083.0,22564830.0,541,184,357,37150,10262,26888,29313474.0,8071776.0,21241697.0,0.7869,0.7899,0.7866,0.79
2023-10-30 16:25,351,184,167,27006,17457,9549,21304893.0,13755914.0,7548978.0,325,170,155,26535,17101,9434,20940280.0,13470945.0,7469335.0,0.788,0.7906,0.7877,0.7917
2023-10-30 16:30,1009,616,393,105195,85922,19273,83133389.0,67874256.0,15259132.0,983,605,378,102124,83545,18579,80570273.0,65860926.0,14709346.0,0.79,0.7917,0.7883,0.7917
2023-10-30 16:35,1279,696,583,109713,78996,30717,86844814.0,62484200.0,24360614.0,1234,684,550,104945,76835,28110,82973733.0,60674546.0,22299187.0,0.791,0.7931,0.7897,0.7933
2023-10-30 16:40,802,419,383,51529,41723,9806,40842757.0,33063286.0,7779470.0,756,401,355,49462,40736,8726,39100089.0,32174590.0,6925499.0,0.7924,0.7933,0.7898,0.7937
2023-10-30 16:45,973,744,229,74331,61558,12773,58612195.0,48682706.0,9929488.0,921,729,192,70194,60438,9756,55543496.0,47793087.0,7750408.0,0.7908,0.7774,0.7908,0.7944
2023-10-30 16:50,965,455,510,62535,37051,25484,49446440.0,29251759.0,20194680.0,937,444,493,61914,36337,25577,49250809.0,28983214.0,20267594.0,0.7895,0.7924,0.7976,0.7924
2023-10-30 16:55,438,215,223,33068,24706,8362,26101887.0,19505488.0,6596399.0,411,205,206,32571,24863,7708,25734372.0,19622204.0,6112168.0,0.7895,0.7889,0.7892,0.793
2023-10-30 17:00,506,405,101,50313,45512,4801,39741021.0,35935554.0,3805467.0,501,398,103,51170,45283,5887,40459490.0,35754541.0,4704949.0,0.7896,0.7926,0.7896,0.7992
2023-10-30 17:05,170,125,45,7789,4457,3332,6164468.0,3521787.0,2642680.0,162,122,40,7220,4555,2665,5718333.0,3596566.0,2121767.0,0.7902,0.7931,0.7896,0.7962
2023-10-30 17:10,337,214,123,30320,22867,7453,24089831.0,18038064.0,6051766.0,325,206,119,29948,22637,7311,23801076.0,17857148.0,5943928.0,0.7888,0.812,0.7888,0.813
2023-10-30 17:15,161,121,40,15171,11279,3892,12230912.0,8899624.0,3331288.0,141,111,30,12346,11249,1097,9741694.0,8871339.0,870355.0,0.789,0.8559,0.7886,0.7934
2023-10-30 17:20,392,317,75,31125,26397,4728,24555327.0,20820133.0,3735194.0,378,308,70,30919,26625,4294,24405201.0,20999032.0,3406168.0,0.7887,0.79,0.7887,0.7932
2023-10-30 17:25,497,354,143,29031,22098,6933,22895926.0,17463682.0,5432244.0,469,342,127,27763,21338,6425,21908860.0,16827072.0,5081788.0,0.7903,0.7835,0.7886,0.7909
2023-10-30 17:30,430,257,173,42107,25697,16410,32734853.0,20182221.0,12552632.0,388,221,167,36160,20534,15626,28790781.0,16165957.0,12624824.0,0.7854,0.7649,0.7873,0.8079
2023-10-30 17:35,376,196,180,36804,19295,17509,29003211.0,15174188.0,13829022.0,356,190,166,36453,19950,16503,28712307.0,15668452.0,13043854.0,0.7864,0.7898,0.7854,0.7904
2023-10-30 17:40,92,65,27,8802,6573,2229,6936533.0,5171249.0,1765283.0,74,50,24,8885,6710,2175,7000351.0,5277691.0,1722659.0,0.7867,0.792,0.7865,0.792
2023-10-30 17:45,152,103,49,11450,9535,1915,8930351.0,7498954.0,1431396.0,133,91,42,10389,9153,1236,8175656.0,7198471.0,977185.0,0.7865,0.7475,0.7865,0.7906
2023-10-30 17:50,486,284,202,36935,27662,9273,28849960.0,21748912.0,7101047.0,449,257,192,34857,26570,8287,27419223.0,20883095.0,6536128.0,0.7862,0.7658,0.786,0.7887
2023-10-30 17:55,323,188,135,26032,18573,7459,20469995.0,14589359.0,5880636.0,301,172,129,25001,17838,7163,19655331.0,14009203.0,5646128.0,0.7855,0.7884,0.7854,0.7882
2023-10-30 18:00,369,255,114,33674,23147,10527,26493961.0,18190281.0,8303680.0,347,247,100,33333,23536,9797,26190945.0,18466161.0,7724784.0,0.7859,0.7888,0.7846,0.7885
2023-10-30 18:05,673,362,311,48731,27028,21703,38244065.0,21230755.0,17013310.0,644,346,298,41070,26124,14946,32307066.0,20522236.0,11784830.0,0.7855,0.7839,0.7856,0.7885
2023-10-30 18:10,142,89,53,16119,11300,4819,13402442.0,9608160.0,3794282.0,116,71,45,8678,4361,4317,6823709.0,3422107.0,3401602.0,0.8503,0.7874,0.7847,0.788
2023-10-30 18:15,86,50,36,3417,2897,520,2680562.0,2273739.0,406822.0,64,46,18,3008,2637,371,2360563.0,2067251.0,293312.0,0.7849,0.7824,0.7839,0.7906
2023-10-30 18:20,457,285,172,34739,25892,8847,27176316.0,20344357.0,6831959.0,420,265,155,33083,25516,7567,25999880.0,20035772.0,5964108.0,0.7857,0.7722,0.7852,0.7882
2023-10-30 18:25,553,161,392,62864,14615,48249,49465034.0,11466455.0,37998579.0,524,145,379,61752,14854,46898,48608190.0,11638180.0,36970010.0,0.7846,0.7876,0.7835,0.7883
2023-10-30 18:30,478,176,302,22511,11107,11404,17687075.0,8725726.0,8961348.0,452,162,290,36081,11686,24395,28746403.0,9099743.0,19646659.0,0.7856,0.7858,0.7787,0.8054
2023-10-30 18:35,551,183,368,39754,10391,29363,31223376.0,8198687.0,23024689.0,514,171,343,39055,10900,28155,30693782.0,8528730.0,22165052.0,0.789,0.7841,0.7825,0.7873
2023-10-31 10:00,10936,7000,3936,1061668,703495,358173,838603186.0,554585291.0,284017895.0,10495,6752,3743,1031419,682625,348794,814964444.0,538490040.0,276474404.0,0.7883,0.793,0.7889,0.7927
2023-10-31 10:05,1291,596,695,108182,45835,62347,85311474.0,35954237.0,49357237.0,1166,520,646,81300,26378,54922,64443771.0,20983083.0,43460688.0,0.7844,0.7917,0.7955,0.7913
2023-10-31 10:10,1160,391,769,95188,22264,72924,74646116.0,17411910.0,57234206.0,1018,292,726,90269,20177,70092,70988177.0,15783878.0,55204299.0,0.7821,0.7848,0.7823,0.7876
2023-10-31 10:15,741,373,368,43746,21208,22538,34333039.0,16599352.0,17733687.0,645,310,335,40180,19904,20276,31595128.0,15586742.0,16008385.0,0.7827,0.7868,0.7831,0.7895
2023-10-31 10:20,1127,610,517,52100,31057,21043,41185227.0,24632066.0,16553160.0,943,511,432,49290,29561,19729,38986780.0,23448999.0,15537781.0,0.7931,0.7866,0.7932,0.7876
2023-10-31 10:25,1224,459,765,83282,29766,53516,65151135.0,23238907.0,41912228.0,1109,410,699,78596,27766,50830,61636618.0,21680220.0,39956397.0,0.7807,0.7832,0.7808,0.7861
2023-10-31 10:30,2310,935,1375,204434,66248,138186,161050800.0,53114951.0,107935848.0,2080,797,1283,191648,60411,131237,149950597.0,47227704.0,102722892.0,0.8018,0.7811,0.7818,0.7827
2023-10-31 10:35,1677,901,776,122990,54700,68290,96162054.0,42742328.0,53419726.0,1588,872,716,128237,62112,66125,99954464.0,48207499.0,51746964.0,0.7814,0.7822,0.7761,0.7826
2023-10-31 10:40,1335,764,571,88279,53760,34519,68657124.0,41857589.0,26799535.0,1248,706,542,83187,50635,32552,65013598.0,39576381.0,25437217.0,0.7786,0.7764,0.7816,0.7814
2023-10-31 10:45,1038,510,528,75906,29723,46183,59250025.0,22969523.0,36280502.0,870,434,436,64549,24276,40273,50711010.0,18748641.0,31962368.0,0.7728,0.7856,0.7723,0.7936
2023-10-31 10:50,786,411,375,38246,16278,21968,29548226.0,12479147.0,17069079.0,686,345,341,36491,13711,22780,28304769.0,10565744.0,17739024.0,0.7666,0.777,0.7706,0.7787
2023-10-31 10:55,1218,503,715,103668,34914,68754,80722119.0,27161786.0,53560333.0,1055,414,641,89738,26319,63419,69756666.0,20317997.0,49438669.0,0.778,0.779,0.772,0.7796
2023-10-31 11:00,1393,783,610,97272,38689,58583,75701230.0,30032443.0,45668787.0,1306,745,561,96120,40171,55949,74745075.0,31113777.0,43631298.0,0.7763,0.7796,0.7745,0.7798
2023-10-31 11:05,1294,675,619,99912,42410,57502,77277955.0,32782176.0,44495778.0,1241,656,585,103867,47015,56852,80489819.0,36335895.0,44153923.0,0.773,0.7738,0.7729,0.7766
2023-10-31 11:10,2034,965,1069,195485,64950,130535,150636954.0,51253362.0,99383591.0,1671,746,925,157696,47001,110695,123131588.0,37490187.0,85641401.0,0.7891,0.7614,0.7976,0.7737
2023-10-31 11:15,1932,1098,834,167629,101926,65703,129380547.0,78696670.0,50683877.0,1709,950,759,152790,91856,60934,117635951.0,70481211.0,47154740.0,0.7721,0.7714,0.7673,0.7739
2023-10-31 11:20,852,577,275,55135,34377,20758,42542372.0,26477116.0,16065256.0,823,574,249,54867,32005,22862,42502122.0,24604129.0,17897992.0,0.7702,0.7739,0.7688,0.7829
2023-10-31 11:25,1210,372,838,109797,28574,81223,84746776.0,21966837.0,62779939.0,1167,354,813,112742,31889,80853,88399851.0,25831577.0,62568274.0,0.7688,0.7729,0.81,0.7739
2023-10-31 11:30,1457,731,726,127564,36742,90822,97903806.0,28204289.0,69699516.0,1335,653,682,117565,32350,85215,90683617.0,24817082.0,65866535.0,0.7676,0.7674,0.7671,0.7729
2023-10-31 11:35,1599,705,894,139283,41860,97423,107204726.0,32100545.0,75104181.0,1495,644,851,125383,31178,94205,96583161.0,23840112.0,72743049.0,0.7669,0.7709,0.7646,0.7722
2023-10-31 11:40,1691,982,709,132605,55202,77403,102487296.0,42693660.0,59793636.0,1605,942,663,124466,48450,76016,95922768.0,37193131.0,58729636.0,0.7734,0.7725,0.7677,0.7726
2023-10-31 11:45,2258,1270,988,186297,90855,95442,143296764.0,69726785.0,73569978.0,2135,1199,936,181750,89174,92576,139951063.0,68464242.0,71486821.0,0.7675,0.7708,0.7678,0.7722
2023-10-31 11:50,454,144,310,42011,12978,29033,33024224.0,9946670.0,23077554.0,419,133,286,25902,12553,13349,19907258.0,9625839.0,10281419.0,0.7664,0.7949,0.7668,0.7702
2023-10-31 11:55,576,327,249,45858,22531,23327,35288406.0,17347336.0,17941070.0,536,309,227,43190,21132,22058,33190439.0,16201800.0,16988638.0,0.7699,0.7691,0.7667,0.7702
2023-10-31 12:00,1041,301,740,82067,19511,62556,63219996.0,15191448.0,48028547.0,1011,287,724,85657,23650,62007,66107611.0,18365322.0,47742289.0,0.7786,0.7678,0.7765,0.7699
2023-10-31 12:05,1225,436,789,126693,34698,91995,97527847.0,26714459.0,70813387.0,1168,400,768,122445,32267,90178,94134362.0,24709669.0,69424692.0,0.7699,0.7698,0.7658,0.7699
2023-10-31 12:10,671,301,370,52108,34832,17276,40041623.0,26722366.0,13319256.0,637,279,358,52579,35779,16800,40359836.0,27402925.0,12956910.0,0.7672,0.771,0.7659,0.7712
2023-10-31 12:15,450,189,261,39682,21989,17693,30557343.0,16945148.0,13612194.0,394,151,243,33770,17782,15988,25982994.0,13649075.0,12333918.0,0.7706,0.7694,0.7676,0.7714
2023-10-31 12:20,274,135,139,28764,15924,12840,22407649.0,12240237.0,10167412.0,249,115,134,23307,14300,9007,17942517.0,10985809.0,6956707.0,0.7687,0.7919,0.7682,0.7724
2023-10-31 12:25,710,268,442,41026,16224,24802,31607550.0,12469987.0,19137562.0,691,256,435,41711,16764,24947,32132910.0,12884039.0,19248871.0,0.7686,0.7716,0.7686,0.7716
2023-10-31 12:30,601,249,352,43340,19135,24205,33428693.0,14750085.0,18678607.0,557,224,333,43543,19924,23619,33584797.0,15327683.0,18257114.0,0.7708,0.7717,0.7693,0.773
2023-10-31 12:35,627,241,386,45292,17560,27732,34930400.0,13512055.0,21418345.0,602,222,380,44675,17269,27406,34448499.0,13283319.0,21165179.0,0.7695,0.7723,0.7692,0.7723
2023-10-31 12:40,434,229,205,38994,24787,14207,30081498.0,19090421.0,10991077.0,394,202,192,33231,20820,12411,25603471.0,16004905.0,9598566.0,0.7702,0.7736,0.7687,0.7734
2023-10-31 12:45,154,65,89,9087,3875,5212,6985891.0,2978344.0,4007547.0,144,59,85,9419,4369,5050,7262127.0,3353068.0,3909058.0,0.7686,0.7689,0.7675,0.7741
2023-10-31 12:50,447,224,223,35391,16466,18925,27740406.0,13101513.0,14638892.0,422,214,208,33456,15668,17788,26447496.0,12684301.0,13763195.0,0.7957,0.7735,0.8096,0.7737
2023-10-31 12:55,513,293,220,37130,23767,13363,29430545.0,18451726.0,10978819.0,478,282,196,34935,22676,12259,27301798.0,17488065.0,9813732.0,0.7764,0.8216,0.7712,0.8005
2023-10-31 13:00,815,254,561,61061,16775,44286,47518378.0,12955418.0,34562959.0,759,220,539,57714,14250,43464,44953251.0,10981406.0,33971844.0,0.7723,0.7804,0.7706,0.7816
2023-10-31 13:05,861,309,552,115512,58659,56853,90854884.0,45467385.0,45387499.0,752,269,483,106136,56221,49915,83539987.0,43483405.0,40056582.0,0.7751,0.7983,0.7734,0.8025
2023-10-31 13:10,3316,1578,1738,320371,166201,154170,251597245.0,130880918.0,120716327.0,3000,1457,1543,290929,150331,140598,227304758.0,117069850.0,110234907.0,0.7875,0.783,0.7787,0.784
2023-10-31 13:15,1025,663,362,72304,49948,22356,56285730.0,38826817.0,17458913.0,1004,656,348,72423,50457,21966,56396263.0,39223425.0,17172838.0,0.7773,0.7809,0.7774,0.7818
2023-10-31 13:20,729,373,356,52465,29869,22596,41093537.0,23459619.0,17633918.0,668,328,340,49601,29136,20465,38556837.0,22593530.0,15963306.0,0.7854,0.7804,0.7755,0.78
2023-10-31 13:25,1692,784,908,118044,52783,65261,94863425.0,43890839.0,50972585.0,1633,764,869,115348,51931,63417,91221087.0,41691303.0,49529784.0,0.8315,0.7811,0.8028,0.781
2023-10-31 13:30,367,251,116,25488,16344,9144,19853246.0,12691929.0,7161317.0,348,245,103,27702,18217,9485,21584246.0,14144509.0,7439736.0,0.7765,0.7832,0.7764,0.7844
2023-10-31 13:35,1413,297,1116,140797,36510,104287,109441834.0,28301122.0,81140711.0,1362,270,1092,138685,33672,105013,108249444.0,26100866.0,82148577.0,0.7752,0.7781,0.7752,0.7823
2023-10-31 13:40,1916,237,1679,150962,27199,123763,117514557.0,21104681.0,96409875.0,1889,221,1668,149710,26915,122795,116562681.0,20886701.0,95675980.0,0.7759,0.779,0.776,0.7792
2023-10-31 13:45,412,172,240,27133,10633,16500,21084614.0,8243228.0,12841386.0,396,168,228,25914,10597,15317,21525348.0,9583654.0,11941694.0,0.7752,0.7783,0.9044,0.7796
2023-10-31 13:50,575,286,289,25827,9006,16821,20163941.0,6997119.0,13166822.0,557,277,280,26144,8867,17277,20412253.0,6882370.0,13529883.0,0.7769,0.7828,0.7762,0.7831
2023-10-31 13:55,987,228,759,91058,19497,71561,70931551.0,15126957.0,55804594.0,973,223,750,89936,19378,70558,70078141.0,15034899.0,55043242.0,0.7759,0.7798,0.7759,0.7801
2023-10-31 14:00,1052,285,767,70280,20798,49482,54471722.0,16085301.0,38386420.0,1025,272,753,67996,20198,47798,52877308.0,15624282.0,37253026.0,0.7734,0.7758,0.7736,0.7794
2023-10-31 14:05,1803,690,1113,150297,54499,95798,116512858.0,42116745.0,74396113.0,1760,671,1089,149431,54652,94779,115870849.0,42225767.0,73645082.0,0.7728,0.7766,0.7726,0.777
2023-10-31 14:10,1447,567,880,96468,36369,60099,74668394.0,28065405.0,46602988.0,1394,530,864,94320,35127,59193,73037947.0,27106485.0,45931461.0,0.7717,0.7754,0.7717,0.776
2023-10-31 14:15,705,426,279,40742,18673,22069,31412503.0,14416117.0,16996386.0,658,388,270,39971,18383,21588,30896795.0,14159600.0,16737195.0,0.772,0.7701,0.7703,0.7753
2023-10-31 14:20,903,310,593,57523,20696,36827,44231924.0,15917806.0,28314117.0,853,282,571,55684,20711,34973,42975780.0,15920227.0,27055552.0,0.7691,0.7688,0.7687,0.7736
2023-10-31 14:25,2086,977,1109,169189,74840,94349,133148511.0,60602973.0,72545538.0,1977,909,1068,158429,67560,90869,123786703.0,53539337.0,70247365.0,0.8098,0.7689,0.7925,0.7731
2023-10-31 14:30,3898,1990,1908,352825,152591,200234,273754134.0,118976871.0,154777262.0,3820,1956,1864,345987,149914,196073,269487246.0,117896875.0,151590371.0,0.7797,0.773,0.7864,0.7731
2023-10-31 14:35,3919,1886,2033,378221,148754,229467,292165203.0,114481515.0,177683687.0,3895,1876,2019,374194,145561,228633,289085839.0,112038675.0,177047164.0,0.7696,0.7743,0.7697,0.7744
2023-10-31 14:40,2367,1230,1137,219398,95629,123769,169631218.0,73730132.0,95901086.0,2340,1219,1121,218886,95013,123873,169187573.0,73207396.0,95980177.0,0.771,0.7748,0.7705,0.7748
2023-10-31 14:45,1592,902,690,128024,65705,62319,98717047.0,50607976.0,48109071.0,1559,890,669,127408,67448,59960,98297683.0,51885025.0,46412658.0,0.7702,0.772,0.7693,0.7741
2023-10-31 14:50,2124,960,1164,179119,92321,86798,139344532.0,72274699.0,67069833.0,2096,943,1153,178284,92081,86203,138731677.0,72121622.0,66610055.0,0.7829,0.7727,0.7832,0.7727
2023-10-31 14:55,852,489,363,51915,28560,23355,40089674.0,22022957.0,18066717.0,821,464,357,51012,27530,23482,39361834.0,21196345.0,18165489.0,0.7711,0.7736,0.7699,0.7736
2023-10-31 15:00,1488,682,806,124995,35533,89462,97053150.0,27605267.0,69447882.0,1427,653,774,121427,33468,87959,94112623.0,25806168.0,68306455.0,0.7769,0.7763,0.7711,0.7766
2023-10-31 15:05,880,471,409,65772,29987,35785,50749665.0,23093688.0,27655976.0,836,445,391,61929,28605,33324,47847654.0,22032404.0,25815250.0,0.7701,0.7728,0.7702,0.7747
2023-10-31 15:10,298,157,141,22004,11036,10968,16968101.0,8492411.0,8475689.0,281,144,137,22101,11315,10786,18369067.0,10032477.0,8336589.0,0.7695,0.7728,0.8867,0.7729
2023-10-31 15:15,1116,447,669,82844,33785,49059,63820456.0,26035116.0,37785340.0,1081,429,652,80147,32617,47530,61780032.0,25067332.0,36712700.0,0.7706,0.7702,0.7685,0.7724
2023-10-31 15:20,676,341,335,54842,23446,31396,42296211.0,18055632.0,24240578.0,644,320,324,53641,22763,30878,41357292.0,17498462.0,23858830.0,0.7701,0.7721,0.7687,0.7727
2023-10-31 15:25,441,131,310,21885,6195,15690,16887357.0,4766238.0,12121118.0,414,112,302,20572,5231,15341,15866383.0,4020054.0,11846329.0,0.7694,0.7725,0.7685,0.7722
2023-10-31 15:30,142,53,89,10817,3877,6940,8346452.0,2984687.0,5361764.0,132,49,83,11975,5472,6503,9225574.0,4200591.0,5024983.0,0.7698,0.7726,0.7677,0.7727
2023-10-31 15:35,877,346,531,65312,5038,60274,50498780.0,3880747.0,46618033.0,859,334,525,65134,4913,60221,50367237.0,3783454.0,46583783.0,0.7703,0.7734,0.7701,0.7735
2023-10-31 15:40,373,124,249,32174,4775,27399,24894884.0,3679132.0,21215752.0,353,115,238,30956,4282,26674,23944630.0,3297358.0,20647272.0,0.7705,0.7743,0.7701,0.7741
2023-10-31 15:45,214,83,131,17364,5484,11880,13442152.0,4229113.0,9213039.0,186,64,122,16934,5151,11783,13104218.0,3969052.0,9135166.0,0.7712,0.7755,0.7705,0.7753
2023-10-31 15:50,582,158,424,60862,8883,51979,47085440.0,6853249.0,40232191.0,568,149,419,60226,8655,51571,46591926.0,6669853.0,39922072.0,0.7715,0.774,0.7706,0.7741
2023-10-31 15:55,660,300,360,53142,21283,31859,41177427.0,16608685.0,24568742.0,600,269,331,47743,18696,29047,36920511.0,14413110.0,22507400.0,0.7804,0.7712,0.7709,0.7749
2023-10-31 16:00,436,120,316,29774,9759,20015,22988699.0,7524648.0,15464050.0,411,105,306,28637,9262,19375,22137021.0,7141429.0,14995592.0,0.771,0.7726,0.771,0.774
2023-10-31 16:05,339,165,174,30578,21579,8999,23615906.0,16650411.0,6965495.0,311,151,160,25613,16581,9032,19780829.0,12785060.0,6995768.0,0.7716,0.774,0.7711,0.7746
2023-10-31 16:10,395,140,255,29252,13566,15686,22787449.0,10614058.0,12173391.0,375,130,245,28446,12415,16031,22038834.0,9591059.0,12447775.0,0.7824,0.7761,0.7725,0.7765
2023-10-31 16:15,1090,471,619,74404,51333,23071,57572978.0,39664487.0,17908491.0,1069,463,606,72481,50182,22299,56088126.0,38776436.0,17311689.0,0.7727,0.7762,0.7727,0.7763
2023-10-31 16:20,356,129,227,33501,12282,21219,25598890.0,9259127.0,16339763.0,330,115,215,27598,8905,18693,21362544.0,6864305.0,14498238.0,0.7539,0.7701,0.7708,0.7756
2023-10-31 16:25,436,176,260,46486,15841,30645,36146900.0,12370239.0,23776660.0,405,162,243,47547,17800,29747,36819773.0,13738766.0,23081007.0,0.7809,0.7759,0.7718,0.7759
2023-10-31 16:30,493,276,217,33304,7361,25943,25881516.0,5714338.0,20167178.0,509,286,223,32314,6733,25581,25089888.0,5201183.0,19888704.0,0.7763,0.7774,0.7725,0.7775
2023-10-31 16:35,1228,344,884,109215,16851,92364,84697837.0,13016945.0,71680891.0,1236,351,885,109315,17017,92298,84767894.0,13133742.0,71634151.0,0.7725,0.7761,0.7718,0.7761
2023-10-31 16:40,2207,525,1682,181665,27385,154280,140693850.0,21144722.0,119549127.0,2191,515,1676,181838,27361,154477,140828947.0,21125887.0,119703060.0,0.7721,0.7749,0.7721,0.7749
2023-10-31 16:45,1333,199,1134,112110,10787,101323,86750311.0,8324126.0,78426184.0,1321,193,1128,110982,10855,100127,85985619.0,8376588.0,77609031.0,0.7717,0.774,0.7717,0.7751
2023-10-31 16:50,1263,316,947,132573,11847,120726,102666514.0,9126029.0,93540484.0,1267,322,945,133521,12568,120953,103398422.0,9679011.0,93719411.0,0.7703,0.7748,0.7701,0.7748
2023-10-31 16:55,297,72,225,38629,2909,35720,29939924.0,2241287.0,27698636.0,289,67,222,38441,2837,35604,29797319.0,2186172.0,27611147.0,0.7705,0.7754,0.7706,0.7755
2023-10-31 17:00,813,183,630,86607,9400,77207,67028969.0,7250029.0,59778939.0,796,176,620,86479,9512,76967,66943526.0,7323083.0,59620443.0,0.7713,0.7743,0.7699,0.7746
2023-10-31 17:05,502,121,381,51454,4460,46994,39820911.0,3437976.0,36382935.0,492,117,375,51046,4382,46664,39526019.0,3377767.0,36148252.0,0.7708,0.7742,0.7708,0.7746
2023-10-31 17:10,214,84,130,18214,5032,13182,14087930.0,3878875.0,10209055.0,208,81,127,17944,4890,13054,13879894.0,3769510.0,10110383.0,0.7708,0.7745,0.7709,0.7745
2023-10-31 17:15,672,108,564,58109,4318,53791,44999995.0,3331200.0,41668795.0,666,104,562,58852,5015,53837,45563171.0,3859068.0,41704103.0,0.7715,0.7746,0.7695,0.7746
2023-10-31 17:20,243,69,174,19408,1770,17638,15020477.0,1363902.0,13656574.0,238,67,171,19380,1801,17579,15000767.0,1386620.0,13614147.0,0.7706,0.7743,0.7699,0.7745
2023-10-31 17:25,594,157,437,43665,9538,34127,33845582.0,7412768.0,26432814.0,572,147,425,42595,8724,33871,32957952.0,6721381.0,26236571.0,0.7772,0.7745,0.7704,0.7746
2023-10-31 17:30,307,120,187,30944,5212,25732,23936249.0,4013313.0,19922936.0,301,119,182,30782,5321,25461,23833680.0,4097378.0,19736301.0,0.77,0.7742,0.77,0.7752
2023-10-31 17:35,619,139,480,53830,9034,44796,41644391.0,6961340.0,34683051.0,617,141,476,55787,11151,44636,42943065.0,8382840.0,34560224.0,0.7706,0.7742,0.7518,0.7743
2023-10-31 17:40,179,74,105,14301,6604,7697,11041962.0,5083588.0,5958373.0,170,72,98,14248,6762,7486,10999290.0,5205238.0,5794052.0,0.7698,0.7741,0.7698,0.774
2023-10-31 17:45,711,239,472,76887,19128,57759,59420068.0,14718334.0,44701734.0,705,235,470,76880,19023,57857,59422297.0,14637540.0,44784757.0,0.7695,0.7739,0.7695,0.7741
2023-10-31 17:50,1263,416,847,99502,13813,85689,77001339.0,10670943.0,66330396.0,1249,407,842,99367,13765,85602,76864795.0,10601812.0,66262983.0,0.7725,0.7741,0.7702,0.7741
2023-10-31 17:55,1163,430,733,108761,17546,91215,84299493.0,13642709.0,70656783.0,1143,418,725,105796,15739,90057,81888630.0,12127095.0,69761535.0,0.7775,0.7746,0.7705,0.7746
2023-10-31 18:00,170,104,66,8149,4177,3972,6298043.0,3221112.0,3076930.0,157,97,60,7850,4605,3245,6047692.0,3534699.0,2512993.0,0.7712,0.7747,0.7676,0.7744
2023-10-31 18:05,435,213,222,32844,15182,17662,25375675.0,11727407.0,13648267.0,399,202,197,44960,13606,31354,35466891.0,10504355.0,24962535.0,0.7725,0.7727,0.772,0.7962
2023-10-31 18:10,505,253,252,29202,9251,19951,22685564.0,7139323.0,15546241.0,492,245,247,29245,9003,20242,22732721.0,6942627.0,15790093.0,0.7717,0.7792,0.7711,0.7801
2023-10-31 18:15,273,124,149,13251,5636,7615,10251860.0,4347091.0,5904769.0,262,121,141,11712,5543,6169,9054159.0,4275735.0,4778423.0,0.7713,0.7754,0.7714,0.7746
2023-10-31 18:20,557,102,455,66994,4971,62023,51937880.0,3853856.0,48084024.0,548,100,448,66549,5580,60969,51578181.0,4304364.0,47273816.0,0.7753,0.7753,0.7714,0.7754
2023-10-31 18:25,710,269,441,67184,14414,52770,52024796.0,11158188.0,40866607.0,683,254,429,65151,13250,51901,50428301.0,10228410.0,40199890.0,0.7741,0.7744,0.772,0.7745
2023-10-31 18:30,2271,612,1659,267051,56402,210649,206099817.0,43518863.0,162580954.0,2266,598,1668,264273,56113,208160,204227150.0,43278420.0,160948730.0,0.7716,0.7718,0.7713,0.7732
2023-10-31 18:35,2703,1083,1620,318713,126354,192359,246249362.0,97477749.0,148771613.0,2661,1062,1599,307171,118846,188325,237400899.0,91664209.0,145736689.0,0.7715,0.7734,0.7713,0.7739
2023-11-01 10:00,3296,2090,1206,434597,348162,86435,337636621.0,269409337.0,68227284.0,2934,1909,1025,413603,335940,77663,321142005.0,260416422.0,60725582.0,0.7738,0.7893,0.7752,0.7819
2023-11-01 10:05,1103,600,503,73506,46137,27369,57161231.0,35576726.0,21584505.0,961,546,415,66286,41983,24303,51613868.0,32415726.0,19198142.0,0.7711,0.7886,0.7721,0.7899
2023-11-01 10:10,878,572,306,65958,51963,13995,51113654.0,40186933.0,10926721.0,798,511,287,63925,49962,13963,49502614.0,38638484.0,10864129.0,0.7734,0.7808,0.7734,0.7781
2023-11-01 10:15,863,371,492,65308,26563,38745,50712043.0,20573421.0,30138621.0,784,322,462,60281,24213,36068,46724934.0,18696663.0,28028271.0,0.7745,0.7779,0.7722,0.7771
2023-11-01 10:20,610,313,297,22597,14342,8255,17491135.0,11064707.0,6426428.0,466,247,219,21368,13794,7574,16568540.0,10664620.0,5903919.0,0.7715,0.7785,0.7731,0.7795
2023-11-01 10:25,930,563,367,56023,43473,12550,43331914.0,33622860.0,9709053.0,889,542,347,53929,42829,11100,41737439.0,33115736.0,8621702.0,0.7734,0.7736,0.7732,0.7767
2023-11-01 10:30,1459,948,511,90037,66775,23262,69879251.0,51620411.0,18258840.0,1400,915,485,87001,65061,21940,67643443.0,50302809.0,17340633.0,0.773,0.7849,0.7732,0.7904
2023-11-01 10:35,655,412,243,44343,26334,18009,34361108.0,20362988.0,13998119.0,597,383,214,41572,24980,16592,32298153.0,19307410.0,12990742.0,0.7733,0.7773,0.7729,0.783
2023-11-01 10:40,615,390,225,46372,32320,14052,35711979.0,24962219.0,10749760.0,573,369,204,40390,27656,12734,31211151.0,21336392.0,9874758.0,0.7723,0.765,0.7715,0.7755
2023-11-01 10:45,399,228,171,32034,20289,11745,24729540.0,15631164.0,9098376.0,372,213,159,31276,20213,11063,24145597.0,15576475.0,8569122.0,0.7704,0.7747,0.7706,0.7746
2023-11-01 10:50,570,152,418,40057,18980,21077,30715255.0,14411058.0,16304196.0,563,149,414,37667,16515,21152,29083363.0,12720030.0,16363333.0,0.7593,0.7736,0.7702,0.7736
2023-11-01 10:55,642,223,419,47117,19423,27694,36341977.0,14926038.0,21415939.0,608,208,400,43310,15727,27583,33458924.0,12113686.0,21345238.0,0.7685,0.7733,0.7702,0.7739
2023-11-01 11:00,1798,707,1091,133633,40471,93162,103381673.0,31228508.0,72153165.0,1768,693,1075,134177,41830,92347,103776422.0,32250875.0,71525547.0,0.7716,0.7745,0.771,0.7745
2023-11-01 11:05,1247,478,769,98405,30213,68192,76048202.0,23282020.0,52766181.0,1219,465,754,97461,29884,67577,75348633.0,23030270.0,52318362.0,0.7706,0.7738,0.7707,0.7742
2023-11-01 11:10,736,270,466,52597,28860,23737,40602690.0,22246315.0,18356375.0,708,253,455,52281,28706,23575,40361996.0,22121848.0,18240147.0,0.7708,0.7733,0.7706,0.7737
2023-11-01 11:15,382,135,247,29827,10456,19371,23081889.0,8090404.0,14991485.0,357,125,232,28840,10093,18747,22280719.0,7773271.0,14507447.0,0.7738,0.7739,0.7702,0.7739
2023-11-01 11:20,355,110,245,34387,11898,22489,26574064.0,9174127.0,17399937.0,346,107,239,34229,11769,22460,26456540.0,9074526.0,17382013.0,0.7711,0.7737,0.7711,0.7739
2023-11-01 11:25,195,92,103,15916,7601,8315,12303482.0,5861085.0,6442397.0,196,94,102,16172,7751,8421,12499994.0,5976255.0,6523739.0,0.7711,0.7748,0.771,0.7747
2023-11-01 11:30,197,69,128,14508,3315,11193,11217086.0,2548118.0,8668967.0,167,52,115,14451,3123,11328,11179840.0,2404480.0,8775359.0,0.7687,0.7745,0.7699,0.7747
2023-11-01 11:35,639,220,419,42771,27935,14836,32915507.0,21429032.0,11486475.0,631,214,417,41925,27088,14837,32318158.0,20829448.0,11488710.0,0.7671,0.7742,0.769,0.7743
2023-11-01 11:40,821,572,249,76940,51354,25586,59497242.0,39655281.0,19841961.0,803,564,239,75998,50729,25269,58763132.0,39166816.0,19596316.0,0.7722,0.7755,0.7721,0.7755
2023-11-01 11:45,850,399,451,69735,43801,25934,53966637.0,33839661.0,20126976.0,831,392,439,69432,43615,25817,53731476.0,33695864.0,20035611.0,0.7726,0.7761,0.7726,0.7761
2023-11-01 11:50,407,294,113,44450,37146,7304,34362763.0,28700011.0,5662752.0,391,283,108,43563,36790,6773,33677554.0,28424736.0,5252818.0,0.7726,0.7753,0.7726,0.7756
2023-11-01 11:55,865,466,399,61343,44229,17114,47380993.0,34146227.0,13234765.0,842,449,393,59516,44000,15516,45997879.0,33973974.0,12023905.0,0.772,0.7733,0.7721,0.7749
2023-11-01 12:00,348,206,142,18881,12427,6454,14546856.0,9583937.0,4962919.0,333,196,137,18539,12223,6316,14314151.0,9425579.0,4888572.0,0.7712,0.769,0.7711,0.774
2023-11-01 12:05,448,273,175,39676,29879,9797,30632018.0,23048752.0,7583266.0,420,257,163,38516,29866,8650,29733766.0,23033589.0,6700176.0,0.7714,0.774,0.7712,0.7746
2023-11-01 12:10,653,188,465,56299,13414,42885,43234885.0,10318386.0,32916499.0,622,167,455,50235,9227,41008,38825998.0,7106702.0,31719296.0,0.7692,0.7676,0.7702,0.7735
2023-11-01 12:15,1717,934,783,131841,70053,61788,102229875.0,54304034.0,47925840.0,1670,912,758,126987,67093,59894,98256337.0,51803122.0,46453215.0,0.7752,0.7756,0.7721,0.7756
2023-11-01 12:20,1740,695,1045,120565,41749,78816,93738949.0,32344080.0,61394868.0,1707,681,1026,118392,40266,78126,92053796.0,31118754.0,60935041.0,0.7747,0.779,0.7728,0.78
2023-11-01 12:25,888,608,280,81142,47518,33624,62885184.0,36738306.0,26146877.0,864,599,265,79298,47155,32143,61404912.0,36452239.0,24952673.0,0.7731,0.7776,0.773,0.7763
2023-11-01 12:30,435,286,149,43206,30297,12909,33425649.0,23406716.0,10018932.0,418,278,140,42263,29901,12362,32698292.0,23103177.0,9595114.0,0.7726,0.7761,0.7727,0.7762
2023-11-01 12:35,744,370,374,54381,29683,24698,42033587.0,22902586.0,19131001.0,728,358,370,50764,27779,22985,39251488.0,21440149.0,17811339.0,0.7716,0.7746,0.7718,0.7749
2023-11-01 12:40,805,598,207,54619,46152,8467,42177145.0,35618141.0,6559004.0,795,593,202,54848,46493,8355,42300613.0,35828758.0,6471855.0,0.7718,0.7747,0.7706,0.7746
2023-11-01 12:45,908,682,226,76917,64275,12642,59337904.0,49559861.0,9778042.0,888,669,219,75931,63718,12213,58618289.0,49173083.0,9445206.0,0.7711,0.7735,0.7717,0.7734
2023-11-01 12:50,1071,761,310,92271,73260,19011,71254753.0,56552316.0,14702436.0,1060,752,308,92450,73218,19232,71392294.0,56518945.0,14873349.0,0.7719,0.7734,0.7719,0.7734
2023-11-01 12:55,404,247,157,35490,21013,14477,27438931.0,16224088.0,11214843.0,377,233,144,35908,22080,13828,27682991.0,16975803.0,10707188.0,0.7721,0.7747,0.7688,0.7743
2023-11-01 13:00,1308,595,713,118175,44356,73819,91495810.0,34290436.0,57205374.0,1296,589,707,119497,45979,73518,92537947.0,35511446.0,57026500.0,0.7731,0.7749,0.7723,0.7757
2023-11-01 13:05,1326,700,626,134092,67519,66573,103397442.0,52082380.0,51315062.0,1292,679,613,129540,65343,64197,100150435.0,50406650.0,49743784.0,0.7714,0.7708,0.7714,0.7749
2023-11-01 13:10,1364,583,781,139058,52855,86203,107345645.0,40765489.0,66580156.0,1342,567,775,137016,52352,84664,105928580.0,40371844.0,65556736.0,0.7713,0.7724,0.7712,0.7743
2023-11-01 13:15,587,262,325,41768,6011,35757,32296847.0,4632081.0,27664765.0,578,257,321,41207,6050,35157,31868138.0,4659818.0,27208320.0,0.7706,0.7737,0.7702,0.7739
2023-11-01 13:20,423,173,250,35903,5230,30673,27759813.0,4028185.0,23731627.0,416,166,250,36029,5195,30834,27857475.0,4000253.0,23857222.0,0.7702,0.7737,0.77,0.7737
2023-11-01 13:25,445,97,348,26141,3720,22421,20211668.0,2870544.0,17341124.0,435,89,346,24896,2485,22411,19245728.0,1913088.0,17332639.0,0.7717,0.7734,0.7699,0.7734
2023-11-01 13:30,501,237,264,17937,2260,15677,13868355.0,1743999.0,12124356.0,500,237,263,18425,2749,15676,14242229.0,2118553.0,12123675.0,0.7717,0.7734,0.7707,0.7734
2023-11-01 13:35,177,78,99,17611,3154,14457,13636138.0,2439986.0,11196152.0,170,74,96,17353,3087,14266,13416005.0,2380187.0,11035817.0,0.7736,0.7744,0.771,0.7736
2023-11-01 13:40,749,260,489,54033,10714,43319,41761088.0,8262300.0,33498787.0,726,247,479,53741,10533,43208,41532664.0,8117675.0,33414989.0,0.7712,0.7733,0.7707,0.7734
2023-11-01 13:45,437,94,343,29480,3570,25910,22764943.0,2749071.0,20015872.0,423,86,337,28782,3251,25531,22248965.0,2502029.0,19746936.0,0.77,0.7725,0.7696,0.7734
2023-11-01 13:50,263,108,155,17694,3340,14354,13681829.0,2574249.0,11107580.0,258,108,150,17998,3515,14483,13918915.0,2709010.0,11209905.0,0.7707,0.7738,0.7707,0.774
2023-11-01 13:55,500,165,335,34135,4389,29746,26389208.0,3378853.0,23010355.0,496,163,333,34168,4328,29840,26413751.0,3330804.0,23082947.0,0.7698,0.7736,0.7696,0.7736
2023-11-01 14:00,2769,197,2572,305909,5370,300539,236905192.0,4139791.0,232765400.0,2775,194,2581,306591,5496,301095,237432493.0,4236943.0,233195550.0,0.7709,0.7745,0.7709,0.7745
2023-11-01 14:05,2130,324,1806,217487,14706,202781,168351333.0,11345641.0,157005692.0,2106,312,1794,216275,14153,202122,167459415.0,10917182.0,156542233.0,0.7715,0.7743,0.7714,0.7745
2023-11-01 14:10,2669,335,2334,267928,10054,257874,207578326.0,7798535.0,199779791.0,2650,326,2324,268070,10253,257817,207635626.0,7897128.0,199738498.0,0.7757,0.7747,0.7702,0.7747
2023-11-01 14:15,1415,268,1147,156227,17309,138918,120949795.0,13353088.0,107596706.0,1396,261,1135,155992,17274,138718,120763113.0,13321682.0,107441430.0,0.7715,0.7745,0.7712,0.7745
2023-11-01 14:20,2354,824,1530,199827,42651,157176,154732789.0,32925415.0,121807373.0,2334,810,1524,199247,42196,157051,154272568.0,32558381.0,121714186.0,0.772,0.775,0.7716,0.775
2023-11-01 14:25,1713,807,906,150819,64435,86384,116617557.0,49675798.0,66941758.0,1692,799,893,149429,63831,85598,115532314.0,49199523.0,66332791.0,0.7709,0.7749,0.7708,0.7749
2023-11-01 14:30,138,61,77,9306,3875,5431,7190163.0,2987005.0,4203157.0,123,51,72,9121,3670,5451,7047218.0,2829042.0,4218176.0,0.7708,0.7739,0.7709,0.7738
2023-11-01 14:35,320,205,115,31339,22479,8860,24202211.0,17340303.0,6861908.0,301,193,108,30160,21779,8381,23287551.0,16797018.0,6490533.0,0.7714,0.7745,0.7712,0.7744
2023-11-01 14:40,431,208,223,35314,10320,24994,27297164.0,7963519.0,19333645.0,412,194,218,34107,9326,24781,26364489.0,7194362.0,19170127.0,0.7717,0.7735,0.7714,0.7736
2023-11-01 14:45,348,109,239,19930,4129,15801,15396734.0,3173757.0,12222976.0,334,101,233,19732,4157,15575,15245045.0,3195803.0,12049242.0,0.7687,0.7736,0.7688,0.7736
2023-11-01 14:50,257,167,90,14446,7673,6773,11153257.0,5919442.0,5233815.0,247,165,82,13720,8282,5438,10578140.0,6374848.0,4203292.0,0.7715,0.7727,0.7697,0.7729
2023-11-01 14:55,520,281,239,13941,8780,5161,10770988.0,6792849.0,3978139.0,498,273,225,13287,8455,4832,10251902.0,6517898.0,3734004.0,0.7737,0.7708,0.7709,0.7728
2023-11-01 15:00,413,156,257,27236,7170,20066,21018136.0,5523294.0,15494841.0,389,139,250,26448,6490,19958,20413324.0,4999103.0,15414220.0,0.7703,0.7722,0.7703,0.7723
2023-11-01 15:05,392,234,158,22382,11803,10579,17405326.0,9230786.0,8174539.0,376,225,151,21882,10668,11214,16888836.0,8216120.0,8672716.0,0.7821,0.7727,0.7702,0.7734
2023-11-01 15:10,470,294,176,19869,13550,6319,15347979.0,10455333.0,4892645.0,464,292,172,19664,13519,6145,15188653.0,10431069.0,4757584.0,0.7716,0.7743,0.7716,0.7742
2023-11-01 15:15,143,84,59,8403,6591,1812,6481294.0,5076251.0,1405043.0,139,80,59,8268,6455,1813,6374935.0,4969414.0,1405521.0,0.7702,0.7754,0.7699,0.7752
2023-11-01 15:20,645,295,350,36401,19169,17232,28122465.0,14788985.0,13333479.0,631,289,342,36016,19109,16907,27829398.0,14742682.0,13086716.0,0.7715,0.7738,0.7715,0.774
2023-11-01 15:25,597,339,258,29666,22689,6977,23004797.0,17605615.0,5399182.0,568,325,243,28986,22148,6838,22395057.0,17091579.0,5303477.0,0.776,0.7739,0.7717,0.7756
2023-11-01 15:30,692,319,373,45204,29727,15477,35017259.0,23007764.0,12009495.0,666,301,365,42823,28351,14472,33123234.0,21893818.0,11229416.0,0.774,0.776,0.7722,0.7759
2023-11-01 15:35,264,198,66,19483,16108,3375,15074543.0,12458222.0,2616321.0,244,185,59,15917,12944,2973,12310609.0,10004946.0,2305662.0,0.7734,0.7752,0.7729,0.7755
2023-11-01 15:40,571,368,203,37470,30089,7381,29117714.0,23375531.0,5742182.0,563,368,195,38613,31588,7025,29884040.0,24421223.0,5462817.0,0.7769,0.778,0.7731,0.7776
2023-11-01 15:45,813,307,506,44552,24626,19926,34366074.0,19029634.0,15336440.0,791,299,492,43165,24261,18904,33416231.0,18747292.0,14668939.0,0.7727,0.7697,0.7727,0.776
2023-11-01 15:50,5766,3939,1827,596807,492329,104478,467971902.0,385909868.0,82062034.0,5307,3777,1530,551330,461747,89583,431071937.0,360683020.0,70388916.0,0.7838,0.7854,0.7811,0.7857
2023-11-01 15:55,1855,815,1040,138234,95255,42979,108705323.0,74908602.0,33796721.0,1696,760,936,130780,93719,37061,102816587.0,73503652.0,29312935.0,0.7864,0.7864,0.7843,0.7909
2023-11-01 16:00,1676,716,960,91707,42165,49542,72067894.0,33048938.0,39018955.0,1578,657,921,93371,49975,43396,73207641.0,39035298.0,34172342.0,0.7838,0.7876,0.7811,0.7875
2023-11-01 16:05,1478,782,696,73040,43867,29173,57487180.0,34487108.0,23000071.0,1413,750,663,72399,44047,28352,56935655.0,34565626.0,22370029.0,0.7862,0.7884,0.7847,0.789
2023-11-01 16:10,1031,559,472,69793,46684,23109,54828012.0,36695711.0,18132300.0,927,518,409,60844,43521,17323,47803870.0,34110939.0,13692931.0,0.786,0.7846,0.7838,0.7904
2023-11-01 16:15,924,513,411,75150,56094,19056,59197796.0,44156978.0,15040818.0,830,488,342,68285,54014,14271,53683601.0,42386079.0,11297522.0,0.7872,0.7893,0.7847,0.7916
2023-11-01 16:20,584,197,387,32932,21752,11180,25872026.0,17045843.0,8826183.0,551,179,372,32094,21129,10965,25191483.0,16530011.0,8661472.0,0.7836,0.7895,0.7823,0.7899
2023-11-01 16:25,748,248,500,36129,19823,16306,28293230.0,15551312.0,12741917.0,689,226,463,34372,19374,14998,27063073.0,15197900.0,11865173.0,0.7845,0.7814,0.7844,0.7911
2023-11-01 16:30,953,386,567,50829,34140,16689,39952846.0,26781917.0,13170929.0,932,375,557,50914,34173,16741,40111637.0,26785432.0,13326204.0,0.7845,0.7892,0.7838,0.796
2023-11-01 16:35,1144,450,694,48942,29589,19353,38559617.0,23330151.0,15229466.0,1106,425,681,47200,28411,18789,37115587.0,22294609.0,14820978.0,0.7885,0.7869,0.7847,0.7888
2023-11-01 16:40,880,433,447,58258,35046,23212,45701142.0,27589974.0,18111167.0,807,396,411,54063,33167,20896,42496450.0,26018449.0,16478001.0,0.7873,0.7803,0.7845,0.7886
2023-11-01 16:45,146,89,57,7497,4836,2661,5828978.0,3777959.0,2051018.0,125,82,43,6819,4584,2235,5346629.0,3583810.0,1762819.0,0.7812,0.7708,0.7818,0.7887
2023-11-01 16:50,269,173,96,11097,6561,4536,8706228.0,5142485.0,3563743.0,245,156,89,11248,6428,4820,8810316.0,5016057.0,3794259.0,0.7838,0.7857,0.7803,0.7872
2023-11-01 16:55,69,34,35,3329,1753,1576,2616131.0,1374632.0,1241498.0,53,27,26,2647,1541,1106,2065673.0,1195998.0,869674.0,0.7842,0.7878,0.7761,0.7863
2023-11-01 17:00,228,133,95,10472,6530,3942,8207100.0,5124964.0,3082136.0,210,125,85,9908,6280,3628,7761063.0,4907846.0,2853216.0,0.7848,0.7819,0.7815,0.7864
2023-11-01 17:05,186,102,84,10012,6168,3844,7850663.0,4826117.0,3024545.0,170,93,77,9575,5697,3878,7507524.0,4457483.0,3050041.0,0.7824,0.7868,0.7824,0.7865
2023-11-01 17:10,641,314,327,45989,26109,19880,36067152.0,20410223.0,15656928.0,623,309,314,44997,25652,19345,35282636.0,20047459.0,15235177.0,0.7817,0.7876,0.7815,0.7876
2023-11-01 17:15,1453,658,795,94755,67495,27260,74574889.0,53116477.0,21458411.0,1389,633,756,92343,66132,26211,72582936.0,51918761.0,20664175.0,0.787,0.7872,0.7851,0.7884
2023-11-01 17:20,812,336,476,40045,27209,12836,31380105.0,21343883.0,10036221.0,775,317,458,38282,26699,11583,30065871.0,20932558.0,9133313.0,0.7844,0.7819,0.784,0.7885
2023-11-01 17:25,901,588,313,64292,52592,11700,50663459.0,41427842.0,9235617.0,856,574,282,61751,51257,10494,48515767.0,40234171.0,8281596.0,0.7877,0.7894,0.7849,0.7892
2023-11-01 17:30,526,318,208,39211,34535,4676,31027353.0,27333982.0,3693371.0,473,305,168,35184,31549,3635,27907799.0,25026050.0,2881748.0,0.7915,0.7899,0.7932,0.7928
2023-11-01 17:35,806,529,277,51816,39361,12455,40776093.0,31091534.0,9684559.0,682,451,231,42932,33651,9281,33734147.0,26368285.0,7365862.0,0.7899,0.7776,0.7836,0.7936
2023-11-01 17:40,1386,538,848,105937,63321,42616,83268464.0,49720843.0,33547621.0,1271,463,808,96241,58166,38075,75790567.0,45679150.0,30111416.0,0.7852,0.7872,0.7853,0.7908
2023-11-01 17:45,898,522,376,63192,36569,26623,49626158.0,28724743.0,20901415.0,785,439,346,53203,31527,21676,41775104.0,24678545.0,17096559.0,0.7855,0.7851,0.7828,0.7887
2023-11-01 17:50,1095,545,550,81941,42472,39469,64572463.0,33359523.0,31212939.0,1021,514,507,77147,39960,37187,60661598.0,31259056.0,29402542.0,0.7854,0.7908,0.7823,0.7907
2023-11-01 17:55,557,311,246,36122,23301,12821,28366715.0,18289817.0,10076898.0,499,284,215,34026,22391,11635,26766697.0,17561926.0,9204771.0,0.7849,0.786,0.7843,0.7911
2023-11-01 18:00,236,152,84,16686,11459,5227,13073062.0,8972607.0,4100455.0,203,132,71,15854,11661,4193,12405781.0,9087849.0,3317931.0,0.783,0.7845,0.7793,0.7913
2023-11-01 18:05,352,213,139,43561,26596,16965,34338927.0,20856512.0,13482415.0,346,212,134,42935,29148,13787,33720952.0,22834045.0,10886906.0,0.7842,0.7947,0.7834,0.7897
2023-11-01 18:10,602,205,397,47935,27574,20361,37442762.0,21606870.0,15835892.0,560,182,378,43710,25755,17955,34352881.0,20178677.0,14174204.0,0.7836,0.7778,0.7835,0.7894
2023-11-01 18:15,1036,541,495,67128,38584,28544,52781179.0,30292460.0,22488719.0,996,517,479,65830,38045,27785,51780027.0,29862397.0,21917630.0,0.7851,0.7879,0.7849,0.7888
2023-11-01 18:20,1738,882,856,156930,96045,60885,123228319.0,75425745.0,47802574.0,1683,846,837,152969,95054,57915,120316092.0,74636334.0,45679757.0,0.7853,0.7851,0.7852,0.7887
2023-11-01 18:25,221,170,51,13780,11688,2092,10836419.0,9187630.0,1648789.0,185,147,38,11513,9648,1865,9032366.0,7560411.0,1471954.0,0.7861,0.7881,0.7836,0.7893
2023-11-01 18:30,512,383,129,41122,37021,4101,32361108.0,29147105.0,3214002.0,488,363,125,40256,35538,4718,31604595.0,27887153.0,3717441.0,0.7873,0.7837,0.7847,0.7879
2023-11-01 18:35,229,124,105,15151,8787,6364,11939291.0,6927712.0,5011578.0,200,97,103,16841,7834,9007,13348713.0,6146336.0,7202377.0,0.7884,0.7875,0.7846,0.7996
2023-11-02 10:00,2597,1255,1342,191102,100052,91050,151335941.0,78808413.0,72527528.0,2085,986,1099,158312,82015,76297,125749042.0,65170362.0,60578679.0,0.7877,0.7966,0.7946,0.794
2023-11-02 10:05,1825,1127,698,163497,115029,48468,129031860.0,90822971.0,38208888.0,1626,1030,596,151797,109987,41810,119672775.0,86544000.0,33128775.0,0.7896,0.7883,0.7869,0.7924
2023-11-02 10:10,950,644,306,66157,43592,22565,52169816.0,34343911.0,17825905.0,852,587,265,62669,41834,20835,49407522.0,32903872.0,16503649.0,0.7878,0.79,0.7865,0.7921
2023-11-02 10:15,676,382,294,31935,19298,12637,25110356.0,15102971.0,10007385.0,491,278,213,26380,15637,10743,20842547.0,12307243.0,8535303.0,0.7826,0.7919,0.7871,0.7945
2023-11-02 10:20,679,395,284,44941,27525,17416,35695632.0,21839017.0,13856615.0,556,318,238,38154,24547,13607,30144234.0,19345672.0,10798561.0,0.7934,0.7956,0.7881,0.7936
2023-11-02 10:25,397,174,223,27810,8458,19352,22142477.0,6717249.0,15425227.0,317,132,185,24642,7340,17302,19550070.0,5793089.0,13756981.0,0.7942,0.7971,0.7892,0.7951
2023-11-02 10:30,304,151,153,16511,7099,9412,12922698.0,5611203.0,7311495.0,236,117,119,12123,5947,6176,9604195.0,4697856.0,4906339.0,0.7904,0.7768,0.79,0.7944
2023-11-02 10:35,616,300,316,47222,28789,18433,37000309.0,22710618.0,14289690.0,530,248,282,40331,26100,14231,31834013.0,20562923.0,11271090.0,0.7889,0.7752,0.7879,0.792
2023-11-02 10:40,373,178,195,31538,13546,17992,24873157.0,10630811.0,14242345.0,332,154,178,20120,8347,11773,15886286.0,6570262.0,9316023.0,0.7848,0.7916,0.7871,0.7913
2023-11-02 10:45,260,159,101,26778,8672,18106,22611814.0,6982753.0,15629060.0,194,128,66,11625,6386,5239,9192451.0,5031286.0,4161165.0,0.8052,0.8632,0.7879,0.7943
2023-11-02 10:50,286,150,136,20687,7536,13151,16489576.0,5960884.0,10528691.0,228,124,104,30599,7134,23465,25555078.0,5631900.0,19923177.0,0.791,0.8006,0.7894,0.8491
2023-11-02 10:55,235,123,112,29385,5787,23598,24685527.0,4895635.0,19789892.0,190,101,89,10778,5190,5588,8891070.0,4395394.0,4495675.0,0.846,0.8386,0.8469,0.8045
2023-11-02 11:00,227,106,121,16933,7485,9448,13447203.0,5906528.0,7540675.0,189,85,104,12396,5346,7050,9773259.0,4197982.0,5575277.0,0.7891,0.7981,0.7853,0.7908
2023-11-02 11:05,462,305,157,25154,16020,9134,19727740.0,12567228.0,7160512.0,419,285,134,23536,14848,8688,18535259.0,11664752.0,6870507.0,0.7845,0.7839,0.7856,0.7908
2023-11-02 11:10,653,274,379,43077,13727,29350,34044054.0,10835976.0,23208077.0,621,259,362,39682,11599,28083,31340686.0,9140625.0,22200060.0,0.7894,0.7907,0.7881,0.7905
2023-11-02 11:15,503,156,347,29090,12869,16221,22632769.0,9803891.0,12828878.0,467,135,332,23660,8154,15506,18678418.0,6414258.0,12264160.0,0.7618,0.7909,0.7866,0.7909
2023-11-02 11:20,585,165,420,39237,10821,28416,31026108.0,8549182.0,22476926.0,557,151,406,38660,10378,28282,30548514.0,8181583.0,22366931.0,0.7901,0.791,0.7884,0.7909
2023-11-02 11:25,88,52,36,11007,3018,7989,8996319.0,2321503.0,6674816.0,80,47,33,11166,2865,8301,9147118.0,2247911.0,6899207.0,0.7692,0.8355,0.7846,0.8311
2023-11-02 11:30,231,114,117,18582,6895,11687,14626369.0,5438905.0,9187464.0,214,102,112,17784,7295,10489,14025556.0,5739972.0,8285584.0,0.7888,0.7861,0.7868,0.7899
2023-11-02 11:35,223,95,128,16914,5261,11653,13377346.0,4154697.0,9222649.0,200,84,116,14503,4878,9625,11455387.0,3843302.0,7612085.0,0.7897,0.7914,0.7879,0.7909
2023-11-02 11:40,222,98,124,18753,10372,8381,14771307.0,8178362.0,6592945.0,200,87,113,16847,9810,7037,13293708.0,7733027.0,5560680.0,0.7885,0.7867,0.7883,0.7902
2023-11-02 11:45,141,92,49,22513,9071,13442,18321043.0,7147422.0,11173621.0,122,84,38,22062,8980,13082,18078166.0,7075021.0,11003144.0,0.7879,0.8312,0.7879,0.8411
2023-11-02 11:50,47,34,13,4179,3962,217,3291099.0,3122220.0,168879.0,34,26,8,4436,3905,531,3518488.0,3076197.0,442291.0,0.788,0.7782,0.7878,0.8329
2023-11-02 11:55,149,70,79,17814,9106,8708,14053386.0,7171739.0,6881647.0,129,61,68,18403,8561,9842,14522273.0,6744615.0,7777658.0,0.7876,0.7903,0.7878,0.7903
2023-11-02 12:00,197,137,60,12369,8981,3388,9763209.0,7074114.0,2689094.0,184,129,55,12672,8387,4285,9986883.0,6601266.0,3385617.0,0.7877,0.7937,0.7871,0.7901
2023-11-02 12:05,344,261,83,13832,7304,6528,10929581.0,5742669.0,5186911.0,327,253,74,12993,7179,5814,10254489.0,5647851.0,4606638.0,0.7862,0.7946,0.7867,0.7923
2023-11-02 12:10,79,40,39,6721,4105,2616,5306156.0,3230327.0,2075828.0,70,32,38,7284,4012,3272,5754533.0,3157018.0,2597515.0,0.7869,0.7935,0.7869,0.7939
2023-11-02 12:15,138,80,58,6738,3805,2933,5324218.0,3039352.0,2284865.0,120,69,51,5927,3515,2412,4673924.0,2765514.0,1908409.0,0.7988,0.779,0.7868,0.7912
2023-11-02 12:20,319,58,261,9798,2065,7733,7741746.0,1629462.0,6112283.0,307,51,256,9917,2103,7814,7827441.0,1653079.0,6174361.0,0.7891,0.7904,0.7861,0.7902
2023-11-02 12:25,123,88,35,7705,5546,2159,6079403.0,4371855.0,1707548.0,111,81,30,7527,5491,2036,5940265.0,4329176.0,1611089.0,0.7883,0.7909,0.7884,0.7913
2023-11-02 12:30,518,242,276,45104,18551,26553,35747829.0,14732138.0,21015691.0,483,226,257,43702,17589,26113,34535814.0,13869180.0,20666634.0,0.7941,0.7915,0.7885,0.7914
2023-11-02 12:35,1530,935,595,124242,82027,42215,98230706.0,64719833.0,33510873.0,1501,919,582,120526,81062,39464,95170065.0,63951765.0,31218299.0,0.789,0.7938,0.7889,0.7911
2023-11-02 12:40,536,201,335,35147,15269,19878,27589814.0,12008735.0,15581079.0,497,188,309,33199,14951,18248,26189257.0,11758292.0,14430964.0,0.7865,0.7838,0.7865,0.7908
2023-11-02 12:45,122,66,56,6549,3870,2679,5183043.0,3034154.0,2148888.0,92,50,42,5852,3410,2442,4641046.0,2675753.0,1965292.0,0.784,0.8021,0.7847,0.8048
2023-11-02 12:50,185,65,120,11847,6067,5780,9284376.0,4777710.0,4506665.0,155,52,103,10392,5470,4922,8188604.0,4300288.0,3888316.0,0.7875,0.7797,0.7862,0.79
2023-11-02 12:55,188,76,112,15140,4984,10156,11958334.0,3926041.0,8032292.0,167,63,104,13857,4269,9588,10946107.0,3362410.0,7583697.0,0.7877,0.7909,0.7876,0.791
2023-11-02 13:00,199,101,98,15849,9820,6029,12497779.0,7733114.0,4764665.0,181,92,89,13909,8176,5733,10971302.0,6437669.0,4533632.0,0.7875,0.7903,0.7874,0.7908
2023-11-02 13:05,644,250,394,50275,17507,32768,39847548.0,13940833.0,25906714.0,577,226,351,44125,15977,28148,34867003.0,12593911.0,22273091.0,0.7963,0.7906,0.7883,0.7913
2023-11-02 13:10,117,77,40,6016,4330,1686,4759658.0,3425666.0,1333992.0,92,69,23,5724,4293,1431,4513349.0,3379641.0,1133708.0,0.7911,0.7912,0.7872,0.7922
2023-11-02 13:15,187,104,83,11294,6949,4345,8923852.0,5493468.0,3430383.0,154,92,62,9833,6043,3790,7777490.0,4757566.0,3019924.0,0.7905,0.7895,0.7873,0.7968
2023-11-02 13:20,406,222,184,31131,16226,14905,24754270.0,12956912.0,11797357.0,351,193,158,27336,13222,14114,21610999.0,10426388.0,11184610.0,0.7985,0.7915,0.7886,0.7924
2023-11-02 13:25,1128,668,460,103815,69804,34011,82308893.0,55294105.0,27014787.0,1042,623,419,95051,64365,30686,75176606.0,50814946.0,24361660.0,0.7921,0.7943,0.7895,0.7939
2023-11-02 13:30,348,235,113,25386,14524,10862,20088029.0,11460681.0,8627348.0,266,177,89,28368,18068,10300,22437295.0,14247430.0,8189865.0,0.7891,0.7943,0.7885,0.7951
2023-11-02 13:35,576,217,359,28016,13426,14590,22183052.0,10607516.0,11575535.0,543,196,347,29118,12806,16312,23058346.0,10120805.0,12937540.0,0.7901,0.7934,0.7903,0.7931
2023-11-02 13:40,325,192,133,10837,7232,3605,8567881.0,5722448.0,2845433.0,289,169,120,10396,7014,3382,8229716.0,5544897.0,2684819.0,0.7913,0.7893,0.7905,0.7939
2023-11-02 13:45,457,166,291,19844,12016,7828,15701957.0,9494826.0,6207131.0,417,139,278,20145,11286,8859,15947770.0,8916869.0,7030900.0,0.7902,0.7929,0.7901,0.7936
2023-11-02 13:50,352,188,164,25412,17398,8014,20212218.0,13863980.0,6348238.0,285,159,126,23813,16328,7485,18847600.0,12891069.0,5956530.0,0.7969,0.7921,0.7895,0.7958
2023-11-02 13:55,1541,998,543,115861,87913,27948,92516728.0,70340629.0,22176098.0,1271,888,383,94716,72534,22182,75228982.0,57516014.0,17712968.0,0.8001,0.7935,0.793,0.7985
2023-11-02 14:00,977,513,464,57626,38528,19098,46027987.0,30716414.0,15311572.0,785,448,337,48220,34565,13655,38466025.0,27496012.0,10970012.0,0.7972,0.8017,0.7955,0.8034
2023-11-02 14:05,755,306,449,42086,23346,18740,33611409.0,18714372.0,14897037.0,611,238,373,34065,18632,15433,27167111.0,14809938.0,12357173.0,0.8016,0.7949,0.7949,0.8007
2023-11-02 14:10,490,168,322,22306,10032,12274,17852073.0,7975087.0,9876986.0,448,145,303,20338,8454,11884,16251235.0,6715446.0,9535789.0,0.795,0.8047,0.7944,0.8024
2023-11-02 14:15,206,106,100,10705,5570,5135,8543896.0,4467090.0,4076806.0,167,89,78,13191,7996,5195,10558570.0,6328993.0,4229577.0,0.802,0.7939,0.7915,0.8142
2023-11-02 14:20,618,226,392,29680,16846,12834,23585416.0,13408984.0,10176432.0,558,205,353,29912,20946,8966,23756295.0,16596329.0,7159965.0,0.796,0.7929,0.7923,0.7986
2023-11-02 14:25,888,328,560,78472,34057,44415,62478436.0,27090855.0,35387580.0,820,291,529,73026,31100,41926,58213748.0,24683946.0,33529802.0,0.7955,0.7967,0.7937,0.7997
2023-11-02 14:30,666,331,335,53559,25869,27690,42701453.0,20615830.0,22085622.0,607,306,301,50608,24190,26418,40282625.0,19204343.0,21078282.0,0.7969,0.7976,0.7939,0.7979
2023-11-02 14:35,466,335,131,57582,51050,6532,45744331.0,40544523.0,5199808.0,431,319,112,55754,49974,5780,44347882.0,39713068.0,4634814.0,0.7942,0.7961,0.7947,0.8019
2023-11-02 14:40,1144,584,560,76148,51683,24465,61084115.0,41504335.0,19579780.0,828,458,370,58928,40031,18897,47068452.0,31796634.0,15271818.0,0.8031,0.8003,0.7943,0.8082
2023-11-02 14:45,617,267,350,38123,17289,20834,30551808.0,13984374.0,16567434.0,508,230,278,31425,14920,16505,25150314.0,11893787.0,13256526.0,0.8089,0.7952,0.7972,0.8032
2023-11-02 14:50,813,374,439,57018,31195,25823,45432447.0,24895563.0,20536884.0,731,330,401,51642,30270,21372,41223198.0,24093375.0,17129822.0,0.7981,0.7953,0.7959,0.8015
2023-11-02 14:55,569,305,264,48351,31822,16529,38294946.0,25314463.0,12980483.0,500,273,227,39358,27316,12042,31365257.0,21722658.0,9642599.0,0.7955,0.7853,0.7952,0.8007
2023-11-02 15:00,406,248,158,32072,22832,9240,25815451.0,18233898.0,7581552.0,351,230,121,29116,19466,9650,23391134.0,15498628.0,7892506.0,0.7986,0.8205,0.7962,0.8179
2023-11-02 15:05,1118,647,471,96696,60015,36681,76778634.0,48195396.0,28583238.0,922,559,363,69107,44248,24859,55307188.0,35313307.0,19993881.0,0.8031,0.7792,0.7981,0.8043
2023-11-02 15:10,578,261,317,33768,14725,19043,26946877.0,11744113.0,15202763.0,489,217,272,28376,12647,15729,22737318.0,10096210.0,12641107.0,0.7976,0.7983,0.7983,0.8037
2023-11-02 15:15,1134,305,829,74977,23458,51519,59649348.0,18681210.0,40968138.0,993,243,750,83371,24124,59247,67654099.0,19220254.0,48433845.0,0.7964,0.7952,0.7967,0.8175
2023-11-02 15:20,1000,410,590,75412,24899,50513,60349408.0,19911826.0,40437582.0,918,383,535,69968,21057,48911,55945393.0,16777873.0,39167520.0,0.7997,0.8005,0.7968,0.8008
2023-11-02 15:25,193,93,100,11871,4443,7428,9830561.0,3532898.0,6297663.0,162,81,81,10380,3652,6728,8474240.0,2899611.0,5574628.0,0.7952,0.8478,0.794,0.8286
2023-11-02 15:30,317,159,158,19698,6121,13577,16131365.0,4928699.0,11202666.0,282,138,144,17370,4737,12633,14276083.0,3783759.0,10492324.0,0.8052,0.8251,0.7988,0.8305
2023-11-02 15:35,309,100,209,18202,4858,13344,14504703.0,3872550.0,10632153.0,277,83,194,16626,5326,11300,13288521.0,4244707.0,9043813.0,0.7971,0.7968,0.797,0.8003
2023-11-02 15:40,283,137,146,19818,10002,9816,15999656.0,8017221.0,7982435.0,235,113,122,16853,8483,8370,13555601.0,6763854.0,6791746.0,0.8016,0.8132,0.7973,0.8114
2023-11-02 15:45,502,264,238,29831,15908,13923,23821209.0,12709015.0,11112194.0,475,251,224,27575,15689,11886,22053238.0,12533458.0,9519779.0,0.7989,0.7981,0.7989,0.8009
2023-11-02 15:50,210,132,78,13529,8560,4969,10931064.0,6819986.0,4111077.0,191,127,64,16698,12308,4390,13391258.0,9776895.0,3614363.0,0.7967,0.8273,0.7944,0.8233
2023-11-02 15:55,2276,1231,1045,227347,135686,91661,182039147.0,108831678.0,73207468.0,1807,995,812,180124,110526,69598,144198744.0,88290946.0,55907797.0,0.8021,0.7987,0.7988,0.8033
2023-11-02 16:00,3590,2004,1586,333002,212603,120399,267057037.0,170991402.0,96065634.0,2916,1655,1261,281515,186010,95505,225409530.0,148558995.0,76850534.0,0.8043,0.7979,0.7987,0.8047
2023-11-02 16:05,2173,1272,901,160597,106289,54308,129373580.0,85762189.0,43611391.0,1679,1016,663,128796,88777,40019,103811327.0,71141064.0,32670263.0,0.8069,0.803,0.8013,0.8164
2023-11-02 16:10,826,488,338,65336,39923,25413,52390377.0,32110826.0,20279551.0,723,442,281,63561,40028,23533,51020130.0,31962879.0,19057251.0,0.8043,0.798,0.7985,0.8098
2023-11-02 16:15,1255,865,390,108488,79303,29185,87359410.0,63956218.0,23403192.0,1084,775,309,93075,70095,22980,74936881.0,56217495.0,18719385.0,0.8065,0.8019,0.802,0.8146
2023-11-02 16:20,1085,626,459,90005,53293,36712,71499416.0,42559742.0,28939674.0,878,509,369,71633,42681,28952,57238642.0,34004106.0,23234535.0,0.7986,0.7883,0.7967,0.8025
2023-11-02 16:25,501,240,261,29348,15953,13395,23571702.0,12815358.0,10756343.0,446,220,226,29211,17800,11411,23336601.0,14180079.0,9156521.0,0.8033,0.803,0.7966,0.8024
2023-11-02 16:30,508,316,192,48084,33384,14700,38567117.0,26727196.0,11839921.0,433,291,142,44053,31648,12405,35290224.0,25265013.0,10025211.0,0.8006,0.8054,0.7983,0.8082
2023-11-02 16:35,322,195,127,25466,17157,8309,20431631.0,13871359.0,6560271.0,264,173,91,20518,14732,5786,16409236.0,11757265.0,4651971.0,0.8085,0.7895,0.7981,0.804
2023-11-02 16:40,1151,458,693,83714,34186,49528,66600787.0,27276730.0,39324056.0,1044,393,651,72940,29045,43895,58367194.0,23152780.0,35214413.0,0.7979,0.794,0.7971,0.8022
2023-11-02 16:45,531,239,292,40704,15994,24710,32045605.0,12741190.0,19304415.0,419,179,240,33098,13214,19884,26415545.0,10509804.0,15905740.0,0.7966,0.7812,0.7954,0.7999
2023-11-02 16:50,931,445,486,78939,27437,51502,62838971.0,21846253.0,40992717.0,816,361,455,73420,24911,48509,58562549.0,19809545.0,38753003.0,0.7962,0.7959,0.7952,0.7989
2023-11-02 16:55,461,240,221,28254,15895,12359,22775180.0,12900130.0,9875050.0,393,202,191,25209,13037,12172,20159252.0,10386740.0,9772512.0,0.8116,0.799,0.7967,0.8029
2023-11-02 17:00,855,352,503,66700,21947,44753,52865308.0,17491681.0,35373626.0,781,311,470,57334,18711,38623,45796467.0,14893613.0,30902854.0,0.797,0.7904,0.796,0.8001
2023-11-02 17:05,351,207,144,20079,11815,8264,16077938.0,9411921.0,6666017.0,314,182,132,18340,10548,7792,14690032.0,8395159.0,6294872.0,0.7966,0.8066,0.7959,0.8079
2023-11-02 17:10,918,535,383,54101,26106,27995,42894353.0,20751662.0,22142691.0,859,509,350,50185,25549,24636,39975357.0,20306077.0,19669280.0,0.7949,0.791,0.7948,0.7984
2023-11-02 17:15,623,298,325,45356,18208,27148,36016612.0,14449172.0,21567440.0,499,234,265,42086,14756,27330,33450400.0,11646653.0,21803747.0,0.7936,0.7944,0.7893,0.7978
2023-11-02 17:20,1873,1024,849,170886,83776,87110,133907052.0,66040727.0,67866325.0,1500,848,652,145716,73921,71795,115240141.0,58202974.0,57037166.0,0.7883,0.7791,0.7874,0.7944
2023-11-02 17:25,830,263,567,92454,21265,71189,73129705.0,16733154.0,56396550.0,758,214,544,87638,17597,70041,69784820.0,14192743.0,55592077.0,0.7869,0.7922,0.8065,0.7937
2023-11-02 17:30,410,139,271,46443,8789,37654,36767881.0,6925825.0,29842055.0,378,132,246,45095,8514,36581,35739922.0,6708079.0,29031842.0,0.788,0.7925,0.7879,0.7936
2023-11-02 17:35,917,371,546,78138,27645,50493,61806389.0,21880166.0,39926222.0,832,333,499,73279,24645,48634,57907636.0,19400576.0,38507060.0,0.7915,0.7907,0.7872,0.7918
2023-11-02 17:40,5012,1425,3587,570492,119999,450493,446573801.0,93522887.0,353050913.0,4608,1175,3433,536690,100486,436204,420705058.0,78208443.0,342496615.0,0.7794,0.7837,0.7783,0.7852
2023-11-02 17:45,1843,919,924,150346,55692,94654,118718643.0,44176211.0,74542432.0,1684,823,861,138178,46970,91208,108954383.0,36977503.0,71976880.0,0.7932,0.7875,0.7873,0.7892
2023-11-02 17:50,1088,475,613,102010,43582,58428,80420748.0,34261263.0,46159485.0,994,412,582,95447,40789,54658,75007947.0,31836698.0,43171249.0,0.7861,0.79,0.7805,0.7898
2023-11-02 17:55,1121,430,691,104406,30813,73593,81588155.0,24187399.0,57400756.0,1022,382,640,96768,31081,65687,76072578.0,24317811.0,51754767.0,0.785,0.78,0.7824,0.7879
2023-11-02 18:00,667,185,482,70877,15686,55191,55968844.0,12292258.0,43676586.0,606,146,460,66546,13309,53237,52368092.0,10379226.0,41988866.0,0.7836,0.7914,0.7799,0.7887
2023-11-02 18:05,407,158,249,36692,10212,26480,28849164.0,7978637.0,20870527.0,350,132,218,32800,8362,24438,25844755.0,6521781.0,19322974.0,0.7813,0.7882,0.7799,0.7907
2023-11-02 18:10,464,134,330,33628,7583,26045,26381874.0,5948004.0,20433869.0,425,121,304,30737,6094,24643,24162174.0,4768784.0,19393389.0,0.7844,0.7846,0.7825,0.787
2023-11-02 18:15,206,88,118,15553,5205,10348,12198851.0,4087210.0,8111641.0,164,68,96,10427,3206,7221,8205105.0,2505018.0,5700087.0,0.7852,0.7839,0.7814,0.7894
2023-11-02 18:20,987,200,787,111620,8190,103430,87634890.0,6419126.0,81215763.0,958,187,771,111561,8149,103412,87723844.0,6382060.0,81341783.0,0.7838,0.7852,0.7832,0.7866
2023-11-02 18:25,1742,167,1575,213627,10126,203501,166934710.0,7963496.0,158971213.0,1685,119,1566,207471,5778,201693,163414286.0,4514954.0,158899332.0,0.7864,0.7812,0.7814,0.7878
2023-11-02 18:30,3750,682,3068,496839,39306,457533,387931730.0,30586202.0,357345528.0,3575,585,2990,483695,32431,451264,377936153.0,25218006.0,352718146.0,0.7782,0.781,0.7776,0.7816
2023-11-02 18:35,1265,479,786,101560,34537,67023,79306727.0,26962114.0,52344613.0,1188,438,750,103366,34015,69351,80759570.0,26445969.0,54313601.0,0.7807,0.781,0.7775,0.7832
2023-11-03 10:00,5046,1594,3452,554955,112446,442509,434614225.0,86759375.0,347854850.0,4566,1327,3239,526691,95081,431610,413400848.0,74217674.0,339183174.0,0.7716,0.7861,0.7806,0.7859
2023-11-03 10:05,898,377,521,76715,21375,55340,59960385.0,16539951.0,43420434.0,743,285,458,66788,14712,52076,52377113.0,11451355.0,40925758.0,0.7738,0.7846,0.7784,0.7859
2023-11-03 10:10,603,245,358,40234,7680,32554,31497179.0,5983659.0,25513520.0,503,182,321,36947,5966,30981,28949450.0,4632993.0,24316456.0,0.7791,0.7837,0.7766,0.7849
2023-11-03 10:15,1422,749,673,84791,30248,54543,66472214.0,23561824.0,42910389.0,1234,651,583,81379,31262,50117,63689954.0,24334509.0,39355444.0,0.779,0.7867,0.7784,0.7853
2023-11-03 10:20,1178,593,585,86021,29928,56093,67393016.0,23360786.0,44032230.0,1130,569,561,84547,29239,55308,66223546.0,22818362.0,43405184.0,0.7806,0.785,0.7804,0.7848
2023-11-03 10:25,490,300,190,35445,17049,18396,27781596.0,13332755.0,14448840.0,431,259,172,33554,15449,18105,26290689.0,12059063.0,14231625.0,0.782,0.7854,0.7806,0.7861
2023-11-03 10:30,1157,592,565,90385,34797,55588,71224628.0,27452564.0,43772064.0,1066,536,530,81519,32129,49390,64025509.0,25163882.0,38861627.0,0.7889,0.7874,0.7832,0.7868
2023-11-03 10:35,657,468,189,44684,29189,15495,35090418.0,22891161.0,12199257.0,607,440,167,42222,27678,14544,33136898.0,21685289.0,11451609.0,0.7842,0.7873,0.7835,0.7874
2023-11-03 10:40,1621,1191,430,178040,112356,65684,139832393.0,88135045.0,51697347.0,1572,1177,395,172222,110207,62015,135404755.0,86443894.0,48960861.0,0.7844,0.7871,0.7844,0.7895
2023-11-03 10:45,2308,1202,1106,287264,143534,143730,225763838.0,112534928.0,113228910.0,2277,1190,1087,287038,143460,143578,225598106.0,112470875.0,113127231.0,0.784,0.7878,0.784,0.7879
2023-11-03 10:50,2524,1293,1231,279302,142984,136318,219238987.0,111999789.0,107239198.0,2482,1270,1212,280064,142458,137606,219910489.0,111582390.0,108328099.0,0.7833,0.7867,0.7833,0.7872
2023-11-03 10:55,3133,762,2371,409213,56146,353067,320955100.0,43891709.0,277063391.0,3082,736,2346,404254,56483,347771,317275789.0,44156446.0,273119343.0,0.7817,0.7847,0.7818,0.7853
2023-11-03 11:00,4291,826,3465,562271,48240,514031,441043319.0,37701138.0,403342180.0,4266,818,3448,562514,48906,513608,441220500.0,38207524.0,403012976.0,0.7815,0.7847,0.7812,0.7847
2023-11-03 11:05,4854,886,3968,686781,59574,627207,537928807.0,46504324.0,491424483.0,4784,834,3950,683442,57987,625455,535547465.0,45264635.0,490282830.0,0.7806,0.7835,0.7806,0.7839
2023-11-03 11:10,4883,1144,3739,621529,63965,557564,486693425.0,49825133.0,436868292.0,4823,1109,3714,617092,61932,555160,483248396.0,48267860.0,434980536.0,0.7789,0.7835,0.7794,0.7835
2023-11-03 11:15,3606,328,3278,468229,14566,453663,366418181.0,11336959.0,355081221.0,3586,313,3273,467123,14544,452579,365634657.0,11330198.0,354304458.0,0.7783,0.7827,0.779,0.7829
2023-11-03 11:20,1724,475,1249,178039,15191,162848,138778672.0,11732541.0,127046131.0,1535,358,1177,167992,8816,159176,131133444.0,6805350.0,124328094.0,0.7723,0.7802,0.7719,0.7811
2023-11-03 11:25,3820,1676,2144,338020,128429,209591,263561451.0,100154550.0,163406900.0,3661,1599,2062,325544,119970,205574,253174929.0,92874531.0,160300397.0,0.7798,0.7796,0.7741,0.7798
2023-11-03 11:30,2660,1523,1137,221144,120552,100592,171353459.0,93158867.0,78194592.0,2588,1478,1110,221557,121699,99858,171719003.0,94053195.0,77665808.0,0.7728,0.7773,0.7728,0.7778
2023-11-03 11:35,3478,1412,2066,313713,130334,183379,239764843.0,99871785.0,139893058.0,2966,1116,1850,273714,112818,160896,210329563.0,86077374.0,124252189.0,0.7663,0.7629,0.763,0.7723
2023-11-03 11:40,1665,788,877,124624,45257,79367,96059982.0,34936163.0,61123819.0,1443,638,805,109938,34145,75793,84713979.0,26193045.0,58520933.0,0.772,0.7701,0.7671,0.7721
2023-11-03 11:45,1098,411,687,63169,24388,38781,48696367.0,18807378.0,29888989.0,1024,381,643,61196,25325,35871,47150963.0,19410730.0,27740233.0,0.7712,0.7707,0.7665,0.7733
2023-11-03 11:50,552,255,297,38373,16434,21939,29627372.0,12671987.0,16955385.0,456,189,267,33176,11257,21919,25693355.0,8658307.0,17035047.0,0.7711,0.7728,0.7691,0.7772
2023-11-03 11:55,586,273,313,29893,9335,20558,23055528.0,7182682.0,15872846.0,546,248,298,35120,14789,20331,27036640.0,11302387.0,15734252.0,0.7694,0.7721,0.7642,0.7739
2023-11-03 12:00,336,158,178,19865,6684,13181,15417734.0,5186530.0,10231204.0,280,123,157,20766,7001,13765,16112548.0,5374696.0,10737852.0,0.776,0.7762,0.7677,0.7801
2023-11-03 12:05,542,448,94,15850,9234,6616,12277704.0,7199485.0,5078218.0,507,424,83,14095,8547,5548,10873608.0,6570921.0,4302687.0,0.7797,0.7676,0.7688,0.7755
2023-11-03 12:10,584,234,350,32916,8461,24455,25360719.0,6515657.0,18845062.0,561,227,334,30227,7469,22758,23442305.0,5743272.0,17699033.0,0.7701,0.7706,0.7689,0.7777
2023-11-03 12:15,651,269,382,40449,7214,33235,31118608.0,5551151.0,25567457.0,591,239,352,38173,7220,30953,29467574.0,5540412.0,23927162.0,0.7695,0.7693,0.7674,0.773
2023-11-03 12:20,545,243,302,47320,13787,33533,36328006.0,10403012.0,25924993.0,506,215,291,42228,8206,34022,32605999.0,6284955.0,26321044.0,0.7546,0.7731,0.7659,0.7736
2023-11-03 12:25,453,181,272,34038,7807,26231,26303976.0,6007349.0,20296626.0,430,164,266,32298,7308,24990,24964183.0,5601854.0,19362329.0,0.7695,0.7738,0.7665,0.7748
2023-11-03 12:30,479,169,310,35048,7150,27898,27182735.0,5505124.0,21677611.0,439,134,305,31317,4563,26754,24234120.0,3504436.0,20729683.0,0.7699,0.777,0.768,0.7748
2023-11-03 12:35,891,658,233,32297,12562,19735,24906507.0,9669079.0,15237427.0,839,613,226,31638,12411,19227,24465334.0,9539198.0,14926136.0,0.7697,0.7721,0.7686,0.7763
2023-11-03 12:40,243,136,107,24482,8983,15499,19074383.0,6970444.0,12103938.0,211,121,90,17474,6532,10942,13507995.0,5017528.0,8490466.0,0.776,0.7809,0.7681,0.776
2023-11-03 12:45,562,142,420,32191,4451,27740,24885187.0,3431292.0,21453895.0,503,98,405,30382,3234,27148,23499400.0,2486929.0,21012470.0,0.7709,0.7734,0.769,0.774
2023-11-03 12:50,186,83,103,7869,2260,5609,6071756.0,1737572.0,4334184.0,146,50,96,6633,1234,5399,5121930.0,948750.0,4173180.0,0.7688,0.7727,0.7688,0.773
2023-11-03 12:55,757,197,560,49398,7306,42092,38208018.0,5653392.0,32554626.0,706,158,548,47733,6602,41131,36930186.0,5083850.0,31846336.0,0.7738,0.7734,0.77,0.7743
2023-11-03 13:00,527,369,158,28847,14174,14673,22303314.0,10949019.0,11354294.0,498,347,151,27673,13434,14239,21376085.0,10360077.0,11016008.0,0.7725,0.7738,0.7712,0.7737
2023-11-03 13:05,459,301,158,30833,12304,18529,23989165.0,9622182.0,14366983.0,413,275,138,30387,13012,17375,23281806.0,9813980.0,13467825.0,0.782,0.7754,0.7542,0.7751
2023-11-03 13:10,524,339,185,31003,11338,19665,23976687.0,8748603.0,15228083.0,520,341,179,30743,10799,19944,23779371.0,8329719.0,15449651.0,0.7716,0.7744,0.7713,0.7747
2023-11-03 13:15,585,226,359,43544,14080,29464,33681252.0,10853098.0,22828154.0,593,244,349,41506,13173,28333,32111170.0,10160346.0,21950823.0,0.7708,0.7748,0.7713,0.7747
2023-11-03 13:20,844,419,425,87152,17381,69771,67288385.0,13373543.0,53914842.0,807,401,406,83303,15309,67994,64411730.0,11791397.0,52620332.0,0.7694,0.7727,0.7702,0.7739
2023-11-03 13:25,525,278,247,36931,14988,21943,28639122.0,11649573.0,16989549.0,502,259,243,34613,11634,22979,26772519.0,8961604.0,17810914.0,0.7773,0.7743,0.7703,0.7751
2023-11-03 13:30,892,392,500,61508,14482,47026,47537181.0,11165743.0,36371438.0,878,385,493,60065,13954,46111,46483649.0,10759508.0,35724140.0,0.771,0.7734,0.7711,0.7747
2023-11-03 13:35,206,43,163,23288,1230,22058,18065530.0,945633.0,17119896.0,194,37,157,24200,2397,21803,18764165.0,1833759.0,16930405.0,0.7688,0.7761,0.765,0.7765
2023-11-03 13:40,339,97,242,29912,2411,27501,23120110.0,1859633.0,21260476.0,303,78,225,30227,2260,27967,23366304.0,1739028.0,21627275.0,0.7713,0.7731,0.7695,0.7733
2023-11-03 13:45,333,103,230,26739,2525,24214,20759637.0,1946029.0,18813608.0,304,87,217,26014,2517,23497,20170315.0,1939794.0,18230521.0,0.7707,0.777,0.7707,0.7759
2023-11-03 13:50,393,47,346,30904,1494,29410,23962878.0,1165677.0,22797201.0,379,44,335,30115,1091,29024,23337489.0,840383.0,22497106.0,0.7802,0.7752,0.7703,0.7751
2023-11-03 13:55,1225,112,1113,133547,5140,128407,103369557.0,3991498.0,99378059.0,1212,107,1105,132992,4693,128299,102921278.0,3612738.0,99308539.0,0.7766,0.7739,0.7698,0.774
2023-11-03 14:00,2495,1116,1379,285702,118046,167656,224968191.0,92516980.0,132451211.0,2105,941,1164,235231,92756,142475,185050178.0,72533596.0,112516582.0,0.7837,0.79,0.782,0.7897
2023-11-03 14:05,1213,707,506,120243,58815,61428,93931233.0,45503673.0,48427560.0,957,557,400,100447,46679,53768,78781971.0,36161262.0,42620708.0,0.7737,0.7884,0.7747,0.7927
2023-11-03 14:10,1003,579,424,73111,42091,31020,57296153.0,33218793.0,24077359.0,950,554,396,74007,44303,29704,57264987.0,34154692.0,23110294.0,0.7892,0.7762,0.7709,0.778
2023-11-03 14:15,988,492,496,65785,30608,35177,51137081.0,23730529.0,27406552.0,944,464,480,67503,30572,36931,52494730.0,23677657.0,28817073.0,0.7753,0.7791,0.7745,0.7803
2023-11-03 14:20,831,260,571,54804,16126,38678,45966969.0,12532554.0,33434415.0,817,247,570,53802,15481,38321,41854047.0,11998599.0,29855448.0,0.7772,0.8644,0.7751,0.7791
2023-11-03 14:25,2731,1442,1289,345878,191604,154274,268443579.0,148281321.0,120162258.0,2719,1429,1290,347212,192324,154888,269453507.0,148805780.0,120647726.0,0.7739,0.7789,0.7737,0.7789
2023-11-03 14:30,2833,1375,1458,343972,178463,165509,267078775.0,138233653.0,128845122.0,2775,1351,1424,340607,177398,163209,264422773.0,137361240.0,127061532.0,0.7746,0.7785,0.7743,0.7785
2023-11-03 14:35,2439,864,1575,256692,71254,185438,199304335.0,55076524.0,144227810.0,2408,839,1569,256714,71641,185073,199339380.0,55375191.0,143964188.0,0.773,0.7778,0.773,0.7779
2023-11-03 14:40,1052,659,393,68119,29427,38692,52821065.0,22785195.0,30035870.0,1029,645,384,68338,29772,38566,53005527.0,23033043.0,29972484.0,0.7743,0.7763,0.7736,0.7772
2023-11-03 14:45,1024,646,378,81799,51794,30005,63549412.0,40152828.0,23396584.0,999,635,364,80879,50948,29931,62818085.0,39478967.0,23339118.0,0.7752,0.7798,0.7749,0.7798
2023-11-03 14:50,1350,728,622,97557,56648,40909,75850402.0,43925461.0,31924940.0,1316,716,600,95698,55711,39987,74399267.0,43193479.0,31205788.0,0.7754,0.7804,0.7753,0.7804
2023-11-03 14:55,352,80,272,11446,3926,7520,8857132.0,3045490.0,5811642.0,338,75,263,13128,6203,6925,10149071.0,4757159.0,5391912.0,0.7757,0.7728,0.7669,0.7786
2023-11-03 15:00,1324,596,728,120451,35232,85219,94408854.0,27410501.0,66998353.0,1278,565,713,111409,33290,78119,86798043.0,25834008.0,60964034.0,0.778,0.7862,0.776,0.7804
2023-11-03 15:05,610,159,451,37369,6068,31301,29106746.0,4714163.0,24392582.0,571,134,437,36310,5720,30590,28337023.0,4438636.0,23898386.0,0.7769,0.7793,0.776,0.7812
2023-11-03 15:10,363,151,212,32592,11298,21294,25362427.0,8767460.0,16594967.0,343,144,199,31389,11014,20375,24424314.0,8543869.0,15880444.0,0.776,0.7793,0.7757,0.7794
2023-11-03 15:15,585,333,252,37790,11278,26512,29463528.0,8764128.0,20699400.0,571,324,247,37258,11000,26258,29016764.0,8533407.0,20483357.0,0.7771,0.7808,0.7758,0.7801
2023-11-03 15:20,560,240,320,43618,11280,32338,34029929.0,8767586.0,25262342.0,545,230,315,43965,11200,32765,34289265.0,8693160.0,25596105.0,0.7773,0.7812,0.7762,0.7812
2023-11-03 15:25,778,229,549,37768,17878,19890,30083122.0,13879597.0,16203524.0,755,213,542,36968,17675,19293,29461572.0,13721522.0,15740049.0,0.7764,0.8147,0.7763,0.8158
2023-11-03 15:30,570,257,313,45427,18867,26560,35338407.0,14649204.0,20689202.0,548,249,299,45150,19728,25422,34918297.0,15102301.0,19815996.0,0.7764,0.779,0.7655,0.7795
2023-11-03 15:35,408,213,195,28762,13607,15155,22383657.0,10584016.0,11799640.0,396,207,189,28874,13420,15454,22470489.0,10422199.0,12048289.0,0.7778,0.7786,0.7766,0.7796
2023-11-03 15:40,140,81,59,3877,1700,2177,3017250.0,1319028.0,1698221.0,130,74,56,3774,1612,2162,2936968.0,1249399.0,1687568.0,0.7759,0.7801,0.7751,0.7806
2023-11-03 15:45,469,248,221,40279,19348,20931,31259784.0,15007976.0,16251808.0,448,235,213,41731,18668,23063,32500965.0,14479336.0,18021629.0,0.7757,0.7764,0.7756,0.7814
2023-11-03 15:50,1152,477,675,126592,39458,87134,97669924.0,30497158.0,67172765.0,1089,429,660,118469,36200,82269,91850669.0,27985202.0,63865466.0,0.7729,0.7709,0.7731,0.7763
2023-11-03 15:55,2891,1100,1791,281221,85790,195431,218291803.0,66396979.0,151894823.0,2839,1081,1758,280338,85653,194685,217600670.0,66274155.0,151326515.0,0.7739,0.7772,0.7738,0.7773
2023-11-03 16:00,1044,362,682,68331,27867,40464,53046516.0,21593258.0,31453257.0,1011,355,656,67572,27593,39979,52455550.0,21375525.0,31080025.0,0.7749,0.7773,0.7747,0.7774
2023-11-03 16:05,976,403,573,68871,32856,36015,53285068.0,25429628.0,27855439.0,935,385,550,65571,31516,34055,50877258.0,24389995.0,26487262.0,0.774,0.7734,0.7739,0.7778
2023-11-03 16:10,505,290,215,30029,15692,14337,23301003.0,12157324.0,11143679.0,486,270,216,29845,15074,14771,23167332.0,11670198.0,11497134.0,0.7747,0.7773,0.7742,0.7784
2023-11-03 16:15,692,345,347,37668,21155,16513,29120380.0,16368145.0,12752235.0,679,336,343,37473,21440,16033,29019143.0,16567761.0,12451381.0,0.7737,0.7723,0.7728,0.7766
2023-11-03 16:20,192,49,143,12736,2095,10641,9900830.0,1630023.0,8270806.0,182,44,138,9415,1915,7500,7304071.0,1482423.0,5821647.0,0.7781,0.7773,0.7741,0.7762
2023-11-03 16:25,260,124,136,14972,8117,6855,11594283.0,6276049.0,5318234.0,251,120,131,14549,8095,6454,11271665.0,6259381.0,5012283.0,0.7732,0.7758,0.7732,0.7766
2023-11-03 16:30,375,153,222,23878,10837,13041,18490366.0,8390570.0,10099795.0,353,141,212,22932,10624,12308,17752598.0,8203371.0,9549227.0,0.7743,0.7745,0.7722,0.7759
2023-11-03 16:35,720,459,261,58859,35554,23305,45599033.0,27489762.0,18109271.0,699,441,258,58086,34656,23430,45000195.0,26789066.0,18211128.0,0.7732,0.7771,0.773,0.7773
2023-11-03 16:40,527,253,274,30972,13895,17077,23970791.0,10738325.0,13232466.0,509,238,271,30681,13913,16768,23747343.0,10747974.0,12999368.0,0.7728,0.7749,0.7725,0.7752
2023-11-03 16:45,188,102,86,8642,3854,4788,6702819.0,2979907.0,3722912.0,171,93,78,8721,4051,4670,6758187.0,3128616.0,3629571.0,0.7732,0.7776,0.7723,0.7772
2023-11-03 16:50,580,203,377,40421,14798,25623,31157520.0,11423970.0,19733550.0,551,188,363,36665,14011,22654,28354248.0,10812937.0,17541311.0,0.772,0.7701,0.7717,0.7743
2023-11-03 16:55,437,174,263,27466,10276,17190,21253150.0,7958945.0,13294205.0,398,154,244,28026,9483,18543,21679692.0,7316360.0,14363332.0,0.7745,0.7734,0.7715,0.7746
2023-11-03 17:00,1084,569,515,67497,22768,44729,51957156.0,17577862.0,34379293.0,1000,512,488,61457,20162,41295,47546255.0,15554062.0,31992193.0,0.772,0.7686,0.7715,0.7747
2023-11-03 17:05,947,420,527,92130,38954,53176,71187176.0,30029645.0,41157531.0,917,404,513,91332,39157,52175,70595672.0,30178828.0,40416844.0,0.7709,0.774,0.7707,0.7746
2023-11-03 17:10,1089,642,447,79382,27672,51710,61431685.0,21364225.0,40067459.0,1047,626,421,77476,26248,51228,60023871.0,20260939.0,39762932.0,0.7721,0.7748,0.7719,0.7762
2023-11-03 17:15,543,410,133,30283,14255,16028,23474138.0,11029047.0,12445091.0,528,401,127,28964,13195,15769,22433930.0,10189211.0,12244719.0,0.7737,0.7765,0.7722,0.7765
2023-11-03 17:20,491,356,135,27494,11546,15948,21298938.0,8923181.0,12375757.0,464,348,116,27698,11540,16158,21458352.0,8918573.0,12539779.0,0.7728,0.776,0.7728,0.7761
2023-11-03 17:25,498,404,94,23038,11010,12028,17861139.0,8516122.0,9345017.0,478,393,85,22561,11130,11431,17490049.0,8601476.0,8888572.0,0.7735,0.7769,0.7728,0.7776
2023-11-03 17:30,363,199,164,35488,12188,23300,27540015.0,9444856.0,18095159.0,347,191,156,34816,11718,23098,26979498.0,9042354.0,17937143.0,0.7749,0.7766,0.7717,0.7766
2023-11-03 17:35,942,459,483,99989,34920,65069,77453819.0,26981416.0,50472403.0,927,452,475,99705,34983,64722,77242494.0,27028056.0,50214438.0,0.7727,0.7757,0.7726,0.7758
2023-11-03 17:40,283,179,104,23840,13834,10006,18441865.0,10683599.0,7758266.0,278,175,103,22691,13344,9347,17552653.0,10303736.0,7248916.0,0.7723,0.7754,0.7722,0.7755
2023-11-03 17:45,1368,635,733,131097,42451,88646,101362599.0,32766090.0,68596508.0,1356,630,726,130756,42058,88698,101151342.0,32462118.0,68689224.0,0.7719,0.7738,0.7718,0.7744
2023-11-03 17:50,364,104,260,35113,3970,31143,27231470.0,3094242.0,24137227.0,332,87,245,34306,3631,30675,26576871.0,2800840.0,23776031.0,0.7794,0.775,0.7714,0.7751
2023-11-03 17:55,553,237,316,37824,6559,31265,29305976.0,5069389.0,24236587.0,536,230,306,37129,6399,30730,28767418.0,4941377.0,23826041.0,0.7729,0.7752,0.7722,0.7753
2023-11-03 18:00,170,110,60,14059,2892,11167,10897145.0,2242432.0,8654713.0,161,105,56,13689,3489,10200,10603030.0,2677798.0,7925232.0,0.7754,0.775,0.7675,0.777
2023-11-03 18:05,768,520,248,32924,19290,13634,25592798.0,14872381.0,10720416.0,751,512,239,30538,18220,12318,23599260.0,14054916.0,9544344.0,0.771,0.7863,0.7714,0.7748
2023-11-03 18:10,237,143,94,11014,5387,5627,8509275.0,4161325.0,4347949.0,210,119,91,10109,4710,5399,7809631.0,3631138.0,4178493.0,0.7725,0.7727,0.7709,0.7739
2023-11-03 18:15,287,192,95,19896,13898,5998,15345628.0,10716256.0,4629371.0,274,182,92,19981,13389,6592,15416963.0,10319630.0,5097333.0,0.7711,0.7718,0.7708,0.7733
2023-11-03 18:20,180,94,86,16466,7144,9322,12711612.0,5503642.0,7207969.0,190,99,91,17168,8536,8632,13248280.0,6567677.0,6680602.0,0.7704,0.7732,0.7694,0.7739
2023-11-03 18:25,379,110,269,19967,6885,13082,15428194.0,5348376.0,10079817.0,331,78,253,14837,5379,9458,11453606.0,4137854.0,7315751.0,0.7768,0.7705,0.7693,0.7735
2023-11-03 18:30,315,154,161,15879,6520,9359,12237624.0,5011641.0,7225983.0,293,142,151,14990,6407,8583,11481198.0,4841872.0,6639325.0,0.7687,0.7721,0.7557,0.7735
2023-11-03 18:35,952,242,710,96653,9575,87078,74647058.0,7377084.0,67269973.0,922,228,694,97497,8952,88545,75319391.0,6875701.0,68443690.0,0.7705,0.7725,0.7681,0.773
2023-11-06 10:00,3320,1376,1944,263607,94635,168972,204670506.0,72604954.0,132065552.0,2942,1185,1757,238927,79066,159861,184733878.0,60866901.0,123866977.0,0.7672,0.7816,0.7698,0.7748
2023-11-06 10:05,2986,1338,1648,317156,98227,218929,243332261.0,75157515.0,168174745.0,2778,1198,1580,300783,87812,212971,231459655.0,67262619.0,164197035.0,0.7651,0.7682,0.766,0.771
2023-11-06 10:10,1294,671,623,151200,40198,111002,118357343.0,31702521.0,86654822.0,1206,622,584,150530,40965,109565,117529817.0,32129762.0,85400054.0,0.7887,0.7807,0.7843,0.7794
2023-11-06 10:15,1530,950,580,125920,61429,64491,98217339.0,47212431.0,51004907.0,1381,873,508,123050,60384,62666,95633812.0,46417092.0,49216720.0,0.7686,0.7909,0.7687,0.7854
2023-11-06 10:20,652,233,419,56370,6886,49484,44410495.0,5300073.0,39110421.0,620,216,404,55041,6087,48954,43436476.0,4684214.0,38752262.0,0.7697,0.7904,0.7695,0.7916
2023-11-06 10:25,1405,745,660,119334,58217,61117,92310765.0,45259492.0,47051273.0,1298,696,602,113018,54417,58601,86809159.0,41672206.0,45136953.0,0.7774,0.7699,0.7658,0.7702
2023-11-06 10:30,1490,917,573,124233,70220,54013,95341523.0,53818405.0,41523118.0,1317,874,443,119736,66915,52821,92568860.0,51935511.0,40633348.0,0.7664,0.7688,0.7761,0.7693
2023-11-06 10:35,2479,1682,797,273508,184083,89425,210191860.0,141245587.0,68946272.0,2436,1661,775,275009,186493,88516,211333634.0,143064435.0,68269199.0,0.7673,0.771,0.7671,0.7713
2023-11-06 10:40,4003,2949,1054,495210,363397,131813,380138774.0,278596216.0,101542557.0,3957,2921,1036,492106,361216,130890,377849146.0,276980625.0,100868521.0,0.7666,0.7704,0.7668,0.7706
2023-11-06 10:45,2101,1397,704,199572,146067,53505,153451682.0,112103692.0,41347989.0,2074,1376,698,200326,145590,54736,154024475.0,111713664.0,42310811.0,0.7675,0.7728,0.7673,0.773
2023-11-06 10:50,2285,1772,513,235870,187475,48395,181239230.0,143881625.0,37357605.0,2252,1759,493,233966,187834,46132,179748632.0,144136475.0,35612156.0,0.7675,0.7719,0.7674,0.772
2023-11-06 10:55,932,739,193,83012,72962,10050,63814149.0,56012289.0,7801860.0,908,726,182,81148,72549,8599,62333870.0,55695312.0,6638558.0,0.7677,0.7763,0.7677,0.772
2023-11-06 11:00,1705,1178,527,150273,104052,46221,115411325.0,79815633.0,35595692.0,1671,1158,513,147508,104187,43321,113266550.0,79923420.0,33343130.0,0.7671,0.7701,0.7671,0.7697
2023-11-06 11:05,1557,755,802,155069,58007,97062,119565409.0,45059629.0,74505779.0,1466,686,780,148313,53150,95163,113826780.0,40665616.0,73161164.0,0.7768,0.7676,0.7651,0.7688
2023-11-06 11:10,105,51,54,6811,1174,5637,5245934.0,890347.0,4355586.0,84,34,50,6969,1204,5765,5351820.0,901067.0,4450753.0,0.7584,0.7727,0.7484,0.772
2023-11-06 11:15,114,29,85,17919,1080,16839,13785509.0,832705.0,12952804.0,105,26,79,16635,368,16267,12828237.0,281937.0,12546300.0,0.771,0.7692,0.7661,0.7713
2023-11-06 11:20,2661,742,1919,384075,58813,325262,296861148.0,45211733.0,251649414.0,2614,714,1900,381152,57651,323501,294599985.0,44307888.0,250292097.0,0.7687,0.7737,0.7686,0.7737
2023-11-06 11:25,3391,922,2469,435385,68466,366919,336764434.0,52781748.0,283982686.0,3372,911,2461,434707,68914,365793,336143505.0,53024014.0,283119491.0,0.7709,0.774,0.7694,0.774
2023-11-06 11:30,1122,580,542,120973,54979,65994,93412014.0,42411531.0,51000483.0,1082,562,520,120288,54425,65863,92829451.0,41916358.0,50913092.0,0.7714,0.7728,0.7702,0.773
2023-11-06 11:35,1231,632,599,108531,59608,48923,83748950.0,45890517.0,37858432.0,1217,631,586,108148,59816,48332,83391063.0,46046012.0,37345051.0,0.7699,0.7738,0.7698,0.7727
2023-11-06 11:40,1600,913,687,188400,115483,72917,145482042.0,89088569.0,56393473.0,1539,872,667,187046,114103,72943,144235106.0,87823991.0,56411115.0,0.7714,0.7734,0.7697,0.7734
2023-11-06 11:45,1705,920,785,207428,109829,97599,160413965.0,84781768.0,75632197.0,1666,894,772,204182,108958,95224,157749835.0,83998365.0,73751470.0,0.7719,0.7749,0.7709,0.7745
2023-11-06 11:50,1108,309,799,136392,38507,97885,105386160.0,29681829.0,75704331.0,1057,286,771,134671,37817,96854,104114478.0,29159700.0,74954778.0,0.7708,0.7734,0.7711,0.7739
2023-11-06 11:55,698,265,433,80185,23284,56901,61964374.0,17954414.0,44009959.0,683,257,426,80052,23196,56856,61859523.0,17883237.0,43976285.0,0.7711,0.7734,0.771,0.7735
2023-11-06 12:00,3303,1620,1683,325670,188081,137589,251222290.0,144839686.0,106382604.0,3281,1602,1679,324993,187482,137511,250702723.0,144375783.0,106326940.0,0.7701,0.7732,0.7701,0.7732
2023-11-06 12:05,1077,586,491,103813,58849,44964,80093906.0,45366747.0,34727159.0,1059,579,480,102907,58721,44186,79439842.0,45258127.0,34181714.0,0.7709,0.7723,0.7707,0.7736
2023-11-06 12:10,3039,1517,1522,305240,187072,118168,235240621.0,143906533.0,91334088.0,3010,1512,1498,304437,186841,117596,234635105.0,143722595.0,90912510.0,0.7693,0.7729,0.7692,0.7731
2023-11-06 12:15,1643,565,1078,153658,67775,85883,118407650.0,52103158.0,66304492.0,1618,553,1065,152187,67250,84937,117304164.0,51700090.0,65604074.0,0.7688,0.772,0.7688,0.7724
2023-11-06 12:20,1685,866,819,201163,103013,98150,154754434.0,79110936.0,75643498.0,1630,831,799,198124,102023,96101,152481532.0,78326516.0,74155016.0,0.768,0.7707,0.7677,0.7716
2023-11-06 12:25,134,82,52,17005,11015,5990,13042289.0,8434648.0,4607640.0,110,62,48,15759,10041,5718,12097176.0,7694628.0,4402548.0,0.7657,0.7692,0.7663,0.7699
2023-11-06 12:30,324,163,161,59998,35532,24466,46129429.0,27254305.0,18875123.0,312,158,154,59102,34764,24338,45437796.0,26660359.0,18777437.0,0.767,0.7715,0.7669,0.7715
2023-11-06 12:35,517,135,382,38330,9421,28909,29524433.0,7236912.0,22287520.0,470,105,365,37105,8446,28659,28581117.0,6480627.0,22100490.0,0.7682,0.771,0.7673,0.7712
2023-11-06 12:40,2295,998,1297,282042,123936,158106,217068778.0,95180738.0,121888040.0,2277,989,1288,279670,122723,156947,215259243.0,94270227.0,120989015.0,0.768,0.7709,0.7682,0.7709
2023-11-06 12:45,778,476,302,83365,52177,31188,64097622.0,40053127.0,24044495.0,744,454,290,81572,51300,30272,62736930.0,39377301.0,23359629.0,0.7676,0.771,0.7676,0.7717
2023-11-06 12:50,1851,744,1107,188301,67206,121095,145005332.0,51633524.0,93371808.0,1826,728,1098,186829,66388,120441,143903134.0,51003239.0,92899895.0,0.7683,0.7711,0.7683,0.7713
2023-11-06 12:55,980,324,656,120956,24320,96636,93141388.0,18682169.0,74459219.0,969,318,651,120915,24381,96534,93104496.0,18729383.0,74375113.0,0.7682,0.7705,0.7682,0.7705
2023-11-06 13:00,1742,544,1198,243939,62199,181740,187948051.0,47805227.0,140142824.0,1722,534,1188,242166,61491,180675,186599364.0,47258106.0,139341257.0,0.7686,0.7711,0.7685,0.7712
2023-11-06 13:05,1400,444,956,159105,35225,123880,122573947.0,27070913.0,95503034.0,1362,436,926,158076,35011,123065,121817336.0,26906647.0,94910688.0,0.7685,0.7709,0.7685,0.7712
2023-11-06 13:10,670,269,401,78609,26166,52443,60560841.0,20109829.0,40451012.0,620,250,370,77507,25274,52233,59753113.0,19404023.0,40349090.0,0.7685,0.7713,0.7677,0.7725
2023-11-06 13:15,536,221,315,72168,34805,37363,55586697.0,26761995.0,28824701.0,522,211,311,71380,34408,36972,54961156.0,26440954.0,28520201.0,0.7689,0.7715,0.7685,0.7714
2023-11-06 13:20,1062,580,482,155835,96282,59553,119993750.0,74001008.0,45992741.0,1041,568,473,152194,95578,56616,117138176.0,73444107.0,43694069.0,0.7686,0.7723,0.7684,0.7718
2023-11-06 13:25,788,419,369,83179,45938,37241,64024520.0,35285575.0,28738945.0,770,409,361,82780,45815,36965,63699132.0,35173479.0,28525652.0,0.7681,0.7717,0.7677,0.7717
2023-11-06 13:30,2816,1465,1351,360805,272396,88409,277445313.0,209234942.0,68210370.0,2799,1459,1340,361821,273620,88201,278136832.0,210085327.0,68051505.0,0.7681,0.7715,0.7678,0.7716
2023-11-06 13:35,2015,870,1145,235384,135406,99978,181192428.0,104093534.0,77098893.0,2001,862,1139,236294,135195,101099,181950184.0,103904221.0,78045962.0,0.7688,0.7712,0.7686,0.772
2023-11-06 13:40,1812,1032,780,212483,152865,59618,163551123.0,117521170.0,46029953.0,1794,1018,776,212321,152697,59624,163424844.0,117391464.0,46033379.0,0.7688,0.7721,0.7688,0.7721
2023-11-06 13:45,525,370,155,35615,19767,15848,27463477.0,15205157.0,12258320.0,517,365,152,35185,19540,15645,27118500.0,15030125.0,12088375.0,0.7692,0.7735,0.7692,0.7727
2023-11-06 13:50,1010,393,617,108492,50691,57801,83632062.0,38976384.0,44655677.0,1009,393,616,108723,50890,57833,83809067.0,39127750.0,44681316.0,0.7689,0.7726,0.7689,0.7726
2023-11-06 13:55,497,300,197,54629,37641,16988,42058383.0,28957311.0,13101071.0,492,299,193,53934,37453,16481,41545308.0,28812171.0,12733137.0,0.7693,0.7712,0.7693,0.7726
2023-11-06 14:00,1540,882,658,167025,104125,62900,128674799.0,80043305.0,48631494.0,1529,873,656,165360,103714,61646,127383347.0,79724964.0,47658383.0,0.7687,0.7732,0.7687,0.7731
2023-11-06 14:05,1115,632,483,138385,75243,63142,106753615.0,57957367.0,48796248.0,1093,624,469,137536,74677,62859,106048350.0,57466416.0,48581934.0,0.7703,0.7728,0.7695,0.7729
2023-11-06 14:10,1201,718,483,140444,69621,70823,108287911.0,53571865.0,54716045.0,1185,711,474,139978,69505,70473,107930730.0,53483778.0,54446951.0,0.7695,0.7726,0.7695,0.7726
2023-11-06 14:15,3485,1720,1765,419906,193736,226170,323535402.0,149009410.0,174525991.0,3445,1698,1747,417165,192652,224513,321522040.0,148121607.0,173400432.0,0.7691,0.7717,0.7689,0.7723
2023-11-06 14:20,2516,881,1635,337309,68538,268771,260100938.0,52711967.0,207388970.0,2498,867,1631,336518,68232,268286,259522673.0,52476634.0,207046038.0,0.7691,0.7716,0.7691,0.7717
2023-11-06 14:25,2983,990,1993,417737,52849,364888,322187222.0,40646308.0,281540913.0,2973,981,1992,418780,53228,365552,323021058.0,40935874.0,282085183.0,0.7691,0.7716,0.7691,0.7717
2023-11-06 14:30,735,284,451,95812,10517,85295,73957124.0,8110437.0,65846687.0,715,270,445,94860,9997,84863,73210816.0,7684459.0,65526357.0,0.7712,0.772,0.7687,0.7721
2023-11-06 14:35,952,269,683,161789,4394,157395,124884751.0,3376159.0,121508592.0,926,255,671,160285,4100,156185,123725009.0,3149121.0,120575888.0,0.7684,0.772,0.7681,0.772
2023-11-06 14:40,1093,270,823,170309,4975,165334,131442883.0,3815836.0,127627047.0,1076,259,817,169934,4413,165521,131197062.0,3389527.0,127807534.0,0.767,0.7719,0.7681,0.7722
2023-11-06 14:45,514,212,302,56391,5244,51147,43494262.0,4029756.0,39464505.0,499,203,296,55654,5133,50521,42922756.0,3944143.0,38978612.0,0.7685,0.7716,0.7684,0.7715
2023-11-06 14:50,1175,194,981,179388,9313,170075,138569389.0,7193382.0,131376007.0,1165,190,975,178460,8570,169890,137826269.0,6588208.0,131238061.0,0.7724,0.7725,0.7688,0.7725
2023-11-06 14:55,1010,254,756,147591,14822,132769,113794364.0,11391509.0,102402855.0,992,245,747,147090,14647,132443,113435853.0,11260211.0,102175642.0,0.7686,0.7713,0.7688,0.7715
2023-11-06 15:00,1029,294,735,113715,8356,105359,87690534.0,6418590.0,81271943.0,1005,283,722,113562,8065,105497,87595501.0,6194499.0,81401002.0,0.7681,0.7714,0.7681,0.7716
2023-11-06 15:05,414,108,306,55351,8119,47232,42643942.0,6200695.0,36443246.0,394,97,297,52494,5779,46715,40476089.0,4435754.0,36040334.0,0.7637,0.7716,0.7676,0.7715
2023-11-06 15:10,445,109,336,67048,4479,62569,51734652.0,3440205.0,48294446.0,426,93,333,66643,4274,62369,51424510.0,3284146.0,48140363.0,0.7681,0.7719,0.7684,0.7719
2023-11-06 15:15,1714,752,962,253348,67227,186121,195279864.0,51582061.0,143697802.0,1692,737,955,253020,67151,185869,195027761.0,51523111.0,143504650.0,0.7673,0.7721,0.7673,0.7721
2023-11-06 15:20,1335,344,991,222042,36096,185946,171284162.0,27697437.0,143586724.0,1328,342,986,222075,36288,185787,171304554.0,27838470.0,143466083.0,0.7673,0.7722,0.7672,0.7722
2023-11-06 15:25,1223,278,945,185576,23353,162223,143228289.0,17965903.0,125262385.0,1215,276,939,185040,23015,162025,142824956.0,17705303.0,125119653.0,0.7693,0.7722,0.7693,0.7722
2023-11-06 15:30,1853,414,1439,216724,25271,191453,167426292.0,19442535.0,147983757.0,1846,408,1438,216879,25136,191743,167543062.0,19337475.0,148205587.0,0.7694,0.773,0.7693,0.7729
2023-11-06 15:35,1566,522,1044,184263,35266,148997,142021832.0,27106985.0,114914846.0,1527,502,1025,181324,33955,147369,139773919.0,26091472.0,113682446.0,0.7686,0.7713,0.7684,0.7714
2023-11-06 15:40,762,412,350,83318,34636,48682,64192274.0,26665472.0,37526801.0,735,398,337,81790,34018,47772,62946840.0,26119822.0,36827018.0,0.7699,0.7709,0.7678,0.7709
2023-11-06 15:45,2689,402,2287,486628,40644,445984,375396931.0,31253748.0,344143183.0,2683,399,2284,487539,41290,446249,376065205.0,31721573.0,344343631.0,0.769,0.7716,0.7683,0.7716
2023-11-06 15:50,1215,165,1050,249582,3641,245941,192766333.0,2789639.0,189976694.0,1181,145,1036,246198,2228,243970,190098417.0,1710517.0,188387900.0,0.7662,0.7724,0.7677,0.7722
2023-11-06 15:55,1319,644,675,140940,47068,93872,108482087.0,36085554.0,72396533.0,1285,623,662,138753,45686,93067,106802110.0,35023607.0,71778503.0,0.7667,0.7712,0.7666,0.7713
2023-11-06 16:00,119,69,50,5938,3287,2651,4572145.0,2528431.0,2043714.0,94,51,43,4797,2461,2336,3682485.0,1883343.0,1799142.0,0.7692,0.7709,0.7653,0.7702
2023-11-06 16:05,198,93,105,17848,5775,12073,13730464.0,4446999.0,9283464.0,186,88,98,17288,5530,11758,13305064.0,4248314.0,9056749.0,0.77,0.7689,0.7682,0.7703
2023-11-06 16:10,266,87,179,25758,4194,21564,19813936.0,3222315.0,16591621.0,250,77,173,25059,4079,20980,19301779.0,3133754.0,16168024.0,0.7683,0.7694,0.7683,0.7706
2023-11-06 16:15,358,95,263,29919,5708,24211,23030052.0,4381176.0,18648875.0,336,83,253,28256,5344,22912,21751140.0,4101579.0,17649561.0,0.7676,0.7703,0.7675,0.7703
2023-11-06 16:20,181,89,92,15282,3833,11449,11775863.0,2950043.0,8825820.0,171,86,85,14858,3868,10990,11444474.0,2971647.0,8472827.0,0.7696,0.7709,0.7683,0.771
2023-11-06 16:25,133,59,74,12659,2367,10292,9768695.0,1846169.0,7922525.0,125,53,72,12777,2090,10687,9845915.0,1605323.0,8240591.0,0.78,0.7698,0.7681,0.7711
2023-11-06 16:30,130,32,98,15448,1473,13975,11898598.0,1131880.0,10766717.0,120,27,93,14396,896,13500,11083247.0,688384.0,10394863.0,0.7684,0.7704,0.7683,0.77
2023-11-06 16:35,312,152,160,15943,4066,11877,12267979.0,3123832.0,9144147.0,294,142,152,15386,3765,11621,11839797.0,2893164.0,8946633.0,0.7683,0.7699,0.7684,0.7699
2023-11-06 16:40,214,105,109,15204,4353,10851,11693975.0,3363121.0,8330854.0,194,93,101,14454,4078,10376,11119096.0,3133376.0,7985720.0,0.7726,0.7677,0.7684,0.7696
2023-11-06 16:45,172,100,72,10098,2752,7346,7810297.0,2153878.0,5656418.0,159,92,67,9620,2371,7249,7401977.0,1820871.0,5581106.0,0.7827,0.77,0.768,0.7699
2023-11-06 16:50,90,49,41,6791,2511,4280,5209408.0,1929788.0,3279620.0,78,42,36,6393,2266,4127,4923277.0,1741426.0,3181851.0,0.7685,0.7663,0.7685,0.771
2023-11-06 16:55,97,46,51,8196,2154,6042,6309805.0,1654887.0,4654917.0,92,44,48,7943,2079,5864,6114691.0,1596869.0,4517822.0,0.7683,0.7704,0.7681,0.7704
2023-11-06 17:00,81,51,30,3800,1640,2160,2950446.0,1282165.0,1668281.0,76,47,29,3687,1536,2151,2841159.0,1180502.0,1660656.0,0.7818,0.7724,0.7686,0.772
2023-11-06 17:05,72,46,26,3624,3023,601,2800251.0,2337844.0,462406.0,56,38,18,3393,2849,544,2607725.0,2188391.0,419333.0,0.7734,0.7694,0.7681,0.7708
2023-11-06 17:10,38,25,13,2768,1832,936,2132099.0,1408957.0,723141.0,41,25,16,2511,1368,1143,1929074.0,1045224.0,883850.0,0.7691,0.7726,0.7641,0.7733
2023-11-06 17:15,44,33,11,1450,814,636,1124813.0,631686.0,493126.0,30,22,8,972,480,492,749464.0,368992.0,380472.0,0.776,0.7754,0.7687,0.7733
2023-11-06 17:20,166,160,6,11289,10616,673,8681634.0,8167716.0,513917.0,155,151,4,10510,10387,123,8079943.0,7985087.0,94855.0,0.7694,0.7636,0.7688,0.7712
2023-11-06 17:25,166,67,99,11851,3803,8048,9096828.0,2936967.0,6159860.0,148,59,89,9857,2943,6914,7594839.0,2261995.0,5332843.0,0.7723,0.7654,0.7686,0.7713
2023-11-06 17:30,277,154,123,12328,5234,7094,9515435.0,4037049.0,5478386.0,276,153,123,12660,5307,7353,9761315.0,4082177.0,5679138.0,0.7713,0.7723,0.7692,0.7724
2023-11-06 17:35,99,75,24,9655,7431,2224,7490919.0,5774178.0,1716740.0,87,67,20,7913,6341,1572,6084488.0,4870442.0,1214045.0,0.777,0.7719,0.7681,0.7723
2023-11-06 17:40,469,191,278,34973,19682,15291,26928513.0,15137230.0,11791283.0,453,183,270,35260,19944,15316,27154323.0,15338256.0,11816066.0,0.7691,0.7711,0.7691,0.7715
2023-11-06 17:45,191,91,100,14775,6389,8386,11408783.0,4905835.0,6502948.0,184,85,99,14377,6166,8211,11148442.0,4733774.0,6414667.0,0.7679,0.7755,0.7677,0.7812
2023-11-06 17:50,371,181,190,28686,16880,11806,22074002.0,12962403.0,9111599.0,345,163,182,25742,14085,11657,19804486.0,10807616.0,8996870.0,0.7679,0.7718,0.7673,0.7718
2023-11-06 17:55,553,174,379,29982,15674,14308,23101222.0,12059395.0,11041827.0,550,170,380,30562,15806,14756,23554058.0,12162675.0,11391383.0,0.7694,0.7717,0.7695,0.772
2023-11-06 18:00,302,37,265,9092,1657,7435,6984658.0,1273833.0,5710825.0,279,25,254,9140,3090,6050,7005809.0,2342490.0,4663319.0,0.7688,0.7681,0.7581,0.7708
2023-11-06 18:05,338,134,204,26992,9758,17234,20785588.0,7510460.0,13275128.0,321,121,200,25867,8815,17052,19927476.0,6779209.0,13148267.0,0.7697,0.7703,0.7691,0.7711
2023-11-06 18:10,1160,266,894,140189,28781,111408,108019773.0,22132584.0,85887188.0,1153,257,896,140054,28753,111301,107915357.0,22107536.0,85807821.0,0.769,0.7709,0.7689,0.771
2023-11-06 18:15,971,330,641,107159,17221,89938,82547326.0,13222518.0,69324808.0,949,312,637,107176,17078,90098,82563055.0,13114784.0,69448271.0,0.7678,0.7708,0.7679,0.7708
2023-11-06 18:20,1196,361,835,115002,30452,84550,88596999.0,23410047.0,65186952.0,1198,359,839,115954,30633,85321,89321528.0,23535343.0,65786184.0,0.7688,0.771,0.7683,0.771
2023-11-06 18:25,1650,540,1110,189531,69055,120476,145949001.0,53047477.0,92901524.0,1630,526,1104,189323,68202,121121,145713093.0,52302278.0,93410814.0,0.7682,0.7711,0.7669,0.7712
2023-11-06 18:30,2151,1206,945,245687,191264,54423,189211168.0,147177114.0,42034054.0,2132,1198,934,243924,191033,52891,187808493.0,146960580.0,40847913.0,0.7695,0.7724,0.7693,0.7723
2023-11-06 18:35,636,359,277,64028,51508,12520,49259246.0,39637199.0,9622046.0,629,355,274,64054,51566,12488,49304326.0,39667148.0,9637178.0,0.7695,0.7685,0.7693,0.7717
2023-11-07 10:00,2307,818,1489,204789,61441,143348,158845044.0,46387250.0,112457794.0,1939,642,1297,183319,48815,134504,141668602.0,37594727.0,104073874.0,0.755,0.7845,0.7701,0.7738
2023-11-07 10:05,1021,434,587,88694,33810,54884,68530132.0,26075958.0,42454173.0,936,397,539,81091,29539,51552,62623287.0,22748045.0,39875241.0,0.7712,0.7735,0.7701,0.7735
2023-11-07 10:10,771,372,399,77802,48394,29408,59900339.0,37191522.0,22708817.0,736,351,385,75933,47662,28271,58481515.0,36635642.0,21845873.0,0.7685,0.7722,0.7687,0.7727
2023-11-07 10:15,1726,927,799,150692,87928,62764,116524800.0,67955799.0,48569001.0,1570,851,719,146691,86058,60633,113272192.0,66387695.0,46884497.0,0.7729,0.7738,0.7714,0.7733
2023-11-07 10:20,1330,871,459,137544,108705,28839,106254213.0,83941425.0,22312788.0,1273,844,429,133502,106094,27408,103124483.0,81903218.0,21221265.0,0.7722,0.7737,0.772,0.7743
2023-11-07 10:25,1575,1003,572,203611,157989,45622,158175161.0,121941226.0,36233935.0,1536,985,551,198234,154037,44197,154043632.0,118895302.0,35148330.0,0.7718,0.7942,0.7719,0.7953
2023-11-07 10:30,597,195,402,54816,12684,42132,42694785.0,9794173.0,32900611.0,545,164,381,52344,11181,41163,40789132.0,8617335.0,32171796.0,0.7722,0.7809,0.7707,0.7816
2023-11-07 10:35,358,115,243,39711,7926,31785,30655759.0,6115936.0,24539822.0,339,105,234,40217,9581,30636,31086063.0,7386702.0,23699361.0,0.7716,0.7721,0.771,0.7736
2023-11-07 10:40,424,93,331,41301,3265,38036,31933438.0,2509389.0,29424049.0,404,86,318,39997,2646,37351,30936236.0,2040537.0,28895698.0,0.7686,0.7736,0.7712,0.7736
2023-11-07 10:45,325,116,209,32194,7185,25009,24891697.0,5538107.0,19353590.0,300,99,201,29074,4508,24566,22476233.0,3469822.0,19006411.0,0.7708,0.7739,0.7697,0.7737
2023-11-07 10:50,279,116,163,22258,9268,12990,17215857.0,7162959.0,10052898.0,263,105,158,24368,11283,13085,18827209.0,8701766.0,10125443.0,0.7729,0.7739,0.7712,0.7738
2023-11-07 10:55,1539,813,726,129139,56542,72597,99783691.0,43637560.0,56146130.0,1524,806,718,128427,56134,72293,99243865.0,43326332.0,55917533.0,0.7718,0.7734,0.7718,0.7735
2023-11-07 11:00,1125,499,626,158072,56674,101398,121977586.0,43570535.0,78407050.0,1102,485,617,156939,56195,100744,121110670.0,43199798.0,77910872.0,0.7688,0.7733,0.7687,0.7734
2023-11-07 11:05,1146,433,713,121319,28603,92716,93771786.0,22065629.0,71706157.0,1132,425,707,118005,26498,91507,91283029.0,20441638.0,70841391.0,0.7714,0.7734,0.7714,0.7742
2023-11-07 11:10,315,165,150,31156,12038,19118,24102179.0,9296848.0,14805330.0,287,152,135,30659,11524,19135,23707053.0,8888467.0,14818585.0,0.7723,0.7744,0.7713,0.7744
2023-11-07 11:15,241,140,101,24394,13667,10727,18916315.0,10621162.0,8295153.0,213,125,88,22864,12705,10159,17679489.0,9808922.0,7870567.0,0.7771,0.7733,0.7721,0.7747
2023-11-07 11:20,141,53,88,17374,4525,12849,13463696.0,3494282.0,9969413.0,128,45,83,17200,4491,12709,13329977.0,3464335.0,9865641.0,0.7722,0.7759,0.7714,0.7763
2023-11-07 11:25,377,220,157,46791,19907,26884,36255223.0,15353798.0,20901425.0,356,210,146,42692,19343,23349,33011651.0,14919988.0,18091663.0,0.7713,0.7775,0.7713,0.7748
2023-11-07 11:30,670,209,461,74515,17897,56618,57371499.0,13772703.0,43598796.0,619,177,442,74264,16247,58017,57424328.0,12514063.0,44910265.0,0.7696,0.7701,0.7702,0.7741
2023-11-07 11:35,182,77,105,18301,7354,10947,14118197.0,5662003.0,8456194.0,169,63,106,18790,7206,11584,14496937.0,5547579.0,8949358.0,0.7699,0.7725,0.7699,0.7726
2023-11-07 11:40,973,215,758,101323,22215,79108,78472569.0,17131041.0,61341528.0,932,189,743,98160,20233,77927,76007981.0,15582554.0,60425427.0,0.7711,0.7754,0.7702,0.7754
2023-11-07 11:45,208,73,135,24349,3490,20859,18813945.0,2686173.0,16127772.0,191,61,130,23920,3170,20750,18486540.0,2442711.0,16043829.0,0.7697,0.7732,0.7706,0.7732
2023-11-07 11:50,312,115,197,12868,3332,9536,9940768.0,2570320.0,7370448.0,297,110,187,12673,3269,9404,9785531.0,2514740.0,7270791.0,0.7714,0.7729,0.7693,0.7732
2023-11-07 11:55,116,46,70,9930,3038,6892,7654909.0,2341930.0,5312979.0,105,40,65,9408,2467,6941,7266719.0,1901843.0,5364876.0,0.7709,0.7709,0.7709,0.7729
2023-11-07 12:00,213,92,121,20398,6684,13714,15767308.0,5149155.0,10618153.0,194,83,111,18491,5937,12554,14277476.0,4572521.0,9704955.0,0.7704,0.7743,0.7702,0.7731
2023-11-07 12:05,803,168,635,107847,19107,88740,83258958.0,14707070.0,68551888.0,780,154,626,106316,17689,88627,82085989.0,13620133.0,68465856.0,0.7697,0.7725,0.77,0.7725
2023-11-07 12:10,231,91,140,25576,8774,16802,19684130.0,6750224.0,12933906.0,197,82,115,22468,8926,13542,17336388.0,6868647.0,10467740.0,0.7693,0.7698,0.7695,0.773
2023-11-07 12:15,556,203,353,79357,12098,67259,61228393.0,9313325.0,51915067.0,531,181,350,77564,10259,67305,59856455.0,7892916.0,51963539.0,0.7698,0.7719,0.7694,0.7721
2023-11-07 12:20,790,501,289,57441,34315,23126,44380110.0,26450164.0,17929946.0,760,483,277,54786,32565,22221,42285661.0,25100125.0,17185535.0,0.7708,0.7753,0.7708,0.7734
2023-11-07 12:25,1533,1008,525,150303,105632,44671,115948549.0,81431956.0,34516593.0,1513,1000,513,149530,105224,44306,115337833.0,81100717.0,34237115.0,0.7709,0.7727,0.7707,0.7727
2023-11-07 12:30,433,60,373,38453,2445,36008,29661493.0,1881993.0,27779500.0,297,48,249,37504,2419,35085,28948404.0,1863014.0,27085389.0,0.7697,0.7715,0.7702,0.772
2023-11-07 12:35,270,62,208,32128,4276,27852,24652795.0,3288945.0,21363850.0,245,46,199,30896,3354,27542,23899692.0,2578424.0,21321267.0,0.7692,0.767,0.7688,0.7741
2023-11-07 12:40,428,111,317,59849,8176,51673,46197519.0,6301499.0,39896020.0,427,113,314,59223,7933,51290,45706440.0,6106808.0,39599632.0,0.7707,0.7721,0.7698,0.7721
2023-11-07 12:45,629,260,369,76278,12579,63699,58901378.0,9694537.0,49206840.0,615,250,365,76422,12448,63974,59022677.0,9589362.0,49433314.0,0.7707,0.7725,0.7704,0.7727
2023-11-07 12:50,353,118,235,39085,10815,28270,30071620.0,8326417.0,21745202.0,327,110,217,36894,10246,26648,28469406.0,7886841.0,20582565.0,0.7699,0.7692,0.7697,0.7724
2023-11-07 12:55,535,37,498,64969,1059,63910,50164609.0,825453.0,49339155.0,527,31,496,64911,1008,63903,50111719.0,775498.0,49336221.0,0.7795,0.772,0.7693,0.772
2023-11-07 13:00,414,109,305,33402,13345,20057,25710503.0,10272169.0,15438333.0,399,101,298,32733,13055,19678,25232879.0,10048469.0,15184409.0,0.7697,0.7697,0.7697,0.7716
2023-11-07 13:05,1653,764,889,187208,88820,98388,143893294.0,68330297.0,75562997.0,1627,748,879,183926,87916,96010,141626506.0,67635611.0,73990894.0,0.7693,0.768,0.7693,0.7707
2023-11-07 13:10,1486,879,607,130117,86051,44066,100142425.0,66199382.0,33943042.0,1466,876,590,130165,86105,44060,100199569.0,66236209.0,33963360.0,0.7693,0.7703,0.7692,0.7708
2023-11-07 13:15,390,163,227,37664,15682,21982,28999495.0,12064257.0,16935238.0,365,148,217,36469,14633,21836,28096424.0,11255464.0,16840960.0,0.7693,0.7704,0.7692,0.7712
2023-11-07 13:20,462,271,191,54531,33691,20840,41945913.0,25911288.0,16034625.0,446,266,180,54008,33765,20243,41576567.0,25968225.0,15608342.0,0.7691,0.7694,0.7691,0.771
2023-11-07 13:25,444,129,315,42985,5186,37799,33122085.0,3986798.0,29135287.0,405,100,305,41612,4376,37236,32077542.0,3364330.0,28713212.0,0.7688,0.7708,0.7688,0.7711
2023-11-07 13:30,215,84,131,19184,6280,12904,14772919.0,4827576.0,9945342.0,203,79,124,18818,6037,12781,14493125.0,4641239.0,9851885.0,0.7687,0.7707,0.7688,0.7708
2023-11-07 13:35,122,52,70,12567,3899,8668,9678072.0,2997737.0,6680335.0,120,49,71,13013,4094,8919,10020001.0,3145854.0,6874147.0,0.7688,0.7707,0.7684,0.7707
2023-11-07 13:40,173,86,87,11252,6167,5085,8654226.0,4740064.0,3914162.0,163,81,82,10848,6028,4820,8349359.0,4631791.0,3717568.0,0.7686,0.7697,0.7684,0.7713
2023-11-07 13:45,94,40,54,4196,2428,1768,3231329.0,1866719.0,1364610.0,91,39,52,4032,2474,1558,3104017.0,1901277.0,1202739.0,0.7688,0.7718,0.7685,0.772
2023-11-07 13:50,418,244,174,28460,16477,11983,22038129.0,12801749.0,9236380.0,397,231,166,26702,15365,11337,20561738.0,11812184.0,8749554.0,0.7769,0.7708,0.7688,0.7718
2023-11-07 13:55,816,501,315,93356,56513,36843,71880485.0,43454330.0,28426155.0,804,491,313,92722,56099,36623,71380324.0,43124013.0,28256311.0,0.7689,0.7715,0.7687,0.7715
2023-11-07 14:00,660,337,323,47812,25383,22429,36704346.0,19521663.0,17182682.0,643,329,314,46076,24742,21334,35480279.0,19029453.0,16450825.0,0.7691,0.7661,0.7691,0.7711
2023-11-07 14:05,818,273,545,98407,8151,90256,75832440.0,6266350.0,69566090.0,805,264,541,98260,8115,90145,75719926.0,6238599.0,69481327.0,0.7688,0.7708,0.7688,0.7708
2023-11-07 14:10,145,46,99,19874,3112,16762,15283579.0,2365076.0,12918503.0,130,39,91,18754,2737,16017,14453531.0,2103035.0,12350496.0,0.76,0.7707,0.7684,0.7711
2023-11-07 14:15,321,95,226,41200,3406,37794,31588645.0,2614689.0,28973956.0,274,72,202,37482,2905,34577,28853691.0,2228921.0,26624770.0,0.7677,0.7666,0.7673,0.77
2023-11-07 14:20,130,42,88,11665,2095,9570,9002214.0,1639442.0,7362772.0,108,30,78,11072,1532,9540,8518580.0,1175511.0,7343069.0,0.7825,0.7694,0.7673,0.7697
2023-11-07 14:25,198,76,122,18762,2663,16099,14433411.0,2049335.0,12384076.0,167,58,109,17385,2461,14924,13375856.0,1888428.0,11487428.0,0.7696,0.7692,0.7673,0.7697
2023-11-07 14:30,703,70,633,106615,3871,102744,81977240.0,2973112.0,79004128.0,678,51,627,106031,3702,102329,81528340.0,2835913.0,78692427.0,0.768,0.7689,0.766,0.769
2023-11-07 14:35,289,101,188,50683,6421,44262,38965902.0,4918082.0,34047820.0,286,88,198,48891,6104,42787,37598136.0,4671553.0,32926583.0,0.7659,0.7692,0.7653,0.7695
2023-11-07 14:40,154,121,33,16807,9977,6830,12923725.0,7660656.0,5263069.0,149,116,33,16863,9943,6920,12966709.0,7631812.0,5334897.0,0.7678,0.7706,0.7676,0.7709
2023-11-07 14:45,98,51,47,11175,3699,7476,8554017.0,2834895.0,5719122.0,81,41,40,10137,3305,6832,7809451.0,2531892.0,5277559.0,0.7664,0.765,0.7661,0.7725
2023-11-07 14:50,121,37,84,21723,3359,18364,16826640.0,2676829.0,14149810.0,102,30,72,19936,2444,17492,15363432.0,1869494.0,13493937.0,0.7969,0.7705,0.7649,0.7714
2023-11-07 14:55,259,36,223,56416,2073,54343,43511851.0,1590243.0,41921608.0,241,29,212,54689,1979,52710,42168803.0,1517431.0,40651372.0,0.7671,0.7714,0.7668,0.7712
2023-11-07 15:00,103,20,83,27840,987,26853,21472348.0,756498.0,20715849.0,97,17,80,28299,1087,27212,21829493.0,832468.0,20997024.0,0.7665,0.7715,0.7658,0.7716
2023-11-07 15:05,291,68,223,69063,2751,66312,53164355.0,2108755.0,51055599.0,272,55,217,68322,2713,65609,52717249.0,2079555.0,50637694.0,0.7665,0.7699,0.7665,0.7718
2023-11-07 15:10,171,58,113,36044,4460,31584,27778228.0,3426563.0,24351664.0,157,50,107,35675,4159,31516,27504578.0,3192373.0,24312205.0,0.7683,0.771,0.7676,0.7714
2023-11-07 15:15,342,77,265,75838,4565,71273,58482167.0,3531326.0,54950840.0,319,56,263,75310,4270,71040,58048601.0,3275758.0,54772843.0,0.7736,0.771,0.7672,0.771
2023-11-07 15:20,202,34,168,41868,2180,39688,32248295.0,1683766.0,30564528.0,193,27,166,41909,1872,40037,32271545.0,1436773.0,30834772.0,0.7724,0.7701,0.7675,0.7702
2023-11-07 15:25,323,141,182,37793,7323,30470,29245484.0,5726345.0,23519139.0,307,131,176,36631,6506,30125,28248405.0,4995735.0,23252669.0,0.782,0.7719,0.7679,0.7719
2023-11-07 15:30,693,373,320,75027,22881,52146,57727118.0,17591161.0,40135956.0,678,366,312,74210,22494,51716,57094275.0,17278809.0,39815465.0,0.7688,0.7697,0.7682,0.7699
2023-11-07 15:35,609,347,262,67567,27940,39627,52031486.0,21461530.0,30569956.0,597,338,259,67542,27801,39741,52012585.0,21355740.0,30656845.0,0.7681,0.7714,0.7682,0.7714
2023-11-07 15:40,111,47,64,11555,3007,8548,8906355.0,2312885.0,6593470.0,96,33,63,11563,2781,8782,8910839.0,2134941.0,6775897.0,0.7692,0.7713,0.7677,0.7716
2023-11-07 15:45,345,110,235,32897,4517,28380,25351957.0,3485488.0,21866468.0,331,100,231,32194,4416,27778,24793143.0,3390157.0,21402985.0,0.7716,0.7705,0.7677,0.7705
2023-11-07 15:50,374,103,271,50455,8229,42226,38735577.0,6316078.0,32419499.0,351,90,261,47512,6488,41024,36580822.0,4979597.0,31601225.0,0.7675,0.7678,0.7675,0.7703
2023-11-07 15:55,543,219,324,77131,21581,55550,59407284.0,16587314.0,42819970.0,523,207,316,76763,21208,55555,59113282.0,16286597.0,42826685.0,0.7686,0.7708,0.7679,0.7709
2023-11-07 16:00,410,255,155,40739,24904,15835,31384078.0,19162490.0,12221588.0,392,243,149,40470,24881,15589,31156674.0,19125705.0,12030969.0,0.7695,0.7718,0.7687,0.7718
2023-11-07 16:05,1042,772,270,113023,71779,41244,87032066.0,55197205.0,31834860.0,1032,766,266,112885,71879,41006,86894811.0,55242717.0,31652094.0,0.769,0.7719,0.7686,0.7719
2023-11-07 16:10,1446,1087,359,157034,88824,68210,120978038.0,68306266.0,52671771.0,1439,1081,358,157073,88723,68350,120987096.0,68207016.0,52780079.0,0.769,0.7722,0.7688,0.7722
2023-11-07 16:15,1479,1227,252,151784,117675,34109,116817793.0,90501479.0,26316314.0,1461,1220,241,150851,117107,33744,116069132.0,90032570.0,26036562.0,0.7691,0.7715,0.7688,0.7716
2023-11-07 16:20,396,225,171,51964,26008,25956,40115196.0,20052561.0,20062635.0,369,211,158,50972,25265,25707,39291711.0,19422771.0,19868939.0,0.771,0.7729,0.7688,0.7729
2023-11-07 16:25,1050,676,374,153563,111141,42422,118129589.0,85376319.0,32753269.0,1045,673,372,153404,110993,42411,117998882.0,85252722.0,32746160.0,0.7682,0.7721,0.7681,0.7721
2023-11-07 16:30,791,449,342,125495,76883,48612,96624570.0,59078759.0,37545811.0,781,445,336,124841,76486,48355,96085671.0,58745195.0,37340476.0,0.7684,0.7724,0.7681,0.7722
2023-11-07 16:35,1268,634,634,193613,101446,92167,149130844.0,77949662.0,71181182.0,1261,631,630,193464,101553,91911,149016998.0,78030665.0,70986332.0,0.7684,0.7723,0.7684,0.7723
2023-11-07 16:40,1002,557,445,145978,89077,56901,112362188.0,68423061.0,43939126.0,991,551,440,143962,89229,54733,110802977.0,68536730.0,42266246.0,0.7681,0.7722,0.7681,0.7722
2023-11-07 16:45,436,260,176,69089,45596,23493,53176727.0,35039262.0,18137464.0,429,256,173,68527,45232,23295,52738875.0,34752452.0,17986422.0,0.7685,0.772,0.7683,0.7721
2023-11-07 16:50,2198,1139,1059,319560,210244,109316,245895176.0,161548102.0,84347073.0,2180,1130,1050,319008,210185,108823,245497016.0,161505360.0,83991655.0,0.7684,0.7716,0.7684,0.7718
2023-11-07 16:55,1090,477,613,127074,76877,50197,97810891.0,59078793.0,38732098.0,1086,475,611,127508,77331,50177,98130757.0,59413994.0,38716763.0,0.7685,0.7716,0.7683,0.7716
2023-11-07 17:00,814,424,390,81908,57197,24711,63054403.0,43978342.0,19076061.0,801,419,382,80286,55899,24387,61775708.0,42949480.0,18826228.0,0.7689,0.772,0.7683,0.772
2023-11-07 17:05,350,173,177,36836,24761,12075,28340374.0,19017613.0,9322761.0,342,166,176,37055,24695,12360,28504336.0,18962300.0,9542036.0,0.768,0.7721,0.7679,0.772
2023-11-07 17:10,420,315,105,31649,22298,9351,24358829.0,17151809.0,7207019.0,410,307,103,30562,22129,8433,23535360.0,17021479.0,6513880.0,0.7692,0.7707,0.7692,0.7724
2023-11-07 17:15,452,373,79,63978,52891,11087,49182847.0,40659439.0,8523407.0,448,372,76,63909,52890,11019,49164452.0,40658173.0,8506279.0,0.7687,0.7688,0.7687,0.772
2023-11-07 17:20,388,276,112,57621,41304,16317,44355807.0,31763109.0,12592697.0,373,266,107,57283,41161,16122,44093732.0,31649659.0,12444073.0,0.769,0.7718,0.7689,0.7719
2023-11-07 17:25,563,444,119,70218,59961,10257,54028874.0,46120956.0,7907918.0,545,436,109,69798,59669,10129,53702771.0,45885328.0,7817443.0,0.7692,0.771,0.769,0.7718
2023-11-07 17:30,604,397,207,84812,61566,23246,65249665.0,47303379.0,17946286.0,573,382,191,84828,61423,23405,65259955.0,47190304.0,18069651.0,0.7683,0.772,0.7683,0.772
2023-11-07 17:35,607,366,241,85863,57513,28350,66035134.0,44202567.0,21832567.0,587,353,234,85237,57217,28020,65593017.0,43977025.0,21615991.0,0.7686,0.7701,0.7686,0.7714
2023-11-07 17:40,682,359,323,66810,47464,19346,51371303.0,36512805.0,14858498.0,668,353,315,66001,47201,18800,50807601.0,36310437.0,14497163.0,0.7693,0.768,0.7693,0.7711
2023-11-07 17:45,1123,822,301,118413,92732,25681,91056354.0,71286532.0,19769821.0,1122,825,297,118619,93213,25406,91244694.0,71653800.0,19590894.0,0.7687,0.7698,0.7687,0.7711
2023-11-07 17:50,1111,657,454,116212,71297,44915,89386193.0,54762460.0,34623733.0,1093,649,444,117252,70672,46580,90249688.0,54273473.0,35976214.0,0.7681,0.7709,0.768,0.7724
2023-11-07 17:55,550,380,170,75092,53256,21836,57674365.0,40838641.0,16835724.0,542,375,167,74946,53271,21675,57568879.0,40850700.0,16718179.0,0.7668,0.771,0.7668,0.7713
2023-11-07 18:00,783,528,255,106499,73773,32726,81838910.0,56592343.0,25246566.0,768,519,249,104795,73719,31076,80518344.0,56541977.0,23976367.0,0.7671,0.7715,0.767,0.7715
2023-11-07 18:05,509,360,149,69104,47517,21587,53147053.0,36493928.0,16653124.0,508,362,146,69100,47487,21613,53146113.0,36472326.0,16673786.0,0.768,0.7714,0.768,0.7715
2023-11-07 18:10,1259,317,942,213279,29717,183562,164011444.0,22808915.0,141202529.0,1218,287,931,210928,28526,182402,162485069.0,21895392.0,140589676.0,0.7675,0.7692,0.7676,0.7708
2023-11-07 18:15,2601,931,1670,391371,105338,286033,301153931.0,80835654.0,220318276.0,2584,919,1665,390156,104631,285525,300239323.0,80288004.0,219951319.0,0.7674,0.7703,0.7673,0.7703
2023-11-07 18:20,884,93,791,145768,7628,138140,112256770.0,5852948.0,106403822.0,882,88,794,145225,7856,137369,111837281.0,6025742.0,105811539.0,0.7673,0.7703,0.767,0.7703
2023-11-07 18:25,48,22,26,3648,530,3118,2802461.0,399853.0,2402608.0,35,13,22,3180,134,3046,2450170.0,103022.0,2347147.0,0.7544,0.7706,0.7688,0.7706
2023-11-07 18:30,157,111,46,9483,3510,5973,7326150.0,2715975.0,4610175.0,138,103,35,8191,2867,5324,6314248.0,2202984.0,4111263.0,0.7738,0.7718,0.7684,0.7722
2023-11-07 18:35,130,117,13,4688,4308,380,3614280.0,3321490.0,292790.0,127,117,10,4826,4552,274,3705768.0,3494743.0,211025.0,0.771,0.7705,0.7677,0.7702
2023-11-08 10:00,3800,1493,2307,380826,125426,255400,293170031.0,95145815.0,198024215.0,3456,1329,2127,355931,109684,246247,273709505.0,84046784.0,189662721.0,0.7586,0.7753,0.7663,0.7702
2023-11-08 10:05,5322,2087,3235,651093,169401,481692,500008542.0,130531061.0,369477481.0,5020,1887,3133,634987,159348,475639,487211367.0,122102339.0,365109028.0,0.7705,0.767,0.7663,0.7676
2023-11-08 10:10,3977,1431,2546,576318,88819,487499,443533866.0,69520893.0,374012973.0,3767,1284,2483,566128,82794,483334,434423935.0,63597096.0,370826839.0,0.7827,0.7672,0.7681,0.7672
2023-11-08 10:15,1633,669,964,215359,26707,188652,166150190.0,20350855.0,145799334.0,1460,568,892,212217,25137,187080,163757965.0,19115960.0,144642005.0,0.762,0.7728,0.7605,0.7732
2023-11-08 10:20,1120,538,582,179860,39907,139953,137520762.0,30294205.0,107226557.0,1108,537,571,182339,42093,140246,139454650.0,32001370.0,107453279.0,0.7591,0.7662,0.7603,0.7662
2023-11-08 10:25,1186,701,485,141978,54287,87691,108453989.0,41359665.0,67094324.0,1121,665,456,137306,51410,85896,106221860.0,40433880.0,65787980.0,0.7619,0.7651,0.7865,0.7659
2023-11-08 10:30,863,315,548,107387,27358,80029,82167720.0,20870819.0,61296901.0,809,293,516,106722,27853,78869,81642522.0,21227182.0,60415340.0,0.7629,0.7659,0.7621,0.766
2023-11-08 10:35,1744,1095,649,254682,151814,102868,194523200.0,115792176.0,78731024.0,1682,1061,621,252019,150869,101150,192577805.0,115063706.0,77514098.0,0.7627,0.7654,0.7627,0.7663
2023-11-08 10:40,2338,1158,1180,317936,89502,228434,243546387.0,68265855.0,175280532.0,2301,1127,1174,317813,88863,228950,243449531.0,67773747.0,175675784.0,0.7627,0.7673,0.7627,0.7673
2023-11-08 10:45,1184,564,620,162243,39248,122995,124476624.0,29964752.0,94511871.0,1161,553,608,160249,38639,121610,122855570.0,29482496.0,93373073.0,0.7635,0.7684,0.763,0.7678
2023-11-08 10:50,530,101,429,69429,3032,66397,53241020.0,2317700.0,50923319.0,495,77,418,68164,2506,65658,52258304.0,1913557.0,50344746.0,0.7644,0.767,0.7636,0.7668
2023-11-08 10:55,479,216,263,45717,11795,33922,35359481.0,9022502.0,26336979.0,442,199,243,44797,11638,33159,34646813.0,8891821.0,25754992.0,0.7649,0.7764,0.764,0.7767
2023-11-08 11:00,275,206,69,27446,19389,8057,21044296.0,14816238.0,6228057.0,241,186,55,24150,17831,6319,18455562.0,13599513.0,4856048.0,0.7642,0.773,0.7627,0.7685
2023-11-08 11:05,313,153,160,42690,11811,30879,32505533.0,8889784.0,23615749.0,275,130,145,41282,11718,29564,31519280.0,8807233.0,22712047.0,0.7527,0.7648,0.7516,0.7682
2023-11-08 11:10,276,121,155,30703,6868,23835,23559011.0,5269431.0,18289579.0,249,104,145,28903,5732,23171,22858234.0,5063855.0,17794379.0,0.7672,0.7673,0.8834,0.768
2023-11-08 11:15,1000,366,634,115718,31806,83912,88737494.0,24290801.0,64446693.0,978,355,623,114610,30878,83732,87876216.0,23568132.0,64308084.0,0.7637,0.768,0.7633,0.768
2023-11-08 11:20,339,179,160,44425,17062,27363,34017766.0,13016438.0,21001328.0,331,174,157,43813,17230,26583,33567436.0,13144529.0,20422906.0,0.7629,0.7675,0.7629,0.7683
2023-11-08 11:25,2862,1709,1153,409121,305671,103450,314632753.0,234123404.0,80509348.0,2799,1679,1120,399545,298764,100781,307269142.0,228795545.0,78473597.0,0.7659,0.7782,0.7658,0.7787
2023-11-08 11:30,2205,1776,429,332631,295102,37529,255673702.0,226151157.0,29522544.0,2182,1769,413,330878,294736,36142,254326715.0,225867317.0,28459398.0,0.7663,0.7867,0.7663,0.7874
2023-11-08 11:35,766,701,65,105637,101416,4221,80836892.0,77600430.0,3236461.0,742,693,49,105308,101981,3327,80594129.0,78032595.0,2561534.0,0.7652,0.7668,0.7652,0.7699
2023-11-08 11:40,679,515,164,85381,63539,21842,65564962.0,48742110.0,16822852.0,646,495,151,78830,60325,18505,60393710.0,46151626.0,14242084.0,0.7671,0.7702,0.765,0.7696
2023-11-08 11:45,673,521,152,126090,109374,16716,96541340.0,83656196.0,12885143.0,657,516,141,124857,108588,16269,95585960.0,83044286.0,12541674.0,0.7649,0.7708,0.7648,0.7709
2023-11-08 11:50,2583,985,1598,349433,110188,239245,268797841.0,84506154.0,184291687.0,2575,983,1592,349622,110640,238982,268954631.0,84848896.0,184105735.0,0.7669,0.7703,0.7669,0.7704
2023-11-08 11:55,1109,599,510,127429,51832,75597,98014552.0,39775717.0,58238834.0,1093,591,502,125311,51219,74092,96380930.0,39286460.0,57094469.0,0.7674,0.7704,0.767,0.7706
2023-11-08 12:00,911,676,235,137422,114000,23422,105361845.0,87350645.0,18011200.0,896,671,225,137487,114181,23306,105426721.0,87483012.0,17943708.0,0.7662,0.769,0.7662,0.7699
2023-11-08 12:05,2196,1483,713,279601,229658,49943,214777733.0,176103678.0,38674054.0,2165,1472,693,276469,227298,49171,212429657.0,174256979.0,38172678.0,0.7668,0.7744,0.7666,0.7763
2023-11-08 12:10,1159,1006,153,165436,155856,9580,126938490.0,119477653.0,7460837.0,1150,1000,150,165129,155749,9380,126863387.0,119399969.0,7463418.0,0.7666,0.7788,0.7666,0.7957
2023-11-08 12:15,1385,790,595,168472,135125,33347,129251509.0,103573981.0,25677527.0,1371,784,587,167735,134950,32785,128691742.0,103441246.0,25250495.0,0.7665,0.77,0.7665,0.7702
2023-11-08 12:20,2194,1290,904,294692,203095,91597,225881178.0,155503835.0,70377342.0,2159,1266,893,290801,200480,90321,222966069.0,153508599.0,69457470.0,0.7657,0.7683,0.7657,0.769
2023-11-08 12:25,2184,1300,884,246460,127602,118858,189117383.0,97738087.0,91379296.0,2175,1295,880,247518,128724,118794,189916561.0,98587012.0,91329548.0,0.766,0.7688,0.7659,0.7688
2023-11-08 12:30,1612,685,927,189081,53661,135420,145200218.0,41185265.0,104014953.0,1596,677,919,187945,53436,134509,144262791.0,40908353.0,103354438.0,0.7675,0.7681,0.7656,0.7684
2023-11-08 12:35,950,260,690,128145,23476,104669,98336155.0,17964096.0,80372058.0,938,250,688,128183,23363,104820,98357224.0,17869290.0,80487933.0,0.7652,0.7679,0.7649,0.7679
2023-11-08 12:40,1166,385,781,157357,34487,122870,120768565.0,26372889.0,94395675.0,1158,378,780,158615,34675,123940,121769846.0,26516531.0,95253315.0,0.7647,0.7683,0.7647,0.7685
2023-11-08 12:45,588,158,430,64752,12351,52401,49756249.0,9451668.0,40304580.0,577,147,430,64829,11967,52862,49816840.0,9157146.0,40659694.0,0.7653,0.7692,0.7652,0.7692
2023-11-08 12:50,1236,381,855,200271,57546,142725,153745733.0,43961549.0,109784184.0,1219,371,848,199600,57405,142195,153233309.0,43854582.0,109378727.0,0.7639,0.7692,0.764,0.7692
2023-11-08 12:55,1912,801,1111,231347,76061,155286,177676599.0,58243785.0,119432814.0,1881,777,1104,229030,75376,153654,175857864.0,57677851.0,118180012.0,0.7658,0.7691,0.7652,0.7691
2023-11-08 13:00,3322,1508,1814,432270,128919,303351,331872300.0,98663076.0,233209223.0,3245,1448,1797,430640,128184,302456,330611789.0,98100841.0,232510948.0,0.7653,0.7688,0.7653,0.7687
2023-11-08 13:05,1996,834,1162,285117,78927,206190,219028038.0,60462892.0,158565146.0,1982,826,1156,284686,78521,206165,218698096.0,60149980.0,158548115.0,0.7661,0.769,0.766,0.769
2023-11-08 13:10,1164,477,687,152633,44979,107654,117173775.0,34446953.0,82726822.0,1140,463,677,150666,43549,107117,115712341.0,33348742.0,82363599.0,0.7658,0.7685,0.7658,0.7689
2023-11-08 13:15,1164,695,469,157609,83673,73936,120839995.0,64071237.0,56768758.0,1152,689,463,156644,83262,73382,120138700.0,63756577.0,56382123.0,0.7657,0.7678,0.7657,0.7683
2023-11-08 13:20,1158,410,748,166289,60150,106139,127644704.0,46062263.0,81582441.0,1146,400,746,166155,59999,106156,127527476.0,45934516.0,81592960.0,0.7658,0.7686,0.7656,0.7686
2023-11-08 13:25,332,194,138,49507,31133,18374,37926823.0,23810339.0,14116484.0,324,192,132,49454,31000,18454,37889229.0,23709188.0,14180040.0,0.7648,0.7683,0.7648,0.7684
2023-11-08 13:30,1699,629,1070,233526,90775,142751,179288856.0,69477145.0,109811711.0,1686,623,1063,232969,90893,142076,178890115.0,69552773.0,109337341.0,0.7654,0.7693,0.7652,0.7696
2023-11-08 13:35,3370,956,2414,486210,57232,428978,371742443.0,43593711.0,328148732.0,3298,908,2390,478348,53504,424844,366171489.0,40761357.0,325410132.0,0.7617,0.765,0.7618,0.766
2023-11-08 13:40,328,54,274,46530,3073,43457,35625095.0,2343342.0,33281753.0,315,47,268,45520,3941,41579,34835917.0,2991905.0,31844012.0,0.7626,0.7659,0.7592,0.7659
2023-11-08 13:45,136,20,116,14631,670,13961,11182309.0,504290.0,10678019.0,126,16,110,14317,551,13766,10965547.0,418933.0,10546614.0,0.7527,0.7648,0.7603,0.7661
2023-11-08 13:50,204,40,164,30726,852,29874,23509420.0,649733.0,22859687.0,195,35,160,30521,1091,29430,23348706.0,831933.0,22516773.0,0.7626,0.7652,0.7625,0.7651
2023-11-08 13:55,874,439,435,100449,13204,87245,76548589.0,9994751.0,66553838.0,828,406,422,96156,11091,85065,73509081.0,8450481.0,65058599.0,0.7569,0.7628,0.7619,0.7648
2023-11-08 14:00,524,173,351,52895,10468,42427,40977660.0,8653928.0,32323732.0,459,125,334,42386,4285,38101,32377649.0,3249627.0,29128022.0,0.8267,0.7619,0.7584,0.7645
2023-11-08 14:05,141,102,39,9229,3793,5436,7244839.0,3083612.0,4161227.0,107,81,26,10797,5938,4859,8325711.0,4608119.0,3717592.0,0.813,0.7655,0.776,0.7651
2023-11-08 14:10,2136,995,1141,223489,84835,138654,169491850.0,64302872.0,105188978.0,1817,789,1028,206857,75391,131466,157263525.0,57134713.0,100128811.0,0.758,0.7586,0.7578,0.7616
2023-11-08 14:15,1591,899,692,186427,127848,58579,141555959.0,96967256.0,44588703.0,1534,861,673,183671,127064,56607,139493515.0,96358245.0,43135270.0,0.7585,0.7612,0.7583,0.762
2023-11-08 14:20,699,459,240,104023,82916,21107,79176422.0,63060507.0,16115915.0,662,438,224,101894,82254,19640,77410844.0,62444172.0,14966671.0,0.7605,0.7635,0.7592,0.7621
2023-11-08 14:25,176,141,35,18291,16281,2010,13904309.0,12367015.0,1537294.0,175,145,30,18344,16730,1614,13942377.0,12705335.0,1237042.0,0.7596,0.7648,0.7594,0.7664
2023-11-08 14:30,201,120,81,20707,15578,5129,15697816.0,11825644.0,3872172.0,183,108,75,20088,15561,4527,15266612.0,11808503.0,3458109.0,0.7591,0.755,0.7589,0.7639
2023-11-08 14:35,601,362,239,63576,40527,23049,48300732.0,30747881.0,17552851.0,579,346,233,62395,39543,22852,47432776.0,30010952.0,17421823.0,0.7587,0.7615,0.7589,0.7624
2023-11-08 14:40,2036,824,1212,205862,79233,126629,156527196.0,60084218.0,96442978.0,2027,824,1203,205869,79093,126776,156538579.0,59974343.0,96564236.0,0.7583,0.7616,0.7583,0.7617
2023-11-08 14:45,1311,412,899,198034,55032,143002,150726206.0,41716806.0,109009399.0,1291,402,889,197650,54992,142658,150451285.0,41704030.0,108747254.0,0.758,0.7623,0.7584,0.7623
2023-11-08 14:50,592,205,387,62144,20728,41416,47143453.0,15641488.0,31501965.0,570,193,377,57715,16712,41003,43905739.0,12667107.0,31238631.0,0.7546,0.7606,0.758,0.7619
2023-11-08 14:55,583,238,345,64589,22845,41744,49138735.0,17320287.0,31818448.0,558,219,339,62672,21171,41501,47678123.0,16042971.0,31635152.0,0.7582,0.7622,0.7578,0.7623
2023-11-08 15:00,337,126,211,28957,9201,19756,22017583.0,6977042.0,15040541.0,313,108,205,30088,8818,21270,22899783.0,6680913.0,16218869.0,0.7583,0.7613,0.7576,0.7625
2023-11-08 15:05,724,233,491,84562,12602,71960,64227101.0,9555290.0,54671810.0,657,177,480,81370,11058,70312,61954726.0,8379138.0,53575588.0,0.7582,0.7598,0.7577,0.762
2023-11-08 15:10,1316,554,762,144383,41159,103224,109542516.0,31229766.0,78312749.0,1264,523,741,139942,39232,100710,106332928.0,29704382.0,76628546.0,0.7588,0.7587,0.7571,0.7609
2023-11-08 15:15,2428,697,1731,329727,64200,265527,250710383.0,48552453.0,202157930.0,2328,615,1713,324925,61910,263015,247022667.0,46812797.0,200209869.0,0.7563,0.7613,0.7561,0.7612
2023-11-08 15:20,2229,801,1428,335523,56339,279184,254864425.0,42611307.0,212253117.0,2177,755,1422,334816,55602,279214,254329579.0,42048201.0,212281378.0,0.7563,0.7603,0.7562,0.7603
2023-11-08 15:25,2236,840,1396,369911,72383,297528,281008978.0,54777868.0,226231109.0,2205,824,1381,370457,73390,297067,281343598.0,55467809.0,225875788.0,0.7568,0.7604,0.7558,0.7604
2023-11-08 15:30,2005,1081,924,288629,183802,104827,219119479.0,139322499.0,79796979.0,1972,1059,913,285703,181495,104208,216877405.0,137546548.0,79330856.0,0.758,0.7612,0.7579,0.7613
2023-11-08 15:35,1700,946,754,229091,169343,59748,173795101.0,128347383.0,45447718.0,1680,931,749,228720,168964,59756,173520520.0,128061966.0,45458554.0,0.7579,0.7607,0.7579,0.7607
2023-11-08 15:40,1679,921,758,223994,149374,74620,169963700.0,113204458.0,56759242.0,1663,911,752,223973,149732,74241,169956585.0,113471266.0,56485318.0,0.7579,0.7606,0.7578,0.7608
2023-11-08 15:45,1256,697,559,159822,84179,75643,121344700.0,63790550.0,57554150.0,1235,681,554,158145,83451,74694,120086574.0,63242868.0,56843706.0,0.7578,0.7609,0.7578,0.761
2023-11-08 15:50,1812,509,1303,283402,70896,212506,215375513.0,53721963.0,161653549.0,1803,504,1299,283950,71435,212515,215781942.0,54124435.0,161657507.0,0.7578,0.7607,0.7577,0.7607
2023-11-08 15:55,1723,609,1114,272352,69614,202738,207058423.0,52775584.0,154282838.0,1708,603,1105,272411,69475,202936,207104542.0,52669131.0,154435410.0,0.7581,0.761,0.7581,0.761
2023-11-08 16:00,949,471,478,139756,57289,82467,106290476.0,43507347.0,62783129.0,930,458,472,138244,56514,81730,105074039.0,42849192.0,62224846.0,0.7594,0.7613,0.7582,0.7613
2023-11-08 16:05,452,145,307,40442,18210,22232,30767203.0,13843038.0,16924165.0,437,135,302,40017,18025,21992,30407052.0,13665763.0,16741288.0,0.7602,0.7613,0.7582,0.7612
2023-11-08 16:10,1598,908,690,212986,82497,130489,162153075.0,62607471.0,99545604.0,1576,898,678,212123,82287,129836,161445013.0,62425522.0,99019491.0,0.7589,0.7629,0.7586,0.7627
2023-11-08 16:15,1075,476,599,129666,39040,90626,98705065.0,29644208.0,69060857.0,1046,460,586,128863,38844,90019,98163387.0,29494728.0,68668659.0,0.7593,0.762,0.7593,0.7628
2023-11-08 16:20,415,266,149,35355,26013,9342,26873914.0,19762412.0,7111502.0,411,262,149,35480,26126,9354,26953685.0,19833723.0,7119962.0,0.7597,0.7612,0.7592,0.7612
2023-11-08 16:25,1949,596,1353,277435,70871,206564,211214850.0,53768371.0,157446479.0,1920,577,1343,276566,70477,206089,210541767.0,53448613.0,157093154.0,0.7587,0.7622,0.7584,0.7623
2023-11-08 16:30,1741,693,1048,256746,71728,185018,195215552.0,54363250.0,140852302.0,1717,681,1036,248085,69373,178712,188660988.0,52594696.0,136066291.0,0.7579,0.7613,0.7581,0.7614
2023-11-08 16:35,2073,628,1445,205277,21330,183947,155810806.0,16151500.0,139659306.0,2048,610,1438,204509,20837,183672,155229748.0,15779399.0,139450349.0,0.7572,0.7592,0.7573,0.7592
2023-11-08 16:40,1107,113,994,165200,7956,157244,125392276.0,6020292.0,119371984.0,1089,100,989,164779,7712,157067,125079004.0,5835466.0,119243538.0,0.7567,0.7592,0.7567,0.7592
2023-11-08 16:45,754,104,650,96721,4621,92100,73419430.0,3497154.0,69922276.0,737,82,655,96388,3975,92413,73170047.0,3008543.0,70161504.0,0.7568,0.7592,0.7569,0.7592
2023-11-08 16:50,755,151,604,112405,5671,106734,85340002.0,4300968.0,81039034.0,738,140,598,111796,5290,106506,84871028.0,4001776.0,80869251.0,0.7584,0.7593,0.7565,0.7593
2023-11-08 16:55,1365,174,1191,220891,9410,211481,167692221.0,7124873.0,160567348.0,1355,170,1185,220746,9422,211324,167580024.0,7130541.0,160449482.0,0.7572,0.7593,0.7568,0.7593
2023-11-08 17:00,526,107,419,68697,9197,59500,52166884.0,6973645.0,45193239.0,499,95,404,71409,8427,62982,54208294.0,6368600.0,47839693.0,0.7583,0.7596,0.7557,0.7596
2023-11-08 17:05,236,116,120,18086,5666,12420,13722516.0,4285001.0,9437514.0,220,108,112,18313,7380,10933,13815648.0,5505416.0,8310232.0,0.7563,0.7599,0.746,0.7601
2023-11-08 17:10,125,57,68,9570,3046,6524,7271878.0,2322313.0,4949565.0,115,48,67,9336,2663,6673,7079236.0,2012674.0,5066561.0,0.7624,0.7587,0.7558,0.7593
2023-11-08 17:15,107,50,57,5617,3041,2576,4258799.0,2301307.0,1957492.0,103,49,54,6093,4186,1907,4564918.0,3113582.0,1451335.0,0.7568,0.7599,0.7438,0.7611
2023-11-08 17:20,296,86,210,61836,3490,58346,46984027.0,2642148.0,44341879.0,285,78,207,56393,3235,53158,42849920.0,2447125.0,40402795.0,0.7571,0.76,0.7565,0.7601
2023-11-08 17:25,281,245,36,6995,5565,1430,5308365.0,4215971.0,1092394.0,268,234,34,6663,5199,1464,5058795.0,3939048.0,1119747.0,0.7576,0.7639,0.7577,0.7649
2023-11-08 17:30,249,142,107,21719,7990,13729,16514465.0,6052675.0,10461790.0,235,135,100,25762,7498,18264,19579364.0,5675762.0,13903602.0,0.7575,0.762,0.757,0.7613
2023-11-08 17:35,147,56,91,19268,3530,15738,14706788.0,2726437.0,11980351.0,134,48,86,18422,2819,15603,14012430.0,2131362.0,11881068.0,0.7724,0.7612,0.7561,0.7615
2023-11-08 17:40,913,573,340,96279,77150,19129,73108511.0,58558039.0,14550472.0,893,565,328,95194,76169,19025,72211172.0,57740469.0,14470702.0,0.759,0.7606,0.7581,0.7606
2023-11-08 17:45,1812,890,922,229675,138496,91179,174482381.0,105035537.0,69446843.0,1797,881,916,229312,138206,91106,174189083.0,104800182.0,69388900.0,0.7584,0.7617,0.7583,0.7616
2023-11-08 17:50,1318,1029,289,228741,158990,69751,173701022.0,120577573.0,53123449.0,1296,1018,278,227830,158828,69002,173003214.0,120443994.0,52559220.0,0.7584,0.7616,0.7583,0.7617
2023-11-08 17:55,483,344,139,71710,48104,23606,54442134.0,36480629.0,17961505.0,477,340,137,71912,48212,23700,54590341.0,36554289.0,18036052.0,0.7584,0.7609,0.7582,0.761
2023-11-08 18:00,714,281,433,99593,50806,48787,75646236.0,38521293.0,37124943.0,702,279,423,99634,51253,48381,75664572.0,38844970.0,36819601.0,0.7582,0.761,0.7579,0.761
2023-11-08 18:05,1852,1537,315,321565,251280,70285,244016669.0,190474199.0,53542469.0,1844,1532,312,321774,251128,70646,244178102.0,190356602.0,53821500.0,0.758,0.7618,0.758,0.7618
2023-11-08 18:10,1364,968,396,191207,126885,64322,145163654.0,96208248.0,48955406.0,1348,956,392,187183,123408,63775,142100440.0,93568888.0,48531552.0,0.7582,0.7611,0.7582,0.761
2023-11-08 18:15,144,80,64,15403,9357,6046,11672152.0,7081547.0,4590605.0,130,74,56,14996,9342,5654,11370970.0,7066748.0,4304221.0,0.7568,0.7593,0.7564,0.7613
2023-11-08 18:20,2459,658,1801,351504,92620,258884,267224133.0,70198540.0,197025593.0,2454,658,1796,349943,93044,256899,266163224.0,70557310.0,195605913.0,0.7579,0.7611,0.7583,0.7614
2023-11-08 18:25,1459,132,1327,242008,10331,231677,183990024.0,7816022.0,176174002.0,1434,116,1318,240603,10047,230556,182929673.0,7600555.0,175329118.0,0.7566,0.7604,0.7565,0.7605
2023-11-08 18:30,1606,254,1352,249016,20833,228183,189258646.0,15777126.0,173481519.0,1593,247,1346,248649,20831,227818,188981463.0,15771146.0,173210316.0,0.7573,0.7603,0.7571,0.7603
2023-11-08 18:35,10091,806,9285,1314703,59901,1254802,996876785.0,45322131.0,951554654.0,10068,795,9273,1310908,57019,1253889,994115518.0,43168379.0,950947138.0,0.7566,0.7583,0.7571,0.7584
2023-11-09 10:00,2564,1010,1554,218810,70271,148539,165398576.0,52292378.0,113106198.0,2063,761,1302,190284,53120,137164,143976334.0,39930642.0,104045691.0,0.7442,0.7615,0.7517,0.7585
2023-11-09 10:05,6880,1602,5278,1062302,130488,931814,804718177.0,98182836.0,706535340.0,6750,1518,5232,1058685,129824,928861,801913322.0,97686112.0,704227210.0,0.7524,0.7582,0.7525,0.7582
2023-11-09 10:10,5469,1366,4103,857583,99438,758145,649436466.0,74770536.0,574665930.0,5371,1302,4069,855033,97756,757277,647514384.0,73484381.0,574030003.0,0.7519,0.758,0.7517,0.758
2023-11-09 10:15,2039,633,1406,238257,36456,201801,179977362.0,27360800.0,152616562.0,1921,550,1371,234068,35573,198495,176962629.0,26693686.0,150268943.0,0.7505,0.7563,0.7504,0.757
2023-11-09 10:20,1656,559,1097,193257,20299,172958,146319930.0,15194807.0,131125123.0,1451,426,1025,188694,16722,171972,142401944.0,12525201.0,129876743.0,0.7485,0.7581,0.749,0.7552
2023-11-09 10:25,3495,1521,1974,452691,134216,318475,341244246.0,100817111.0,240427135.0,3427,1488,1939,449025,132801,316224,338343881.0,99612271.0,238731610.0,0.7512,0.7549,0.7501,0.7549
2023-11-09 10:30,3266,2232,1034,455050,273089,181961,342471487.0,205083128.0,137388358.0,3222,2210,1012,452916,271550,181366,340828902.0,203849876.0,136979026.0,0.751,0.755,0.7507,0.7553
2023-11-09 10:35,1497,890,607,180485,85321,95164,135917565.0,64109711.0,71807854.0,1458,865,593,180210,85208,95002,135702712.0,64013869.0,71688842.0,0.7514,0.7546,0.7513,0.7546
2023-11-09 10:40,2231,1701,530,282219,175867,106352,212540917.0,132299863.0,80241053.0,2201,1684,517,280607,175273,105334,211301974.0,131808678.0,79493295.0,0.7523,0.7545,0.752,0.7547
2023-11-09 10:45,4203,1604,2599,656439,199841,456598,494331095.0,149908711.0,344422384.0,4172,1583,2589,654956,199520,455436,493221611.0,149655274.0,343566337.0,0.7501,0.7543,0.7501,0.7544
2023-11-09 10:50,4953,1352,3601,868755,112775,755980,654094965.0,84484565.0,569610400.0,4725,1188,3537,855858,105254,750604,644549418.0,78869184.0,565680234.0,0.7491,0.7535,0.7493,0.7536
2023-11-09 10:55,1890,405,1485,272684,16498,256186,204828646.0,12296420.0,192532226.0,1747,313,1434,267350,15520,251830,201002722.0,11554890.0,189447831.0,0.7453,0.7515,0.7445,0.7523
2023-11-09 11:00,1449,686,763,165672,29370,136302,124124298.0,22004250.0,102120047.0,1353,620,733,163497,27661,135836,122439291.0,20632008.0,101807282.0,0.7492,0.7492,0.7459,0.7495
2023-11-09 11:05,4619,1648,2971,662936,92309,570627,495429968.0,69284894.0,426145074.0,4383,1491,2892,642639,82801,559838,479939082.0,61534485.0,418404596.0,0.7506,0.7468,0.7432,0.7474
2023-11-09 11:10,1072,317,755,179190,13495,165695,133828627.0,10143143.0,123685483.0,948,230,718,171787,10336,161451,128198021.0,7673452.0,120524569.0,0.7516,0.7465,0.7424,0.7465
2023-11-09 11:15,953,579,374,89701,17992,71709,66965704.0,13432778.0,53532926.0,873,522,351,88038,16576,71462,65718666.0,12348882.0,53369783.0,0.7466,0.7465,0.745,0.7468
2023-11-09 11:20,252,57,195,40148,2729,37419,29985608.0,2040329.0,27945278.0,222,42,180,38582,2369,36213,28800952.0,1757698.0,27043254.0,0.7476,0.7468,0.742,0.7468
2023-11-09 11:25,302,113,189,30117,4049,26068,23148889.0,3714657.0,19434232.0,255,91,164,32186,7015,25171,24649903.0,5863059.0,18786843.0,0.9174,0.7455,0.8358,0.7464
2023-11-09 11:30,893,275,618,119325,12280,107045,88835088.0,9131245.0,79703842.0,832,249,583,117328,11808,105520,87395300.0,8772732.0,78622568.0,0.7436,0.7446,0.7429,0.7451
2023-11-09 11:35,1284,392,892,168258,24171,144087,125406420.0,17990247.0,107416172.0,1232,346,886,161868,18861,143007,120619374.0,13995894.0,106623480.0,0.7443,0.7455,0.7421,0.7456
2023-11-09 11:40,1681,898,783,204887,137214,67673,152517522.0,102020984.0,50496537.0,1647,880,767,207030,137577,69453,154091401.0,102256601.0,51834799.0,0.7435,0.7462,0.7433,0.7463
2023-11-09 11:45,2262,1117,1145,323867,169321,154546,241012364.0,125832837.0,115179527.0,2232,1103,1129,325012,171316,153696,242540232.0,127945150.0,114595081.0,0.7432,0.7453,0.7468,0.7456
2023-11-09 11:50,737,327,410,46482,30647,15835,34649683.0,22830579.0,11819103.0,711,307,404,48797,33443,15354,35962994.0,24511947.0,11451047.0,0.745,0.7464,0.7329,0.7458
2023-11-09 11:55,233,145,88,24637,13482,11155,18402328.0,10040465.0,8361863.0,194,111,83,23821,12888,10933,17783572.0,9591415.0,8192157.0,0.7447,0.7496,0.7442,0.7493
2023-11-09 12:00,322,276,46,33777,30207,3570,25146838.0,22478507.0,2668331.0,300,258,42,33316,30011,3305,24802141.0,22331026.0,2471114.0,0.7441,0.7474,0.7441,0.7477
2023-11-09 12:05,189,74,115,23209,10657,12552,17327075.0,7937446.0,9389629.0,166,61,105,20853,8608,12245,15569354.0,6406956.0,9162398.0,0.7448,0.7481,0.7443,0.7483
2023-11-09 12:10,2007,1178,829,252336,147027,105309,188823784.0,109842871.0,78980912.0,1955,1163,792,250857,146771,104086,187638573.0,109564121.0,78074451.0,0.7471,0.75,0.7465,0.7501
2023-11-09 12:15,1830,1278,552,218344,150853,67491,163130419.0,112543726.0,50586693.0,1822,1277,545,215817,150363,65454,161258054.0,112178033.0,49080021.0,0.746,0.7495,0.746,0.7498
2023-11-09 12:20,826,485,341,102758,71443,31315,76829793.0,53354710.0,23475082.0,780,454,326,100654,69497,31157,75228523.0,51865020.0,23363502.0,0.7468,0.7496,0.7463,0.7499
2023-11-09 12:25,342,255,87,41566,31532,10034,31077409.0,23550038.0,7527371.0,332,252,80,41285,31589,9696,30868460.0,23589267.0,7279193.0,0.7469,0.7502,0.7468,0.7507
2023-11-09 12:30,1955,1371,584,263192,152967,110225,196875948.0,114220614.0,82655333.0,1937,1358,579,263574,153493,110081,197160857.0,114613888.0,82546969.0,0.7467,0.7499,0.7467,0.7499
2023-11-09 12:35,2284,1502,782,294818,184863,109955,220295185.0,137957985.0,82337200.0,2250,1479,771,293621,184469,109152,219434671.0,137661542.0,81773129.0,0.7463,0.7488,0.7463,0.7492
2023-11-09 12:40,961,167,794,165611,10241,155370,123702022.0,7630269.0,116071752.0,954,165,789,163971,10187,153784,122549797.0,7588268.0,114961529.0,0.7451,0.7471,0.7449,0.7476
2023-11-09 12:45,2395,518,1877,379727,42020,337707,283638369.0,31243256.0,252395113.0,2364,503,1861,376330,40214,336116,281164975.0,29952840.0,251212134.0,0.7435,0.7474,0.7448,0.7474
2023-11-09 12:50,4905,1211,3694,754841,72289,682552,564758480.0,55574132.0,509184348.0,4773,1111,3662,742617,63921,678696,553778820.0,47429808.0,506349012.0,0.7688,0.746,0.742,0.7461
2023-11-09 12:55,2989,1021,1968,462990,46960,416030,343902868.0,34629060.0,309273807.0,2704,825,1879,449902,38685,411217,334407580.0,28553512.0,305854068.0,0.7374,0.7434,0.7381,0.7438
2023-11-09 13:00,942,378,564,116929,15215,101714,87959841.0,12539058.0,75420783.0,790,259,531,113618,14295,99323,85482352.0,11813364.0,73668988.0,0.8241,0.7415,0.8264,0.7417
2023-11-09 13:05,309,121,188,57483,4651,52832,42584618.0,3431289.0,39153329.0,278,103,175,56055,3510,52545,41524425.0,2580649.0,38943776.0,0.7378,0.7411,0.7352,0.7412
2023-11-09 13:10,1377,897,480,176633,107644,68989,131978041.0,80739078.0,51238962.0,1305,855,450,172979,105075,67904,128807704.0,78369060.0,50438644.0,0.7501,0.7427,0.7458,0.7428
2023-11-09 13:15,2518,1763,755,353003,272075,80928,261690376.0,201515163.0,60175213.0,2472,1749,723,348985,270704,78281,258713643.0,200493868.0,58219775.0,0.7407,0.7436,0.7406,0.7437
2023-11-09 13:20,2482,1728,754,424029,327526,96503,314442123.0,242702747.0,71739376.0,2450,1704,746,423577,327469,96108,314115154.0,242640233.0,71474920.0,0.741,0.7434,0.741,0.7437
2023-11-09 13:25,220,118,102,26484,13574,12910,19682743.0,10056932.0,9625811.0,216,123,93,24501,13697,10804,18160914.0,10120120.0,8040794.0,0.7409,0.7456,0.7389,0.7442
2023-11-09 13:30,1286,715,571,150761,75020,75741,113197590.0,56879962.0,56317628.0,1251,691,560,149073,73912,75161,112005674.0,56077111.0,55928563.0,0.7582,0.7436,0.7587,0.7441
2023-11-09 13:35,2146,578,1568,277453,45905,231548,205714914.0,33896407.0,171818507.0,2063,514,1549,273549,43614,229935,202849284.0,32199781.0,170649503.0,0.7384,0.742,0.7383,0.7422
2023-11-09 13:40,1719,653,1066,233332,64167,169165,173109459.0,47433921.0,125675537.0,1683,633,1050,230587,62707,167880,171070355.0,46336908.0,124733447.0,0.7392,0.7429,0.7389,0.743
2023-11-09 13:45,198,80,118,15614,4554,11060,11535704.0,3362578.0,8173125.0,178,67,111,14945,4487,10458,11074409.0,3311547.0,7762861.0,0.7384,0.739,0.738,0.7423
2023-11-09 13:50,510,86,424,50607,5068,45539,37687882.0,3803277.0,33884605.0,478,67,411,47774,4586,43188,35533865.0,3383840.0,32150025.0,0.7504,0.7441,0.7379,0.7444
2023-11-09 13:55,2056,973,1083,338948,120296,218652,251468458.0,88986896.0,162481561.0,2003,944,1059,333515,116853,216662,247417578.0,86426482.0,160991095.0,0.7397,0.7431,0.7396,0.7431
2023-11-09 14:00,2230,1558,672,348387,266865,81522,258410512.0,197596641.0,60813870.0,2203,1551,652,348818,268302,80516,258679873.0,198627699.0,60052174.0,0.7404,0.746,0.7403,0.7458
2023-11-09 14:05,2174,852,1322,326961,123289,203672,242403786.0,91165785.0,151238001.0,2115,815,1300,322052,121891,200161,238776061.0,90138247.0,148637813.0,0.7394,0.7426,0.7395,0.7426
2023-11-09 14:10,2636,805,1831,386554,83673,302881,286917828.0,61911684.0,225006144.0,2612,787,1825,384875,82328,302547,285665794.0,60908738.0,224757056.0,0.7399,0.7429,0.7398,0.7429
2023-11-09 14:15,2158,803,1355,274504,107385,167119,203763509.0,79387905.0,124375603.0,2141,789,1352,273592,106578,167014,203059534.0,78770245.0,124289288.0,0.7393,0.7442,0.7391,0.7442
2023-11-09 14:20,1962,598,1364,281776,69387,212389,209407731.0,51396764.0,158010966.0,1944,589,1355,280673,68463,212210,208533529.0,50655278.0,157878251.0,0.7407,0.744,0.7399,0.744
2023-11-09 14:25,526,144,382,50814,13109,37705,37745163.0,9707374.0,28037788.0,509,134,375,50716,13072,37644,37670795.0,9674419.0,27996376.0,0.7405,0.7436,0.7401,0.7437
2023-11-09 14:30,2116,1295,821,286166,210344,75822,212532807.0,156112317.0,56420490.0,2088,1282,806,283640,208970,74670,210541766.0,154988709.0,55553057.0,0.7422,0.7441,0.7417,0.744
2023-11-09 14:35,1051,931,120,170295,160940,9355,126325486.0,119364268.0,6961218.0,1025,918,107,168596,160567,8029,125070143.0,119083458.0,5986685.0,0.7417,0.7441,0.7416,0.7456
2023-11-09 14:40,1044,737,307,132341,104730,27611,98285861.0,77649781.0,20636080.0,1034,732,302,132756,104723,28033,98670977.0,77645086.0,21025891.0,0.7414,0.7474,0.7414,0.75
2023-11-09 14:45,1984,680,1304,246455,93202,153253,183129023.0,69059856.0,114069167.0,1955,658,1297,245073,92548,152525,182099728.0,68571802.0,113527925.0,0.741,0.7443,0.7409,0.7443
2023-11-09 14:50,3106,758,2348,397231,89672,307559,295030788.0,66397291.0,228633496.0,3076,737,2339,397548,88918,308630,295346102.0,65830360.0,229515742.0,0.7404,0.7434,0.7403,0.7437
2023-11-09 14:55,3300,2304,996,457671,361929,95742,340722709.0,269274014.0,71448695.0,3186,2229,957,450232,356979,93253,334702812.0,265100461.0,69602351.0,0.744,0.7463,0.7426,0.7464
2023-11-09 15:00,7893,5419,2474,1098804,880828,217976,818454309.0,655409437.0,163044872.0,7800,5361,2439,1095701,878754,216947,815946577.0,653667603.0,162278973.0,0.7441,0.748,0.7439,0.748
2023-11-09 15:05,3106,2224,882,431086,368507,62579,321145877.0,274315588.0,46830289.0,3054,2192,862,427318,366986,60332,318243516.0,273081237.0,45162279.0,0.7444,0.7483,0.7441,0.7486
2023-11-09 15:10,1910,1033,877,319058,261143,57915,237008905.0,193787118.0,43221787.0,1872,1009,863,315988,259448,56540,234724403.0,192528042.0,42196361.0,0.7421,0.7463,0.7421,0.7463
2023-11-09 15:15,1319,952,367,214434,191488,22946,159211103.0,142120336.0,17090766.0,1274,919,355,210817,189175,21642,156486086.0,140350664.0,16135421.0,0.7422,0.7448,0.7419,0.7456
2023-11-09 15:20,236,107,129,24717,15850,8867,18292561.0,11741851.0,6550710.0,203,83,120,22672,14464,8208,16827701.0,10715296.0,6112405.0,0.7408,0.7388,0.7408,0.7447
2023-11-09 15:25,428,306,122,82741,75868,6873,61371895.0,56256666.0,5115228.0,404,286,118,81914,75548,6366,60731376.0,55993666.0,4737710.0,0.7415,0.7442,0.7412,0.7442
2023-11-09 15:30,483,241,242,74210,49921,24289,55102435.0,37029348.0,18073086.0,465,225,240,73139,49340,23799,54282559.0,36573135.0,17709424.0,0.7418,0.7441,0.7412,0.7441
2023-11-09 15:35,3236,1813,1423,526806,383033,143773,391564571.0,284344573.0,107219998.0,3201,1796,1405,522964,380758,142206,388701987.0,282650818.0,106051168.0,0.7424,0.7458,0.7423,0.7458
2023-11-09 15:40,1893,1212,681,356365,287900,68465,264621567.0,213606383.0,51015184.0,1892,1211,681,356161,287770,68391,264468575.0,213508902.0,50959673.0,0.7419,0.7451,0.7419,0.7451
2023-11-09 15:45,1030,646,384,185620,141791,43829,138083305.0,105128670.0,32954635.0,1001,629,372,177362,141368,35994,131633309.0,104810822.0,26822487.0,0.7414,0.7519,0.7414,0.7452
2023-11-09 15:50,1413,739,674,207929,161530,46399,154236649.0,119741922.0,34494726.0,1389,723,666,205967,160459,45508,152831875.0,118943058.0,33888817.0,0.7413,0.7434,0.7413,0.7447
2023-11-09 15:55,2120,1002,1118,330479,181988,148491,245574258.0,135026110.0,110548147.0,2093,986,1107,328790,181071,147719,244313958.0,134288020.0,110025938.0,0.742,0.7445,0.7416,0.7448
2023-11-09 16:00,1564,649,915,191869,75412,116457,143384385.0,56662769.0,86721615.0,1549,640,909,190162,74398,115764,142068090.0,55860724.0,86207365.0,0.7514,0.7447,0.7508,0.7447
2023-11-09 16:05,1219,538,681,167994,42496,125498,125026886.0,31544806.0,93482079.0,1207,533,674,167286,42399,124887,124491282.0,31473033.0,93018249.0,0.7423,0.7449,0.7423,0.7448
2023-11-09 16:10,1099,572,527,149235,102391,46844,110916545.0,76036457.0,34880088.0,1091,569,522,148796,101753,47043,110619113.0,75560516.0,35058597.0,0.7426,0.7446,0.7426,0.7452
2023-11-09 16:15,3133,1207,1926,421977,240608,181369,313780281.0,178663993.0,135116287.0,3127,1204,1923,421710,240304,181406,313581781.0,178438571.0,135143210.0,0.7426,0.745,0.7426,0.745
2023-11-09 16:20,1146,491,655,151918,75180,76738,112905180.0,55810389.0,57094791.0,1126,483,643,150947,75328,75619,112235980.0,55917376.0,56318603.0,0.7424,0.744,0.7423,0.7448
2023-11-09 16:25,1109,349,760,150148,47754,102394,112342558.0,36094596.0,76247962.0,1106,349,757,150243,47788,102455,112413715.0,36120132.0,76293583.0,0.7558,0.7447,0.7558,0.7447
2023-11-09 16:30,2490,619,1871,381538,124041,257497,284420473.0,92684845.0,191735627.0,2481,615,1866,381671,124207,257464,284526098.0,92814119.0,191711978.0,0.7472,0.7446,0.7473,0.7446
2023-11-09 16:35,867,160,707,105142,29869,75273,78176897.0,22155031.0,56021865.0,854,154,700,104728,29593,75135,77882784.0,21949896.0,55932888.0,0.7417,0.7442,0.7417,0.7444
2023-11-09 16:40,864,260,604,108909,50961,57948,80945728.0,37815645.0,43130083.0,842,243,599,107451,49802,57649,79852882.0,36949601.0,42903281.0,0.7421,0.7443,0.7419,0.7442
2023-11-09 16:45,874,394,480,132620,75101,57519,98619573.0,55771439.0,42848133.0,867,389,478,132664,74894,57770,98657560.0,55617287.0,43040273.0,0.7426,0.7449,0.7426,0.745
2023-11-09 16:50,1301,916,385,224369,165456,58913,166472028.0,122588010.0,43884018.0,1289,908,381,217710,159363,58347,161799380.0,118343767.0,43455613.0,0.7409,0.7449,0.7426,0.7448
2023-11-09 16:55,2551,1295,1256,358183,208088,150095,266921035.0,154950042.0,111970993.0,2512,1280,1232,353475,205988,147487,263095215.0,153068509.0,110026706.0,0.7446,0.746,0.7431,0.746
2023-11-09 17:00,1070,334,736,126718,68372,58346,94235499.0,50773058.0,43462440.0,1054,325,729,126390,68166,58224,94002707.0,50619902.0,43382804.0,0.7426,0.7449,0.7426,0.7451
2023-11-09 17:05,288,124,164,34525,18268,16257,25659710.0,13551591.0,12108119.0,267,109,158,32478,17585,14893,24135708.0,13039317.0,11096390.0,0.7418,0.7448,0.7415,0.7451
2023-11-09 17:10,129,70,59,16378,9574,6804,12188302.0,7121040.0,5067261.0,122,64,58,16278,9285,6993,12082584.0,6873824.0,5208759.0,0.7438,0.7447,0.7403,0.7449
2023-11-09 17:15,483,167,316,77366,18588,58778,57505263.0,13782737.0,43722525.0,468,154,314,77301,18617,58684,57510654.0,13804293.0,43706361.0,0.7415,0.7439,0.7415,0.7448
2023-11-09 17:20,954,290,664,129183,36706,92477,96036254.0,27212534.0,68823720.0,937,276,661,128857,36100,92757,95827144.0,26756842.0,69070301.0,0.7414,0.7442,0.7412,0.7446
2023-11-09 17:25,1802,833,969,233417,92787,140630,173397956.0,68788599.0,104609357.0,1782,819,963,232474,92499,139975,173398770.0,69192995.0,104205775.0,0.7414,0.7439,0.748,0.7445
2023-11-09 17:30,391,205,186,57219,25914,31305,42473848.0,19175617.0,23298231.0,361,183,178,54883,25091,29792,40747343.0,18563812.0,22183531.0,0.74,0.7442,0.7399,0.7446
2023-11-09 17:35,185,93,92,24529,9426,15103,18204185.0,6967456.0,11236729.0,147,66,81,24128,9413,14715,17905567.0,6949057.0,10956510.0,0.7392,0.744,0.7382,0.7446
2023-11-09 17:40,630,385,245,80335,39887,40448,59588706.0,29511512.0,30077194.0,590,364,226,77817,38815,39002,57702256.0,28689344.0,29012912.0,0.7399,0.7436,0.7391,0.7439
2023-11-09 17:45,137,85,52,12290,6364,5926,9101312.0,4703439.0,4397873.0,120,72,48,11492,6248,5244,8511377.0,4617009.0,3894368.0,0.7391,0.7421,0.739,0.7426
2023-11-09 17:50,761,301,460,131745,38386,93359,97707018.0,28339543.0,69367474.0,741,280,461,133488,37841,95647,99047575.0,27934521.0,71113054.0,0.7383,0.743,0.7382,0.7435
2023-11-09 17:55,1327,457,870,198703,75889,122814,147174644.0,56038959.0,91135684.0,1298,436,862,196659,74913,121746,145650320.0,55304759.0,90345561.0,0.7384,0.7421,0.7383,0.7421
2023-11-09 18:00,773,306,467,99221,44156,55065,73386671.0,32564368.0,40822303.0,751,291,460,99294,44766,54528,73430889.0,33001357.0,40429531.0,0.7375,0.7413,0.7372,0.7414
2023-11-09 18:05,3573,1814,1759,462359,252539,209820,342512915.0,187788325.0,154724589.0,3147,1567,1580,425462,233499,191963,314074011.0,172019327.0,142054683.0,0.7436,0.7374,0.7367,0.74
2023-11-09 18:10,4054,2492,1562,600245,439401,160844,445066816.0,325500411.0,119566404.0,3961,2465,1496,591795,435067,156728,437983227.0,321477893.0,116505334.0,0.7408,0.7434,0.7389,0.7434
2023-11-09 18:15,5205,3171,2034,777473,601513,175960,578582693.0,447149791.0,131432901.0,5057,3090,1967,764634,592885,171749,568330210.0,440034006.0,128296203.0,0.7434,0.7469,0.7422,0.747
2023-11-09 18:20,4657,3494,1163,849960,750179,99781,632128471.0,557605876.0,74522595.0,4619,3476,1143,847436,748640,98796,630067544.0,556263238.0,73804306.0,0.7433,0.7469,0.743,0.747
2023-11-09 18:25,5346,4156,1190,940907,822715,118192,700130403.0,611798694.0,88331709.0,5278,4134,1144,938322,821434,116888,697920289.0,610550960.0,87369329.0,0.7436,0.7474,0.7433,0.7475
2023-11-09 18:30,3196,2092,1104,500843,401764,99079,373360488.0,299297905.0,74062582.0,3103,2046,1057,496718,399712,97006,370132953.0,297511477.0,72621475.0,0.745,0.7475,0.7443,0.7486
2023-11-09 18:35,4216,3145,1071,672388,589666,82722,503284712.0,440874211.0,62410501.0,4024,3066,958,658911,583669,75242,492770191.0,435919972.0,56850219.0,0.7477,0.7545,0.7469,0.7556
2023-11-10 10:00,3690,1824,1866,390771,180983,209788,294260689.0,135115769.0,159144920.0,3284,1636,1648,367937,170288,197649,276456516.0,127537679.0,148918836.0,0.7466,0.7586,0.749,0.7535
2023-11-10 10:05,2138,1050,1088,252622,109328,143294,188964858.0,81596879.0,107367978.0,2036,996,1040,248524,107551,140973,186050093.0,80223386.0,105826706.0,0.7463,0.7493,0.7459,0.7507
2023-11-10 10:10,2008,843,1165,236785,61575,175210,176760109.0,45741382.0,131018726.0,1966,827,1139,235692,61277,174415,176044563.0,45536677.0,130507886.0,0.7429,0.7478,0.7431,0.7483
2023-11-10 10:15,1859,909,950,183321,95533,87788,136562072.0,70997955.0,65564117.0,1722,848,874,179085,93631,85454,133361000.0,69546339.0,63814661.0,0.7432,0.7468,0.7428,0.7468
2023-11-10 10:20,2267,1228,1039,183099,100956,82143,136443554.0,75089618.0,61353935.0,2213,1200,1013,180258,98754,81504,134327506.0,73406632.0,60920874.0,0.7438,0.7469,0.7433,0.7475
2023-11-10 10:25,1509,894,615,166263,67380,98883,123541099.0,50075222.0,73465876.0,1461,863,598,162971,67598,95373,121374788.0,50236066.0,71138721.0,0.7432,0.743,0.7432,0.7459
2023-11-10 10:30,3240,1339,1901,492445,119416,373029,367086708.0,88673392.0,278413316.0,3159,1295,1864,488285,116575,371710,364005956.0,86565103.0,277440853.0,0.7426,0.7464,0.7426,0.7464
2023-11-10 10:35,1137,805,332,126741,54883,71858,94345078.0,40764975.0,53580103.0,1090,777,313,126016,54268,71748,93804305.0,40302821.0,53501483.0,0.7428,0.7456,0.7427,0.7457
2023-11-10 10:40,3818,2202,1616,495617,218000,277617,368930244.0,161850382.0,207079861.0,3749,2151,1598,493253,216806,276447,367149887.0,160938627.0,206211260.0,0.7424,0.7459,0.7423,0.7459
2023-11-10 10:45,2160,734,1426,319890,59044,260846,238479542.0,43885918.0,194593623.0,2138,725,1413,319554,58975,260579,238229169.0,43833126.0,194396043.0,0.7433,0.746,0.7432,0.746
2023-11-10 10:50,1131,610,521,134462,30274,104188,100387860.0,22572503.0,77815357.0,1094,588,506,132867,29395,103472,99138950.0,21855738.0,77283212.0,0.7456,0.7469,0.7435,0.7469
2023-11-10 10:55,1039,545,494,138005,71757,66248,103245082.0,53801225.0,49443857.0,948,486,462,133104,68224,64880,99189138.0,50768578.0,48420559.0,0.7498,0.7463,0.7441,0.7463
2023-11-10 11:00,1316,645,671,144674,63100,81574,107854144.0,46937393.0,60916751.0,1291,639,652,144276,63270,81006,107552622.0,47062024.0,60490598.0,0.7439,0.7468,0.7438,0.7467
2023-11-10 11:05,1888,940,948,253956,111204,142752,189226595.0,82665540.0,106561055.0,1868,925,943,253409,110866,142543,188798555.0,82393546.0,106405009.0,0.7434,0.7465,0.7432,0.7465
2023-11-10 11:10,1452,782,670,182718,115214,67504,136061280.0,85684118.0,50377161.0,1426,771,655,181754,115023,66731,135354686.0,85546975.0,49807711.0,0.7437,0.7463,0.7437,0.7464
2023-11-10 11:15,763,449,314,73862,33830,40032,55007399.0,25142012.0,29865387.0,747,444,303,73491,33746,39745,54717160.0,25068300.0,29648860.0,0.7432,0.746,0.7429,0.746
2023-11-10 11:20,605,127,478,46192,15009,31183,34396683.0,11143518.0,23253165.0,597,120,477,45836,14563,31273,34137113.0,10817109.0,23320004.0,0.7425,0.7457,0.7428,0.7457
2023-11-10 11:25,886,238,648,84320,36107,48213,62745276.0,26845173.0,35900102.0,861,224,637,82481,35411,47070,61453605.0,26327759.0,35125846.0,0.7435,0.7446,0.7435,0.7462
2023-11-10 11:30,2272,1026,1246,270205,141726,128479,201306553.0,105388687.0,95917866.0,2256,1017,1239,269522,141395,128127,200794402.0,105141865.0,95652536.0,0.7436,0.7466,0.7436,0.7465
2023-11-10 11:35,1174,474,700,146676,63565,83111,109234559.0,47251260.0,61983299.0,1159,469,690,146009,63221,82788,108758179.0,46993592.0,61764586.0,0.7434,0.7458,0.7433,0.7461
2023-11-10 11:40,1578,496,1082,201747,48848,152899,150362179.0,36307341.0,114054838.0,1563,486,1077,201659,48850,152809,150296496.0,36308456.0,113988040.0,0.7433,0.7459,0.7433,0.746
2023-11-10 11:45,660,164,496,55225,15116,40109,41052681.0,11216682.0,29835999.0,645,159,486,54628,15158,39470,40669415.0,11242355.0,29427059.0,0.742,0.7439,0.7417,0.7456
2023-11-10 11:50,3791,1585,2206,532019,244503,287516,395805368.0,181455505.0,214349863.0,3770,1578,2192,531601,244677,286924,395502721.0,181584511.0,213918209.0,0.7421,0.7455,0.7421,0.7456
2023-11-10 11:55,313,132,181,51449,22133,29316,38268657.0,16410712.0,21857944.0,297,126,171,50289,22089,28200,37407869.0,16374896.0,21032973.0,0.7415,0.7456,0.7413,0.7459
2023-11-10 12:00,1448,659,789,229780,81289,148491,170973748.0,60326829.0,110646919.0,1424,639,785,228468,79915,148553,170001102.0,59297308.0,110703793.0,0.7421,0.7451,0.742,0.7452
2023-11-10 12:05,1020,303,717,185543,42472,143071,138026474.0,31510779.0,106515694.0,992,286,706,183607,41906,141701,136657925.0,31073950.0,105583975.0,0.7419,0.7445,0.7415,0.7451
2023-11-10 12:10,514,184,330,86427,26200,60227,64305871.0,19435074.0,44870796.0,501,176,325,86939,26381,60558,64684679.0,19558643.0,45126036.0,0.7418,0.745,0.7414,0.7452
2023-11-10 12:15,169,69,100,24140,9580,14560,17943679.0,7103857.0,10839821.0,145,56,89,20818,7527,13291,15482998.0,5579206.0,9903792.0,0.7415,0.7445,0.7412,0.7452
2023-11-10 12:20,414,186,228,55435,20925,34510,41288085.0,15533704.0,25754380.0,393,176,217,55587,21274,34313,41399632.0,15785780.0,25613852.0,0.7424,0.7463,0.742,0.7465
2023-11-10 12:25,1003,628,375,121282,88812,32470,90063338.0,65879220.0,24184117.0,975,615,360,120447,88366,32081,89447595.0,65549399.0,23898195.0,0.7418,0.7448,0.7418,0.7449
2023-11-10 12:30,379,123,256,33515,10523,22992,24885037.0,7791541.0,17093496.0,363,113,250,33149,10450,22699,24630368.0,7740118.0,16890250.0,0.7404,0.7435,0.7407,0.7441
2023-11-10 12:35,751,390,361,82908,42814,40094,61477039.0,31703488.0,29773551.0,725,371,354,82989,43414,39575,61557982.0,32144855.0,29413126.0,0.7405,0.7426,0.7404,0.7432
2023-11-10 12:40,551,193,358,52679,11061,41618,39108864.0,8193383.0,30915480.0,539,185,354,52484,11062,41422,38969497.0,8189208.0,30780288.0,0.7407,0.7428,0.7403,0.7431
2023-11-10 12:45,980,244,736,115492,13266,102226,85780845.0,9825314.0,75955530.0,939,211,728,115000,13088,101912,85412230.0,9685720.0,75726510.0,0.7406,0.743,0.74,0.7431
2023-11-10 12:50,937,295,642,125081,23149,101932,92870610.0,17139524.0,75731086.0,913,279,634,124735,22854,101881,92622740.0,16912680.0,75710060.0,0.7404,0.743,0.74,0.7431
2023-11-10 12:55,637,168,469,115980,7308,108672,86206819.0,5407787.0,80799032.0,616,151,465,114850,6377,108473,85411619.0,4718137.0,80693481.0,0.74,0.7435,0.7399,0.7439
2023-11-10 13:00,667,332,335,67210,17100,50110,49874573.0,12652381.0,37222191.0,641,319,322,65585,16026,49559,48704218.0,11853909.0,36850308.0,0.7399,0.7428,0.7397,0.7436
2023-11-10 13:05,554,181,373,29410,11506,17904,21730501.0,8461237.0,13269264.0,532,173,359,28648,11134,17514,21227099.0,8224206.0,13002893.0,0.7354,0.7411,0.7387,0.7424
2023-11-10 13:10,415,107,308,18668,6914,11754,13839130.0,5118543.0,8720587.0,397,93,304,18476,6938,11538,13693798.0,5134276.0,8559522.0,0.7403,0.7419,0.74,0.7419
2023-11-10 13:15,186,103,83,6519,4255,2264,4873517.0,3190454.0,1683063.0,163,89,74,6181,4039,2142,4579864.0,2986944.0,1592919.0,0.7498,0.7434,0.7395,0.7437
2023-11-10 13:20,154,75,79,4749,2718,2031,3526713.0,2012415.0,1514298.0,141,68,73,4261,2341,1920,3162336.0,1732431.0,1429905.0,0.7404,0.7456,0.74,0.7447
2023-11-10 13:25,785,363,422,47841,33230,14611,35471856.0,24619461.0,10852395.0,766,355,411,47676,32982,14694,35347671.0,24430661.0,10917009.0,0.7409,0.7428,0.7407,0.743
2023-11-10 13:30,345,200,145,31802,27797,4005,23518925.0,20540492.0,2978433.0,335,198,137,31218,27529,3689,23084481.0,20341627.0,2742854.0,0.7389,0.7437,0.7389,0.7435
2023-11-10 13:35,876,568,308,57220,44072,13148,42399151.0,32628523.0,9770627.0,859,562,297,57018,44430,12588,42248750.0,32895740.0,9353010.0,0.7403,0.7431,0.7404,0.743
2023-11-10 13:40,378,177,201,32641,11282,21359,24196289.0,8337313.0,15858975.0,356,166,190,31777,11088,20689,23565924.0,8189768.0,15376155.0,0.739,0.7425,0.7386,0.7432
2023-11-10 13:45,1068,380,688,103895,21470,82425,77088672.0,15878918.0,61209754.0,1052,374,678,103591,21522,82069,76862492.0,15915000.0,60947492.0,0.7396,0.7426,0.7395,0.7426
2023-11-10 13:50,813,282,531,61824,11776,50048,45866165.0,8718521.0,37147643.0,801,274,527,61929,11744,50185,45947573.0,8694189.0,37253383.0,0.7404,0.7422,0.7403,0.7423
2023-11-10 13:55,435,191,244,32650,7539,25111,24223990.0,5593393.0,18630596.0,414,181,233,32036,7319,24717,23765283.0,5415791.0,18349492.0,0.7419,0.7419,0.74,0.7424
2023-11-10 14:00,255,202,53,10866,6242,4624,8071914.0,4632584.0,3439329.0,255,196,59,11915,6595,5320,8842326.0,4884871.0,3957454.0,0.7422,0.7438,0.7407,0.7439
2023-11-10 14:05,153,91,62,6795,4797,1998,5032388.0,3550747.0,1481641.0,142,84,58,4610,2597,2013,3419746.0,1923929.0,1495816.0,0.7402,0.7416,0.7408,0.7431
2023-11-10 14:10,401,90,311,69295,4762,64533,51546123.0,3522132.0,48023991.0,383,85,298,68654,4700,63954,51075766.0,3475285.0,47600480.0,0.7396,0.7442,0.7394,0.7443
2023-11-10 14:15,374,101,273,27836,5237,22599,20672837.0,3870756.0,16802080.0,358,90,268,27319,4946,22373,20298475.0,3662787.0,16635687.0,0.7391,0.7435,0.7406,0.7436
2023-11-10 14:20,704,184,520,89781,9990,79791,66709155.0,7397028.0,59312127.0,688,177,511,88377,9765,78612,65662722.0,7221221.0,58441500.0,0.7404,0.7433,0.7395,0.7434
2023-11-10 14:25,573,156,417,49148,5778,43370,36483231.0,4277024.0,32206207.0,559,146,413,49161,5736,43425,36492738.0,4245723.0,32247014.0,0.7402,0.7426,0.7402,0.7426
2023-11-10 14:30,330,115,215,38463,5807,32656,28560766.0,4297078.0,24263687.0,317,110,207,37707,5748,31959,28008546.0,4253876.0,23754670.0,0.74,0.743,0.7401,0.7433
2023-11-10 14:35,1003,613,390,78371,41955,36416,58070533.0,31000116.0,27070416.0,975,594,381,77304,41295,36009,57282434.0,30512416.0,26770017.0,0.7389,0.7434,0.7389,0.7434
2023-11-10 14:40,473,74,399,20550,2877,17673,15240281.0,2127251.0,13113030.0,460,68,392,20234,2711,17523,15003281.0,1998646.0,13004634.0,0.7394,0.742,0.7372,0.7421
2023-11-10 14:45,1167,237,930,134155,13706,120449,99451626.0,10138255.0,89313370.0,1138,219,919,131209,11179,120030,97312944.0,8267407.0,89045537.0,0.7397,0.7415,0.7395,0.7419
2023-11-10 14:50,219,73,146,21233,2656,18577,15761915.0,1983723.0,13778192.0,198,59,139,20874,2351,18523,15476350.0,1737256.0,13739093.0,0.7469,0.7417,0.7389,0.7417
2023-11-10 14:55,98,62,36,4950,2120,2830,3673954.0,1573985.0,2099969.0,88,55,33,4927,2097,2830,3652109.0,1551242.0,2100867.0,0.7424,0.742,0.7397,0.7424
2023-11-10 15:00,362,165,197,26578,7793,18785,19798932.0,5855232.0,13943700.0,328,146,182,24182,6545,17637,18012008.0,4842069.0,13169938.0,0.7513,0.7423,0.7398,0.7467
2023-11-10 15:05,171,74,97,15059,4252,10807,11145033.0,3159814.0,7985219.0,146,57,89,14245,4136,10109,10563265.0,3057850.0,7505415.0,0.7431,0.7389,0.7393,0.7424
2023-11-10 15:10,161,73,88,6061,3146,2915,4476816.0,2328744.0,2148072.0,132,56,76,5532,2809,2723,4101448.0,2078769.0,2022679.0,0.7402,0.7369,0.74,0.7428
2023-11-10 15:15,68,40,28,2683,423,2260,2013720.0,315003.0,1698716.0,55,28,27,2463,391,2072,1851771.0,289000.0,1562771.0,0.7447,0.7516,0.7391,0.7542
2023-11-10 15:20,157,88,69,9361,3692,5669,6954189.0,2732243.0,4221945.0,145,78,67,8845,3500,5345,6578079.0,2587734.0,3990345.0,0.74,0.7447,0.7394,0.7466
2023-11-10 15:25,113,47,66,6964,1994,4970,5106078.0,1476797.0,3629281.0,101,43,58,6047,1799,4248,4489363.0,1330321.0,3159042.0,0.7406,0.7302,0.7395,0.7437
2023-11-10 15:30,129,62,67,7426,2219,5207,5449383.0,1639754.0,3809629.0,132,63,69,7613,2573,5040,5644807.0,1900227.0,3744580.0,0.739,0.7316,0.7385,0.743
2023-11-10 15:35,248,110,138,17654,7646,10008,13060441.0,5648021.0,7412420.0,232,98,134,16974,7067,9907,12594240.0,5224647.0,7369593.0,0.7387,0.7406,0.7393,0.7439
2023-11-10 15:40,113,54,59,8723,3503,5220,6453774.0,2588967.0,3864807.0,103,51,52,7283,2972,4311,5401471.0,2195982.0,3205489.0,0.7391,0.7404,0.7389,0.7436
2023-11-10 15:45,120,41,79,11623,1808,9815,8638281.0,1351791.0,7286489.0,108,36,72,11650,2055,9595,8640714.0,1519966.0,7120747.0,0.7477,0.7424,0.7396,0.7421
2023-11-10 15:50,92,42,50,4097,1890,2207,3016602.0,1389498.0,1627104.0,79,32,47,3518,1452,2066,2606151.0,1071297.0,1534853.0,0.7352,0.7372,0.7378,0.7429
2023-11-10 15:55,79,35,44,4259,1107,3152,3126456.0,818335.0,2308121.0,64,29,35,3599,1143,2456,2668836.0,845420.0,1823416.0,0.7392,0.7323,0.7397,0.7424
2023-11-10 16:00,661,336,325,56763,27808,28955,42033198.0,20524504.0,21508694.0,637,324,313,55280,27053,28227,40935017.0,19966518.0,20968498.0,0.7381,0.7428,0.7381,0.7429
2023-11-10 16:05,70,45,25,3562,2179,1383,2638283.0,1610769.0,1027514.0,63,39,24,3632,2162,1470,2688532.0,1597154.0,1091378.0,0.7392,0.743,0.7387,0.7424
2023-11-10 16:10,190,92,98,14783,3773,11010,10933885.0,2791341.0,8142544.0,165,81,84,14025,3796,10229,10396110.0,2808459.0,7587651.0,0.7398,0.7396,0.7398,0.7418
2023-11-10 16:15,179,115,64,13542,6580,6962,10039939.0,4866724.0,5173215.0,177,110,67,13420,6308,7112,9944194.0,4665043.0,5279151.0,0.7396,0.7431,0.7395,0.7423
2023-11-10 16:20,334,127,207,26409,11611,14798,19548404.0,8594824.0,10953580.0,318,120,198,26180,11570,14610,19390189.0,8562820.0,10827369.0,0.7402,0.7402,0.7401,0.7411
2023-11-10 16:25,539,288,251,44413,16252,28161,32923480.0,12035583.0,20887896.0,523,273,250,44340,16211,28129,32860243.0,11995586.0,20864657.0,0.7406,0.7417,0.74,0.7417
2023-11-10 16:30,82,55,27,5072,3722,1350,3754678.0,2752543.0,1002135.0,66,47,19,4839,3505,1334,3582637.0,2592074.0,990562.0,0.7395,0.7423,0.7395,0.7426
2023-11-10 16:35,351,257,94,26814,17180,9634,20063466.0,12912275.0,7151190.0,316,230,86,24863,15401,9462,18428681.0,11402979.0,7025701.0,0.7516,0.7423,0.7404,0.7425
2023-11-10 16:40,1222,933,289,109002,103404,5598,80737802.0,76576606.0,4161195.0,1215,933,282,108798,103242,5556,80583559.0,76456389.0,4127170.0,0.7406,0.7433,0.7406,0.7428
2023-11-10 16:45,812,683,129,89344,84848,4496,66203107.0,62868719.0,3334388.0,793,671,122,88780,84557,4223,65767356.0,62630193.0,3137163.0,0.741,0.7416,0.7407,0.7429
2023-11-10 16:50,352,274,78,24565,20202,4363,18200740.0,14962436.0,3238304.0,325,254,71,24656,20384,4272,18270411.0,15098389.0,3172022.0,0.7406,0.7422,0.7407,0.7425
2023-11-10 16:55,350,170,180,18492,11313,7179,13695429.0,8378695.0,5316734.0,341,163,178,18050,11029,7021,13379069.0,8167787.0,5211282.0,0.7406,0.7406,0.7406,0.7422
2023-11-10 17:00,229,90,139,11979,5482,6497,8883554.0,4061424.0,4822129.0,219,86,133,12120,5687,6433,8987885.0,4211717.0,4776167.0,0.7409,0.7422,0.7406,0.7424
2023-11-10 17:05,177,86,91,11423,8054,3369,8461989.0,5959593.0,2502396.0,176,85,91,11019,7755,3264,8164469.0,5739560.0,2424908.0,0.74,0.7428,0.7401,0.7429
2023-11-10 17:10,297,124,173,18998,8682,10316,14088232.0,6423937.0,7664295.0,283,113,170,18946,8469,10477,14058310.0,6263612.0,7794697.0,0.7399,0.743,0.7396,0.744
2023-11-10 17:15,165,74,91,13279,4616,8663,9848199.0,3413595.0,6434604.0,157,69,88,12632,4528,8104,9368809.0,3348773.0,6020036.0,0.7395,0.7428,0.7396,0.7428
2023-11-10 17:20,125,71,54,8936,4429,4507,6625011.0,3277760.0,3347251.0,123,69,54,8971,4463,4508,6651113.0,3302907.0,3348206.0,0.7401,0.7427,0.7401,0.7427
2023-11-10 17:25,180,132,48,10123,8040,2083,7491228.0,5951355.0,1539872.0,173,131,42,9309,7811,1498,6894479.0,5781574.0,1112905.0,0.7402,0.7393,0.7402,0.7429
2023-11-10 17:30,326,232,94,24191,16319,7872,17912765.0,12069514.0,5843251.0,318,228,90,24062,16433,7629,17780710.0,12114373.0,5666337.0,0.7396,0.7423,0.7372,0.7427
2023-11-10 17:35,503,261,242,34276,21213,13063,25401271.0,15711392.0,9689878.0,499,258,241,34398,21249,13149,25490041.0,15735833.0,9754207.0,0.7406,0.7418,0.7405,0.7418
2023-11-10 17:40,478,247,231,34600,22400,12200,25639521.0,16585126.0,9054394.0,472,242,230,35939,22671,13268,26638743.0,16785379.0,9853364.0,0.7404,0.7422,0.7404,0.7426
2023-11-10 17:45,836,627,209,72723,63063,9660,53830055.0,46662390.0,7167665.0,830,623,207,72764,63143,9621,53864967.0,46721137.0,7143829.0,0.7399,0.742,0.7399,0.7425
2023-11-10 17:50,606,391,215,49446,41101,8345,36621566.0,30427542.0,6194024.0,602,390,212,49199,40653,8546,36438676.0,30095009.0,6343667.0,0.7403,0.7422,0.7403,0.7423
2023-11-10 17:55,168,99,69,9955,5787,4168,7373197.0,4280121.0,3093076.0,158,95,63,9768,6056,3712,7236789.0,4479010.0,2757779.0,0.7396,0.7421,0.7396,0.7429
2023-11-10 18:00,218,147,71,15984,10922,5062,11837799.0,8070093.0,3767706.0,213,142,71,16114,11459,4655,11889439.0,8430561.0,3458877.0,0.7389,0.7443,0.7357,0.743
2023-11-10 18:05,323,222,101,22184,15169,7015,16435026.0,11230109.0,5204917.0,314,218,96,22074,14897,7177,16360268.0,11027980.0,5332288.0,0.7403,0.742,0.7403,0.743
2023-11-10 18:10,199,118,81,15576,10759,4817,11538528.0,7950700.0,3587827.0,179,108,71,14771,10448,4323,10931834.0,7722002.0,3209832.0,0.739,0.7448,0.7391,0.7425
2023-11-10 18:15,220,176,44,17943,16029,1914,13266761.0,11847201.0,1419559.0,209,170,39,18038,16133,1905,13328019.0,11913200.0,1414819.0,0.7391,0.7417,0.7384,0.7427
2023-11-10 18:20,198,96,102,16218,9559,6659,12010546.0,7073388.0,4937158.0,193,90,103,16424,9476,6948,12159518.0,7002016.0,5157502.0,0.74,0.7414,0.7389,0.7423
2023-11-10 18:25,282,80,202,26957,2705,24252,20033371.0,2017871.0,18015500.0,285,88,197,26180,2407,23773,19438441.0,1777845.0,17660595.0,0.746,0.7428,0.7386,0.7429
2023-11-10 18:30,831,77,754,79064,2021,77043,58522721.0,1497601.0,57025120.0,817,70,747,77802,1899,75903,57674951.0,1405058.0,56269892.0,0.741,0.7402,0.7399,0.7413
2023-11-10 18:35,1044,180,864,109010,8447,100563,80859700.0,6261771.0,74597928.0,1034,176,858,110158,9837,100321,81689274.0,7266053.0,74423220.0,0.7413,0.7418,0.7386,0.7419
2023-11-13 10:00,4380,2451,1929,397006,194918,202088,293270345.0,142786413.0,150483932.0,3903,2236,1667,377420,186905,190515,278284620.0,137176281.0,141108339.0,0.7325,0.7446,0.7339,0.7407
2023-11-13 10:05,3686,2372,1314,391459,269868,121591,288846875.0,198673698.0,90173177.0,3546,2288,1258,378968,260019,118949,279443190.0,191262195.0,88180994.0,0.7362,0.7416,0.7356,0.7413
2023-11-13 10:10,3298,2001,1297,359861,257257,102604,266206822.0,189999929.0,76206893.0,3209,1951,1258,361820,261352,100468,267605780.0,192995632.0,74610148.0,0.7386,0.7427,0.7385,0.7426
2023-11-13 10:15,837,465,372,59397,31943,27454,43966715.0,23593101.0,20373613.0,761,427,334,54905,29964,24941,40618332.0,22111280.0,18507051.0,0.7386,0.7421,0.7379,0.742
2023-11-13 10:20,1934,981,953,143408,81063,62345,105978947.0,59806564.0,46172382.0,1770,896,874,137161,77528,59633,101369382.0,57189312.0,44180070.0,0.7378,0.7406,0.7377,0.7409
2023-11-13 10:25,1079,511,568,62589,30545,32044,46274064.0,22556236.0,23717828.0,1059,497,562,63802,31860,31942,47185846.0,23527219.0,23658626.0,0.7385,0.7402,0.7385,0.7407
2023-11-13 10:30,1599,803,796,106841,51121,55720,79199780.0,37856976.0,41342803.0,1566,788,778,105245,50098,55147,77935759.0,37018059.0,40917700.0,0.7405,0.742,0.7389,0.742
2023-11-13 10:35,457,291,166,19198,11141,8057,14284470.0,8248627.0,6035842.0,426,280,146,18029,10864,7165,13345647.0,8030304.0,5315343.0,0.7404,0.7491,0.7392,0.7418
2023-11-13 10:40,480,195,285,26541,16457,10084,19604586.0,12147271.0,7457315.0,436,179,257,24422,16138,8284,18053167.0,11913012.0,6140155.0,0.7381,0.7395,0.7382,0.7412
2023-11-13 10:45,1343,851,492,108896,84881,24015,80200670.0,62520837.0,17679833.0,1281,827,454,104494,82627,21867,77038586.0,60853369.0,16185217.0,0.7366,0.7362,0.7365,0.7402
2023-11-13 10:50,278,207,71,26100,22350,3750,19228771.0,16463210.0,2765560.0,253,198,55,25250,22149,3101,18610718.0,16315235.0,2295483.0,0.7366,0.7375,0.7366,0.7402
2023-11-13 10:55,648,450,198,58306,54471,3835,42961612.0,40134897.0,2826715.0,629,441,188,58055,54320,3735,42786676.0,40023864.0,2762812.0,0.7368,0.7371,0.7368,0.7397
2023-11-13 11:00,351,216,135,22482,19196,3286,16548013.0,14138359.0,2409654.0,325,204,121,21876,19065,2811,16117491.0,14038540.0,2078950.0,0.7365,0.7333,0.7364,0.7396
2023-11-13 11:05,443,298,145,32902,25432,7470,24265159.0,18737177.0,5527982.0,425,287,138,31186,24417,6769,23003918.0,17989101.0,5014817.0,0.7368,0.74,0.7367,0.7409
2023-11-13 11:10,708,489,219,75671,65372,10299,55751208.0,48155909.0,7595298.0,685,479,206,75817,65581,10236,55870305.0,48309455.0,7560850.0,0.7366,0.7375,0.7366,0.7387
2023-11-13 11:15,784,399,385,56303,39456,16847,41467908.0,29052548.0,12415359.0,759,386,373,55417,39162,16255,40837783.0,28834178.0,12003605.0,0.7363,0.7369,0.7363,0.7385
2023-11-13 11:20,275,170,105,24296,16370,7926,17884026.0,12035913.0,5848113.0,258,159,99,23709,15822,7887,17466334.0,11636581.0,5829753.0,0.7352,0.7378,0.7355,0.7392
2023-11-13 11:25,825,565,260,83306,73126,10180,61237943.0,53727700.0,7510242.0,799,551,248,83175,73175,10000,61146534.0,53760585.0,7385949.0,0.7347,0.7377,0.7347,0.7386
2023-11-13 11:30,209,120,89,13080,6938,6142,9600742.0,5105389.0,4495353.0,190,111,79,11887,6655,5232,8762733.0,4896211.0,3866521.0,0.7359,0.7319,0.7357,0.739
2023-11-13 11:35,232,137,95,16574,8182,8392,12209206.0,6015337.0,6193869.0,217,129,88,17193,9162,8031,12667076.0,6735614.0,5931461.0,0.7352,0.7381,0.7352,0.7386
2023-11-13 11:40,1051,575,476,92496,43391,49105,68126732.0,31911621.0,36215111.0,992,536,456,89609,42218,47391,66010507.0,30988451.0,35022055.0,0.7354,0.7375,0.734,0.739
2023-11-13 11:45,1336,622,714,112223,51225,60998,81904876.0,37391196.0,44513679.0,1195,527,668,103095,46408,56687,75597796.0,33893520.0,41704276.0,0.7299,0.7298,0.7303,0.7357
2023-11-13 11:50,701,361,340,39274,15811,23463,28558935.0,11522659.0,17036275.0,512,248,264,31042,13606,17436,22706446.0,9898956.0,12807489.0,0.7288,0.7261,0.7275,0.7345
2023-11-13 11:55,634,234,400,29644,14211,15433,21601223.0,10390853.0,11210369.0,545,171,374,25353,11219,14134,18486044.0,8149650.0,10336394.0,0.7312,0.7264,0.7264,0.7313
2023-11-13 12:00,685,347,338,43748,22664,21084,31831988.0,16447565.0,15384423.0,566,282,284,33481,18643,14838,24419745.0,13539840.0,10879904.0,0.7257,0.7297,0.7263,0.7332
2023-11-13 12:05,301,132,169,19617,9859,9758,14088131.0,6993517.0,7094614.0,242,98,144,16500,8100,8400,11941967.0,5774693.0,6167274.0,0.7094,0.7271,0.7129,0.7342
2023-11-13 12:10,988,500,488,57825,23393,34432,41839708.0,16867725.0,24971983.0,771,369,402,42599,16447,26152,30995001.0,11888467.0,19106534.0,0.7211,0.7253,0.7228,0.7306
2023-11-13 12:15,1110,545,565,63997,26800,37197,46995731.0,20115148.0,26880582.0,913,393,520,58580,21030,37550,42405660.0,15131901.0,27273759.0,0.7506,0.7227,0.7195,0.7263
2023-11-13 12:20,1385,504,881,102549,31802,70747,72968204.0,22761082.0,50207122.0,1124,317,807,80017,19144,60873,57675234.0,13732798.0,43942435.0,0.7157,0.7097,0.7173,0.7219
2023-11-13 12:25,2796,1337,1459,279473,105943,173530,205382662.0,81185590.0,124197072.0,2371,1045,1326,256947,96527,160420,188132895.0,72927157.0,115205737.0,0.7663,0.7157,0.7555,0.7182
2023-11-13 12:30,1280,755,525,79141,46281,32860,57968100.0,34359730.0,23608370.0,1112,640,472,69850,41053,28797,51212990.0,30518094.0,20694895.0,0.7424,0.7185,0.7434,0.7186
2023-11-13 12:35,733,444,289,50150,34155,15995,36024345.0,24526706.0,11497638.0,636,385,251,46636,31947,14689,33408257.0,22837344.0,10570913.0,0.7181,0.7188,0.7149,0.7196
2023-11-13 12:40,372,208,164,17446,9804,7642,12582162.0,7056851.0,5525311.0,311,167,144,14999,7730,7269,10813898.0,5526168.0,5287730.0,0.7198,0.723,0.7149,0.7274
2023-11-13 12:45,237,117,120,13800,4679,9121,9913066.0,3355387.0,6557679.0,197,85,112,14246,5880,8366,10166761.0,4152496.0,6014265.0,0.7171,0.719,0.7062,0.7189
2023-11-13 12:50,734,176,558,58187,21234,36953,41604178.0,15160273.0,26443904.0,674,131,543,53371,18001,35370,38216766.0,12848170.0,25368595.0,0.714,0.7156,0.7137,0.7172
2023-11-13 12:55,126,63,63,8335,3393,4942,5908982.0,2407599.0,3501383.0,70,28,42,6398,2149,4249,4594148.0,1532647.0,3061501.0,0.7096,0.7085,0.7132,0.7205
2023-11-13 13:00,283,125,158,25811,13121,12690,19094166.0,9962585.0,9131580.0,220,79,141,19147,7172,11975,13756866.0,5136903.0,8619963.0,0.7593,0.7196,0.7162,0.7198
2023-11-13 13:05,227,117,110,18935,12655,6280,13617450.0,9086882.0,4530568.0,192,93,99,16318,11252,5066,11723549.0,8071582.0,3651967.0,0.718,0.7214,0.7173,0.7209
2023-11-13 13:10,721,423,298,57584,37804,19780,41294288.0,27087262.0,14207026.0,688,406,282,57753,39002,18751,41451817.0,27940737.0,13511080.0,0.7165,0.7183,0.7164,0.7206
2023-11-13 13:15,1327,1065,262,107740,91365,16375,77287164.0,65480753.0,11806410.0,1293,1043,250,106439,90812,15627,76337571.0,65066500.0,11271071.0,0.7167,0.721,0.7165,0.7213
2023-11-13 13:20,1015,442,573,105985,46964,59021,75887532.0,33529631.0,42357901.0,954,397,557,97481,39516,57965,69949263.0,28293987.0,41655275.0,0.7139,0.7177,0.716,0.7186
2023-11-13 13:25,713,194,519,77837,22995,54842,55726862.0,16407286.0,39319576.0,663,167,496,81943,28795,53148,58647253.0,20456860.0,38190393.0,0.7135,0.717,0.7104,0.7186
2023-11-13 13:30,747,408,339,79862,51170,28692,57249781.0,36640638.0,20609143.0,697,375,322,77002,48933,28069,55129816.0,34968436.0,20161379.0,0.7161,0.7183,0.7146,0.7183
2023-11-13 13:35,263,122,141,23819,14573,9246,17014239.0,10410608.0,6603630.0,233,104,129,22283,14373,7910,15955546.0,10268459.0,5687086.0,0.7144,0.7142,0.7144,0.719
2023-11-13 13:40,588,227,361,68436,19066,49370,48954124.0,13642840.0,35311283.0,471,134,337,53649,10401,43248,38455817.0,7384784.0,31071032.0,0.7156,0.7152,0.71,0.7184
2023-11-13 13:45,706,342,364,67372,31363,36009,48380027.0,22538505.0,25841522.0,654,324,330,61271,30015,31256,43854204.0,21430549.0,22423655.0,0.7186,0.7176,0.714,0.7174
2023-11-13 13:50,702,495,207,79897,60147,19750,57257140.0,43057931.0,14199208.0,649,466,183,76580,58290,18290,54817775.0,41671501.0,13146273.0,0.7159,0.7189,0.7149,0.7188
2023-11-13 13:55,145,59,86,14811,6794,8017,10604795.0,4853032.0,5751762.0,128,54,74,10890,5280,5610,7793689.0,3756078.0,4037610.0,0.7143,0.7174,0.7114,0.7197
2023-11-13 14:00,205,98,107,20266,7715,12551,14627895.0,5589962.0,9037932.0,154,66,88,15083,3218,11865,10862486.0,2303787.0,8558699.0,0.7246,0.7201,0.7159,0.7213
2023-11-13 14:05,138,57,81,13725,5482,8243,9896008.0,3928233.0,5967774.0,99,38,61,10812,3173,7639,7791942.0,2263896.0,5528046.0,0.7166,0.724,0.7135,0.7237
2023-11-13 14:10,180,53,127,20944,5047,15897,14962038.0,3605824.0,11356214.0,151,35,116,14377,2853,11524,10333898.0,2040934.0,8292963.0,0.7144,0.7144,0.7154,0.7196
2023-11-13 14:15,155,50,105,11979,3749,8230,8595786.0,2684687.0,5911098.0,141,38,103,11805,3543,8262,8479625.0,2535101.0,5944524.0,0.7161,0.7182,0.7155,0.7195
2023-11-13 14:20,1023,661,362,131220,94266,36954,94182836.0,67754418.0,26428418.0,969,629,340,123189,88891,34298,88310934.0,63640949.0,24669985.0,0.7188,0.7152,0.7159,0.7193
2023-11-13 14:25,818,488,330,86108,52407,33701,62478069.0,38130584.0,24347485.0,745,451,294,77590,47439,30151,55827319.0,34037802.0,21789516.0,0.7276,0.7225,0.7175,0.7227
2023-11-13 14:30,1235,670,565,112393,66400,45993,81633165.0,48424958.0,33208206.0,1085,625,460,105731,64476,41255,76314944.0,46368505.0,29946439.0,0.7293,0.722,0.7192,0.7259
2023-11-13 14:35,1985,1438,547,258829,210573,48256,188454158.0,153323343.0,35130815.0,1812,1371,441,246244,205087,41157,179803048.0,149810696.0,29992352.0,0.7281,0.728,0.7305,0.7287
2023-11-13 14:40,345,179,166,27043,17585,9458,19615793.0,12735413.0,6880380.0,305,158,147,26593,18144,8449,19291616.0,13119349.0,6172266.0,0.7242,0.7275,0.7231,0.7305
2023-11-13 14:45,1010,420,590,94181,45257,48924,67941127.0,32637837.0,35303290.0,962,391,571,87250,42634,44616,63088720.0,30729143.0,32359576.0,0.7212,0.7216,0.7208,0.7253
2023-11-13 14:50,264,89,175,18874,3854,15020,13688680.0,2793036.0,10895644.0,234,69,165,16767,3396,13371,12148280.0,2446010.0,9702270.0,0.7247,0.7254,0.7203,0.7256
2023-11-13 14:55,100,35,65,6201,1491,4710,4485286.0,1074780.0,3410506.0,90,31,59,5870,1401,4469,4243718.0,1007310.0,3236407.0,0.7208,0.7241,0.719,0.7242
2023-11-13 15:00,130,59,71,9663,3880,5783,6984345.0,2796159.0,4188186.0,112,50,62,9047,3713,5334,6537061.0,2673681.0,3863380.0,0.7207,0.7242,0.7201,0.7243
2023-11-13 15:05,132,48,84,7523,2160,5363,5466158.0,1588140.0,3878018.0,116,39,77,7116,1788,5328,5152875.0,1290765.0,3862109.0,0.7353,0.7231,0.7219,0.7249
2023-11-13 15:10,368,103,265,29773,7173,22600,21557864.0,5171847.0,16386017.0,350,96,254,27884,6828,21056,20168258.0,4923301.0,15244957.0,0.721,0.725,0.721,0.724
2023-11-13 15:15,244,45,199,22460,5785,16675,16239684.0,4173671.0,12066012.0,225,38,187,20000,3780,16220,14464866.0,2723454.0,11741412.0,0.7215,0.7236,0.7205,0.7239
2023-11-13 15:20,70,29,41,3836,1087,2749,2792405.0,795969.0,1996436.0,54,16,38,3632,863,2769,2631304.0,619603.0,2011701.0,0.7323,0.7262,0.718,0.7265
2023-11-13 15:25,158,63,95,9670,4359,5311,6971628.0,3135395.0,3836233.0,138,51,87,8468,3941,4527,6122926.0,2841947.0,3280979.0,0.7193,0.7223,0.7211,0.7248
2023-11-13 15:30,263,195,68,10849,8898,1951,7843136.0,6428277.0,1414858.0,253,185,68,10336,8466,1870,7472317.0,6114196.0,1358121.0,0.7224,0.7252,0.7222,0.7263
2023-11-13 15:35,271,55,216,34108,1845,32263,24698313.0,1333126.0,23365187.0,253,42,211,34315,1920,32395,24842809.0,1382466.0,23460343.0,0.7226,0.7242,0.72,0.7242
2023-11-13 15:40,92,63,29,5216,4238,978,3767690.0,3061250.0,706439.0,80,56,24,5332,4376,956,3854016.0,3160709.0,693306.0,0.7223,0.7223,0.7223,0.7252
2023-11-13 15:45,166,49,117,17420,3368,14052,12597327.0,2427978.0,10169349.0,145,38,107,16090,2609,13481,11641838.0,1878473.0,9763365.0,0.7209,0.7237,0.72,0.7242
2023-11-13 15:50,108,45,63,9246,3225,6021,6683531.0,2327138.0,4356393.0,96,38,58,8998,3151,5847,6508550.0,2274263.0,4234287.0,0.7216,0.7235,0.7218,0.7242
2023-11-13 15:55,237,66,171,29922,5718,24204,21601365.0,4123935.0,17477430.0,221,54,167,27264,4989,22275,19702612.0,3577940.0,16124671.0,0.7212,0.7221,0.7172,0.7239
2023-11-13 16:00,262,60,202,27909,3455,24454,20176583.0,2492431.0,17684151.0,240,43,197,27806,3561,24245,20096277.0,2562898.0,17533378.0,0.7214,0.7232,0.7197,0.7232
2023-11-13 16:05,832,282,550,95971,26330,69641,69159476.0,18944468.0,50215008.0,785,253,532,94004,25194,68810,67857513.0,18124109.0,49733403.0,0.7195,0.7211,0.7194,0.7228
2023-11-13 16:10,702,204,498,79330,19413,59917,56900584.0,13675139.0,43225445.0,679,187,492,73627,14116,59511,53122348.0,10155672.0,42966676.0,0.7044,0.7214,0.7194,0.722
2023-11-13 16:15,455,133,322,52154,12706,39448,37556248.0,9107339.0,28448909.0,423,112,311,48792,9434,39358,35183730.0,6770184.0,28413545.0,0.7168,0.7212,0.7176,0.7219
2023-11-13 16:20,606,191,415,65351,16536,48815,47034691.0,11847181.0,35187510.0,564,164,400,64024,14625,49399,46154709.0,10499799.0,35654909.0,0.7164,0.7208,0.7179,0.7218
2023-11-13 16:25,127,30,97,16304,1177,15127,11773721.0,851709.0,10922012.0,112,24,88,15108,1296,13812,10901154.0,929186.0,9971968.0,0.7236,0.722,0.717,0.722
2023-11-13 16:30,127,42,85,13826,1304,12522,10002055.0,960519.0,9041535.0,107,26,81,14618,2246,12372,10538195.0,1605308.0,8932887.0,0.7366,0.7221,0.7147,0.722
2023-11-13 16:35,352,44,308,52328,4905,47423,37701416.0,3516415.0,34185000.0,334,31,303,49150,1635,47515,35430173.0,1173860.0,34256312.0,0.7169,0.7209,0.718,0.721
2023-11-13 16:40,723,23,700,144618,2707,141911,104431057.0,1950392.0,102480665.0,716,13,703,143602,725,142877,103699694.0,519944.0,103179749.0,0.7205,0.7221,0.7172,0.7222
2023-11-13 16:45,624,95,529,115769,11325,104444,83571554.0,8115688.0,75455866.0,611,87,524,115712,11265,104447,83535946.0,8070694.0,75465251.0,0.7166,0.7225,0.7164,0.7225
2023-11-13 16:50,1015,91,924,170211,13935,156276,122886049.0,9959698.0,112926351.0,1000,84,916,169347,14523,154824,122244097.0,10369067.0,111875029.0,0.7147,0.7226,0.714,0.7226
2023-11-13 16:55,385,41,344,56688,2663,54025,40942220.0,1912121.0,39030099.0,369,32,337,56106,2251,53855,40532606.0,1614141.0,38918464.0,0.718,0.7224,0.7171,0.7227
2023-11-13 17:00,664,43,621,90316,776,89540,65278164.0,555202.0,64722962.0,629,15,614,90361,688,89673,65314195.0,494660.0,64819535.0,0.7155,0.7228,0.719,0.7228
2023-11-13 17:05,72,17,55,6693,594,6099,4834784.0,426917.0,4407867.0,62,13,49,6144,444,5700,4439133.0,316845.0,4122287.0,0.7187,0.7227,0.7136,0.7232
2023-11-13 17:10,139,36,103,17461,3431,14030,12595013.0,2457613.0,10137400.0,130,30,100,16914,2911,14003,12197131.0,2079837.0,10117294.0,0.7163,0.7226,0.7145,0.7225
2023-11-13 17:15,107,32,75,9727,3597,6130,7107009.0,2678420.0,4428589.0,96,27,69,10661,4507,6154,7670385.0,3223111.0,4447274.0,0.7446,0.7224,0.7151,0.7227
2023-11-13 17:20,111,34,77,8080,2167,5913,5797536.0,1557771.0,4239764.0,103,30,73,7363,1863,5500,5314898.0,1340533.0,3974365.0,0.7189,0.717,0.7196,0.7226
2023-11-13 17:25,66,37,29,5515,4084,1431,3972866.0,2939303.0,1033563.0,63,31,32,6435,4292,2143,4639730.0,3087252.0,1552478.0,0.7197,0.7223,0.7193,0.7244
2023-11-13 17:30,105,26,79,9534,2209,7325,6875753.0,1630605.0,5245148.0,91,22,69,6934,1857,5077,5001767.0,1331889.0,3669878.0,0.7382,0.7161,0.7172,0.7228
2023-11-13 17:35,190,65,125,23020,5000,18020,16633245.0,3610786.0,13022459.0,175,54,121,22504,4730,17774,16256382.0,3404115.0,12852267.0,0.7222,0.7227,0.7197,0.7231
2023-11-13 17:40,108,34,74,11905,3310,8595,8598168.0,2385608.0,6212559.0,96,25,71,11486,2995,8491,8294248.0,2157273.0,6136974.0,0.7207,0.7228,0.7203,0.7228
2023-11-13 17:45,389,47,342,59964,4449,55515,43362448.0,3219762.0,40142685.0,376,39,337,60253,4566,55687,43550081.0,3286906.0,40263174.0,0.7237,0.7231,0.7199,0.723
2023-11-13 17:50,326,88,238,42993,8770,34223,31096399.0,6358968.0,24737430.0,296,69,227,40103,7440,32663,28964946.0,5338080.0,23626866.0,0.7251,0.7228,0.7175,0.7234
2023-11-13 17:55,213,77,136,23390,8234,15156,16903051.0,5931377.0,10971673.0,190,65,125,23164,8767,14397,16734052.0,6307775.0,10426277.0,0.7204,0.7239,0.7195,0.7242
2023-11-13 18:00,233,64,169,24431,4310,20121,17664012.0,3102946.0,14561065.0,216,53,163,24643,4598,20045,17801062.0,3295522.0,14505540.0,0.7199,0.7237,0.7167,0.7236
2023-11-13 18:05,138,50,88,12948,3282,9666,9394487.0,2400523.0,6993964.0,125,42,83,12762,3089,9673,9228745.0,2229007.0,6999737.0,0.7314,0.7236,0.7216,0.7236
2023-11-13 18:10,263,203,60,34806,31452,3354,25109564.0,22682879.0,2426685.0,249,196,53,34560,31299,3261,24915082.0,22550992.0,2364090.0,0.7212,0.7235,0.7205,0.725
2023-11-13 18:15,371,156,215,43401,21578,21823,31377378.0,15572452.0,15804925.0,353,146,207,44582,21201,23381,32239892.0,15298630.0,16941261.0,0.7217,0.7242,0.7216,0.7246
2023-11-13 18:20,572,328,244,92395,70131,22264,66545932.0,50439777.0,16106155.0,577,333,244,91672,70774,20898,66034880.0,50905399.0,15129481.0,0.7192,0.7234,0.7193,0.724
2023-11-13 18:25,424,246,178,62710,48914,13796,45116421.0,35160241.0,9956179.0,391,223,168,62954,49021,13933,45316523.0,35238240.0,10078283.0,0.7188,0.7217,0.7188,0.7233
2023-11-13 18:30,788,21,767,137812,1761,136051,99720377.0,1266083.0,98454294.0,770,10,760,133426,648,132778,96570074.0,464201.0,96105873.0,0.719,0.7237,0.7164,0.7238
2023-11-13 18:35,2264,71,2193,345545,6028,339517,249882321.0,4337261.0,245545060.0,2246,60,2186,344888,5123,339765,249426923.0,3682129.0,245744794.0,0.7195,0.7232,0.7187,0.7233
2023-11-14 10:00,3049,318,2731,484345,33838,450507,349808992.0,24609250.0,325199741.0,2762,210,2552,476336,29645,446691,343465681.0,21152016.0,322313665.0,0.7273,0.7219,0.7135,0.7216
2023-11-14 10:05,1988,566,1422,282709,34851,247858,201573402.0,25034057.0,176539344.0,1559,311,1248,250558,26133,224425,178596655.0,18938112.0,159658543.0,0.7183,0.7123,0.7247,0.7114
2023-11-14 10:10,2052,1121,931,275309,141251,134058,193002783.0,99173653.0,93829129.0,1577,812,765,237552,115953,121599,165632968.0,80275869.0,85357099.0,0.7021,0.6999,0.6923,0.702
2023-11-14 10:15,1430,935,495,143558,105785,37773,99925383.0,73584350.0,26341033.0,1151,784,367,132757,100358,32399,92341612.0,69602768.0,22738844.0,0.6956,0.6974,0.6935,0.7018
2023-11-14 10:20,3658,1808,1850,447363,174163,273200,311877103.0,121173912.0,190703190.0,3404,1651,1753,429736,167589,262147,299731095.0,116423570.0,183307525.0,0.6958,0.698,0.6947,0.6993
2023-11-14 10:25,1033,495,538,112049,47246,64803,78647349.0,33120882.0,45526467.0,887,399,488,104100,42029,62071,72887910.0,29298194.0,43589716.0,0.701,0.7025,0.6971,0.7023
2023-11-14 10:30,700,418,282,52654,37039,15615,36966861.0,25957537.0,11009324.0,497,312,185,47390,33594,13796,33220138.0,23486524.0,9733613.0,0.7008,0.705,0.6991,0.7055
2023-11-14 10:35,773,446,327,97773,77627,20146,68535884.0,54351359.0,14184525.0,707,402,305,95017,76011,19006,66671038.0,53214932.0,13456106.0,0.7002,0.7041,0.7001,0.708
2023-11-14 10:40,522,159,363,47117,9342,37775,33247712.0,6544798.0,26702913.0,448,113,335,45345,8118,37227,32035936.0,5680873.0,26355063.0,0.7006,0.7069,0.6998,0.708
2023-11-14 10:45,553,290,263,47751,25586,22165,34954239.0,19283447.0,15670792.0,458,226,232,44425,23645,20780,31248392.0,16557814.0,14690578.0,0.7537,0.707,0.7003,0.707
2023-11-14 10:50,320,208,112,27898,19271,8627,19663207.0,13543239.0,6119967.0,291,183,108,26284,18676,7608,18501141.0,13108461.0,5392680.0,0.7028,0.7094,0.7019,0.7088
2023-11-14 10:55,1672,810,862,189065,75955,113110,134278784.0,53443802.0,80834982.0,1588,752,836,187784,74785,112999,133384581.0,52603156.0,80781425.0,0.7036,0.7147,0.7034,0.7149
2023-11-14 11:00,555,273,282,52234,25259,26975,37517103.0,17784480.0,19732623.0,475,236,239,58237,30382,27855,41616029.0,21174699.0,20441329.0,0.7041,0.7315,0.6969,0.7338
2023-11-14 11:05,1917,265,1652,286132,26959,259173,202214118.0,18950650.0,183263468.0,1880,234,1646,281763,26379,255384,199064529.0,18527556.0,180536972.0,0.7029,0.7071,0.7024,0.7069
2023-11-14 11:10,2281,589,1692,274412,51786,222626,193852567.0,36368402.0,157484164.0,2263,577,1686,273056,51501,221555,192858105.0,36148779.0,156709325.0,0.7023,0.7074,0.7019,0.7073
2023-11-14 11:15,2711,609,2102,407250,49769,357481,286443663.0,34382006.0,252061656.0,2489,463,2026,382046,35414,346632,270000916.0,24625649.0,245375267.0,0.6908,0.7051,0.6954,0.7079
2023-11-14 11:20,1200,211,989,186007,9446,176561,131657535.0,6611793.0,125045742.0,1146,168,978,185525,9331,176194,130615914.0,6488842.0,124127072.0,0.7,0.7082,0.6954,0.7045
2023-11-14 11:25,2482,498,1984,463195,20805,442390,326366958.0,14562868.0,311804089.0,2430,468,1962,462341,20421,441920,325765493.0,14291330.0,311474163.0,0.7,0.7048,0.6998,0.7048
2023-11-14 11:30,1814,894,920,322686,119112,203574,229853938.0,84379598.0,145474340.0,1737,852,885,311242,110582,200660,219798503.0,77686199.0,142112304.0,0.7084,0.7146,0.7025,0.7082
2023-11-14 11:35,2179,1384,795,287578,206174,81404,202565450.0,145024960.0,57540490.0,2097,1332,765,283872,204652,79220,199981581.0,143908579.0,56073002.0,0.7034,0.7069,0.7032,0.7078
2023-11-14 11:40,755,245,510,92792,28509,64283,65328053.0,20012227.0,45315825.0,732,227,505,91561,28216,63345,64454018.0,19779362.0,44674656.0,0.702,0.7049,0.701,0.7053
2023-11-14 11:45,742,439,303,74615,37526,37089,52636255.0,26361922.0,26274333.0,682,408,274,74092,38330,35762,52131812.0,26867828.0,25263984.0,0.7025,0.7084,0.701,0.7064
2023-11-14 11:50,310,195,115,22958,13496,9462,16165187.0,9472937.0,6692249.0,303,181,122,22312,12463,9849,15711673.0,8745018.0,6966655.0,0.7019,0.7073,0.7017,0.7073
2023-11-14 11:55,289,123,166,24196,6186,18010,17172256.0,4408718.0,12763538.0,206,70,136,21741,4618,17123,15368348.0,3229169.0,12139179.0,0.7127,0.7087,0.6993,0.7089
2023-11-14 12:00,173,101,72,10209,6415,3794,7189677.0,4508494.0,2681183.0,160,92,68,9662,5928,3734,6813986.0,4171685.0,2642301.0,0.7028,0.7067,0.7037,0.7076
2023-11-14 12:05,150,56,94,5660,1295,4365,3994220.0,911553.0,3082667.0,96,26,70,5735,1395,4340,4039415.0,971432.0,3067983.0,0.7039,0.7062,0.6964,0.7069
2023-11-14 12:10,129,57,72,7202,2392,4810,5084292.0,1688597.0,3395695.0,121,44,77,6189,1594,4595,4364322.0,1115206.0,3249116.0,0.7059,0.706,0.6996,0.7071
2023-11-14 12:15,102,62,40,8340,4303,4037,5885577.0,3025146.0,2860431.0,60,31,29,9212,5372,3840,6482131.0,3763275.0,2718856.0,0.703,0.7086,0.7005,0.708
2023-11-14 12:20,143,70,73,11174,4526,6648,7894371.0,3183129.0,4711241.0,137,65,72,10510,4512,5998,7412517.0,3167895.0,4244622.0,0.7033,0.7087,0.7021,0.7077
2023-11-14 12:25,192,46,146,21022,1535,19487,14856445.0,1077775.0,13778669.0,163,32,131,21240,1980,19260,15006140.0,1382739.0,13623400.0,0.7021,0.7071,0.6984,0.7073
2023-11-14 12:30,331,146,185,27554,9880,17674,20767197.0,6903096.0,13864101.0,307,131,176,26386,9614,16772,20431999.0,6717219.0,13714780.0,0.6987,0.7844,0.6987,0.8177
2023-11-14 12:35,204,108,96,16942,7870,9072,13131903.0,6729329.0,6402574.0,158,84,74,15988,7175,8813,11244077.0,5017473.0,6226604.0,0.8551,0.7058,0.6993,0.7065
2023-11-14 12:40,118,82,36,6520,4413,2107,4563143.0,3082912.0,1480231.0,97,66,31,6693,4549,2144,4683417.0,3175198.0,1508219.0,0.6986,0.7025,0.698,0.7035
2023-11-14 12:45,219,117,102,14127,5745,8382,11102611.0,5208471.0,5894139.0,205,112,93,13856,6999,6857,11659205.0,5946954.0,5712250.0,0.9066,0.7032,0.8497,0.8331
2023-11-14 12:50,143,80,63,7896,3983,3913,5522205.0,2774511.0,2747693.0,113,62,51,7446,3616,3830,5208379.0,2518009.0,2690369.0,0.6966,0.7022,0.6964,0.7024
2023-11-14 12:55,203,135,68,18644,11905,6739,13140069.0,8395574.0,4744495.0,166,104,62,16318,10212,6106,11445797.0,7131525.0,4314271.0,0.7052,0.704,0.6983,0.7066
2023-11-14 13:00,160,101,59,16530,7084,9446,11615032.0,4942893.0,6672139.0,150,99,51,16222,7663,8559,11380363.0,5346049.0,6034313.0,0.6978,0.7063,0.6976,0.705
2023-11-14 13:05,230,115,115,21907,7889,14018,16573240.0,6729630.0,9843609.0,219,111,108,18925,7204,11721,14486380.0,6254108.0,8232272.0,0.853,0.7022,0.8681,0.7024
2023-11-14 13:10,484,246,238,43298,18161,25137,30394362.0,12760560.0,17633802.0,411,204,207,40005,15867,24138,27992854.0,11058678.0,16934176.0,0.7026,0.7015,0.697,0.7016
2023-11-14 13:15,386,174,212,30838,13285,17553,21576084.0,9269843.0,12306240.0,357,161,196,26818,11985,14833,18752320.0,8345801.0,10406518.0,0.6978,0.7011,0.6964,0.7016
2023-11-14 13:20,113,60,53,5995,2429,3566,4202239.0,1703588.0,2498651.0,74,38,36,4707,1878,2829,3294146.0,1308394.0,1985751.0,0.7014,0.7007,0.6967,0.7019
2023-11-14 13:25,206,138,68,7628,5896,1732,5326915.0,4113880.0,1213034.0,200,130,70,8640,5914,2726,6660618.0,4743403.0,1917215.0,0.6977,0.7004,0.8021,0.7033
2023-11-14 13:30,261,130,131,23641,8759,14882,16520713.0,6093716.0,10426997.0,211,104,107,20507,8161,12346,14328442.0,5675848.0,8652594.0,0.6957,0.7006,0.6955,0.7008
2023-11-14 13:35,267,123,144,24133,11014,13119,16821283.0,7659251.0,9162032.0,237,104,133,24351,10559,13792,16999894.0,7336354.0,9663539.0,0.6954,0.6984,0.6948,0.7007
2023-11-14 13:40,288,167,121,31714,23836,7878,22055969.0,16555307.0,5500662.0,279,156,123,31207,23725,7482,21709082.0,16477290.0,5231791.0,0.6946,0.6982,0.6945,0.6993
2023-11-14 13:45,497,251,246,48754,22736,26018,33971171.0,15770949.0,18200221.0,420,209,211,38816,14641,24175,27090267.0,10174308.0,16915959.0,0.6937,0.6995,0.6949,0.6997
2023-11-14 13:50,121,64,57,11664,5397,6267,8147868.0,3752478.0,4395390.0,125,65,60,11376,5213,6163,7949963.0,3619301.0,4330662.0,0.6953,0.7014,0.6943,0.7027
2023-11-14 13:55,355,202,153,38304,22818,15486,26595985.0,15826215.0,10769770.0,310,178,132,35166,21149,14017,24553417.0,14710438.0,9842979.0,0.6936,0.6955,0.6956,0.7022
2023-11-14 14:00,316,73,243,35622,6754,28868,24824088.0,4697655.0,20126433.0,328,77,251,37207,8059,29148,25996746.0,5596593.0,20400153.0,0.6955,0.6972,0.6945,0.6999
2023-11-14 14:05,2305,874,1431,226852,62995,163857,157037349.0,44408052.0,112629296.0,1959,652,1307,200976,52416,148560,140033623.0,37040486.0,102993136.0,0.7049,0.6874,0.7067,0.6933
2023-11-14 14:10,522,307,215,37988,15997,21991,26533844.0,11292345.0,15241498.0,385,221,164,30788,13195,17593,21250800.0,9030932.0,12219868.0,0.7059,0.6931,0.6844,0.6946
2023-11-14 14:15,1225,499,726,135547,36459,99088,93276871.0,24817754.0,68459117.0,964,306,658,98765,23096,75669,67676591.0,15698048.0,51978542.0,0.6807,0.6909,0.6797,0.6869
2023-11-14 14:20,887,527,360,62282,29431,32851,45758454.0,23219676.0,22538778.0,578,297,281,59888,19322,40566,43796395.0,15294597.0,28501798.0,0.789,0.6861,0.7916,0.7026
2023-11-14 14:25,4821,1657,3164,594297,131200,463097,401980775.0,88591366.0,313389409.0,4476,1423,3053,569473,123038,446435,386783975.0,83932730.0,302851245.0,0.6752,0.6767,0.6822,0.6784
2023-11-14 14:30,10571,3216,7355,1443981,276013,1167968,970271238.0,187675966.0,782595272.0,9529,2526,7003,1345682,226692,1118990,902752366.0,153326299.0,749426067.0,0.68,0.67,0.6764,0.6697
2023-11-14 14:35,2273,1148,1125,254317,113479,140838,179710239.0,81943754.0,97766485.0,1885,877,1008,222285,93710,128575,150564935.0,62112448.0,88452486.0,0.7221,0.6942,0.6628,0.6879
2023-11-14 14:40,747,495,252,71307,58395,12912,52284183.0,39114806.0,13169377.0,582,402,180,62557,53117,9440,45685307.0,35285157.0,10400149.0,0.6698,1.0199,0.6643,1.1017
2023-11-14 14:45,864,499,365,78520,51408,27112,62194296.0,38880201.0,23314094.0,644,365,279,61522,41246,20276,54872348.0,37012423.0,17859925.0,0.7563,0.8599,0.8974,0.8808
2023-11-14 14:50,476,280,196,38697,24987,13710,27225274.0,16803707.0,10421566.0,344,201,143,31740,21294,10446,22469614.0,14252071.0,8217542.0,0.6725,0.7601,0.6693,0.7867
2023-11-14 14:55,735,331,404,55483,29506,25977,39598548.0,19812450.0,19786098.0,624,269,355,50353,27101,23252,36643352.0,18160045.0,18483307.0,0.6715,0.7617,0.6701,0.7949
2023-11-14 15:00,739,223,516,83823,17157,66666,62825345.0,11503112.0,51322232.0,644,163,481,78459,14447,64012,56260023.0,9659235.0,46600788.0,0.6705,0.7698,0.6686,0.728
2023-11-14 15:05,536,251,285,51964,26359,25605,37954369.0,17698603.0,20255766.0,490,235,255,48212,25175,23037,36225508.0,16848803.0,19376705.0,0.6714,0.7911,0.6693,0.8411
2023-11-14 15:10,1642,578,1064,183308,52330,130978,124469736.0,36220086.0,88249650.0,1504,489,1015,178137,50490,127647,119846907.0,33636579.0,86210327.0,0.6921,0.6738,0.6662,0.6754
2023-11-14 15:15,2910,2435,475,355365,322247,33118,237382669.0,215191570.0,22191099.0,2780,2355,425,348146,317678,30468,232477243.0,212012070.0,20465173.0,0.6678,0.6701,0.6674,0.6717
2023-11-14 15:20,2810,2467,343,380822,368582,12240,258010290.0,246791312.0,11218978.0,2729,2416,313,377804,369102,8702,254361942.0,247001979.0,7359962.0,0.6696,0.9166,0.6692,0.8458
2023-11-14 15:25,1388,1225,163,188706,174930,13776,126904160.0,117518035.0,9386124.0,1198,1062,136,175563,164760,10803,119194638.0,110333633.0,8861004.0,0.6718,0.6813,0.6697,0.8202
2023-11-14 15:30,3359,2704,655,533248,497807,35441,364758048.0,336515518.0,28242530.0,3187,2625,562,532361,501258,31103,363909681.0,338578225.0,25331455.0,0.676,0.7969,0.6755,0.8144
2023-11-14 15:35,1707,898,809,192331,119002,73329,130576850.0,80149384.0,50427465.0,1655,866,789,190091,118752,71339,129081037.0,79936204.0,49144833.0,0.6735,0.6877,0.6731,0.6889
2023-11-14 15:40,2292,631,1661,321023,71151,249872,217645778.0,47902302.0,169743475.0,2255,608,1647,317405,70930,246475,215164510.0,47742850.0,167421659.0,0.6732,0.6793,0.6731,0.6793
2023-11-14 15:45,2309,1525,784,334365,242836,91529,225817781.0,163764119.0,62053662.0,2253,1476,777,332267,240222,92045,224250939.0,161813999.0,62436939.0,0.6744,0.678,0.6736,0.6783
2023-11-14 15:50,1646,1302,344,240043,208017,32026,163252463.0,140737441.0,22515022.0,1558,1262,296,232931,204167,28764,158453230.0,137719598.0,20733632.0,0.6766,0.703,0.6745,0.7208
2023-11-14 15:55,2127,1882,245,352830,338563,14267,239470324.0,228956790.0,10513533.0,2088,1870,218,351098,337934,13164,237633387.0,227913835.0,9719551.0,0.6763,0.7369,0.6744,0.7383
2023-11-14 16:00,425,231,194,37859,24890,12969,26020078.0,16882323.0,9137755.0,361,200,161,34721,23094,11627,23505940.0,15583851.0,7922088.0,0.6783,0.7046,0.6748,0.6814
2023-11-14 16:05,337,206,131,25925,15964,9961,17597824.0,10793011.0,6804812.0,305,193,112,23049,14531,8518,15638156.0,9824474.0,5813681.0,0.6761,0.6831,0.6761,0.6825
2023-11-14 16:10,262,142,120,16018,11128,4890,10845334.0,7526907.0,3318426.0,216,123,93,14605,10925,3680,9881931.0,7370582.0,2511349.0,0.6764,0.6786,0.6747,0.6824
2023-11-14 16:15,169,85,84,10174,5966,4208,6929329.0,4082055.0,2847274.0,157,78,79,8913,5055,3858,6043823.0,3412570.0,2631253.0,0.6842,0.6766,0.6751,0.682
2023-11-14 16:20,111,57,54,4876,2509,2367,4477045.0,2872845.0,1604200.0,72,30,42,4080,1862,2218,3957289.0,2427424.0,1529864.0,1.145,0.6777,1.3037,0.6897
2023-11-14 16:25,80,42,38,5018,2312,2706,3456011.0,1598253.0,1857758.0,73,39,34,5119,2596,2523,3482432.0,1750890.0,1731541.0,0.6913,0.6865,0.6745,0.6863
2023-11-14 16:30,304,204,100,27841,20952,6889,18830568.0,14154549.0,4676018.0,304,204,100,27656,20545,7111,18722286.0,13867510.0,4854775.0,0.6756,0.6788,0.675,0.6827
2023-11-14 16:35,300,210,90,23567,18532,5035,16049070.0,12577083.0,3471987.0,249,175,74,26140,18245,7895,17830166.0,12344151.0,5486015.0,0.6787,0.6896,0.6766,0.6949
2023-11-14 16:40,100,62,38,9570,4718,4852,6548047.0,3180364.0,3367682.0,106,62,44,6378,4508,1870,4325138.0,3044092.0,1281046.0,0.6741,0.6941,0.6753,0.6851
2023-11-14 16:45,506,291,215,51828,29358,22470,35378236.0,19941255.0,15436980.0,451,261,190,47297,28455,18842,32444873.0,19265775.0,13179098.0,0.6792,0.687,0.6771,0.6995
2023-11-14 16:50,206,101,105,16862,7900,8962,11454399.0,5354804.0,6099595.0,186,88,98,16272,7308,8964,11048935.0,4937635.0,6111299.0,0.6778,0.6806,0.6756,0.6818
2023-11-14 16:55,347,219,128,25613,14809,10804,20056658.0,10112480.0,9944178.0,296,189,107,25009,16033,8976,19444293.0,10759310.0,8684982.0,0.6829,0.9204,0.6711,0.9676
2023-11-14 17:00,310,159,151,18643,11073,7570,13168339.0,7600453.0,5567886.0,225,117,108,14860,8983,5877,10143675.0,6103789.0,4039885.0,0.6864,0.7355,0.6795,0.6874
2023-11-14 17:05,174,103,71,9959,6105,3854,9426092.0,4198072.0,5228019.0,142,77,65,9580,4669,4911,9076284.0,3169593.0,5906691.0,0.6876,1.3565,0.6789,1.2027
2023-11-14 17:10,285,168,117,31303,21027,10276,21485943.0,14275652.0,7210291.0,230,134,96,31254,20936,10318,21698340.0,14209292.0,7489047.0,0.6789,0.7017,0.6787,0.7258
2023-11-14 17:15,204,84,120,18735,6065,12670,12764374.0,4124942.0,8639432.0,174,65,109,17582,5823,11759,11974095.0,3946313.0,8027782.0,0.6801,0.6819,0.6777,0.6827
2023-11-14 17:20,308,118,190,31641,9788,21853,21607247.0,6668997.0,14938250.0,273,91,182,30691,9448,21243,20935007.0,6416817.0,14518190.0,0.6813,0.6836,0.6792,0.6834
2023-11-14 17:25,1087,326,761,135272,30941,104331,91861302.0,20941902.0,70919399.0,1001,274,727,124023,27056,96967,84288864.0,18321085.0,65967778.0,0.6768,0.6798,0.6772,0.6803
2023-11-14 17:30,1757,432,1325,256523,29827,226696,175829026.0,20881823.0,154947203.0,1701,399,1302,251908,25554,226354,172260142.0,17836284.0,154423858.0,0.7001,0.6835,0.698,0.6822
2023-11-14 17:35,1395,379,1016,131205,17216,113989,89002829.0,11615370.0,77387459.0,1303,323,980,126767,15922,110845,86041575.0,10743285.0,75298290.0,0.6747,0.6789,0.6747,0.6793
2023-11-14 17:40,1246,528,718,129858,22310,107548,88150753.0,15074661.0,73076091.0,1243,516,727,129834,21845,107989,88146733.0,14744788.0,73401944.0,0.6757,0.6795,0.675,0.6797
2023-11-14 17:45,1309,696,613,127597,48506,79091,86568580.0,32763812.0,53804768.0,1269,667,602,124940,46935,78005,84794031.0,31702265.0,53091766.0,0.6755,0.6803,0.6755,0.6806
2023-11-14 17:50,449,229,220,41415,17573,23842,28040477.0,11867292.0,16173185.0,373,169,204,38850,15308,23542,26332797.0,10296062.0,16036734.0,0.6753,0.6783,0.6726,0.6812
2023-11-14 17:55,752,245,507,86224,17531,68693,58444480.0,11808496.0,46635983.0,735,229,506,85378,17403,67975,57914398.0,11721409.0,46192989.0,0.6736,0.6789,0.6735,0.6796
2023-11-14 18:00,520,167,353,52634,10686,41948,36312384.0,7836184.0,28476200.0,497,152,345,51709,11019,40690,35637147.0,8012013.0,27625134.0,0.7333,0.6788,0.7271,0.6789
2023-11-14 18:05,254,95,159,22117,6081,16036,14981060.0,4097395.0,10883664.0,242,89,153,21487,6436,15051,14551259.0,4331631.0,10219628.0,0.6738,0.6787,0.673,0.679
2023-11-14 18:10,345,150,195,29980,12566,17414,20316465.0,8468230.0,11848235.0,306,125,181,26229,9922,16307,17787288.0,6680904.0,11106384.0,0.6739,0.6804,0.6733,0.6811
2023-11-14 18:15,224,130,94,20390,12251,8139,13747646.0,8263861.0,5483784.0,200,115,85,19688,11840,7848,13293591.0,7966846.0,5326745.0,0.6745,0.6738,0.6729,0.6787
2023-11-14 18:20,1358,583,775,151747,50656,101091,102744706.0,34159784.0,68584921.0,1330,560,770,151214,50586,100628,102365230.0,34092226.0,68273004.0,0.6743,0.6784,0.6739,0.6785
2023-11-14 18:25,852,243,609,112376,29126,83250,76088385.0,19619261.0,56469124.0,823,221,602,110031,27252,82779,74511208.0,18350588.0,56160619.0,0.6736,0.6783,0.6734,0.6784
2023-11-14 18:30,803,85,718,119923,3857,116066,84735083.0,2611341.0,82123741.0,772,65,707,119338,3475,115863,85091458.0,2342954.0,82748504.0,0.677,0.7076,0.6742,0.7142
2023-11-14 18:35,1347,117,1230,206322,2904,203418,140389278.0,2015002.0,138374276.0,1255,70,1185,204814,1676,203138,139352170.0,1124213.0,138227957.0,0.6939,0.6802,0.6708,0.6805
2023-11-29 10:00,7141,6084,1057,804395,717466,86929,531220.0,473214.0,473214.0,6870,5946,924,790668,709333,81335,522605.0,468479.0,468479.0,0.0007,0.0007,0.0007,0.0007
2023-11-29 10:05,2513,398,2115,274871,49229,225642,182614.0,31998.0,31998.0,2373,333,2040,265178,44274,220904,176940.0,29253.0,29253.0,0.0006,0.0007,0.0007,0.0007
2023-11-29 10:10,3218,2469,749,530700,457291,73409,352224.0,303259.0,303259.0,3144,2432,712,525296,455118,70178,349214.0,302363.0,302363.0,0.0007,0.0007,0.0007,0.0007
2023-11-29 10:15,19560,18881,679,3578939,3515647,63292,2379006.0,2336676.0,2336676.0,19374,18773,601,3563812,3512443,51369,2369871.0,2335479.0,2335479.0,0.0007,0.0007,0.0007,0.0007
2023-11-29 10:20,872,661,211,93189,81107,12082,61542.0,53469.0,53469.0,789,608,181,89769,79089,10680,59667.0,52519.0,52519.0,0.0007,0.0007,0.0007,0.0007
2023-11-29 10:25,4763,3070,1693,733474,481232,252242,487362.0,319355.0,319355.0,4479,2905,1574,709242,464020,245222,475635.0,310722.0,310722.0,0.0007,0.0007,0.0007,0.0007
2023-11-29 10:30,5739,1202,4537,919282,109849,809433,618855.0,73639.0,73639.0,5553,1118,4435,915514,114006,801508,618178.0,76550.0,76550.0,0.0007,0.0007,0.0007,0.0007
2023-11-29 10:35,1615,309,1306,275170,23148,252022,185330.0,15253.0,15253.0,1530,281,1249,272054,22918,249136,183704.0,15339.0,15339.0,0.0007,0.0007,0.0007,0.0007
2023-11-29 10:40,1843,299,1544,313374,30218,283156,209253.0,20001.0,20001.0,1762,250,1512,304133,23574,280559,204172.0,15685.0,15685.0,0.0007,0.0007,0.0007,0.0007
2023-11-29 10:45,1490,561,929,207508,43767,163741,138620.0,28818.0,28818.0,1431,524,907,205133,42605,162528,137373.0,28367.0,28367.0,0.0007,0.0007,0.0007,0.0007
2023-11-29 10:50,1244,223,1021,189374,16698,172676,126807.0,11110.0,11110.0,1225,212,1013,187336,15579,171757,125472.0,10371.0,10371.0,0.0007,0.0007,0.0007,0.0007
2023-11-29 10:55,742,228,514,106071,19497,86574,70593.0,12969.0,12969.0,704,211,493,106054,18214,87840,71085.0,12117.0,12117.0,0.0007,0.0007,0.0007,0.0007
2023-11-29 11:00,380,257,123,28279,17872,10407,18867.0,11896.0,11896.0,348,235,113,27020,16809,10211,18030.0,11193.0,11193.0,0.0007,0.0007,0.0007,0.0007
2023-11-29 11:05,1961,210,1751,349271,14365,334906,234283.0,9304.0,9304.0,1930,193,1737,349393,14854,334539,234625.0,9891.0,9891.0,0.0006,0.0007,0.0007,0.0007
2023-11-29 11:10,3583,690,2893,564128,68280,495848,375775.0,45376.0,45376.0,3527,653,2874,558624,64662,493962,373255.0,43000.0,43000.0,0.0007,0.0007,0.0007,0.0007
2023-11-29 11:15,1983,582,1401,272369,47962,224407,181392.0,30918.0,30918.0,1956,572,1384,274904,51185,223719,184052.0,34031.0,34031.0,0.0006,0.0007,0.0007,0.0007
2023-11-29 11:20,1033,372,661,134906,36125,98781,90145.0,23819.0,23819.0,990,352,638,132103,33565,98538,88550.0,22366.0,22366.0,0.0007,0.0007,0.0007,0.0007
2023-11-29 11:25,407,192,215,39837,18733,21104,26654.0,12486.0,12486.0,381,183,198,38641,17628,21013,25854.0,11750.0,11750.0,0.0007,0.0007,0.0007,0.0007
2023-11-29 11:30,344,170,174,29152,17159,11993,19363.0,11446.0,11446.0,318,155,163,28197,16747,11450,18853.0,11173.0,11173.0,0.0007,0.0007,0.0007,0.0007
2023-11-29 11:35,490,424,66,33411,29920,3491,22281.0,19929.0,19929.0,469,411,58,34352,31963,2389,22900.0,21296.0,21296.0,0.0007,0.0007,0.0007,0.0007
2023-11-29 11:40,1578,432,1146,212974,32687,180287,142112.0,21610.0,21610.0,1534,406,1128,211627,31901,179726,141922.0,21275.0,21275.0,0.0007,0.0007,0.0007,0.0007
2023-11-29 11:45,4143,1874,2269,632434,201885,430549,423517.0,134402.0,134402.0,4112,1860,2252,631934,202002,429932,423504.0,134634.0,134634.0,0.0007,0.0007,0.0007,0.0007
2023-11-29 11:50,186,57,129,14789,4754,10035,9797.0,3082.0,3082.0,161,40,121,13290,3657,9633,8892.0,2435.0,2435.0,0.0006,0.0007,0.0007,0.0007
2023-11-29 11:55,276,93,183,32486,6795,25691,21594.0,4507.0,4507.0,247,77,170,29306,5920,23386,19674.0,3949.0,3949.0,0.0007,0.0007,0.0007,0.0007
2023-11-29 12:00,77,47,30,4642,2678,1964,2742.0,1772.0,1772.0,53,30,23,3337,2110,1227,2229.0,1404.0,1404.0,0.0007,0.0005,0.0007,0.0007
2023-11-29 12:05,50,23,27,2760,616,2144,1851.0,410.0,410.0,42,19,23,2753,613,2140,1844.0,408.0,408.0,0.0007,0.0007,0.0007,0.0007
2023-11-29 12:10,79,39,40,6767,2896,3871,4522.0,1927.0,1927.0,72,37,35,6175,2666,3509,4130.0,1774.0,1774.0,0.0007,0.0007,0.0007,0.0007
2023-11-29 12:15,313,139,174,22547,10919,11628,14871.0,7230.0,7230.0,275,115,160,21344,10436,10908,14210.0,6919.0,6919.0,0.0007,0.0007,0.0007,0.0007
2023-11-29 12:20,151,91,60,9835,5055,4780,6475.0,3348.0,3348.0,119,63,56,9283,4620,4663,6182.0,3064.0,3064.0,0.0007,0.0007,0.0007,0.0007
2023-11-29 12:25,64,35,29,3009,983,2026,1945.0,650.0,650.0,36,14,22,2309,595,1714,1543.0,395.0,395.0,0.0007,0.0006,0.0007,0.0007
2023-11-29 12:30,94,54,40,6601,2843,3758,4335.0,1878.0,1878.0,77,45,32,5783,2645,3138,3851.0,1752.0,1752.0,0.0007,0.0007,0.0007,0.0007
2023-11-29 12:35,52,26,26,4011,1496,2515,2574.0,924.0,924.0,46,25,21,4068,1556,2512,2711.0,1030.0,1030.0,0.0006,0.0007,0.0007,0.0007
2023-11-29 12:40,2565,580,1985,399305,57542,341763,264913.0,38034.0,38034.0,2520,554,1966,395169,55190,339979,262742.0,36539.0,36539.0,0.0007,0.0007,0.0007,0.0007
2023-11-29 12:45,3322,1206,2116,457485,124515,332970,304140.0,82281.0,82281.0,3289,1193,2096,456140,123649,332491,303466.0,81918.0,81918.0,0.0007,0.0007,0.0007,0.0007
2023-11-29 12:50,175,108,67,16372,10879,5493,10824.0,7157.0,7157.0,161,99,62,14751,9209,5542,9804.0,6104.0,6104.0,0.0007,0.0007,0.0007,0.0007
2023-11-29 12:55,816,528,288,109307,74102,35205,72480.0,49052.0,49052.0,805,525,280,108351,73599,34752,71923.0,48747.0,48747.0,0.0007,0.0007,0.0007,0.0007
2023-11-29 13:00,48,22,26,1641,1050,591,1025.0,650.0,650.0,37,18,19,1557,1019,538,1032.0,673.0,673.0,0.0006,0.0006,0.0007,0.0007
2023-11-29 13:05,17715,16915,800,3213261,3125202,88059,2129511.0,2070786.0,2070786.0,17693,16901,792,3211067,3123762,87305,2128394.0,2070162.0,2070162.0,0.0007,0.0007,0.0007,0.0007
2023-11-29 13:10,71,43,28,4744,3334,1410,3136.0,2211.0,2211.0,56,37,19,4425,3353,1072,2943.0,2224.0,2224.0,0.0007,0.0007,0.0007,0.0007
2023-11-29 13:15,55,35,20,6713,4104,2609,4437.0,2696.0,2696.0,49,33,16,5697,3390,2307,3789.0,2247.0,2247.0,0.0007,0.0007,0.0007,0.0007
2023-11-29 13:20,62,37,25,3868,2220,1648,2571.0,1471.0,1471.0,51,28,23,3747,2027,1720,2494.0,1346.0,1346.0,0.0007,0.0007,0.0007,0.0007
2023-11-29 13:25,52,28,24,5219,3674,1545,3471.0,2438.0,2438.0,50,28,22,4901,3436,1465,3261.0,2281.0,2281.0,0.0007,0.0007,0.0007,0.0007
2023-11-29 13:30,54,41,13,5684,4926,758,3776.0,3270.0,3270.0,51,38,13,5668,4908,760,3766.0,3259.0,3259.0,0.0007,0.0007,0.0007,0.0007
2023-11-29 13:35,95,20,75,5535,688,4847,3651.0,428.0,428.0,84,13,71,5547,497,5050,3708.0,330.0,330.0,0.0006,0.0007,0.0007,0.0007
2023-11-29 13:40,59,32,27,5866,3071,2795,3695.0,1838.0,1838.0,52,28,24,5413,2752,2661,3604.0,1827.0,1827.0,0.0006,0.0007,0.0007,0.0007
2023-11-29 13:45,98,57,41,7985,4667,3318,5249.0,3026.0,3026.0,87,49,38,7516,4371,3145,5003.0,2900.0,2900.0,0.0006,0.0007,0.0007,0.0007
2023-11-29 13:50,125,65,60,12225,8700,3525,7967.0,5772.0,5772.0,114,63,51,11817,8746,3071,7856.0,5803.0,5803.0,0.0007,0.0006,0.0007,0.0007
2023-11-29 13:55,928,799,129,128642,118102,10540,84941.0,77886.0,77886.0,918,790,128,127675,117151,10524,84988.0,77941.0,77941.0,0.0007,0.0007,0.0007,0.0007
2023-11-29 14:00,1961,1952,9,251627,251058,569,167599.0,167219.0,167219.0,1953,1947,6,252452,252169,283,168142.0,167953.0,167953.0,0.0007,0.0007,0.0007,0.0007
2023-11-29 14:05,747,562,185,95315,77261,18054,63407.0,51322.0,51322.0,710,537,173,93590,76188,17402,62272.0,50626.0,50626.0,0.0007,0.0007,0.0007,0.0007
2023-11-29 14:10,395,359,36,56131,54366,1765,37174.0,36009.0,36009.0,373,349,24,55133,53722,1411,36636.0,35691.0,35691.0,0.0007,0.0007,0.0007,0.0007
2023-11-29 14:15,57,41,16,4844,3876,968,3101.0,2513.0,2513.0,46,35,11,4382,3726,656,2917.0,2478.0,2478.0,0.0006,0.0006,0.0007,0.0007
2023-11-29 14:20,3892,2709,1183,563979,460827,103152,375699.0,306413.0,306413.0,3812,2674,1138,559940,457697,102243,374642.0,305849.0,305849.0,0.0007,0.0007,0.0007,0.0007
2023-11-29 14:25,4984,3221,1763,714121,574638,139483,476531.0,383886.0,383886.0,4914,3189,1725,710890,573804,137086,475462.0,383357.0,383357.0,0.0007,0.0007,0.0007,0.0007
2023-11-29 14:30,1675,166,1509,127082,24862,102220,85118.0,16561.0,16561.0,1655,154,1501,126677,24599,102078,84838.0,16387.0,16387.0,0.0007,0.0007,0.0007,0.0007
2023-11-29 14:35,2189,347,1842,299095,57377,241718,199785.0,38199.0,38199.0,2182,348,1834,297803,57092,240711,199326.0,38007.0,38007.0,0.0007,0.0007,0.0007,0.0007
2023-11-29 14:40,1184,123,1061,190190,11361,178829,127408.0,7561.0,7561.0,1160,115,1045,188756,11433,177323,126471.0,7609.0,7609.0,0.0007,0.0007,0.0007,0.0007
2023-11-29 14:45,3355,185,3170,590366,21174,569192,392906.0,14043.0,14043.0,3294,158,3136,585548,20557,564991,390634.0,13642.0,13642.0,0.0007,0.0007,0.0007,0.0007
2023-11-29 14:50,804,111,693,131854,8410,123444,87342.0,5502.0,5502.0,773,92,681,129916,7414,122502,86513.0,4913.0,4913.0,0.0007,0.0007,0.0007,0.0007
2023-11-29 14:55,452,132,320,57542,10669,46873,38238.0,7057.0,7057.0,431,121,310,57002,10957,46045,37936.0,7262.0,7262.0,0.0007,0.0007,0.0007,0.0007
2023-11-29 15:00,99,57,42,6368,3861,2507,4225.0,2557.0,2557.0,96,55,41,6095,3847,2248,4046.0,2550.0,2550.0,0.0007,0.0007,0.0007,0.0007
2023-11-29 15:05,89,33,56,7160,1276,5884,4757.0,841.0,841.0,72,26,46,6738,1179,5559,4478.0,781.0,781.0,0.0007,0.0007,0.0007,0.0007
2023-11-29 15:10,1144,99,1045,194995,7496,187499,128774.0,4937.0,4937.0,1095,64,1031,191139,5958,185181,126889.0,3925.0,3925.0,0.0007,0.0007,0.0007,0.0007
2023-11-29 15:15,3188,70,3118,560998,4632,556366,372425.0,3039.0,3039.0,3155,50,3105,560616,4521,556095,372351.0,2972.0,2972.0,0.0007,0.0007,0.0007,0.0007
2023-11-29 15:20,16585,300,16285,2978568,10386,2968182,1977957.0,6857.0,6857.0,16568,289,16279,2977963,9634,2968329,1977569.0,6369.0,6369.0,0.0007,0.0007,0.0007,0.0007
2023-11-29 15:25,973,80,893,160099,2442,157657,106256.0,1601.0,1601.0,964,73,891,159789,2120,157669,106066.0,1401.0,1401.0,0.0007,0.0007,0.0007,0.0007
2023-11-29 15:30,431,62,369,60684,2752,57932,40126.0,1701.0,1701.0,400,48,352,59433,2018,57415,39480.0,1334.0,1334.0,0.0006,0.0007,0.0007,0.0007
2023-11-29 15:35,628,48,580,116818,2435,114383,77563.0,1475.0,1475.0,614,41,573,115605,2008,113597,76820.0,1328.0,1328.0,0.0006,0.0007,0.0007,0.0007
2023-11-29 15:40,746,231,515,103238,17008,86230,68528.0,11225.0,11225.0,738,226,512,103207,17029,86178,68539.0,11269.0,11269.0,0.0007,0.0007,0.0007,0.0007
2023-11-29 15:45,1991,203,1788,290817,18616,272201,193106.0,12269.0,12269.0,1981,196,1785,290864,18619,272245,193179.0,12303.0,12303.0,0.0007,0.0007,0.0007,0.0007
2023-11-29 15:50,368,188,180,41223,17363,23860,27162.0,11482.0,11482.0,342,173,169,39702,16945,22757,26325.0,11210.0,11210.0,0.0007,0.0007,0.0007,0.0007
2023-11-29 15:55,740,108,632,98014,5321,92693,64693.0,3482.0,3482.0,711,96,615,96897,5017,91880,64297.0,3312.0,3312.0,0.0007,0.0007,0.0007,0.0007
2023-11-29 16:00,14565,2584,11981,2411633,250224,2161409,1592624.0,164195.0,164195.0,14486,2533,11953,2400686,242637,2158049,1587228.0,159582.0,159582.0,0.0007,0.0007,0.0007,0.0007
2023-11-29 16:05,7499,2369,5130,1096830,239031,857799,724417.0,157106.0,157106.0,7460,2339,5121,1096086,238589,857497,724291.0,156933.0,156933.0,0.0007,0.0007,0.0007,0.0007
2023-11-29 16:10,4748,1641,3107,705121,176815,528306,465175.0,116105.0,116105.0,4724,1627,3097,704450,176504,527946,464945.0,115989.0,115989.0,0.0007,0.0007,0.0007,0.0007
2023-11-29 16:15,13726,1672,12054,2275905,173528,2102377,1501202.0,113972.0,113972.0,13704,1664,12040,2275829,173625,2102204,1501167.0,114041.0,114041.0,0.0007,0.0007,0.0007,0.0007
2023-11-29 16:20,4472,1700,2772,522944,162886,360058,343136.0,106775.0,106775.0,4412,1656,2756,517724,160035,357689,341101.0,104997.0,104997.0,0.0007,0.0007,0.0007,0.0007
2023-11-29 16:25,2951,1035,1916,383641,115546,268095,251377.0,75600.0,75600.0,2888,994,1894,376469,111001,265468,247616.0,72673.0,72673.0,0.0007,0.0007,0.0007,0.0007
2023-11-29 16:30,254,115,139,26790,14110,12680,17532.0,9202.0,9202.0,230,98,132,26537,13784,12753,17390.0,9007.0,9007.0,0.0007,0.0007,0.0007,0.0007
2023-11-29 16:35,692,80,612,84950,7593,77357,55743.0,4798.0,4798.0,668,65,603,84142,6955,77187,55378.0,4546.0,4546.0,0.0006,0.0007,0.0007,0.0007
2023-11-29 16:40,1430,943,487,149286,94638,54648,97239.0,61232.0,61232.0,1396,925,471,146355,92532,53823,96046.0,60581.0,60581.0,0.0006,0.0007,0.0007,0.0007
2023-11-29 16:45,427,280,147,43070,26718,16352,28269.0,17462.0,17462.0,376,249,127,39369,24169,15200,25911.0,15852.0,15852.0,0.0007,0.0007,0.0007,0.0007
2023-11-29 16:50,188,57,131,15573,6056,9517,10135.0,3976.0,3976.0,174,52,122,14755,5931,8824,9727.0,3895.0,3895.0,0.0007,0.0006,0.0007,0.0007
2023-11-29 16:55,402,217,185,41480,26937,14543,27264.0,17671.0,17671.0,385,209,176,40679,26555,14124,26746.0,17419.0,17419.0,0.0007,0.0007,0.0007,0.0007
2023-11-29 17:00,4308,2749,1559,503561,362001,141560,330683.0,237247.0,237247.0,4282,2735,1547,501950,361077,140873,329834.0,236840.0,236840.0,0.0007,0.0007,0.0007,0.0007
2023-11-29 17:05,1268,1111,157,145652,136450,9202,95518.0,89506.0,89506.0,1252,1112,140,147053,138075,8978,96481.0,90553.0,90553.0,0.0007,0.0007,0.0007,0.0007
2023-11-29 17:10,45,26,19,4630,3977,653,3033.0,2602.0,2602.0,58,24,34,3990,3068,922,2621.0,2011.0,2011.0,0.0007,0.0007,0.0007,0.0007
2023-11-29 17:15,1841,1312,529,215271,176301,38970,141382.0,115691.0,115691.0,1832,1308,524,215157,176415,38742,141299.0,115758.0,115758.0,0.0007,0.0007,0.0007,0.0007
2023-11-29 17:20,1258,999,259,143271,128243,15028,94067.0,84169.0,84169.0,1253,992,261,143376,128224,15152,94139.0,84157.0,84157.0,0.0007,0.0007,0.0007,0.0007
2023-11-29 17:25,254,138,116,23872,16262,7610,15049.0,10664.0,10664.0,243,134,109,22223,15886,6337,14594.0,10418.0,10418.0,0.0007,0.0006,0.0007,0.0007
2023-11-29 17:30,405,178,227,42714,20367,22347,28073.0,13341.0,13341.0,398,173,225,42315,19968,22347,27817.0,13082.0,13082.0,0.0007,0.0007,0.0007,0.0007
2023-11-29 17:35,337,35,302,30621,2833,27788,20129.0,1827.0,1827.0,331,32,299,30615,2796,27819,20156.0,1833.0,1833.0,0.0006,0.0007,0.0007,0.0007
2023-11-29 17:40,1898,1067,831,219483,106776,112707,144357.0,69975.0,69975.0,1895,1069,826,220244,107630,112614,144909.0,70571.0,70571.0,0.0007,0.0007,0.0007,0.0007
2023-11-29 17:45,286,104,182,25142,9258,15884,16112.0,5932.0,5932.0,261,85,176,24107,8670,15437,15850.0,5678.0,5678.0,0.0006,0.0006,0.0007,0.0007
2023-11-29 17:50,448,239,209,58193,21484,36709,38294.0,14071.0,14071.0,440,231,209,58149,21472,36677,38280.0,14079.0,14079.0,0.0007,0.0007,0.0007,0.0007
2023-11-29 17:55,243,103,140,29022,9112,19910,19056.0,5973.0,5973.0,231,99,132,28518,8960,19558,18780.0,5874.0,5874.0,0.0007,0.0007,0.0007,0.0007
2023-11-29 18:00,672,171,501,82153,15926,66227,54071.0,10425.0,10425.0,659,163,496,82629,16248,66381,54370.0,10619.0,10619.0,0.0007,0.0007,0.0007,0.0007
2023-11-29 18:05,2417,376,2041,341861,28766,313095,224871.0,18794.0,18794.0,2396,362,2034,341187,28620,312567,224744.0,18719.0,18719.0,0.0007,0.0007,0.0007,0.0007
2023-11-29 18:10,3608,440,3168,512077,39652,472425,337103.0,25934.0,25934.0,3594,430,3164,511476,39586,471890,336838.0,25891.0,25891.0,0.0007,0.0007,0.0007,0.0007
2023-11-29 18:15,4649,1492,3157,678664,124627,554037,446419.0,81280.0,81280.0,4618,1467,3151,676726,123393,553333,445441.0,80768.0,80768.0,0.0007,0.0007,0.0007,0.0007
2023-11-29 18:20,6741,1051,5690,993765,136432,857333,653502.0,89174.0,89174.0,6722,1042,5680,991814,135581,856233,652323.0,88631.0,88631.0,0.0007,0.0007,0.0007,0.0007
2023-11-29 18:25,6294,462,5832,989492,32943,956549,651104.0,21479.0,21479.0,6283,451,5832,990491,33598,956893,651759.0,21904.0,21904.0,0.0007,0.0007,0.0007,0.0007
2023-11-29 18:30,4603,376,4227,765102,18252,746850,503109.0,11592.0,11592.0,4585,367,4218,766128,18775,747353,504106.0,12222.0,12222.0,0.0006,0.0007,0.0007,0.0007
2023-11-29 18:35,2907,75,2832,556196,3066,553130,365309.0,1961.0,1961.0,2886,68,2818,554320,3058,551262,364901.0,1975.0,1975.0,0.0006,0.0007,0.0006,0.0007
2023-11-30 10:00,21101,6427,14674,2626616,763694,1862922,1723346.0,497276.0,497276.0,20841,6301,14540,2613034,759178,1853856,1714461.0,494700.0,494700.0,0.0007,0.0007,0.0007,0.0007
2023-11-30 10:05,3313,1382,1931,380576,161713,218863,246860.0,104658.0,104658.0,3171,1292,1879,366289,154824,211465,239115.0,100404.0,100404.0,0.0006,0.0006,0.0006,0.0007
2023-11-30 10:10,11221,5977,5244,1356631,679277,677354,881526.0,439263.0,439263.0,11115,5898,5217,1351990,677020,674970,879109.0,438395.0,438395.0,0.0006,0.0007,0.0006,0.0007
2023-11-30 10:15,2599,1029,1570,319394,90177,229217,207031.0,57746.0,57746.0,2441,947,1494,318843,91549,227294,207285.0,59045.0,59045.0,0.0006,0.0007,0.0006,0.0007
2023-11-30 10:20,3599,1353,2246,497363,131923,365440,323248.0,85120.0,85120.0,3515,1300,2215,490522,127199,363323,319214.0,82144.0,82144.0,0.0006,0.0007,0.0006,0.0007
2023-11-30 10:25,363,224,139,40356,15070,25286,26453.0,9726.0,9726.0,327,197,130,34101,13847,20254,22171.0,8966.0,8966.0,0.0006,0.0007,0.0006,0.0007
2023-11-30 10:30,1355,475,880,178123,40863,137260,116110.0,26165.0,26165.0,1335,462,873,176717,40201,136516,115526.0,26085.0,26085.0,0.0006,0.0007,0.0006,0.0007
2023-11-30 10:35,1160,649,511,111462,61135,50327,72523.0,39675.0,39675.0,1149,647,502,112297,62066,50231,73059.0,40274.0,40274.0,0.0006,0.0007,0.0006,0.0007
2023-11-30 10:40,3681,1287,2394,538366,117713,420653,353678.0,75445.0,75445.0,3554,1227,2327,531223,113130,418093,350496.0,73917.0,73917.0,0.0006,0.0007,0.0007,0.0007
2023-11-30 10:45,616,333,283,60954,24572,36382,39603.0,15897.0,15897.0,532,276,256,58389,23035,35354,38331.0,15047.0,15047.0,0.0006,0.0007,0.0007,0.0007
2023-11-30 10:50,389,93,296,47572,7297,40275,31133.0,4737.0,4737.0,344,77,267,45105,6170,38935,29546.0,4017.0,4017.0,0.0006,0.0007,0.0007,0.0007
2023-11-30 10:55,181,87,94,17986,8994,8992,11536.0,5845.0,5845.0,155,76,79,16586,8231,8355,10836.0,5353.0,5353.0,0.0006,0.0006,0.0007,0.0007
2023-11-30 11:00,294,102,192,20505,6382,14123,13245.0,4147.0,4147.0,266,93,173,20819,7110,13709,13580.0,4620.0,4620.0,0.0006,0.0006,0.0006,0.0007
2023-11-30 11:05,710,305,405,73355,30060,43295,47489.0,19479.0,19479.0,653,276,377,69195,28537,40658,45047.0,18514.0,18514.0,0.0006,0.0006,0.0006,0.0007
2023-11-30 11:10,2321,897,1424,264890,90000,174890,172106.0,58196.0,58196.0,2269,866,1403,262000,87570,174430,170303.0,56667.0,56667.0,0.0006,0.0007,0.0006,0.0007
2023-11-30 11:15,1225,552,673,123899,49803,74096,80286.0,32094.0,32094.0,1175,526,649,124278,50775,73503,80616.0,32812.0,32812.0,0.0006,0.0007,0.0006,0.0007
2023-11-30 11:20,4271,318,3953,782267,34462,747805,507713.0,21689.0,21689.0,4240,305,3935,779122,33112,746010,506465.0,21408.0,21408.0,0.0006,0.0006,0.0006,0.0007
2023-11-30 11:25,68,43,25,5141,3862,1279,3316.0,2483.0,2483.0,54,32,22,5225,3896,1329,3375.0,2508.0,2508.0,0.0006,0.0007,0.0006,0.0007
2023-11-30 11:30,277,208,69,32604,26525,6079,20875.0,17098.0,17098.0,250,194,56,31448,26071,5377,20341.0,16843.0,16843.0,0.0006,0.0006,0.0006,0.0007
2023-11-30 11:35,1703,1639,64,281466,274314,7152,181712.0,177066.0,177066.0,1681,1623,58,280954,274205,6749,181399.0,177014.0,177014.0,0.0006,0.0006,0.0006,0.0006
2023-11-30 11:40,1574,1391,183,253182,234160,19022,163665.0,151328.0,151328.0,1553,1380,173,252200,233451,18749,163059.0,150873.0,150873.0,0.0006,0.0006,0.0006,0.0006
2023-11-30 11:45,4840,3621,1219,735181,576976,158205,475216.0,372500.0,372500.0,4826,3613,1213,735165,577142,158023,475217.0,372614.0,372614.0,0.0006,0.0006,0.0006,0.0006
2023-11-30 11:50,3638,3110,528,651395,596647,54748,420573.0,385336.0,385336.0,3616,3102,514,650099,596296,53803,420039.0,385106.0,385106.0,0.0006,0.0006,0.0006,0.0006
2023-11-30 11:55,2761,1835,926,376297,274879,101418,243176.0,177327.0,177327.0,2772,1828,944,377704,274597,103107,244113.0,177149.0,177149.0,0.0006,0.0006,0.0006,0.0006
2023-11-30 12:00,3596,3047,549,543843,476943,66900,351339.0,308048.0,308048.0,3574,3030,544,543369,476846,66523,351213.0,307991.0,307991.0,0.0006,0.0006,0.0006,0.0006
2023-11-30 12:05,3358,3169,189,578322,557806,20516,373896.0,360564.0,360564.0,3336,3152,184,577401,557261,20140,373302.0,360214.0,360214.0,0.0006,0.0006,0.0006,0.0006
2023-11-30 12:10,451,262,189,59100,44081,15019,38200.0,28444.0,28444.0,438,254,184,58910,43856,15054,38081.0,28301.0,28301.0,0.0006,0.0006,0.0006,0.0006
2023-11-30 12:15,106,69,37,12350,7751,4599,7917.0,4932.0,4932.0,87,56,31,10879,6954,3925,7044.0,4488.0,4488.0,0.0006,0.0006,0.0006,0.0007
2023-11-30 12:20,1126,777,349,160799,131587,29212,103731.0,84729.0,84729.0,1076,770,306,159465,131618,27847,103092.0,84983.0,84983.0,0.0006,0.0007,0.0006,0.0007
2023-11-30 12:25,10803,9537,1266,1762953,1712733,50220,1141242.0,1108399.0,1108399.0,10785,9524,1261,1761021,1710726,50295,1140032.0,1107136.0,1107136.0,0.0006,0.0007,0.0006,0.0007
2023-11-30 12:30,6966,5651,1315,1121221,985859,135362,725729.0,638206.0,638206.0,6956,5646,1310,1119712,985753,133959,725360.0,638167.0,638167.0,0.0006,0.0006,0.0006,0.0007
2023-11-30 12:35,1498,123,1375,266193,12551,253642,173151.0,8109.0,8109.0,1486,114,1372,265549,11782,253767,172758.0,7616.0,7616.0,0.0006,0.0007,0.0006,0.0007
2023-11-30 12:40,3909,258,3651,663097,26029,637068,429629.0,16329.0,16329.0,3859,226,3633,657453,24095,633358,427846.0,15573.0,15573.0,0.0006,0.0006,0.0006,0.0007
2023-11-30 12:45,2634,1599,1035,288963,116888,172075,187136.0,75334.0,75334.0,2605,1586,1019,288163,116368,171795,186945.0,75321.0,75321.0,0.0006,0.0006,0.0006,0.0006
2023-11-30 12:50,9151,8894,257,667333,629801,37532,432043.0,407699.0,407699.0,9122,8878,244,664923,629416,35507,430530.0,407455.0,407455.0,0.0006,0.0006,0.0006,0.0006
2023-11-30 12:55,27,20,7,696,485,211,379.0,241.0,241.0,21,15,6,884,331,553,572.0,212.0,212.0,0.0005,0.0007,0.0006,0.0007
2023-11-30 13:00,68,44,24,3840,2398,1442,2353.0,1477.0,1477.0,48,32,16,3676,2482,1194,2382.0,1603.0,1603.0,0.0006,0.0006,0.0006,0.0007
2023-11-30 13:05,379,313,66,29962,23902,6060,19403.0,15472.0,15472.0,369,304,65,29172,23297,5875,18901.0,15082.0,15082.0,0.0006,0.0006,0.0006,0.0007
2023-11-30 13:10,53,28,25,3208,1833,1375,2057.0,1185.0,1185.0,50,29,21,3328,2052,1276,2155.0,1326.0,1326.0,0.0006,0.0006,0.0006,0.0006
2023-11-30 13:15,188,117,71,17715,8485,9230,11497.0,5481.0,5481.0,172,105,67,17642,8177,9465,11451.0,5276.0,5276.0,0.0006,0.0007,0.0006,0.0007
2023-11-30 13:20,43,27,16,3035,1166,1869,1923.0,705.0,705.0,32,17,15,2825,946,1879,1836.0,611.0,611.0,0.0006,0.0007,0.0006,0.0007
2023-11-30 13:25,49,28,21,3331,1032,2299,2151.0,666.0,666.0,40,22,18,3524,1247,2277,2288.0,803.0,803.0,0.0006,0.0006,0.0006,0.0007
2023-11-30 13:30,159,106,53,11866,7654,4212,7656.0,4949.0,4949.0,149,100,49,11502,7449,4053,7452.0,4817.0,4817.0,0.0006,0.0006,0.0006,0.0007
2023-11-30 13:35,216,81,135,21931,4602,17329,14229.0,2971.0,2971.0,188,61,127,20464,3988,16476,13288.0,2578.0,2578.0,0.0006,0.0006,0.0006,0.0007
2023-11-30 13:40,134,69,65,11296,3851,7445,7298.0,2450.0,2450.0,110,56,54,10083,2976,7107,6550.0,1925.0,1925.0,0.0006,0.0007,0.0006,0.0007
2023-11-30 13:45,120,75,45,10288,4650,5638,6688.0,3005.0,3005.0,110,65,45,8788,3376,5412,5716.0,2184.0,2184.0,0.0006,0.0007,0.0006,0.0007
2023-11-30 13:50,143,115,28,12138,8236,3902,7744.0,5189.0,5189.0,119,97,22,10653,7304,3349,6929.0,4736.0,4736.0,0.0006,0.0007,0.0006,0.0007
2023-11-30 13:55,8822,7788,1034,1369700,1075106,294594,889640.0,697089.0,697089.0,8803,7773,1030,1368191,1074008,294183,888950.0,696665.0,696665.0,0.0006,0.0007,0.0006,0.0007
2023-11-30 14:00,14069,13271,798,2478612,2385689,92923,1607636.0,1546966.0,1546966.0,14061,13267,794,2478133,2385337,92796,1607432.0,1546845.0,1546845.0,0.0006,0.0007,0.0006,0.0007
2023-11-30 14:05,195,143,52,25047,18913,6134,16271.0,12266.0,12266.0,188,138,50,25103,18923,6180,16308.0,12274.0,12274.0,0.0006,0.0007,0.0006,0.0007
2023-11-30 14:10,1061,868,193,181096,156048,25048,117410.0,101045.0,101045.0,1048,859,189,180649,155745,24904,117280.0,101010.0,101010.0,0.0006,0.0007,0.0006,0.0007
2023-11-30 14:15,371,283,88,60265,51894,8371,39089.0,33627.0,33627.0,357,275,82,59332,51374,7958,38491.0,33297.0,33297.0,0.0006,0.0007,0.0006,0.0007
2023-11-30 14:20,99,55,44,9467,4051,5416,5988.0,2441.0,2441.0,76,43,33,8640,3644,4996,5647.0,2373.0,2373.0,0.0006,0.0007,0.0007,0.0007
2023-11-30 14:25,192,101,91,16896,8786,8110,10462.0,5511.0,5511.0,151,79,72,14509,7662,6847,9475.0,4985.0,4985.0,0.0006,0.0006,0.0007,0.0007
2023-11-30 14:30,162,90,72,16456,8137,8319,10744.0,5287.0,5287.0,135,80,55,14488,7312,7176,9473.0,4766.0,4766.0,0.0006,0.0007,0.0007,0.0007
2023-11-30 14:35,138,61,77,13184,5403,7781,8037.0,3513.0,3513.0,121,52,69,10839,4448,6391,7082.0,2892.0,2892.0,0.0007,0.0006,0.0007,0.0007
2023-11-30 14:40,24,19,5,1004,930,74,650.0,602.0,602.0,13,9,4,877,803,74,571.0,522.0,522.0,0.0006,0.0007,0.0007,0.0007
2023-11-30 14:45,141,76,65,12926,6275,6651,8436.0,4084.0,4084.0,138,73,65,12945,6171,6774,8450.0,4017.0,4017.0,0.0007,0.0007,0.0007,0.0007
2023-11-30 14:50,66,26,40,2648,712,1936,1726.0,461.0,461.0,61,23,38,2661,712,1949,1736.0,463.0,463.0,0.0006,0.0007,0.0007,0.0007
2023-11-30 14:55,496,199,297,41608,23885,17723,26859.0,15480.0,15480.0,478,192,286,41050,23871,17179,26692.0,15472.0,15472.0,0.0006,0.0006,0.0006,0.0007
2023-11-30 15:00,533,231,302,54874,30863,24011,35667.0,19995.0,19995.0,520,224,296,55362,31198,24164,35991.0,20214.0,20214.0,0.0006,0.0007,0.0006,0.0007
2023-11-30 15:05,667,127,540,51078,11839,39239,33053.0,7678.0,7678.0,652,119,533,49871,11604,38267,32480.0,7526.0,7526.0,0.0006,0.0006,0.0006,0.0007
2023-11-30 15:10,604,517,87,97779,89778,8001,63181.0,57967.0,57967.0,593,512,81,96024,88104,7920,62103.0,56940.0,56940.0,0.0006,0.0007,0.0006,0.0007
2023-11-30 15:15,42,23,19,3180,2153,1027,2049.0,1397.0,1397.0,32,18,14,2850,1871,979,1855.0,1216.0,1216.0,0.0006,0.0006,0.0006,0.0007
2023-11-30 15:20,45,36,9,3374,2944,430,2202.0,1916.0,1916.0,42,34,8,3086,2956,130,2009.0,1923.0,1923.0,0.0007,0.0007,0.0007,0.0007
2023-11-30 15:25,22,13,9,2065,1316,749,1261.0,771.0,771.0,22,13,9,2474,1598,876,1610.0,1038.0,1038.0,0.0006,0.0007,0.0006,0.0007
2023-11-30 15:30,211,187,24,24512,21813,2699,15859.0,14166.0,14166.0,200,179,21,23837,21323,2514,15514.0,13869.0,13869.0,0.0006,0.0006,0.0007,0.0007
2023-11-30 15:35,815,746,69,95969,86098,9871,62552.0,56071.0,56071.0,802,739,63,93111,85178,7933,60663.0,55470.0,55470.0,0.0007,0.0007,0.0007,0.0007
2023-11-30 15:40,95,52,43,10056,4919,5137,6322.0,2955.0,2955.0,92,51,41,10862,5472,5390,7096.0,3564.0,3564.0,0.0006,0.0007,0.0007,0.0007
2023-11-30 15:45,216,130,86,26538,18598,7940,17048.0,11834.0,11834.0,195,117,78,25247,17700,7547,16460.0,11506.0,11506.0,0.0006,0.0007,0.0007,0.0007
2023-11-30 15:50,113,35,78,9349,2531,6818,6029.0,1625.0,1625.0,101,30,71,8925,2474,6451,5843.0,1613.0,1613.0,0.0006,0.0006,0.0007,0.0007
2023-11-30 15:55,413,51,362,34900,1567,33333,22837.0,1006.0,1006.0,403,47,356,34685,1292,33393,22711.0,835.0,835.0,0.0006,0.0007,0.0006,0.0007
2023-11-30 16:00,191,52,139,12599,1973,10626,8134.0,1274.0,1274.0,187,49,138,12743,2142,10601,8327.0,1383.0,1383.0,0.0006,0.0006,0.0006,0.0007
2023-11-30 16:05,533,143,390,67387,13776,53611,43853.0,8854.0,8854.0,529,143,386,67405,13770,53635,44056.0,8942.0,8942.0,0.0006,0.0007,0.0006,0.0007
2023-11-30 16:10,2114,202,1912,157632,21258,136374,102887.0,13836.0,13836.0,2106,196,1910,157902,21563,136339,103258.0,14029.0,14029.0,0.0007,0.0007,0.0007,0.0007
2023-11-30 16:15,2423,1571,852,310271,245898,64373,202039.0,159993.0,159993.0,2405,1562,843,310468,245760,64708,202434.0,160052.0,160052.0,0.0007,0.0007,0.0007,0.0007
2023-11-30 16:20,6788,1127,5661,1065758,136693,929065,695659.0,88918.0,88918.0,6766,1114,5652,1062338,135764,926574,694555.0,88318.0,88318.0,0.0007,0.0007,0.0007,0.0007
2023-11-30 16:25,10857,632,10225,1948380,57739,1890641,1273158.0,37513.0,37513.0,10843,624,10219,1946125,56372,1889753,1271699.0,36640.0,36640.0,0.0006,0.0007,0.0006,0.0007
2023-11-30 16:30,7182,319,6863,1302079,30151,1271928,850366.0,19583.0,19583.0,7179,318,6861,1302024,30083,1271941,850339.0,19541.0,19541.0,0.0006,0.0007,0.0006,0.0007
2023-11-30 16:35,11207,1634,9573,1889526,163438,1726088,1232289.0,105875.0,105875.0,11177,1619,9558,1887294,162294,1725000,1231434.0,105230.0,105230.0,0.0006,0.0007,0.0006,0.0007
2023-11-30 16:40,4542,1701,2841,631947,162074,469873,411555.0,104977.0,104977.0,4536,1701,2835,632293,162322,469971,411777.0,105134.0,105134.0,0.0006,0.0007,0.0006,0.0007
2023-11-30 16:45,3536,470,3066,616725,45075,571650,400475.0,29122.0,29122.0,3475,432,3043,611566,42915,568651,398486.0,27727.0,27727.0,0.0006,0.0006,0.0006,0.0007
2023-11-30 16:50,3289,159,3130,565970,13574,552396,367425.0,8720.0,8720.0,3229,123,3106,563520,12698,550822,366629.0,8178.0,8178.0,0.0006,0.0006,0.0006,0.0007
2023-11-30 16:55,2966,186,2780,476384,6966,469418,308086.0,4376.0,4376.0,2880,123,2757,472463,4845,467618,306682.0,3097.0,3097.0,0.0006,0.0006,0.0006,0.0006
2023-11-30 17:00,2233,220,2013,380249,17703,362546,242610.0,10795.0,10795.0,2036,83,1953,359238,7230,352008,231728.0,4581.0,4581.0,0.0006,0.0006,0.0006,0.0006
2023-11-30 17:05,653,343,310,57103,25187,31916,36034.0,15625.0,15625.0,517,250,267,55481,24356,31125,35331.0,15385.0,15385.0,0.0006,0.0006,0.0006,0.0006
2023-11-30 17:10,270,167,103,22049,11591,10458,13622.0,6891.0,6891.0,235,151,84,20542,10524,10018,13160.0,6709.0,6709.0,0.0006,0.0006,0.0006,0.0006
2023-11-30 17:15,310,107,203,28608,6566,22042,17999.0,4190.0,4190.0,258,79,179,26027,5605,20422,16699.0,3576.0,3576.0,0.0006,0.0006,0.0006,0.0006
2023-11-30 17:20,306,125,181,23874,6722,17152,15036.0,4129.0,4129.0,278,106,172,22718,6215,16503,14588.0,3975.0,3975.0,0.0006,0.0006,0.0006,0.0006
2023-11-30 17:25,769,272,497,100479,19813,80666,64483.0,12626.0,12626.0,723,233,490,99185,19065,80120,63812.0,12170.0,12170.0,0.0006,0.0006,0.0006,0.0006
2023-11-30 17:30,769,151,618,100249,10351,89898,64303.0,6440.0,6440.0,752,132,620,98673,9135,89538,63471.0,5835.0,5835.0,0.0006,0.0006,0.0006,0.0006
2023-11-30 17:35,127,67,60,8286,3739,4547,5313.0,2383.0,2383.0,109,58,51,8116,3658,4458,5212.0,2341.0,2341.0,0.0006,0.0006,0.0006,0.0006
2023-11-30 17:40,149,70,79,11987,3968,8019,7676.0,2515.0,2515.0,136,61,75,16621,3680,12941,10952.0,2356.0,2356.0,0.0006,0.0006,0.0006,0.0007
2023-11-30 17:45,3080,2238,842,203429,139469,63960,130582.0,89326.0,89326.0,3065,2225,840,203073,138892,64181,130418.0,89015.0,89015.0,0.0006,0.0006,0.0006,0.0006
2023-11-30 17:50,17532,3729,13803,2796566,343921,2452645,1808362.0,220415.0,220415.0,17485,3700,13785,2793904,342327,2451577,1807281.0,220023.0,220023.0,0.0006,0.0006,0.0006,0.0006
2023-11-30 17:55,806,577,229,75358,47711,27647,48444.0,30493.0,30493.0,784,564,220,76009,48853,27156,49068.0,31439.0,31439.0,0.0006,0.0006,0.0006,0.0006
2023-11-30 18:00,354,236,118,33891,20096,13795,21829.0,12919.0,12919.0,324,214,110,33711,19766,13945,21829.0,12706.0,12706.0,0.0006,0.0006,0.0006,0.0007
2023-11-30 18:05,253,92,161,23909,9036,14873,15408.0,5746.0,5746.0,235,96,139,23203,8244,14959,15048.0,5321.0,5321.0,0.0006,0.0006,0.0006,0.0007
2023-11-30 18:10,93,42,51,6868,2963,3905,4411.0,1913.0,1913.0,56,27,29,5446,2855,2591,3525.0,1841.0,1841.0,0.0006,0.0006,0.0006,0.0007
2023-11-30 18:15,138,86,52,12213,7532,4681,7836.0,4794.0,4794.0,126,76,50,11499,7356,4143,7442.0,4750.0,4750.0,0.0006,0.0006,0.0006,0.0006
2023-11-30 18:20,180,142,38,23424,22370,1054,15179.0,14490.0,14490.0,178,139,39,23390,22034,1356,15158.0,14273.0,14273.0,0.0006,0.0007,0.0006,0.0007
2023-11-30 18:25,549,268,281,79575,31966,47609,51762.0,20708.0,20708.0,539,262,277,79903,31729,48174,52055.0,20555.0,20555.0,0.0006,0.0007,0.0006,0.0007
2023-11-30 18:30,573,271,302,75879,18613,57266,49354.0,11964.0,11964.0,528,248,280,73881,18420,55461,48147.0,11910.0,11910.0,0.0006,0.0007,0.0006,0.0007
2023-11-30 18:35,1008,308,700,167284,20142,147142,108913.0,13018.0,13018.0,970,287,683,165140,19562,145578,107561.0,12639.0,12639.0,0.0006,0.0007,0.0006,0.0007
2023-12-01 10:00,7612,3602,4010,784501,351164,433337,508321.0,226311.0,226311.0,7357,3480,3877,770803,345808,424995,499805.0,223250.0,223250.0,0.0006,0.0007,0.0006,0.0007
2023-12-01 10:05,10331,5144,5187,1180454,533241,647213,766233.0,344087.0,344087.0,10198,5066,5132,1177712,531901,645811,764692.0,343258.0,343258.0,0.0006,0.0007,0.0006,0.0007
2023-12-01 10:10,12799,4442,8357,1533646,442080,1091566,997379.0,285007.0,285007.0,12760,4421,8339,1529158,439647,1089511,994463.0,283520.0,283520.0,0.0006,0.0007,0.0006,0.0007
2023-12-01 10:15,6169,2746,3423,676663,282820,393843,436896.0,181793.0,181793.0,6095,2701,3394,672463,280171,392292,434991.0,180126.0,180126.0,0.0006,0.0006,0.0006,0.0006
2023-12-01 10:20,5955,2315,3640,679848,234145,445703,438570.0,150148.0,150148.0,5916,2292,3624,678863,234062,444801,438070.0,150107.0,150107.0,0.0006,0.0006,0.0006,0.0006
2023-12-01 10:25,2085,60,2025,306930,3435,303495,198596.0,2157.0,2157.0,2030,34,1996,305623,1823,303800,197800.0,1158.0,1158.0,0.0006,0.0006,0.0006,0.0006
2023-12-01 10:30,1231,341,890,132330,27530,104800,84998.0,17335.0,17335.0,1185,313,872,127800,25420,102380,82480.0,16244.0,16244.0,0.0006,0.0006,0.0006,0.0006
2023-12-01 10:35,2312,628,1684,228848,69316,159532,146810.0,44224.0,44224.0,2240,580,1660,224152,66420,157732,144026.0,42388.0,42388.0,0.0006,0.0006,0.0006,0.0006
2023-12-01 10:40,858,527,331,102999,57055,45944,64269.0,35167.0,35167.0,472,223,249,52730,27628,25102,33508.0,17432.0,17432.0,0.0006,0.0006,0.0006,0.0006
2023-12-01 10:45,858,708,150,108644,96047,12597,67803.0,59837.0,59837.0,774,663,111,105446,96927,8519,66881.0,61432.0,61432.0,0.0006,0.0006,0.0006,0.0006
2023-12-01 10:50,441,344,97,32813,25350,7463,20078.0,15498.0,15498.0,384,305,79,32176,25700,6476,20448.0,16307.0,16307.0,0.0006,0.0006,0.0006,0.0006
2023-12-01 10:55,407,280,127,44385,28588,15797,28129.0,18084.0,18084.0,333,225,108,39121,27335,11786,24951.0,17386.0,17386.0,0.0006,0.0006,0.0006,0.0006
2023-12-01 11:00,6130,1099,5031,1000833,143130,857703,635796.0,90778.0,90778.0,6059,1048,5011,997293,141188,856105,635036.0,89620.0,89620.0,0.0006,0.0006,0.0006,0.0006
2023-12-01 11:05,8446,587,7859,1541313,42571,1498742,981293.0,26670.0,26670.0,8412,563,7849,1538533,40674,1497859,980331.0,25815.0,25815.0,0.0006,0.0006,0.0006,0.0006
2023-12-01 11:10,2011,402,1609,318488,29064,289424,202881.0,18322.0,18322.0,1963,368,1595,318096,29324,288772,203010.0,18614.0,18614.0,0.0006,0.0006,0.0006,0.0006
2023-12-01 11:15,1226,194,1032,192389,15777,176612,121643.0,8937.0,8937.0,1179,165,1014,187678,11938,175740,119896.0,7599.0,7599.0,0.0006,0.0006,0.0006,0.0006
2023-12-01 11:20,2595,2073,522,362598,302742,59856,230759.0,192408.0,192408.0,2519,2042,477,358212,301038,57174,228617.0,191937.0,191937.0,0.0006,0.0006,0.0006,0.0006
2023-12-01 11:25,700,581,119,102593,93516,9077,65497.0,59651.0,59651.0,631,564,67,98578,93060,5518,62924.0,59367.0,59367.0,0.0006,0.0006,0.0006,0.0006
2023-12-01 11:30,4879,4223,656,747985,683061,64924,478807.0,437078.0,437078.0,4832,4199,633,745311,682427,62884,477140.0,436653.0,436653.0,0.0006,0.0006,0.0006,0.0006
2023-12-01 11:35,869,652,217,96984,79230,17754,61822.0,50691.0,50691.0,805,614,191,91803,77933,13870,58858.0,49895.0,49895.0,0.0006,0.0006,0.0006,0.0006
2023-12-01 11:40,2391,2306,85,459207,455153,4054,292831.0,290818.0,290818.0,2371,2295,76,458758,455093,3665,293182.0,290820.0,290820.0,0.0006,0.0005,0.0006,0.0006
2023-12-01 11:45,284,140,144,27338,14205,13133,17443.0,9083.0,9083.0,269,135,134,26583,14162,12421,17087.0,9076.0,9076.0,0.0006,0.0006,0.0006,0.0006
2023-12-01 11:50,237,161,76,20738,14986,5752,13308.0,9596.0,9596.0,219,149,70,20487,15171,5316,13150.0,9719.0,9719.0,0.0006,0.0006,0.0006,0.0006
2023-12-01 11:55,94,42,52,3500,2153,1347,2197.0,1361.0,1361.0,66,32,34,3083,1857,1226,1981.0,1191.0,1191.0,0.0006,0.0006,0.0006,0.0006
2023-12-01 12:00,146,115,31,7735,6725,1010,4889.0,4253.0,4253.0,125,106,19,7175,6489,686,4612.0,4167.0,4167.0,0.0006,0.0006,0.0006,0.0006
2023-12-01 12:05,59,16,43,3670,421,3249,2349.0,253.0,253.0,44,10,34,3763,507,3256,2427.0,325.0,325.0,0.0006,0.0006,0.0006,0.0006
2023-12-01 12:10,111,40,71,5478,1485,3993,3524.0,951.0,951.0,69,19,50,4403,1201,3202,2835.0,770.0,770.0,0.0006,0.0006,0.0006,0.0006
2023-12-01 12:15,71,27,44,3440,971,2469,2266.0,620.0,620.0,46,12,34,1646,445,1201,1059.0,284.0,284.0,0.0006,0.0007,0.0006,0.0006
2023-12-01 12:20,622,370,252,67800,47894,19906,43046.0,30660.0,30660.0,615,370,245,67520,48050,19470,43288.0,30761.0,30761.0,0.0006,0.0006,0.0006,0.0006
2023-12-01 12:25,765,419,346,89016,58365,30651,56965.0,37320.0,37320.0,749,405,344,88585,57958,30627,56770.0,37075.0,37075.0,0.0006,0.0006,0.0006,0.0006
2023-12-01 12:30,1212,863,349,174402,142046,32356,111702.0,90908.0,90908.0,1188,848,340,174301,142017,32284,111653.0,90891.0,90891.0,0.0006,0.0006,0.0006,0.0006
2023-12-01 12:35,164,66,98,14338,5691,8647,9203.0,3638.0,3638.0,156,58,98,14513,5752,8761,9317.0,3677.0,3677.0,0.0006,0.0006,0.0006,0.0006
2023-12-01 12:40,648,270,378,84408,43116,41292,53693.0,27497.0,27497.0,610,245,365,81357,42598,38759,52142.0,27203.0,27203.0,0.0006,0.0006,0.0006,0.0006
2023-12-01 12:45,85,45,40,6056,2766,3290,3550.0,1433.0,1433.0,63,33,30,5507,2324,3183,3524.0,1474.0,1474.0,0.0005,0.0006,0.0006,0.0006
2023-12-01 12:50,182,86,96,14689,5872,8817,9278.0,3650.0,3650.0,143,58,85,14957,5723,9234,9565.0,3638.0,3638.0,0.0006,0.0006,0.0006,0.0006
2023-12-01 12:55,168,65,103,14911,4377,10534,9482.0,2778.0,2778.0,134,48,86,13043,3204,9839,8363.0,2034.0,2034.0,0.0006,0.0006,0.0006,0.0006
2023-12-01 13:00,400,48,352,56354,1252,55102,36222.0,749.0,749.0,378,37,341,56004,1160,54844,36054.0,739.0,739.0,0.0006,0.0006,0.0006,0.0006
2023-12-01 13:05,1111,48,1063,183061,2179,180882,117869.0,1382.0,1382.0,1105,42,1063,183480,2140,181340,118145.0,1363.0,1363.0,0.0006,0.0006,0.0006,0.0006
2023-12-01 13:10,4030,1650,2380,516244,79628,436616,331830.0,50826.0,50826.0,4009,1637,2372,514753,78436,436317,330963.0,50152.0,50152.0,0.0006,0.0006,0.0006,0.0006
2023-12-01 13:15,1643,1163,480,120653,61884,58769,77389.0,39587.0,39587.0,1624,1149,475,120460,61744,58716,77257.0,39488.0,39488.0,0.0006,0.0006,0.0006,0.0006
2023-12-01 13:20,1719,399,1320,244884,29039,215845,157337.0,18541.0,18541.0,1694,382,1312,244332,28746,215586,157105.0,18401.0,18401.0,0.0006,0.0006,0.0006,0.0006
2023-12-01 13:25,3981,1609,2372,476427,133598,342829,306303.0,85551.0,85551.0,3963,1609,2354,475855,133446,342409,305956.0,85453.0,85453.0,0.0006,0.0006,0.0006,0.0006
2023-12-01 13:30,1610,790,820,133252,41330,91922,85654.0,26479.0,26479.0,1593,780,813,133152,41204,91948,85594.0,26403.0,26403.0,0.0006,0.0006,0.0006,0.0006
2023-12-01 13:35,7855,2570,5285,1027800,181727,846073,661190.0,116367.0,116367.0,7834,2564,5270,1027500,181818,845682,661001.0,116426.0,116426.0,0.0006,0.0006,0.0006,0.0006
2023-12-01 13:40,281,94,187,32161,8157,24004,20664.0,5217.0,5217.0,268,86,182,31903,8021,23882,20505.0,5136.0,5136.0,0.0006,0.0006,0.0006,0.0006
2023-12-01 13:45,65,42,23,3481,2555,926,2227.0,1631.0,1631.0,57,35,22,3406,2550,856,2183.0,1632.0,1632.0,0.0006,0.0006,0.0006,0.0006
2023-12-01 13:50,35,18,17,709,587,122,451.0,372.0,372.0,24,11,13,693,557,136,444.0,356.0,356.0,0.0006,0.0006,0.0006,0.0006
2023-12-01 13:55,80,29,51,4414,1503,2911,2759.0,939.0,939.0,58,19,39,4438,1995,2443,2846.0,1268.0,1268.0,0.0006,0.0006,0.0006,0.0006
2023-12-01 14:00,1089,324,765,128282,29831,98451,82371.0,19056.0,19056.0,1087,320,767,128667,29702,98965,82640.0,18995.0,18995.0,0.0006,0.0006,0.0006,0.0006
2023-12-01 14:05,1039,499,540,98134,33110,65024,62947.0,21172.0,21172.0,1031,496,535,98533,33935,64598,63220.0,21693.0,21693.0,0.0006,0.0006,0.0006,0.0006
2023-12-01 14:10,1486,477,1009,176113,39701,136412,113006.0,25277.0,25277.0,1479,472,1007,175223,38864,136359,112552.0,24856.0,24856.0,0.0006,0.0006,0.0006,0.0006
2023-12-01 14:15,3967,1076,2891,498703,103854,394849,320289.0,66421.0,66421.0,3954,1071,2883,497780,103597,394183,319703.0,66258.0,66258.0,0.0006,0.0006,0.0006,0.0006
2023-12-01 14:20,2065,339,1726,328495,32310,296185,210787.0,20455.0,20455.0,2049,327,1722,328197,31846,296351,210799.0,20361.0,20361.0,0.0006,0.0006,0.0006,0.0006
2023-12-01 14:25,7561,1308,6253,1362316,126067,1236249,874704.0,80575.0,80575.0,7554,1304,6250,1361378,125915,1235463,874099.0,80480.0,80480.0,0.0006,0.0006,0.0006,0.0006
2023-12-01 14:30,7121,497,6624,1266980,40953,1226027,813715.0,26167.0,26167.0,7111,489,6622,1267256,41121,1226135,813898.0,26278.0,26278.0,0.0006,0.0006,0.0006,0.0006
2023-12-01 14:35,2986,13,2973,465949,338,465611,299518.0,210.0,210.0,2976,9,2967,465621,450,465171,299356.0,282.0,282.0,0.0006,0.0006,0.0006,0.0006
2023-12-01 14:40,1506,349,1157,183790,36388,147402,117961.0,23224.0,23224.0,1499,344,1155,182431,35259,147172,117099.0,22517.0,22517.0,0.0006,0.0006,0.0006,0.0006
2023-12-01 14:45,563,48,515,107121,1455,105666,68584.0,874.0,874.0,542,34,508,106512,1265,105247,68459.0,807.0,807.0,0.0006,0.0006,0.0006,0.0006
2023-12-01 14:50,201,17,184,36624,328,36296,23541.0,204.0,204.0,191,12,179,36410,201,36209,23409.0,128.0,128.0,0.0006,0.0006,0.0006,0.0006
2023-12-01 14:55,58,17,41,2743,605,2138,1748.0,375.0,375.0,48,9,39,3654,1374,2280,2337.0,872.0,872.0,0.0006,0.0006,0.0006,0.0006
2023-12-01 15:00,88,42,46,4063,2252,1811,2519.0,1359.0,1359.0,71,32,39,3928,2066,1862,2510.0,1316.0,1316.0,0.0006,0.0006,0.0006,0.0006
2023-12-01 15:05,103,39,64,7074,1579,5495,4483.0,973.0,973.0,85,28,57,6845,1497,5348,4385.0,954.0,954.0,0.0006,0.0006,0.0006,0.0006
2023-12-01 15:10,47,12,35,2846,1286,1560,1812.0,811.0,811.0,42,9,33,1929,351,1578,1236.0,222.0,222.0,0.0006,0.0006,0.0006,0.0006
2023-12-01 15:15,69,32,37,3715,1092,2623,2362.0,685.0,685.0,50,22,28,2921,779,2142,1869.0,496.0,496.0,0.0006,0.0006,0.0006,0.0006
2023-12-01 15:20,31,8,23,889,211,678,562.0,128.0,128.0,24,4,20,1061,200,861,680.0,127.0,127.0,0.0006,0.0006,0.0006,0.0006
2023-12-01 15:25,74,37,37,3259,1341,1918,2051.0,846.0,846.0,52,22,30,2804,1066,1738,1794.0,678.0,678.0,0.0006,0.0006,0.0006,0.0006
2023-12-01 15:30,101,44,57,8197,3375,4822,5220.0,2146.0,2146.0,78,33,45,8928,4372,4556,5698.0,2779.0,2779.0,0.0006,0.0006,0.0006,0.0006
2023-12-01 15:35,191,92,99,20160,5678,14482,12854.0,3608.0,3608.0,145,54,91,17407,4295,13112,11146.0,2731.0,2731.0,0.0006,0.0006,0.0006,0.0006
2023-12-01 15:40,394,180,214,66471,18646,47825,42514.0,11857.0,11857.0,367,162,205,66546,18082,48464,42565.0,11496.0,11496.0,0.0006,0.0006,0.0006,0.0006
2023-12-01 15:45,103,67,36,3281,2223,1058,2082.0,1403.0,1403.0,84,54,30,3026,2153,873,1932.0,1371.0,1371.0,0.0006,0.0006,0.0006,0.0006
2023-12-01 15:50,85,45,40,7219,5085,2134,4592.0,3232.0,3232.0,70,35,35,6430,4948,1482,4099.0,3150.0,3150.0,0.0006,0.0006,0.0006,0.0006
2023-12-01 15:55,76,51,25,14881,13208,1673,9446.0,8411.0,8411.0,65,45,20,13521,13164,357,8618.0,8389.0,8389.0,0.0006,0.0006,0.0006,0.0006
2023-12-01 16:00,50,32,18,3605,3161,444,2286.0,2005.0,2005.0,33,18,15,3232,2978,254,2062.0,1894.0,1894.0,0.0006,0.0006,0.0006,0.0007
2023-12-01 16:05,55,34,21,4725,3851,874,2983.0,2449.0,2449.0,45,31,14,4014,3779,235,2554.0,2403.0,2403.0,0.0006,0.0006,0.0006,0.0006
2023-12-01 16:10,54,21,33,2114,1580,534,1310.0,1002.0,1002.0,36,17,19,1874,1515,359,1193.0,961.0,961.0,0.0006,0.0006,0.0006,0.0006
2023-12-01 16:15,307,108,199,68297,20803,47494,43624.0,13237.0,13237.0,301,100,201,67729,20496,47233,43261.0,13041.0,13041.0,0.0006,0.0006,0.0006,0.0006
2023-12-01 16:20,80,51,29,9639,5301,4338,6144.0,3368.0,3368.0,62,40,22,7955,4824,3131,5078.0,3070.0,3070.0,0.0006,0.0006,0.0006,0.0006
2023-12-01 16:25,65,40,25,3601,2440,1161,2241.0,1515.0,1515.0,50,30,20,2911,2361,550,1853.0,1501.0,1501.0,0.0006,0.0006,0.0006,0.0006
2023-12-01 16:30,48,32,16,1783,1626,157,1103.0,1006.0,1006.0,41,27,14,2132,1578,554,1353.0,998.0,998.0,0.0006,0.0006,0.0006,0.0006
2023-12-01 16:35,34,16,18,395,186,209,226.0,113.0,113.0,23,9,14,313,177,136,199.0,112.0,112.0,0.0006,0.0005,0.0006,0.0006
2023-12-01 16:40,73,50,23,4015,2629,1386,2531.0,1661.0,1661.0,57,37,20,4142,2892,1250,2639.0,1839.0,1839.0,0.0006,0.0006,0.0006,0.0006
2023-12-01 16:45,73,30,43,5103,1697,3406,3156.0,1072.0,1072.0,52,18,34,4387,1616,2771,2807.0,1026.0,1026.0,0.0006,0.0006,0.0006,0.0006
2023-12-01 16:50,51,19,32,2589,273,2316,1550.0,133.0,133.0,39,14,25,2605,420,2185,1662.0,264.0,264.0,0.0005,0.0006,0.0006,0.0006
2023-12-01 16:55,54,26,28,3229,1010,2219,2044.0,618.0,618.0,39,18,21,2560,775,1785,1638.0,492.0,492.0,0.0006,0.0006,0.0006,0.0006
2023-12-01 17:00,102,45,57,9596,3209,6387,6011.0,1970.0,1970.0,73,23,50,7409,2446,4963,4727.0,1549.0,1549.0,0.0006,0.0006,0.0006,0.0006
2023-12-01 17:05,68,43,25,3611,2501,1110,2282.0,1573.0,1573.0,54,28,26,2960,1873,1087,1880.0,1186.0,1186.0,0.0006,0.0006,0.0006,0.0006
2023-12-01 17:10,55,24,31,2410,764,1646,1517.0,466.0,466.0,35,8,27,2213,576,1637,1409.0,364.0,364.0,0.0006,0.0006,0.0006,0.0006
2023-12-01 17:15,181,36,145,22829,1024,21805,13747.0,646.0,646.0,160,22,138,22262,1046,21216,14186.0,662.0,662.0,0.0006,0.0006,0.0006,0.0006
2023-12-01 17:20,1105,203,902,125333,14052,111281,79736.0,8834.0,8834.0,1089,189,900,125361,14020,111341,79816.0,8876.0,8876.0,0.0006,0.0006,0.0006,0.0006
2023-12-01 17:25,2355,1772,583,185589,138775,46814,117569.0,87762.0,87762.0,2331,1756,575,185003,138182,46821,117327.0,87502.0,87502.0,0.0006,0.0006,0.0006,0.0006
2023-12-01 17:30,2931,348,2583,481900,24199,457701,306450.0,15278.0,15278.0,2860,297,2563,478161,21698,456463,304443.0,13737.0,13737.0,0.0006,0.0006,0.0006,0.0006
2023-12-01 17:35,3493,60,3433,633483,2153,631330,403256.0,1316.0,1316.0,3453,33,3420,633300,2376,630924,403265.0,1486.0,1486.0,0.0006,0.0006,0.0006,0.0006
2023-12-01 17:40,3214,44,3170,480408,1473,478935,305653.0,929.0,929.0,3186,24,3162,479744,1327,478417,305416.0,838.0,838.0,0.0006,0.0006,0.0006,0.0006
2023-12-01 17:45,2979,37,2942,544704,1735,542969,347035.0,1097.0,1097.0,2967,30,2937,544246,1499,542747,346748.0,948.0,948.0,0.0006,0.0006,0.0006,0.0006
2023-12-01 17:50,2331,46,2285,456008,1409,454599,290469.0,891.0,891.0,2321,40,2281,455983,1330,454653,290478.0,840.0,840.0,0.0006,0.0006,0.0006,0.0006
2023-12-01 17:55,1675,634,1041,265495,78465,187030,168708.0,49581.0,49581.0,1630,600,1030,263504,76953,186551,167624.0,48770.0,48770.0,0.0006,0.0006,0.0006,0.0006
2023-12-01 18:00,821,536,285,110582,72586,37996,70239.0,46021.0,46021.0,812,533,279,112139,73853,38286,71208.0,46807.0,46807.0,0.0006,0.0006,0.0006,0.0006
2023-12-01 18:05,45,16,29,2393,826,1567,1497.0,518.0,518.0,27,6,21,1844,183,1661,1179.0,115.0,115.0,0.0006,0.0006,0.0006,0.0006
2023-12-01 18:10,54,16,38,3112,785,2327,1923.0,498.0,498.0,43,14,29,3080,776,2304,1962.0,492.0,492.0,0.0006,0.0006,0.0006,0.0006
2023-12-01 18:15,61,35,26,4155,2164,1991,2621.0,1373.0,1373.0,54,33,21,3808,2169,1639,2424.0,1374.0,1374.0,0.0006,0.0006,0.0006,0.0006
2023-12-01 18:20,195,129,66,30282,19176,11106,19019.0,12137.0,12137.0,171,124,47,25012,18886,6126,15890.0,11977.0,11977.0,0.0006,0.0006,0.0006,0.0006
2023-12-01 18:25,474,322,152,51536,35677,15859,32523.0,22580.0,22580.0,462,298,164,50493,35686,14807,32031.0,22606.0,22606.0,0.0006,0.0006,0.0006,0.0006
2023-12-01 18:30,125,70,55,5587,1992,3595,3404.0,1148.0,1148.0,86,41,45,4661,1544,3117,2964.0,976.0,976.0,0.0006,0.0006,0.0006,0.0006
2023-12-01 18:35,84,36,48,5541,1372,4169,3506.0,856.0,856.0,79,37,42,7976,3168,4808,5022.0,1962.0,1962.0,0.0006,0.0006,0.0006,0.0006
2023-12-04 10:00,3514,1847,1667,482298,240667,241631,300205.0,147415.0,147415.0,2398,1318,1080,383290,180629,202661,252172.0,117638.0,117638.0,0.0006,0.0006,0.0007,0.0007
2023-12-04 10:05,3436,2251,1185,442310,308903,133407,277554.0,191895.0,191895.0,2632,1873,759,377266,277048,100218,248531.0,182041.0,182041.0,0.0006,0.0006,0.0007,0.0007
2023-12-04 10:10,2996,1579,1417,361036,207549,153487,224314.0,130165.0,130165.0,2006,1164,842,263889,161916,101973,175277.0,107011.0,107011.0,0.0006,0.0006,0.0007,0.0007
2023-12-04 10:15,3104,2213,891,390485,272776,117709,244945.0,171529.0,171529.0,2404,1821,583,325504,242296,83208,215992.0,160493.0,160493.0,0.0006,0.0006,0.0007,0.0007
2023-12-04 10:20,4322,3063,1259,550143,400512,149631,357908.0,260778.0,260778.0,3071,2300,771,445102,339413,105689,296892.0,225729.0,225729.0,0.0007,0.0006,0.0007,0.0007
2023-12-04 10:25,11228,2274,8954,1744420,135833,1608587,1156929.0,87857.0,87857.0,10570,1935,8635,1703229,120427,1582802,1137459.0,80185.0,80185.0,0.0006,0.0007,0.0007,0.0007
2023-12-04 10:30,2943,1164,1779,425631,133133,292498,276011.0,85648.0,85648.0,2520,957,1563,384165,111393,272772,255865.0,73860.0,73860.0,0.0006,0.0007,0.0007,0.0007
2023-12-04 10:35,6159,1246,4913,916414,140806,775608,602694.0,91486.0,91486.0,5865,1100,4765,891846,133370,758476,593102.0,88384.0,88384.0,0.0006,0.0007,0.0007,0.0007
2023-12-04 10:40,1282,577,705,143777,55367,88410,91526.0,35153.0,35153.0,1044,466,578,120929,44739,76190,80172.0,29508.0,29508.0,0.0006,0.0006,0.0007,0.0007
2023-12-04 10:45,981,409,572,91184,36483,54701,59014.0,22992.0,22992.0,839,336,503,85048,33583,51465,56435.0,22202.0,22202.0,0.0006,0.0007,0.0007,0.0007
2023-12-04 10:50,658,319,339,102847,50455,52392,66847.0,32875.0,32875.0,509,252,257,93484,45895,47589,62011.0,30285.0,30285.0,0.0007,0.0006,0.0007,0.0007
2023-12-04 10:55,275,172,103,21982,12141,9841,13845.0,7845.0,7845.0,208,138,70,17277,9911,7366,11466.0,6553.0,6553.0,0.0006,0.0006,0.0007,0.0007
2023-12-04 11:00,433,203,230,41839,15700,26139,26116.0,9720.0,9720.0,319,148,171,35725,13461,22264,23680.0,8860.0,8860.0,0.0006,0.0006,0.0007,0.0007
2023-12-04 11:05,1944,1555,389,268111,233127,34984,173543.0,150640.0,150640.0,1751,1471,280,245404,217979,27425,163343.0,144987.0,144987.0,0.0006,0.0007,0.0007,0.0007
2023-12-04 11:10,1517,957,560,164051,106608,57443,103930.0,67875.0,67875.0,1106,732,374,123574,84055,39519,82750.0,56089.0,56089.0,0.0006,0.0006,0.0007,0.0007
2023-12-04 11:15,9264,2544,6720,1365998,334034,1031964,906428.0,219939.0,219939.0,8943,2383,6560,1339149,322680,1016469,895587.0,215007.0,215007.0,0.0007,0.0007,0.0007,0.0007
2023-12-04 11:20,4038,926,3112,519222,83284,435938,344136.0,54934.0,54934.0,3869,834,3035,510305,79543,430762,341027.0,52846.0,52846.0,0.0007,0.0007,0.0007,0.0007
2023-12-04 11:25,2737,703,2034,364582,62849,301733,241841.0,40960.0,40960.0,2608,637,1971,354947,57799,297148,236809.0,38367.0,38367.0,0.0007,0.0007,0.0007,0.0007
2023-12-04 11:30,2996,601,2395,477440,44302,433138,316881.0,28272.0,28272.0,2879,548,2331,462510,38769,423741,308544.0,25741.0,25741.0,0.0006,0.0007,0.0007,0.0007
2023-12-04 11:35,3827,875,2952,599016,101502,497514,396216.0,64505.0,64505.0,3603,738,2865,585127,94946,490181,390739.0,63087.0,63087.0,0.0006,0.0007,0.0007,0.0007
2023-12-04 11:40,3707,550,3157,582556,49000,533556,387157.0,31367.0,31367.0,3533,448,3085,572062,42107,529955,381719.0,27870.0,27870.0,0.0006,0.0007,0.0007,0.0007
2023-12-04 11:45,3040,657,2383,479958,58048,421910,315473.0,37141.0,37141.0,2729,500,2229,460333,49384,410949,306007.0,32657.0,32657.0,0.0006,0.0007,0.0007,0.0007
2023-12-04 11:50,833,344,489,87267,36161,51106,55304.0,22075.0,22075.0,703,280,423,76266,30509,45757,50539.0,20102.0,20102.0,0.0006,0.0007,0.0007,0.0007
2023-12-04 11:55,1871,1347,524,187693,158003,29690,122717.0,103713.0,103713.0,1763,1312,451,182137,156445,25692,120689.0,103586.0,103586.0,0.0007,0.0006,0.0007,0.0007
2023-12-04 12:00,1019,769,250,127029,105395,21634,82947.0,69124.0,69124.0,921,721,200,121730,102803,18927,80761.0,68118.0,68118.0,0.0007,0.0006,0.0007,0.0007
2023-12-04 12:05,2376,587,1789,313353,54231,259122,203884.0,35617.0,35617.0,2172,472,1700,298306,48931,249375,198101.0,32294.0,32294.0,0.0007,0.0006,0.0007,0.0007
2023-12-04 12:10,1849,436,1413,249183,32224,216959,163563.0,20982.0,20982.0,1689,345,1344,230350,27570,202780,152445.0,18044.0,18044.0,0.0007,0.0007,0.0007,0.0007
2023-12-04 12:15,2946,1024,1922,388921,73869,315052,248283.0,47035.0,47035.0,2626,832,1794,359986,62048,297938,236985.0,40533.0,40533.0,0.0006,0.0006,0.0007,0.0007
2023-12-04 12:20,2907,821,2086,430886,69931,360955,280619.0,44650.0,44650.0,2708,683,2025,428553,60721,367832,281056.0,39680.0,39680.0,0.0006,0.0007,0.0007,0.0007
2023-12-04 12:25,1802,566,1236,264013,44865,219148,172011.0,28389.0,28389.0,1670,491,1179,254247,40943,213304,167417.0,26816.0,26816.0,0.0006,0.0007,0.0007,0.0007
2023-12-04 12:30,3320,824,2496,599554,105774,493780,393941.0,68509.0,68509.0,3188,752,2436,590700,100364,490336,389194.0,65860.0,65860.0,0.0006,0.0007,0.0007,0.0007
2023-12-04 12:35,1053,637,416,144390,83260,61130,94477.0,54605.0,54605.0,954,588,366,145190,87411,57779,95586.0,57390.0,57390.0,0.0007,0.0007,0.0007,0.0007
2023-12-04 12:40,1867,1255,612,175118,90020,85098,114450.0,58810.0,58810.0,1761,1193,568,166530,83969,82561,109478.0,55045.0,55045.0,0.0007,0.0007,0.0007,0.0007
2023-12-04 12:45,2744,2350,394,415564,376399,39165,271841.0,246183.0,246183.0,2657,2296,361,406470,369034,37436,266935.0,242211.0,242211.0,0.0007,0.0007,0.0007,0.0007
2023-12-04 12:50,1002,563,439,122980,82358,40622,79490.0,52999.0,52999.0,875,513,362,123979,87694,36285,81666.0,57610.0,57610.0,0.0006,0.0007,0.0007,0.0007
2023-12-04 12:55,10079,8455,1624,1712178,1541413,170765,1128698.0,1016847.0,1016847.0,9878,8374,1504,1698351,1536538,161813,1121219.0,1013845.0,1013845.0,0.0007,0.0007,0.0007,0.0007
2023-12-04 13:00,2986,2325,661,462063,397307,64756,300945.0,258493.0,258493.0,2765,2210,555,438271,386064,52207,290289.0,255483.0,255483.0,0.0007,0.0007,0.0007,0.0007
2023-12-04 13:05,1896,1516,380,273637,237895,35742,172669.0,150434.0,150434.0,1527,1313,214,222915,206609,16306,148563.0,137621.0,137621.0,0.0006,0.0006,0.0007,0.0007
2023-12-04 13:10,1658,1033,625,200934,136644,64290,132136.0,89985.0,89985.0,1437,931,506,182516,130315,52201,121892.0,86784.0,86784.0,0.0007,0.0007,0.0007,0.0007
2023-12-04 13:15,722,553,169,83623,69348,14275,53104.0,43793.0,43793.0,621,509,112,72082,64496,7586,48031.0,42941.0,42941.0,0.0006,0.0007,0.0007,0.0007
2023-12-04 13:20,10262,5517,4745,1719802,911786,808016,1149057.0,603956.0,603956.0,9641,5232,4409,1661300,877074,784226,1123493.0,591309.0,591309.0,0.0007,0.0007,0.0007,0.0007
2023-12-04 13:25,7978,3460,4518,1136092,360427,775665,751543.0,231762.0,231762.0,6249,2379,3870,997809,283901,713908,677744.0,192361.0,192361.0,0.0006,0.0007,0.0007,0.0007
2023-12-04 13:30,5718,3294,2424,636072,318765,317307,413001.0,202979.0,202979.0,3909,2282,1627,514268,255647,258621,353235.0,174532.0,174532.0,0.0006,0.0007,0.0007,0.0007
2023-12-04 13:35,4986,2208,2778,626059,204523,421536,411060.0,133027.0,133027.0,3840,1504,2336,534041,157378,376663,365455.0,106765.0,106765.0,0.0007,0.0007,0.0007,0.0007
2023-12-04 13:40,3966,2438,1528,445884,253081,192803,289683.0,161751.0,161751.0,3088,1986,1102,376933,218878,158055,258464.0,149294.0,149294.0,0.0006,0.0007,0.0007,0.0007
2023-12-04 13:45,3394,2178,1216,375379,254717,120662,247920.0,168662.0,168662.0,2667,1849,818,315438,226501,88937,216960.0,155221.0,155221.0,0.0007,0.0007,0.0007,0.0007
2023-12-04 13:50,2943,1591,1352,338187,164010,174177,220178.0,105865.0,105865.0,2461,1343,1118,305888,150275,155613,209256.0,102310.0,102310.0,0.0006,0.0007,0.0007,0.0007
2023-12-04 13:55,1825,888,937,200373,101574,98799,128824.0,64863.0,64863.0,1388,691,697,161012,82530,78482,110375.0,56314.0,56314.0,0.0006,0.0006,0.0007,0.0007
2023-12-04 14:00,2030,1500,530,233833,188340,45493,153434.0,125228.0,125228.0,1673,1297,376,213348,178272,35076,146057.0,121892.0,121892.0,0.0007,0.0006,0.0007,0.0007
2023-12-04 14:05,2716,1535,1181,336627,159374,177253,224193.0,105033.0,105033.0,2279,1279,1000,295241,135204,160037,202014.0,92111.0,92111.0,0.0007,0.0007,0.0007,0.0007
2023-12-04 14:10,1894,999,895,209546,84542,125004,138497.0,55183.0,55183.0,1619,831,788,188433,67149,121284,129032.0,45812.0,45812.0,0.0007,0.0007,0.0007,0.0007
2023-12-04 14:15,2131,838,1293,244812,80293,164519,163514.0,53686.0,53686.0,1886,679,1207,238053,83855,154198,162733.0,57081.0,57081.0,0.0007,0.0007,0.0007,0.0007
2023-12-04 14:20,7459,6164,1295,1311126,1114036,197090,891806.0,757392.0,757392.0,7070,5960,1110,1284535,1100414,184121,880026.0,753278.0,753278.0,0.0007,0.0007,0.0007,0.0007
2023-12-04 14:25,3676,2555,1121,378320,283277,95043,243036.0,179017.0,179017.0,2766,2117,649,293232,234420,58812,202246.0,161330.0,161330.0,0.0006,0.0007,0.0007,0.0007
2023-12-04 14:30,3873,2420,1453,383745,267155,116590,250561.0,175784.0,175784.0,2877,1974,903,297047,220978,76069,205435.0,152417.0,152417.0,0.0007,0.0006,0.0007,0.0007
2023-12-04 14:35,4364,2467,1897,491321,282791,208530,334149.0,193129.0,193129.0,3345,2012,1333,409368,236927,172441,285373.0,164396.0,164396.0,0.0007,0.0007,0.0007,0.0007
2023-12-04 14:40,4315,2417,1898,492245,288851,203394,327668.0,194267.0,194267.0,3259,1838,1421,389439,240472,148967,271706.0,167146.0,167146.0,0.0007,0.0007,0.0007,0.0007
2023-12-04 14:45,4422,2353,2069,592594,309998,282596,395980.0,205034.0,205034.0,3266,1749,1517,463318,250347,212971,324180.0,174407.0,174407.0,0.0007,0.0007,0.0007,0.0007
2023-12-04 14:50,2861,1610,1251,340987,197129,143858,222469.0,127708.0,127708.0,2035,1241,794,260345,162425,97920,183134.0,113842.0,113842.0,0.0006,0.0007,0.0007,0.0007
2023-12-04 14:55,4035,2030,2005,414903,196895,218008,269868.0,133067.0,133067.0,2929,1470,1459,297866,142552,155314,209558.0,99757.0,99757.0,0.0007,0.0006,0.0007,0.0007
2023-12-04 15:00,2854,1833,1021,289265,172077,117188,195323.0,115227.0,115227.0,2309,1537,772,246378,152238,94140,172677.0,106306.0,106306.0,0.0007,0.0007,0.0007,0.0007
2023-12-04 15:05,2344,1144,1200,208828,98621,110207,140449.0,66534.0,66534.0,1736,760,976,166792,74068,92724,116807.0,51667.0,51667.0,0.0007,0.0007,0.0007,0.0007
2023-12-04 15:10,2004,924,1080,175378,60022,115356,115732.0,38952.0,38952.0,1367,630,737,141306,49287,92019,98965.0,34256.0,34256.0,0.0006,0.0007,0.0007,0.0007
2023-12-04 15:15,1725,1162,563,170621,126909,43712,113331.0,83859.0,83859.0,1334,942,392,144378,108305,36073,101081.0,75659.0,75659.0,0.0007,0.0007,0.0007,0.0007
2023-12-04 15:20,1457,790,667,131754,73999,57755,88076.0,50264.0,50264.0,1132,663,469,112340,69083,43257,78635.0,48253.0,48253.0,0.0007,0.0007,0.0007,0.0007
2023-12-04 15:25,1862,846,1016,158388,73982,84406,104746.0,50005.0,50005.0,1444,618,826,126005,59432,66573,87858.0,41268.0,41268.0,0.0007,0.0006,0.0007,0.0007
2023-12-04 15:30,2904,1619,1285,347137,186828,160309,224638.0,121313.0,121313.0,2147,1207,940,262176,144227,117949,182137.0,99822.0,99822.0,0.0006,0.0006,0.0007,0.0007
2023-12-04 15:35,1893,1170,723,201290,116023,85267,136881.0,79635.0,79635.0,1612,1010,602,186228,106152,80076,129585.0,73580.0,73580.0,0.0007,0.0007,0.0007,0.0007
2023-12-04 15:40,2882,1166,1716,356999,108142,248857,237774.0,71347.0,71347.0,2233,792,1441,301021,79973,221048,208610.0,54961.0,54961.0,0.0007,0.0007,0.0007,0.0007
2023-12-04 15:45,3005,1980,1025,408241,262680,145561,271827.0,175409.0,175409.0,2645,1774,871,380494,246526,133968,263296.0,170334.0,170334.0,0.0007,0.0007,0.0007,0.0007
2023-12-04 15:50,1312,672,640,165995,71842,94153,112943.0,48552.0,48552.0,1070,530,540,150185,60174,90011,104229.0,41609.0,41609.0,0.0007,0.0007,0.0007,0.0007
2023-12-04 15:55,1928,683,1245,241717,59453,182264,165011.0,40633.0,40633.0,1654,496,1158,223446,51772,171674,154747.0,35622.0,35622.0,0.0007,0.0007,0.0007,0.0007
2023-12-04 16:00,1874,1303,571,206848,139353,67495,137599.0,91297.0,91297.0,1596,1164,432,186816,126854,59962,129359.0,87596.0,87596.0,0.0007,0.0007,0.0007,0.0007
2023-12-04 16:05,1884,1252,632,228036,139645,88391,149214.0,90247.0,90247.0,1598,1106,492,201039,131120,69919,139297.0,90629.0,90629.0,0.0006,0.0007,0.0007,0.0007
2023-12-04 16:10,2467,1413,1054,299770,150684,149086,200821.0,100986.0,100986.0,2188,1266,922,278416,140575,137841,193371.0,97354.0,97354.0,0.0007,0.0007,0.0007,0.0007
2023-12-04 16:15,2286,1580,706,329535,220351,109184,226067.0,151651.0,151651.0,2041,1458,583,314607,215123,99484,218277.0,149048.0,149048.0,0.0007,0.0007,0.0007,0.0007
2023-12-04 16:20,1524,601,923,179705,47547,132158,121133.0,31048.0,31048.0,1307,500,807,167417,43452,123965,115954.0,29851.0,29851.0,0.0007,0.0007,0.0007,0.0007
2023-12-04 16:25,1414,666,748,175588,52539,123049,119242.0,34259.0,34259.0,1259,601,658,161877,44140,117737,112288.0,30489.0,30489.0,0.0007,0.0007,0.0007,0.0007
2023-12-04 16:30,2392,1167,1225,280660,103663,176997,189931.0,69054.0,69054.0,1986,933,1053,263355,96980,166375,183004.0,67109.0,67109.0,0.0007,0.0007,0.0007,0.0007
2023-12-04 16:35,2878,1853,1025,338872,215165,123707,226397.0,142994.0,142994.0,2486,1657,829,297998,195971,102027,207025.0,135860.0,135860.0,0.0007,0.0007,0.0007,0.0007
2023-12-04 16:40,2540,798,1742,322355,58741,263614,216086.0,38658.0,38658.0,2153,582,1571,290679,46001,244678,201343.0,31622.0,31622.0,0.0007,0.0007,0.0007,0.0007
2023-12-04 16:45,1843,941,902,185111,74892,110219,125120.0,49497.0,49497.0,1546,794,752,168096,67430,100666,116063.0,46396.0,46396.0,0.0007,0.0007,0.0007,0.0007
2023-12-04 16:50,4196,1390,2806,571085,134918,436167,387490.0,91462.0,91462.0,3774,1161,2613,541398,115084,426314,373709.0,79162.0,79162.0,0.0007,0.0007,0.0007,0.0007
2023-12-04 16:55,4926,1595,3331,657521,154693,502828,438370.0,100698.0,100698.0,4356,1261,3095,616634,136751,479883,422627.0,93049.0,93049.0,0.0007,0.0007,0.0007,0.0007
2023-12-04 17:00,4322,2973,1349,618887,465236,153651,419178.0,316681.0,316681.0,4023,2821,1202,591752,454131,137621,406574.0,311692.0,311692.0,0.0007,0.0007,0.0007,0.0007
2023-12-04 17:05,2224,1519,705,248404,170875,77529,165381.0,113564.0,113564.0,1924,1351,573,221071,154800,66271,151580.0,105862.0,105862.0,0.0007,0.0007,0.0007,0.0007
2023-12-04 17:10,1661,690,971,170898,53618,117280,112706.0,36074.0,36074.0,1338,507,831,148070,44303,103767,101331.0,30122.0,30122.0,0.0007,0.0007,0.0007,0.0007
2023-12-04 17:15,1615,848,767,185546,90921,94625,123298.0,59615.0,59615.0,1386,715,671,170147,85834,84313,116234.0,58501.0,58501.0,0.0007,0.0007,0.0007,0.0007
2023-12-04 17:20,1620,544,1076,212286,58999,153287,142189.0,39660.0,39660.0,1406,420,986,191885,49968,141917,131182.0,34003.0,34003.0,0.0007,0.0007,0.0007,0.0007
2023-12-04 17:25,1489,899,590,189236,126583,62653,128087.0,85297.0,85297.0,1328,828,500,183437,121349,62088,125256.0,82707.0,82707.0,0.0007,0.0007,0.0007,0.0007
2023-12-04 17:30,1614,643,971,187790,54339,133451,121426.0,36259.0,36259.0,1281,471,810,156663,45650,111013,106671.0,30920.0,30920.0,0.0007,0.0006,0.0007,0.0007
2023-12-04 17:35,1311,682,629,128589,54500,74089,81048.0,34114.0,34114.0,949,468,481,100237,36704,63533,68098.0,24806.0,24806.0,0.0006,0.0006,0.0007,0.0007
2023-12-04 17:40,807,476,331,56443,20774,35669,37199.0,13536.0,13536.0,496,246,250,46482,14964,31518,31598.0,10100.0,10100.0,0.0007,0.0007,0.0007,0.0007
2023-12-04 17:45,1599,958,641,140114,42347,97767,94082.0,27488.0,27488.0,1077,497,580,132412,39448,92964,90053.0,26684.0,26684.0,0.0006,0.0007,0.0007,0.0007
2023-12-04 17:50,1661,1035,626,186151,119602,66549,123664.0,79163.0,79163.0,1437,928,509,175209,115206,60003,119198.0,78185.0,78185.0,0.0007,0.0007,0.0007,0.0007
2023-12-04 17:55,846,399,447,83191,35993,47198,55707.0,24280.0,24280.0,751,347,404,78601,32043,46558,53398.0,21685.0,21685.0,0.0007,0.0007,0.0007,0.0007
2023-12-04 18:00,1024,649,375,141220,74658,66562,93989.0,49297.0,49297.0,927,597,330,132613,71244,61369,90271.0,48234.0,48234.0,0.0007,0.0007,0.0007,0.0007
2023-12-04 18:05,2431,1029,1402,296464,84578,211886,192602.0,55466.0,55466.0,1833,647,1186,225493,47497,177996,152528.0,31946.0,31946.0,0.0007,0.0006,0.0007,0.0007
2023-12-04 18:10,894,395,499,94814,34418,60396,62217.0,21903.0,21903.0,772,352,420,89438,35427,54011,60319.0,23744.0,23744.0,0.0006,0.0007,0.0007,0.0007
2023-12-04 18:15,1158,523,635,122266,39108,83158,80731.0,24988.0,24988.0,935,397,538,117428,38865,78563,79316.0,26067.0,26067.0,0.0006,0.0007,0.0007,0.0007
2023-12-04 18:20,1374,702,672,170196,70714,99482,112954.0,46269.0,46269.0,1218,620,598,156144,62001,94143,105401.0,41708.0,41708.0,0.0007,0.0007,0.0007,0.0007
2023-12-04 18:25,1042,323,719,109443,19086,90357,69507.0,12163.0,12163.0,868,251,617,99227,21066,78161,66911.0,14106.0,14106.0,0.0006,0.0006,0.0007,0.0007
2023-12-04 18:30,1670,655,1015,193296,69879,123417,129202.0,45944.0,45944.0,1485,572,913,177651,61253,116398,119918.0,41167.0,41167.0,0.0007,0.0007,0.0007,0.0007
2023-12-04 18:35,5922,1611,4311,644445,314273,330172,426879.0,205857.0,205857.0,5687,1485,4202,606463,292330,314133,409795.0,197085.0,197085.0,0.0007,0.0007,0.0007,0.0007
2023-12-05 10:00,21187,12449,8738,2970454,1754922,1215532,2023898.0,1189823.0,1189823.0,19668,11680,7988,2828863,1684985,1143878,1949143.0,1158015.0,1158015.0,0.0007,0.0007,0.0007,0.0007
2023-12-05 10:05,4225,2677,1548,508215,324564,183651,337290.0,217205.0,217205.0,3613,2374,1239,464022,302790,161232,319561.0,208140.0,208140.0,0.0007,0.0007,0.0007,0.0007
2023-12-05 10:10,5147,3115,2032,664576,424408,240168,450991.0,287734.0,287734.0,4484,2792,1692,615458,400221,215237,424372.0,275774.0,275774.0,0.0007,0.0007,0.0007,0.0007
2023-12-05 10:15,4208,2394,1814,440192,232158,208034,280028.0,148434.0,148434.0,3173,1788,1385,325457,175900,149557,221201.0,119030.0,119030.0,0.0006,0.0006,0.0007,0.0007
2023-12-05 10:20,4778,2800,1978,482648,229039,253609,307109.0,144573.0,144573.0,3578,2060,1518,389930,186993,202937,261934.0,124961.0,124961.0,0.0006,0.0006,0.0007,0.0007
2023-12-05 10:25,5250,3554,1696,641914,455109,186805,415900.0,295550.0,295550.0,4518,3168,1350,567770,411454,156316,379989.0,274839.0,274839.0,0.0006,0.0006,0.0007,0.0007
2023-12-05 10:30,3322,2274,1048,431537,299174,132363,284003.0,196874.0,196874.0,2957,2096,861,408684,287805,120879,275202.0,193462.0,193462.0,0.0007,0.0007,0.0007,0.0007
2023-12-05 10:35,5206,3547,1659,717225,497443,219782,477553.0,331908.0,331908.0,4973,3435,1538,699985,488016,211969,471899.0,328609.0,328609.0,0.0007,0.0007,0.0007,0.0007
2023-12-05 10:40,1112,420,692,124538,26417,98121,80822.0,17055.0,17055.0,850,306,544,107282,19479,87803,72177.0,12980.0,12980.0,0.0006,0.0006,0.0007,0.0007
2023-12-05 10:45,547,215,332,61858,15966,45892,41161.0,10266.0,10266.0,463,187,276,58709,13538,45171,39584.0,9037.0,9037.0,0.0006,0.0007,0.0007,0.0007
2023-12-05 10:50,2200,517,1683,284354,38671,245683,190426.0,24974.0,24974.0,2102,444,1658,282162,37198,244964,190732.0,24988.0,24988.0,0.0006,0.0007,0.0007,0.0007
2023-12-05 10:55,4712,1141,3571,635030,90984,544046,427527.0,59965.0,59965.0,4583,1086,3497,631024,88492,542532,426283.0,59501.0,59501.0,0.0007,0.0007,0.0007,0.0007
2023-12-05 11:00,9176,1579,7597,1425560,127532,1298028,953550.0,83780.0,83780.0,8917,1426,7491,1398641,113203,1285438,941133.0,75699.0,75699.0,0.0007,0.0007,0.0007,0.0007
2023-12-05 11:05,6712,1111,5601,1119602,90904,1028698,751937.0,60428.0,60428.0,6559,1046,5513,1108320,88368,1019952,745059.0,58982.0,58982.0,0.0007,0.0007,0.0007,0.0007
2023-12-05 11:10,4807,1015,3792,676706,90756,585950,445172.0,58537.0,58537.0,4551,821,3730,637056,75043,562013,424880.0,49597.0,49597.0,0.0006,0.0007,0.0007,0.0007
2023-12-05 11:15,3001,1367,1634,334709,115044,219665,205364.0,73520.0,73520.0,2188,800,1388,250832,70190,180642,165836.0,46077.0,46077.0,0.0006,0.0006,0.0007,0.0007
2023-12-05 11:20,5295,2246,3049,650031,162788,487243,417005.0,101976.0,101976.0,4464,1614,2850,602527,142115,460412,396842.0,93103.0,93103.0,0.0006,0.0006,0.0007,0.0007
2023-12-05 11:25,1679,484,1195,210346,47835,162511,134212.0,28580.0,28580.0,1540,420,1120,196330,40664,155666,129322.0,26603.0,26603.0,0.0006,0.0007,0.0007,0.0007
2023-12-05 11:30,1798,1439,359,184442,144074,40368,119534.0,93207.0,93207.0,1276,1076,200,163700,136340,27360,108291.0,90056.0,90056.0,0.0006,0.0007,0.0007,0.0007
2023-12-05 11:35,1321,719,602,158216,93191,65025,102335.0,60048.0,60048.0,1177,654,523,148306,87679,60627,98355.0,57977.0,57977.0,0.0006,0.0007,0.0007,0.0007
2023-12-05 11:40,3392,725,2667,392733,64554,328179,258555.0,42081.0,42081.0,3242,656,2586,386391,61544,324847,256205.0,40550.0,40550.0,0.0007,0.0007,0.0007,0.0007
2023-12-05 11:45,3325,740,2585,416646,62839,353807,273717.0,40908.0,40908.0,3202,677,2525,411527,59115,352412,272010.0,38858.0,38858.0,0.0007,0.0007,0.0007,0.0007
2023-12-05 11:50,18982,13046,5936,2680528,1749995,930533,1774643.0,1157774.0,1157774.0,18770,12950,5820,2661253,1740294,920959,1765855.0,1154783.0,1154783.0,0.0007,0.0007,0.0007,0.0007
2023-12-05 11:55,2654,1651,1003,372706,250849,121857,243258.0,165062.0,165062.0,2462,1566,896,356962,245363,111599,236576.0,162233.0,162233.0,0.0007,0.0006,0.0007,0.0007
2023-12-05 12:00,2793,1626,1167,332245,138591,193654,218169.0,90413.0,90413.0,2654,1544,1110,325716,134283,191433,215344.0,88340.0,88340.0,0.0007,0.0007,0.0007,0.0007
2023-12-05 12:05,1811,545,1266,296874,40374,256500,194404.0,24909.0,24909.0,1679,475,1204,285524,34334,251190,189044.0,22588.0,22588.0,0.0006,0.0007,0.0007,0.0007
2023-12-05 12:10,1034,460,574,119831,33329,86502,78725.0,21651.0,21651.0,934,409,525,120136,32434,87702,79757.0,21382.0,21382.0,0.0006,0.0007,0.0007,0.0007
2023-12-05 12:15,1660,682,978,184198,55393,128805,121223.0,35828.0,35828.0,1565,625,940,177017,51502,125515,117165.0,33904.0,33904.0,0.0006,0.0007,0.0007,0.0007
2023-12-05 12:20,3317,2105,1212,396586,273761,122825,261234.0,180144.0,180144.0,3211,2063,1148,389011,272284,116727,258033.0,180220.0,180220.0,0.0007,0.0007,0.0007,0.0007
2023-12-05 12:25,2489,536,1953,318226,30889,287337,211110.0,20332.0,20332.0,2380,480,1900,314466,28972,285494,209379.0,19175.0,19175.0,0.0007,0.0007,0.0007,0.0007
2023-12-05 12:30,7447,4623,2824,1056428,731881,324547,699123.0,484030.0,484030.0,7368,4595,2773,1045673,727934,317739,693970.0,482364.0,482364.0,0.0007,0.0007,0.0007,0.0007
2023-12-05 12:35,8933,2456,6477,1248711,207887,1040824,826754.0,136418.0,136418.0,8815,2404,6411,1235722,203262,1032460,821589.0,134717.0,134717.0,0.0007,0.0007,0.0007,0.0007
2023-12-05 12:40,1101,258,843,151056,19431,131625,99807.0,12822.0,12822.0,1056,226,830,148227,18246,129981,98553.0,12059.0,12059.0,0.0007,0.0007,0.0007,0.0007
2023-12-05 12:45,364,139,225,47609,12449,35160,31759.0,8190.0,8190.0,329,115,214,44035,10414,33621,29311.0,6880.0,6880.0,0.0007,0.0007,0.0007,0.0007
2023-12-05 12:50,2291,412,1879,313107,28773,284334,206911.0,18982.0,18982.0,2244,401,1843,311999,29428,282571,207188.0,19432.0,19432.0,0.0007,0.0007,0.0007,0.0007
2023-12-05 12:55,3042,882,2160,354721,83104,271617,234786.0,54736.0,54736.0,2981,867,2114,352013,81175,270838,233337.0,53584.0,53584.0,0.0007,0.0007,0.0007,0.0007
2023-12-05 13:00,1533,333,1200,214693,31697,182996,141970.0,20592.0,20592.0,1495,312,1183,216182,30176,186006,143376.0,19904.0,19904.0,0.0006,0.0007,0.0007,0.0007
2023-12-05 13:05,1449,423,1026,211061,53081,157980,138744.0,34920.0,34920.0,1369,388,981,207654,52083,155571,137651.0,34349.0,34349.0,0.0007,0.0007,0.0007,0.0007
2023-12-05 13:10,1047,180,867,147482,10739,136743,97624.0,6984.0,6984.0,1028,170,858,149140,12393,136747,98846.0,8145.0,8145.0,0.0007,0.0007,0.0007,0.0007
2023-12-05 13:15,1759,934,825,219734,86396,133338,144902.0,56359.0,56359.0,1722,912,810,214986,81982,133004,142449.0,54131.0,54131.0,0.0007,0.0007,0.0007,0.0007
2023-12-05 13:20,9384,7668,1716,1684502,1298808,385694,1114729.0,858543.0,858543.0,9311,7621,1690,1680642,1297245,383397,1113450.0,858363.0,858363.0,0.0007,0.0007,0.0007,0.0007
2023-12-05 13:25,1906,1466,440,294358,245521,48837,194435.0,162310.0,162310.0,1817,1419,398,288690,242110,46580,191801.0,160670.0,160670.0,0.0007,0.0007,0.0007,0.0007
2023-12-05 13:30,6132,4693,1439,874470,807881,66589,580888.0,536883.0,536883.0,6068,4673,1395,871748,807599,64149,579875.0,536984.0,536984.0,0.0007,0.0007,0.0007,0.0007
2023-12-05 13:35,4367,2826,1541,489439,215512,273927,325865.0,143151.0,143151.0,4349,2822,1527,488837,215653,273184,325503.0,143239.0,143239.0,0.0007,0.0007,0.0007,0.0007
2023-12-05 13:40,2045,1577,468,317302,274515,42787,207025.0,178337.0,178337.0,1884,1502,382,299935,260948,38987,200027.0,173869.0,173869.0,0.0006,0.0007,0.0007,0.0007
2023-12-05 13:45,2234,1231,1003,254277,149208,105069,168299.0,98953.0,98953.0,2068,1165,903,246941,147916,99025,165388.0,98820.0,98820.0,0.0007,0.0007,0.0007,0.0007
2023-12-05 13:50,1619,655,964,224367,89720,134647,148980.0,59255.0,59255.0,1546,619,927,214606,86157,128449,143701.0,57523.0,57523.0,0.0007,0.0007,0.0007,0.0007
2023-12-05 13:55,3920,2835,1085,628411,470735,157676,418579.0,314210.0,314210.0,3853,2798,1055,619018,466027,152991,414394.0,311652.0,311652.0,0.0007,0.0007,0.0007,0.0007
2023-12-05 14:00,1303,252,1051,185288,28070,157218,123828.0,18748.0,18748.0,1244,226,1018,187414,27774,159640,125733.0,18527.0,18527.0,0.0007,0.0007,0.0007,0.0007
2023-12-05 14:05,780,490,290,122529,80791,41738,81868.0,53783.0,53783.0,765,483,282,124058,81558,42500,83006.0,54403.0,54403.0,0.0007,0.0007,0.0007,0.0007
2023-12-05 14:10,1340,912,428,182879,136169,46710,120407.0,90000.0,90000.0,1207,858,349,176159,134482,41677,118161.0,90016.0,90016.0,0.0007,0.0007,0.0007,0.0007
2023-12-05 14:15,265,155,110,28494,15574,12920,18894.0,10335.0,10335.0,183,97,86,28422,13662,14760,19297.0,9143.0,9143.0,0.0007,0.0007,0.0007,0.0007
2023-12-05 14:20,428,166,262,50967,17095,33872,33626.0,11404.0,11404.0,375,143,232,43519,15892,27627,29260.0,10618.0,10618.0,0.0007,0.0007,0.0007,0.0007
2023-12-05 14:25,3274,1232,2042,431546,135505,296041,286915.0,89957.0,89957.0,3178,1174,2004,422448,131041,291407,282931.0,87432.0,87432.0,0.0007,0.0007,0.0007,0.0007
2023-12-05 14:30,2594,783,1811,368163,76932,291231,245629.0,50428.0,50428.0,2540,756,1784,365333,74608,290725,244689.0,49749.0,49749.0,0.0007,0.0007,0.0007,0.0007
2023-12-05 14:35,2302,760,1542,309069,45413,263656,206225.0,30261.0,30261.0,2260,736,1524,306509,44647,261862,205236.0,29772.0,29772.0,0.0007,0.0007,0.0007,0.0007
2023-12-05 14:40,932,393,539,141042,30058,110984,93988.0,19452.0,19452.0,905,382,523,135538,28721,106817,90868.0,19151.0,19151.0,0.0006,0.0007,0.0007,0.0007
2023-12-05 14:45,472,171,301,63492,13139,50353,42415.0,8683.0,8683.0,443,150,293,62582,12256,50326,42148.0,8176.0,8176.0,0.0007,0.0007,0.0007,0.0007
2023-12-05 14:50,2271,478,1793,416760,41301,375459,277288.0,27407.0,27407.0,2196,421,1775,411080,38923,372157,275247.0,25894.0,25894.0,0.0007,0.0007,0.0007,0.0007
2023-12-05 14:55,2842,594,2248,370574,43639,326935,247293.0,28711.0,28711.0,2787,568,2219,374395,44753,329642,250441.0,29753.0,29753.0,0.0007,0.0007,0.0007,0.0007
2023-12-05 15:00,1350,528,822,154926,30647,124279,103448.0,20371.0,20371.0,1316,514,802,153248,30715,122533,102519.0,20434.0,20434.0,0.0007,0.0007,0.0007,0.0007
2023-12-05 15:05,598,148,450,87042,7928,79114,58919.0,5215.0,5215.0,531,124,407,76517,7148,69369,51227.0,4745.0,4745.0,0.0007,0.0007,0.0007,0.0007
2023-12-05 15:10,1361,362,999,180137,23773,156364,116793.0,15407.0,15407.0,1193,255,938,170514,16629,153885,113794.0,10988.0,10988.0,0.0006,0.0006,0.0007,0.0007
2023-12-05 15:15,1280,311,969,177377,20802,156575,117732.0,13693.0,13693.0,1186,271,915,183060,19372,163688,122735.0,12793.0,12793.0,0.0007,0.0007,0.0007,0.0007
2023-12-05 15:20,588,180,408,93807,10232,83575,62224.0,6728.0,6728.0,532,143,389,87702,8413,79289,58395.0,5545.0,5545.0,0.0007,0.0007,0.0007,0.0007
2023-12-05 15:25,814,396,418,100170,28685,71485,65790.0,18131.0,18131.0,738,357,381,95473,25366,70107,63535.0,16778.0,16778.0,0.0006,0.0007,0.0007,0.0007
2023-12-05 15:30,775,436,339,94191,39845,54346,62448.0,26139.0,26139.0,720,421,299,96498,39623,56875,64309.0,26254.0,26254.0,0.0007,0.0007,0.0007,0.0007
2023-12-05 15:35,521,297,224,77786,26476,51310,51378.0,17494.0,17494.0,517,287,230,69053,26109,42944,46039.0,17278.0,17278.0,0.0007,0.0007,0.0007,0.0007
2023-12-05 15:40,1460,441,1019,192522,32299,160223,127705.0,21185.0,21185.0,1439,428,1011,200982,30915,170067,133565.0,20425.0,20425.0,0.0007,0.0007,0.0007,0.0007
2023-12-05 15:45,1827,794,1033,211263,62454,148809,139873.0,41124.0,41124.0,1750,762,988,206578,60329,146249,137334.0,39927.0,39927.0,0.0007,0.0007,0.0007,0.0007
2023-12-05 15:50,571,286,285,66196,26200,39996,43579.0,16946.0,16946.0,510,269,241,63140,24896,38244,42004.0,16475.0,16475.0,0.0006,0.0007,0.0007,0.0007
2023-12-05 15:55,735,453,282,81164,36906,44258,53474.0,23948.0,23948.0,687,429,258,73308,34606,38702,48841.0,22917.0,22917.0,0.0006,0.0007,0.0007,0.0007
2023-12-05 16:00,252,150,102,30657,13168,17489,20335.0,8645.0,8645.0,229,134,95,33858,12876,20982,22582.0,8519.0,8519.0,0.0007,0.0007,0.0007,0.0007
2023-12-05 16:05,1275,237,1038,209879,13065,196814,137337.0,8478.0,8478.0,1192,189,1003,202980,9053,193927,134792.0,5964.0,5964.0,0.0006,0.0007,0.0007,0.0007
2023-12-05 16:10,1265,270,995,196315,19268,177047,129970.0,12642.0,12642.0,1218,238,980,195289,18553,176736,129428.0,12154.0,12154.0,0.0007,0.0007,0.0007,0.0007
2023-12-05 16:15,1468,424,1044,217204,17330,199874,144192.0,11423.0,11423.0,1434,407,1027,215464,16398,199066,143131.0,10834.0,10834.0,0.0007,0.0007,0.0007,0.0007
2023-12-05 16:20,2356,677,1679,315115,33440,281675,208784.0,21886.0,21886.0,2324,652,1672,313365,32594,280771,208131.0,21545.0,21545.0,0.0007,0.0007,0.0007,0.0007
2023-12-05 16:25,2561,1171,1390,276183,68809,207374,183175.0,45336.0,45336.0,2519,1142,1377,274894,68165,206729,182489.0,45085.0,45085.0,0.0007,0.0007,0.0007,0.0007
2023-12-05 16:30,2155,631,1524,285744,39279,246465,188942.0,25938.0,25938.0,2115,606,1509,283296,38592,244704,187982.0,25490.0,25490.0,0.0007,0.0007,0.0007,0.0007
2023-12-05 16:35,1201,230,971,170133,13701,156432,112470.0,8871.0,8871.0,1154,210,944,168456,13374,155082,111788.0,8816.0,8816.0,0.0006,0.0007,0.0007,0.0007
2023-12-05 16:40,1394,407,987,213243,27043,186200,140935.0,17381.0,17381.0,1354,386,968,207852,26097,181755,137948.0,17214.0,17214.0,0.0006,0.0007,0.0007,0.0007
2023-12-05 16:45,659,170,489,132588,13571,119017,88051.0,8942.0,8942.0,641,162,479,108838,11582,97256,72299.0,7633.0,7633.0,0.0007,0.0007,0.0007,0.0007
2023-12-05 16:50,1392,314,1078,207503,26882,180621,136594.0,17543.0,17543.0,1348,290,1058,229162,25690,203472,152127.0,16940.0,16940.0,0.0007,0.0007,0.0007,0.0007
2023-12-05 16:55,1024,194,830,160721,13510,147211,106646.0,8832.0,8832.0,1007,187,820,151739,13085,138654,100913.0,8643.0,8643.0,0.0007,0.0007,0.0007,0.0007
2023-12-05 17:00,86,44,42,13089,2782,10307,8459.0,1787.0,1787.0,66,30,36,12685,2166,10519,8446.0,1424.0,1424.0,0.0006,0.0006,0.0007,0.0007
2023-12-05 17:05,2489,407,2082,390180,40007,350173,258142.0,26394.0,26394.0,2442,391,2051,394156,38957,355199,261521.0,25706.0,25706.0,0.0007,0.0007,0.0007,0.0007
2023-12-05 17:10,754,173,581,127999,11278,116721,84888.0,7383.0,7383.0,732,155,577,128752,11358,117394,85461.0,7472.0,7472.0,0.0007,0.0007,0.0007,0.0007
2023-12-05 17:15,1335,778,557,166745,87090,79655,109136.0,56256.0,56256.0,1267,740,527,158442,83670,74772,105221.0,55373.0,55373.0,0.0006,0.0007,0.0007,0.0007
2023-12-05 17:20,1531,732,799,185271,102962,82309,122851.0,68107.0,68107.0,1498,719,779,181259,100770,80489,120287.0,66711.0,66711.0,0.0007,0.0007,0.0007,0.0007
2023-12-05 17:25,627,477,150,109340,90621,18719,72271.0,59891.0,59891.0,614,474,140,111309,91915,19394,73723.0,60748.0,60748.0,0.0007,0.0007,0.0007,0.0007
2023-12-05 17:30,401,220,181,69922,39686,30236,44523.0,26159.0,26159.0,354,193,161,59803,37979,21824,39598.0,25077.0,25077.0,0.0007,0.0006,0.0007,0.0007
2023-12-05 17:35,231,107,124,34853,11072,23781,22819.0,6996.0,6996.0,207,92,115,29311,10783,18528,19404.0,7082.0,7082.0,0.0006,0.0007,0.0007,0.0007
2023-12-05 17:40,2576,477,2099,370347,49335,321012,245246.0,32453.0,32453.0,2462,445,2017,375727,46267,329460,249146.0,30497.0,30497.0,0.0007,0.0007,0.0007,0.0007
2023-12-05 17:45,2358,424,1934,325798,33128,292670,215329.0,21438.0,21438.0,2289,390,1899,320157,30832,289325,212090.0,20290.0,20290.0,0.0006,0.0007,0.0007,0.0007
2023-12-05 17:50,1356,290,1066,192014,17716,174298,126897.0,11345.0,11345.0,1340,280,1060,191847,17523,174324,127104.0,11538.0,11538.0,0.0006,0.0007,0.0007,0.0007
2023-12-05 17:55,2184,349,1835,366944,35153,331791,243312.0,23197.0,23197.0,2129,320,1809,341531,23520,318011,226581.0,15508.0,15508.0,0.0007,0.0007,0.0007,0.0007
2023-12-05 18:00,82,41,41,12372,1218,11154,7414.0,803.0,803.0,60,28,32,15099,1109,13990,10108.0,719.0,719.0,0.0007,0.0006,0.0006,0.0007
2023-12-05 18:05,89,34,55,18571,1765,16806,9872.0,1050.0,1050.0,62,19,43,12672,655,12017,8442.0,430.0,430.0,0.0006,0.0005,0.0007,0.0007
2023-12-05 18:10,61,29,32,11805,2146,9659,7551.0,1143.0,1143.0,39,16,23,9212,616,8596,6144.0,405.0,405.0,0.0005,0.0007,0.0007,0.0007
2023-12-05 18:15,72,42,30,12365,2895,9470,8058.0,1748.0,1748.0,51,29,22,10767,1781,8986,7173.0,1170.0,1170.0,0.0006,0.0007,0.0007,0.0007
2023-12-05 18:20,76,54,22,16163,6116,10047,10280.0,4035.0,4035.0,60,39,21,15445,4645,10800,10358.0,3063.0,3063.0,0.0007,0.0006,0.0007,0.0007
2023-12-05 18:25,144,53,91,27599,3063,24536,17298.0,1998.0,1998.0,85,26,59,18991,1647,17344,12627.0,1075.0,1075.0,0.0007,0.0006,0.0007,0.0007
2023-12-05 18:30,511,123,388,82381,4791,77590,54365.0,2957.0,2957.0,447,86,361,79404,2907,76497,52574.0,1902.0,1902.0,0.0006,0.0007,0.0007,0.0007
2023-12-05 18:35,1368,125,1243,223578,8599,214979,147783.0,5611.0,5611.0,1316,101,1215,222938,9426,213512,147531.0,6165.0,6165.0,0.0007,0.0007,0.0007,0.0007
2023-12-06 10:00,1979,931,1048,240675,94505,146170,160363975.0,62339193.0,98024782.0,1591,725,866,205601,80580,125021,136751677.0,53319202.0,83432474.0,0.6596,0.6706,0.6617,0.6673
2023-12-06 10:05,1933,605,1328,223485,27981,195504,147986226.0,18334771.0,129651454.0,1710,471,1239,216173,23666,192507,143594278.0,15565187.0,128029091.0,0.6553,0.6632,0.6577,0.6651
2023-12-06 10:10,2278,731,1547,271219,32039,239180,177878016.0,20871818.0,157006198.0,1851,451,1400,246558,16976,229582,162215603.0,11013430.0,151202172.0,0.6515,0.6564,0.6488,0.6586
2023-12-06 10:15,1736,685,1051,218875,45949,172926,143159050.0,30109936.0,113049114.0,1403,462,941,197263,33747,163516,129096882.0,21942455.0,107154426.0,0.6553,0.6537,0.6502,0.6553
2023-12-06 10:20,1868,1252,616,191104,112197,78907,126601695.0,73445108.0,53156587.0,1580,1060,520,177497,103911,73586,116532947.0,67828108.0,48704839.0,0.6546,0.6737,0.6528,0.6619
2023-12-06 10:25,1485,678,807,162869,55781,107088,107181129.0,36509896.0,70671233.0,1371,612,759,158927,55390,103537,104514454.0,36204292.0,68310161.0,0.6545,0.6599,0.6536,0.6598
2023-12-06 10:30,3074,582,2492,531803,20358,511445,347768693.0,13232449.0,334536244.0,2829,404,2425,517018,14413,502605,338297456.0,9367145.0,328930310.0,0.65,0.6541,0.6499,0.6545
2023-12-06 10:35,2619,1117,1502,384692,53270,331422,252011380.0,34765681.0,217245699.0,2537,1068,1469,385552,52282,333270,252455840.0,33999725.0,218456114.0,0.6526,0.6555,0.6503,0.6555
2023-12-06 10:40,1949,1142,807,232405,132995,99410,152532049.0,87013573.0,65518476.0,1837,1089,748,228012,130811,97201,149490783.0,85400029.0,64090754.0,0.6543,0.6591,0.6529,0.6594
2023-12-06 10:45,2191,1339,852,246784,147773,99011,161683349.0,96621156.0,65062192.0,2133,1307,826,244355,147058,97297,160014565.0,96074757.0,63939808.0,0.6538,0.6571,0.6533,0.6572
2023-12-06 10:50,2558,1501,1057,251280,152355,98925,164723085.0,99607719.0,65115366.0,2512,1479,1033,250369,152374,97995,164106079.0,99603689.0,64502390.0,0.6538,0.6582,0.6537,0.6582
2023-12-06 10:55,1813,710,1103,204203,82681,121522,134075463.0,54090160.0,79985302.0,1770,685,1085,202016,81889,120127,132589605.0,53525100.0,79064505.0,0.6542,0.6582,0.6536,0.6582
2023-12-06 11:00,3482,518,2964,521653,47961,473692,342330847.0,31332409.0,310998438.0,3367,457,2910,510939,45477,465462,335539365.0,29707290.0,305832075.0,0.6533,0.6565,0.6532,0.6571
2023-12-06 11:05,3497,1336,2161,451648,68978,382670,292730114.0,44564205.0,248165908.0,2913,924,1989,423914,54647,369267,275046142.0,35114972.0,239931170.0,0.6461,0.6485,0.6426,0.6497
2023-12-06 11:10,1702,889,813,172788,50012,122776,111604859.0,32307024.0,79297835.0,1276,540,736,160006,40915,119091,103259631.0,26234527.0,77025104.0,0.646,0.6459,0.6412,0.6468
2023-12-06 11:15,2216,1512,704,311937,218843,93094,201514943.0,141199920.0,60315023.0,2035,1400,635,304339,214981,89358,196398836.0,138458322.0,57940513.0,0.6452,0.6479,0.644,0.6484
2023-12-06 11:20,2872,2426,446,390188,342852,47336,252631172.0,221749268.0,30881903.0,2744,2365,379,377022,339410,37612,243732234.0,219218664.0,24513569.0,0.6468,0.6524,0.6459,0.6517
2023-12-06 11:25,2634,1117,1517,317988,120691,197297,206062820.0,77977605.0,128085214.0,2559,1069,1490,311344,113179,198165,203056632.0,73132565.0,129924066.0,0.6461,0.6492,0.6462,0.6556
2023-12-06 11:30,1586,285,1301,258200,13820,244380,167333851.0,8912035.0,158421816.0,1478,219,1259,256603,14531,242072,166579574.0,9317616.0,157261958.0,0.6449,0.6483,0.6412,0.6496
2023-12-06 11:35,2385,724,1661,328666,51878,276788,212153138.0,33376595.0,178776542.0,2240,623,1617,319287,46482,272805,206384897.0,29934623.0,176450273.0,0.6434,0.6459,0.644,0.6468
2023-12-06 11:40,1972,226,1746,276385,16230,260155,178622907.0,10428881.0,168194025.0,1886,176,1710,271159,13866,257293,175499319.0,8881001.0,166618317.0,0.6426,0.6465,0.6405,0.6476
2023-12-06 11:45,1963,272,1691,303648,11980,291668,196387336.0,7670090.0,188717245.0,1882,218,1664,300186,8581,291605,194181078.0,5514155.0,188666923.0,0.6402,0.647,0.6426,0.647
2023-12-06 11:50,1239,695,544,177175,100112,77063,114493347.0,64605817.0,49887529.0,1158,671,487,172834,98258,74576,111727238.0,63354842.0,48372395.0,0.6453,0.6474,0.6448,0.6486
2023-12-06 11:55,3154,2084,1070,456672,304809,151863,294981302.0,196529400.0,98451902.0,3093,2043,1050,453596,303075,150521,292869107.0,195283576.0,97585530.0,0.6448,0.6483,0.6443,0.6483
2023-12-06 12:00,1701,870,831,223054,122162,100892,144098358.0,78687231.0,65411127.0,1690,865,825,223314,122708,100606,144268334.0,79036782.0,65231551.0,0.6441,0.6483,0.6441,0.6484
2023-12-06 12:05,2143,1288,855,334514,225848,108666,216363698.0,145898511.0,70465187.0,2108,1274,834,333508,225186,108322,215597921.0,145360247.0,70237673.0,0.646,0.6485,0.6455,0.6484
2023-12-06 12:10,1505,758,747,202815,108446,94369,131187035.0,70012689.0,61174346.0,1434,741,693,200845,108301,92544,129936094.0,69909517.0,60026577.0,0.6456,0.6482,0.6455,0.6486
2023-12-06 12:15,1937,557,1380,351316,83366,267950,227255835.0,53704044.0,173551791.0,1897,538,1359,348140,81956,266184,225312451.0,52781484.0,172530967.0,0.6442,0.6477,0.644,0.6482
2023-12-06 12:20,2050,1844,206,304315,287508,16807,196506512.0,185563970.0,10942542.0,1984,1809,175,302401,286102,16299,195293786.0,184671723.0,10622063.0,0.6454,0.6511,0.6455,0.6517
2023-12-06 12:25,565,378,187,72175,59107,13068,46630940.0,38119776.0,8511163.0,522,353,169,70833,58434,12399,45758136.0,37678628.0,8079508.0,0.6449,0.6513,0.6448,0.6516
2023-12-06 12:30,163,111,52,25900,15668,10232,16792045.0,10111140.0,6680904.0,146,102,44,25443,15272,10171,16491280.0,9850489.0,6640791.0,0.6453,0.6529,0.645,0.6529
2023-12-06 12:35,173,84,89,26052,11218,14834,16900457.0,7246973.0,9653483.0,147,69,78,25378,10813,14565,16460195.0,6972724.0,9487470.0,0.646,0.6508,0.6448,0.6514
2023-12-06 12:40,711,168,543,106045,14006,92039,68639483.0,9035473.0,59604010.0,685,171,514,103845,13807,90038,67302438.0,8899875.0,58402563.0,0.6451,0.6476,0.6446,0.6486
2023-12-06 12:45,1799,424,1375,369055,46771,322284,238542068.0,30063824.0,208478243.0,1735,377,1358,362727,42472,320255,234588164.0,27297149.0,207291014.0,0.6428,0.6469,0.6427,0.6473
2023-12-06 12:50,915,227,688,170153,27376,142777,109662612.0,17600425.0,92062186.0,804,178,626,152447,18970,133477,98545126.0,12153543.0,86391583.0,0.6429,0.6448,0.6407,0.6472
2023-12-06 12:55,469,189,280,49196,12416,36780,31484282.0,7891234.0,23593047.0,288,71,217,37190,5638,31552,23900798.0,3509514.0,20391283.0,0.6356,0.6415,0.6225,0.6463
2023-12-06 13:00,1048,672,376,128255,63711,64544,83084630.0,41340254.0,41744376.0,907,573,334,121760,58435,63325,78545846.0,37559722.0,40986123.0,0.6489,0.6468,0.6428,0.6472
2023-12-06 13:05,3341,2359,982,452549,342474,110075,291565313.0,220280680.0,71284633.0,3280,2326,954,452207,343359,108848,291294811.0,220795580.0,70499230.0,0.6432,0.6476,0.643,0.6477
2023-12-06 13:10,1503,907,596,196648,148954,47694,126516333.0,95721865.0,30794467.0,1472,892,580,193467,146994,46473,124522765.0,94467380.0,30055384.0,0.6426,0.6457,0.6427,0.6467
2023-12-06 13:15,716,159,557,112983,15497,97486,72879138.0,9945822.0,62933316.0,715,167,548,113594,17229,96365,73331472.0,11049106.0,62282365.0,0.6418,0.6456,0.6413,0.6463
2023-12-06 13:20,657,219,438,106882,16577,90305,68605818.0,10621036.0,57984782.0,561,180,381,99369,16273,83096,64075489.0,10403708.0,53671781.0,0.6407,0.6421,0.6393,0.6459
2023-12-06 13:25,1980,674,1306,288669,66644,222025,185792965.0,43398642.0,142394322.0,1722,485,1237,258914,50233,208681,166606900.0,32134125.0,134472775.0,0.6512,0.6413,0.6397,0.6444
2023-12-06 13:30,2908,1551,1357,395179,159425,235754,255879164.0,102656065.0,153223099.0,2756,1482,1274,389599,155347,234252,252171119.0,99883598.0,152287520.0,0.6439,0.6499,0.643,0.6501
2023-12-06 13:35,2705,1699,1006,346969,256588,90381,223727524.0,165149900.0,58577623.0,2583,1661,922,342752,255077,87675,221054664.0,164108790.0,56945874.0,0.6436,0.6481,0.6434,0.6495
2023-12-06 13:40,1167,120,1047,92007,7893,84114,59549913.0,5059663.0,54490250.0,1143,110,1033,90624,7508,83116,58650380.0,4815318.0,53835062.0,0.641,0.6478,0.6414,0.6477
2023-12-06 13:45,3533,351,3182,531237,29481,501756,342420032.0,18849703.0,323570329.0,3406,277,3129,521047,25558,495489,336052312.0,16314473.0,319737839.0,0.6394,0.6449,0.6383,0.6453
2023-12-06 13:50,1479,785,694,207286,93878,113408,133396650.0,60292970.0,73103679.0,1420,749,671,205086,93237,111849,131819965.0,59683497.0,72136467.0,0.6422,0.6446,0.6401,0.6449
2023-12-06 13:55,1080,766,314,175647,132705,42942,112851577.0,85087077.0,27764500.0,1039,741,298,171493,131153,40340,110137509.0,84074239.0,26063270.0,0.6412,0.6466,0.641,0.6461
2023-12-06 14:00,1010,810,200,191287,177725,13562,123054238.0,114268182.0,8786056.0,973,788,185,185433,172447,12986,119229599.0,110816352.0,8413247.0,0.6429,0.6478,0.6426,0.6479
2023-12-06 14:05,354,206,148,33731,19354,14377,21721136.0,12444420.0,9276715.0,315,186,129,32670,20969,11701,21054592.0,13486494.0,7568098.0,0.643,0.6452,0.6432,0.6468
2023-12-06 14:10,386,255,131,40358,25964,14394,26019960.0,16724505.0,9295454.0,345,237,108,40299,25374,14925,25971992.0,16321519.0,9650472.0,0.6441,0.6458,0.6432,0.6466
2023-12-06 14:15,1480,1138,342,217289,174423,42866,140403963.0,112691718.0,27712244.0,1426,1097,329,212706,170514,42192,137207198.0,109884171.0,27323027.0,0.6461,0.6465,0.6444,0.6476
2023-12-06 14:20,1312,1133,179,263022,243136,19886,170140344.0,157181732.0,12958612.0,1244,1107,137,256315,239468,16847,165548259.0,154586236.0,10962022.0,0.6465,0.6516,0.6455,0.6507
2023-12-06 14:25,1892,415,1477,299879,60011,239868,194303954.0,38828929.0,155475025.0,1832,382,1450,293621,58854,234767,190380783.0,37982905.0,152397878.0,0.647,0.6482,0.6454,0.6491
2023-12-06 14:30,715,163,552,75427,9434,65993,48991021.0,6155351.0,42835670.0,687,148,539,74397,8205,66192,48254798.0,5284726.0,42970072.0,0.6525,0.6491,0.6441,0.6492
2023-12-06 14:35,1934,1333,601,240924,169167,71757,155836151.0,109124010.0,46712140.0,1906,1320,586,239230,169025,70205,154609708.0,109030541.0,45579166.0,0.6451,0.651,0.6451,0.6492
2023-12-06 14:40,1341,763,578,151830,79055,72775,98284364.0,51007997.0,47276367.0,1314,746,568,151120,79120,72000,97833880.0,51047938.0,46785941.0,0.6452,0.6496,0.6452,0.6498
2023-12-06 14:45,787,474,313,88130,49380,38750,56956010.0,31822808.0,25133202.0,788,478,310,90387,51247,39140,58434968.0,33024611.0,25410356.0,0.6444,0.6486,0.6444,0.6492
2023-12-06 14:50,1048,655,393,148883,100036,48847,95855669.0,64232765.0,31622904.0,1045,653,392,146989,100027,46962,94601764.0,64198282.0,30403481.0,0.6421,0.6474,0.6418,0.6474
2023-12-06 14:55,1745,567,1178,304674,74584,230090,196219771.0,47822190.0,148397581.0,1617,488,1129,291198,67534,223664,187640714.0,43323479.0,144317234.0,0.6412,0.645,0.6415,0.6452
2023-12-06 15:00,1652,244,1408,344185,14637,329548,222061341.0,9406609.0,212654732.0,1584,193,1391,339816,10504,329312,219246413.0,6709729.0,212536684.0,0.6427,0.6453,0.6388,0.6454
2023-12-06 15:05,1137,333,804,195088,16071,179017,125892977.0,10317556.0,115575420.0,1128,336,792,196740,19524,177216,126850997.0,12490686.0,114360311.0,0.642,0.6456,0.6398,0.6453
2023-12-06 15:10,1235,485,750,182199,39598,142601,117320359.0,25404500.0,91915859.0,1190,459,731,179920,37884,142036,115870300.0,24269439.0,91600861.0,0.6416,0.6446,0.6406,0.6449
2023-12-06 15:15,2717,1221,1496,407310,141850,265460,261407718.0,90778961.0,170628756.0,2606,1147,1459,397428,135592,261836,255416115.0,86612596.0,168803518.0,0.64,0.6428,0.6388,0.6447
2023-12-06 15:20,2595,1849,746,348361,282159,66202,222792972.0,180160942.0,42632029.0,2581,1848,733,348706,283218,65488,223032574.0,180817407.0,42215166.0,0.6385,0.644,0.6384,0.6446
2023-12-06 15:25,2835,2266,569,406775,362719,44056,260086171.0,231698406.0,28387765.0,2813,2252,561,407225,363919,43306,260341583.0,232437930.0,27903653.0,0.6388,0.6444,0.6387,0.6443
2023-12-06 15:30,1548,1254,294,244870,227452,17418,156580777.0,145340651.0,11240125.0,1529,1241,288,243833,226931,16902,155913966.0,145008344.0,10905621.0,0.639,0.6453,0.639,0.6452
2023-12-06 15:35,1526,1249,277,209430,181696,27734,134371170.0,116447847.0,17923323.0,1487,1225,262,203440,178656,24784,130496469.0,114500388.0,15996081.0,0.6409,0.6463,0.6409,0.6454
2023-12-06 15:40,823,729,94,122221,110907,11314,78319798.0,71022108.0,7297690.0,799,712,87,123791,112654,11137,79339649.0,72150160.0,7189489.0,0.6404,0.645,0.6405,0.6455
2023-12-06 15:45,991,734,257,145098,120700,24398,92945675.0,77220207.0,15725468.0,974,725,249,141149,117526,23623,90423956.0,75197707.0,15226249.0,0.6398,0.6445,0.6398,0.6446
2023-12-06 15:50,1601,1435,166,248105,230125,17980,159683082.0,148071408.0,11611673.0,1542,1405,137,240634,225001,15633,154519312.0,144413125.0,10106187.0,0.6434,0.6458,0.6418,0.6465
2023-12-06 15:55,2056,1345,711,277650,186991,90659,178718789.0,120170147.0,58548641.0,2034,1341,693,275703,187174,88529,177474344.0,120290796.0,57183548.0,0.6427,0.6458,0.6427,0.6459
2023-12-06 16:00,1914,566,1348,302600,47423,255177,195263163.0,30442394.0,164820768.0,1897,551,1346,303472,46681,256791,195851965.0,29966998.0,165884967.0,0.6419,0.6459,0.642,0.646
2023-12-06 16:05,1750,538,1212,248041,35792,212249,160027277.0,23002678.0,137024598.0,1746,535,1211,249077,36742,212335,160695213.0,23608437.0,137086776.0,0.6427,0.6456,0.6425,0.6456
2023-12-06 16:10,1839,393,1446,367343,45988,321355,236857377.0,29469933.0,207387443.0,1834,388,1446,369745,47204,322541,238564108.0,30254775.0,208309333.0,0.6408,0.6454,0.6409,0.6458
2023-12-06 16:15,2052,742,1310,348022,99499,248523,224065040.0,63757311.0,160307729.0,2047,737,1310,345640,98433,247207,222486001.0,63076350.0,159409650.0,0.6408,0.645,0.6408,0.6448
2023-12-06 16:20,3130,668,2462,486237,62407,423830,313056178.0,39990716.0,273065462.0,3111,660,2451,487282,63446,423836,313726495.0,40651582.0,273074913.0,0.6408,0.6443,0.6407,0.6443
2023-12-06 16:25,1692,616,1076,218687,50888,167799,140658460.0,32612304.0,108046156.0,1679,605,1074,218365,50616,167749,140450652.0,32437051.0,108013601.0,0.6409,0.6439,0.6408,0.6439
2023-12-06 16:30,1863,582,1281,276375,58791,217584,178050754.0,37676961.0,140373793.0,1843,570,1273,274507,58972,215535,176688128.0,37788875.0,138899253.0,0.6409,0.6451,0.6408,0.6444
2023-12-06 16:35,1884,163,1721,329705,15900,313805,212272170.0,10201445.0,202070724.0,1856,154,1702,328191,15799,312392,211306335.0,10105073.0,201201261.0,0.6416,0.6439,0.6396,0.6441
2023-12-06 16:40,2593,197,2396,459534,15857,443677,295384876.0,10121094.0,285263782.0,2559,178,2381,456850,15202,441648,293793162.0,9704741.0,284088421.0,0.6383,0.643,0.6384,0.6432
2023-12-06 16:45,2445,392,2053,474043,17703,456340,305043382.0,11305743.0,293737639.0,2411,371,2040,471490,17703,453787,303079817.0,11301595.0,291778222.0,0.6386,0.6437,0.6384,0.643
2023-12-06 16:50,2281,395,1886,454918,14416,440502,292457030.0,9214801.0,283242228.0,2266,383,1883,455377,14726,440651,292739135.0,9401875.0,283337259.0,0.6392,0.643,0.6385,0.643
2023-12-06 16:55,2546,639,1907,488820,56152,432668,314225190.0,35961436.0,278263754.0,2513,623,1890,490905,56581,434324,315839625.0,36181257.0,279658368.0,0.6404,0.6431,0.6395,0.6439
2023-12-06 17:00,2867,653,2214,551250,90880,460370,354355729.0,58138614.0,296217115.0,2829,636,2193,548012,89593,458419,352341697.0,57298132.0,295043565.0,0.6397,0.6434,0.6395,0.6436
2023-12-06 17:05,1847,566,1281,272126,39653,232473,175067496.0,25426753.0,149640742.0,1832,556,1276,270934,38551,232383,174227746.0,24648675.0,149579071.0,0.6412,0.6437,0.6394,0.6437
2023-12-06 17:10,1802,555,1247,306550,53618,252932,197212050.0,34313305.0,162898745.0,1794,560,1234,307303,53476,253827,197876069.0,34218264.0,163657805.0,0.64,0.644,0.6399,0.6448
2023-12-06 17:15,1570,334,1236,230992,36806,194186,148531355.0,23566039.0,124965316.0,1545,319,1226,230624,36666,193958,148255351.0,23431601.0,124823750.0,0.6403,0.6435,0.6391,0.6436
2023-12-06 17:20,968,374,594,148643,40189,108454,95588857.0,25736696.0,69852161.0,941,361,580,147653,40087,107566,94977985.0,25654306.0,69323678.0,0.6404,0.6441,0.64,0.6445
2023-12-06 17:25,2201,457,1744,387049,61592,325457,249142975.0,39433267.0,209709708.0,2173,437,1736,385293,61280,324013,247910868.0,39229730.0,208681137.0,0.6402,0.6444,0.6402,0.6441
2023-12-06 17:30,3387,541,2846,640012,84131,555881,411530496.0,53841857.0,357688638.0,3306,485,2821,629673,77141,552532,405205688.0,49377291.0,355828396.0,0.64,0.6435,0.6401,0.644
2023-12-06 17:35,1036,97,939,180642,3376,177266,116197838.0,2154056.0,114043782.0,1014,84,930,179538,2977,176561,115497103.0,1895337.0,113601766.0,0.638,0.6433,0.6367,0.6434
2023-12-06 17:40,1129,114,1015,207107,3083,204024,133137527.0,1984594.0,131152933.0,1118,114,1004,203753,3627,200126,131195388.0,2299691.0,128895697.0,0.6437,0.6428,0.634,0.6441
2023-12-06 17:45,927,337,590,146628,26394,120234,94090271.0,16824059.0,77266211.0,900,314,586,144996,25378,119618,93036853.0,16178732.0,76858121.0,0.6374,0.6426,0.6375,0.6425
2023-12-06 17:50,1356,478,878,267869,40949,226920,172337052.0,26207651.0,146129401.0,1303,445,858,263407,37356,226051,169475837.0,23903635.0,145572202.0,0.64,0.644,0.6399,0.644
2023-12-06 17:55,733,295,438,128998,25395,103603,83071318.0,16308024.0,66763294.0,715,283,432,128791,25170,103621,82915450.0,16140708.0,66774742.0,0.6422,0.6444,0.6413,0.6444
2023-12-06 18:00,377,188,189,53584,16695,36889,34497294.0,10708625.0,23788668.0,357,174,183,47872,16794,31078,30826964.0,10744372.0,20082591.0,0.6414,0.6449,0.6398,0.6462
2023-12-06 18:05,206,112,94,29906,10694,19212,19200035.0,6829882.0,12370152.0,191,105,86,30061,10925,19136,19308532.0,6972678.0,12335853.0,0.6387,0.6439,0.6382,0.6446
2023-12-06 18:10,351,119,232,56853,14355,42498,36224279.0,9104551.0,27119728.0,317,98,219,51007,11506,39501,32720874.0,7335860.0,25385013.0,0.6342,0.6381,0.6376,0.6426
2023-12-06 18:15,3231,423,2808,504086,24142,479944,323051072.0,15333060.0,307718012.0,3147,387,2760,506521,23399,483122,324719768.0,14881151.0,309838617.0,0.6351,0.6412,0.636,0.6413
2023-12-06 18:20,2122,217,1905,383163,11470,371693,245629913.0,7388568.0,238241344.0,2051,184,1867,379519,9518,370001,243227001.0,6053240.0,237173761.0,0.6442,0.641,0.636,0.641
2023-12-06 18:25,723,396,327,93075,30010,63065,59549992.0,19133433.0,40416559.0,699,384,315,91200,29470,61730,58331675.0,18757243.0,39574431.0,0.6376,0.6409,0.6365,0.6411
2023-12-06 18:30,315,160,155,37113,8736,28377,23670452.0,5598761.0,18071690.0,234,119,115,27586,6171,21415,17630918.0,3915382.0,13715536.0,0.6409,0.6368,0.6345,0.6405
2023-12-06 18:35,571,212,359,85516,8850,76666,54568126.0,5662277.0,48905849.0,491,156,335,86208,9323,76885,55029596.0,5856063.0,49173533.0,0.6398,0.6379,0.6281,0.6396
2023-12-07 10:00,3916,2136,1780,508259,265352,242907,312561.0,160054.0,160054.0,3055,1731,1324,443890,237120,206770,279363.0,148166.0,148166.0,0.0006,0.0006,0.0006,0.0006
2023-12-07 10:05,9277,1954,7323,1595477,213061,1382416,980252.0,128998.0,128998.0,8458,1441,7017,1519767,179414,1340353,941308.0,110799.0,110799.0,0.0006,0.0006,0.0006,0.0006
2023-12-07 10:10,9132,2310,6822,1488683,239618,1249065,882812.0,138658.0,138658.0,7638,1440,6198,1347506,165793,1181713,819519.0,100191.0,100191.0,0.0006,0.0006,0.0006,0.0006
2023-12-07 10:15,2660,1307,1353,348773,157687,191086,207325.0,92938.0,92938.0,1822,806,1016,251752,107244,144508,153430.0,64477.0,64477.0,0.0006,0.0006,0.0006,0.0006
2023-12-07 10:20,3126,1176,1950,400463,102571,297892,232350.0,58044.0,58044.0,2364,695,1669,337177,67706,269471,203432.0,40534.0,40534.0,0.0006,0.0006,0.0006,0.0006
2023-12-07 10:25,6393,1719,4674,1046081,202267,843814,619490.0,117217.0,117217.0,5551,1250,4301,958874,161112,797762,577617.0,96631.0,96631.0,0.0006,0.0006,0.0006,0.0006
2023-12-07 10:30,2616,1739,877,388237,288222,100015,229851.0,170473.0,170473.0,2270,1516,754,360268,273355,86913,217098.0,164438.0,164438.0,0.0006,0.0006,0.0006,0.0006
2023-12-07 10:35,1284,891,393,144696,101997,42699,82105.0,56979.0,56979.0,893,632,261,115356,87629,27727,69590.0,52722.0,52722.0,0.0006,0.0006,0.0006,0.0006
2023-12-07 10:40,1448,610,838,184445,63538,120907,106100.0,37435.0,37435.0,1069,384,685,150898,47725,103173,91070.0,28616.0,28616.0,0.0006,0.0006,0.0006,0.0006
2023-12-07 10:45,1370,765,605,150314,72666,77648,85803.0,40304.0,40304.0,1062,563,499,131462,60864,70598,79110.0,36520.0,36520.0,0.0006,0.0006,0.0006,0.0006
2023-12-07 10:50,2184,625,1559,313151,56843,256308,185409.0,33337.0,33337.0,1922,476,1446,293887,48134,245753,177132.0,28838.0,28838.0,0.0006,0.0006,0.0006,0.0006
2023-12-07 10:55,4163,802,3361,657708,75373,582335,392114.0,43640.0,43640.0,3869,634,3235,644405,70590,573815,387038.0,42223.0,42223.0,0.0006,0.0006,0.0006,0.0006
2023-12-07 11:00,2748,1048,1700,364011,91882,272129,206423.0,52132.0,52132.0,1946,564,1382,289559,53026,236533,172947.0,31344.0,31344.0,0.0006,0.0006,0.0006,0.0006
2023-12-07 11:05,4212,2371,1841,605970,359482,246488,354244.0,209115.0,209115.0,3547,1994,1553,559717,336028,223689,332626.0,199455.0,199455.0,0.0006,0.0006,0.0006,0.0006
2023-12-07 11:10,2178,990,1188,234141,103210,130931,135069.0,58996.0,58996.0,1705,744,961,211265,89983,121282,125734.0,53366.0,53366.0,0.0006,0.0006,0.0006,0.0006
2023-12-07 11:15,1463,664,799,152027,58832,93195,87066.0,33330.0,33330.0,1090,487,603,131621,47267,84354,78348.0,27949.0,27949.0,0.0006,0.0006,0.0006,0.0006
2023-12-07 11:20,4847,1133,3714,854505,124048,730457,506661.0,71710.0,71710.0,4559,960,3599,831879,114240,717639,495863.0,67763.0,67763.0,0.0006,0.0006,0.0006,0.0006
2023-12-07 11:25,2035,1213,822,265657,168160,97497,149507.0,97715.0,97715.0,1540,957,583,217311,145141,72170,128455.0,85347.0,85347.0,0.0006,0.0005,0.0006,0.0006
2023-12-07 11:30,3249,1441,1808,397611,246233,151378,227469.0,141071.0,141071.0,2710,1179,1531,350275,221533,128742,206549.0,130207.0,130207.0,0.0006,0.0006,0.0006,0.0006
2023-12-07 11:35,1811,1000,811,234538,122768,111770,135979.0,71028.0,71028.0,1529,826,703,213854,107673,106181,126063.0,63265.0,63265.0,0.0006,0.0006,0.0006,0.0006
2023-12-07 11:40,2545,774,1771,394363,71117,323246,228022.0,40856.0,40856.0,2262,594,1668,372450,61721,310729,219371.0,36179.0,36179.0,0.0006,0.0006,0.0006,0.0006
2023-12-07 11:45,3848,922,2926,656436,116496,539940,381885.0,65857.0,65857.0,3543,740,2803,620723,94743,525980,365322.0,55407.0,55407.0,0.0006,0.0006,0.0006,0.0006
2023-12-07 11:50,3825,3310,515,632201,578447,53754,369762.0,338347.0,338347.0,3531,3149,382,604110,567276,36834,356425.0,334469.0,334469.0,0.0006,0.0006,0.0006,0.0006
2023-12-07 11:55,4198,3683,515,740271,671840,68431,436063.0,395609.0,395609.0,3917,3521,396,714959,652750,62209,423532.0,386395.0,386395.0,0.0006,0.0006,0.0006,0.0006
2023-12-07 12:00,1377,508,869,165317,56620,108697,96224.0,33280.0,33280.0,1195,385,810,158450,54511,103939,94162.0,32182.0,32182.0,0.0006,0.0006,0.0006,0.0006
2023-12-07 12:05,1875,1170,705,263004,173339,89665,153071.0,100227.0,100227.0,1717,1094,623,235649,158442,77207,140269.0,94128.0,94128.0,0.0006,0.0006,0.0006,0.0006
2023-12-07 12:10,3020,2419,601,487731,415650,72081,289692.0,246467.0,246467.0,2810,2312,498,478254,407670,70584,285343.0,243005.0,243005.0,0.0006,0.0006,0.0006,0.0006
2023-12-07 12:15,2089,1415,674,289818,208336,81482,169915.0,121548.0,121548.0,1562,1121,441,251240,188278,62962,150602.0,112556.0,112556.0,0.0006,0.0006,0.0006,0.0006
2023-12-07 12:20,1321,620,701,175177,74563,100614,103045.0,43889.0,43889.0,1146,524,622,164907,72235,92672,98895.0,43074.0,43074.0,0.0006,0.0006,0.0006,0.0006
2023-12-07 12:25,3154,775,2379,535978,82262,453716,318436.0,48190.0,48190.0,2960,668,2292,521951,78409,443542,312196.0,46612.0,46612.0,0.0006,0.0006,0.0006,0.0006
2023-12-07 12:30,1627,495,1132,221576,40104,181472,130964.0,23373.0,23373.0,1473,394,1079,214298,35008,179290,128166.0,20778.0,20778.0,0.0006,0.0006,0.0006,0.0006
2023-12-07 12:35,5358,1215,4143,925008,125400,799608,549261.0,72970.0,72970.0,5158,1087,4071,900144,107476,792668,538844.0,63968.0,63968.0,0.0006,0.0006,0.0006,0.0006
2023-12-07 12:40,2262,1739,523,340324,271783,68541,199693.0,159079.0,159079.0,2000,1615,385,321789,263900,57889,192881.0,158024.0,158024.0,0.0006,0.0006,0.0006,0.0006
2023-12-07 12:45,944,666,278,119540,91899,27641,70938.0,54743.0,54743.0,857,616,241,115771,91255,24516,69212.0,54464.0,54464.0,0.0006,0.0006,0.0006,0.0006
2023-12-07 12:50,1161,870,291,134039,102491,31548,79025.0,60269.0,60269.0,1052,800,252,131083,100241,30842,78436.0,59895.0,59895.0,0.0006,0.0006,0.0006,0.0006
2023-12-07 12:55,1964,1728,236,364357,347673,16684,216612.0,206604.0,206604.0,1814,1640,174,350965,337479,13486,210657.0,202507.0,202507.0,0.0006,0.0006,0.0006,0.0006
2023-12-07 13:00,671,481,190,71502,58973,12529,41658.0,34267.0,34267.0,570,435,135,66153,57915,8238,39697.0,34705.0,34705.0,0.0006,0.0006,0.0006,0.0006
2023-12-07 13:05,849,671,178,99690,84811,14879,58976.0,50181.0,50181.0,698,586,112,91441,80814,10627,55078.0,48627.0,48627.0,0.0006,0.0006,0.0006,0.0006
2023-12-07 13:10,2382,1987,395,365206,329801,35405,216767.0,195945.0,195945.0,2250,1931,319,350915,322423,28492,212133.0,194801.0,194801.0,0.0006,0.0006,0.0006,0.0006
2023-12-07 13:15,2070,948,1122,308211,137593,170618,178610.0,82073.0,82073.0,1850,824,1026,278670,123365,155305,167627.0,73984.0,73984.0,0.0006,0.0006,0.0006,0.0006
2023-12-07 13:20,1425,1184,241,191312,170768,20544,112997.0,100893.0,100893.0,1271,1086,185,181655,162361,19294,108870.0,97187.0,97187.0,0.0006,0.0006,0.0006,0.0006
2023-12-07 13:25,2457,498,1959,427120,44042,383078,252724.0,26071.0,26071.0,2249,355,1894,405647,35294,370353,242974.0,20978.0,20978.0,0.0006,0.0006,0.0006,0.0006
2023-12-07 13:30,1659,422,1237,256311,34174,222137,152603.0,19738.0,19738.0,1516,339,1177,251879,31944,219935,150743.0,18974.0,18974.0,0.0006,0.0006,0.0006,0.0006
2023-12-07 13:35,629,411,218,89623,64188,25435,51960.0,36693.0,36693.0,552,368,184,82870,60184,22686,49649.0,35967.0,35967.0,0.0006,0.0006,0.0006,0.0006
2023-12-07 13:40,2436,1295,1141,350760,265072,85688,209956.0,158156.0,158156.0,2331,1259,1072,346491,264123,82368,208383.0,158553.0,158553.0,0.0006,0.0006,0.0006,0.0006
2023-12-07 13:45,455,338,117,62392,55873,6519,37453.0,33492.0,33492.0,378,298,80,61030,55059,5971,36627.0,33008.0,33008.0,0.0006,0.0006,0.0006,0.0006
2023-12-07 13:50,871,399,472,107142,46431,60711,62827.0,27697.0,27697.0,770,337,433,100496,43538,56958,60301.0,26023.0,26023.0,0.0006,0.0006,0.0006,0.0006
2023-12-07 13:55,2147,295,1852,276943,27654,249289,166245.0,16249.0,16249.0,2104,265,1839,267422,19188,248234,160844.0,11456.0,11456.0,0.0006,0.0006,0.0006,0.0006
2023-12-07 14:00,4965,1021,3944,923043,130592,792451,551027.0,77239.0,77239.0,4842,947,3895,910893,124193,786700,546492.0,74225.0,74225.0,0.0006,0.0006,0.0006,0.0006
2023-12-07 14:05,451,223,228,49001,25898,23103,28973.0,15128.0,15128.0,391,189,202,46470,25116,21354,27840.0,14986.0,14986.0,0.0006,0.0006,0.0006,0.0006
2023-12-07 14:10,266,140,126,23023,10892,12131,13382.0,6469.0,6469.0,223,118,105,21845,11588,10257,13076.0,6903.0,6903.0,0.0006,0.0006,0.0006,0.0006
2023-12-07 14:15,4060,832,3228,702039,73078,628961,417232.0,43173.0,43173.0,3771,600,3171,688412,64950,623462,410544.0,38542.0,38542.0,0.0006,0.0006,0.0006,0.0006
2023-12-07 14:20,5628,723,4905,1036839,64406,972433,617587.0,37883.0,37883.0,5491,626,4865,1028750,57668,971082,613056.0,34129.0,34129.0,0.0006,0.0006,0.0006,0.0006
2023-12-07 14:25,3565,564,3001,653258,34305,618953,386205.0,19827.0,19827.0,3446,480,2966,644371,30483,613888,383569.0,18018.0,18018.0,0.0006,0.0006,0.0006,0.0006
2023-12-07 14:30,2456,535,1921,473379,32146,441233,281497.0,18912.0,18912.0,2392,506,1886,468974,30052,438922,279440.0,17799.0,17799.0,0.0006,0.0006,0.0006,0.0006
2023-12-07 14:35,3954,3091,863,644261,495918,148343,382447.0,293979.0,293979.0,3817,3013,804,637805,491043,146762,379557.0,291911.0,291911.0,0.0006,0.0006,0.0006,0.0006
2023-12-07 14:40,1032,546,486,126611,63205,63406,74603.0,37499.0,37499.0,941,490,451,121311,62389,58922,72268.0,37070.0,37070.0,0.0006,0.0006,0.0006,0.0006
2023-12-07 14:45,690,170,520,100120,10877,89243,59600.0,6246.0,6246.0,626,125,501,97626,8857,88769,58284.0,5243.0,5243.0,0.0006,0.0006,0.0006,0.0006
2023-12-07 14:50,2873,426,2447,517537,46166,471371,307933.0,27371.0,27371.0,2806,382,2424,514665,45187,469478,306932.0,26814.0,26814.0,0.0006,0.0006,0.0006,0.0006
2023-12-07 14:55,2693,725,1968,414960,68224,346736,246663.0,40289.0,40289.0,2617,672,1945,412986,67468,345518,246226.0,40007.0,40007.0,0.0006,0.0006,0.0006,0.0006
2023-12-07 15:00,4400,846,3554,757485,80549,676936,450864.0,47400.0,47400.0,4342,812,3530,755952,79627,676325,450656.0,47237.0,47237.0,0.0006,0.0006,0.0006,0.0006
2023-12-07 15:05,6735,5707,1028,1296310,1140105,156205,770112.0,676808.0,676808.0,6679,5670,1009,1289954,1136046,153908,767963.0,676019.0,676019.0,0.0006,0.0006,0.0006,0.0006
2023-12-07 15:10,994,859,135,167698,158717,8981,99596.0,94237.0,94237.0,946,830,116,165798,157528,8270,98712.0,93738.0,93738.0,0.0006,0.0006,0.0006,0.0006
2023-12-07 15:15,310,230,80,45597,42023,3574,27123.0,24983.0,24983.0,326,252,74,45127,41160,3967,26865.0,24482.0,24482.0,0.0006,0.0006,0.0006,0.0006
2023-12-07 15:20,272,186,86,29452,21817,7635,17485.0,12898.0,12898.0,227,151,76,28609,19563,9046,17093.0,11649.0,11649.0,0.0006,0.0006,0.0006,0.0006
2023-12-07 15:25,1655,1188,467,245245,186022,59223,144943.0,109368.0,109368.0,1516,1110,406,232441,182844,49597,139200.0,109337.0,109337.0,0.0006,0.0006,0.0006,0.0006
2023-12-07 15:30,2925,2288,637,518230,456191,62039,309665.0,272569.0,272569.0,2813,2245,568,511993,453207,58786,306989.0,271535.0,271535.0,0.0006,0.0006,0.0006,0.0006
2023-12-07 15:35,374,209,165,36467,24222,12245,21655.0,14288.0,14288.0,328,188,140,35023,23512,11511,20968.0,14042.0,14042.0,0.0006,0.0006,0.0006,0.0006
2023-12-07 15:40,3809,3175,634,651425,580060,71365,389648.0,347877.0,347877.0,3581,3068,513,621115,560018,61097,374155.0,337145.0,337145.0,0.0006,0.0006,0.0006,0.0006
2023-12-07 15:45,840,301,539,102547,31568,70979,60725.0,18848.0,18848.0,785,264,521,95643,27734,67909,57619.0,16638.0,16638.0,0.0006,0.0006,0.0006,0.0006
2023-12-07 15:50,454,174,280,55065,15048,40017,32847.0,8794.0,8794.0,423,159,264,56295,15590,40705,33968.0,9354.0,9354.0,0.0006,0.0006,0.0006,0.0006
2023-12-07 15:55,1600,1209,391,240190,201673,38517,144581.0,121225.0,121225.0,1501,1158,343,227346,194306,33040,137369.0,117306.0,117306.0,0.0006,0.0006,0.0006,0.0006
2023-12-07 16:00,1168,760,408,163044,121868,41176,96985.0,72908.0,72908.0,1085,717,368,160767,121326,39441,97211.0,73289.0,73289.0,0.0006,0.0006,0.0006,0.0006
2023-12-07 16:05,1073,804,269,139345,116890,22455,82661.0,69682.0,69682.0,954,754,200,128592,111747,16845,77827.0,67533.0,67533.0,0.0006,0.0006,0.0006,0.0006
2023-12-07 16:10,684,495,189,76956,62767,14189,44741.0,36366.0,36366.0,488,388,100,67887,57410,10477,41109.0,34687.0,34687.0,0.0006,0.0006,0.0006,0.0006
2023-12-07 16:15,5275,3789,1486,791661,625115,166546,470975.0,369766.0,369766.0,4590,3429,1161,728945,590406,138539,447286.0,361463.0,361463.0,0.0006,0.0006,0.0006,0.0006
2023-12-07 16:20,1280,669,611,134657,49265,85392,78442.0,29825.0,29825.0,969,443,526,110364,36615,73749,67634.0,22260.0,22260.0,0.0006,0.0006,0.0006,0.0006
2023-12-07 16:25,803,383,420,81199,36289,44910,47399.0,21518.0,21518.0,646,292,354,70043,30853,39190,42704.0,18682.0,18682.0,0.0006,0.0006,0.0006,0.0006
2023-12-07 16:30,675,336,339,68610,33287,35323,40163.0,19200.0,19200.0,543,267,276,59134,28370,30764,36115.0,17217.0,17217.0,0.0006,0.0006,0.0006,0.0006
2023-12-07 16:35,2218,1509,709,310874,224914,85960,186922.0,135770.0,135770.0,2147,1494,653,304429,222590,81839,185507.0,135430.0,135430.0,0.0006,0.0006,0.0006,0.0006
2023-12-07 16:40,768,377,391,105967,29732,76235,64083.0,17799.0,17799.0,692,325,367,105187,28865,76322,64141.0,17474.0,17474.0,0.0006,0.0006,0.0006,0.0006
2023-12-07 16:45,653,281,372,86494,23987,62507,52139.0,14372.0,14372.0,593,241,352,83986,22703,61283,51270.0,13760.0,13760.0,0.0006,0.0006,0.0006,0.0006
2023-12-07 16:50,967,369,598,129564,33618,95946,78815.0,20366.0,20366.0,935,355,580,127125,33236,93889,77595.0,20164.0,20164.0,0.0006,0.0006,0.0006,0.0006
2023-12-07 16:55,261,140,121,32109,12855,19254,19396.0,7598.0,7598.0,224,110,114,26755,10388,16367,16314.0,6294.0,6294.0,0.0006,0.0006,0.0006,0.0006
2023-12-07 17:00,229,108,121,28044,11483,16561,16639.0,6600.0,6600.0,220,101,119,26870,10768,16102,16375.0,6530.0,6530.0,0.0006,0.0006,0.0006,0.0006
2023-12-07 17:05,457,222,235,49186,23948,25238,29795.0,14472.0,14472.0,398,196,202,46331,23393,22938,28241.0,14202.0,14202.0,0.0006,0.0006,0.0006,0.0006
2023-12-07 17:10,793,370,423,104248,46443,57805,63494.0,28185.0,28185.0,772,364,408,106889,47484,59405,65137.0,28770.0,28770.0,0.0006,0.0006,0.0006,0.0006
2023-12-07 17:15,1774,1454,320,175584,136882,38702,106742.0,82960.0,82960.0,1694,1402,292,172973,134129,38844,105599.0,81716.0,81716.0,0.0006,0.0006,0.0006,0.0006
2023-12-07 17:20,1264,965,299,133001,100348,32653,81143.0,61064.0,61064.0,1195,934,261,128566,98479,30087,78533.0,60020.0,60020.0,0.0006,0.0006,0.0006,0.0006
2023-12-07 17:25,768,711,57,66906,60513,6393,40155.0,36284.0,36284.0,732,690,42,71289,66894,4395,43095.0,40393.0,40393.0,0.0006,0.0006,0.0006,0.0006
2023-12-07 17:30,609,406,203,65600,39549,26051,39527.0,23986.0,23986.0,580,387,193,66336,41138,25198,40497.0,25036.0,25036.0,0.0006,0.0006,0.0006,0.0006
2023-12-07 17:35,4638,3900,738,723428,649042,74386,440133.0,395159.0,395159.0,4473,3823,650,709590,643152,66438,433221.0,392356.0,392356.0,0.0006,0.0006,0.0006,0.0006
2023-12-07 17:40,1270,886,384,157625,126195,31430,95185.0,76311.0,76311.0,1094,803,291,148024,117910,30114,91015.0,72340.0,72340.0,0.0006,0.0006,0.0006,0.0006
2023-12-07 17:45,950,749,201,120739,99348,21391,71056.0,59014.0,59014.0,853,710,143,109288,95245,14043,67147.0,58453.0,58453.0,0.0006,0.0006,0.0006,0.0006
2023-12-07 17:50,2815,2544,271,472315,441275,31040,288544.0,270740.0,270740.0,2732,2511,221,465115,439375,25740,285503.0,269606.0,269606.0,0.0006,0.0006,0.0006,0.0006
2023-12-07 17:55,1825,1325,500,266135,217521,48614,161961.0,132562.0,132562.0,1713,1278,435,258890,213159,45731,158438.0,130270.0,130270.0,0.0006,0.0006,0.0006,0.0006
2023-12-07 18:00,436,274,162,54299,33105,21194,32406.0,20154.0,20154.0,359,228,131,48042,28628,19414,29561.0,17514.0,17514.0,0.0006,0.0006,0.0006,0.0006
2023-12-07 18:05,456,253,203,58817,34855,23962,35754.0,20940.0,20940.0,388,227,161,55849,33619,22230,34347.0,20598.0,20598.0,0.0006,0.0006,0.0006,0.0006
2023-12-07 18:10,441,322,119,44948,31400,13548,26600.0,18590.0,18590.0,376,279,97,37385,29624,7761,23017.0,18189.0,18189.0,0.0006,0.0006,0.0006,0.0006
2023-12-07 18:15,750,504,246,80327,53214,27113,45345.0,29123.0,29123.0,500,345,155,59148,37507,21641,36469.0,22993.0,22993.0,0.0005,0.0006,0.0006,0.0006
2023-12-07 18:20,1701,651,1050,215296,50674,164622,126605.0,30113.0,30113.0,1315,412,903,187767,38576,149191,116204.0,23729.0,23729.0,0.0006,0.0006,0.0006,0.0006
2023-12-07 18:25,3800,1989,1811,537686,151904,385782,325959.0,90876.0,90876.0,3505,1776,1729,516329,138375,377954,318347.0,84751.0,84751.0,0.0006,0.0006,0.0006,0.0006
2023-12-07 18:30,4011,2062,1949,556499,299101,257398,331622.0,178604.0,178604.0,3533,1787,1746,510411,278569,231842,312643.0,169827.0,169827.0,0.0006,0.0006,0.0006,0.0006
2023-12-07 18:35,2859,2262,597,304818,222054,82764,183089.0,134060.0,134060.0,2104,1605,499,287848,215861,71987,175433.0,131420.0,131420.0,0.0006,0.0006,0.0006,0.0006
2023-12-08 10:00,3767,2922,845,649986,543684,106302,393982.0,328728.0,328728.0,3321,2694,627,628278,536291,91987,382304.0,325745.0,325745.0,0.0006,0.0006,0.0006,0.0006
2023-12-08 10:05,2714,1669,1045,346298,212750,133548,209154.0,128075.0,128075.0,2439,1508,931,331591,203107,128484,202345.0,123512.0,123512.0,0.0006,0.0006,0.0006,0.0006
2023-12-08 10:10,1405,873,532,187543,136862,50681,112590.0,81953.0,81953.0,1102,715,387,162219,123204,39015,99361.0,75304.0,75304.0,0.0006,0.0006,0.0006,0.0006
2023-12-08 10:15,1508,1149,359,197221,151831,45390,118988.0,91292.0,91292.0,1361,1064,297,178515,142645,35870,109228.0,87191.0,87191.0,0.0006,0.0006,0.0006,0.0006
2023-12-08 10:20,1415,882,533,195893,113756,82137,118813.0,69454.0,69454.0,1317,842,475,185270,111144,74126,113233.0,67887.0,67887.0,0.0006,0.0006,0.0006,0.0006
2023-12-08 10:25,2417,1490,927,310664,134950,175714,189228.0,81351.0,81351.0,2313,1420,893,312151,130393,181758,191134.0,79553.0,79553.0,0.0006,0.0006,0.0006,0.0006
2023-12-08 10:30,2170,1788,382,321079,276086,44993,195155.0,167644.0,167644.0,2099,1745,354,315272,272904,42368,192777.0,166729.0,166729.0,0.0006,0.0006,0.0006,0.0006
2023-12-08 10:35,1107,979,128,174915,164611,10304,106785.0,100631.0,100631.0,1018,931,87,169222,160815,8407,103595.0,98403.0,98403.0,0.0006,0.0006,0.0006,0.0006
2023-12-08 10:40,1076,898,178,106626,86459,20167,64783.0,52660.0,52660.0,956,825,131,101431,85414,16017,62253.0,52341.0,52341.0,0.0006,0.0006,0.0006,0.0006
2023-12-08 10:45,8331,6753,1578,931302,607791,323511,573895.0,373388.0,373388.0,8199,6697,1502,914063,598200,315863,563846.0,368015.0,368015.0,0.0006,0.0006,0.0006,0.0006
2023-12-08 10:50,2369,1138,1231,319583,127590,191993,197033.0,78366.0,78366.0,2272,1089,1183,316061,125331,190730,195345.0,77089.0,77089.0,0.0006,0.0006,0.0006,0.0006
2023-12-08 10:55,992,654,338,113630,79845,33785,69778.0,49033.0,49033.0,932,630,302,118833,82195,36638,73242.0,50514.0,50514.0,0.0006,0.0006,0.0006,0.0006
2023-12-08 11:00,1909,995,914,240082,110341,129741,147463.0,67559.0,67559.0,1789,941,848,236896,111480,125416,146246.0,68450.0,68450.0,0.0006,0.0006,0.0006,0.0006
2023-12-08 11:05,1145,803,342,148880,111330,37550,91196.0,68037.0,68037.0,1110,799,311,140861,106899,33962,86754.0,65716.0,65716.0,0.0006,0.0006,0.0006,0.0006
2023-12-08 11:10,402,293,109,56704,50399,6305,34442.0,30599.0,30599.0,356,264,92,55836,49417,6419,34290.0,30307.0,30307.0,0.0006,0.0006,0.0006,0.0006
2023-12-08 11:15,1022,674,348,127045,98810,28235,77439.0,60651.0,60651.0,956,638,318,124502,97665,26837,76625.0,60016.0,60016.0,0.0006,0.0006,0.0006,0.0006
2023-12-08 11:20,626,431,195,64844,42768,22076,39377.0,26213.0,26213.0,561,395,166,61980,42254,19726,38158.0,25951.0,25951.0,0.0006,0.0006,0.0006,0.0006
2023-12-08 11:25,659,466,193,67558,51774,15784,41257.0,31537.0,31537.0,599,438,161,65931,51345,14586,40544.0,31510.0,31510.0,0.0006,0.0006,0.0006,0.0006
2023-12-08 11:30,1145,762,383,155295,103945,51350,95212.0,63733.0,63733.0,1098,735,363,147225,103352,43873,90603.0,63432.0,63432.0,0.0006,0.0006,0.0006,0.0006
2023-12-08 11:35,326,228,98,33371,26014,7357,20355.0,15898.0,15898.0,263,188,75,30387,24453,5934,18636.0,14968.0,14968.0,0.0006,0.0006,0.0006,0.0006
2023-12-08 11:40,167,137,30,16430,14565,1865,9786.0,8640.0,8640.0,139,113,26,15682,13168,2514,9634.0,8072.0,8072.0,0.0006,0.0006,0.0006,0.0006
2023-12-08 11:45,153,132,21,17428,15006,2422,10048.0,8502.0,8502.0,106,97,9,13020,10111,2909,8019.0,6194.0,6194.0,0.0006,0.0006,0.0006,0.0006
2023-12-08 11:50,56,38,18,3802,1731,2071,2365.0,1057.0,1057.0,40,32,8,2972,1590,1382,1837.0,972.0,972.0,0.0006,0.0006,0.0006,0.0006
2023-12-08 11:55,157,58,99,12567,2229,10338,6987.0,1362.0,1362.0,133,50,83,10523,2514,8009,6488.0,1538.0,1538.0,0.0006,0.0005,0.0006,0.0006
2023-12-08 12:00,249,86,163,16652,4768,11884,9787.0,2809.0,2809.0,199,60,139,12990,4353,8637,7975.0,2652.0,2652.0,0.0006,0.0006,0.0006,0.0006
2023-12-08 12:05,243,106,137,19056,9599,9457,11335.0,5815.0,5815.0,189,73,116,16072,8267,7805,9843.0,5037.0,5037.0,0.0006,0.0006,0.0006,0.0006
2023-12-08 12:10,246,164,82,21079,14616,6463,12547.0,8604.0,8604.0,200,145,55,19946,13836,6110,12183.0,8431.0,8431.0,0.0006,0.0006,0.0006,0.0006
2023-12-08 12:15,753,720,33,105617,104249,1368,64549.0,63704.0,63704.0,743,717,26,104480,103492,988,63857.0,63250.0,63250.0,0.0006,0.0006,0.0006,0.0006
2023-12-08 12:20,1554,1409,145,265920,261438,4482,161947.0,159280.0,159280.0,1486,1364,122,263226,259382,3844,160993.0,158615.0,158615.0,0.0006,0.0006,0.0006,0.0006
2023-12-08 12:25,1298,1207,91,219177,209627,9550,133791.0,128022.0,128022.0,1254,1182,72,220892,208502,12390,135159.0,127523.0,127523.0,0.0006,0.0006,0.0006,0.0006
2023-12-08 12:30,925,276,649,127890,46395,81495,78101.0,28247.0,28247.0,883,248,635,127599,44319,83280,78204.0,26997.0,26997.0,0.0006,0.0006,0.0006,0.0006
2023-12-08 12:35,1129,258,871,161500,40253,121247,97808.0,23910.0,23910.0,1085,232,853,156853,37666,119187,95916.0,22820.0,22820.0,0.0006,0.0006,0.0006,0.0006
2023-12-08 12:40,510,133,377,73022,5042,67980,44652.0,2785.0,2785.0,480,114,366,69959,4235,65724,42973.0,2578.0,2578.0,0.0006,0.0006,0.0006,0.0006
2023-12-08 12:45,301,122,179,40406,6804,33602,25018.0,4137.0,4137.0,286,114,172,38391,7345,31046,23591.0,4469.0,4469.0,0.0006,0.0006,0.0006,0.0006
2023-12-08 12:50,809,270,539,98604,20318,78286,59708.0,11803.0,11803.0,771,252,519,96759,18794,77965,59293.0,11450.0,11450.0,0.0006,0.0006,0.0006,0.0006
2023-12-08 12:55,159,119,40,16714,13305,3409,10205.0,8112.0,8112.0,143,110,33,16367,12903,3464,9995.0,7868.0,7868.0,0.0006,0.0006,0.0006,0.0006
2023-12-08 13:00,147,100,47,15467,10010,5457,9400.0,6101.0,6101.0,135,91,44,15693,10596,5097,9589.0,6459.0,6459.0,0.0006,0.0006,0.0006,0.0006
2023-12-08 13:05,52,33,19,3590,1694,1896,2141.0,970.0,970.0,43,27,16,3377,1517,1860,2074.0,925.0,925.0,0.0006,0.0006,0.0006,0.0006
2023-12-08 13:10,342,136,206,39857,16827,23030,24120.0,10256.0,10256.0,314,127,187,36719,15178,21541,22470.0,9254.0,9254.0,0.0006,0.0006,0.0006,0.0006
2023-12-08 13:15,2203,685,1518,319615,73522,246093,184546.0,43234.0,43234.0,1829,469,1360,279712,56151,223561,169528.0,33876.0,33876.0,0.0006,0.0006,0.0006,0.0006
2023-12-08 13:20,1006,549,457,108544,64877,43667,61792.0,37458.0,37458.0,728,389,339,83846,49707,34139,50856.0,29892.0,29892.0,0.0006,0.0006,0.0006,0.0006
2023-12-08 13:25,2377,576,1801,378739,53922,324817,225743.0,31923.0,31923.0,2185,465,1720,364119,48260,315859,220107.0,28959.0,28959.0,0.0006,0.0006,0.0006,0.0006
2023-12-08 13:30,1930,760,1170,346146,135338,210808,208339.0,81287.0,81287.0,1746,673,1073,335000,127682,207318,202508.0,76973.0,76973.0,0.0006,0.0006,0.0006,0.0006
2023-12-08 13:35,1539,492,1047,222088,64612,157476,131892.0,38790.0,38790.0,1355,398,957,212600,61567,151033,128456.0,37080.0,37080.0,0.0006,0.0006,0.0006,0.0006
2023-12-08 13:40,1592,615,977,227575,56007,171568,133588.0,33105.0,33105.0,1358,454,904,204693,44641,160052,122933.0,26545.0,26545.0,0.0006,0.0006,0.0006,0.0006
2023-12-08 13:45,1149,279,870,190897,15654,175243,114522.0,9060.0,9060.0,1046,201,845,187423,12022,175401,112889.0,7158.0,7158.0,0.0006,0.0006,0.0006,0.0006
2023-12-08 13:50,2045,1522,523,331861,287953,43908,196562.0,170314.0,170314.0,1865,1441,424,318536,278965,39571,192098.0,168104.0,168104.0,0.0006,0.0006,0.0006,0.0006
2023-12-08 13:55,1381,278,1103,182523,37797,144726,110054.0,22653.0,22653.0,1346,265,1081,181733,39400,142333,109626.0,23629.0,23629.0,0.0006,0.0006,0.0006,0.0006
2023-12-08 14:00,1196,442,754,178030,52268,125762,107244.0,31289.0,31289.0,1155,409,746,176346,51124,125222,106342.0,30668.0,30668.0,0.0006,0.0006,0.0006,0.0006
2023-12-08 14:05,1397,311,1086,190591,43544,147047,114563.0,26050.0,26050.0,1331,280,1051,186986,43954,143032,112665.0,26317.0,26317.0,0.0006,0.0006,0.0006,0.0006
2023-12-08 14:10,1579,881,698,223191,96832,126359,133703.0,57331.0,57331.0,1507,843,664,215368,95088,120280,129868.0,57059.0,57059.0,0.0006,0.0006,0.0006,0.0006
2023-12-08 14:15,1413,1036,377,136242,88471,47771,81529.0,52884.0,52884.0,1367,1007,360,133431,87108,46323,80241.0,52280.0,52280.0,0.0006,0.0006,0.0006,0.0006
2023-12-08 14:20,1063,698,365,106871,57119,49752,64361.0,34290.0,34290.0,1022,681,341,107513,57628,49885,64823.0,34605.0,34605.0,0.0006,0.0006,0.0006,0.0006
2023-12-08 14:25,608,309,299,63791,28174,35617,37710.0,16805.0,16805.0,538,272,266,62836,28571,34265,37900.0,17118.0,17118.0,0.0006,0.0006,0.0006,0.0006
2023-12-08 14:30,780,204,576,88565,12365,76200,53314.0,7389.0,7389.0,736,180,556,84223,10493,73730,50752.0,6283.0,6283.0,0.0006,0.0006,0.0006,0.0006
2023-12-08 14:35,1309,246,1063,198500,12038,186462,119331.0,7000.0,7000.0,1264,216,1048,198477,12553,185924,119567.0,7524.0,7524.0,0.0006,0.0006,0.0006,0.0006
2023-12-08 14:40,933,294,639,102629,22674,79955,61789.0,13528.0,13528.0,902,280,622,101591,22854,78737,61173.0,13705.0,13705.0,0.0006,0.0006,0.0006,0.0006
2023-12-08 14:45,1235,598,637,166172,43061,123111,99882.0,25708.0,25708.0,1200,577,623,159215,35450,123765,95999.0,21261.0,21261.0,0.0006,0.0006,0.0006,0.0006
2023-12-08 14:50,1481,449,1032,219955,24405,195550,130392.0,14565.0,14565.0,1371,395,976,210736,19653,191083,126945.0,11752.0,11752.0,0.0006,0.0006,0.0006,0.0006
2023-12-08 14:55,737,240,497,107823,16401,91422,63926.0,9106.0,9106.0,592,145,447,101116,12111,89005,60652.0,7166.0,7166.0,0.0006,0.0006,0.0006,0.0006
2023-12-08 15:00,165,89,76,17781,4862,12919,10471.0,2658.0,2658.0,134,72,62,15329,4283,11046,9327.0,2546.0,2546.0,0.0005,0.0006,0.0006,0.0006
2023-12-08 15:05,237,181,56,19217,11229,7988,11432.0,6613.0,6613.0,208,159,49,20036,10879,9157,12039.0,6482.0,6482.0,0.0006,0.0006,0.0006,0.0006
2023-12-08 15:10,1049,410,639,106490,34780,71710,63251.0,20662.0,20662.0,981,375,606,110059,40189,69870,65787.0,23845.0,23845.0,0.0006,0.0006,0.0006,0.0006
2023-12-08 15:15,505,260,245,56062,17290,38772,33248.0,10016.0,10016.0,457,216,241,55367,17050,38317,33137.0,10126.0,10126.0,0.0006,0.0006,0.0006,0.0006
2023-12-08 15:20,295,176,119,22966,11722,11244,13673.0,6948.0,6948.0,251,147,104,22442,11546,10896,13436.0,6882.0,6882.0,0.0006,0.0006,0.0006,0.0006
2023-12-08 15:25,629,278,351,75359,26858,48501,44925.0,15868.0,15868.0,585,266,319,69488,23377,46111,41532.0,13906.0,13906.0,0.0006,0.0006,0.0006,0.0006
2023-12-08 15:30,1154,259,895,155854,22123,133731,92365.0,12890.0,12890.0,1053,190,863,155896,22863,133033,93047.0,13506.0,13506.0,0.0006,0.0006,0.0006,0.0006
2023-12-08 15:35,761,221,540,111770,13418,98352,66197.0,7731.0,7731.0,640,138,502,105807,10479,95328,63158.0,6159.0,6159.0,0.0006,0.0006,0.0006,0.0006
2023-12-08 15:40,1168,288,880,179400,19273,160127,106398.0,10952.0,10952.0,1024,195,829,171684,13785,157899,102345.0,8064.0,8064.0,0.0006,0.0006,0.0006,0.0006
2023-12-08 15:45,1266,841,425,134213,74260,59953,79315.0,43577.0,43577.0,1127,767,360,129800,71374,58426,77352.0,42403.0,42403.0,0.0006,0.0006,0.0006,0.0006
2023-12-08 15:50,1115,912,203,119964,90006,29958,71432.0,53482.0,53482.0,1089,898,191,116500,86332,30168,69414.0,51316.0,51316.0,0.0006,0.0006,0.0006,0.0006
2023-12-08 15:55,1574,928,646,209970,101858,108112,125217.0,60519.0,60519.0,1543,906,637,208652,100310,108342,124538.0,59670.0,59670.0,0.0006,0.0006,0.0006,0.0006
2023-12-08 16:00,1647,1394,253,171625,125537,46088,101973.0,74413.0,74413.0,1568,1370,198,173355,124086,49269,103651.0,73970.0,73970.0,0.0006,0.0006,0.0006,0.0006
2023-12-08 16:05,2532,2439,93,354572,344821,9751,211462.0,205622.0,205622.0,2477,2411,66,352008,344478,7530,210031.0,205502.0,205502.0,0.0006,0.0006,0.0006,0.0006
2023-12-08 16:10,2213,2058,155,278552,258410,20142,166187.0,154215.0,154215.0,2165,2036,129,275456,257276,18180,164537.0,153533.0,153533.0,0.0006,0.0006,0.0006,0.0006
2023-12-08 16:15,1572,1494,78,139124,128786,10338,82783.0,76706.0,76706.0,1519,1453,66,136946,126753,10193,81764.0,75628.0,75628.0,0.0006,0.0006,0.0006,0.0006
2023-12-08 16:20,943,877,66,73919,68514,5405,44013.0,40831.0,40831.0,928,870,58,76448,69377,7071,45735.0,41462.0,41462.0,0.0006,0.0006,0.0006,0.0006
2023-12-08 16:25,617,533,84,49079,43790,5289,29279.0,26132.0,26132.0,588,515,73,48351,43455,4896,28927.0,25976.0,25976.0,0.0006,0.0006,0.0006,0.0006
2023-12-08 16:30,363,252,111,32873,21635,11238,19653.0,12919.0,12919.0,328,232,96,29655,20970,8685,17777.0,12545.0,12545.0,0.0006,0.0006,0.0006,0.0006
2023-12-08 16:35,315,218,97,42379,32257,10122,25144.0,19045.0,19045.0,284,196,88,42788,31462,11326,25638.0,18810.0,18810.0,0.0006,0.0006,0.0006,0.0006
2023-12-08 16:40,541,234,307,71889,33116,38773,42266.0,18829.0,18829.0,467,194,273,65640,28422,37218,39524.0,17017.0,17017.0,0.0006,0.0006,0.0006,0.0006
2023-12-08 16:45,499,238,261,65029,32512,32517,38725.0,19135.0,19135.0,440,207,233,62804,33876,28928,37785.0,20288.0,20288.0,0.0006,0.0006,0.0006,0.0006
2023-12-08 16:50,328,216,112,41660,30118,11542,24426.0,17424.0,17424.0,286,196,90,36375,27417,8958,21922.0,16488.0,16488.0,0.0006,0.0006,0.0006,0.0006
2023-12-08 16:55,232,146,86,26132,16843,9289,15395.0,10053.0,10053.0,197,127,70,22266,14437,7829,13426.0,8680.0,8680.0,0.0006,0.0006,0.0006,0.0006
2023-12-08 17:00,162,106,56,17032,11938,5094,10068.0,7155.0,7155.0,149,103,46,16730,12103,4627,10079.0,7274.0,7274.0,0.0006,0.0006,0.0006,0.0006
2023-12-08 17:05,459,414,45,49881,46949,2932,30008.0,28248.0,28248.0,443,403,40,49167,46278,2889,29625.0,27869.0,27869.0,0.0006,0.0006,0.0006,0.0006
2023-12-08 17:10,207,150,57,20187,15656,4531,12048.0,9369.0,9369.0,199,150,49,20731,16602,4129,12484.0,9983.0,9983.0,0.0006,0.0006,0.0006,0.0006
2023-12-08 17:15,1507,1219,288,209452,180420,29032,125399.0,107784.0,107784.0,1461,1200,261,207326,180404,26922,124942.0,108605.0,108605.0,0.0006,0.0006,0.0006,0.0006
2023-12-08 17:20,2627,2139,488,421539,383495,38044,254016.0,230994.0,230994.0,2585,2117,468,418935,383222,35713,252498.0,230852.0,230852.0,0.0006,0.0006,0.0006,0.0006
2023-12-08 17:25,3803,3524,279,684423,661271,23152,412386.0,398343.0,398343.0,3776,3509,267,681986,659474,22512,410987.0,397322.0,397322.0,0.0006,0.0006,0.0006,0.0006
2023-12-08 17:30,1324,941,383,195293,160768,34525,117511.0,96521.0,96521.0,1270,914,356,193504,159877,33627,116817.0,96368.0,96368.0,0.0006,0.0006,0.0006,0.0006
2023-12-08 17:35,511,365,146,74645,63664,10981,44858.0,38363.0,38363.0,498,360,138,74143,63447,10696,44730.0,38229.0,38229.0,0.0006,0.0006,0.0006,0.0006
2023-12-08 17:40,933,676,257,117519,102475,15044,69362.0,61597.0,61597.0,831,650,181,112098,100876,11222,67565.0,60756.0,60756.0,0.0006,0.0005,0.0006,0.0006
2023-12-08 17:45,519,182,337,34834,14635,20199,20883.0,8789.0,8789.0,336,157,179,31398,13614,17784,18936.0,8182.0,8182.0,0.0006,0.0006,0.0006,0.0006
2023-12-08 17:50,485,288,197,38989,28564,10425,23158.0,17000.0,17000.0,372,256,116,38289,27578,10711,23044.0,16550.0,16550.0,0.0006,0.0006,0.0006,0.0006
2023-12-08 17:55,113,67,46,7342,4135,3207,4420.0,2479.0,2479.0,95,51,44,7106,3553,3553,4277.0,2130.0,2130.0,0.0006,0.0006,0.0006,0.0006
2023-12-08 18:00,98,46,52,6800,2991,3809,4105.0,1799.0,1799.0,93,46,47,7261,3874,3387,4361.0,2309.0,2309.0,0.0006,0.0006,0.0006,0.0006
2023-12-08 18:05,1241,1006,235,226753,199619,27134,135638.0,119851.0,119851.0,1205,987,218,226864,201336,25528,136291.0,120862.0,120862.0,0.0006,0.0006,0.0006,0.0006
2023-12-08 18:10,2371,730,1641,381326,88409,292917,226262.0,52801.0,52801.0,2284,662,1622,366969,80118,286851,220689.0,47907.0,47907.0,0.0006,0.0006,0.0006,0.0006
2023-12-08 18:15,3756,422,3334,659616,33697,625919,393182.0,19817.0,19817.0,3627,339,3288,646125,27893,618232,387381.0,16604.0,16604.0,0.0006,0.0006,0.0006,0.0006
2023-12-08 18:20,1336,192,1144,241070,7055,234015,141444.0,3989.0,3989.0,1259,148,1111,236531,7877,228654,141652.0,4649.0,4649.0,0.0006,0.0006,0.0006,0.0006
2023-12-08 18:25,783,155,628,90496,7956,82540,52748.0,4301.0,4301.0,638,77,561,80359,3672,76687,48064.0,2164.0,2164.0,0.0005,0.0006,0.0006,0.0006
2023-12-08 18:30,770,191,579,109123,15131,93992,64275.0,8435.0,8435.0,621,88,533,95987,7594,88393,57336.0,4496.0,4496.0,0.0006,0.0006,0.0006,0.0006
2023-12-08 18:35,4388,210,4178,706830,15635,691195,418881.0,9014.0,9014.0,4263,136,4127,702882,16169,686713,417690.0,9478.0,9478.0,0.0006,0.0006,0.0006,0.0006
