,secid,put_orders_b,put_orders_s,put_val_b,put_val_s,put_vol_b,put_vol_s,put_vwap_b,put_vwap_s,put_vol,put_val,put_orders,cancel_orders_b,cancel_orders_s,cancel_val_b,cancel_val_s,cancel_vol_b,cancel_vol_s,cancel_vwap_b,cancel_vwap_s,cancel_vol,cancel_val,cancel_orders,ts
0,AFLT,1688,1622,370465975.0,195214199.0,949130,481115,39.03,40.58,1430245,565680175.0,3310,1316,847,342382106.0,147306317.0,873736,370805,39.19,39.73,1244541,489688424.0,2163,2023-11-01 10:05:00
1,AFLT,1858,1358,506149442.0,236416877.0,1283715,594129,39.43,39.79,1877844,742566320.0,3216,1615,1137,493799716.0,213934443.0,1253206,537234,39.4,39.82,1790440,707734159.0,2752,2023-11-01 10:10:00
2,AFLT,1020,1193,224482165.0,136526511.0,566520,344179,39.62,39.67,910699,361008677.0,2213,822,1007,195058219.0,126995574.0,494886,319037,39.41,39.81,813923,322053794.0,1829,2023-11-01 10:15:00
3,AFLT,532,1279,60333146.0,71712975.0,153449,180558,39.32,39.72,334007,132046122.0,1811,393,1159,58101250.0,68222327.0,147788,171917,39.31,39.68,319705,126323578.0,1552,2023-11-01 10:20:00
4,AFLT,574,542,85708640.0,92507849.0,216933,233022,39.51,39.7,449955,178216489.0,1116,452,477,82361138.0,83021376.0,208914,209093,39.42,39.71,418007,165382515.0,929,2023-11-01 10:25:00
5,AFLT,520,211,54012865.0,52338665.0,136162,127207,39.67,41.14,263369,106351530.0,731,396,177,50208565.0,47736543.0,127311,120184,39.44,39.72,247495,97945108.0,573,2023-11-01 10:30:00
6,AFLT,396,493,53984381.0,72478411.0,136545,182264,39.54,39.77,318809,126462792.0,889,329,420,52154374.0,56927567.0,132372,143232,39.4,39.75,275604,109081941.0,749,2023-11-01 10:35:00
7,AFLT,515,542,85210368.0,88177330.0,216259,221974,39.4,39.72,438233,173387698.0,1057,427,515,78183678.0,96379114.0,198515,242233,39.38,39.79,440748,174562793.0,942,2023-11-01 10:40:00
8,AFLT,551,406,91948673.0,84758874.0,232838,213555,39.49,39.69,446393,176707547.0,957,415,350,89876677.0,83012340.0,227919,209082,39.43,39.7,437001,172889017.0,765,2023-11-01 10:45:00
9,AFLT,563,313,60929881.0,43220704.0,154452,108812,39.45,39.72,263264,104150586.0,876,505,293,60164859.0,42585161.0,152880,107182,39.35,39.73,260062,102750021.0,798,2023-11-01 10:50:00
10,AFLT,415,355,72163557.0,60398638.0,183366,153784,39.35,39.27,337150,132562195.0,770,337,315,69528447.0,57478351.0,176675,144716,39.35,39.72,321391,127006799.0,652,2023-11-01 10:55:00
11,AFLT,323,205,47138336.0,47255260.0,118999,119263,39.61,39.62,238262,94393596.0,528,269,159,45444793.0,44754367.0,115164,112716,39.46,39.71,227880,90199161.0,428,2023-11-01 11:00:00
12,AFLT,723,675,217991968.0,188992872.0,553625,477311,39.38,39.6,1030936,406984841.0,1398,664,568,216119950.0,182796931.0,548875,460526,39.38,39.69,1009401,398916881.0,1232,2023-11-01 11:05:00
13,AFLT,1111,1013,278557401.0,290974722.0,707455,734656,39.37,39.61,1442111,569532123.0,2124,1013,959,253481263.0,286437540.0,644141,722707,39.35,39.63,1366848,539918803.0,1972,2023-11-01 11:10:00
14,AFLT,760,180,43943930.0,51194575.0,111321,128443,39.47,39.86,239764,95138505.0,940,722,164,47262828.0,54451966.0,119800,136792,39.45,39.81,256592,101714795.0,886,2023-11-01 11:15:00
15,AFLT,1592,938,415715342.0,368255039.0,1054604,929956,39.42,39.6,1984560,783970381.0,2530,1523,886,436558941.0,367727720.0,1107326,928362,39.42,39.61,2035688,804286661.0,2409,2023-11-01 11:20:00
16,AFLT,408,361,116491511.0,94453351.0,295461,238355,39.43,39.63,533816,210944863.0,769,369,351,97509623.0,95040748.0,247575,239730,39.39,39.64,487305,192550371.0,720,2023-11-01 11:25:00
17,AFLT,444,350,74153530.0,101660530.0,188155,255681,39.41,39.76,443836,175814060.0,794,381,314,70538859.0,98338658.0,179233,247420,39.36,39.75,426653,168877517.0,695,2023-11-01 11:30:00
18,AFLT,771,483,86680113.0,89976418.0,219523,226815,39.49,39.67,446338,176656531.0,1254,666,422,105993079.0,86374426.0,268903,217741,39.42,39.67,486644,192367505.0,1088,2023-11-01 11:35:00
19,AFLT,2273,978,285489747.0,131999000.0,722329,332885,39.52,39.65,1055214,417488748.0,3251,2235,935,281986786.0,134416832.0,714205,338955,39.48,39.66,1053160,416403619.0,3170,2023-11-01 11:40:00
20,AFLT,1245,454,232188180.0,100967664.0,587937,254926,39.49,39.61,842863,333155845.0,1699,1176,383,229680443.0,98581159.0,581646,248428,39.49,39.68,830074,328261602.0,1559,2023-11-01 11:45:00
21,AFLT,961,587,154069092.0,141364658.0,390135,357218,39.49,39.57,747353,295433750.0,1548,899,561,153316198.0,136565961.0,388445,344158,39.47,39.68,732603,289882159.0,1460,2023-11-01 11:50:00
22,AFLT,868,992,99319873.0,86041781.0,251504,216665,39.49,39.71,468169,185361655.0,1860,831,967,98327346.0,83368837.0,249072,210123,39.48,39.68,459195,181696184.0,1798,2023-11-01 11:55:00
23,AFLT,1090,516,199178730.0,142581597.0,506641,359990,39.31,39.61,866631,341760328.0,1606,1014,456,193131426.0,141008427.0,489645,355638,39.44,39.65,845283,334139853.0,1470,2023-11-01 12:00:00
24,AFLT,1308,759,201043889.0,133994254.0,509743,338109,39.44,39.63,847852,335038143.0,2067,1255,744,199356553.0,133785399.0,505528,337570,39.44,39.63,843098,333141952.0,1999,2023-11-01 12:05:00
25,AFLT,1186,629,218904668.0,106298669.0,554535,268111,39.48,39.65,822646,325203337.0,1815,1132,615,222132792.0,109987122.0,562877,277400,39.46,39.65,840277,332119915.0,1747,2023-11-01 12:10:00
26,AFLT,2292,804,291428041.0,137008515.0,737672,345949,39.51,39.6,1083621,428436556.0,3096,2231,681,292006732.0,135271030.0,739170,340973,39.5,39.67,1080143,427277763.0,2912,2023-11-01 12:15:00
27,AFLT,887,1519,137375449.0,445589004.0,348688,1125165,39.4,39.6,1473853,582964453.0,2406,814,1396,134576973.0,440879247.0,341442,1112683,39.41,39.62,1454125,575456221.0,2210,2023-11-01 12:20:00
28,AFLT,1282,6101,261962152.0,1746948713.0,665574,4416986,39.36,39.55,5082560,2008910866.0,7383,1224,5879,260425363.0,1744452998.0,661778,4409394,39.35,39.56,5071172,2004878362.0,7103,2023-11-01 12:25:00
29,AFLT,523,525,82407909.0,127209990.0,209419,321351,39.35,39.59,530770,209617899.0,1048,437,427,80976894.0,125141262.0,205906,315921,39.33,39.61,521827,206118156.0,864,2023-11-01 12:30:00
30,AFLT,915,309,121367166.0,75066037.0,308445,189876,39.35,39.53,498321,196433204.0,1224,817,253,119279181.0,73343139.0,303379,185280,39.32,39.59,488659,192622321.0,1070,2023-11-01 12:35:00
31,AFLT,506,365,54087801.0,53435309.0,137296,135161,39.4,39.53,272457,107523111.0,871,437,354,54133257.0,54495552.0,137659,137757,39.32,39.56,275416,108628810.0,791,2023-11-01 12:40:00
32,AFLT,2029,807,422623062.0,155408573.0,1070947,392539,39.46,39.59,1463486,578031636.0,2836,1967,756,418815784.0,154595895.0,1061957,390329,39.44,39.61,1452286,573411679.0,2723,2023-11-01 12:45:00
33,AFLT,1364,445,165176305.0,76492491.0,418294,193018,39.49,39.63,611312,241668796.0,1809,1304,417,165630255.0,75738322.0,419443,190827,39.49,39.69,610270,241368578.0,1721,2023-11-01 12:50:00
34,AFLT,778,251,85711324.0,96089955.0,217273,239820,39.45,40.07,457093,181801279.0,1029,731,232,85484856.0,62636416.0,216700,157991,39.45,39.65,374691,148121272.0,963,2023-11-01 12:55:00
35,AFLT,1547,1067,275897951.0,359658386.0,699754,904659,39.43,39.76,1604413,635556337.0,2614,1493,997,276024946.0,357650293.0,700021,901454,39.43,39.67,1601475,633675240.0,2490,2023-11-01 13:00:00
36,AFLT,1336,1005,126455804.0,294553071.0,321162,745051,39.37,39.53,1066213,421008875.0,2341,1260,952,125556772.0,293562839.0,318905,742449,39.37,39.54,1061354,419119612.0,2212,2023-11-01 13:05:00
37,AFLT,447,1877,72243588.0,618374418.0,183608,1565886,39.35,39.49,1749494,690618006.0,2324,386,1869,71531203.0,617511514.0,181834,1563223,39.34,39.5,1745057,689042718.0,2255,2023-11-01 13:10:00
38,AFLT,451,956,62753273.0,283783650.0,159868,718146,39.25,39.52,878014,346536924.0,1407,380,896,60927022.0,282750651.0,155176,715413,39.26,39.52,870589,343677673.0,1276,2023-11-01 13:15:00
39,AFLT,373,225,45241045.0,45117611.0,115074,114150,39.31,39.52,229224,90358657.0,598,295,166,45069746.0,42247406.0,114663,106691,39.31,39.6,221354,87317153.0,461,2023-11-01 13:20:00
40,AFLT,816,2175,188377197.0,683933471.0,480280,1733179,39.22,39.46,2213459,872310669.0,2991,741,2147,184050084.0,682713366.0,469608,1729877,39.19,39.47,2199485,866763450.0,2888,2023-11-01 13:25:00
41,AFLT,632,379,115720187.0,84970150.0,294082,214628,39.35,39.59,508710,200690337.0,1011,575,342,115198581.0,84354727.0,292868,212996,39.33,39.6,505864,199553308.0,917,2023-11-01 13:30:00
42,AFLT,621,195,56020102.0,27912435.0,142197,70517,39.4,39.58,212714,83932537.0,816,583,196,56009738.0,27898120.0,142189,70245,39.39,39.72,212434,83907858.0,779,2023-11-01 13:35:00
43,AFLT,1043,335,143071244.0,75828446.0,365014,191788,39.2,39.54,556802,218899690.0,1378,984,307,137628386.0,76348922.0,349808,192741,39.34,39.61,542549,213977309.0,1291,2023-11-01 13:40:00
44,AFLT,1354,1222,176182102.0,347314846.0,447554,879087,39.37,39.51,1326641,523496948.0,2576,1300,1187,175574570.0,346061459.0,446317,875891,39.34,39.51,1322208,521636029.0,2487,2023-11-01 13:45:00
45,AFLT,1274,915,232890511.0,265165859.0,590899,668806,39.41,39.65,1259705,498056371.0,2189,1221,875,226332381.0,264412188.0,574994,666972,39.36,39.64,1241966,490744569.0,2096,2023-11-01 13:50:00
46,AFLT,952,261,115215094.0,53474191.0,292093,134761,39.44,39.68,426854,168689285.0,1213,914,235,115881192.0,50803445.0,293804,128041,39.44,39.68,421845,166684638.0,1149,2023-11-01 13:55:00
47,AFLT,1278,275,137062650.0,32150913.0,347225,81100,39.47,39.64,428325,169213564.0,1553,1255,272,138998645.0,33507823.0,352143,84489,39.47,39.66,436632,172506468.0,1527,2023-11-01 14:00:00
48,AFLT,1057,396,114130825.0,31009873.0,289196,78146,39.46,39.68,367342,145140698.0,1453,1012,368,111003657.0,30652151.0,281154,77278,39.48,39.66,358432,141655808.0,1380,2023-11-01 14:05:00
49,AFLT,818,242,152486845.0,33545595.0,386445,84545,39.46,39.68,470990,186032441.0,1060,801,228,150006724.0,31316630.0,380152,78893,39.46,39.7,459045,181323354.0,1029,2023-11-01 14:10:00
50,AFLT,884,207,82139496.0,20330908.0,207979,51154,39.49,39.74,259133,102470405.0,1091,878,210,81774118.0,21154616.0,207068,53244,39.49,39.73,260312,102928735.0,1088,2023-11-01 14:15:00
51,AFLT,1592,1034,380815217.0,189890901.0,967544,479434,39.36,39.61,1446978,570706118.0,2626,1495,1001,379432073.0,184603369.0,964057,465521,39.36,39.66,1429578,564035443.0,2496,2023-11-01 14:20:00
52,AFLT,950,3736,97077167.0,1584726073.0,246402,4007725,39.4,39.54,4254127,1681803240.0,4686,910,3735,96758147.0,1584206724.0,245622,4006376,39.39,39.54,4251998,1680964872.0,4645,2023-11-01 14:25:00
53,AFLT,523,3354,96444279.0,1379028999.0,245146,3487439,39.34,39.54,3732585,1475473279.0,3877,476,3327,94060152.0,1378767902.0,239111,3486678,39.34,39.54,3725789,1472828054.0,3803,2023-11-01 14:30:00
54,AFLT,550,424,52499375.0,148234126.0,133302,374519,39.38,39.58,507821,200733502.0,974,522,395,51947644.0,148920894.0,132204,376172,39.29,39.59,508376,200868538.0,917,2023-11-01 14:35:00
55,AFLT,224,130,28528031.0,31112506.0,72338,78678,39.44,39.54,151016,59640537.0,354,216,133,27108193.0,29747123.0,68784,75106,39.41,39.61,143890,56855316.0,349,2023-11-01 14:40:00
56,AFLT,113,119,25728218.0,31455754.0,65345,79321,39.37,39.66,144666,57183973.0,232,98,103,24380114.0,31638364.0,61968,79784,39.34,39.66,141752,56018478.0,201,2023-11-01 14:45:00
57,AFLT,397,181,41557395.0,51535578.0,105602,129912,39.35,39.67,235514,93092974.0,578,364,154,36672924.0,49924469.0,93094,125834,39.39,39.67,218928,86597393.0,518,2023-11-01 14:50:00
58,AFLT,484,296,31933704.0,48852541.0,80726,123144,39.56,39.67,203870,80786245.0,780,439,272,28971314.0,46518399.0,73554,117208,39.39,39.69,190762,75489713.0,711,2023-11-01 14:55:00
59,AFLT,266,476,59058179.0,94010917.0,150253,237239,39.31,39.63,387492,153069096.0,742,258,470,58752201.0,92893783.0,149497,234268,39.3,39.65,383765,151645984.0,728,2023-11-01 15:00:00
60,AFLT,252,721,44974121.0,257067228.0,113997,650643,39.45,39.51,764640,302041350.0,973,208,665,43824163.0,255994466.0,111397,647346,39.34,39.55,758743,299818629.0,873,2023-11-01 15:05:00
61,AFLT,331,523,49001933.0,125701028.0,124570,317854,39.34,39.55,442424,174702961.0,854,291,487,48526949.0,124990944.0,123327,316042,39.35,39.55,439369,173517893.0,778,2023-11-01 15:10:00
62,AFLT,263,334,60256788.0,52383909.0,153261,132512,39.32,39.53,285773,112640697.0,597,240,311,59359618.0,51958226.0,150980,131249,39.32,39.59,282229,111317844.0,551,2023-11-01 15:15:00
63,AFLT,251,368,40587479.0,92544204.0,103362,233643,39.27,39.61,337005,133131684.0,619,215,353,38047916.0,92571735.0,96898,233696,39.27,39.61,330594,130619652.0,568,2023-11-01 15:20:00
64,AFLT,412,484,48126463.0,80589716.0,122461,203512,39.3,39.6,325973,128716179.0,896,397,469,48899873.0,80460927.0,124438,203183,39.3,39.6,327621,129360800.0,866,2023-11-01 15:25:00
65,AFLT,358,904,49404110.0,173865275.0,124886,439500,39.56,39.56,564386,223269385.0,1262,342,887,47314457.0,174570999.0,120399,441229,39.3,39.56,561628,221885456.0,1229,2023-11-01 15:30:00
66,AFLT,162,230,33763732.0,36287239.0,86431,91581,39.06,39.62,178012,70050971.0,392,127,216,29890650.0,35494001.0,75988,89558,39.34,39.63,165546,65384652.0,343,2023-11-01 15:35:00
67,AFLT,242,303,32501660.0,60513087.0,82373,152780,39.46,39.61,235153,93014748.0,545,200,286,31498922.0,60271132.0,80096,152042,39.33,39.64,232138,91770054.0,486,2023-11-01 15:40:00
68,AFLT,528,751,133635138.0,199162613.0,340823,504451,39.21,39.48,845274,332797752.0,1279,468,672,130498642.0,218685165.0,332763,548524,39.22,39.87,881287,349183807.0,1140,2023-11-01 15:45:00
69,AFLT,1267,910,253424410.0,272041117.0,648740,692178,39.06,39.3,1340918,525465527.0,2177,1054,849,228922644.0,262851578.0,586228,666307,39.05,39.45,1252535,491774222.0,1903,2023-11-01 15:50:00
70,AFLT,795,5981,168468876.0,2974935136.0,431988,7568153,39.0,39.31,8000141,3143404013.0,6776,598,5917,156538172.0,2960227060.0,403429,7530076,38.8,39.31,7933505,3116765232.0,6515,2023-11-01 15:55:00
71,AFLT,751,9709,94217572.0,2567360066.0,241324,6548481,39.04,39.21,6789805,2661577638.0,10460,586,9655,79457092.0,2547233214.0,204038,6497436,38.94,39.2,6701474,2626690307.0,10241,2023-11-01 16:00:00
72,AFLT,513,1687,108317676.0,711075809.0,278513,1813911,38.89,39.2,2092424,819393485.0,2200,417,1638,118393701.0,706891705.0,304350,1802798,38.9,39.21,2107148,825285406.0,2055,2023-11-01 16:05:00
73,AFLT,584,1390,94381836.0,383292574.0,242606,977752,38.9,39.2,1220358,477674410.0,1974,457,1342,85512950.0,381891461.0,219892,974005,38.89,39.21,1193897,467404412.0,1799,2023-11-01 16:10:00
74,AFLT,834,921,192783833.0,273360252.0,492240,694733,39.16,39.35,1186973,466144085.0,1755,709,878,184965605.0,268242026.0,473808,681648,39.04,39.35,1155456,453207632.0,1587,2023-11-01 16:15:00
75,AFLT,1021,1506,311863508.0,572147280.0,798857,1454519,39.04,39.34,2253376,884010788.0,2527,921,1433,285411985.0,549715537.0,731388,1397593,39.02,39.33,2128981,835127523.0,2354,2023-11-01 16:20:00
76,AFLT,662,5905,123861194.0,2767173665.0,315203,7073108,39.3,39.12,7388311,2891034860.0,6567,529,5835,119967358.0,2757356023.0,307783,7047137,38.98,39.13,7354920,2877323381.0,6364,2023-11-01 16:25:00
77,AFLT,986,3775,162203126.0,1757599163.0,418976,4508497,38.71,38.98,4927473,1919802289.0,4761,709,3692,141252269.0,1735218602.0,365072,4441917,38.69,39.06,4806989,1876470871.0,4401,2023-11-01 16:30:00
78,AFLT,842,3743,170741570.0,1681765633.0,437499,4301395,39.03,39.1,4738894,1852507204.0,4585,679,3625,157344586.0,1674315845.0,405334,4282071,38.82,39.1,4687405,1831660432.0,4304,2023-11-01 16:35:00
79,AFLT,758,431,169878935.0,108670513.0,430020,276628,39.5,39.28,706648,278549448.0,1189,714,335,165155096.0,98467658.0,423009,250639,39.04,39.29,673648,263622754.0,1049,2023-11-01 16:40:00
80,AFLT,428,305,83596041.0,99491502.0,214168,253238,39.03,39.29,467406,183087543.0,733,377,275,79081678.0,76218968.0,202532,193466,39.05,39.4,395998,155300647.0,652,2023-11-01 16:45:00
81,AFLT,601,368,163033668.0,100321648.0,417796,256064,39.02,39.18,673860,263355317.0,969,520,342,160118675.0,124286538.0,410461,315414,39.01,39.4,725875,284405213.0,862,2023-11-01 16:50:00
82,AFLT,615,289,114287017.0,53434151.0,292813,136212,39.03,39.23,429025,167721168.0,904,572,300,116643580.0,56949396.0,298894,145119,39.03,39.24,444013,173592976.0,872,2023-11-01 16:55:00
83,AFLT,397,266,56277809.0,51446272.0,143551,131100,39.2,39.24,274651,107724082.0,663,339,238,51927356.0,50184048.0,133058,127897,39.03,39.24,260955,102111404.0,577,2023-11-01 17:00:00
84,AFLT,698,408,125713284.0,85637876.0,322192,218396,39.02,39.21,540588,211351161.0,1106,652,361,123671289.0,88235007.0,316945,224616,39.02,39.28,541561,211906296.0,1013,2023-11-01 17:05:00
85,AFLT,211,312,27799686.0,72082581.0,71273,183728,39.0,39.23,255001,99882267.0,523,174,283,25862814.0,69564081.0,66290,177486,39.01,39.19,243776,95426895.0,457,2023-11-01 17:10:00
86,AFLT,546,426,91849321.0,82107890.0,235369,210656,39.02,38.98,446025,173957211.0,972,503,400,90527240.0,80851650.0,231984,206105,39.02,39.23,438089,171378890.0,903,2023-11-01 17:15:00
87,AFLT,386,594,65719344.0,158607995.0,167992,404892,39.12,39.17,572884,224327339.0,980,353,576,58267577.0,157584948.0,149457,402169,38.99,39.18,551626,215852525.0,929,2023-11-01 17:20:00
88,AFLT,399,300,62020309.0,55237042.0,158856,140920,39.04,39.2,299776,117257351.0,699,342,280,62181487.0,55157676.0,159354,140675,39.02,39.21,300029,117339164.0,622,2023-11-01 17:25:00
89,AFLT,483,765,72250351.0,232828193.0,185250,594408,39.0,39.17,779658,305078545.0,1248,432,712,71745717.0,234248434.0,183933,597801,39.01,39.19,781734,305994151.0,1144,2023-11-01 17:30:00
90,AFLT,416,346,48961009.0,65707263.0,125850,166645,38.9,39.43,292495,114668273.0,762,374,316,47249977.0,44722501.0,121213,114074,38.98,39.2,235287,91972479.0,690,2023-11-01 17:35:00
91,AFLT,979,145,55555167.0,28309583.0,142059,71456,39.11,39.62,213515,83864751.0,1124,933,125,55389487.0,27167285.0,141641,68275,39.11,39.79,209916,82556772.0,1058,2023-11-01 17:40:00
92,AFLT,844,765,63598050.0,108449927.0,162689,276237,39.09,39.26,438926,172047977.0,1609,797,729,63589559.0,111119230.0,162679,282649,39.09,39.31,445328,174708789.0,1526,2023-11-01 17:45:00
93,AFLT,205,222,21646933.0,9332980.0,55980,23756,38.67,39.29,79736,30979913.0,427,164,116,21689730.0,9439815.0,56264,24009,38.55,39.32,80273,31129546.0,280,2023-11-01 17:50:00
94,AFLT,618,785,38048241.0,281226880.0,97261,717140,39.12,39.22,814401,319275121.0,1403,553,681,37787892.0,279038998.0,96843,711621,39.02,39.21,808464,316826891.0,1234,2023-11-01 17:55:00
95,AFLT,642,412,30393924.0,167045134.0,77446,425936,39.25,39.22,503382,197439058.0,1054,587,358,26537418.0,164312497.0,67861,419027,39.11,39.21,486888,190849916.0,945,2023-11-01 18:00:00
96,AFLT,609,106,32189910.0,6626378.0,82345,16931,39.09,39.14,99276,38816288.0,715,586,76,31710761.0,3630160.0,81206,9216,39.05,39.39,90422,35340922.0,662,2023-11-01 18:05:00
97,AFLT,366,101,20995694.0,26825656.0,53610,68239,39.16,39.31,121849,47821350.0,467,332,87,19643038.0,26397742.0,50224,66897,39.11,39.46,117121,46040780.0,419,2023-11-01 18:10:00
98,AFLT,178,275,18984851.0,46923485.0,48614,119745,39.05,39.19,168359,65908336.0,453,167,266,17639378.0,45402949.0,45184,115843,39.04,39.19,161027,63042327.0,433,2023-11-01 18:15:00
99,AFLT,167,226,15580986.0,50179878.0,39994,120831,38.96,41.53,160825,65760865.0,393,125,208,15354886.0,47051934.0,39401,119819,38.97,39.27,159220,62406821.0,333,2023-11-01 18:20:00
100,AFLT,160,89,6535772.0,8751977.0,16693,21811,39.15,40.13,38504,15287749.0,249,138,89,6038699.0,7555294.0,15450,18779,39.09,40.23,34229,13593994.0,227,2023-11-01 18:25:00
101,AFLT,126,246,15184425.0,14548544.0,38884,36917,39.05,39.41,75801,29732970.0,372,103,225,12849681.0,13134702.0,32904,33318,39.05,39.42,66222,25984384.0,328,2023-11-01 18:30:00
102,AFLT,224,92,22715824.0,15450559.0,58108,39569,39.09,39.05,97677,38166384.0,316,185,93,21714461.0,13986891.0,55661,35039,39.01,39.92,90700,35701353.0,278,2023-11-01 18:35:00
103,AFLT,278,128,20648746.0,13214309.0,52787,33583,39.12,39.35,86370,33863056.0,406,244,117,23626571.0,16398885.0,60550,41674,39.02,39.35,102224,40025456.0,361,2023-11-01 18:40:00
104,AFLT,2678,2581,1138022927.0,679972967.0,2920072,1701785,38.97,39.96,4621857,1817995894.0,5259,2317,1674,1115932179.0,628657901.0,2861126,1583097,39.0,39.71,4444223,1744590081.0,3991,2023-11-02 10:05:00
105,AFLT,482,617,91705422.0,106490586.0,234951,268305,39.03,39.69,503256,198196009.0,1099,369,514,88545278.0,102698665.0,226836,258972,39.03,39.66,485808,191243944.0,883,2023-11-02 10:10:00
106,AFLT,616,495,40334743.0,54526420.0,102955,137453,39.18,39.67,240408,94861163.0,1111,508,360,37556005.0,52697186.0,95824,132929,39.19,39.64,228753,90253191.0,868,2023-11-02 10:15:00
107,AFLT,677,927,66616768.0,58077203.0,169587,146974,39.28,39.52,316561,124693971.0,1604,542,877,62511695.0,54934154.0,159579,138895,39.17,39.55,298474,117445850.0,1419,2023-11-02 10:20:00
108,AFLT,756,750,156341034.0,152589337.0,398913,386835,39.19,39.45,785748,308930371.0,1506,680,686,151963753.0,150249406.0,387597,380863,39.21,39.45,768460,302213160.0,1366,2023-11-02 10:25:00
109,AFLT,325,731,57498826.0,107738031.0,146556,272145,39.23,39.59,418701,165236857.0,1056,281,698,56240255.0,104401623.0,143375,263954,39.23,39.55,407329,160641879.0,979,2023-11-02 10:30:00
110,AFLT,1013,826,189104395.0,201899182.0,463750,509685,40.78,39.61,973435,391003578.0,1839,834,678,183734236.0,199419786.0,459464,503243,39.99,39.63,962707,383154022.0,1512,2023-11-02 10:35:00
111,AFLT,2270,1177,876780177.0,270481165.0,2226806,686062,39.37,39.43,2912868,1147261342.0,3447,2175,1068,867234437.0,262609326.0,2205068,663429,39.33,39.58,2868497,1129843763.0,3243,2023-11-02 10:40:00
112,AFLT,2273,570,820980813.0,59699475.0,2087048,150891,39.34,39.56,2237939,880680289.0,2843,2210,512,819345916.0,55477908.0,2082912,140123,39.34,39.59,2223035,874823824.0,2722,2023-11-02 10:45:00
113,AFLT,2222,942,896482884.0,203119786.0,2274927,511205,39.41,39.73,2786132,1099602671.0,3164,2150,800,887651784.0,195635834.0,2253644,492194,39.39,39.75,2745838,1083287619.0,2950,2023-11-02 10:50:00
114,AFLT,1755,454,848210879.0,72811937.0,2150400,183954,39.44,39.58,2334354,921022817.0,2209,1698,323,847834635.0,68117171.0,2149623,171725,39.44,39.67,2321348,915951806.0,2021,2023-11-02 10:55:00
115,AFLT,1072,265,497270402.0,57765995.0,1260547,145642,39.45,39.66,1406189,555036398.0,1337,1007,206,492029953.0,55040825.0,1248740,138717,39.4,39.68,1387457,547070778.0,1213,2023-11-02 11:00:00
116,AFLT,2462,394,1316819183.0,67803060.0,3344339,171182,39.37,39.61,3515521,1384622243.0,2856,2423,362,1317244401.0,66849729.0,3345401,168555,39.37,39.66,3513956,1384094130.0,2785,2023-11-02 11:05:00
117,AFLT,2951,600,1528542125.0,80704273.0,3883513,204557,39.36,39.45,4088070,1609246399.0,3551,2907,558,1527748854.0,78650453.0,3881575,198530,39.36,39.62,4080105,1606399308.0,3465,2023-11-02 11:10:00
118,AFLT,303,383,87511415.0,79868353.0,222297,202191,39.37,39.5,424488,167379769.0,686,244,347,84088223.0,79612417.0,213848,201469,39.32,39.52,415317,163700641.0,591,2023-11-02 11:15:00
119,AFLT,478,505,129853746.0,57183813.0,330067,144804,39.34,39.49,474871,187037560.0,983,430,475,129652452.0,55567806.0,329568,140590,39.34,39.52,470158,185220258.0,905,2023-11-02 11:20:00
120,AFLT,1225,611,537136442.0,127461630.0,1364956,323644,39.35,39.38,1688600,664598072.0,1836,1187,571,537445794.0,127459103.0,1365772,322749,39.35,39.49,1688521,664904897.0,1758,2023-11-02 11:25:00
121,AFLT,328,294,88775450.0,59378809.0,225433,150309,39.38,39.5,375742,148154260.0,622,298,264,85461495.0,60675242.0,217679,153462,39.26,39.54,371141,146136737.0,562,2023-11-02 11:30:00
122,AFLT,2007,492,776972634.0,82510802.0,1974252,208553,39.36,39.56,2182805,859483437.0,2499,1975,459,774981308.0,81128270.0,1969683,204975,39.35,39.58,2174658,856109578.0,2434,2023-11-02 11:35:00
123,AFLT,469,551,70889721.0,54887385.0,181954,138497,38.96,39.63,320451,125777106.0,1020,416,532,65169321.0,52891190.0,166178,133543,39.22,39.61,299721,118060512.0,948,2023-11-02 11:40:00
124,AFLT,783,646,159938941.0,83171847.0,405809,209972,39.41,39.61,615781,243110788.0,1429,748,601,156935674.0,84052798.0,398789,212072,39.35,39.63,610861,240988473.0,1349,2023-11-02 11:45:00
125,AFLT,560,466,189235998.0,67527298.0,481418,170287,39.31,39.65,651705,256763296.0,1026,529,438,188492723.0,66324860.0,479626,167125,39.3,39.69,646751,254817583.0,967,2023-11-02 11:50:00
126,AFLT,298,310,84392461.0,89349143.0,214746,225409,39.3,39.64,440155,173741604.0,608,260,270,82342397.0,84177670.0,209673,212067,39.27,39.69,421740,166520067.0,530,2023-11-02 11:55:00
127,AFLT,409,604,110427295.0,195903064.0,281729,499553,39.2,39.22,781282,306330360.0,1013,368,574,110276902.0,191024902.0,281320,483405,39.2,39.52,764725,301301805.0,942,2023-11-02 12:00:00
128,AFLT,475,1008,119052437.0,422940705.0,303353,1071884,39.25,39.46,1375237,541993143.0,1483,466,992,118384670.0,422230575.0,301617,1070082,39.25,39.46,1371699,540615246.0,1458,2023-11-02 12:05:00
129,AFLT,1190,4381,163616326.0,2218571223.0,418056,5627988,39.14,39.42,6046044,2382187549.0,5571,1144,4353,154913279.0,2217405520.0,394729,5624914,39.25,39.42,6019643,2372318799.0,5497,2023-11-02 12:10:00
130,AFLT,2832,1568,128952207.0,226355108.0,328994,573086,39.2,39.5,902080,355307315.0,4400,2801,1540,127914167.0,224525233.0,326242,568301,39.21,39.51,894543,352439401.0,4341,2023-11-02 12:15:00
131,AFLT,720,1106,123679580.0,462900288.0,316439,1176387,39.08,39.35,1492826,586579869.0,1826,621,1063,121623485.0,457727960.0,311115,1162942,39.09,39.36,1474057,579351446.0,1684,2023-11-02 12:20:00
132,AFLT,859,2809,83053276.0,699202342.0,212219,1777811,39.14,39.33,1990030,782255618.0,3668,722,2789,81073588.0,699377143.0,207277,1778263,39.11,39.33,1985540,780450731.0,3511,2023-11-02 12:25:00
133,AFLT,1843,3401,184037834.0,1437705447.0,469934,3655398,39.16,39.33,4125332,1621743282.0,5244,1792,3380,180657816.0,1437790226.0,461797,3655613,39.12,39.33,4117410,1618448043.0,5172,2023-11-02 12:30:00
134,AFLT,1012,989,283782383.0,237232734.0,722736,600967,39.27,39.48,1323703,521015117.0,2001,982,950,280852414.0,235880170.0,716470,597555,39.2,39.47,1314025,516732584.0,1932,2023-11-02 12:35:00
135,AFLT,1437,821,193014869.0,136240812.0,490968,344601,39.31,39.54,835569,329255682.0,2258,1392,793,190732120.0,135601802.0,485757,343013,39.26,39.53,828770,326333922.0,2185,2023-11-02 12:40:00
136,AFLT,520,360,32888606.0,40439213.0,83894,102120,39.2,39.6,186014,73327820.0,880,498,344,32988918.0,40026593.0,84164,101073,39.2,39.6,185237,73015512.0,842,2023-11-02 12:45:00
137,AFLT,870,613,83252646.0,78921449.0,213481,199574,39.0,39.54,413055,162174095.0,1483,842,597,82845919.0,78714262.0,212501,198986,38.99,39.56,411487,161560182.0,1439,2023-11-02 12:50:00
138,AFLT,231,202,55064502.0,37842868.0,140481,95893,39.2,39.46,236374,92907371.0,433,191,178,52872533.0,37749288.0,134777,95662,39.23,39.46,230439,90621821.0,369,2023-11-02 12:55:00
139,AFLT,607,1178,59503467.0,126030305.0,151959,318846,39.16,39.53,470805,185533773.0,1785,593,1154,58886547.0,124624572.0,150399,315308,39.15,39.52,465707,183511119.0,1747,2023-11-02 13:00:00
140,AFLT,221,199,41114301.0,43809021.0,104785,110513,39.24,39.64,215298,84923323.0,420,174,168,40369400.0,43419882.0,103056,109739,39.17,39.57,212795,83789283.0,342,2023-11-02 13:05:00
141,AFLT,347,328,54599628.0,83248285.0,139283,210595,39.2,39.53,349878,137847914.0,675,320,286,54529196.0,77970559.0,139081,197131,39.21,39.55,336212,132499756.0,606,2023-11-02 13:10:00
142,AFLT,339,431,66278579.0,95753988.0,169015,242277,39.21,39.52,411292,162032568.0,770,310,413,65660894.0,95488954.0,167460,241629,39.21,39.52,409089,161149849.0,723,2023-11-02 13:15:00
143,AFLT,706,355,174227961.0,110279799.0,444459,279315,39.2,39.48,723774,284507760.0,1061,670,320,172773848.0,110078112.0,440760,278783,39.2,39.49,719543,282851960.0,990,2023-11-02 13:20:00
144,AFLT,172,150,33659137.0,28447090.0,85724,71928,39.26,39.55,157652,62106227.0,322,145,135,32919873.0,27446057.0,83962,69392,39.21,39.55,153354,60365931.0,280,2023-11-02 13:25:00
145,AFLT,549,327,49743419.0,32830302.0,126721,83189,39.25,39.46,209910,82573722.0,876,527,308,48272283.0,33109599.0,122997,83889,39.25,39.47,206886,81381882.0,835,2023-11-02 13:30:00
146,AFLT,326,2202,46014514.0,94190410.0,117254,238990,39.24,39.41,356244,140204925.0,2528,292,2187,45638205.0,93865175.0,116312,237910,39.24,39.45,354222,139503380.0,2479,2023-11-02 13:35:00
147,AFLT,587,128,40353213.0,25249746.0,102801,63995,39.25,39.46,166796,65602959.0,715,559,113,39493147.0,25662514.0,100534,65002,39.28,39.48,165536,65155661.0,672,2023-11-02 13:40:00
148,AFLT,804,350,133357976.0,77591208.0,339835,196653,39.24,39.46,536488,210949184.0,1154,760,330,133421981.0,77006319.0,340012,195069,39.24,39.48,535081,210428300.0,1090,2023-11-02 13:45:00
149,AFLT,374,258,69062782.0,48020077.0,175978,121697,39.25,39.46,297675,117082860.0,632,360,256,68704717.0,47240931.0,175111,119655,39.23,39.48,294766,115945649.0,616,2023-11-02 13:50:00
150,AFLT,310,224,64499902.0,62561148.0,164299,158067,39.26,39.58,322366,127061051.0,534,278,193,63625915.0,61397390.0,162321,155099,39.2,39.59,317420,125023305.0,471,2023-11-02 13:55:00
151,AFLT,1632,447,593764698.0,50047516.0,1510739,126757,39.3,39.48,1637496,643812214.0,2079,1609,446,595530006.0,51998548.0,1515275,131756,39.3,39.47,1647031,647528554.0,2055,2023-11-02 14:00:00
152,AFLT,156,143,50999199.0,22129794.0,129743,55935,39.31,39.56,185678,73128993.0,299,150,128,50619244.0,23021597.0,128783,58189,39.31,39.56,186972,73640842.0,278,2023-11-02 14:05:00
153,AFLT,476,238,120712284.0,27974847.0,307021,70965,39.32,39.42,377986,148687131.0,714,422,206,118780648.0,24920477.0,302107,63095,39.32,39.5,365202,143701125.0,628,2023-11-02 14:10:00
154,AFLT,382,86,31303520.0,14775356.0,79381,37453,39.43,39.45,116834,46078876.0,468,337,77,30605821.0,15268707.0,77855,38662,39.31,39.49,116517,45874528.0,414,2023-11-02 14:15:00
155,AFLT,534,280,124665713.0,43565337.0,317331,110863,39.29,39.3,428194,168231050.0,814,477,248,124493729.0,42080875.0,317059,106536,39.27,39.5,423595,166574604.0,725,2023-11-02 14:20:00
156,AFLT,707,701,150936692.0,189717520.0,384632,479999,39.24,39.52,864631,340654213.0,1408,653,678,150384845.0,189012110.0,383315,478089,39.23,39.53,861404,339396956.0,1331,2023-11-02 14:25:00
157,AFLT,200,152,50667906.0,44837355.0,129520,113830,39.12,39.39,243350,95505261.0,352,166,143,50575104.0,43565715.0,129362,110278,39.1,39.51,239640,94140820.0,309,2023-11-02 14:30:00
158,AFLT,815,232,80929823.0,38571904.0,206227,97827,39.24,39.43,304054,119501728.0,1047,767,205,80844974.0,39724997.0,206026,100757,39.24,39.43,306783,120569972.0,972,2023-11-02 14:35:00
159,AFLT,275,250,44863815.0,55932004.0,114304,141709,39.25,39.47,256013,100795820.0,525,240,237,44987002.0,55176587.0,114664,139800,39.23,39.47,254464,100163590.0,477,2023-11-02 14:40:00
160,AFLT,864,479,85791811.0,95263027.0,218517,241966,39.26,39.37,460483,181054838.0,1343,818,467,84737121.0,94860988.0,215833,240524,39.26,39.44,456357,179598109.0,1285,2023-11-02 14:45:00
161,AFLT,381,498,97738950.0,204784295.0,250186,523268,39.07,39.14,773454,302523246.0,879,269,464,94250447.0,197065334.0,241194,499739,39.08,39.43,740933,291315782.0,733,2023-11-02 14:50:00
162,AFLT,235,513,56541487.0,152904318.0,144865,388985,39.03,39.31,533850,209445806.0,748,172,487,47733285.0,151918337.0,122131,386438,39.08,39.31,508569,199651623.0,659,2023-11-02 14:55:00
163,AFLT,534,244,43837828.0,44028230.0,112108,111831,39.1,39.37,223939,87866058.0,778,502,238,44569854.0,45585568.0,114079,115742,39.07,39.39,229821,90155422.0,740,2023-11-02 15:00:00
164,AFLT,717,1496,57791165.0,563785449.0,148021,1434411,39.04,39.3,1582432,621576615.0,2213,680,1469,56417601.0,558194694.0,144445,1419709,39.06,39.32,1564154,614612295.0,2149,2023-11-02 15:05:00
165,AFLT,266,160,17880962.0,26442824.0,45661,67124,39.16,39.39,112785,44323787.0,426,228,147,18079882.0,26182326.0,46183,66466,39.15,39.39,112649,44262208.0,375,2023-11-02 15:10:00
166,AFLT,213,774,42852159.0,305868677.0,109609,778023,39.1,39.31,887632,348720836.0,987,162,750,42469259.0,305232757.0,108813,776179,39.03,39.33,884992,347702017.0,912,2023-11-02 15:15:00
167,AFLT,214,152,34017516.0,39123039.0,86704,99416,39.23,39.35,186120,73140555.0,366,169,140,31149141.0,36152999.0,79821,91845,39.02,39.36,171666,67302140.0,309,2023-11-02 15:20:00
168,AFLT,163,155,17953199.0,34036940.0,45807,84757,39.19,40.16,130564,51990140.0,318,134,148,17577865.0,33778962.0,44918,85791,39.13,39.37,130709,51356828.0,282,2023-11-02 15:25:00
169,AFLT,266,162,10755048.0,17185100.0,27455,43643,39.17,39.38,71098,27940149.0,428,179,153,9827192.0,16575380.0,25095,42090,39.16,39.38,67185,26402573.0,332,2023-11-02 15:30:00
170,AFLT,747,499,76815730.0,88814038.0,196802,225461,39.03,39.39,422263,165629769.0,1246,660,479,77440115.0,88174222.0,198486,223852,39.02,39.39,422338,165614337.0,1139,2023-11-02 15:35:00
171,AFLT,341,339,49818820.0,74416800.0,127375,188945,39.11,39.39,316320,124235620.0,680,309,325,47993325.0,74238612.0,122743,188479,39.1,39.39,311222,122231938.0,634,2023-11-02 15:40:00
172,AFLT,538,1073,41061377.0,443874404.0,104833,1127782,39.17,39.36,1232615,484935782.0,1611,513,1060,41067216.0,442420155.0,104834,1123609,39.17,39.37,1228443,483487371.0,1573,2023-11-02 15:45:00
173,AFLT,461,756,56362563.0,288708937.0,144000,733804,39.14,39.34,877804,345071501.0,1217,440,741,56174130.0,289545014.0,143558,735897,39.13,39.35,879455,345719144.0,1181,2023-11-02 15:50:00
174,AFLT,440,2187,121518700.0,809132284.0,310729,2058090,39.11,39.31,2368819,930650984.0,2627,419,2166,120822681.0,808926199.0,308979,2057480,39.1,39.32,2366459,929748880.0,2585,2023-11-02 15:55:00
175,AFLT,223,232,34238081.0,52757896.0,87452,133789,39.15,39.43,221241,86995977.0,455,199,217,33603320.0,53401013.0,85990,135373,39.08,39.45,221363,87004333.0,416,2023-11-02 16:00:00
176,AFLT,286,557,58506287.0,146605474.0,149700,372251,39.08,39.38,521951,205111761.0,843,254,557,59323219.0,147193883.0,151943,373511,39.04,39.41,525454,206517102.0,811,2023-11-02 16:05:00
177,AFLT,427,542,53083079.0,226789711.0,135748,575898,39.1,39.38,711646,279872790.0,969,385,537,52298193.0,225856391.0,133802,573497,39.09,39.38,707299,278154584.0,922,2023-11-02 16:10:00
178,AFLT,949,1361,55332990.0,652065020.0,141325,1657058,39.15,39.35,1798383,707398010.0,2310,918,1329,54603141.0,651510288.0,139533,1655653,39.13,39.35,1795186,706113430.0,2247,2023-11-02 16:15:00
179,AFLT,698,785,49345480.0,188491916.0,126055,478975,39.15,39.35,605030,237837397.0,1483,666,779,49294757.0,188339099.0,125949,478572,39.14,39.35,604521,237633856.0,1445,2023-11-02 16:20:00
180,AFLT,218,264,20703760.0,88556473.0,52763,225054,39.24,39.35,277817,109260233.0,482,184,241,19686140.0,88327964.0,50227,224462,39.19,39.35,274689,108014105.0,425,2023-11-02 16:25:00
181,AFLT,329,765,21320903.0,330615158.0,54142,840221,39.38,39.35,894363,351936061.0,1094,343,770,21349077.0,330239439.0,54425,839263,39.23,39.35,893688,351588517.0,1113,2023-11-02 16:30:00
182,AFLT,170,269,30890852.0,69955633.0,78830,177470,39.19,39.42,256300,100846485.0,439,138,245,30687185.0,70147684.0,78531,177903,39.08,39.43,256434,100834869.0,383,2023-11-02 16:35:00
183,AFLT,276,587,56568751.0,69609080.0,144508,177657,39.15,39.18,322165,126177832.0,863,229,573,55906136.0,68184752.0,142787,173256,39.15,39.35,316043,124090888.0,802,2023-11-02 16:40:00
184,AFLT,203,562,19205910.0,21618005.0,49080,54967,39.13,39.33,104047,40823915.0,765,172,535,18905367.0,22244290.0,48308,56513,39.14,39.36,104821,41149657.0,707,2023-11-02 16:45:00
185,AFLT,162,134,20354205.0,26633599.0,52132,67614,39.04,39.39,119746,46987804.0,296,127,121,20089611.0,25798856.0,51457,65478,39.04,39.4,116935,45888467.0,248,2023-11-02 16:50:00
186,AFLT,188,368,40854402.0,54318676.0,104456,138098,39.11,39.33,242554,95173078.0,556,179,365,37064723.0,54975944.0,94725,139751,39.13,39.34,234476,92040667.0,544,2023-11-02 16:55:00
187,AFLT,386,408,57565903.0,79936874.0,147105,203310,39.13,39.32,350415,137502777.0,794,349,392,55175965.0,78458580.0,141002,199384,39.13,39.35,340386,133634546.0,741,2023-11-02 17:00:00
188,AFLT,236,295,20133672.0,23591994.0,51505,59954,39.09,39.35,111459,43725667.0,531,195,277,20478943.0,24836137.0,52518,63115,38.99,39.35,115633,45315080.0,472,2023-11-02 17:05:00
189,AFLT,390,738,84322367.0,127101144.0,214703,322814,39.27,39.37,537517,211423511.0,1128,342,716,81319662.0,127665011.0,207609,324237,39.17,39.37,531846,208984673.0,1058,2023-11-02 17:10:00
190,AFLT,1000,1611,286356548.0,384557865.0,731784,976962,39.13,39.36,1708746,670914414.0,2611,930,1536,283503947.0,373495047.0,724453,948779,39.13,39.37,1673232,656998995.0,2466,2023-11-02 17:15:00
191,AFLT,299,810,60850843.0,110843223.0,155974,281436,39.01,39.38,437410,171694067.0,1109,261,783,58286846.0,110341879.0,149474,280158,38.99,39.39,429632,168628726.0,1044,2023-11-02 17:20:00
192,AFLT,341,662,51822670.0,83467393.0,132377,211527,39.15,39.46,343904,135290063.0,1003,341,664,51681824.0,82748354.0,132124,209689,39.12,39.46,341813,134430179.0,1005,2023-11-02 17:25:00
193,AFLT,354,1034,51230475.0,116719068.0,131177,296783,39.05,39.33,427960,167949544.0,1388,334,997,52087462.0,116570677.0,133382,295915,39.05,39.39,429297,168658140.0,1331,2023-11-02 17:30:00
194,AFLT,261,287,24285546.0,84799496.0,62098,215415,39.11,39.37,277513,109085042.0,548,221,261,24917614.0,84196568.0,63723,213828,39.1,39.38,277551,109114182.0,482,2023-11-02 17:35:00
195,AFLT,467,361,64700245.0,120575680.0,164871,306355,39.24,39.36,471226,185275926.0,828,448,336,62968674.0,119395734.0,160934,303298,39.13,39.37,464232,182364408.0,784,2023-11-02 17:40:00
196,AFLT,1042,1496,176281864.0,495355053.0,452079,1262157,38.99,39.25,1714236,671636917.0,2538,953,1437,172712349.0,492282578.0,442847,1252161,39.0,39.31,1695008,664994927.0,2390,2023-11-02 17:45:00
197,AFLT,953,643,130972761.0,156737572.0,335295,399085,39.06,39.27,734380,287710333.0,1596,875,543,127635167.0,152574941.0,327032,388161,39.03,39.31,715193,280210108.0,1418,2023-11-02 17:50:00
198,AFLT,916,743,143552727.0,164215626.0,368301,418334,38.98,39.25,786635,307768354.0,1659,798,663,139870731.0,164170550.0,359232,417824,38.94,39.29,777056,304041281.0,1461,2023-11-02 17:55:00
199,AFLT,253,296,25349825.0,62341542.0,65069,158713,38.96,39.28,223782,87691368.0,549,195,274,27995490.0,62347953.0,71816,158447,38.98,39.35,230263,90343444.0,469,2023-11-02 18:00:00
200,AFLT,339,516,33880472.0,165016009.0,87184,419451,38.86,39.34,506635,198896481.0,855,288,496,32955211.0,162640148.0,84831,413310,38.85,39.35,498141,195595360.0,784,2023-11-02 18:05:00
201,AFLT,534,1671,51798370.0,686896120.0,133381,1751133,38.83,39.23,1884514,738694491.0,2205,458,1650,50917227.0,684547371.0,131152,1744381,38.82,39.24,1875533,735464599.0,2108,2023-11-02 18:10:00
202,AFLT,770,569,50893677.0,139781230.0,130574,356511,38.98,39.21,487085,190674908.0,1339,704,531,49578324.0,139726013.0,127333,356211,38.94,39.23,483544,189304337.0,1235,2023-11-02 18:15:00
203,AFLT,367,389,61607817.0,92796284.0,158719,235981,38.82,39.32,394700,154404102.0,756,304,353,59568614.0,91262618.0,153559,231972,38.79,39.34,385531,150831232.0,657,2023-11-02 18:20:00
204,AFLT,205,708,22941463.0,176828695.0,58520,450672,39.2,39.24,509192,199770159.0,913,171,685,22681325.0,176747389.0,58245,450315,38.94,39.25,508560,199428715.0,856,2023-11-02 18:25:00
205,AFLT,442,2115,27095502.0,723326473.0,69501,1848046,38.99,39.14,1917547,750421975.0,2557,377,2089,30542322.0,725954897.0,78425,1853259,38.94,39.17,1931684,756497220.0,2466,2023-11-02 18:30:00
206,AFLT,342,724,34600927.0,154792859.0,92100,395617,37.57,39.13,487717,189393787.0,1066,256,692,22772390.0,153504930.0,58554,391713,38.89,39.19,450267,176277320.0,948,2023-11-02 18:35:00
207,AFLT,342,1016,19059702.0,307451026.0,50104,785183,38.04,39.16,835287,326510728.0,1358,304,987,23748473.0,310423501.0,61101,792093,38.87,39.19,853194,334171975.0,1291,2023-11-02 18:40:00
208,AFLT,1382,2596,246419319.0,463763279.0,636007,1162719,38.74,39.89,1798726,710182598.0,3978,949,1834,225399887.0,409953571.0,579134,1038857,38.92,39.46,1617991,635353458.0,2783,2023-11-03 10:05:00
209,AFLT,640,1350,91877338.0,181490205.0,235186,459538,39.07,39.49,694724,273367543.0,1990,549,1244,88048042.0,174779775.0,225575,442637,39.03,39.49,668212,262827818.0,1793,2023-11-03 10:10:00
210,AFLT,579,675,98650731.0,100930510.0,254906,255556,38.7,39.49,510462,199581242.0,1254,455,547,90805151.0,99971665.0,233138,252959,38.95,39.52,486097,190776816.0,1002,2023-11-03 10:15:00
211,AFLT,443,369,56943579.0,56616481.0,146512,141073,38.87,40.13,287585,113560060.0,812,313,325,50787817.0,50741073.0,130592,127263,38.89,39.87,257855,101528891.0,638,2023-11-03 10:20:00
212,AFLT,293,284,48171077.0,44955942.0,123263,114666,39.08,39.21,237929,93127019.0,577,220,246,45479322.0,41013896.0,116320,103864,39.1,39.49,220184,86493218.0,466,2023-11-03 10:25:00
213,AFLT,321,203,36439106.0,37134321.0,93312,93900,39.05,39.55,187212,73573427.0,524,205,177,34099895.0,34650880.0,87306,87919,39.06,39.41,175225,68750775.0,382,2023-11-03 10:30:00
214,AFLT,580,687,95148457.0,113053263.0,243397,286515,39.09,39.46,529912,208201721.0,1267,431,625,88698776.0,117726431.0,226983,297513,39.08,39.57,524496,206425207.0,1056,2023-11-03 10:35:00
215,AFLT,255,280,49819062.0,67374111.0,127217,170817,39.16,39.44,298034,117193173.0,535,173,246,48642442.0,65399692.0,124295,165786,39.13,39.45,290081,114042134.0,419,2023-11-03 10:40:00
216,AFLT,580,583,69832356.0,50466837.0,178284,128022,39.17,39.42,306306,120299193.0,1163,533,565,70298363.0,49699532.0,179483,126038,39.17,39.43,305521,119997895.0,1098,2023-11-03 10:45:00
217,AFLT,737,850,224174741.0,127744034.0,572674,324804,39.15,39.33,897478,351918776.0,1587,695,798,221199380.0,125934659.0,565036,320185,39.15,39.33,885221,347134039.0,1493,2023-11-03 10:50:00
218,AFLT,1119,1083,352788995.0,199001207.0,901964,506085,39.11,39.32,1408049,551790203.0,2202,1033,1035,352109080.0,195972533.0,900149,498176,39.12,39.34,1398325,548081613.0,2068,2023-11-03 10:55:00
219,AFLT,363,626,74650817.0,65425417.0,191447,166536,38.99,39.29,357983,140076235.0,989,317,598,72897881.0,64592240.0,186943,164284,38.99,39.32,351227,137490122.0,915,2023-11-03 11:00:00
220,AFLT,691,576,147840339.0,120452337.0,378993,307320,39.01,39.19,686313,268292677.0,1267,592,495,146531537.0,118783465.0,375864,302302,38.99,39.29,678166,265315002.0,1087,2023-11-03 11:05:00
221,AFLT,1034,793,259393421.0,105055191.0,665152,267761,39.0,39.23,932913,364448612.0,1827,963,766,255563556.0,101775922.0,655059,258855,39.01,39.32,913914,357339479.0,1729,2023-11-03 11:10:00
222,AFLT,547,629,88017848.0,64566493.0,232847,164715,37.8,39.2,397562,152584342.0,1176,465,609,76289830.0,63603260.0,195780,162113,38.97,39.23,357893,139893091.0,1074,2023-11-03 11:15:00
223,AFLT,269,297,50257162.0,50449732.0,129189,128782,38.9,39.17,257971,100706895.0,566,209,255,49973866.0,49643553.0,128433,126603,38.91,39.21,255036,99617419.0,464,2023-11-03 11:20:00
224,AFLT,273,308,34508703.0,89132062.0,88594,225988,38.95,39.44,314582,123640765.0,581,230,273,34452522.0,68177307.0,88392,172775,38.98,39.46,261167,102629830.0,503,2023-11-03 11:25:00
225,AFLT,433,411,100560038.0,142234031.0,258493,356433,38.9,39.9,614926,242794069.0,844,362,371,97962996.0,136239290.0,252168,346621,38.85,39.3,598789,234202286.0,733,2023-11-03 11:30:00
226,AFLT,401,664,70883225.0,114664657.0,183258,292673,38.68,39.18,475931,185547882.0,1065,328,598,68592281.0,112038740.0,176392,285474,38.89,39.25,461866,180631021.0,926,2023-11-03 11:35:00
227,AFLT,513,619,85944099.0,146349815.0,221161,373367,38.86,39.2,594528,232293915.0,1132,424,580,85075623.0,145143315.0,218908,369907,38.86,39.24,588815,230218939.0,1004,2023-11-03 11:40:00
228,AFLT,598,362,98222494.0,98948785.0,252459,252629,38.91,39.17,505088,197171279.0,960,543,329,95165853.0,98405716.0,244639,251042,38.9,39.2,495681,193571569.0,872,2023-11-03 11:45:00
229,AFLT,991,652,239701368.0,104373678.0,616579,266659,38.88,39.14,883238,344075046.0,1643,951,531,238703885.0,103050108.0,614209,262870,38.86,39.2,877079,341753993.0,1482,2023-11-03 11:50:00
230,AFLT,485,293,66501855.0,48869632.0,170618,125003,38.98,39.09,295621,115371487.0,778,432,237,64275763.0,48253537.0,164946,123008,38.97,39.23,287954,112529300.0,669,2023-11-03 11:55:00
231,AFLT,396,333,88197546.0,89602083.0,226930,228901,38.87,39.14,455831,177799629.0,729,327,261,86387079.0,85560814.0,222237,218125,38.87,39.23,440362,171947893.0,588,2023-11-03 12:00:00
232,AFLT,588,602,131821028.0,175632685.0,339004,448708,38.88,39.14,787712,307453713.0,1190,517,525,128094335.0,171043966.0,329317,436821,38.9,39.16,766138,299138301.0,1042,2023-11-03 12:05:00
233,AFLT,501,656,139468269.0,134447382.0,359601,343470,38.78,39.14,703071,273915652.0,1157,437,645,122930918.0,132648489.0,316157,338876,38.88,39.14,655033,255579408.0,1082,2023-11-03 12:10:00
234,AFLT,381,778,110137997.0,144182446.0,277648,367998,39.67,39.18,645646,254320443.0,1159,342,719,107454253.0,141812610.0,272769,361907,39.39,39.18,634676,249266864.0,1061,2023-11-03 12:15:00
235,AFLT,389,393,76503629.0,83325078.0,196688,212555,38.9,39.2,409243,159828708.0,782,340,348,76032948.0,79038249.0,195516,201572,38.89,39.21,397088,155071197.0,688,2023-11-03 12:20:00
236,AFLT,289,436,51408571.0,94135526.0,132123,240519,38.91,39.14,372642,145544097.0,725,231,400,50587998.0,93413065.0,130057,238454,38.9,39.17,368511,144001064.0,631,2023-11-03 12:25:00
237,AFLT,394,392,75664396.0,66834363.0,194328,170336,38.94,39.24,364664,142498759.0,786,360,389,74442745.0,67672366.0,191222,172832,38.93,39.15,364054,142115112.0,749,2023-11-03 12:30:00
238,AFLT,490,766,164457974.0,111044789.0,424015,286032,38.79,38.82,710047,275502764.0,1256,404,725,162234110.0,106979836.0,418507,273175,38.76,39.16,691682,269213946.0,1129,2023-11-03 12:35:00
239,AFLT,468,544,88813519.0,114661811.0,227979,293319,38.96,39.09,521298,203475330.0,1012,404,540,88002899.0,114952626.0,226107,293513,38.92,39.16,519620,202955526.0,944,2023-11-03 12:40:00
240,AFLT,534,426,113588393.0,134601147.0,291910,344431,38.91,39.08,636341,248189541.0,960,453,396,112670652.0,133743869.0,289580,341713,38.91,39.14,631293,246414522.0,849,2023-11-03 12:45:00
241,AFLT,406,225,72929908.0,60771933.0,189233,155259,38.54,39.14,344492,133701841.0,631,339,212,63041088.0,60614494.0,162167,154880,38.87,39.14,317047,123655582.0,551,2023-11-03 12:50:00
242,AFLT,345,209,45449697.0,57056978.0,116774,145798,38.92,39.13,262572,102506676.0,554,302,184,45990342.0,55807722.0,118157,142587,38.92,39.14,260744,101798065.0,486,2023-11-03 12:55:00
243,AFLT,275,169,23971486.0,41907543.0,61589,106835,38.92,39.23,168424,65879029.0,444,266,176,23281644.0,41384117.0,59817,105441,38.92,39.25,165258,64665761.0,442,2023-11-03 13:00:00
244,AFLT,242,533,41691880.0,64275799.0,107230,164276,38.88,39.13,271506,105967680.0,775,195,507,41940087.0,62887061.0,107921,160840,38.86,39.1,268761,104827148.0,702,2023-11-03 13:05:00
245,AFLT,171,790,48872755.0,102457067.0,125555,262226,38.93,39.07,387781,151329822.0,961,154,764,47709016.0,127879006.0,122581,319025,38.92,40.08,441606,175588023.0,918,2023-11-03 13:10:00
246,AFLT,299,146,38939383.0,26679478.0,99981,68219,38.95,39.11,168200,65618861.0,445,248,98,39589507.0,22853261.0,101698,58423,38.93,39.12,160121,62442768.0,346,2023-11-03 13:15:00
247,AFLT,238,177,42758760.0,56396486.0,109871,143446,38.92,39.32,253317,99155246.0,415,203,187,42559719.0,55162528.0,109495,140923,38.87,39.14,250418,97722247.0,390,2023-11-03 13:20:00
248,AFLT,889,953,243754413.0,308595848.0,627922,791557,38.82,38.99,1419479,552350261.0,1842,678,847,238653884.0,300380969.0,614754,769822,38.82,39.02,1384576,539034853.0,1525,2023-11-03 13:25:00
249,AFLT,499,439,105377857.0,98879839.0,271986,253735,38.74,38.97,525721,204257696.0,938,339,395,103773807.0,98629264.0,267875,253061,38.74,38.97,520936,202403071.0,734,2023-11-03 13:30:00
250,AFLT,532,860,122157543.0,184480806.0,315687,474236,38.7,38.9,789923,306638349.0,1392,349,827,119639888.0,182892052.0,309375,469034,38.67,38.99,778409,302531940.0,1176,2023-11-03 13:35:00
251,AFLT,655,693,149973174.0,286030259.0,387653,732010,38.69,39.07,1119663,436003433.0,1348,517,648,147109364.0,257263776.0,380503,658116,38.66,39.09,1038619,404373141.0,1165,2023-11-03 13:40:00
252,AFLT,563,822,142048874.0,208393770.0,367442,533881,38.66,39.03,901323,350442645.0,1385,449,775,137277707.0,207019641.0,355035,530013,38.67,39.06,885048,344297348.0,1224,2023-11-03 13:45:00
253,AFLT,874,836,276764856.0,297845091.0,715769,763561,38.67,39.01,1479330,574609948.0,1710,796,810,274740605.0,296266955.0,710743,758826,38.66,39.04,1469569,571007560.0,1606,2023-11-03 13:50:00
254,AFLT,503,587,97969893.0,213495363.0,252716,547540,38.77,38.99,800256,311465257.0,1090,448,555,96300686.0,214056621.0,248488,548983,38.75,38.99,797471,310357308.0,1003,2023-11-03 13:55:00
255,AFLT,359,332,60692699.0,82736654.0,156318,212230,38.83,38.98,368548,143429353.0,691,317,312,59724169.0,84194852.0,153898,215769,38.81,39.02,369667,143919021.0,629,2023-11-03 14:00:00
256,AFLT,400,258,56767288.0,51288279.0,146368,131348,38.78,39.05,277716,108055568.0,658,359,220,55071615.0,50601904.0,142062,129577,38.77,39.05,271639,105673519.0,579,2023-11-03 14:05:00
257,AFLT,451,327,58801332.0,57262498.0,151416,146613,38.83,39.06,298029,116063830.0,778,386,288,56081766.0,54402487.0,144411,139322,38.83,39.05,283733,110484254.0,674,2023-11-03 14:10:00
258,AFLT,904,1798,331837698.0,752287876.0,859664,1946241,38.6,38.65,2805905,1084125574.0,2702,653,1717,324844536.0,728089644.0,841497,1871580,38.6,38.9,2713077,1052934180.0,2370,2023-11-03 14:15:00
259,AFLT,1556,5945,230511916.0,3135907496.0,597311,8083537,38.59,38.79,8680848,3366419412.0,7501,1244,5858,220898048.0,3128781484.0,572862,8065080,38.56,38.79,8637942,3349679532.0,7102,2023-11-03 14:20:00
260,AFLT,705,2440,91590458.0,1409596753.0,237333,3632444,38.59,38.81,3869777,1501187211.0,3145,601,2371,92894946.0,1407309320.0,240922,3626572,38.56,38.81,3867494,1500204266.0,2972,2023-11-03 14:25:00
261,AFLT,1193,5861,365464932.0,3214537166.0,942258,8278487,38.79,38.83,9220745,3580002099.0,7054,1108,5810,358652793.0,3214767249.0,927388,8279077,38.67,38.83,9206465,3573420043.0,6918,2023-11-03 14:30:00
262,AFLT,2364,665,825533434.0,175872978.0,2129475,451614,38.77,38.94,2581089,1001406413.0,3029,2268,621,825020596.0,174719114.0,2128267,448551,38.76,38.95,2576818,999739710.0,2889,2023-11-03 14:35:00
263,AFLT,1264,510,414970068.0,201692308.0,1070316,499585,38.77,40.37,1569901,616662377.0,1774,1233,465,412587650.0,193691391.0,1064267,496238,38.77,39.03,1560505,606279041.0,1698,2023-11-03 14:40:00
264,AFLT,737,266,198250575.0,83276736.0,511433,213260,38.76,39.05,724693,281527312.0,1003,679,233,196041543.0,81987127.0,505791,210037,38.76,39.03,715828,278028670.0,912,2023-11-03 14:45:00
265,AFLT,466,265,135141795.0,53605346.0,348364,137430,38.79,39.01,485794,188747141.0,731,411,258,135768471.0,52988682.0,350222,135835,38.77,39.01,486057,188757153.0,669,2023-11-03 14:50:00
266,AFLT,468,309,100925278.0,96836844.0,260868,248765,38.69,38.93,509633,197762122.0,777,419,279,97648324.0,94146167.0,252362,241681,38.69,38.95,494043,191794491.0,698,2023-11-03 14:55:00
267,AFLT,559,391,164306838.0,112263810.0,413707,287944,39.72,38.99,701651,276570649.0,950,460,321,137296860.0,112051136.0,354239,287325,38.76,39.0,641564,249347996.0,781,2023-11-03 15:00:00
268,AFLT,1387,515,207070903.0,133328857.0,528175,341315,39.2,39.06,869490,340399761.0,1902,757,401,196449758.0,128691907.0,505383,329281,38.87,39.08,834664,325141666.0,1158,2023-11-03 15:05:00
269,AFLT,700,563,179070425.0,178594852.0,458783,458869,39.03,38.92,917652,357665277.0,1263,599,483,164571103.0,166627735.0,422913,426053,38.91,39.11,848966,331198839.0,1082,2023-11-03 15:10:00
270,AFLT,490,183,72004097.0,50007716.0,184978,127901,38.93,39.1,312879,122011813.0,673,515,184,72034192.0,49904314.0,185074,127551,38.92,39.12,312625,121938506.0,699,2023-11-03 15:15:00
271,AFLT,353,276,96087674.0,77262651.0,247109,197820,38.88,39.06,444929,173350325.0,629,299,242,94134856.0,114363816.0,242225,274526,38.86,41.66,516751,208498672.0,541,2023-11-03 15:20:00
272,AFLT,440,392,75274900.0,64441620.0,193319,164188,38.94,39.25,357507,139716520.0,832,382,381,74307347.0,62023534.0,191003,158694,38.9,39.08,349697,136330882.0,763,2023-11-03 15:25:00
273,AFLT,1814,739,434347498.0,250348806.0,1113535,639064,39.01,39.17,1752599,684696305.0,2553,1556,650,428096748.0,246819106.0,1097781,630093,39.0,39.17,1727874,674915855.0,2206,2023-11-03 15:30:00
274,AFLT,678,668,183842558.0,168332012.0,471561,430188,38.99,39.13,901749,352174570.0,1346,595,619,177540882.0,164764234.0,455603,420561,38.97,39.18,876164,342305117.0,1214,2023-11-03 15:35:00
275,AFLT,607,728,200294392.0,166779852.0,509029,425818,39.35,39.17,934847,367074244.0,1335,539,637,190897837.0,163279502.0,488815,415878,39.05,39.26,904693,354177340.0,1176,2023-11-03 15:40:00
276,AFLT,610,769,160767474.0,196075948.0,411913,501388,39.03,39.11,913301,356843423.0,1379,556,740,160222681.0,191949480.0,410516,489499,39.03,39.21,900015,352172161.0,1296,2023-11-03 15:45:00
277,AFLT,409,518,107283120.0,127449504.0,275291,326427,38.97,39.04,601718,234732624.0,927,360,497,113158137.0,124408762.0,290427,317588,38.96,39.17,608015,237566899.0,857,2023-11-03 15:50:00
278,AFLT,463,961,123839710.0,208352820.0,318211,533072,38.92,39.09,851283,332192530.0,1424,440,942,118853116.0,207196700.0,305332,530110,38.93,39.09,835442,326049816.0,1382,2023-11-03 15:55:00
279,AFLT,911,482,225165678.0,86501468.0,576607,220968,39.05,39.15,797575,311667147.0,1393,879,470,223715247.0,85879012.0,573384,219406,39.02,39.14,792790,309594260.0,1349,2023-11-03 16:00:00
280,AFLT,596,723,120882074.0,175203597.0,310155,447725,38.97,39.13,757880,296085672.0,1319,549,699,119840665.0,171960989.0,307488,439016,38.97,39.17,746504,291801655.0,1248,2023-11-03 16:05:00
281,AFLT,458,465,96691011.0,102903745.0,248105,262882,38.97,39.14,510987,199594757.0,923,427,453,95154076.0,102974020.0,244206,262984,38.96,39.16,507190,198128097.0,880,2023-11-03 16:10:00
282,AFLT,208,180,28478575.0,26496941.0,73154,67627,38.93,39.18,140781,54975517.0,388,188,161,29863976.0,25940360.0,76656,66196,38.96,39.19,142852,55804337.0,349,2023-11-03 16:15:00
283,AFLT,128,130,30026442.0,27872988.0,77104,71226,38.94,39.13,148330,57899430.0,258,115,117,29974849.0,28625930.0,76980,73091,38.94,39.16,150071,58600780.0,232,2023-11-03 16:20:00
284,AFLT,381,479,95979334.0,108439408.0,246456,277034,38.94,39.14,523490,204418743.0,860,345,456,95867720.0,106403713.0,246139,271703,38.95,39.16,517842,202271434.0,801,2023-11-03 16:25:00
285,AFLT,500,892,112928135.0,217681236.0,288908,556538,39.09,39.11,845446,330609371.0,1392,450,869,109794011.0,216882245.0,282103,554507,38.92,39.11,836610,326676257.0,1319,2023-11-03 16:30:00
286,AFLT,303,373,94825548.0,84867139.0,243599,216873,38.93,39.13,460472,179692687.0,676,294,354,94336314.0,84011021.0,242345,214677,38.93,39.13,457022,178347336.0,648,2023-11-03 16:35:00
287,AFLT,279,319,66422762.0,56244355.0,170641,143417,38.93,39.22,314058,122667118.0,598,239,305,63194154.0,55692406.0,162284,142111,38.94,39.19,304395,118886561.0,544,2023-11-03 16:40:00
288,AFLT,1024,1159,249310865.0,416006607.0,640996,1067103,38.89,38.98,1708099,665317473.0,2183,950,1134,245573907.0,414145379.0,631420,1059109,38.89,39.1,1690529,659719287.0,2084,2023-11-03 16:45:00
289,AFLT,1248,2425,407422425.0,978189783.0,1052343,2519188,38.72,38.83,3571531,1385612209.0,3673,1112,2297,400596570.0,957386347.0,1034770,2454081,38.71,39.01,3488851,1357982917.0,3409,2023-11-03 16:50:00
290,AFLT,2148,9351,120382286.0,3456634634.0,310836,8875309,38.73,38.95,9186145,3577016920.0,11499,2066,9416,120347387.0,3442738635.0,310738,8838970,38.73,38.95,9149708,3563086022.0,11482,2023-11-03 16:55:00
291,AFLT,832,7987,142151209.0,4679113389.0,366479,12008112,38.79,38.97,12374591,4821264599.0,8819,747,7959,137103182.0,4678765791.0,353472,12007242,38.79,38.97,12360714,4815868973.0,8706,2023-11-03 17:00:00
292,AFLT,818,4075,104567423.0,1992356612.0,269311,5110908,38.83,38.98,5380219,2096924035.0,4893,758,4050,102545572.0,1989694018.0,264156,5102795,38.82,38.99,5366951,2092239591.0,4808,2023-11-03 17:05:00
293,AFLT,905,1400,115154061.0,657546555.0,296574,1678741,38.83,39.17,1975315,772700617.0,2305,845,1390,117260170.0,655876132.0,302148,1681462,38.81,39.01,1983610,773136302.0,2235,2023-11-03 17:10:00
294,AFLT,213,850,26570495.0,368327996.0,68474,945277,38.8,38.97,1013751,394898491.0,1063,167,826,26147805.0,366405127.0,67412,940096,38.79,38.98,1007508,392552932.0,993,2023-11-03 17:15:00
295,AFLT,595,2253,120702783.0,1155319460.0,310984,2966812,38.81,38.94,3277796,1276022243.0,2848,488,2243,114341906.0,1152083988.0,294863,2956498,38.78,38.97,3251361,1266425895.0,2731,2023-11-03 17:20:00
296,AFLT,396,2032,28479790.0,1075303483.0,73361,2760200,38.82,38.96,2833561,1103783273.0,2428,320,2005,27596034.0,1076355542.0,71156,2762903,38.78,38.96,2834059,1103951576.0,2325,2023-11-03 17:25:00
297,AFLT,295,1054,25095774.0,587955640.0,64582,1508744,38.86,38.97,1573326,613051415.0,1349,214,1041,24762562.0,588367830.0,63772,1509708,38.83,38.97,1573480,613130393.0,1255,2023-11-03 17:30:00
298,AFLT,635,524,55254802.0,104224622.0,136548,267425,40.47,38.97,403973,159479424.0,1159,595,503,53126730.0,103145618.0,136688,264543,38.87,38.99,401231,156272348.0,1098,2023-11-03 17:35:00
299,AFLT,1104,796,85889250.0,270900407.0,220683,693957,38.92,39.04,914640,356789657.0,1900,1064,764,86424374.0,269032896.0,222078,688828,38.92,39.06,910906,355457271.0,1828,2023-11-03 17:40:00
300,AFLT,892,353,65867342.0,81671082.0,169154,209676,38.94,38.95,378830,147538425.0,1245,873,341,66045529.0,81026400.0,169621,207567,38.94,39.04,377188,147071930.0,1214,2023-11-03 17:45:00
301,AFLT,654,270,66969847.0,40380219.0,172235,103416,38.88,39.05,275651,107350067.0,924,628,245,66460686.0,39764974.0,171113,101801,38.84,39.06,272914,106225660.0,873,2023-11-03 17:50:00
302,AFLT,632,179,45499750.0,28766765.0,116784,73609,38.96,39.08,190393,74266516.0,811,567,168,45034737.0,28075331.0,115803,71864,38.89,39.07,187667,73110068.0,735,2023-11-03 17:55:00
303,AFLT,581,254,85547638.0,64262190.0,219863,164525,38.91,39.06,384388,149809828.0,835,547,236,84122445.0,64542123.0,216448,165138,38.86,39.08,381586,148664568.0,783,2023-11-03 18:00:00
304,AFLT,1410,653,145876921.0,189926435.0,373120,486083,39.1,39.07,859203,335803357.0,2063,1354,622,141838755.0,187535970.0,364580,479694,38.9,39.09,844274,329374725.0,1976,2023-11-03 18:05:00
305,AFLT,869,206,79793367.0,51189092.0,204952,130840,38.93,39.12,335792,130982460.0,1075,841,189,79104998.0,52117536.0,203216,133210,38.93,39.12,336426,131222534.0,1030,2023-11-03 18:10:00
306,AFLT,1371,1272,62664856.0,187325946.0,160953,479696,38.93,39.05,640649,249990802.0,2643,1347,1263,63002043.0,186847743.0,161826,478485,38.93,39.05,640311,249849787.0,2610,2023-11-03 18:15:00
307,AFLT,803,268,38941825.0,20190821.0,100017,51616,38.94,39.12,151633,59132646.0,1071,752,259,38821534.0,19867856.0,99753,50787,38.92,39.12,150540,58689390.0,1011,2023-11-03 18:20:00
308,AFLT,612,165,32156387.0,40661090.0,82261,103570,39.09,39.26,185831,72817478.0,777,583,142,30153028.0,37061117.0,77421,94523,38.95,39.21,171944,67214146.0,725,2023-11-03 18:25:00
309,AFLT,216,81,13453864.0,7247019.0,34466,18536,39.04,39.1,53002,20700883.0,297,222,66,15241431.0,11333541.0,39136,28809,38.94,39.34,67945,26574973.0,288,2023-11-03 18:30:00
310,AFLT,774,123,71237190.0,31597348.0,182920,80701,38.94,39.15,263621,102834538.0,897,740,111,70422652.0,31215505.0,180865,79668,38.94,39.18,260533,101638157.0,851,2023-11-03 18:35:00
311,AFLT,1231,538,76064659.0,92984563.0,195139,237435,38.98,39.16,432574,169049223.0,1769,1217,543,78363197.0,95119834.0,201130,242868,38.96,39.17,443998,173483032.0,1760,2023-11-03 18:40:00
312,AFLT,1642,4261,482934139.0,1685276214.0,1247684,4283041,38.71,39.35,5530725,2168210354.0,5903,1272,3514,461422599.0,1632814027.0,1188964,4161315,38.81,39.24,5350279,2094236627.0,4786,2023-11-06 10:05:00
313,AFLT,660,926,100515314.0,195605984.0,258700,498758,38.85,39.22,757458,296121299.0,1586,539,819,98292078.0,193304132.0,253091,492628,38.84,39.24,745719,291596211.0,1358,2023-11-06 10:10:00
314,AFLT,681,771,142159645.0,139988376.0,363196,355887,39.14,39.34,719083,282148021.0,1452,606,608,134184788.0,131607611.0,345065,334378,38.89,39.36,679443,265792399.0,1214,2023-11-06 10:15:00
315,AFLT,2024,1491,647644088.0,341486767.0,1653025,865865,39.18,39.44,2518890,989130856.0,3515,1861,1240,631388666.0,332785406.0,1617342,843641,39.04,39.45,2460983,964174072.0,3101,2023-11-06 10:20:00
316,AFLT,356,249,85500397.0,54066167.0,220364,137660,38.8,39.28,358024,139566565.0,605,232,201,74591075.0,51271786.0,190905,130286,39.07,39.35,321191,125862862.0,433,2023-11-06 10:25:00
317,AFLT,483,339,123186956.0,92853474.0,313966,235179,39.24,39.48,549145,216040431.0,822,442,247,121271574.0,87747788.0,309852,222490,39.14,39.44,532342,209019363.0,689,2023-11-06 10:30:00
318,AFLT,3333,606,1263275198.0,114513740.0,3227031,291422,39.15,39.29,3518453,1377788938.0,3939,3262,554,1258457196.0,112874355.0,3214755,286766,39.15,39.36,3501521,1371331551.0,3816,2023-11-06 10:35:00
319,AFLT,2032,644,696253889.0,96898964.0,1778397,246193,39.15,39.36,2024590,793152853.0,2676,1957,589,696580704.0,96599425.0,1779246,245535,39.15,39.34,2024781,793180130.0,2546,2023-11-06 10:40:00
320,AFLT,4530,896,1993278183.0,204170728.0,5084211,518014,39.21,39.41,5602225,2197448912.0,5426,4312,774,1983236915.0,200842929.0,5060577,509583,39.19,39.41,5570160,2184079844.0,5086,2023-11-06 10:45:00
321,AFLT,1800,2065,520074543.0,1002480934.0,1328875,2563962,39.14,39.1,3892837,1522555478.0,3865,1604,1981,510065798.0,983256912.0,1303593,2502733,39.13,39.29,3806326,1493322711.0,3585,2023-11-06 10:50:00
322,AFLT,790,1041,113753925.0,427192731.0,291433,1088508,39.03,39.25,1379941,540946656.0,1831,705,970,112502040.0,424900545.0,288345,1082657,39.02,39.25,1371002,537402586.0,1675,2023-11-06 10:55:00
323,AFLT,1016,498,78721345.0,134030839.0,201291,342159,39.11,39.17,543450,212752184.0,1514,944,471,76873915.0,130947341.0,196929,333884,39.04,39.22,530813,207821256.0,1415,2023-11-06 11:00:00
324,AFLT,367,222,41029300.0,50344604.0,105029,128204,39.06,39.27,233233,91373904.0,589,291,192,39638451.0,41057250.0,101506,104772,39.05,39.19,206278,80695701.0,483,2023-11-06 11:05:00
325,AFLT,964,421,57530851.0,123531466.0,147056,315203,39.12,39.19,462259,181062318.0,1385,908,390,55797150.0,122037243.0,142883,311384,39.05,39.19,454267,177834393.0,1298,2023-11-06 11:10:00
326,AFLT,495,4841,36219424.0,2419702569.0,92805,6175449,39.03,39.18,6268254,2455921993.0,5336,389,4839,33579902.0,2420011628.0,86025,6176155,39.04,39.18,6262180,2453591531.0,5228,2023-11-06 11:15:00
327,AFLT,273,2668,28788546.0,1607552791.0,73818,4101361,39.0,39.2,4175179,1636341338.0,2941,244,2647,27305087.0,1607081698.0,69999,4100166,39.01,39.2,4170165,1634386785.0,2891,2023-11-06 11:20:00
328,AFLT,1274,744,258159081.0,175895728.0,652621,447774,39.56,39.28,1100395,434054809.0,2018,1157,626,238774317.0,171960450.0,610111,437295,39.14,39.32,1047406,410734767.0,1783,2023-11-06 11:25:00
329,AFLT,856,428,150575885.0,90256888.0,384400,229115,39.17,39.39,613515,240832773.0,1284,793,399,147939197.0,90766096.0,377674,230446,39.17,39.39,608120,238705294.0,1192,2023-11-06 11:30:00
330,AFLT,1256,833,331972855.0,204689229.0,844731,518390,39.3,39.49,1363121,536662084.0,2089,1128,669,319866796.0,195615318.0,814400,495303,39.28,39.49,1309703,515482115.0,1797,2023-11-06 11:35:00
331,AFLT,375,632,72445712.0,68561498.0,184426,173735,39.28,39.46,358161,141007210.0,1007,333,600,68556110.0,65472840.0,174512,165910,39.28,39.46,340422,134028951.0,933,2023-11-06 11:40:00
332,AFLT,278,806,47251803.0,58957931.0,120158,149925,39.32,39.32,270083,106209735.0,1084,223,762,45890990.0,56085563.0,116880,142289,39.26,39.42,259169,101976554.0,985,2023-11-06 11:45:00
333,AFLT,342,713,66498942.0,78738425.0,169242,199578,39.29,39.45,368820,145237367.0,1055,284,654,67061798.0,75882813.0,170827,192331,39.26,39.45,363158,142944612.0,938,2023-11-06 11:50:00
334,AFLT,268,254,71326232.0,56874429.0,181935,144774,39.2,39.28,326709,128200662.0,522,221,222,70887353.0,53642382.0,180791,136064,39.21,39.42,316855,124529735.0,443,2023-11-06 11:55:00
335,AFLT,500,871,126640681.0,109688725.0,323125,279119,39.19,39.3,602244,236329406.0,1371,427,828,124325849.0,109723176.0,317252,278685,39.19,39.37,595937,234049025.0,1255,2023-11-06 12:00:00
336,AFLT,454,1013,85994499.0,77112697.0,219393,195706,39.2,39.4,415099,163107196.0,1467,367,992,85061658.0,77021324.0,217039,195416,39.19,39.41,412455,162082982.0,1359,2023-11-06 12:05:00
337,AFLT,377,154,38919527.0,14963117.0,99201,37978,39.23,39.4,137179,53882644.0,531,359,136,38927182.0,14676039.0,99235,37248,39.23,39.4,136483,53603221.0,495,2023-11-06 12:10:00
338,AFLT,379,207,65525474.0,36388380.0,166351,92244,39.39,39.45,258595,101913855.0,586,341,178,62478847.0,34379968.0,159269,87192,39.23,39.43,246461,96858815.0,519,2023-11-06 12:15:00
339,AFLT,155,173,35463154.0,37498600.0,90370,94879,39.24,39.52,185249,72961754.0,328,147,151,34884756.0,35882505.0,88921,90820,39.23,39.51,179741,70767262.0,298,2023-11-06 12:20:00
340,AFLT,292,181,74779603.0,42094578.0,190672,107083,39.22,39.31,297755,116874181.0,473,217,146,74831600.0,42564522.0,190792,107914,39.22,39.44,298706,117396122.0,363,2023-11-06 12:25:00
341,AFLT,132,125,17809330.0,15657131.0,45463,39738,39.17,39.4,85201,33466461.0,257,124,120,17504459.0,15697134.0,44619,39827,39.23,39.41,84446,33201594.0,244,2023-11-06 12:30:00
342,AFLT,181,192,31606271.0,38373888.0,80540,97264,39.24,39.45,177804,69980160.0,373,151,169,30286424.0,37019034.0,77194,93699,39.23,39.51,170893,67305459.0,320,2023-11-06 12:35:00
343,AFLT,416,133,38112080.0,26882687.0,97101,68177,39.25,39.43,165278,64994767.0,549,393,118,38425052.0,26573076.0,97921,67398,39.24,39.43,165319,64998128.0,511,2023-11-06 12:40:00
344,AFLT,179,176,34229398.0,28280074.0,87290,71726,39.21,39.43,159016,62509472.0,355,170,164,32940595.0,27829397.0,83981,70594,39.22,39.42,154575,60769993.0,334,2023-11-06 12:45:00
345,AFLT,231,162,41366595.0,29703370.0,105449,75242,39.23,39.48,180691,71069965.0,393,188,139,41403560.0,29946556.0,105550,75841,39.23,39.49,181391,71350116.0,327,2023-11-06 12:50:00
346,AFLT,333,245,80555823.0,44386360.0,205829,112957,39.14,39.29,318786,124942183.0,578,308,219,80557055.0,43666047.0,205731,110833,39.16,39.4,316564,124223103.0,527,2023-11-06 12:55:00
347,AFLT,206,107,25308366.0,16976104.0,64541,43262,39.21,39.24,107803,42284471.0,313,170,81,25278198.0,16425701.0,64491,41715,39.2,39.38,106206,41703900.0,251,2023-11-06 13:00:00
348,AFLT,190,149,18761261.0,28837993.0,47856,73097,39.2,39.45,120953,47599254.0,339,171,128,18177909.0,28710825.0,46386,72734,39.19,39.47,119120,46888734.0,299,2023-11-06 13:05:00
349,AFLT,381,147,37401633.0,22113728.0,95381,56180,39.21,39.36,151561,59515362.0,528,348,137,36839293.0,22116881.0,93987,56159,39.2,39.38,150146,58956174.0,485,2023-11-06 13:10:00
350,AFLT,291,154,29203018.0,29293702.0,74496,74378,39.2,39.38,148874,58496721.0,445,212,118,29395671.0,27354567.0,75019,69467,39.18,39.38,144486,56750239.0,330,2023-11-06 13:15:00
351,AFLT,322,120,31337326.0,22347916.0,79930,56730,39.21,39.39,136660,53685242.0,442,299,113,32147524.0,24931186.0,82022,63244,39.19,39.42,145266,57078711.0,412,2023-11-06 13:20:00
352,AFLT,661,244,46459979.0,20409197.0,118381,51870,39.25,39.35,170251,66869177.0,905,607,222,45836507.0,20191446.0,116884,51293,39.22,39.36,168177,66027953.0,829,2023-11-06 13:25:00
353,AFLT,208,217,16528392.0,17021043.0,42184,43282,39.18,39.33,85466,33549435.0,425,169,195,16157573.0,16790544.0,41235,42654,39.18,39.36,83889,32948118.0,364,2023-11-06 13:30:00
354,AFLT,188,307,19591668.0,25101752.0,50034,63898,39.16,39.28,113932,44693420.0,495,167,289,19499628.0,24335180.0,49818,61833,39.14,39.36,111651,43834809.0,456,2023-11-06 13:35:00
355,AFLT,215,202,38366965.0,31972620.0,97913,81309,39.18,39.32,179222,70339585.0,417,200,196,38041314.0,31478279.0,97228,79957,39.13,39.37,177185,69519594.0,396,2023-11-06 13:40:00
356,AFLT,206,330,30506433.0,31729942.0,77842,80819,39.19,39.26,158661,62236375.0,536,163,308,30253786.0,30681146.0,77225,78011,39.18,39.33,155236,60934932.0,471,2023-11-06 13:45:00
357,AFLT,245,260,30999852.0,36180409.0,79099,91853,39.19,39.39,170952,67180261.0,505,205,250,31197282.0,36483953.0,79643,92586,39.17,39.41,172229,67681236.0,455,2023-11-06 13:50:00
358,AFLT,204,370,30489958.0,38802178.0,77865,98650,39.16,39.33,176515,69292136.0,574,156,344,29601591.0,38654895.0,75639,98276,39.14,39.33,173915,68256486.0,500,2023-11-06 13:55:00
359,AFLT,320,253,60472560.0,44263784.0,154455,112460,39.15,39.36,266915,104736344.0,573,303,251,61191646.0,47059784.0,156301,119506,39.15,39.38,275807,108251430.0,554,2023-11-06 14:00:00
360,AFLT,257,123,54159198.0,30151213.0,138048,76415,39.23,39.46,214463,84310411.0,380,224,118,52889495.0,29927668.0,134902,75851,39.21,39.46,210753,82817163.0,342,2023-11-06 14:05:00
361,AFLT,294,250,63958938.0,41881491.0,163009,106248,39.24,39.42,269257,105840430.0,544,260,217,61065664.0,38168440.0,156011,96913,39.14,39.38,252924,99234104.0,477,2023-11-06 14:10:00
362,AFLT,332,228,38665801.0,38473551.0,98551,97685,39.23,39.39,196236,77139353.0,560,275,204,37313486.0,39204382.0,95167,99500,39.21,39.4,194667,76517868.0,479,2023-11-06 14:15:00
363,AFLT,450,220,105768834.0,51499700.0,269425,130541,39.26,39.45,399966,157268535.0,670,403,182,105050574.0,50305932.0,267757,127525,39.23,39.45,395282,155356506.0,585,2023-11-06 14:20:00
364,AFLT,273,205,44405277.0,39342237.0,113184,99740,39.23,39.44,212924,83747514.0,478,244,178,44312902.0,38851276.0,112966,98529,39.23,39.43,211495,83164179.0,422,2023-11-06 14:25:00
365,AFLT,346,258,69782838.0,32769618.0,178226,83190,39.15,39.39,261416,102552456.0,604,311,258,69455894.0,33313896.0,177416,84531,39.15,39.41,261947,102769791.0,569,2023-11-06 14:30:00
366,AFLT,486,341,108427576.0,58659408.0,276186,148548,39.26,39.49,424734,167086984.0,827,415,316,105194907.0,58879039.0,268025,149148,39.25,39.48,417173,164073946.0,731,2023-11-06 14:35:00
367,AFLT,1258,603,355495796.0,99468531.0,903123,251784,39.36,39.51,1154907,454964328.0,1861,1104,527,350237683.0,97573097.0,890492,246936,39.33,39.51,1137428,447810780.0,1631,2023-11-06 14:40:00
368,AFLT,790,390,141395829.0,79763555.0,359379,201817,39.34,39.52,561196,221159385.0,1180,718,316,136722336.0,75733517.0,347815,191463,39.31,39.56,539278,212455853.0,1034,2023-11-06 14:45:00
369,AFLT,329,273,54599559.0,48728820.0,138372,122995,39.46,39.62,261367,103328380.0,602,259,222,49179843.0,46325335.0,124988,116943,39.35,39.61,241931,95505178.0,481,2023-11-06 14:50:00
370,AFLT,1550,200,638294137.0,36520513.0,1622228,92288,39.35,39.57,1714516,674814650.0,1750,1494,144,642836579.0,34942702.0,1633741,88211,39.35,39.61,1721952,677779282.0,1638,2023-11-06 14:55:00
371,AFLT,657,538,62755574.0,72194924.0,159311,182555,39.39,39.55,341866,134950499.0,1195,615,519,61704556.0,70940862.0,156720,179399,39.37,39.54,336119,132645419.0,1134,2023-11-06 15:00:00
372,AFLT,798,229,69446452.0,46341476.0,176194,117046,39.41,39.59,293240,115787928.0,1027,726,184,64550351.0,45109438.0,163817,113851,39.4,39.62,277668,109659790.0,910,2023-11-06 15:05:00
373,AFLT,384,536,52488780.0,90914521.0,133321,230118,39.37,39.51,363439,143403301.0,920,339,511,54232059.0,90413249.0,137784,228788,39.36,39.52,366572,144645308.0,850,2023-11-06 15:10:00
374,AFLT,248,161,49306863.0,40937230.0,125348,104505,39.34,39.17,229853,90244094.0,409,206,145,48960734.0,39759552.0,124484,100527,39.33,39.55,225011,88720286.0,351,2023-11-06 15:15:00
375,AFLT,306,313,61746918.0,53635032.0,156978,135604,39.33,39.55,292582,115381950.0,619,273,294,61208527.0,53542291.0,155645,135314,39.33,39.57,290959,114750819.0,567,2023-11-06 15:20:00
376,AFLT,5709,1203,2236385869.0,60210890.0,5678350,152422,39.38,39.5,5830772,2296596759.0,6912,5693,1189,2235368784.0,56087781.0,5675845,141938,39.38,39.52,5817783,2291456566.0,6882,2023-11-06 15:25:00
377,AFLT,6824,1853,2568134491.0,113128858.0,6521321,287386,39.38,39.36,6808707,2681263350.0,8677,6739,1814,2567312024.0,106232807.0,6519219,268883,39.38,39.51,6788102,2673544832.0,8553,2023-11-06 15:30:00
378,AFLT,691,266,155756941.0,77330557.0,396840,196172,39.25,39.42,593012,233087499.0,957,646,248,151469996.0,76992259.0,385711,194737,39.27,39.54,580448,228462256.0,894,2023-11-06 15:35:00
379,AFLT,457,336,106014005.0,70056864.0,270254,177804,39.23,39.4,448058,176070870.0,793,383,308,102627442.0,69675561.0,261662,176724,39.22,39.43,438386,172303003.0,691,2023-11-06 15:40:00
380,AFLT,200,80,22758867.0,16893949.0,58006,42866,39.24,39.41,100872,39652817.0,280,165,79,22211726.0,16669745.0,56618,42272,39.23,39.43,98890,38881472.0,244,2023-11-06 15:45:00
381,AFLT,200,147,21968508.0,28096739.0,55976,71137,39.25,39.5,127113,50065247.0,347,186,141,22175281.0,27061268.0,56520,68397,39.23,39.56,124917,49236550.0,327,2023-11-06 15:50:00
382,AFLT,292,179,38319604.0,35333606.0,97679,89618,39.23,39.43,187297,73653211.0,471,232,164,38295654.0,35083809.0,97621,88980,39.23,39.43,186601,73379464.0,396,2023-11-06 15:55:00
383,AFLT,296,231,69982899.0,42928190.0,178681,109615,39.17,39.16,288296,112911090.0,527,228,182,68544354.0,41325979.0,175009,104898,39.17,39.4,279907,109870333.0,410,2023-11-06 16:00:00
384,AFLT,205,118,35248863.0,31000534.0,89930,78545,39.2,39.47,168475,66249397.0,323,163,112,34512789.0,30787570.0,88106,77976,39.17,39.48,166082,65300359.0,275,2023-11-06 16:05:00
385,AFLT,1318,429,225564965.0,104956712.0,574426,266024,39.27,39.45,840450,330521677.0,1747,1288,410,228348965.0,104169584.0,581674,264044,39.26,39.45,845718,332518549.0,1698,2023-11-06 16:10:00
386,AFLT,1429,336,155650373.0,25702629.0,395753,65209,39.33,39.42,460962,181353002.0,1765,1389,322,156442756.0,26118833.0,397775,66254,39.33,39.42,464029,182561589.0,1711,2023-11-06 16:15:00
387,AFLT,1971,388,521739260.0,93328786.0,1327029,236376,39.32,39.48,1563405,615068047.0,2359,1958,384,521964024.0,92860831.0,1327636,235244,39.32,39.47,1562880,614824855.0,2342,2023-11-06 16:20:00
388,AFLT,481,386,65031585.0,51243391.0,165399,129857,39.32,39.46,295256,116274977.0,867,438,356,63909840.0,51880464.0,162614,131488,39.3,39.46,294102,115790305.0,794,2023-11-06 16:25:00
389,AFLT,212,92,23620362.0,19353075.0,60111,49087,39.29,39.43,109198,42973437.0,304,163,84,23517592.0,18871047.0,59851,47810,39.29,39.47,107661,42388639.0,247,2023-11-06 16:30:00
390,AFLT,322,137,53671323.0,33294348.0,136500,84158,39.32,39.56,220658,86965671.0,459,309,109,53304308.0,32955091.0,135615,83323,39.31,39.55,218938,86259399.0,418,2023-11-06 16:35:00
391,AFLT,519,160,92155608.0,27352208.0,234651,69786,39.27,39.19,304437,119507816.0,679,451,140,92375205.0,26923261.0,235166,68211,39.28,39.47,303377,119298466.0,591,2023-11-06 16:40:00
392,AFLT,740,398,80565602.0,65035760.0,204918,164837,39.32,39.45,369755,145601363.0,1138,717,392,79896048.0,61059804.0,203220,154843,39.32,39.43,358063,140955852.0,1109,2023-11-06 16:45:00
393,AFLT,526,346,63202813.0,53873346.0,160771,136288,39.31,39.53,297059,117076159.0,872,516,333,63475513.0,53691896.0,161476,135818,39.31,39.53,297294,117167409.0,849,2023-11-06 16:50:00
394,AFLT,433,99,38460152.0,14593988.0,97814,36975,39.32,39.47,134789,53054141.0,532,389,83,38571389.0,14995902.0,98105,37994,39.32,39.47,136099,53567291.0,472,2023-11-06 16:55:00
395,AFLT,401,257,43201476.0,26755065.0,109819,67817,39.34,39.45,177636,69956542.0,658,370,235,42735482.0,26422305.0,108686,66971,39.32,39.45,175657,69157787.0,605,2023-11-06 17:00:00
396,AFLT,183,80,12240551.0,16920618.0,31136,42684,39.31,39.64,73820,29161170.0,263,152,72,10875407.0,17182464.0,27687,43363,39.28,39.62,71050,28057871.0,224,2023-11-06 17:05:00
397,AFLT,1296,221,124565803.0,42920646.0,316597,108677,39.35,39.49,425274,167486450.0,1517,1225,195,120637361.0,45810857.0,306654,116046,39.34,39.48,422700,166448218.0,1420,2023-11-06 17:10:00
398,AFLT,412,542,82456990.0,66860224.0,209617,169425,39.34,39.46,379042,149317215.0,954,414,544,81580520.0,66621425.0,207431,168819,39.33,39.46,376250,148201945.0,958,2023-11-06 17:15:00
399,AFLT,184,88,19666699.0,21392168.0,50070,53966,39.28,39.64,104036,41058867.0,272,155,65,18334426.0,20153531.0,46644,50865,39.31,39.62,97509,38487957.0,220,2023-11-06 17:20:00
400,AFLT,772,707,119727898.0,60378944.0,304245,153042,39.35,39.45,457287,180106843.0,1479,692,691,120391537.0,62406424.0,305960,158185,39.35,39.45,464145,182797962.0,1383,2023-11-06 17:25:00
401,AFLT,1034,727,153932297.0,84463925.0,388450,213744,39.63,39.52,602194,238396222.0,1761,980,656,146792220.0,81320895.0,372733,205761,39.38,39.52,578494,228113115.0,1636,2023-11-06 17:30:00
402,AFLT,517,389,63169291.0,51619983.0,160510,130382,39.36,39.59,290892,114789275.0,906,489,389,62404356.0,50633876.0,158600,127876,39.35,39.6,286476,113038232.0,878,2023-11-06 17:35:00
403,AFLT,216,114,16703331.0,8390311.0,42381,21191,39.41,39.59,63572,25093642.0,330,155,69,16769320.0,7293078.0,42570,18441,39.39,39.55,61011,24062399.0,224,2023-11-06 17:40:00
404,AFLT,532,291,47837252.0,22121689.0,121574,56014,39.35,39.49,177588,69958942.0,823,311,273,46289535.0,21489525.0,117682,54379,39.33,39.52,172061,67779061.0,584,2023-11-06 17:45:00
405,AFLT,656,208,31568490.0,21324586.0,80133,53746,39.4,39.68,133879,52893076.0,864,535,193,30443440.0,20995841.0,77326,52860,39.37,39.72,130186,51439281.0,728,2023-11-06 17:50:00
406,AFLT,239,199,19910589.0,10395067.0,50544,26291,39.39,39.54,76835,30305657.0,438,182,176,20251910.0,10365940.0,51437,26205,39.37,39.56,77642,30617850.0,358,2023-11-06 17:55:00
407,AFLT,3786,1220,1569732224.0,278659762.0,3961585,704882,39.62,39.53,4666467,1848391986.0,5006,3615,977,1547944704.0,266039761.0,3910717,670245,39.58,39.69,4580962,1813984466.0,4592,2023-11-06 18:00:00
408,AFLT,513,479,69992062.0,47553128.0,177207,119736,39.5,39.71,296943,117545190.0,992,428,389,51483491.0,44829999.0,130184,112649,39.55,39.8,242833,96313490.0,817,2023-11-06 18:05:00
409,AFLT,237,159,21553158.0,15980227.0,54470,40218,39.57,39.73,94688,37533386.0,396,212,108,20958534.0,14161191.0,52976,35616,39.56,39.76,88592,35119726.0,320,2023-11-06 18:10:00
410,AFLT,496,412,35470637.0,109641022.0,89146,276258,39.79,39.69,365404,145111659.0,908,421,350,35303313.0,109433614.0,89226,275661,39.57,39.7,364887,144736928.0,771,2023-11-06 18:15:00
411,AFLT,802,304,78833778.0,60384950.0,199063,152045,39.6,39.72,351108,139218728.0,1106,776,284,77904693.0,56989940.0,196788,143424,39.59,39.74,340212,134894633.0,1060,2023-11-06 18:20:00
412,AFLT,330,1159,39412546.0,412433964.0,99740,1040285,39.52,39.65,1140025,451846511.0,1489,289,1134,38499924.0,409232150.0,97416,1032005,39.52,39.65,1129421,447732074.0,1423,2023-11-06 18:25:00
413,AFLT,682,2421,21471993.0,1018032077.0,54323,2568021,39.53,39.64,2622344,1039504070.0,3103,622,2388,21159220.0,1018817695.0,53633,2569909,39.45,39.64,2623542,1039976916.0,3010,2023-11-06 18:30:00
414,AFLT,879,2349,37715381.0,1034945355.0,95445,2610675,39.52,39.64,2706120,1072660736.0,3228,865,2348,37436042.0,1032739345.0,94806,2605044,39.49,39.64,2699850,1070175387.0,3213,2023-11-06 18:35:00
415,AFLT,1787,739,92383347.0,143782986.0,233292,362443,39.6,39.67,595735,236166333.0,2526,1754,708,93579402.0,144267039.0,236645,363676,39.54,39.67,600321,237846442.0,2462,2023-11-06 18:40:00
416,AFLT,878,1652,73515475.0,130703500.0,190245,318314,38.64,41.06,508559,204218976.0,2530,435,875,55786996.0,87324631.0,141377,220066,39.46,39.68,361443,143111627.0,1310,2023-11-07 10:05:00
417,AFLT,530,460,107960957.0,80027751.0,274435,200275,39.34,39.96,474710,187988709.0,990,468,374,99777480.0,72612646.0,253646,181920,39.34,39.91,435566,172390126.0,842,2023-11-07 10:10:00
418,AFLT,818,378,93994117.0,24480274.0,237913,61395,39.51,39.87,299308,118474391.0,1196,680,228,91456207.0,21923815.0,231434,55008,39.52,39.86,286442,113380023.0,908,2023-11-07 10:15:00
419,AFLT,503,253,75583231.0,25677612.0,192727,64312,39.22,39.93,257039,101260843.0,756,410,178,72781390.0,23753051.0,185237,59417,39.29,39.98,244654,96534442.0,588,2023-11-07 10:20:00
420,AFLT,478,265,86873278.0,54659302.0,220531,137631,39.39,39.71,358162,141532581.0,743,391,205,84511529.0,50176923.0,214525,126151,39.39,39.78,340676,134688452.0,596,2023-11-07 10:25:00
421,AFLT,530,426,85887879.0,93943214.0,217765,236534,39.44,39.72,454299,179831094.0,956,423,377,82995732.0,89016700.0,210624,224031,39.4,39.73,434655,172012432.0,800,2023-11-07 10:30:00
422,AFLT,250,227,49081434.0,43306016.0,124666,109093,39.37,39.7,233759,92387450.0,477,180,180,45124348.0,39228082.0,114567,98781,39.39,39.71,213348,84352430.0,360,2023-11-07 10:35:00
423,AFLT,797,200,81843061.0,39884484.0,149763,100594,54.65,39.65,250357,121727545.0,997,720,141,57160971.0,38675628.0,145022,97522,39.42,39.66,242544,95836599.0,861,2023-11-07 10:40:00
424,AFLT,405,411,42736147.0,53360812.0,108487,134825,39.39,39.58,243312,96096960.0,816,286,380,40913649.0,52318695.0,103822,131986,39.41,39.64,235808,93232344.0,666,2023-11-07 10:45:00
425,AFLT,498,477,77744259.0,88074050.0,197469,221909,39.37,39.69,419378,165818309.0,975,414,455,71959547.0,87829289.0,182717,221222,39.38,39.7,403939,159788836.0,869,2023-11-07 10:50:00
426,AFLT,305,354,43711171.0,51166217.0,110931,129323,39.4,39.56,240254,94877388.0,659,252,308,42335217.0,47445566.0,107435,119529,39.41,39.69,226964,89780784.0,560,2023-11-07 10:55:00
427,AFLT,792,632,169436820.0,153042186.0,431262,386950,39.29,39.55,818212,322479006.0,1424,680,556,169357267.0,150322980.0,431011,379261,39.29,39.64,810272,319680247.0,1236,2023-11-07 11:00:00
428,AFLT,479,527,107290065.0,98725597.0,274924,249309,39.03,39.6,524233,206015662.0,1006,422,488,93790458.0,97765549.0,238855,246762,39.27,39.62,485617,191556008.0,910,2023-11-07 11:05:00
429,AFLT,919,575,142537068.0,140744811.0,362579,355947,39.31,39.54,718526,283281879.0,1494,787,547,137844373.0,139330912.0,350634,352041,39.31,39.58,702675,277175286.0,1334,2023-11-07 11:10:00
430,AFLT,708,346,68710047.0,74762151.0,174310,188773,39.42,39.6,363083,143472198.0,1054,633,318,67879732.0,73700853.0,172383,186099,39.38,39.6,358482,141580585.0,951,2023-11-07 11:15:00
431,AFLT,419,269,40348684.0,49609924.0,102604,125293,39.32,39.6,227897,89958609.0,688,352,217,39050135.0,48300221.0,99263,121938,39.34,39.61,221201,87350356.0,569,2023-11-07 11:20:00
432,AFLT,599,441,117300946.0,146260527.0,298576,368983,39.29,39.64,667559,263561473.0,1040,583,407,118168208.0,146331096.0,300775,368923,39.29,39.66,669698,264499304.0,990,2023-11-07 11:25:00
433,AFLT,479,269,63911559.0,54259180.0,162631,137151,39.3,39.56,299782,118170739.0,748,451,247,62006607.0,46747379.0,157903,118063,39.27,39.6,275966,108753986.0,698,2023-11-07 11:30:00
434,AFLT,457,438,64851044.0,87416494.0,164905,211471,39.33,41.34,376376,152267538.0,895,411,399,64109956.0,82893048.0,163004,209797,39.33,39.51,372801,147003004.0,810,2023-11-07 11:35:00
435,AFLT,267,213,64356793.0,49245730.0,163779,124821,39.29,39.45,288600,113602524.0,480,231,194,64120612.0,48024583.0,163160,121382,39.3,39.56,284542,112145196.0,425,2023-11-07 11:40:00
436,AFLT,930,417,147794073.0,83974121.0,324432,212467,45.55,39.52,536899,231768194.0,1347,856,383,145457598.0,90002995.0,318476,227711,45.67,39.53,546187,235460594.0,1239,2023-11-07 11:45:00
437,AFLT,447,339,54717651.0,49653824.0,138924,125660,39.39,39.51,264584,104371475.0,786,400,315,54056523.0,48839572.0,137267,123591,39.38,39.52,260858,102896096.0,715,2023-11-07 11:50:00
438,AFLT,328,269,32527075.0,30329221.0,82612,76714,39.37,39.54,159326,62856296.0,597,282,254,32072613.0,29045499.0,81496,73461,39.35,39.54,154957,61118112.0,536,2023-11-07 11:55:00
439,AFLT,353,277,71128190.0,48460370.0,180982,122740,39.3,39.48,303722,119588560.0,630,312,239,71266153.0,49770162.0,181339,125850,39.3,39.55,307189,121036315.0,551,2023-11-07 12:00:00
440,AFLT,524,285,102245566.0,72135628.0,260307,182359,39.28,39.56,442666,174381195.0,809,473,250,101242026.0,71171564.0,257730,179754,39.28,39.59,437484,172413591.0,723,2023-11-07 12:05:00
441,AFLT,603,445,57237476.0,42958657.0,145553,108647,39.32,39.54,254200,100196133.0,1048,548,391,56642200.0,42325691.0,144068,107051,39.32,39.54,251119,98967892.0,939,2023-11-07 12:10:00
442,AFLT,276,145,49447782.0,32216896.0,126039,81570,39.23,39.5,207609,81664679.0,421,250,132,49021811.0,30887704.0,124923,78076,39.24,39.56,202999,79909516.0,382,2023-11-07 12:15:00
443,AFLT,305,188,48431359.0,36051162.0,123564,91309,39.2,39.48,214873,84482522.0,493,259,152,47985083.0,35541414.0,122443,89816,39.19,39.57,212259,83526498.0,411,2023-11-07 12:20:00
444,AFLT,403,240,51022892.0,35958163.0,130205,83272,39.19,43.18,213477,86981056.0,643,392,216,49984514.0,37211902.0,127569,84319,39.18,44.13,211888,87196416.0,608,2023-11-07 12:25:00
445,AFLT,183,84,20416062.0,12984552.0,51942,32867,39.31,39.51,84809,33400614.0,267,166,79,18360589.0,12706077.0,46709,32155,39.31,39.52,78864,31066667.0,245,2023-11-07 12:30:00
446,AFLT,363,338,62698535.0,78682036.0,159668,199323,39.27,39.47,358991,141380572.0,701,314,298,61070381.0,76282949.0,155505,192961,39.27,39.53,348466,137353330.0,612,2023-11-07 12:35:00
447,AFLT,205,183,15796223.0,27000791.0,40164,68216,39.33,39.58,108380,42797014.0,388,140,156,15294082.0,25986647.0,38925,65819,39.29,39.48,104744,41280729.0,296,2023-11-07 12:40:00
448,AFLT,588,209,41062167.0,39455826.0,103929,99905,39.51,39.49,203834,80517993.0,797,577,181,40302754.0,37941212.0,102558,96025,39.3,39.51,198583,78243967.0,758,2023-11-07 12:45:00
449,AFLT,280,350,40954944.0,59224949.0,104221,149966,39.3,39.49,254187,100179893.0,630,223,302,39727187.0,57971746.0,101118,146800,39.29,39.49,247918,97698933.0,525,2023-11-07 12:50:00
450,AFLT,166,144,28176835.0,28974160.0,71608,73367,39.35,39.49,144975,57150996.0,310,128,115,26854195.0,28423876.0,68394,71993,39.26,39.48,140387,55278071.0,243,2023-11-07 12:55:00
451,AFLT,340,145,22282838.0,26238502.0,56685,66421,39.31,39.5,123106,48521341.0,485,304,138,22139530.0,26302593.0,56351,66577,39.29,39.51,122928,48442123.0,442,2023-11-07 13:00:00
452,AFLT,242,244,27757702.0,33496462.0,70033,85123,39.64,39.35,155156,61254164.0,486,196,205,26524964.0,32607592.0,67512,82574,39.29,39.49,150086,59132557.0,401,2023-11-07 13:05:00
453,AFLT,167,217,17442574.0,22550081.0,44394,57088,39.29,39.5,101482,39992655.0,384,73,192,14887120.0,21226931.0,37900,53746,39.28,39.49,91646,36114051.0,265,2023-11-07 13:10:00
454,AFLT,199,184,76293515.0,54977226.0,147539,138892,51.71,39.58,286431,131270742.0,383,171,150,76512815.0,52124817.0,143881,131665,53.18,39.59,275546,128637632.0,321,2023-11-07 13:15:00
455,AFLT,160,514,17823287.0,45468596.0,45355,115270,39.3,39.45,160625,63291883.0,674,88,493,17457817.0,45421244.0,44435,115143,39.29,39.45,159578,62879061.0,581,2023-11-07 13:20:00
456,AFLT,128,165,19388798.0,24785753.0,49251,62766,39.37,39.49,112017,44174552.0,293,104,131,19240531.0,24328114.0,48972,61577,39.29,39.51,110549,43568646.0,235,2023-11-07 13:25:00
457,AFLT,173,234,28979185.0,35713377.0,73347,90888,39.51,39.29,164235,64692563.0,407,134,194,27656268.0,33473798.0,70384,84725,39.29,39.51,155109,61130067.0,328,2023-11-07 13:30:00
458,AFLT,227,328,23455449.0,39887301.0,59657,100990,39.32,39.5,160647,63342751.0,555,185,306,23646512.0,39587118.0,60169,100225,39.3,39.5,160394,63233631.0,491,2023-11-07 13:35:00
459,AFLT,326,329,31755663.0,35337142.0,80787,89463,39.31,39.5,170250,67092805.0,655,209,284,31452979.0,35152632.0,80047,88997,39.29,39.5,169044,66605612.0,493,2023-11-07 13:40:00
460,AFLT,330,845,37973378.0,70130736.0,96537,177726,39.34,39.46,274263,108104114.0,1175,272,828,37389632.0,70160526.0,95118,177794,39.31,39.46,272912,107550159.0,1100,2023-11-07 13:45:00
461,AFLT,299,538,30194844.0,64492461.0,76778,163337,39.33,39.48,240115,94687305.0,837,236,508,30556386.0,64294609.0,77726,162802,39.31,39.49,240528,94850996.0,744,2023-11-07 13:50:00
462,AFLT,869,650,158999409.0,114418261.0,404243,289378,39.33,39.54,693621,273417670.0,1519,781,616,156772695.0,114736116.0,398878,290140,39.3,39.55,689018,271508812.0,1397,2023-11-07 13:55:00
463,AFLT,668,459,122432270.0,101137331.0,310912,255702,39.38,39.55,566614,223569601.0,1127,666,451,123512358.0,101677490.0,313771,257048,39.36,39.56,570819,225189848.0,1117,2023-11-07 14:00:00
464,AFLT,592,374,101121827.0,89771421.0,256687,226692,39.39,39.6,483379,190893248.0,966,553,330,100385866.0,89365318.0,255296,225699,39.32,39.59,480995,189751185.0,883,2023-11-07 14:05:00
465,AFLT,507,408,82555136.0,59967479.0,209992,151600,39.31,39.56,361592,142522616.0,915,459,377,80843110.0,55827592.0,205721,141144,39.3,39.55,346865,136670703.0,836,2023-11-07 14:10:00
466,AFLT,379,325,84386931.0,86620008.0,214245,218068,39.39,39.72,432313,171006939.0,704,328,266,75060480.0,84087615.0,190929,211731,39.31,39.71,402660,159148095.0,594,2023-11-07 14:15:00
467,AFLT,304,276,42274298.0,51464838.0,107228,129982,39.42,39.59,237210,93739137.0,580,258,232,41232260.0,49872531.0,104761,125773,39.36,39.65,230534,91104791.0,490,2023-11-07 14:20:00
468,AFLT,220,223,40551350.0,40721447.0,102813,102771,39.44,39.62,205584,81272797.0,443,160,176,40753253.0,40091832.0,103455,101120,39.39,39.65,204575,80845085.0,336,2023-11-07 14:25:00
469,AFLT,202,195,40113860.0,43200249.0,101663,108830,39.46,39.7,210493,83314110.0,397,186,164,38841961.0,42472514.0,98626,106989,39.38,39.7,205615,81314476.0,350,2023-11-07 14:30:00
470,AFLT,234,168,37328954.0,38588074.0,94370,97552,39.56,39.56,191922,75917028.0,402,189,145,36808384.0,38137648.0,93334,96097,39.44,39.69,189431,74946033.0,334,2023-11-07 14:35:00
471,AFLT,238,222,44250243.0,44824756.0,112361,113663,39.38,39.44,226024,89075000.0,460,214,174,42957019.0,43840555.0,109064,110568,39.39,39.65,219632,86797574.0,388,2023-11-07 14:40:00
472,AFLT,180,210,16283025.0,25284100.0,41312,63880,39.41,39.58,105192,41567125.0,390,154,173,15920193.0,23279936.0,40402,58796,39.4,39.59,99198,39200129.0,327,2023-11-07 14:45:00
473,AFLT,195,241,32786821.0,39744489.0,83316,100326,39.35,39.62,183642,72531310.0,436,174,209,31463621.0,39744073.0,79924,100298,39.37,39.63,180222,71207695.0,383,2023-11-07 14:50:00
474,AFLT,354,353,86530649.0,85318609.0,219894,215135,39.35,39.66,435029,171849258.0,707,297,307,78589745.0,83786805.0,199751,211239,39.34,39.66,410990,162376550.0,604,2023-11-07 14:55:00
475,AFLT,240,338,34531810.0,59396975.0,87612,150011,39.41,39.6,237623,93928785.0,578,223,319,34112096.0,58102239.0,86550,146738,39.41,39.6,233288,92214335.0,542,2023-11-07 15:00:00
476,AFLT,907,918,45507843.0,50907390.0,115343,128422,39.45,39.64,243765,96415233.0,1825,926,876,46112581.0,50272303.0,116890,126777,39.45,39.65,243667,96384885.0,1802,2023-11-07 15:05:00
477,AFLT,307,481,18249970.0,80959338.0,46284,204776,39.43,39.54,251060,99209308.0,788,260,440,17878905.0,80319567.0,45347,203159,39.43,39.54,248506,98198473.0,700,2023-11-07 15:10:00
478,AFLT,349,380,26484985.0,81954650.0,67099,207298,39.47,39.53,274397,108439635.0,729,321,364,26503916.0,81721641.0,67179,206707,39.45,39.54,273886,108225558.0,685,2023-11-07 15:15:00
479,AFLT,154,107,23435142.0,22235982.0,59436,56086,39.43,39.65,115522,45671124.0,261,161,83,22798900.0,22230865.0,57844,56062,39.41,39.65,113906,45029765.0,244,2023-11-07 15:20:00
480,AFLT,87,63,8450875.0,6305449.0,21441,15904,39.41,39.65,37345,14756324.0,150,71,38,8835053.0,6030228.0,22424,15211,39.4,39.64,37635,14865281.0,109,2023-11-07 15:25:00
481,AFLT,288,590,36640182.0,148206712.0,92711,374547,39.52,39.57,467258,184846894.0,878,241,556,35999071.0,146732343.0,91307,370817,39.43,39.57,462124,182731414.0,797,2023-11-07 15:30:00
482,AFLT,270,371,46401931.0,76762621.0,117594,193582,39.46,39.65,311176,123164552.0,641,242,347,45998673.0,76726213.0,116730,193485,39.41,39.65,310215,122724886.0,589,2023-11-07 15:35:00
483,AFLT,325,411,52015880.0,79555922.0,131991,201050,39.41,39.57,333041,131571802.0,736,299,382,51031573.0,77475492.0,129445,195789,39.42,39.57,325234,128507065.0,681,2023-11-07 15:40:00
484,AFLT,243,244,49052427.0,64780268.0,124467,163232,39.41,39.69,287699,113832695.0,487,235,222,48233189.0,66587297.0,122415,167774,39.4,39.69,290189,114820486.0,457,2023-11-07 15:45:00
485,AFLT,398,606,80607871.0,142194951.0,204766,359103,39.37,39.6,563869,222802822.0,1004,366,569,78758372.0,141412938.0,200106,357119,39.36,39.6,557225,220171310.0,935,2023-11-07 15:50:00
486,AFLT,265,707,36700154.0,152951748.0,92934,386542,39.49,39.57,479476,189651902.0,972,244,676,38139871.0,153240360.0,96605,387258,39.48,39.57,483863,191380231.0,920,2023-11-07 15:55:00
487,AFLT,351,287,55306437.0,56464802.0,140137,142441,39.47,39.64,282578,111771240.0,638,331,255,54101745.0,54880623.0,137134,138416,39.45,39.65,275550,108982368.0,586,2023-11-07 16:00:00
488,AFLT,811,653,68551595.0,124509662.0,173924,314264,39.41,39.62,488188,193061258.0,1464,763,626,67428040.0,123732053.0,171039,312281,39.42,39.62,483320,191160093.0,1389,2023-11-07 16:05:00
489,AFLT,382,215,76113413.0,67644821.0,193298,170387,39.38,39.7,363685,143758235.0,597,384,186,76331079.0,67269208.0,193932,169411,39.36,39.71,363343,143600287.0,570,2023-11-07 16:10:00
490,AFLT,336,234,29902584.0,42813951.0,68613,108348,43.58,39.52,176961,72716535.0,570,326,224,29775475.0,41593909.0,68333,105013,43.57,39.61,173346,71369385.0,550,2023-11-07 16:15:00
491,AFLT,477,423,55851991.0,84487942.0,141945,213481,39.35,39.58,355426,140339934.0,900,450,389,59186663.0,88419596.0,150466,223245,39.34,39.61,373711,147606259.0,839,2023-11-07 16:20:00
492,AFLT,370,428,65099228.0,97741290.0,165494,246548,39.34,39.64,412042,162840519.0,798,321,381,61183535.0,92519191.0,155476,233786,39.35,39.57,389262,153702726.0,702,2023-11-07 16:25:00
493,AFLT,296,262,57083930.0,55459388.0,147695,142212,38.65,39.0,289907,112543318.0,558,280,238,55259377.0,52437670.0,142540,132609,38.77,39.54,275149,107697048.0,518,2023-11-07 16:30:00
494,AFLT,308,267,42159949.0,60283844.0,107006,152275,39.4,39.59,259281,102443793.0,575,271,250,42413535.0,61026210.0,107759,153550,39.36,39.74,261309,103439746.0,521,2023-11-07 16:35:00
495,AFLT,277,181,37583995.0,34600502.0,95459,87301,39.37,39.63,182760,72184497.0,458,264,134,35680441.0,34123892.0,90622,86019,39.37,39.67,176641,69804333.0,398,2023-11-07 16:40:00
496,AFLT,389,242,58230285.0,51370556.0,147935,129734,39.36,39.6,277669,109600842.0,631,376,229,56248225.0,51706637.0,143383,130559,39.23,39.6,273942,107954863.0,605,2023-11-07 16:45:00
497,AFLT,461,180,25961269.0,30370961.0,65909,76818,39.39,39.54,142727,56332231.0,641,433,146,32151103.0,30296601.0,83138,76583,38.67,39.56,159721,62447704.0,579,2023-11-07 16:50:00
498,AFLT,488,440,62832517.0,72299363.0,158912,182728,39.54,39.57,341640,135131880.0,928,479,411,61906265.0,72282413.0,157386,182690,39.33,39.57,340076,134188678.0,890,2023-11-07 16:55:00
499,AFLT,583,479,83414756.0,84086971.0,211580,212226,39.42,39.62,423806,167501728.0,1062,572,464,83036994.0,84463049.0,210784,213162,39.39,39.62,423946,167500043.0,1036,2023-11-07 17:00:00
500,AFLT,412,523,70564657.0,75858663.0,178967,191565,39.43,39.6,370532,146423320.0,935,370,483,70300659.0,76053442.0,178288,192076,39.43,39.6,370364,146354101.0,853,2023-11-07 17:05:00
501,AFLT,563,194,79567212.0,34310117.0,201735,86406,39.44,39.71,288141,113877330.0,757,505,162,78953467.0,31325230.0,200269,78903,39.42,39.7,279172,110278697.0,667,2023-11-07 17:10:00
502,AFLT,638,151,45703057.0,23798592.0,74549,60063,61.31,39.62,134612,69501650.0,789,634,141,48003138.0,25577874.0,75010,64543,64.0,39.63,139553,73581012.0,775,2023-11-07 17:15:00
503,AFLT,1343,472,353322351.0,140551760.0,892759,353221,39.58,39.79,1245980,493874112.0,1815,1296,372,350886215.0,135498460.0,847940,340601,41.38,39.78,1188541,486384675.0,1668,2023-11-07 17:20:00
504,AFLT,4628,3388,1255927406.0,994018393.0,3143045,2476271,39.96,40.14,5619316,2249945799.0,8016,3495,2543,1214169800.0,954105410.0,3049535,2374677,39.81,40.18,5424212,2168275210.0,6038,2023-11-07 17:25:00
505,AFLT,715,968,94583488.0,186247299.0,229917,465267,41.14,40.03,695184,280830787.0,1683,589,822,93156142.0,178464357.0,234239,445184,39.77,40.09,679423,271620499.0,1411,2023-11-07 17:30:00
506,AFLT,1033,696,124669996.0,119647137.0,314149,299353,39.68,39.97,613502,244317133.0,1729,937,582,98636267.0,112902152.0,247585,281260,39.84,40.14,528845,211538420.0,1519,2023-11-07 17:35:00
507,AFLT,706,1345,59137174.0,433514567.0,148191,1083246,39.91,40.02,1231437,492651742.0,2051,612,1251,58069048.0,432991852.0,145812,1080925,39.82,40.06,1226737,491060900.0,1863,2023-11-07 17:40:00
508,AFLT,853,460,90063501.0,83058380.0,225904,207266,39.87,40.07,433170,173121882.0,1313,722,328,80038187.0,80309263.0,201100,199878,39.8,40.18,400978,160347451.0,1050,2023-11-07 17:45:00
509,AFLT,900,204,82420551.0,21012464.0,205963,52452,40.02,40.06,258415,103433016.0,1104,788,120,85915042.0,18199537.0,214954,45323,39.97,40.16,260277,104114580.0,908,2023-11-07 17:50:00
510,AFLT,487,340,64729483.0,72113027.0,162059,179952,39.94,40.07,342011,136842511.0,827,279,259,59908138.0,69296213.0,150113,172591,39.91,40.15,322704,129204352.0,538,2023-11-07 17:55:00
511,AFLT,372,471,26898078.0,74957404.0,67077,187198,40.1,40.04,254275,101855483.0,843,338,421,23558814.0,73120490.0,58917,182325,39.99,40.1,241242,96679304.0,759,2023-11-07 18:00:00
512,AFLT,558,392,69055141.0,76382844.0,171556,190983,40.25,39.99,362539,145437985.0,950,503,325,64951894.0,73386288.0,162651,182561,39.93,40.2,345212,138338182.0,828,2023-11-07 18:05:00
513,AFLT,478,239,30684454.0,33743561.0,76934,84208,39.88,40.07,161142,64428015.0,717,426,164,30138448.0,29369172.0,75580,73025,39.88,40.22,148605,59507620.0,590,2023-11-07 18:10:00
514,AFLT,528,307,51051027.0,61237472.0,127953,152991,39.9,40.03,280944,112288500.0,835,504,239,50816661.0,57706855.0,127299,143767,39.92,40.14,271066,108523517.0,743,2023-11-07 18:15:00
515,AFLT,386,228,25371336.0,28555715.0,63421,71332,40.0,40.03,134753,53927051.0,614,348,165,19515681.0,23211651.0,48904,57922,39.91,40.07,106826,42727332.0,513,2023-11-07 18:20:00
516,AFLT,394,125,12678201.0,12624593.0,31738,32138,39.95,39.28,63876,25302795.0,519,344,87,12468376.0,12066454.0,31225,30096,39.93,40.09,61321,24534831.0,431,2023-11-07 18:25:00
517,AFLT,636,402,63134991.0,99856144.0,158695,249705,39.78,39.99,408400,162991136.0,1038,600,321,64189175.0,95920832.0,161427,239226,39.76,40.1,400653,160110007.0,921,2023-11-07 18:30:00
518,AFLT,570,702,74720538.0,187278586.0,188298,468370,39.68,39.99,656668,261999124.0,1272,469,662,68587037.0,186742299.0,172076,466867,39.86,40.0,638943,255329336.0,1131,2023-11-07 18:35:00
519,AFLT,706,662,37855346.0,213002539.0,94999,532562,39.85,40.0,627561,250857885.0,1368,681,653,40711131.0,216362938.0,102269,540556,39.81,40.03,642825,257074070.0,1334,2023-11-07 18:40:00
520,AFLT,1827,2866,441730350.0,365518247.0,1098042,896050,40.23,40.79,1994092,807248597.0,4693,1369,1885,411799867.0,314579523.0,1027152,779180,40.09,40.37,1806332,726379390.0,3254,2023-11-08 10:05:00
521,AFLT,568,533,111931248.0,71842755.0,278405,178029,40.2,40.35,456434,183774004.0,1101,502,378,110866313.0,67368366.0,277289,166675,39.98,40.42,443964,178234680.0,880,2023-11-08 10:10:00
522,AFLT,935,1035,170765239.0,134442909.0,427415,334420,39.95,40.2,761835,305208148.0,1970,754,834,165579702.0,129140641.0,414333,320326,39.96,40.32,734659,294720343.0,1588,2023-11-08 10:15:00
523,AFLT,519,756,73093057.0,65162484.0,183204,162660,39.9,40.06,345864,138255542.0,1275,373,642,63123665.0,55566353.0,158226,138282,39.89,40.18,296508,118690019.0,1015,2023-11-08 10:20:00
524,AFLT,515,831,100021057.0,97877439.0,250987,243746,39.85,40.16,494733,197898497.0,1346,337,754,84163686.0,94276945.0,211116,234687,39.87,40.17,445803,178440632.0,1091,2023-11-08 10:25:00
525,AFLT,813,657,138640212.0,143798767.0,347137,357947,39.94,40.17,705084,282438979.0,1470,762,559,133658979.0,138062759.0,334640,343582,39.94,40.18,678222,271721739.0,1321,2023-11-08 10:30:00
526,AFLT,419,698,68457877.0,108796935.0,171518,271155,39.91,40.12,442673,177254812.0,1117,371,641,64232731.0,107600559.0,160885,268056,39.92,40.14,428941,171833291.0,1012,2023-11-08 10:35:00
527,AFLT,830,765,178432192.0,169489954.0,446368,422971,39.97,40.07,869339,347922146.0,1595,769,683,170716860.0,167869481.0,427370,417846,39.95,40.17,845216,338586341.0,1452,2023-11-08 10:40:00
528,AFLT,700,442,90996629.0,84144813.0,228074,209337,39.9,40.2,437411,175141442.0,1142,648,379,86391718.0,82737493.0,215980,205590,40.0,40.24,421570,169129212.0,1027,2023-11-08 10:45:00
529,AFLT,440,396,75447226.0,63853003.0,188430,158713,40.04,40.23,347143,139300230.0,836,408,357,73221351.0,62012408.0,183177,154085,39.97,40.25,337262,135233759.0,765,2023-11-08 10:50:00
530,AFLT,374,515,65571187.0,81287241.0,163823,202543,40.03,40.13,366366,146858428.0,889,332,479,64516182.0,79382818.0,161234,197417,40.01,40.21,358651,143899000.0,811,2023-11-08 10:55:00
531,AFLT,327,397,57589765.0,53991977.0,144003,134242,39.99,40.22,278245,111581742.0,724,281,354,56967543.0,54246986.0,142424,134843,40.0,40.23,277267,111214529.0,635,2023-11-08 11:00:00
532,AFLT,634,677,100958304.0,100079885.0,250748,248604,40.26,40.26,499352,201038190.0,1311,593,630,96019222.0,96581117.0,239856,240085,40.03,40.23,479941,192600339.0,1223,2023-11-08 11:05:00
533,AFLT,348,611,49965767.0,60316215.0,124774,150033,40.05,40.2,274807,110281983.0,959,326,577,48484540.0,60714836.0,121117,151018,40.03,40.2,272135,109199376.0,903,2023-11-08 11:10:00
534,AFLT,432,602,65156424.0,94400092.0,162705,234777,40.05,40.21,397482,159556517.0,1034,388,555,65669965.0,94030221.0,163998,233836,40.04,40.21,397834,159700187.0,943,2023-11-08 11:15:00
535,AFLT,677,987,94781804.0,144061419.0,236531,358348,40.07,40.2,594879,238843223.0,1664,625,939,93721027.0,143491946.0,233989,356823,40.05,40.21,590812,237212974.0,1564,2023-11-08 11:20:00
536,AFLT,517,528,82672688.0,91551365.0,205626,227641,40.21,40.22,433267,174224053.0,1045,477,467,80264985.0,90366059.0,200379,224477,40.06,40.26,424856,170631044.0,944,2023-11-08 11:25:00
537,AFLT,586,682,123848873.0,115392522.0,309064,286477,40.07,40.28,595541,239241395.0,1268,529,621,122640564.0,111263349.0,305972,276070,40.08,40.3,582042,233903913.0,1150,2023-11-08 11:30:00
538,AFLT,754,520,128560278.0,110628058.0,320183,274333,40.15,40.33,594516,239188337.0,1274,701,454,123551982.0,107848478.0,308018,267458,40.11,40.32,575476,231400461.0,1155,2023-11-08 11:35:00
539,AFLT,676,674,116984419.0,103417765.0,291254,256986,40.17,40.24,548240,220402184.0,1350,637,606,115929202.0,99205531.0,288900,245873,40.13,40.35,534773,215134733.0,1243,2023-11-08 11:40:00
540,AFLT,554,637,88607808.0,81836978.0,220085,202836,40.26,40.35,422921,170444787.0,1191,481,570,85454529.0,81359893.0,212887,201665,40.14,40.34,414552,166814423.0,1051,2023-11-08 11:45:00
541,AFLT,477,567,69621174.0,69730428.0,173313,172842,40.17,40.34,346155,139351603.0,1044,449,523,71727342.0,69283655.0,178692,171714,40.14,40.35,350406,141010998.0,972,2023-11-08 11:50:00
542,AFLT,673,840,109377713.0,96546744.0,272443,239985,40.15,40.23,512428,205924457.0,1513,614,784,105252306.0,95925522.0,262181,237797,40.14,40.34,499978,201177829.0,1398,2023-11-08 11:55:00
543,AFLT,729,713,74733654.0,52427651.0,186041,130000,40.17,40.33,316041,127161305.0,1442,684,664,74290016.0,51383183.0,185033,127366,40.15,40.34,312399,125673200.0,1348,2023-11-08 12:00:00
544,AFLT,547,391,73759915.0,78464016.0,183694,194374,40.15,40.37,378068,152223932.0,938,490,358,71357955.0,76752612.0,177766,190121,40.14,40.37,367887,148110568.0,848,2023-11-08 12:05:00
545,AFLT,369,411,77130656.0,106526177.0,192416,264315,40.09,40.3,456731,183656834.0,780,297,282,74340612.0,102381477.0,185487,254030,40.08,40.3,439517,176722090.0,579,2023-11-08 12:10:00
546,AFLT,415,324,40607907.0,70664115.0,101145,175548,40.15,40.25,276693,111272022.0,739,372,269,41318562.0,70576612.0,103082,175274,40.08,40.27,278356,111895174.0,641,2023-11-08 12:15:00
547,AFLT,393,1079,67330881.0,309154973.0,168060,768738,40.06,40.22,936798,376485855.0,1472,377,1038,64042786.0,309026771.0,159864,768149,40.06,40.23,928013,373069557.0,1415,2023-11-08 12:20:00
548,AFLT,486,290,44955930.0,55861988.0,112030,138710,40.13,40.27,250740,100817918.0,776,428,256,43367785.0,49499320.0,108210,122907,40.08,40.27,231117,92867105.0,684,2023-11-08 12:25:00
549,AFLT,242,152,34329111.0,35770213.0,85701,88840,40.06,40.26,174541,70099324.0,394,224,105,34656959.0,40090539.0,86510,99539,40.06,40.28,186049,74747498.0,329,2023-11-08 12:30:00
550,AFLT,498,463,107047686.0,124678806.0,267712,282834,39.99,44.08,550546,231726492.0,961,430,378,98214586.0,107517111.0,245540,266907,40.0,40.28,512447,205731697.0,808,2023-11-08 12:35:00
551,AFLT,460,341,77582003.0,68414198.0,194012,170525,39.99,40.12,364537,145996201.0,801,388,250,75856552.0,66590285.0,189916,165835,39.94,40.15,355751,142446837.0,638,2023-11-08 12:40:00
552,AFLT,368,405,72702031.0,96640283.0,182078,240793,39.93,40.13,422871,169342315.0,773,307,328,71052736.0,94214584.0,177935,234681,39.93,40.15,412616,165267321.0,635,2023-11-08 12:45:00
553,AFLT,326,359,67439494.0,85061057.0,168866,212422,39.94,40.04,381288,152500551.0,685,263,268,65732258.0,80723262.0,164621,201067,39.93,40.15,365688,146455521.0,531,2023-11-08 12:50:00
554,AFLT,341,237,52667742.0,57096575.0,131587,142549,40.03,40.05,274136,109764318.0,578,280,200,52199695.0,56333535.0,130720,140357,39.93,40.14,271077,108533230.0,480,2023-11-08 12:55:00
555,AFLT,405,170,45418319.0,40989515.0,113613,102220,39.98,40.1,215833,86407834.0,575,363,128,43661517.0,40264083.0,109308,100291,39.94,40.15,209599,83925601.0,491,2023-11-08 13:00:00
556,AFLT,778,355,71418759.0,41590818.0,178439,103694,40.02,40.11,282133,113009577.0,1133,735,303,69821559.0,40338515.0,174613,100561,39.99,40.11,275174,110160074.0,1038,2023-11-08 13:05:00
557,AFLT,507,319,61797813.0,78879962.0,154518,196543,39.99,40.13,351061,140677776.0,826,437,283,60576896.0,78329613.0,151729,195135,39.92,40.14,346864,138906509.0,720,2023-11-08 13:10:00
558,AFLT,953,523,144230872.0,148237567.0,361718,358917,39.87,41.3,720635,292468440.0,1476,845,428,141941224.0,152304941.0,355951,342332,39.88,44.49,698283,294246166.0,1273,2023-11-08 13:15:00
559,AFLT,430,325,68121758.0,80705696.0,170921,201682,39.86,40.02,372603,148827454.0,755,348,276,64841120.0,79831345.0,162853,199299,39.82,40.06,362152,144672466.0,624,2023-11-08 13:20:00
560,AFLT,403,389,83902895.0,105442280.0,210807,263550,39.8,40.01,474357,189345176.0,792,325,345,80832548.0,99489981.0,203116,248522,39.8,40.03,451638,180322529.0,670,2023-11-08 13:25:00
561,AFLT,568,350,47613854.0,60930621.0,119452,152097,39.86,40.06,271549,108544476.0,918,507,321,48648589.0,61191662.0,122081,152756,39.85,40.06,274837,109840251.0,828,2023-11-08 13:30:00
562,AFLT,349,482,58260847.0,95887078.0,146341,240261,39.81,39.91,386602,154147926.0,831,314,408,55457239.0,93911224.0,139324,234395,39.8,40.07,373719,149368464.0,722,2023-11-08 13:35:00
563,AFLT,723,718,128297048.0,151531071.0,321053,378412,39.96,40.04,699465,279828119.0,1441,693,656,125704595.0,150997076.0,315203,376991,39.88,40.05,692194,276701672.0,1349,2023-11-08 13:40:00
564,AFLT,323,360,51597962.0,63208501.0,129369,158160,39.88,39.96,287529,114806464.0,683,258,330,51280545.0,62337835.0,128589,155613,39.88,40.06,284202,113618381.0,588,2023-11-08 13:45:00
565,AFLT,302,327,51710556.0,76580606.0,129861,190990,39.82,40.1,320851,128291163.0,629,232,301,50335794.0,75428687.0,126451,188080,39.81,40.1,314531,125764482.0,533,2023-11-08 13:50:00
566,AFLT,409,525,94236207.0,125832436.0,236351,313922,39.87,40.08,550273,220068644.0,934,389,503,93117930.0,126052535.0,233660,314493,39.85,40.08,548153,219170465.0,892,2023-11-08 13:55:00
567,AFLT,276,326,46129911.0,50835788.0,115605,126876,39.9,40.07,242481,96965699.0,602,240,307,48192688.0,51681163.0,120793,128944,39.9,40.08,249737,99873851.0,547,2023-11-08 14:00:00
568,AFLT,284,387,43994930.0,90097644.0,110421,225172,39.84,40.01,335593,134092575.0,671,248,363,42558951.0,89033511.0,106868,222190,39.82,40.07,329058,131592462.0,611,2023-11-08 14:05:00
569,AFLT,338,443,62972766.0,99423831.0,157415,247560,40.0,40.16,404975,162396597.0,781,272,385,59980854.0,95167339.0,150371,236955,39.89,40.16,387326,155148193.0,657,2023-11-08 14:10:00
570,AFLT,431,245,56558377.0,45236337.0,141545,112668,39.96,40.15,254213,101794714.0,676,392,226,53671581.0,48035317.0,134466,119595,39.91,40.16,254061,101706898.0,618,2023-11-08 14:15:00
571,AFLT,330,321,58795119.0,69673064.0,146996,173885,40.0,40.07,320881,128468183.0,651,281,293,57540527.0,68535455.0,144142,170763,39.92,40.13,314905,126075983.0,574,2023-11-08 14:20:00
572,AFLT,231,127,21939558.0,22446406.0,54802,55930,40.03,40.13,110732,44385964.0,358,176,114,21390795.0,19989845.0,53564,49809,39.94,40.13,103373,41380640.0,290,2023-11-08 14:25:00
573,AFLT,234,219,39686966.0,41823197.0,99384,104228,39.93,40.13,203612,81510164.0,453,215,167,39099579.0,41460217.0,97954,103316,39.92,40.13,201270,80559797.0,382,2023-11-08 14:30:00
574,AFLT,201,191,32295477.0,34921687.0,80916,86694,39.91,40.28,167610,67217165.0,392,145,149,32170530.0,33567614.0,80620,83591,39.9,40.16,164211,65738144.0,294,2023-11-08 14:35:00
575,AFLT,300,212,33843964.0,21029951.0,84785,52429,39.92,40.11,137214,54873915.0,512,246,165,33583050.0,20858472.0,84136,51971,39.92,40.13,136107,54441523.0,411,2023-11-08 14:40:00
576,AFLT,547,389,115977615.0,94885535.0,287948,235585,40.28,40.28,523533,210863150.0,936,477,325,109734205.0,93062072.0,274591,231060,39.96,40.28,505651,202796277.0,802,2023-11-08 14:45:00
577,AFLT,381,490,78786407.0,84720017.0,197145,210790,39.96,40.19,407935,163506425.0,871,322,471,78556003.0,83964858.0,196584,208772,39.96,40.22,405356,162520862.0,793,2023-11-08 14:50:00
578,AFLT,201,242,29699385.0,38584013.0,74415,96105,39.91,40.15,170520,68283398.0,443,164,221,28632955.0,37823313.0,71742,94190,39.91,40.16,165932,66456268.0,385,2023-11-08 14:55:00
579,AFLT,206,191,35214851.0,33533719.0,83290,83535,42.28,40.14,166825,68748571.0,397,160,164,32211834.0,33335455.0,80720,83013,39.91,40.16,163733,65547289.0,324,2023-11-08 15:00:00
580,AFLT,332,225,54692498.0,47745146.0,136897,118833,39.95,40.18,255730,102437644.0,557,300,203,54647307.0,46585722.0,136829,115825,39.94,40.22,252654,101233030.0,503,2023-11-08 15:05:00
581,AFLT,281,154,37936136.0,23198919.0,94930,57770,39.96,40.16,152700,61135056.0,435,222,127,36870289.0,23039770.0,92200,57340,39.99,40.18,149540,59910060.0,349,2023-11-08 15:10:00
582,AFLT,463,325,115877461.0,65494899.0,289761,162957,39.99,40.19,452718,181372361.0,788,432,295,115314411.0,64960834.0,288403,161390,39.98,40.25,449793,180275245.0,727,2023-11-08 15:15:00
583,AFLT,327,186,55372782.0,44518534.0,135646,110666,40.82,40.23,246312,99891316.0,513,286,147,56451762.0,43429473.0,136060,107990,41.49,40.22,244050,99881236.0,433,2023-11-08 15:20:00
584,AFLT,683,240,149341102.0,35974751.0,373106,89398,40.03,40.24,462504,185315853.0,923,639,203,148675104.0,35718247.0,371481,88756,40.02,40.24,460237,184393351.0,842,2023-11-08 15:25:00
585,AFLT,481,393,47257277.0,49978205.0,118052,124459,40.03,40.16,242511,97235483.0,874,450,372,46956803.0,50153690.0,117394,124874,40.0,40.16,242268,97110494.0,822,2023-11-08 15:30:00
586,AFLT,313,198,45834559.0,31958613.0,114561,79428,40.01,40.24,193989,77793173.0,511,287,183,46359038.0,32078425.0,115893,79741,40.0,40.23,195634,78437464.0,470,2023-11-08 15:35:00
587,AFLT,597,229,185532283.0,50273839.0,462995,125005,40.07,40.22,588000,235806123.0,826,544,211,184890670.0,49045159.0,461543,121895,40.06,40.24,583438,233935829.0,755,2023-11-08 15:40:00
588,AFLT,315,278,41981579.0,33537954.0,104531,83582,40.16,40.13,188113,75519534.0,593,270,247,40900224.0,32433698.0,102219,80641,40.01,40.22,182860,73333922.0,517,2023-11-08 15:45:00
589,AFLT,266,179,52506796.0,31515674.0,131489,78556,39.93,40.12,210045,84022470.0,445,246,159,50879854.0,31252407.0,127442,77707,39.92,40.22,205149,82132261.0,405,2023-11-08 15:50:00
590,AFLT,265,383,40956745.0,40397745.0,102363,100558,40.01,40.17,202921,81354490.0,648,234,363,40278344.0,40083106.0,100709,99673,39.99,40.21,200382,80361451.0,597,2023-11-08 15:55:00
591,AFLT,224,147,26133811.0,17508488.0,65107,43528,40.14,40.22,108635,43642299.0,371,186,131,25252682.0,17437123.0,63154,43347,39.99,40.23,106501,42689805.0,317,2023-11-08 16:00:00
592,AFLT,477,175,48653040.0,38629171.0,121499,95936,40.04,40.27,217435,87282212.0,652,401,156,48493221.0,38350902.0,121190,95234,40.01,40.27,216424,86844124.0,557,2023-11-08 16:05:00
593,AFLT,206,174,8689120.0,24368793.0,21726,60475,39.99,40.3,82201,33057913.0,380,183,156,10150246.0,24122578.0,25409,59840,39.95,40.31,85249,34272825.0,339,2023-11-08 16:10:00
594,AFLT,288,185,38733559.0,24069280.0,96754,60064,40.03,40.07,156818,62802840.0,473,246,152,38124976.0,23856423.0,95241,59262,40.03,40.26,154503,61981400.0,398,2023-11-08 16:15:00
595,AFLT,342,159,45061212.0,26769776.0,112487,66464,40.06,40.28,178951,71830988.0,501,283,107,44436035.0,26383793.0,111033,65448,40.02,40.31,176481,70819828.0,390,2023-11-08 16:20:00
596,AFLT,217,156,18880020.0,22440598.0,47191,55722,40.01,40.27,102913,41320619.0,373,190,111,18540298.0,21633469.0,46350,53664,40.0,40.31,100014,40173767.0,301,2023-11-08 16:25:00
597,AFLT,344,272,41350714.0,36513096.0,103251,91180,40.05,40.05,194431,77863810.0,616,298,233,45103920.0,35705195.0,112806,88788,39.98,40.21,201594,80809116.0,531,2023-11-08 16:30:00
598,AFLT,382,278,45951342.0,35026463.0,114854,87114,40.01,40.21,201968,80977805.0,660,375,218,44402962.0,34848639.0,110998,86643,40.0,40.22,197641,79251601.0,593,2023-11-08 16:35:00
599,AFLT,380,437,72201575.0,75318378.0,180695,187240,39.96,40.23,367935,147519953.0,817,321,299,71963608.0,74273433.0,180053,184600,39.97,40.23,364653,146237042.0,620,2023-11-08 16:40:00
600,AFLT,572,740,111932760.0,103272395.0,280838,257312,39.86,40.14,538150,215205156.0,1312,522,656,107262006.0,92880709.0,269092,231272,39.86,40.16,500364,200142716.0,1178,2023-11-08 16:45:00
601,AFLT,622,936,124717894.0,138566984.0,312935,346542,39.85,39.99,659477,263284878.0,1558,521,762,123663328.0,135476023.0,310285,337998,39.85,40.08,648283,259139352.0,1283,2023-11-08 16:50:00
602,AFLT,477,1011,77525455.0,121681525.0,194029,303537,39.96,40.09,497566,199206980.0,1488,432,950,73900512.0,120886935.0,185479,301591,39.84,40.08,487070,194787448.0,1382,2023-11-08 16:55:00
603,AFLT,403,470,59798068.0,70161688.0,150058,175211,39.85,40.04,325269,129959757.0,873,319,430,59072514.0,68949687.0,148267,172139,39.84,40.05,320406,128022201.0,749,2023-11-08 17:00:00
604,AFLT,439,537,25922967.0,41540282.0,65034,104059,39.86,39.92,169093,67463250.0,976,412,483,27738007.0,42139977.0,69735,105151,39.78,40.08,174886,69877984.0,895,2023-11-08 17:05:00
605,AFLT,504,244,35275348.0,54253870.0,88411,135160,39.9,40.14,223571,89529219.0,748,456,203,34680336.0,53453602.0,87099,133167,39.82,40.14,220266,88133938.0,659,2023-11-08 17:10:00
606,AFLT,401,349,20976806.0,31082398.0,52624,77496,39.86,40.11,130120,52059205.0,750,355,276,18680777.0,30651056.0,46955,76510,39.78,40.06,123465,49331833.0,631,2023-11-08 17:15:00
607,AFLT,855,516,33332810.0,57687947.0,83559,143785,39.89,40.12,227344,91020757.0,1371,830,475,34217129.0,58964770.0,85802,146986,39.88,40.12,232788,93181900.0,1305,2023-11-08 17:20:00
608,AFLT,189,224,23778235.0,34019811.0,59679,84929,39.84,40.06,144608,57798046.0,413,184,177,24050243.0,33398807.0,60370,83176,39.84,40.15,143546,57449050.0,361,2023-11-08 17:25:00
609,AFLT,108,113,10677650.0,19266455.0,26780,47976,39.87,40.16,74756,29944105.0,221,90,81,10160917.0,18919319.0,25573,46944,39.73,40.3,72517,29080237.0,171,2023-11-08 17:30:00
610,AFLT,165,93,5653289.0,9343185.0,14191,23301,39.84,40.1,37492,14996474.0,258,123,69,6082365.0,10212632.0,15317,25464,39.71,40.11,40781,16294997.0,192,2023-11-08 17:35:00
611,AFLT,118,153,7978704.0,6615749.0,19987,16524,39.92,40.04,36511,14594453.0,271,127,116,8540981.0,7167565.0,21434,17884,39.85,40.08,39318,15708546.0,243,2023-11-08 17:40:00
612,AFLT,291,241,14981482.0,21875878.0,37456,54665,40.0,40.02,92121,36857361.0,532,249,147,16779787.0,20810563.0,42049,51930,39.91,40.07,93979,37590351.0,396,2023-11-08 17:45:00
613,AFLT,163,272,9685168.0,13385861.0,24145,33423,40.11,40.05,57568,23071030.0,435,145,109,8042153.0,13832901.0,20206,34507,39.8,40.09,54713,21875054.0,254,2023-11-08 17:50:00
614,AFLT,271,235,23671779.0,31968715.0,58796,80073,40.26,39.92,138869,55640494.0,506,242,158,21876932.0,29427215.0,54842,73427,39.89,40.08,128269,51304148.0,400,2023-11-08 17:55:00
615,AFLT,306,265,16445318.0,25096195.0,41159,62665,39.96,40.05,103824,41541514.0,571,251,239,20532971.0,28752618.0,51538,71746,39.84,40.08,123284,49285590.0,490,2023-11-08 18:00:00
616,AFLT,301,455,47844904.0,51543232.0,119856,128704,39.92,40.05,248560,99388136.0,756,314,428,47857631.0,51706352.0,119994,129056,39.88,40.07,249050,99563984.0,742,2023-11-08 18:05:00
617,AFLT,202,175,9283483.0,13167357.0,23162,33009,40.08,39.89,56171,22450841.0,377,132,147,8519182.0,12858782.0,21355,32112,39.89,40.04,53467,21377965.0,279,2023-11-08 18:10:00
618,AFLT,203,137,14713440.0,18671936.0,36819,46831,39.96,39.87,83650,33385377.0,340,175,121,13659018.0,16772961.0,34233,41885,39.9,40.05,76118,30431979.0,296,2023-11-08 18:15:00
619,AFLT,161,45,8409381.0,1271189.0,21128,3178,39.8,40.0,24306,9680570.0,206,145,33,8289074.0,1240062.0,20855,3098,39.75,40.03,23953,9529136.0,178,2023-11-08 18:20:00
620,AFLT,148,76,7230312.0,5930690.0,18110,14849,39.92,39.94,32959,13161003.0,224,110,69,6787463.0,5586053.0,17009,13956,39.91,40.03,30965,12373516.0,179,2023-11-08 18:25:00
621,AFLT,272,140,14779847.0,20881241.0,37408,52769,39.51,39.57,90177,35661089.0,412,206,106,14788347.0,19888053.0,37118,49660,39.84,40.05,86778,34676400.0,312,2023-11-08 18:30:00
622,AFLT,420,222,35227545.0,43431780.0,88162,108544,39.96,40.01,196706,78659325.0,642,366,187,33529611.0,42465856.0,84243,106075,39.8,40.03,190318,75995467.0,553,2023-11-08 18:35:00
623,AFLT,569,162,24611533.0,36566140.0,61651,91313,39.92,40.04,152964,61177674.0,731,572,156,24676366.0,37943753.0,61905,94699,39.86,40.07,156604,62620119.0,728,2023-11-08 18:40:00
624,AFLT,1091,1752,120812726.0,163097570.0,306294,396801,39.44,41.1,703095,283910296.0,2843,702,947,101600191.0,117487591.0,254881,293611,39.86,40.01,548492,219087782.0,1649,2023-11-09 10:05:00
625,AFLT,510,725,31138682.0,60782118.0,78130,151993,39.85,39.99,230123,91920800.0,1235,423,558,29912393.0,58049481.0,75036,145048,39.86,40.02,220084,87961874.0,981,2023-11-09 10:10:00
626,AFLT,1841,1623,401018638.0,309628757.0,1004430,775051,39.92,39.95,1779481,710647395.0,3464,1717,1465,392734655.0,302232577.0,986066,756212,39.83,39.97,1742278,694967232.0,3182,2023-11-09 10:15:00
627,AFLT,784,894,102285048.0,132716801.0,258547,332885,39.56,39.87,591432,235001850.0,1678,673,711,98237350.0,128497075.0,247938,321482,39.62,39.97,569420,226734425.0,1384,2023-11-09 10:20:00
628,AFLT,766,974,130070310.0,173804356.0,328148,434704,39.64,39.98,762852,303874666.0,1740,609,871,126353232.0,169840840.0,318766,424796,39.64,39.98,743562,296194073.0,1480,2023-11-09 10:25:00
629,AFLT,829,913,122199584.0,146629896.0,308108,366882,39.66,39.97,674990,268829481.0,1742,685,782,121461431.0,144571448.0,305917,361955,39.7,39.94,667872,266032879.0,1467,2023-11-09 10:30:00
630,AFLT,619,551,81818666.0,92290340.0,210024,231028,38.96,39.95,441052,174109007.0,1170,556,497,73729158.0,90466600.0,185719,226455,39.7,39.95,412174,164195759.0,1053,2023-11-09 10:35:00
631,AFLT,505,1024,124045731.0,178260000.0,312139,445935,39.74,39.97,758074,302305731.0,1529,439,843,122441333.0,177024373.0,308439,442614,39.7,40.0,751053,299465707.0,1282,2023-11-09 10:40:00
632,AFLT,743,850,133750932.0,183587471.0,337019,458981,39.69,40.0,796000,317338404.0,1593,679,785,131692384.0,182982143.0,331885,457231,39.68,40.02,789116,314674527.0,1464,2023-11-09 10:45:00
633,AFLT,588,536,102010993.0,99632961.0,258748,249384,39.42,39.95,508132,201643954.0,1124,522,468,96358345.0,98482861.0,242967,246204,39.66,40.0,489171,194841206.0,990,2023-11-09 10:50:00
634,AFLT,533,898,100698641.0,135124142.0,253703,337909,39.69,39.99,591612,235822784.0,1431,485,836,98730495.0,133031878.0,248818,332585,39.68,40.0,581403,231762374.0,1321,2023-11-09 10:55:00
635,AFLT,901,1941,278574655.0,356065868.0,703298,897086,39.61,39.69,1600384,634640524.0,2842,743,1739,270908476.0,343803020.0,684448,862560,39.58,39.86,1547008,614711497.0,2482,2023-11-09 11:00:00
636,AFLT,535,1190,161485400.0,163809509.0,408370,412423,39.54,39.72,820793,325294910.0,1725,427,1072,160113969.0,147306589.0,405014,370431,39.53,39.77,775445,307420558.0,1499,2023-11-09 11:05:00
637,AFLT,476,716,111994170.0,133601977.0,283403,336408,39.52,39.71,619811,245596148.0,1192,347,625,105532848.0,132289925.0,266974,333012,39.53,39.73,599986,237822773.0,972,2023-11-09 11:10:00
638,AFLT,420,598,96405631.0,100209471.0,243837,252267,39.54,39.72,496104,196615103.0,1018,346,464,94589847.0,97203257.0,239345,244573,39.52,39.74,483918,191793104.0,810,2023-11-09 11:15:00
639,AFLT,449,826,101564509.0,102006387.0,256481,256415,39.6,39.78,512896,203570896.0,1275,363,740,98709004.0,98778572.0,249593,248324,39.55,39.78,497917,197487576.0,1103,2023-11-09 11:20:00
640,AFLT,201,257,36989541.0,38430588.0,93576,96720,39.53,39.73,190296,75420129.0,458,166,194,36496120.0,45760957.0,92250,115096,39.56,39.76,207346,82257078.0,360,2023-11-09 11:25:00
641,AFLT,337,521,74866088.0,99950118.0,189505,251367,39.51,39.76,440872,174816206.0,858,309,439,72964532.0,93959219.0,184615,236229,39.52,39.77,420844,166923752.0,748,2023-11-09 11:30:00
642,AFLT,1577,2026,486509835.0,581898359.0,1234309,1467994,39.42,39.64,2702303,1068408194.0,3603,1364,1730,475151958.0,563103451.0,1206498,1419110,39.38,39.68,2625608,1038255410.0,3094,2023-11-09 11:35:00
643,AFLT,1411,1721,375003476.0,477638158.0,951153,1203667,39.43,39.68,2154820,852641634.0,3132,1275,1594,367647664.0,473112905.0,932761,1191233,39.41,39.72,2123994,840760570.0,2869,2023-11-09 11:40:00
644,AFLT,361,469,68474148.0,81414301.0,173625,205716,39.44,39.58,379341,149888449.0,830,319,421,68526602.0,79589047.0,173764,200664,39.44,39.66,374428,148115650.0,740,2023-11-09 11:45:00
645,AFLT,998,1188,240579503.0,277830410.0,611195,695461,39.36,39.95,1306656,518409913.0,2186,905,1076,237360902.0,271099733.0,603011,683848,39.36,39.64,1286859,508460636.0,1981,2023-11-09 11:50:00
646,AFLT,622,1005,131559561.0,200014169.0,333748,505110,39.42,39.6,838858,331573730.0,1627,534,908,127689903.0,199447459.0,324136,503575,39.39,39.61,827711,327137363.0,1442,2023-11-09 11:55:00
647,AFLT,480,772,106280164.0,116010920.0,269870,292911,39.38,39.61,562781,222291084.0,1252,425,704,106091759.0,115058257.0,269321,290363,39.39,39.63,559684,221150016.0,1129,2023-11-09 12:00:00
648,AFLT,457,696,123468496.0,129450926.0,313911,327132,39.33,39.57,641043,252919423.0,1153,367,622,119698724.0,125515324.0,304244,317084,39.34,39.58,621328,245214048.0,989,2023-11-09 12:05:00
649,AFLT,278,524,55887420.0,77213993.0,142053,195078,39.34,39.58,337131,133101413.0,802,223,466,53811015.0,77538204.0,136813,195867,39.33,39.59,332680,131349219.0,689,2023-11-09 12:10:00
650,AFLT,535,479,91529230.0,98342220.0,232195,248544,39.42,39.57,480739,189871451.0,1014,418,355,88934715.0,96285912.0,225966,243312,39.36,39.57,469278,185220627.0,773,2023-11-09 12:15:00
651,AFLT,724,1093,83404844.0,123870577.0,211730,313217,39.39,39.55,524947,207275421.0,1817,672,1025,83939370.0,123689138.0,210640,312478,39.85,39.58,523118,207628509.0,1697,2023-11-09 12:20:00
652,AFLT,554,592,111861300.0,138339119.0,283982,349401,39.39,39.59,633383,250200420.0,1146,497,514,110146142.0,136793384.0,279846,345358,39.36,39.61,625204,246939526.0,1011,2023-11-09 12:25:00
653,AFLT,562,554,107757567.0,134993455.0,273959,340738,39.33,39.62,614697,242751022.0,1116,507,524,106964837.0,133850465.0,272047,337864,39.32,39.62,609911,240815303.0,1031,2023-11-09 12:30:00
654,AFLT,245,279,46691504.0,91952811.0,118554,232281,39.38,39.59,350835,138644316.0,524,208,221,45961043.0,91007986.0,116763,229904,39.36,39.59,346667,136969030.0,429,2023-11-09 12:35:00
655,AFLT,263,323,44426025.0,59054157.0,112883,149136,39.36,39.6,262019,103480182.0,586,218,252,42419054.0,58515491.0,107728,147701,39.38,39.62,255429,100934546.0,470,2023-11-09 12:40:00
656,AFLT,364,408,64607707.0,82250917.0,164070,207806,39.38,39.58,371876,146858624.0,772,306,331,63986574.0,81320135.0,162543,205437,39.37,39.58,367980,145306710.0,637,2023-11-09 12:45:00
657,AFLT,557,653,121752566.0,138991681.0,309406,351372,39.35,39.56,660778,260744248.0,1210,493,586,120280372.0,137282737.0,305754,346801,39.34,39.59,652555,257563109.0,1079,2023-11-09 12:50:00
658,AFLT,462,600,92658408.0,116524160.0,235125,293894,39.41,39.65,529019,209182568.0,1062,397,541,88524410.0,114844330.0,224873,289723,39.37,39.64,514596,203368740.0,938,2023-11-09 12:55:00
659,AFLT,214,323,41691653.0,54304489.0,105307,137017,39.59,39.63,242324,95996143.0,537,178,287,40019773.0,55344514.0,101538,139612,39.41,39.64,241150,95364287.0,465,2023-11-09 13:00:00
660,AFLT,310,471,78779026.0,97472102.0,199796,246105,39.43,39.61,445901,176251128.0,781,284,396,77934830.0,95841307.0,197760,241949,39.41,39.61,439709,173776138.0,680,2023-11-09 13:05:00
661,AFLT,746,752,135471666.0,154786182.0,344262,391088,39.35,39.58,735350,290257848.0,1498,703,676,135206606.0,152642031.0,343611,385325,39.35,39.61,728936,287848637.0,1379,2023-11-09 13:10:00
662,AFLT,349,472,73321341.0,74846526.0,186433,189202,39.33,39.56,375635,148167867.0,821,268,376,72002506.0,73351803.0,183097,185350,39.32,39.57,368447,145354309.0,644,2023-11-09 13:15:00
663,AFLT,229,306,55716959.0,58850506.0,140845,148876,39.56,39.53,289721,114567465.0,535,197,239,52603728.0,58433532.0,133850,147758,39.3,39.55,281608,111037260.0,436,2023-11-09 13:20:00
664,AFLT,327,290,57827770.0,52919642.0,147072,133813,39.32,39.55,280885,110747413.0,617,299,247,49972894.0,51911007.0,126977,131260,39.36,39.55,258237,101883902.0,546,2023-11-09 13:25:00
665,AFLT,380,323,60800251.0,52352802.0,154398,132202,39.38,39.6,286600,113153054.0,703,329,256,60671363.0,52106589.0,154188,131526,39.35,39.62,285714,112777953.0,585,2023-11-09 13:30:00
666,AFLT,432,537,90743107.0,112147659.0,230749,283278,39.33,39.59,514027,202890767.0,969,395,479,88165763.0,111875059.0,224096,282451,39.34,39.61,506547,200040823.0,874,2023-11-09 13:35:00
667,AFLT,199,240,33910903.0,37426548.0,86193,94474,39.34,39.62,180667,71337452.0,439,196,194,34089748.0,38062883.0,86652,96030,39.34,39.64,182682,72152631.0,390,2023-11-09 13:40:00
668,AFLT,918,1249,214602983.0,267138603.0,542612,674179,39.55,39.62,1216791,481741587.0,2167,828,1141,209643274.0,265637073.0,532728,670303,39.35,39.63,1203031,475280347.0,1969,2023-11-09 13:45:00
669,AFLT,604,1593,131758132.0,186608600.0,334416,471394,39.4,39.59,805810,318366733.0,2197,606,1531,131132034.0,185998556.0,333022,469729,39.38,39.6,802751,317130590.0,2137,2023-11-09 13:50:00
670,AFLT,404,426,74507418.0,73302170.0,189037,185411,39.41,39.53,374448,147809589.0,830,370,377,74106679.0,72019598.0,188288,181642,39.36,39.65,369930,146126278.0,747,2023-11-09 13:55:00
671,AFLT,323,294,67301857.0,56589735.0,170913,142958,39.38,39.58,313871,123891592.0,617,285,270,68252847.0,58350474.0,173376,147408,39.37,39.58,320784,126603322.0,555,2023-11-09 14:00:00
672,AFLT,205,236,34804408.0,39527640.0,88521,99898,39.32,39.57,188419,74332048.0,441,202,200,34894352.0,38947622.0,88769,98418,39.31,39.57,187187,73841974.0,402,2023-11-09 14:05:00
673,AFLT,2133,1956,725264986.0,522258608.0,1844633,1325983,39.32,39.39,3170616,1247523595.0,4089,1875,1701,703500234.0,502416626.0,1792985,1272042,39.24,39.5,3065027,1205916861.0,3576,2023-11-09 14:10:00
674,AFLT,1855,1800,586005552.0,542522699.0,1492946,1379005,39.25,39.34,2871951,1128528252.0,3655,1634,1632,566957660.0,529671441.0,1446936,1341522,39.18,39.48,2788458,1096629102.0,3266,2023-11-09 14:15:00
675,AFLT,1362,2839,414042431.0,623927145.0,1055124,1587689,39.24,39.3,2642813,1037969577.0,4201,1197,2056,395940074.0,606127573.0,1012259,1536163,39.11,39.46,2548422,1002067647.0,3253,2023-11-09 14:20:00
676,AFLT,530,712,141490757.0,137499215.0,361155,349105,39.18,39.39,710260,278989972.0,1242,419,569,129941114.0,136220646.0,331776,345697,39.17,39.4,677473,266161760.0,988,2023-11-09 14:25:00
677,AFLT,645,710,134009585.0,135863603.0,341700,344708,39.22,39.41,686408,269873188.0,1355,389,580,124577928.0,133296956.0,317927,338063,39.18,39.43,655990,257874885.0,969,2023-11-09 14:30:00
678,AFLT,424,552,104257892.0,101970398.0,266134,258623,39.17,39.43,524757,206228290.0,976,380,478,103365563.0,103760468.0,263888,263015,39.17,39.45,526903,207126031.0,858,2023-11-09 14:35:00
679,AFLT,292,387,73476096.0,74943045.0,179035,190049,41.04,39.43,369084,148419141.0,679,236,347,67512501.0,75216482.0,172294,190615,39.18,39.46,362909,142728983.0,583,2023-11-09 14:40:00
680,AFLT,429,512,100106306.0,108487814.0,255352,275573,39.2,39.37,530925,208594121.0,941,367,450,103069539.0,101897064.0,263271,258363,39.15,39.44,521634,204966604.0,817,2023-11-09 14:45:00
681,AFLT,608,845,162839294.0,169593848.0,415403,429801,39.2,39.46,845204,332433142.0,1453,546,762,160401531.0,169406525.0,409441,429304,39.18,39.46,838745,329808056.0,1308,2023-11-09 14:50:00
682,AFLT,415,465,123068851.0,125863873.0,313398,304745,39.27,41.3,618143,248932724.0,880,396,396,122479126.0,118454511.0,312317,300014,39.22,39.48,612331,240933638.0,792,2023-11-09 14:55:00
683,AFLT,403,514,109470536.0,104847086.0,275617,265333,39.72,39.52,540950,214317622.0,917,332,441,104546947.0,104549289.0,266359,264564,39.25,39.52,530923,209096236.0,773,2023-11-09 15:00:00
684,AFLT,479,607,132811393.0,120731166.0,338212,305747,39.27,39.49,643959,253542560.0,1086,407,526,132168377.0,120172333.0,336899,304351,39.23,39.48,641250,252340711.0,933,2023-11-09 15:05:00
685,AFLT,680,734,193507985.0,183476353.0,492780,465024,39.27,39.46,957804,376984338.0,1414,593,644,190837596.0,181563058.0,486290,459450,39.24,39.52,945740,372400654.0,1237,2023-11-09 15:10:00
686,AFLT,606,620,132692861.0,125612644.0,337912,318210,39.27,39.47,656122,258305506.0,1226,540,547,133978081.0,124687031.0,341260,315520,39.26,39.52,656780,258665112.0,1087,2023-11-09 15:15:00
687,AFLT,542,542,143055083.0,145492679.0,363230,368002,39.38,39.54,731232,288547762.0,1084,496,465,138951017.0,142995143.0,354165,361705,39.23,39.53,715870,281946161.0,961,2023-11-09 15:20:00
688,AFLT,371,359,89039582.0,74903112.0,226374,189447,39.33,39.54,415821,163942695.0,730,331,294,86955438.0,70966017.0,221275,179508,39.3,39.53,400783,157921455.0,625,2023-11-09 15:25:00
689,AFLT,309,432,63255223.0,73265478.0,161192,185333,39.24,39.53,346525,136520702.0,741,278,362,64191445.0,71758595.0,163589,181470,39.24,39.54,345059,135950041.0,640,2023-11-09 15:30:00
690,AFLT,213,339,52647872.0,60185753.0,134162,152459,39.24,39.48,286621,112833625.0,552,176,289,52554136.0,64790855.0,133996,150080,39.22,43.17,284076,117344991.0,465,2023-11-09 15:35:00
691,AFLT,496,1201,95990597.0,151708588.0,244750,385297,39.22,39.37,630047,247699185.0,1697,446,1118,94203636.0,148397453.0,240166,376301,39.22,39.44,616467,242601089.0,1564,2023-11-09 15:40:00
692,AFLT,440,1040,103245592.0,140788402.0,263360,358105,39.2,39.31,621465,244033995.0,1480,344,971,101424383.0,139122298.0,258742,352897,39.2,39.42,611639,240546681.0,1315,2023-11-09 15:45:00
693,AFLT,612,735,133741356.0,136339689.0,340657,345505,39.26,39.46,686162,270081045.0,1347,558,644,129409984.0,135748141.0,329997,343957,39.22,39.47,673954,265158126.0,1202,2023-11-09 15:50:00
694,AFLT,1420,987,243757857.0,167167570.0,621050,424368,39.25,39.39,1045418,410925428.0,2407,1327,906,241893033.0,166591002.0,616365,422358,39.25,39.44,1038723,408484036.0,2233,2023-11-09 15:55:00
695,AFLT,420,1104,81761411.0,137590051.0,208169,349200,39.28,39.4,557369,219351462.0,1524,345,1013,79688346.0,136689181.0,203065,346891,39.24,39.4,549956,216377528.0,1358,2023-11-09 16:00:00
696,AFLT,842,1153,203128904.0,225640751.0,517832,572200,39.23,39.43,1090032,428769656.0,1995,755,1051,201308204.0,227462349.0,513318,576546,39.22,39.45,1089864,428770554.0,1806,2023-11-09 16:05:00
697,AFLT,984,2464,285426690.0,478326130.0,724107,1213747,39.42,39.41,1937854,763752821.0,3448,922,2353,275760854.0,473637268.0,703497,1200672,39.2,39.45,1904169,749398123.0,3275,2023-11-09 16:10:00
698,AFLT,302,669,63624251.0,67088982.0,161906,170052,39.3,39.45,331958,130713233.0,971,227,556,64489454.0,66447727.0,164263,168255,39.26,39.49,332518,130937181.0,783,2023-11-09 16:15:00
699,AFLT,500,937,131568124.0,127691352.0,335056,323223,39.27,39.51,658279,259259477.0,1437,455,874,129786350.0,124105469.0,331035,314132,39.21,39.51,645167,253891819.0,1329,2023-11-09 16:20:00
700,AFLT,826,1286,248439304.0,288888684.0,633311,732137,39.23,39.46,1365448,537327989.0,2112,760,1187,246280926.0,281969386.0,628299,713940,39.2,39.49,1342239,528250313.0,1947,2023-11-09 16:25:00
701,AFLT,963,1524,223272612.0,320680569.0,568975,812073,39.24,39.49,1381048,543953181.0,2487,840,1393,221812121.0,320813964.0,565583,812419,39.22,39.49,1378002,542626085.0,2233,2023-11-09 16:30:00
702,AFLT,654,1026,176377112.0,190490229.0,449329,482559,39.25,39.48,931888,366867342.0,1680,621,940,173714998.0,189813649.0,442755,480820,39.24,39.48,923575,363528648.0,1561,2023-11-09 16:35:00
703,AFLT,938,1488,234882047.0,311112422.0,598588,788233,39.24,39.47,1386821,545994469.0,2426,804,1328,229124426.0,307401818.0,584030,778304,39.23,39.5,1362334,536526245.0,2132,2023-11-09 16:40:00
704,AFLT,440,1229,67461295.0,142784874.0,171922,363374,39.24,39.29,535296,210246169.0,1669,423,1169,73375514.0,144741580.0,187116,367132,39.21,39.42,554248,218117095.0,1592,2023-11-09 16:45:00
705,AFLT,271,806,62961815.0,116401160.0,160629,295299,39.2,39.42,455928,179362976.0,1077,230,733,61287124.0,117079622.0,156410,297009,39.18,39.42,453419,178366746.0,963,2023-11-09 16:50:00
706,AFLT,370,583,93417597.0,109792493.0,239290,278692,39.04,39.4,517982,203210090.0,953,308,508,88530270.0,104424804.0,225838,264792,39.2,39.44,490630,192955075.0,816,2023-11-09 16:55:00
707,AFLT,247,567,58047950.0,131403492.0,148098,330382,39.2,39.77,478480,189451442.0,814,191,528,57565888.0,98667552.0,146875,249445,39.19,39.55,396320,156233441.0,719,2023-11-09 17:00:00
708,AFLT,278,432,30692273.0,44585343.0,77999,113141,39.35,39.41,191140,75277617.0,710,242,374,29963150.0,45179983.0,76461,114649,39.19,39.41,191110,75143134.0,616,2023-11-09 17:05:00
709,AFLT,205,369,27621438.0,54351326.0,70467,137695,39.2,39.47,208162,81972764.0,574,194,336,27489852.0,53585449.0,71238,135610,38.59,39.51,206848,81075301.0,530,2023-11-09 17:10:00
710,AFLT,396,812,49444078.0,87496396.0,125989,221613,39.24,39.48,347602,136940475.0,1208,340,726,49367569.0,87762756.0,125835,222629,39.23,39.42,348464,137130325.0,1066,2023-11-09 17:15:00
711,AFLT,225,1156,26151027.0,116286994.0,66843,295341,39.12,39.37,362184,142438021.0,1381,207,1100,26281175.0,109327416.0,67232,277234,39.09,39.44,344466,135608591.0,1307,2023-11-09 17:20:00
712,AFLT,263,706,31883460.0,82125417.0,81570,208170,39.09,39.45,289740,114008878.0,969,208,658,34095876.0,83005541.0,87189,210096,39.11,39.51,297285,117101418.0,866,2023-11-09 17:25:00
713,AFLT,325,693,39656951.0,76830253.0,101009,194568,39.26,39.49,295577,116487204.0,1018,228,625,38765053.0,76810446.0,98903,194523,39.2,39.49,293426,115575499.0,853,2023-11-09 17:30:00
714,AFLT,238,249,19048348.0,26670251.0,45893,67500,41.51,39.51,113393,45718599.0,487,184,189,18818358.0,25114722.0,48249,63580,39.0,39.5,111829,43933080.0,373,2023-11-09 17:35:00
715,AFLT,176,203,16094271.0,30938063.0,40826,78141,39.42,39.59,118967,47032335.0,379,174,155,15671098.0,30378255.0,40069,76687,39.11,39.61,116756,46049353.0,329,2023-11-09 17:40:00
716,AFLT,444,474,39163838.0,34763108.0,100480,88878,38.98,39.11,189358,73926947.0,918,418,281,38098803.0,33533664.0,97694,84860,39.0,39.52,182554,71632467.0,699,2023-11-09 17:45:00
717,AFLT,626,359,31662242.0,31733061.0,80917,80251,39.13,39.54,161168,63395303.0,985,520,205,33803131.0,34902884.0,86423,88369,39.11,39.5,174792,68706016.0,725,2023-11-09 17:50:00
718,AFLT,1058,555,56216377.0,64986653.0,143165,165082,39.27,39.37,308247,121203030.0,1613,956,356,54411561.0,64193671.0,138599,162558,39.26,39.49,301157,118605233.0,1312,2023-11-09 17:55:00
719,AFLT,639,276,70916428.0,58654566.0,191650,144661,37.0,40.55,336311,129570994.0,915,588,198,66215380.0,53382337.0,178716,131901,37.05,40.47,310617,119597718.0,786,2023-11-09 18:00:00
720,AFLT,1480,937,123372280.0,121777843.0,313780,307980,39.32,39.54,621760,245150123.0,2417,1428,859,126054995.0,127972234.0,321972,323056,39.15,39.61,645028,254027230.0,2287,2023-11-09 18:05:00
721,AFLT,757,819,101582723.0,92298315.0,258070,233694,39.36,39.5,491764,193881039.0,1576,652,690,87590931.0,84836526.0,222715,214627,39.33,39.53,437342,172427458.0,1342,2023-11-09 18:10:00
722,AFLT,913,1061,155591417.0,137289452.0,394376,332096,39.45,41.34,726472,292880869.0,1974,800,868,145588406.0,132871571.0,369644,335567,39.39,39.6,705211,278459977.0,1668,2023-11-09 18:15:00
723,AFLT,375,372,32213639.0,24558987.0,81686,62030,39.44,39.59,143716,56772627.0,747,347,265,30290863.0,24220156.0,77031,61102,39.32,39.64,138133,54511020.0,612,2023-11-09 18:20:00
724,AFLT,399,632,31421951.0,44203938.0,79631,111609,39.46,39.61,191240,75625889.0,1031,331,545,32507006.0,40913096.0,82523,103242,39.39,39.63,185765,73420103.0,876,2023-11-09 18:25:00
725,AFLT,381,392,46031289.0,38839621.0,116882,98272,39.38,39.52,215154,84870911.0,773,357,344,46499875.0,40748157.0,118175,102937,39.35,39.59,221112,87248032.0,701,2023-11-09 18:30:00
726,AFLT,643,340,24048048.0,27818853.0,61043,55554,39.4,50.08,116597,51866901.0,983,610,293,22248467.0,26442083.0,56567,52080,39.33,50.77,108647,48690551.0,903,2023-11-09 18:35:00
727,AFLT,692,361,30803288.0,41162318.0,78217,103869,39.38,39.63,182086,71965606.0,1053,683,332,31336067.0,40857860.0,79628,103060,39.35,39.64,182688,72193927.0,1015,2023-11-09 18:40:00
728,AFLT,1454,3200,186938185.0,723123040.0,479453,1823501,38.99,39.66,2302954,910061225.0,4654,954,2302,166427251.0,685550897.0,423912,1737450,39.26,39.46,2161362,851978148.0,3256,2023-11-10 10:05:00
729,AFLT,919,2333,97787646.0,622260505.0,248750,1577101,39.31,39.46,1825851,720048152.0,3252,769,2173,91428004.0,616891917.0,232675,1563525,39.29,39.46,1796200,708319921.0,2942,2023-11-10 10:10:00
730,AFLT,1791,2210,168435011.0,570954094.0,429305,1437199,39.23,39.73,1866504,739389106.0,4001,1654,1969,166551752.0,529365366.0,424552,1343174,39.23,39.41,1767726,695917118.0,3623,2023-11-10 10:15:00
731,AFLT,1109,1544,106355641.0,380134562.0,272157,966057,39.08,39.35,1238214,486490203.0,2653,815,1329,94050752.0,367120476.0,240645,932599,39.08,39.37,1173244,461171228.0,2144,2023-11-10 10:20:00
732,AFLT,802,630,137172976.0,127413023.0,351832,323694,38.99,39.36,675526,264586000.0,1432,630,481,132190397.0,124487523.0,339024,316067,38.99,39.39,655091,256677920.0,1111,2023-11-10 10:25:00
733,AFLT,546,525,95970371.0,98707561.0,245442,251284,39.1,39.28,496726,194677933.0,1071,350,371,88881486.0,94271260.0,227407,239609,39.08,39.34,467016,183152746.0,721,2023-11-10 10:30:00
734,AFLT,445,510,89074160.0,99174243.0,228198,252274,39.03,39.31,480472,188248403.0,955,339,375,83350215.0,94388069.0,213328,239802,39.07,39.36,453130,177738284.0,714,2023-11-10 10:35:00
735,AFLT,213,250,43047887.0,41775859.0,109988,106176,39.14,39.35,216164,84823746.0,463,165,191,41957730.0,40490880.0,107228,102905,39.13,39.35,210133,82448610.0,356,2023-11-10 10:40:00
736,AFLT,408,542,67625080.0,99554239.0,172723,252798,39.15,39.38,425521,167179320.0,950,339,461,63985242.0,99697968.0,163499,253055,39.13,39.4,416554,163683210.0,800,2023-11-10 10:45:00
737,AFLT,516,1871,92006208.0,552176506.0,234928,1404103,39.16,39.33,1639031,644182715.0,2387,451,1767,92387043.0,583625744.0,236064,1478416,39.14,39.48,1714480,676012787.0,2218,2023-11-10 10:50:00
738,AFLT,663,1072,129662116.0,206507643.0,331008,524353,39.17,39.38,855361,336169759.0,1735,587,950,125458248.0,203789487.0,320595,517323,39.13,39.39,837918,329247735.0,1537,2023-11-10 10:55:00
739,AFLT,391,1071,87497861.0,118850120.0,223385,301846,39.17,39.37,525231,206347981.0,1462,315,979,87356756.0,119035556.0,223243,302321,39.13,39.37,525564,206392313.0,1294,2023-11-10 11:00:00
740,AFLT,538,816,130872731.0,170579173.0,335224,433438,39.04,39.35,768662,301451904.0,1354,410,699,127684201.0,164887148.0,327266,418908,39.02,39.36,746174,292571349.0,1109,2023-11-10 11:05:00
741,AFLT,416,637,91788772.0,134106972.0,234959,340132,39.07,39.43,575091,225895744.0,1053,325,511,81994771.0,131922201.0,209917,334380,39.06,39.45,544297,213916972.0,836,2023-11-10 11:10:00
742,AFLT,381,558,79143734.0,102560122.0,204097,260867,38.78,39.32,464964,181703857.0,939,310,475,70711196.0,100560130.0,181154,255654,39.03,39.33,436808,171271326.0,785,2023-11-10 11:15:00
743,AFLT,656,834,131914259.0,189262589.0,337772,482156,39.05,39.25,819928,321176848.0,1490,599,754,129484754.0,188399265.0,331620,479213,39.05,39.31,810833,317884020.0,1353,2023-11-10 11:20:00
744,AFLT,314,499,64384278.0,110000305.0,164836,279819,39.06,39.31,444655,174384583.0,813,253,450,63688474.0,107764202.0,163077,274089,39.05,39.32,437166,171452676.0,703,2023-11-10 11:25:00
745,AFLT,624,754,136948468.0,165910673.0,350646,422301,39.06,39.29,772947,302859142.0,1378,549,665,135388647.0,162592719.0,346669,413666,39.05,39.31,760335,297981367.0,1214,2023-11-10 11:30:00
746,AFLT,344,421,72601833.0,77968177.0,185995,197251,39.03,39.53,383246,150570010.0,765,280,352,69177937.0,76697271.0,177255,194964,39.03,39.34,372219,145875208.0,632,2023-11-10 11:35:00
747,AFLT,348,353,50606614.0,58489679.0,129499,148922,39.08,39.28,278421,109096294.0,701,261,286,48999312.0,55960306.0,125463,142392,39.05,39.3,267855,104959618.0,547,2023-11-10 11:40:00
748,AFLT,666,440,48210443.0,66858974.0,123444,170236,39.05,39.27,293680,115069417.0,1106,599,387,48201877.0,60696629.0,123535,154432,39.02,39.3,277967,108898506.0,986,2023-11-10 11:45:00
749,AFLT,398,538,82516219.0,89468816.0,211471,225228,39.02,39.72,436699,171985036.0,936,306,461,80416899.0,87527991.0,206123,222805,39.01,39.28,428928,167944891.0,767,2023-11-10 11:50:00
750,AFLT,687,870,135503617.0,146307405.0,347346,372839,39.01,39.24,720185,281811023.0,1557,567,783,133143898.0,142767739.0,341350,363655,39.01,39.26,705005,275911637.0,1350,2023-11-10 11:55:00
751,AFLT,613,682,120263849.0,139885638.0,308265,356471,39.01,39.24,664736,260149488.0,1295,517,593,118584928.0,138798178.0,303961,353500,39.01,39.26,657461,257383106.0,1110,2023-11-10 12:00:00
752,AFLT,586,640,137619125.0,169205406.0,353294,430803,38.95,39.28,784097,306824531.0,1226,520,563,135536453.0,165239060.0,347977,420526,38.95,39.29,768503,300775514.0,1083,2023-11-10 12:05:00
753,AFLT,620,1165,180180542.0,420787786.0,462833,1074506,38.93,39.16,1537339,600968329.0,1785,435,1056,176693332.0,412230320.0,453870,1052345,38.93,39.17,1506215,588923653.0,1491,2023-11-10 12:10:00
754,AFLT,473,963,116149045.0,371925824.0,297917,949876,38.99,39.16,1247793,488074870.0,1436,357,908,112262722.0,369795235.0,288364,944437,38.93,39.16,1232801,482057958.0,1265,2023-11-10 12:15:00
755,AFLT,441,534,137549609.0,170678815.0,353676,435845,38.89,39.16,789521,308228424.0,975,364,461,134912617.0,168799380.0,346957,430600,38.88,39.2,777557,303711997.0,825,2023-11-10 12:20:00
756,AFLT,698,763,169358665.0,271815098.0,430088,694925,39.38,39.11,1125013,441173764.0,1461,521,666,164542380.0,269027876.0,422715,686262,38.93,39.2,1108977,433570256.0,1187,2023-11-10 12:25:00
757,AFLT,803,1088,264316215.0,370312757.0,671998,944978,39.33,39.19,1616976,634628973.0,1891,685,946,268142651.0,369534149.0,678659,941745,39.51,39.24,1620404,637676800.0,1631,2023-11-10 12:30:00
758,AFLT,1198,1253,210007566.0,331408274.0,539570,847204,38.92,39.12,1386774,541415840.0,2451,1014,1123,203238442.0,315086990.0,522301,805546,38.91,39.11,1327847,518325433.0,2137,2023-11-10 12:35:00
759,AFLT,670,857,80504607.0,127714525.0,207020,326413,38.89,39.13,533433,208219132.0,1527,589,787,77273306.0,122365331.0,198695,312423,38.89,39.17,511118,199638637.0,1376,2023-11-10 12:40:00
760,AFLT,506,589,95026549.0,126152305.0,244377,319975,38.89,39.43,564352,221178855.0,1095,450,514,93081271.0,118851389.0,239513,303727,38.86,39.13,543240,211932661.0,964,2023-11-10 12:45:00
761,AFLT,351,308,63408788.0,66545247.0,163009,168187,38.9,39.57,331196,129954035.0,659,299,225,62871687.0,65197086.0,161720,164878,38.88,39.54,326598,128068773.0,524,2023-11-10 12:50:00
762,AFLT,582,505,80263415.0,108620480.0,206130,277520,38.94,39.14,483650,188883896.0,1087,526,456,78784708.0,107481658.0,202379,274470,38.93,39.16,476849,186266367.0,982,2023-11-10 12:55:00
763,AFLT,509,659,78600012.0,109571660.0,201903,280218,38.93,39.1,482121,188171673.0,1168,429,580,78252521.0,112994763.0,201036,286636,38.92,39.42,487672,191247284.0,1009,2023-11-10 13:00:00
764,AFLT,552,1894,104713024.0,442133517.0,269476,1132076,38.86,39.06,1401552,546846542.0,2446,449,1779,102990943.0,440177128.0,264903,1126318,38.88,39.08,1391221,543168072.0,2228,2023-11-10 13:05:00
765,AFLT,330,527,87345892.0,85725135.0,238403,218751,36.64,39.19,457154,173071027.0,857,270,431,67890827.0,84131953.0,174413,214666,38.93,39.19,389079,152022781.0,701,2023-11-10 13:10:00
766,AFLT,410,1276,105070840.0,205116968.0,270065,522270,38.91,39.27,792335,310187808.0,1686,336,1195,103719644.0,201083590.0,266625,514035,38.9,39.12,780660,304803234.0,1531,2023-11-10 13:15:00
767,AFLT,441,575,95253414.0,99636803.0,244923,256017,38.89,38.92,500940,194890217.0,1016,364,471,95247920.0,96021632.0,244986,245322,38.88,39.14,490308,191269552.0,835,2023-11-10 13:20:00
768,AFLT,457,562,95296178.0,101414294.0,245093,259619,38.88,39.06,504712,196710472.0,1019,349,521,81663150.0,100546436.0,210152,257134,38.86,39.1,467286,182209587.0,870,2023-11-10 13:25:00
769,AFLT,580,623,59510349.0,79118140.0,152753,202232,38.96,39.12,354985,138628489.0,1203,489,565,58520181.0,78406072.0,150277,200314,38.94,39.14,350591,136926254.0,1054,2023-11-10 13:30:00
770,AFLT,430,436,66386799.0,72525564.0,170414,185317,38.96,39.14,355731,138912363.0,866,377,367,64481448.0,70093061.0,165900,179098,38.87,39.14,344998,134574509.0,744,2023-11-10 13:35:00
771,AFLT,565,370,54715723.0,56000823.0,140500,143126,38.94,39.13,283626,110716546.0,935,509,303,54698061.0,57194315.0,140487,146140,38.93,39.14,286627,111892376.0,812,2023-11-10 13:40:00
772,AFLT,565,622,100390942.0,109164116.0,258108,278970,38.89,39.13,537078,209555058.0,1187,495,514,96903097.0,105861504.0,249136,270451,38.9,39.14,519587,202764601.0,1009,2023-11-10 13:45:00
773,AFLT,264,391,50957088.0,53539333.0,131219,137012,38.83,39.08,268231,104496421.0,655,218,341,50114539.0,56196688.0,129045,142415,38.83,39.46,271460,106311227.0,559,2023-11-10 13:50:00
774,AFLT,279,478,58824514.0,76721143.0,151014,196261,38.95,39.09,347275,135545658.0,757,234,418,56960962.0,75038691.0,146436,191862,38.9,39.11,338298,131999653.0,652,2023-11-10 13:55:00
775,AFLT,328,741,47588108.0,65661218.0,122306,168010,38.91,39.08,290316,113249327.0,1069,301,732,48638739.0,68345830.0,125025,174789,38.9,39.1,299814,116984569.0,1033,2023-11-10 14:00:00
776,AFLT,362,1168,68654842.0,224977827.0,176802,576863,38.83,39.0,753665,293632670.0,1530,276,1134,68129172.0,224201490.0,175449,574377,38.83,39.03,749826,292330662.0,1410,2023-11-10 14:05:00
777,AFLT,354,3058,87056063.0,1329145359.0,223981,3407705,38.87,39.0,3631686,1416201422.0,3412,285,3040,84155704.0,1327793170.0,216559,3404165,38.86,39.0,3620724,1411948875.0,3325,2023-11-10 14:10:00
778,AFLT,408,2545,95888315.0,1435075983.0,246676,3679242,38.87,39.0,3925918,1530964298.0,2953,368,2525,95306830.0,1431842070.0,245189,3670803,38.87,39.01,3915992,1527148900.0,2893,2023-11-10 14:15:00
779,AFLT,231,324,55020785.0,180468968.0,141445,462538,38.9,39.02,603983,235489754.0,555,178,309,52578950.0,177212934.0,135178,454204,38.9,39.02,589382,229791885.0,487,2023-11-10 14:20:00
780,AFLT,290,818,60561348.0,601385546.0,155461,1540980,38.96,39.03,1696441,661946895.0,1108,253,807,61691838.0,602360798.0,158629,1543469,38.89,39.03,1702098,664052636.0,1060,2023-11-10 14:25:00
781,AFLT,287,342,46019298.0,188818257.0,118254,483705,38.92,39.04,601959,234837555.0,629,230,320,45310339.0,188655430.0,116502,483256,38.89,39.04,599758,233965769.0,550,2023-11-10 14:30:00
782,AFLT,334,438,70244413.0,230123354.0,180707,589422,38.87,39.04,770129,300367768.0,772,253,411,70948863.0,229174740.0,182605,586958,38.85,39.04,769563,300123603.0,664,2023-11-10 14:35:00
783,AFLT,342,639,42488171.0,385485632.0,108887,986798,39.02,39.06,1095685,427973803.0,981,316,619,40416086.0,385329864.0,103853,986367,38.92,39.07,1090220,425745951.0,935,2023-11-10 14:40:00
784,AFLT,297,719,55208965.0,417855369.0,141948,1070109,38.89,39.05,1212057,473064334.0,1016,268,670,54926090.0,417189182.0,141280,1068294,38.88,39.05,1209574,472115273.0,938,2023-11-10 14:45:00
785,AFLT,415,1127,88795073.0,558893464.0,228251,1431291,38.9,39.05,1659542,647688537.0,1542,362,1067,88340906.0,558247796.0,227255,1429629,38.87,39.05,1656884,646588703.0,1429,2023-11-10 14:50:00
786,AFLT,615,1112,131793484.0,559416507.0,338519,1432774,38.93,39.04,1771293,691209991.0,1727,580,1077,131656727.0,558687414.0,338197,1430830,38.93,39.05,1769027,690344142.0,1657,2023-11-10 14:55:00
787,AFLT,927,1269,124177542.0,504037280.0,318787,1290391,38.95,39.06,1609178,628214823.0,2196,859,1222,123736662.0,504330480.0,317770,1291164,38.94,39.06,1608934,628067143.0,2081,2023-11-10 15:00:00
788,AFLT,503,1194,93754648.0,371737274.0,240804,951483,38.93,39.07,1192287,465491923.0,1697,497,1174,103916275.0,371223980.0,266897,950177,38.93,39.07,1217074,475140255.0,1671,2023-11-10 15:05:00
789,AFLT,1075,1229,238922924.0,272071162.0,612474,695256,39.01,39.13,1307730,510994086.0,2304,1035,1137,233672389.0,268056824.0,599364,684679,38.99,39.15,1284043,501729214.0,2172,2023-11-10 15:10:00
790,AFLT,1770,1310,314194227.0,284615420.0,805352,726948,39.01,39.15,1532300,598809647.0,3080,1723,1263,312551769.0,283174308.0,800356,723208,39.05,39.16,1523564,595726077.0,2986,2023-11-10 15:15:00
791,AFLT,764,603,151766064.0,96193189.0,389174,245510,39.0,39.18,634684,247959253.0,1367,715,561,152003647.0,96140609.0,389844,245336,38.99,39.19,635180,248144256.0,1276,2023-11-10 15:20:00
792,AFLT,857,567,144124883.0,144751454.0,369704,369367,38.98,39.19,739071,288876338.0,1424,812,531,143492630.0,143254928.0,368108,365485,38.98,39.2,733593,286747558.0,1343,2023-11-10 15:25:00
793,AFLT,753,760,145739783.0,177160450.0,373782,451897,38.99,39.2,825679,322900233.0,1513,708,725,142706539.0,177765061.0,366061,453463,38.98,39.2,819524,320471600.0,1433,2023-11-10 15:30:00
794,AFLT,567,654,92912160.0,100921702.0,238290,257521,38.99,39.19,495811,193833863.0,1221,557,603,88589203.0,100069714.0,227215,255311,38.99,39.2,482526,188658918.0,1160,2023-11-10 15:35:00
795,AFLT,418,454,84749389.0,99960442.0,217349,254983,38.99,39.2,472332,184709832.0,872,388,422,88279945.0,99857346.0,226423,254703,38.99,39.21,481126,188137292.0,810,2023-11-10 15:40:00
796,AFLT,469,622,97700597.0,130794754.0,250404,333654,39.02,39.2,584058,228495351.0,1091,437,569,96254743.0,130067183.0,246804,331791,39.0,39.2,578595,226321926.0,1006,2023-11-10 15:45:00
797,AFLT,333,512,86825043.0,94577169.0,222454,241122,39.03,39.22,463576,181402212.0,845,284,434,84711469.0,94739556.0,217201,241504,39.0,39.23,458705,179451026.0,718,2023-11-10 15:50:00
798,AFLT,490,460,101033117.0,100609511.0,258702,256785,39.05,39.18,515487,201642629.0,950,428,400,100921105.0,98679370.0,258551,251526,39.03,39.23,510077,199600476.0,828,2023-11-10 15:55:00
799,AFLT,330,353,45855122.0,65771806.0,117481,167940,39.03,39.16,285421,111626929.0,683,294,319,46458944.0,64827194.0,119038,165315,39.03,39.21,284353,111286139.0,613,2023-11-10 16:00:00
800,AFLT,317,285,57915145.0,55021250.0,148519,140395,39.0,39.19,288914,112936396.0,602,303,245,60119482.0,53513876.0,154202,136524,38.99,39.2,290726,113633358.0,548,2023-11-10 16:05:00
801,AFLT,454,334,77837835.0,68690138.0,199623,175262,38.99,39.19,374885,146527974.0,788,424,287,78815843.0,69615295.0,202129,177576,38.99,39.2,379705,148431138.0,711,2023-11-10 16:10:00
802,AFLT,697,569,109160267.0,114088741.0,280027,291324,38.98,39.16,571351,223249009.0,1266,645,546,108614080.0,111589286.0,278635,284806,38.98,39.18,563441,220203367.0,1191,2023-11-10 16:15:00
803,AFLT,378,506,72858068.0,79044289.0,187043,201892,38.95,39.15,388935,151902358.0,884,360,478,72020579.0,81074883.0,184869,206957,38.96,39.17,391826,153095463.0,838,2023-11-10 16:20:00
804,AFLT,714,721,98938870.0,86336160.0,253783,220420,38.99,39.17,474203,185275031.0,1435,690,699,98746645.0,86174630.0,253312,219980,38.98,39.17,473292,184921275.0,1389,2023-11-10 16:25:00
805,AFLT,469,511,95989518.0,106969085.0,246380,273060,38.96,39.17,519440,202958604.0,980,430,467,92926688.0,107264615.0,238512,273810,38.96,39.17,512322,200191304.0,897,2023-11-10 16:30:00
806,AFLT,374,815,81551792.0,140187012.0,209350,357862,38.95,39.17,567212,221738804.0,1189,364,774,79834419.0,140190781.0,204955,357858,38.95,39.17,562813,220025200.0,1138,2023-11-10 16:35:00
807,AFLT,240,485,53571357.0,67743872.0,137429,172977,38.98,39.16,310406,121315229.0,725,211,436,54186021.0,67103845.0,139010,171319,38.98,39.17,310329,121289866.0,647,2023-11-10 16:40:00
808,AFLT,214,583,25086402.0,39423745.0,64365,100711,38.98,39.15,165076,64510147.0,797,150,558,24733449.0,39309814.0,63465,100408,38.97,39.15,163873,64043263.0,708,2023-11-10 16:45:00
809,AFLT,221,338,45061882.0,56909361.0,115677,145025,38.95,39.24,260702,101971243.0,559,193,313,36895946.0,56886800.0,94793,144959,38.92,39.24,239752,93782746.0,506,2023-11-10 16:50:00
810,AFLT,185,281,36652502.0,50952162.0,94072,129954,38.96,39.21,224026,87604665.0,466,167,259,35771084.0,44946379.0,91813,114723,38.96,39.18,206536,80717464.0,426,2023-11-10 16:55:00
811,AFLT,154,956,27200776.0,46558353.0,69776,118814,38.98,39.19,188590,73759130.0,1110,155,940,28116612.0,46482118.0,72136,118630,38.98,39.18,190766,74598730.0,1095,2023-11-10 17:00:00
812,AFLT,425,811,46510240.0,57756866.0,119403,147473,38.95,39.16,266876,104267106.0,1236,375,783,46956715.0,58351911.0,120566,148975,38.95,39.17,269541,105308626.0,1158,2023-11-10 17:05:00
813,AFLT,537,357,34268168.0,48160448.0,87814,122876,39.02,39.19,210690,82428616.0,894,508,328,33099507.0,47844773.0,84833,122062,39.02,39.2,206895,80944281.0,836,2023-11-10 17:10:00
814,AFLT,617,325,54794807.0,41498327.0,140388,105986,39.03,39.15,246374,96293135.0,942,589,290,53612128.0,40447559.0,137391,103227,39.02,39.18,240618,94059687.0,879,2023-11-10 17:15:00
815,AFLT,228,240,25250594.0,28308299.0,64831,72262,38.95,39.17,137093,53558893.0,468,232,213,23072399.0,30342565.0,59277,71512,38.92,42.43,130789,53414965.0,445,2023-11-10 17:20:00
816,AFLT,571,254,19737096.0,21067827.0,50514,53815,39.07,39.15,104329,40804923.0,825,528,228,21788342.0,22331339.0,55790,57025,39.05,39.16,112815,44119682.0,756,2023-11-10 17:25:00
817,AFLT,440,220,18187072.0,29080595.0,46231,74204,39.34,39.19,120435,47267667.0,660,413,190,17495899.0,28553726.0,44821,72871,39.04,39.18,117692,46049625.0,603,2023-11-10 17:30:00
818,AFLT,654,282,82374990.0,52381801.0,210975,133558,39.04,39.22,344533,134756792.0,936,618,254,78844762.0,52541089.0,201979,133960,39.04,39.22,335939,131385851.0,872,2023-11-10 17:35:00
819,AFLT,518,488,64085842.0,50841799.0,163069,129585,39.3,39.23,292654,114927642.0,1006,463,420,65839345.0,48032736.0,168566,122416,39.06,39.24,290982,113872081.0,883,2023-11-10 17:40:00
820,AFLT,550,468,65550703.0,53060653.0,167799,135279,39.07,39.22,303078,118611356.0,1018,462,421,63572792.0,55006458.0,162869,140211,39.03,39.23,303080,118579250.0,883,2023-11-10 17:45:00
821,AFLT,432,344,37241966.0,37100258.0,95396,94428,39.04,39.29,189824,74342225.0,776,335,265,36492599.0,30792326.0,93519,78294,39.02,39.33,171813,67284925.0,600,2023-11-10 17:50:00
822,AFLT,305,176,25962715.0,14281883.0,66406,36317,39.1,39.33,102723,40244598.0,481,286,162,22791356.0,14231988.0,58299,36182,39.09,39.33,94481,37023344.0,448,2023-11-10 17:55:00
823,AFLT,296,216,25360793.0,17827236.0,64885,45413,39.09,39.26,110298,43188030.0,512,248,169,27182132.0,16429572.0,69561,41841,39.08,39.27,111402,43611705.0,417,2023-11-10 18:00:00
824,AFLT,350,270,32811012.0,16684075.0,84046,42508,39.04,39.25,126554,49495087.0,620,302,219,32807655.0,16231874.0,84066,41306,39.03,39.3,125372,49039530.0,521,2023-11-10 18:05:00
825,AFLT,257,252,19038240.0,17863840.0,48578,45588,39.19,39.19,94166,36902081.0,509,252,188,18895748.0,17621096.0,48353,44877,39.08,39.27,93230,36516844.0,440,2023-11-10 18:10:00
826,AFLT,431,407,41485766.0,24912432.0,106064,63543,39.11,39.21,169607,66398198.0,838,378,367,40875132.0,25491726.0,104535,65004,39.1,39.22,169539,66366859.0,745,2023-11-10 18:15:00
827,AFLT,438,352,44625958.0,20578790.0,114117,52513,39.11,39.19,166630,65204748.0,790,421,310,46058994.0,22824647.0,117978,58202,39.04,39.22,176180,68883641.0,731,2023-11-10 18:20:00
828,AFLT,352,425,40100913.0,27539107.0,102602,70257,39.08,39.2,172859,67640021.0,777,340,368,32361602.0,29595505.0,82835,75368,39.07,39.27,158203,61957108.0,708,2023-11-10 18:25:00
829,AFLT,301,394,14779462.0,24624364.0,37735,62858,39.17,39.17,100593,39403826.0,695,252,300,17641423.0,22983121.0,45113,58659,39.1,39.18,103772,40624545.0,552,2023-11-10 18:30:00
830,AFLT,244,282,16563768.0,13444309.0,42414,34306,39.05,39.19,76720,30008077.0,526,197,249,15982860.0,13304764.0,40991,33924,38.99,39.22,74915,29287625.0,446,2023-11-10 18:35:00
831,AFLT,246,258,12672556.0,17981483.0,32216,45878,39.34,39.19,78094,30654039.0,504,209,233,13408719.0,18740787.0,34282,47727,39.11,39.27,82009,32149506.0,442,2023-11-10 18:40:00
832,AFLT,2708,5423,500172217.0,951888265.0,1285335,2416043,38.91,39.4,3701378,1452060483.0,8131,2239,4406,477333396.0,910842002.0,1222656,2320825,39.04,39.25,3543481,1388175398.0,6645,2023-11-13 10:05:00
833,AFLT,1023,2396,92119972.0,268862391.0,236265,686284,38.99,39.18,922549,360982363.0,3419,836,2128,84485844.0,265621214.0,216714,677914,38.98,39.18,894628,350107059.0,2964,2023-11-13 10:10:00
834,AFLT,1116,4314,150037814.0,925466118.0,384925,2363128,38.98,39.16,2748053,1075503932.0,5430,944,4060,146082483.0,920675273.0,374796,2350825,38.98,39.16,2725621,1066757757.0,5004,2023-11-13 10:15:00
835,AFLT,759,1559,69770046.0,96253523.0,178743,243253,39.03,39.57,421996,166023569.0,2318,580,1197,64946134.0,89742901.0,166380,228390,39.03,39.29,394770,154689035.0,1777,2023-11-13 10:20:00
836,AFLT,893,1311,134980816.0,146336350.0,345811,373078,39.03,39.22,718889,281317167.0,2204,787,1104,133770682.0,143929609.0,342771,366744,39.03,39.25,709515,277700291.0,1891,2023-11-13 10:25:00
837,AFLT,872,1547,133315506.0,169420453.0,341522,431414,39.04,39.27,772936,302735960.0,2419,788,1361,130287288.0,168614624.0,333762,429378,39.04,39.27,763140,298901913.0,2149,2023-11-13 10:30:00
838,AFLT,683,1407,123710588.0,191032898.0,316913,486618,39.04,39.26,803531,314743487.0,2090,611,1280,118322798.0,187957625.0,303226,478739,39.02,39.26,781965,306280423.0,1891,2023-11-13 10:35:00
839,AFLT,462,1245,85096361.0,163267465.0,218255,416673,38.99,39.18,634928,248363826.0,1707,397,1161,77048968.0,160338405.0,197618,409129,38.99,39.19,606747,237387374.0,1558,2023-11-13 10:40:00
840,AFLT,558,887,85173687.0,114188692.0,218178,291218,39.04,39.21,509396,199362380.0,1445,539,803,84278012.0,113188956.0,216024,288453,39.01,39.24,504477,197466969.0,1342,2023-11-13 10:45:00
841,AFLT,566,1365,127048785.0,149642483.0,325711,381559,39.01,39.22,707270,276691268.0,1931,494,1250,125902648.0,145195267.0,322853,370045,39.0,39.24,692898,271097915.0,1744,2023-11-13 10:50:00
842,AFLT,521,829,104043149.0,135705108.0,266680,346115,39.01,39.21,612795,239748257.0,1350,434,733,102727839.0,133392577.0,263435,340190,39.0,39.21,603625,236120416.0,1167,2023-11-13 10:55:00
843,AFLT,645,2380,164824340.0,578383173.0,423139,1477262,38.95,39.15,1900401,743207513.0,3025,516,2308,163754569.0,577378826.0,420394,1474458,38.95,39.16,1894852,741133395.0,2824,2023-11-13 11:00:00
844,AFLT,496,1147,80197189.0,115515729.0,205836,294714,38.96,39.2,500550,195712918.0,1643,450,1039,78814344.0,115457528.0,202334,294538,38.95,39.2,496872,194271873.0,1489,2023-11-13 11:05:00
845,AFLT,603,858,86228648.0,129576374.0,221062,330544,39.01,39.2,551606,215805023.0,1461,512,732,85102903.0,129272845.0,218207,329762,39.0,39.2,547969,214375749.0,1244,2023-11-13 11:10:00
846,AFLT,536,1132,113312680.0,168396645.0,290602,429817,38.99,39.18,720419,281709326.0,1668,467,1006,111924383.0,167616440.0,287059,427786,38.99,39.18,714845,279540823.0,1473,2023-11-13 11:15:00
847,AFLT,361,1099,75770809.0,120965868.0,194062,308817,39.04,39.17,502879,196736677.0,1460,303,939,71661783.0,120259314.0,184017,306901,38.94,39.19,490918,191921097.0,1242,2023-11-13 11:20:00
848,AFLT,437,936,76981319.0,140174344.0,197354,357531,39.01,39.21,554885,217155663.0,1373,350,857,76046816.0,139223824.0,195036,355096,38.99,39.21,550132,215270641.0,1207,2023-11-13 11:25:00
849,AFLT,557,755,81198467.0,95045692.0,209410,242311,38.77,39.22,451721,176244160.0,1312,489,640,75858267.0,94728276.0,194482,241581,39.01,39.21,436063,170586543.0,1129,2023-11-13 11:30:00
850,AFLT,463,981,99548395.0,159984434.0,255393,408226,38.98,39.19,663619,259532829.0,1444,411,901,98886651.0,157919494.0,253794,402597,38.96,39.23,656391,256806145.0,1312,2023-11-13 11:35:00
851,AFLT,307,666,60311904.0,140066387.0,154734,357149,38.98,39.22,511883,200378292.0,973,242,603,58888844.0,139289864.0,151089,355068,38.98,39.23,506157,198178709.0,845,2023-11-13 11:40:00
852,AFLT,685,1204,94988120.0,192368739.0,243941,490803,38.94,39.19,734744,287356860.0,1889,586,1120,93022868.0,189125525.0,238902,483068,38.94,39.15,721970,282148394.0,1706,2023-11-13 11:45:00
853,AFLT,825,2169,167373403.0,398899132.0,429520,1018684,38.97,39.16,1448204,566272536.0,2994,737,2043,165264589.0,394762788.0,424374,1008084,38.94,39.16,1432458,560027377.0,2780,2023-11-13 11:50:00
854,AFLT,1337,2362,258174521.0,479878159.0,662043,1224345,39.0,39.19,1886388,738052680.0,3699,1178,2172,256918010.0,478978552.0,659080,1221999,38.98,39.2,1881079,735896563.0,3350,2023-11-13 11:55:00
855,AFLT,567,1446,119403445.0,265117575.0,306299,676680,38.98,39.18,982979,384521020.0,2013,473,1345,118411813.0,262099830.0,303874,668737,38.97,39.19,972611,380511643.0,1818,2023-11-13 12:00:00
856,AFLT,536,924,115247831.0,176705163.0,295656,451533,38.98,39.13,747189,291952994.0,1460,430,823,113366990.0,176092808.0,291094,449590,38.95,39.17,740684,289459798.0,1253,2023-11-13 12:05:00
857,AFLT,602,974,97922305.0,192257141.0,251310,490914,38.96,39.16,742224,290179447.0,1576,513,874,97287827.0,190894357.0,249776,487283,38.95,39.18,737059,288182185.0,1387,2023-11-13 12:10:00
858,AFLT,607,738,81473800.0,122851905.0,209274,314678,38.93,39.04,523952,204325706.0,1345,545,640,79583441.0,119884623.0,204444,306218,38.93,39.15,510662,199468065.0,1185,2023-11-13 12:15:00
859,AFLT,611,833,97340417.0,161330077.0,250332,413365,38.88,39.03,663697,258670494.0,1444,474,706,95189137.0,158330059.0,244998,405019,38.85,39.09,650017,253519196.0,1180,2023-11-13 12:20:00
860,AFLT,814,1242,138386562.0,219661853.0,355446,561693,38.93,39.11,917139,358048416.0,2056,744,1132,138242499.0,219481189.0,355333,561227,38.91,39.11,916560,357723689.0,1876,2023-11-13 12:25:00
861,AFLT,320,549,55695963.0,93244528.0,143138,238363,38.91,39.12,381501,148940491.0,869,230,502,55124971.0,92934890.0,141676,237567,38.91,39.12,379243,148059861.0,732,2023-11-13 12:30:00
862,AFLT,660,1231,127018612.0,201797140.0,326533,516114,38.9,39.1,842647,328815753.0,1891,614,1138,126213550.0,200563178.0,324550,512931,38.89,39.1,837481,326776728.0,1752,2023-11-13 12:35:00
863,AFLT,663,991,82130045.0,152291274.0,210630,389411,38.99,39.11,600041,234421319.0,1654,583,892,80820807.0,151679610.0,207527,387810,38.94,39.11,595337,232500417.0,1475,2023-11-13 12:40:00
864,AFLT,499,942,95253399.0,172734242.0,244812,441913,38.91,39.09,686725,267987642.0,1441,466,857,93391912.0,169956013.0,240081,434751,38.9,39.09,674832,263347925.0,1323,2023-11-13 12:45:00
865,AFLT,349,545,67067944.0,77989849.0,172553,199300,38.87,39.13,371853,145057793.0,894,266,475,65856456.0,76375990.0,169292,195033,38.9,39.16,364325,142232446.0,741,2023-11-13 12:50:00
866,AFLT,280,397,76206712.0,91296176.0,195472,232995,38.99,39.18,428467,167502888.0,677,253,310,73191092.0,89401646.0,187946,228140,38.94,39.19,416086,162592739.0,563,2023-11-13 12:55:00
867,AFLT,1338,922,316176388.0,280983261.0,810820,718151,38.99,39.13,1528971,597159649.0,2260,1299,873,315687841.0,280604361.0,809654,717165,38.99,39.13,1526819,596292203.0,2172,2023-11-13 13:00:00
868,AFLT,438,587,134879534.0,166968837.0,346288,426903,38.95,39.11,773191,301848372.0,1025,361,506,131507843.0,165174707.0,337750,421580,38.94,39.18,759330,296682551.0,867,2023-11-13 13:05:00
869,AFLT,236,486,87596339.0,125714373.0,224598,320506,39.0,39.22,545104,213310712.0,722,208,441,83710436.0,123646437.0,214750,315226,38.98,39.22,529976,207356873.0,649,2023-11-13 13:10:00
870,AFLT,777,1228,259030541.0,436365383.0,667937,1126876,38.78,38.72,1794813,695395925.0,2005,514,982,249104686.0,412053946.0,642589,1054402,38.77,39.08,1696991,661158633.0,1496,2023-11-13 13:15:00
871,AFLT,360,470,66658813.0,73348686.0,171811,188108,38.8,38.99,359919,140007499.0,830,203,244,64787386.0,70000811.0,167202,179420,38.75,39.02,346622,134788197.0,447,2023-11-13 13:20:00
872,AFLT,213,140,39548060.0,37887969.0,101948,97128,38.79,39.01,199076,77436030.0,353,158,95,38788718.0,36359713.0,100014,93202,38.78,39.01,193216,75148431.0,253,2023-11-13 13:25:00
873,AFLT,221,269,32744461.0,31639494.0,84086,81131,38.94,39.0,165217,64383956.0,490,113,248,29681455.0,31493489.0,76511,80624,38.79,39.06,157135,61174945.0,361,2023-11-13 13:30:00
874,AFLT,346,492,83733494.0,169104741.0,216064,435369,38.75,38.84,651433,252838235.0,838,230,446,81670745.0,165679415.0,210821,425296,38.74,38.96,636117,247350161.0,676,2023-11-13 13:35:00
875,AFLT,446,212,62278838.0,59900350.0,160451,153566,38.81,39.01,314017,122179189.0,658,390,187,62950491.0,59263698.0,162287,151861,38.79,39.02,314148,122214189.0,577,2023-11-13 13:40:00
876,AFLT,595,441,74661217.0,113583499.0,192790,292010,38.73,38.9,484800,188244716.0,1036,456,368,70674568.0,111227482.0,182508,285451,38.72,38.97,467959,181902051.0,824,2023-11-13 13:45:00
877,AFLT,403,609,105461370.0,184749198.0,272503,474956,38.7,38.9,747459,290210568.0,1012,248,554,100960232.0,178806978.0,260928,459058,38.69,38.95,719986,279767211.0,802,2023-11-13 13:50:00
878,AFLT,279,275,55116370.0,85367058.0,141747,218923,38.88,38.99,360670,140483429.0,554,173,232,51893117.0,88841993.0,134021,225886,38.72,39.33,359907,140735111.0,405,2023-11-13 13:55:00
879,AFLT,306,174,44261577.0,55718524.0,114247,143290,38.74,38.89,257537,99980101.0,480,246,168,46043181.0,57674244.0,118880,148051,38.73,38.96,266931,103717425.0,414,2023-11-13 14:00:00
880,AFLT,156,105,34998546.0,30981526.0,90547,79306,38.65,39.07,169853,65980072.0,261,97,93,34356030.0,30485929.0,88905,78227,38.64,38.97,167132,64841959.0,190,2023-11-13 14:05:00
881,AFLT,267,278,74132121.0,91582512.0,191337,234976,38.74,38.98,426313,165714634.0,545,175,231,66667827.0,88878619.0,172148,227932,38.73,38.99,400080,155546447.0,406,2023-11-13 14:10:00
882,AFLT,1006,1139,313550203.0,422891077.0,811509,1087190,38.64,38.9,1898699,736441281.0,2145,711,979,289624990.0,398444901.0,749685,1024546,38.63,38.89,1774231,688069891.0,1690,2023-11-13 14:15:00
883,AFLT,638,674,134264202.0,195687396.0,346527,503379,38.75,38.87,849906,329951598.0,1312,482,607,133810784.0,196453988.0,346132,502888,38.66,39.07,849020,330264773.0,1089,2023-11-13 14:20:00
884,AFLT,588,684,160796594.0,245251280.0,414786,629443,38.77,38.96,1044229,406047874.0,1272,451,622,150374869.0,240919310.0,388812,617088,38.68,39.04,1005900,391294180.0,1073,2023-11-13 14:25:00
885,AFLT,448,451,126296980.0,158931287.0,325407,408659,38.81,38.89,734066,285228267.0,899,354,400,121455026.0,153365464.0,313994,394014,38.68,38.92,708008,274820490.0,754,2023-11-13 14:30:00
886,AFLT,232,192,47904671.0,50691647.0,123610,130191,38.75,38.94,253801,98596318.0,424,179,160,46358810.0,49989969.0,119846,128304,38.68,38.96,248150,96348780.0,339,2023-11-13 14:35:00
887,AFLT,208,125,25361672.0,26670619.0,65432,68520,38.76,38.92,133952,52032292.0,333,161,110,24323828.0,26513560.0,62824,67904,38.72,39.05,130728,50837389.0,271,2023-11-13 14:40:00
888,AFLT,242,608,54705626.0,104159999.0,141300,267967,38.72,38.87,409267,158865625.0,850,160,580,54076097.0,105573554.0,139718,271189,38.7,38.93,410907,159649651.0,740,2023-11-13 14:45:00
889,AFLT,204,301,51653044.0,87852671.0,133412,225574,38.72,38.95,358986,139505716.0,505,184,281,53451828.0,88725220.0,138173,227722,38.68,38.96,365895,142177048.0,465,2023-11-13 14:50:00
890,AFLT,277,403,59278377.0,85544749.0,152906,220073,38.77,38.87,372979,144823127.0,680,205,373,56524314.0,82769550.0,146025,212513,38.71,38.95,358538,139293864.0,578,2023-11-13 14:55:00
891,AFLT,303,566,71287767.0,138251829.0,183986,355129,38.75,38.93,539115,209539597.0,869,276,531,71062500.0,135350963.0,183403,347592,38.75,38.94,530995,206413464.0,807,2023-11-13 15:00:00
892,AFLT,261,334,52021777.0,71521346.0,134060,183539,38.8,38.97,317599,123543124.0,595,168,316,50698775.0,71789697.0,131032,184115,38.69,38.99,315147,122488473.0,484,2023-11-13 15:05:00
893,AFLT,461,287,79456910.0,79718525.0,205122,205321,38.74,38.83,410443,159175435.0,748,451,272,78893182.0,78847746.0,203714,202285,38.73,38.98,405999,157740929.0,723,2023-11-13 15:10:00
894,AFLT,235,150,56399512.0,58411940.0,145617,148502,38.73,39.33,294119,114811453.0,385,199,140,56375117.0,53515880.0,145603,137459,38.72,38.93,283062,109890998.0,339,2023-11-13 15:15:00
895,AFLT,445,269,58622128.0,73745115.0,151330,189341,38.74,38.95,340671,132367244.0,714,406,253,57920817.0,72418348.0,149574,184161,38.72,39.32,333735,130339166.0,659,2023-11-13 15:20:00
896,AFLT,492,321,67262829.0,86352176.0,173328,221684,38.81,38.95,395012,153615006.0,813,446,300,67700844.0,85954192.0,174828,220683,38.72,38.95,395511,153655036.0,746,2023-11-13 15:25:00
897,AFLT,477,235,54579969.0,75463428.0,140777,194239,38.77,38.85,335016,130043397.0,712,374,234,53406194.0,75352379.0,137789,193246,38.76,38.99,331035,128758573.0,608,2023-11-13 15:30:00
898,AFLT,339,167,56890934.0,55455127.0,145981,142869,38.97,38.82,288850,112346061.0,506,290,149,54818822.0,53284855.0,141587,136723,38.72,38.97,278310,108103678.0,439,2023-11-13 15:35:00
899,AFLT,370,169,52326397.0,55370563.0,134945,142033,38.78,38.98,276978,107696961.0,539,358,154,51129614.0,54686007.0,131900,140270,38.76,38.99,272170,105815622.0,512,2023-11-13 15:40:00
900,AFLT,220,252,40546973.0,43601252.0,104645,111936,38.75,38.95,216581,84148225.0,472,168,233,38207842.0,43520506.0,98599,111726,38.75,38.95,210325,81728349.0,401,2023-11-13 15:45:00
901,AFLT,422,297,97160333.0,96751536.0,251026,252680,38.71,38.29,503706,193911870.0,719,361,280,95124151.0,91429785.0,245816,234814,38.7,38.94,480630,186553937.0,641,2023-11-13 15:50:00
902,AFLT,371,287,46770791.0,44795323.0,120686,115085,38.75,38.92,235771,91566114.0,658,311,262,43359486.0,46967489.0,111988,120537,38.72,38.97,232525,90326975.0,573,2023-11-13 15:55:00
903,AFLT,179,294,27976958.0,54846062.0,72134,140969,38.78,38.91,213103,82823021.0,473,133,278,29675789.0,54657892.0,76660,140459,38.71,38.91,217119,84333682.0,411,2023-11-13 16:00:00
904,AFLT,439,377,48471426.0,46435612.0,125042,119226,38.76,38.95,244268,94907039.0,816,412,364,48090126.0,46644470.0,124167,119799,38.73,38.94,243966,94734596.0,776,2023-11-13 16:05:00
905,AFLT,298,285,84626561.0,84281913.0,218493,217363,38.73,38.77,435856,168908475.0,583,277,258,82625741.0,82582025.0,213392,212187,38.72,38.92,425579,165207767.0,535,2023-11-13 16:10:00
906,AFLT,571,249,82356529.0,69295360.0,211691,177933,38.9,38.94,389624,151651889.0,820,489,227,77436036.0,70002202.0,199843,179672,38.75,38.96,379515,147438238.0,716,2023-11-13 16:15:00
907,AFLT,443,154,67653818.0,38349020.0,174475,98382,38.78,38.98,272857,106002839.0,597,409,137,63029692.0,39429032.0,162668,101044,38.75,39.02,263712,102458724.0,546,2023-11-13 16:20:00
908,AFLT,227,173,42867182.0,42010796.0,110534,107730,38.78,39.0,218264,84877979.0,400,198,155,42865839.0,43176532.0,110576,110709,38.77,39.0,221285,86042371.0,353,2023-11-13 16:25:00
909,AFLT,746,419,105183884.0,96095311.0,270295,246307,38.91,39.01,516602,201279195.0,1165,725,373,103667765.0,94246019.0,267082,241510,38.81,39.02,508592,197913784.0,1098,2023-11-13 16:30:00
910,AFLT,265,192,47273898.0,49926957.0,121898,127965,38.78,39.02,249863,97200856.0,457,206,169,46876933.0,49297591.0,120927,126270,38.76,39.04,247197,96174525.0,375,2023-11-13 16:35:00
911,AFLT,253,184,50843922.0,50278416.0,130825,128889,38.86,39.01,259714,101122339.0,437,220,165,50299291.0,49374838.0,129628,126519,38.8,39.03,256147,99674130.0,385,2023-11-13 16:40:00
912,AFLT,179,163,43746199.0,41669873.0,112679,106738,38.82,39.04,219417,85416072.0,342,155,157,44891558.0,42429797.0,115654,108663,38.82,39.05,224317,87321355.0,312,2023-11-13 16:45:00
913,AFLT,387,197,49972315.0,51670214.0,128984,133564,38.74,38.69,262548,101642529.0,584,360,175,50385896.0,49400640.0,130039,126538,38.75,39.04,256577,99786537.0,535,2023-11-13 16:50:00
914,AFLT,184,246,47037103.0,61293185.0,121221,157128,38.8,39.01,278349,108330288.0,430,142,230,47279154.0,58953348.0,121940,151138,38.77,39.01,273078,106232503.0,372,2023-11-13 16:55:00
915,AFLT,203,200,44288568.0,55514331.0,114005,142228,38.85,39.03,256233,99802900.0,403,168,186,45839783.0,55459183.0,118107,142090,38.81,39.03,260197,101298966.0,354,2023-11-13 17:00:00
916,AFLT,245,245,66357045.0,64750404.0,171088,165937,38.79,39.02,337025,131107450.0,490,199,229,67044074.0,65278912.0,172867,167278,38.78,39.02,340145,132322986.0,428,2023-11-13 17:05:00
917,AFLT,490,344,118641540.0,105027067.0,305578,269226,38.83,39.01,574804,223668607.0,834,472,326,118427783.0,104800292.0,305110,268581,38.81,39.02,573691,223228075.0,798,2023-11-13 17:10:00
918,AFLT,423,97,50856131.0,22052822.0,130936,56716,38.84,38.88,187652,72908954.0,520,398,90,50983869.0,21757959.0,131275,55788,38.84,39.0,187063,72741829.0,488,2023-11-13 17:15:00
919,AFLT,527,244,74248366.0,65269371.0,191009,167298,38.87,39.01,358307,139517738.0,771,489,222,73527864.0,66192786.0,189561,169509,38.79,39.05,359070,139720651.0,711,2023-11-13 17:20:00
920,AFLT,203,185,34219118.0,41363376.0,88242,106051,38.78,39.0,194293,75582494.0,388,179,157,35075258.0,39963200.0,90481,102390,38.77,39.03,192871,75038459.0,336,2023-11-13 17:25:00
921,AFLT,159,313,30424679.0,68229245.0,78442,175032,38.79,38.98,253474,98653924.0,472,145,304,27669168.0,69414033.0,71379,178063,38.76,38.98,249442,97083201.0,449,2023-11-13 17:30:00
922,AFLT,265,217,47945704.0,48111331.0,123436,123236,38.84,39.04,246672,96057035.0,482,203,172,48121808.0,45750373.0,124132,117108,38.77,39.07,241240,93872182.0,375,2023-11-13 17:35:00
923,AFLT,179,100,20606439.0,16578585.0,53054,42507,38.84,39.0,95561,37185024.0,279,141,83,19995513.0,16278784.0,51500,41693,38.83,39.04,93193,36274298.0,224,2023-11-13 17:40:00
924,AFLT,358,194,27906933.0,20342071.0,71705,52024,38.92,39.1,123729,48249004.0,552,342,110,27150822.0,20062816.0,69830,51302,38.88,39.11,121132,47213639.0,452,2023-11-13 17:45:00
925,AFLT,369,245,35211099.0,18177208.0,90365,46499,38.97,39.09,136864,53388308.0,614,292,122,33884719.0,17736892.0,87247,45334,38.84,39.12,132581,51621611.0,414,2023-11-13 17:50:00
926,AFLT,418,218,40900325.0,25482147.0,105083,65448,38.92,38.93,170531,66382472.0,636,388,134,40430013.0,24737451.0,103978,63156,38.88,39.17,167134,65167464.0,522,2023-11-13 17:55:00
927,AFLT,432,187,43111901.0,37458009.0,110760,99608,38.92,37.61,210368,80569911.0,619,380,164,41871813.0,32416279.0,107771,82970,38.85,39.07,190741,74288093.0,544,2023-11-13 18:00:00
928,AFLT,421,168,36033464.0,16590757.0,92757,42509,38.85,39.03,135266,52624222.0,589,378,153,35610299.0,18156400.0,91793,46470,38.79,39.07,138263,53766700.0,531,2023-11-13 18:05:00
929,AFLT,282,213,28465050.0,50550649.0,73242,129593,38.86,39.01,202835,79015700.0,495,282,195,30359194.0,49557438.0,78332,127012,38.76,39.02,205344,79916633.0,477,2023-11-13 18:10:00
930,AFLT,238,137,17244153.0,23207082.0,44313,59385,38.91,39.08,103698,40451236.0,375,188,123,17120566.0,23359844.0,44062,59680,38.86,39.14,103742,40480410.0,311,2023-11-13 18:15:00
931,AFLT,204,205,23825482.0,29750859.0,61459,76276,38.77,39.0,137735,53576342.0,409,158,187,23512430.0,29333686.0,60665,75169,38.76,39.02,135834,52846116.0,345,2023-11-13 18:20:00
932,AFLT,179,185,13122317.0,64149265.0,33784,163383,38.84,39.26,197167,77271583.0,364,128,161,13206763.0,31819415.0,34071,81430,38.76,39.08,115501,45026179.0,289,2023-11-13 18:25:00
933,AFLT,224,117,23825799.0,19428211.0,61441,49849,38.78,38.97,111290,43254010.0,341,178,104,23579462.0,20186796.0,60844,51737,38.75,39.02,112581,43766258.0,282,2023-11-13 18:30:00
934,AFLT,233,132,24267861.0,29305606.0,62561,73148,38.79,40.06,135709,53573467.0,365,185,115,24135696.0,25612311.0,62300,65272,38.74,39.24,127572,49748007.0,300,2023-11-13 18:35:00
935,AFLT,194,10570,6056341.0,1426643311.0,15562,3664094,38.92,38.94,3679656,1432699653.0,10764,182,10563,9224080.0,1430011969.0,23797,3672704,38.76,38.94,3696501,1439236050.0,10745,2023-11-13 18:40:00
936,AFLT,2094,3155,451276792.0,1173580262.0,1180543,3031727,38.23,38.71,4212270,1624857055.0,5249,1221,2103,419361558.0,1107507059.0,1094236,2867140,38.32,38.63,3961376,1526868618.0,3324,2023-11-14 10:05:00
937,AFLT,1442,1520,285574817.0,582956908.0,747085,1517384,38.23,38.42,2264469,868531725.0,2962,850,1280,267899347.0,561912756.0,701334,1458279,38.2,38.53,2159613,829812103.0,2130,2023-11-14 10:10:00
938,AFLT,1020,1305,162772547.0,512031005.0,426154,1334949,38.2,38.36,1761103,674803552.0,2325,657,1117,153047859.0,498041068.0,401196,1296655,38.15,38.41,1697851,651088928.0,1774,2023-11-14 10:15:00
939,AFLT,1789,1928,354347615.0,562572641.0,926648,1468827,38.24,38.3,2395475,916920256.0,3717,1497,1724,335199050.0,549573120.0,878722,1434014,38.15,38.32,2312736,884772170.0,3221,2023-11-14 10:20:00
940,AFLT,1638,789,419001961.0,229435172.0,1096257,600401,38.22,38.21,1696658,648437134.0,2427,1222,583,404661993.0,213233393.0,1059793,555790,38.18,38.37,1615583,617895386.0,1805,2023-11-14 10:25:00
941,AFLT,1044,573,238521822.0,165197958.0,633240,430843,37.67,38.34,1064083,403719781.0,1617,685,454,205900740.0,158066458.0,539449,411275,38.17,38.43,950724,363967198.0,1139,2023-11-14 10:30:00
942,AFLT,883,701,252332807.0,286148134.0,658462,745309,38.32,38.39,1403771,538480942.0,1584,623,580,234943352.0,265086013.0,614680,688358,38.22,38.51,1303038,500029366.0,1203,2023-11-14 10:35:00
943,AFLT,809,626,223695579.0,126479550.0,584977,329910,38.24,38.34,914887,350175129.0,1435,604,548,219409377.0,122847177.0,574111,319412,38.22,38.46,893523,342256555.0,1152,2023-11-14 10:40:00
944,AFLT,364,427,85960563.0,121801927.0,225212,317297,38.17,38.39,542509,207762491.0,791,216,369,77835394.0,119278940.0,203979,309790,38.16,38.5,513769,197114334.0,585,2023-11-14 10:45:00
945,AFLT,577,342,125864175.0,103081134.0,329411,268289,38.21,38.42,597700,228945309.0,919,324,280,121935549.0,100790305.0,319371,262184,38.18,38.44,581555,222725855.0,604,2023-11-14 10:50:00
946,AFLT,626,776,171144722.0,181417771.0,445525,469503,38.41,38.64,915028,352562494.0,1402,419,688,161675171.0,172294558.0,423129,448103,38.21,38.45,871232,333969730.0,1107,2023-11-14 10:55:00
947,AFLT,606,608,145446971.0,123940567.0,376435,323387,38.64,38.33,699822,269387539.0,1214,383,529,138510394.0,119109638.0,363587,309577,38.1,38.47,673164,257620032.0,912,2023-11-14 11:00:00
948,AFLT,884,377,285027616.0,167535757.0,743936,433543,38.31,38.64,1177479,452563374.0,1261,721,324,277001932.0,162539794.0,722949,418042,38.32,38.88,1140991,439541726.0,1045,2023-11-14 11:05:00
949,AFLT,637,508,190161018.0,87201238.0,495531,226336,38.38,38.53,721867,277362256.0,1145,511,459,188733017.0,87927478.0,492390,227955,38.33,38.57,720345,276660496.0,970,2023-11-14 11:10:00
950,AFLT,387,673,84472785.0,98724194.0,221442,256724,38.15,38.46,478166,183196979.0,1060,309,610,79153289.0,97571784.0,206678,252848,38.3,38.59,459526,176725074.0,919,2023-11-14 11:15:00
951,AFLT,493,300,124657159.0,70758665.0,326111,184053,38.23,38.44,510164,195415824.0,793,387,265,119163333.0,65255279.0,311463,169589,38.26,38.48,481052,184418612.0,652,2023-11-14 11:20:00
952,AFLT,527,1313,146002497.0,327397210.0,377684,852410,38.66,38.41,1230094,473399707.0,1840,390,1257,134793334.0,322476403.0,352469,839491,38.24,38.41,1191960,457269738.0,1647,2023-11-14 11:25:00
953,AFLT,335,382,75807800.0,132388381.0,198066,344225,38.27,38.46,542291,208196182.0,717,239,335,73810942.0,130316843.0,192933,338846,38.26,38.46,531779,204127785.0,574,2023-11-14 11:30:00
954,AFLT,279,276,78184334.0,85072211.0,204121,221506,38.3,38.41,425627,163256545.0,555,180,233,78467385.0,82711581.0,205273,214966,38.23,38.48,420239,161178966.0,413,2023-11-14 11:35:00
955,AFLT,266,268,60076999.0,77099345.0,156758,200381,38.32,38.48,357139,137176345.0,534,193,217,59923991.0,74960121.0,156466,194800,38.3,38.48,351266,134884112.0,410,2023-11-14 11:40:00
956,AFLT,354,242,68794674.0,100216692.0,179571,250770,38.31,39.96,430341,169011366.0,596,270,192,66022375.0,95551520.0,172375,247716,38.3,38.57,420091,161573895.0,462,2023-11-14 11:45:00
957,AFLT,288,398,53658452.0,90517717.0,140038,235157,38.32,38.49,375195,144176169.0,686,178,356,53803692.0,89128114.0,140479,231442,38.3,38.51,371921,142931807.0,534,2023-11-14 11:50:00
958,AFLT,246,144,38855507.0,34651580.0,101230,89856,38.38,38.56,191086,73507087.0,390,165,128,37992137.0,34936895.0,99156,90578,38.32,38.57,189734,72929032.0,293,2023-11-14 11:55:00
959,AFLT,309,520,67809664.0,129797317.0,176888,337354,38.33,38.48,514242,197606982.0,829,228,489,67508108.0,128111433.0,176221,332814,38.31,38.49,509035,195619541.0,717,2023-11-14 12:00:00
960,AFLT,372,347,95468153.0,97087577.0,248869,252269,38.36,38.49,501138,192555730.0,719,312,311,97748414.0,94814361.0,255195,246125,38.3,38.52,501320,192562776.0,623,2023-11-14 12:05:00
961,AFLT,289,250,56664470.0,67846935.0,147765,175989,38.35,38.55,323754,124511405.0,539,237,224,55205459.0,63073993.0,144066,163839,38.32,38.5,307905,118279452.0,461,2023-11-14 12:10:00
962,AFLT,609,1066,225008488.0,145496276.0,586555,378461,38.36,38.44,965016,370504765.0,1675,543,1031,224865595.0,175097732.0,586280,445741,38.35,39.28,1032021,399963327.0,1574,2023-11-14 12:15:00
963,AFLT,323,357,90589973.0,92839030.0,235734,242906,38.43,38.22,478640,183429004.0,680,284,301,73328561.0,86982798.0,191519,225653,38.29,38.55,417172,160311359.0,585,2023-11-14 12:20:00
964,AFLT,281,452,60072694.0,122356166.0,156312,319986,38.43,38.24,476298,182428860.0,733,169,413,58140060.0,117063950.0,151618,302792,38.35,38.66,454410,175204010.0,582,2023-11-14 12:25:00
965,AFLT,240,424,51445439.0,115047481.0,133854,299077,38.43,38.47,432931,166492920.0,664,170,397,50457880.0,113526762.0,131614,294527,38.34,38.55,426141,163984642.0,567,2023-11-14 12:30:00
966,AFLT,350,750,110416237.0,175032009.0,288198,456101,38.31,38.38,744299,285448246.0,1100,302,697,108256260.0,171232504.0,282667,444762,38.3,38.5,727429,279488764.0,999,2023-11-14 12:35:00
967,AFLT,414,405,98218384.0,124709885.0,256350,325237,38.31,38.34,581587,222928269.0,819,322,371,95515313.0,121823357.0,249648,316766,38.26,38.46,566414,217338670.0,693,2023-11-14 12:40:00
968,AFLT,531,1071,149864004.0,377868581.0,391465,986662,38.28,38.3,1378127,527732585.0,1602,392,1031,139448988.0,365597329.0,365153,952777,38.19,38.37,1317930,505046317.0,1423,2023-11-14 12:45:00
969,AFLT,333,564,71894486.0,122329857.0,188260,319001,38.19,38.35,507261,194224343.0,897,226,519,71930879.0,117648262.0,188533,306442,38.15,38.39,494975,189579142.0,745,2023-11-14 12:50:00
970,AFLT,226,186,39526230.0,50866381.0,103214,132682,38.3,38.34,235896,90392611.0,412,156,155,38763008.0,45904616.0,101577,119514,38.16,38.41,221091,84667624.0,311,2023-11-14 12:55:00
971,AFLT,427,681,88341428.0,179962936.0,233648,469546,37.81,38.33,703194,268304364.0,1108,282,625,82303697.0,176941683.0,215826,461171,38.13,38.37,676997,259245380.0,907,2023-11-14 13:00:00
972,AFLT,274,285,63022450.0,101717102.0,165419,265961,38.1,38.25,431380,164739552.0,559,176,243,58729378.0,100042895.0,154118,260853,38.11,38.35,414971,158772274.0,419,2023-11-14 13:05:00
973,AFLT,220,361,47536756.0,87253456.0,124044,227903,38.32,38.29,351947,134790212.0,581,168,332,42736951.0,88434855.0,112094,230766,38.13,38.32,342860,131171807.0,500,2023-11-14 13:10:00
974,AFLT,405,353,83998477.0,104985872.0,217844,273706,38.56,38.36,491550,188984349.0,758,326,286,72363374.0,102109255.0,189628,266276,38.16,38.35,455904,174472629.0,612,2023-11-14 13:15:00
975,AFLT,398,296,108071393.0,84646481.0,281824,220493,38.35,38.39,502317,192717875.0,694,345,268,105925755.0,83968461.0,277362,218717,38.19,38.39,496079,189894217.0,613,2023-11-14 13:20:00
976,AFLT,379,281,99800307.0,73699888.0,260838,191819,38.26,38.42,452657,173500195.0,660,330,234,97727532.0,80769769.0,255497,210110,38.25,38.44,465607,178497301.0,564,2023-11-14 13:25:00
977,AFLT,637,257,205416062.0,80023470.0,536679,208846,38.28,38.32,745525,285439532.0,894,580,221,206305133.0,77457094.0,539042,201461,38.27,38.45,740503,283762227.0,801,2023-11-14 13:30:00
978,AFLT,413,458,108808557.0,63793275.0,284709,166334,38.22,38.35,451043,172601833.0,871,376,432,107899256.0,63734219.0,282424,165869,38.2,38.42,448293,171633475.0,808,2023-11-14 13:35:00
979,AFLT,284,446,63671958.0,70362297.0,166790,184298,38.17,38.18,351088,134034255.0,730,198,431,63250990.0,67192485.0,165963,175085,38.11,38.38,341048,130443476.0,629,2023-11-14 13:40:00
980,AFLT,311,219,56838371.0,69966060.0,148935,187308,38.16,37.35,336243,126804432.0,530,259,157,55890418.0,60893271.0,146576,158719,38.13,38.37,305295,116783689.0,416,2023-11-14 13:45:00
981,AFLT,239,209,48971742.0,53119994.0,128621,138558,38.07,38.34,267179,102091736.0,448,188,166,48152302.0,54979170.0,126449,143303,38.08,38.37,269752,103131472.0,354,2023-11-14 13:50:00
982,AFLT,696,646,166999825.0,256098515.0,438813,670863,38.06,38.17,1109676,423098341.0,1342,453,558,157207464.0,221925989.0,413217,580118,38.04,38.26,993335,379133453.0,1011,2023-11-14 13:55:00
983,AFLT,307,341,63810178.0,123871151.0,167542,323819,38.09,38.25,491361,187681329.0,648,241,319,64418235.0,150009601.0,169231,391607,38.07,38.31,560838,214427836.0,560,2023-11-14 14:00:00
984,AFLT,1321,760,474512028.0,273289685.0,1239587,713497,38.28,38.3,1953084,747801714.0,2081,1261,724,465723562.0,271489744.0,1220911,708794,38.15,38.3,1929705,737213306.0,1985,2023-11-14 14:05:00
985,AFLT,2367,768,883560830.0,267742743.0,2314172,698728,38.18,38.32,3012900,1151303574.0,3135,2270,705,879665415.0,264062344.0,2304181,689030,38.18,38.32,2993211,1143727760.0,2975,2023-11-14 14:10:00
986,AFLT,344,310,68676053.0,88617247.0,180303,231464,38.09,38.29,411767,157293300.0,654,309,277,70108009.0,83008896.0,184059,216723,38.09,38.3,400782,153116905.0,586,2023-11-14 14:15:00
987,AFLT,465,226,74382082.0,73973416.0,195407,193146,38.07,38.3,388553,148355499.0,691,390,196,74128590.0,74455079.0,194875,194320,38.04,38.32,389195,148583669.0,586,2023-11-14 14:20:00
988,AFLT,880,439,221191894.0,145284311.0,578156,383637,38.26,37.87,961793,366476205.0,1319,739,360,210004785.0,136847000.0,551975,357781,38.05,38.25,909756,346851785.0,1099,2023-11-14 14:25:00
989,AFLT,907,395,107579183.0,102425461.0,282727,268716,38.05,38.12,551443,210004644.0,1302,817,340,104460490.0,95186411.0,274636,248951,38.04,38.23,523587,199646901.0,1157,2023-11-14 14:30:00
990,AFLT,622,334,132480750.0,94662293.0,348754,247825,37.99,38.2,596579,227143044.0,956,518,258,133472589.0,89760080.0,351309,234832,37.99,38.22,586141,223232669.0,776,2023-11-14 14:35:00
991,AFLT,978,744,216676850.0,260692722.0,571136,686111,37.94,38.0,1257247,477369572.0,1722,575,619,209863961.0,253529972.0,553395,664637,37.92,38.15,1218032,463393933.0,1194,2023-11-14 14:40:00
992,AFLT,475,482,108091275.0,117691993.0,281701,308124,38.37,38.2,589825,225783269.0,957,352,416,99169074.0,113667685.0,261208,297454,37.97,38.21,558662,212836759.0,768,2023-11-14 14:45:00
993,AFLT,316,260,72596722.0,96674205.0,190266,252296,38.16,38.32,442562,169270928.0,576,232,218,67519410.0,70205805.0,177714,183336,37.99,38.29,361050,137725215.0,450,2023-11-14 14:50:00
994,AFLT,468,227,105105589.0,124735432.0,274174,322299,38.34,38.7,596473,229841021.0,695,398,180,96017897.0,115294198.0,252097,297552,38.09,38.75,549649,211312096.0,578,2023-11-14 14:55:00
995,AFLT,322,256,81954395.0,63008306.0,215333,164681,38.06,38.26,380014,144962702.0,578,287,217,81964181.0,61095685.0,215430,159665,38.05,38.26,375095,143059867.0,504,2023-11-14 15:00:00
996,AFLT,493,347,74505388.0,76564459.0,195797,200269,38.05,38.23,396066,151069847.0,840,406,311,71903821.0,74357394.0,189062,194434,38.03,38.24,383496,146261216.0,717,2023-11-14 15:05:00
997,AFLT,1833,418,605795189.0,85485998.0,1588707,218955,38.13,39.04,1807662,691281188.0,2251,1797,371,605398835.0,81052306.0,1587691,211308,38.13,38.36,1798999,686451141.0,2168,2023-11-14 15:10:00
998,AFLT,506,185,81960322.0,57865642.0,215247,151304,38.08,38.24,366551,139825964.0,691,464,171,80647479.0,57477226.0,211896,150200,38.06,38.27,362096,138124706.0,635,2023-11-14 15:15:00
999,AFLT,369,636,75676609.0,249132827.0,199150,653528,38.0,38.12,852678,324809436.0,1005,290,618,75260820.0,246613509.0,198042,645612,38.0,38.2,843654,321874330.0,908,2023-11-14 15:20:00
1000,AFLT,510,189,49178863.0,90261599.0,129355,235853,38.02,38.27,365208,139440462.0,699,455,168,49118725.0,92037017.0,129235,235937,38.01,39.01,365172,141155743.0,623,2023-11-14 15:25:00
1001,AFLT,192,147,35924322.0,51935657.0,94531,135907,38.0,38.21,230438,87859980.0,339,146,138,34668652.0,50255104.0,91205,131457,38.01,38.23,222662,84923757.0,284,2023-11-14 15:30:00
1002,AFLT,316,138,66331035.0,46535654.0,174455,122023,38.02,38.14,296478,112866689.0,454,260,120,65556377.0,44861676.0,172510,117261,38.0,38.26,289771,110418053.0,380,2023-11-14 15:35:00
1003,AFLT,647,205,146529523.0,109720263.0,384833,280585,38.08,39.1,665418,256249786.0,852,587,174,143893831.0,105992844.0,378020,276382,38.07,38.35,654402,249886675.0,761,2023-11-14 15:40:00
1004,AFLT,859,150,186897895.0,65170799.0,489942,170011,38.15,38.33,659953,252068694.0,1009,787,116,186038589.0,64665159.0,487928,168691,38.13,38.33,656619,250703748.0,903,2023-11-14 15:45:00
1005,AFLT,440,112,89832819.0,42760023.0,235995,111843,38.07,38.23,347838,132592842.0,552,400,97,88042080.0,42299405.0,231366,110438,38.05,38.3,341804,130341485.0,497,2023-11-14 15:50:00
1006,AFLT,259,82,48182544.0,25394586.0,126400,66271,38.12,38.32,192671,73577130.0,341,241,63,47137050.0,32780642.0,123740,85553,38.09,38.32,209293,79917692.0,304,2023-11-14 15:55:00
1007,AFLT,231,90,39616258.0,27293141.0,103951,71258,38.11,38.3,175209,66909400.0,321,184,73,38293219.0,25986923.0,100498,67836,38.1,38.31,168334,64280143.0,257,2023-11-14 16:00:00
1008,AFLT,1936,502,780785759.0,161689568.0,2043627,421708,38.21,38.34,2465335,942475328.0,2438,1849,376,769917853.0,155551606.0,2017517,405703,38.16,38.34,2423220,925469459.0,2225,2023-11-14 16:05:00
1009,AFLT,1515,256,543081513.0,77259464.0,1421611,201350,38.2,38.37,1622961,620340977.0,1771,1505,190,544635382.0,75790529.0,1425762,197497,38.2,38.38,1623259,620425911.0,1695,2023-11-14 16:10:00
1010,AFLT,602,217,147260812.0,49287000.0,385607,128727,38.19,38.29,514334,196547812.0,819,524,179,143415002.0,48693604.0,375625,126860,38.18,38.38,502485,192108606.0,703,2023-11-14 16:15:00
1011,AFLT,451,94,74847898.0,29139567.0,196227,75871,38.14,38.41,272098,103987465.0,545,396,75,74755467.0,26584572.0,196300,69157,38.08,38.44,265457,101340040.0,471,2023-11-14 16:20:00
1012,AFLT,402,69,52257096.0,21674196.0,136108,55573,38.39,39.0,191681,73931293.0,471,349,38,51185385.0,21703306.0,133825,55657,38.25,38.99,189482,72888692.0,387,2023-11-14 16:25:00
1013,AFLT,568,158,86574506.0,42674938.0,226151,111242,38.28,38.36,337393,129249444.0,726,516,117,82623115.0,42597564.0,216173,110836,38.22,38.43,327009,125220679.0,633,2023-11-14 16:30:00
1014,AFLT,767,484,183536982.0,148482213.0,477327,385513,38.45,38.52,862840,332019195.0,1251,623,343,174601952.0,143699036.0,456058,373091,38.29,38.52,829149,318300989.0,966,2023-11-14 16:35:00
1015,AFLT,300,141,55456247.0,38576835.0,143599,100383,38.62,38.43,243982,94033082.0,441,232,95,53067686.0,35933949.0,138487,93231,38.32,38.54,231718,89001635.0,327,2023-11-14 16:40:00
1016,AFLT,362,235,76439471.0,69650511.0,199478,181089,38.32,38.46,380567,146089982.0,597,298,163,74706758.0,65372919.0,195113,169697,38.29,38.52,364810,140079678.0,461,2023-11-14 16:45:00
1017,AFLT,406,317,109946722.0,70739636.0,287670,185725,38.22,38.09,473395,180686358.0,723,344,279,108618528.0,65028638.0,284245,169036,38.21,38.47,453281,173647166.0,623,2023-11-14 16:50:00
1018,AFLT,274,169,68330888.0,58546077.0,176781,152129,38.65,38.48,328910,126876966.0,443,214,137,60550098.0,54936887.0,158247,142713,38.26,38.49,300960,115486985.0,351,2023-11-14 16:55:00
1019,AFLT,293,626,69187263.0,65652541.0,180916,171549,38.24,38.27,352465,134839805.0,919,240,579,68911995.0,63406701.0,180222,164923,38.24,38.45,345145,132318696.0,819,2023-11-14 17:00:00
1020,AFLT,296,133,64346623.0,37743476.0,168362,98260,38.22,38.41,266622,102090100.0,429,218,100,63863473.0,63226408.0,167102,158208,38.22,39.96,325310,127089882.0,318,2023-11-14 17:05:00
1021,AFLT,438,113,44820755.0,30659700.0,117106,79916,38.27,38.36,197022,75480456.0,551,403,92,44855564.0,33494591.0,117227,87018,38.26,38.49,204245,78350156.0,495,2023-11-14 17:10:00
1022,AFLT,225,95,43154441.0,30299466.0,112815,79100,38.25,38.31,191915,73453908.0,320,166,79,40347063.0,29685785.0,105495,77192,38.25,38.46,182687,70032849.0,245,2023-11-14 17:15:00
1023,AFLT,252,87,32281660.0,19256669.0,84496,50186,38.2,38.37,134682,51538329.0,339,221,66,32662261.0,18595839.0,85558,48330,38.18,38.48,133888,51258101.0,287,2023-11-14 17:20:00
1024,AFLT,482,122,41716877.0,28866482.0,109094,75668,38.24,38.15,184762,70583359.0,604,434,93,40738673.0,23418997.0,106594,60865,38.22,38.48,167459,64157670.0,527,2023-11-14 17:25:00
1025,AFLT,199,80,22907937.0,16661326.0,59887,28657,38.25,58.14,88544,39569263.0,279,165,39,22053699.0,10535674.0,57698,27374,38.22,38.49,85072,32589373.0,204,2023-11-14 17:30:00
1026,AFLT,338,118,58837624.0,19670395.0,154108,51336,38.18,38.32,205444,78508020.0,456,296,77,58783373.0,19574470.0,153923,50912,38.19,38.45,204835,78357843.0,373,2023-11-14 17:35:00
1027,AFLT,780,405,171168819.0,124290979.0,448504,310710,38.16,40.0,759214,295459799.0,1185,681,296,167575189.0,122071955.0,439055,303411,38.17,40.23,742466,289647144.0,977,2023-11-14 17:40:00
1028,AFLT,256,147,31173283.0,11823890.0,81650,30890,38.18,38.28,112540,42997173.0,403,191,76,30595315.0,11153804.0,80240,29067,38.13,38.37,109307,41749119.0,267,2023-11-14 17:45:00
1029,AFLT,314,299,55513140.0,55327834.0,145640,146187,38.12,37.85,291827,110840974.0,613,230,200,52981972.0,53691219.0,139105,140126,38.09,38.32,279231,106673191.0,430,2023-11-14 17:50:00
1030,AFLT,511,329,72992080.0,39040095.0,191672,102186,38.08,38.2,293858,112032175.0,840,448,225,71078142.0,38199595.0,186625,99744,38.09,38.3,286369,109277737.0,673,2023-11-14 17:55:00
1031,AFLT,370,241,38237361.0,44022244.0,100287,114798,38.13,38.35,215085,82259606.0,611,345,196,37196457.0,44366147.0,97578,115589,38.12,38.38,213167,81562604.0,541,2023-11-14 18:00:00
1032,AFLT,368,406,56345774.0,136055603.0,147783,355273,38.13,38.3,503056,192401377.0,774,333,352,55308907.0,136015545.0,145247,355161,38.08,38.3,500408,191324453.0,685,2023-11-14 18:05:00
1033,AFLT,338,131,50581256.0,56522579.0,132733,147517,38.11,38.32,280250,107103836.0,469,291,99,49981325.0,32792678.0,131145,85595,38.11,38.31,216740,82774004.0,390,2023-11-14 18:10:00
1034,AFLT,801,342,114238181.0,108730800.0,299791,284587,38.11,38.21,584378,222968981.0,1143,742,314,105985218.0,107599021.0,278122,280967,38.11,38.3,559089,213584240.0,1056,2023-11-14 18:15:00
1035,AFLT,1173,721,144142546.0,261194164.0,378421,683727,38.09,38.2,1062148,405336711.0,1894,1079,675,140612200.0,255340535.0,369267,667559,38.08,38.25,1036826,395952736.0,1754,2023-11-14 18:20:00
1036,AFLT,606,269,73405701.0,64841663.0,192782,173479,38.08,37.38,366261,138247365.0,875,449,218,69607617.0,56967569.0,182953,148857,38.05,38.27,331810,126575187.0,667,2023-11-14 18:25:00
1037,AFLT,372,298,44472015.0,78952436.0,117244,174397,37.93,45.27,291641,123424451.0,670,226,247,42772522.0,78434087.0,112827,167790,37.91,46.75,280617,121206609.0,473,2023-11-14 18:30:00
1038,AFLT,229,191,31170631.0,52648215.0,82160,140002,37.94,37.61,222162,83818846.0,420,132,163,28131483.0,50069994.0,74210,130775,37.91,38.29,204985,78201478.0,295,2023-11-14 18:35:00
1039,AFLT,598,106,34350413.0,16091456.0,90327,41979,38.03,38.33,132306,50441869.0,704,555,85,36242920.0,19202056.0,95399,49943,37.99,38.45,145342,55444976.0,640,2023-11-14 18:40:00
1040,AFLT,2577,3890,29403640.0,29403640.0,801137,2146033,3.67,3.74,2947170,109752392.0,6467,1841,2724,27232031.0,27232031.0,735377,2000399,3.7,3.73,2735776,101864301.0,4565,2023-11-29 10:05:00
1041,AFLT,1362,792,13351626.0,13351626.0,363245,312828,3.68,3.7,676073,24911264.0,2154,1198,553,12826046.0,12826046.0,346616,297225,3.7,3.72,643841,23892861.0,1751,2023-11-29 10:10:00
1042,AFLT,651,639,7842376.0,7842376.0,214361,364555,3.66,3.73,578916,21443981.0,1290,466,435,7229883.0,7229883.0,195497,341750,3.7,3.72,537247,19956667.0,901,2023-11-29 10:15:00
1043,AFLT,678,744,8492267.0,8492267.0,233016,338071,3.64,3.59,571087,20642745.0,1422,377,454,7323540.0,7323540.0,199083,276480,3.68,3.71,475563,17588807.0,831,2023-11-29 10:20:00
1044,AFLT,936,3399,18964430.0,18964430.0,528470,3671768,3.59,3.71,4200238,155165149.0,4335,675,3174,16391208.0,16391208.0,444972,3660413,3.68,3.71,4105385,152219222.0,3849,2023-11-29 10:25:00
1045,AFLT,815,728,11138979.0,11138979.0,306634,448482,3.63,3.73,755116,27881584.0,1543,695,580,10780823.0,10780823.0,291848,427334,3.69,3.73,719182,26704443.0,1275,2023-11-29 10:30:00
1046,AFLT,725,496,8749801.0,8749801.0,237954,247872,3.68,3.71,485826,17940070.0,1221,625,380,8267432.0,8267432.0,223587,241679,3.7,3.72,465266,17264688.0,1005,2023-11-29 10:35:00
1047,AFLT,808,574,14123553.0,14123553.0,383332,382638,3.68,3.66,765970,28115645.0,1382,681,468,13840602.0,13840602.0,374934,372383,3.69,3.71,747317,27670870.0,1149,2023-11-29 10:40:00
1048,AFLT,1117,1146,27079079.0,27079079.0,737350,913626,3.67,3.7,1650976,60888381.0,2263,977,985,26562183.0,26562183.0,721845,908958,3.68,3.7,1630803,60222801.0,1962,2023-11-29 10:45:00
1049,AFLT,956,736,29968966.0,29968966.0,812784,539089,3.69,3.71,1351873,49954076.0,1692,843,614,29335225.0,29335225.0,795367,532907,3.69,3.71,1328274,49110745.0,1457,2023-11-29 10:50:00
1050,AFLT,902,1071,24447062.0,24447062.0,663219,657315,3.69,3.7,1320534,48774576.0,1973,831,980,24294906.0,24294906.0,658981,646693,3.69,3.71,1305674,48277515.0,1811,2023-11-29 10:55:00
1051,AFLT,1295,863,33664279.0,33664279.0,915423,545761,3.68,3.7,1461184,53856366.0,2158,1191,719,33657506.0,33657506.0,913774,538832,3.68,3.7,1452606,53620799.0,1910,2023-11-29 11:00:00
1052,AFLT,1675,966,50813077.0,50813077.0,1379764,624408,3.68,3.69,2004172,73852181.0,2641,1546,862,50403234.0,50403234.0,1368261,616695,3.68,3.7,1984956,73247128.0,2408,2023-11-29 11:05:00
1053,AFLT,263,671,7805310.0,7805310.0,213345,303624,3.66,3.7,516969,19053568.0,934,177,586,7644011.0,7644011.0,207751,304198,3.68,3.71,511949,18917267.0,763,2023-11-29 11:10:00
1054,AFLT,710,8267,22996209.0,22996209.0,625299,5503701,3.68,3.7,6129000,226405801.0,8977,635,8211,23014631.0,23014631.0,624524,5484771,3.69,3.7,6109295,225737259.0,8846,2023-11-29 11:15:00
1055,AFLT,269,1130,7964567.0,7964567.0,217447,729970,3.66,3.7,947417,34997488.0,1399,204,1038,7665370.0,7665370.0,208210,725187,3.68,3.7,933397,34521090.0,1242,2023-11-29 11:20:00
1056,AFLT,264,617,7348357.0,7348357.0,201502,247709,3.65,3.67,449211,16446987.0,881,189,492,7000596.0,7000596.0,190239,236641,3.68,3.7,426880,15760822.0,681,2023-11-29 11:25:00
1057,AFLT,462,610,14257945.0,14257945.0,387729,344679,3.68,3.7,732408,27006313.0,1072,364,474,14045722.0,14045722.0,381170,340526,3.68,3.71,721696,26664965.0,838,2023-11-29 11:30:00
1058,AFLT,787,348,21955497.0,21955497.0,595772,244569,3.69,3.71,840341,31022763.0,1135,719,293,21170681.0,21170681.0,573746,240282,3.69,3.71,814028,30075984.0,1012,2023-11-29 11:35:00
1059,AFLT,458,472,11414188.0,11414188.0,310031,415686,3.68,3.66,725717,26622092.0,930,383,403,11275966.0,11275966.0,306140,359293,3.68,3.7,665433,24586066.0,786,2023-11-29 11:40:00
1060,AFLT,497,444,8536417.0,8536417.0,232244,251780,3.68,3.69,484024,17817607.0,941,402,362,8379624.0,8379624.0,227836,251003,3.68,3.7,478839,17663685.0,764,2023-11-29 11:45:00
1061,AFLT,1110,2252,26019410.0,26019410.0,710215,1909728,3.66,3.65,2619943,95720417.0,3362,913,1945,25360970.0,25360970.0,691442,1876780,3.67,3.69,2568222,94535577.0,2858,2023-11-29 11:50:00
1062,AFLT,1489,1747,35550138.0,35550138.0,978725,1375694,3.63,3.67,2354419,86031073.0,3236,1301,1523,34622655.0,34622655.0,945397,1366068,3.66,3.68,2311465,84961122.0,2824,2023-11-29 11:55:00
1063,AFLT,2639,799,105093178.0,105093178.0,2858860,449589,3.68,3.7,3308449,121708907.0,3438,2513,688,105068140.0,105068140.0,2857799,432839,3.68,3.69,3290638,121060177.0,3201,2023-11-29 12:00:00
1064,AFLT,1305,634,45075671.0,45075671.0,1225864,374153,3.68,3.7,1600017,58907611.0,1939,1199,507,44790357.0,44790357.0,1217308,367720,3.68,3.7,1585028,58391756.0,1706,2023-11-29 12:05:00
1065,AFLT,1430,372,59790536.0,59790536.0,1625636,159511,3.68,3.7,1785147,65688952.0,1802,1339,274,59378579.0,59378579.0,1613659,162119,3.68,3.71,1775778,65396555.0,1613,2023-11-29 12:10:00
1066,AFLT,803,883,19841216.0,19841216.0,539580,662561,3.68,3.69,1202141,44306189.0,1686,694,763,19678818.0,19678818.0,534895,665839,3.68,3.71,1200734,44364178.0,1457,2023-11-29 12:15:00
1067,AFLT,436,259,6927130.0,6927130.0,189414,123132,3.66,3.67,312546,11443876.0,695,392,196,6810100.0,6810100.0,185721,121351,3.67,3.69,307072,11289088.0,588,2023-11-29 12:20:00
1068,AFLT,422,463,9690325.0,9690325.0,265227,385785,3.65,3.68,651012,23877507.0,885,342,408,9394862.0,9394862.0,255875,381792,3.67,3.69,637667,23500481.0,750,2023-11-29 12:25:00
1069,AFLT,330,339,7365347.0,7365347.0,200880,226738,3.67,3.65,427618,15640047.0,669,233,259,7226254.0,7226254.0,196968,218954,3.67,3.69,415922,15307702.0,492,2023-11-29 12:30:00
1070,AFLT,474,457,5536209.0,5536209.0,151432,385017,3.66,3.69,536449,19740906.0,931,419,393,5545015.0,5545015.0,151065,386746,3.67,3.69,537811,19814946.0,812,2023-11-29 12:35:00
1071,AFLT,190,213,3520996.0,3520996.0,96499,139276,3.65,3.67,235775,8637483.0,403,140,168,3375238.0,3375238.0,91922,133200,3.67,3.69,225122,8293494.0,308,2023-11-29 12:40:00
1072,AFLT,531,424,9572101.0,9572101.0,260959,363141,3.67,3.69,624100,22969870.0,955,475,389,9421530.0,9421530.0,256738,361364,3.67,3.69,618102,22753703.0,864,2023-11-29 12:45:00
1073,AFLT,938,584,15760715.0,15760715.0,433899,451386,3.63,3.7,885285,32443316.0,1522,885,498,15544436.0,15544436.0,423007,447510,3.67,3.7,870517,32083890.0,1383,2023-11-29 12:50:00
1074,AFLT,823,771,20757113.0,20757113.0,569060,570534,3.65,3.7,1139594,41875672.0,1594,722,664,20662724.0,20662724.0,561888,564832,3.68,3.7,1126720,41572255.0,1386,2023-11-29 12:55:00
1075,AFLT,437,381,8741688.0,8741688.0,240710,242587,3.63,3.7,483297,17711984.0,818,390,310,8829840.0,8829840.0,240073,236245,3.68,3.7,476318,17569721.0,700,2023-11-29 13:00:00
1076,AFLT,1134,680,17800658.0,17800658.0,486232,498684,3.66,3.7,984916,36261294.0,1814,1074,597,17561832.0,17561832.0,477059,495106,3.68,3.7,972165,35889021.0,1671,2023-11-29 13:05:00
1077,AFLT,1831,494,42691036.0,42691036.0,1165547,443421,3.66,3.71,1608968,59141668.0,2325,1729,390,42688470.0,42688470.0,1157715,423772,3.69,3.71,1581487,58404185.0,2119,2023-11-29 13:10:00
1078,AFLT,645,331,13604917.0,13604917.0,370421,286780,3.67,3.7,657201,24224967.0,976,613,281,13546266.0,13546266.0,367574,276193,3.69,3.71,643767,23787489.0,894,2023-11-29 13:15:00
1079,AFLT,840,446,23605292.0,23605292.0,649984,372664,3.63,3.71,1022648,37420907.0,1286,754,368,22822411.0,22822411.0,619171,370008,3.69,3.71,989179,36544996.0,1122,2023-11-29 13:20:00
1080,AFLT,2239,687,88309034.0,88309034.0,2393287,391979,3.69,3.71,2785266,102832714.0,2926,2161,478,86972715.0,86972715.0,2352774,370838,3.7,3.71,2723612,100749267.0,2639,2023-11-29 13:25:00
1081,AFLT,1883,284,70894824.0,70894824.0,1918910,146468,3.69,3.72,2065378,76338411.0,2167,1850,197,71037620.0,71037620.0,1922309,141601,3.7,3.72,2063910,76303197.0,2047,2023-11-29 13:30:00
1082,AFLT,2206,429,89813890.0,89813890.0,2436180,319470,3.69,3.72,2755650,101711225.0,2635,2137,309,89156396.0,89156396.0,2411518,314732,3.7,3.73,2726250,100902839.0,2446,2023-11-29 13:35:00
1083,AFLT,809,443,26000623.0,26000623.0,703022,362934,3.7,3.72,1065956,39495069.0,1252,750,337,25949983.0,25949983.0,700486,350580,3.7,3.73,1051066,39026835.0,1087,2023-11-29 13:40:00
1084,AFLT,784,232,32005817.0,32005817.0,863173,161065,3.71,3.74,1024238,38034933.0,1016,724,167,31854336.0,31854336.0,859054,149054,3.71,3.73,1008108,37410711.0,891,2023-11-29 13:45:00
1085,AFLT,817,251,19189906.0,19189906.0,518077,136842,3.7,3.72,654919,24285634.0,1068,753,177,19036665.0,19036665.0,513860,130691,3.7,3.72,644551,23903665.0,930,2023-11-29 13:50:00
1086,AFLT,4458,291,231445124.0,231445124.0,6258904,130665,3.7,3.71,6389569,236297842.0,4749,4438,234,231399491.0,231399491.0,6257660,127096,3.7,3.72,6384756,236127331.0,4672,2023-11-29 13:55:00
1087,AFLT,544,352,11610578.0,11610578.0,315430,216159,3.68,3.65,531589,19496141.0,896,476,287,11673164.0,11673164.0,316215,216210,3.69,3.72,532425,19713745.0,763,2023-11-29 14:00:00
1088,AFLT,1235,1004,28883893.0,28883893.0,782019,568344,3.69,3.72,1350363,50005754.0,2239,1184,962,28803082.0,28803082.0,779701,565819,3.69,3.72,1345520,49836905.0,2146,2023-11-29 14:05:00
1089,AFLT,1418,758,28836369.0,28836369.0,780379,551406,3.7,3.69,1331785,49164336.0,2176,1363,711,28438684.0,28438684.0,769550,543530,3.7,3.71,1313080,48620418.0,2074,2023-11-29 14:10:00
1090,AFLT,3055,439,135992920.0,135992920.0,3672042,217713,3.7,3.72,3889755,144096674.0,3494,3007,349,135898981.0,135898981.0,3669635,207011,3.7,3.72,3876646,143604109.0,3356,2023-11-29 14:15:00
1091,AFLT,1052,816,31681648.0,31681648.0,875710,560897,3.62,3.73,1436607,52607797.0,1868,946,595,31303436.0,31303436.0,844154,536715,3.71,3.73,1380869,51344595.0,1541,2023-11-29 14:20:00
1092,AFLT,623,393,11716394.0,11716394.0,316257,206614,3.7,3.72,522871,19409604.0,1016,571,281,11858186.0,11858186.0,320316,200011,3.7,3.73,520327,19318357.0,852,2023-11-29 14:25:00
1093,AFLT,2019,463,72120622.0,72120622.0,1946060,355309,3.71,3.69,2301369,85238651.0,2482,1970,383,71902169.0,71902169.0,1940113,343852,3.71,3.73,2283965,84729104.0,2353,2023-11-29 14:30:00
1094,AFLT,1579,242,64435111.0,64435111.0,1737827,161408,3.71,3.73,1899235,70449769.0,1821,1560,200,64369628.0,64369628.0,1735981,160547,3.71,3.73,1896528,70356831.0,1760,2023-11-29 14:35:00
1095,AFLT,2283,393,91729345.0,91729345.0,2470534,360240,3.71,3.73,2830774,105168014.0,2676,2233,295,91400120.0,91400120.0,2461450,355366,3.71,3.73,2816816,104667711.0,2528,2023-11-29 14:40:00
1096,AFLT,6036,156,217200141.0,217200141.0,5855203,118926,3.71,3.77,5974129,221689344.0,6192,6017,98,217156521.0,217156521.0,5853300,66136,3.71,3.73,5919436,219625578.0,6115,2023-11-29 14:45:00
1097,AFLT,5444,361,226277715.0,226277715.0,6097300,401642,3.71,3.73,6498942,241271320.0,5805,5393,310,226170103.0,226170103.0,6093794,400917,3.71,3.73,6494711,241137713.0,5703,2023-11-29 14:50:00
1098,AFLT,1010,209,29752689.0,29752689.0,802770,104702,3.71,3.71,907472,33634697.0,1219,967,139,29715802.0,29715802.0,800846,98754,3.71,3.73,899600,33402250.0,1106,2023-11-29 14:55:00
1099,AFLT,3875,178,162139283.0,162139283.0,4372670,128130,3.71,3.74,4500800,166930801.0,4053,3823,120,162095595.0,162095595.0,4369902,121712,3.71,3.75,4491614,166662442.0,3943,2023-11-29 15:00:00
1100,AFLT,5514,187,226099194.0,226099194.0,6095991,91259,3.71,3.58,6187250,229369377.0,5701,5452,120,226055363.0,226055363.0,6094484,137426,3.71,3.78,6231910,231255981.0,5572,2023-11-29 15:05:00
1101,AFLT,435,243,10158298.0,10158298.0,277980,161319,3.65,3.73,439299,16179627.0,678,372,169,10117331.0,10117331.0,272440,157208,3.71,3.74,429648,15995180.0,541,2023-11-29 15:10:00
1102,AFLT,5260,640,215853673.0,215853673.0,5808004,555756,3.72,3.73,6363760,236596525.0,5900,5170,499,215554365.0,215554365.0,5795300,549606,3.72,3.74,6344906,236115464.0,5669,2023-11-29 15:15:00
1103,AFLT,1326,566,27188797.0,27188797.0,733892,350040,3.7,3.73,1083932,40256303.0,1892,1217,359,26891217.0,26891217.0,721855,340220,3.73,3.75,1062075,39640723.0,1576,2023-11-29 15:20:00
1104,AFLT,293,265,6536083.0,6536083.0,175935,108644,3.72,3.72,284579,10580075.0,558,244,171,6273021.0,6273021.0,168469,106774,3.72,3.75,275243,10276486.0,415,2023-11-29 15:25:00
1105,AFLT,737,460,25726901.0,25726901.0,694048,366230,3.71,3.73,1060278,39391699.0,1197,669,348,25733700.0,25733700.0,690565,358722,3.73,3.75,1049287,39180476.0,1017,2023-11-29 15:30:00
1106,AFLT,718,473,22425291.0,22425291.0,604737,330736,3.71,3.75,935473,34825840.0,1191,628,335,22266069.0,22266069.0,596792,323535,3.73,3.75,920327,34410806.0,963,2023-11-29 15:35:00
1107,AFLT,749,393,18426203.0,18426203.0,495210,232806,3.72,3.75,728016,27163718.0,1142,685,305,18336433.0,18336433.0,491396,223439,3.73,3.75,714835,26723516.0,990,2023-11-29 15:40:00
1108,AFLT,1080,325,36685707.0,36685707.0,984969,196904,3.72,3.75,1181873,44072835.0,1405,1015,225,36468275.0,36468275.0,976167,187115,3.74,3.76,1163282,43496210.0,1240,2023-11-29 15:45:00
1109,AFLT,1600,340,46490055.0,46490055.0,1245838,228940,3.73,3.75,1474778,55071395.0,1940,1550,270,46475605.0,46475605.0,1243738,228769,3.74,3.76,1472507,55069058.0,1820,2023-11-29 15:50:00
1110,AFLT,598,577,17461789.0,17461789.0,468625,368020,3.73,3.74,836645,31237112.0,1175,521,469,17337916.0,17337916.0,464977,359060,3.73,3.75,824037,30817636.0,990,2023-11-29 15:55:00
1111,AFLT,300,221,5232662.0,5232662.0,140609,117947,3.72,3.74,258556,9644061.0,521,239,170,5273905.0,5273905.0,141751,116898,3.72,3.75,258649,9656108.0,409,2023-11-29 16:00:00
1112,AFLT,849,386,11272351.0,11272351.0,303005,210306,3.72,3.72,513311,19097181.0,1235,810,315,11229799.0,11229799.0,301495,205507,3.72,3.75,507002,18932735.0,1125,2023-11-29 16:05:00
1113,AFLT,250,171,3987241.0,3987241.0,106980,82695,3.73,3.75,189675,7087321.0,421,220,146,4085104.0,4085104.0,109631,81466,3.73,3.75,191097,7138961.0,366,2023-11-29 16:10:00
1114,AFLT,437,226,5204823.0,5204823.0,141985,103911,3.67,3.71,245896,9063626.0,663,393,161,5026622.0,5026622.0,134912,101400,3.73,3.75,236312,8829120.0,554,2023-11-29 16:15:00
1115,AFLT,352,262,6633921.0,6633921.0,179100,155206,3.7,3.74,334306,12437365.0,614,267,202,6542905.0,6542905.0,175864,151062,3.72,3.75,326926,12202338.0,469,2023-11-29 16:20:00
1116,AFLT,565,374,8978170.0,8978170.0,242110,283401,3.71,3.71,525511,19499978.0,939,518,310,8915637.0,8915637.0,239611,279692,3.72,3.74,519303,19389880.0,828,2023-11-29 16:25:00
1117,AFLT,6122,6697,203687791.0,203687791.0,5498418,4592420,3.7,3.74,10090838,375485045.0,12819,5279,4641,197264155.0,197264155.0,5285186,4362578,3.73,3.75,9647764,360995794.0,9920,2023-11-29 16:30:00
1118,AFLT,2330,3111,62209026.0,62209026.0,1670326,1368417,3.72,3.72,3038743,113164678.0,5441,1973,1741,60378984.0,60378984.0,1618602,1307693,3.73,3.75,2926295,109417017.0,3714,2023-11-29 16:35:00
1119,AFLT,2709,2457,83031900.0,83031900.0,2234395,1688014,3.72,3.71,3922409,145704527.0,5166,2518,1737,81616823.0,81616823.0,2193758,1650682,3.72,3.74,3844440,143361501.0,4255,2023-11-29 16:40:00
1120,AFLT,2966,2812,100097038.0,100097038.0,2693398,2325815,3.72,3.73,5019213,186877089.0,5778,2746,2212,98148254.0,98148254.0,2637213,2283707,3.72,3.74,4920920,183619774.0,4958,2023-11-29 16:45:00
1121,AFLT,3379,3286,105822256.0,105822256.0,2832913,2014282,3.74,3.75,4847195,181381571.0,6665,2671,2194,104354524.0,104354524.0,2788879,1973287,3.74,3.76,4762166,178598662.0,4865,2023-11-29 16:50:00
1122,AFLT,1474,943,33678555.0,33678555.0,905444,714959,3.72,3.75,1620403,60471287.0,2417,1257,705,32911986.0,32911986.0,880192,680823,3.74,3.76,1561015,58516947.0,1962,2023-11-29 16:55:00
1123,AFLT,1150,1585,34193485.0,34193485.0,919802,1492335,3.72,3.68,2412137,89139601.0,2735,914,1410,32942312.0,32942312.0,883126,1466993,3.73,3.75,2350119,87911687.0,2324,2023-11-29 17:00:00
1124,AFLT,1481,1263,41234256.0,41234256.0,1115208,1026679,3.7,3.75,2141887,79707095.0,2744,1218,1065,40825400.0,40825400.0,1093959,1009206,3.73,3.75,2103165,78670094.0,2283,2023-11-29 17:05:00
1125,AFLT,1149,651,31392115.0,31392115.0,843681,414120,3.72,3.75,1257801,46935825.0,1800,1038,528,31099901.0,31099901.0,832485,411317,3.74,3.76,1243802,46544860.0,1566,2023-11-29 17:10:00
1126,AFLT,744,626,21805669.0,21805669.0,584908,394225,3.73,3.71,979133,36448108.0,1370,673,522,21269456.0,21269456.0,570273,385918,3.73,3.76,956191,35772771.0,1195,2023-11-29 17:15:00
1127,AFLT,489,297,6357655.0,6357655.0,170996,183344,3.72,3.51,354340,12788739.0,786,410,245,6059763.0,6059763.0,162822,169759,3.72,3.75,332581,12424386.0,655,2023-11-29 17:20:00
1128,AFLT,454,487,5538179.0,5538179.0,149318,155966,3.71,3.55,305284,11073665.0,941,272,326,5551530.0,5551530.0,149230,159156,3.72,3.74,308386,11511175.0,598,2023-11-29 17:25:00
1129,AFLT,1100,1548,28985147.0,28985147.0,786644,1058848,3.68,3.69,1845492,68031164.0,2648,780,1253,26585564.0,26585564.0,719346,975166,3.7,3.72,1694512,62882313.0,2033,2023-11-29 17:30:00
1130,AFLT,532,523,8810680.0,8810680.0,238851,188431,3.69,3.68,427282,15746059.0,1055,353,410,8548039.0,8548039.0,231323,191671,3.7,3.72,422994,15686912.0,763,2023-11-29 17:35:00
1131,AFLT,634,430,8778096.0,8778096.0,239254,143422,3.67,3.72,382676,14111140.0,1064,535,331,8915682.0,8915682.0,241034,135540,3.7,3.72,376574,13962368.0,866,2023-11-29 17:40:00
1132,AFLT,388,308,3847777.0,3847777.0,104208,63169,3.69,3.72,167377,6197205.0,696,353,187,3753176.0,3753176.0,101275,62334,3.71,3.73,163609,6076779.0,540,2023-11-29 17:45:00
1133,AFLT,344,360,3316174.0,3316174.0,90714,60150,3.66,3.69,150864,5538438.0,704,314,189,3273336.0,3273336.0,88259,59082,3.71,3.73,147341,5474838.0,503,2023-11-29 17:50:00
1134,AFLT,403,461,6217141.0,6217141.0,168314,158527,3.69,3.67,326841,12033850.0,864,351,313,6248909.0,6248909.0,168987,147660,3.7,3.72,316647,11745432.0,664,2023-11-29 17:55:00
1135,AFLT,228,276,3667725.0,3667725.0,102071,93465,3.59,3.67,195536,7099968.0,504,144,198,2986188.0,2986188.0,80838,87104,3.69,3.72,167942,6223438.0,342,2023-11-29 18:00:00
1136,AFLT,244,307,5032774.0,5032774.0,136502,105818,3.69,3.6,242320,8837139.0,551,205,206,4905976.0,4905976.0,133008,87899,3.69,3.72,220907,8173298.0,411,2023-11-29 18:05:00
1137,AFLT,1432,1855,21631842.0,21631842.0,592812,1635913,3.65,3.67,2228725,81599823.0,3287,1102,1592,19607325.0,19607325.0,534038,1555859,3.67,3.7,2089897,77139821.0,2694,2023-11-29 18:10:00
1138,AFLT,779,966,8960582.0,8960582.0,248495,538527,3.61,3.68,787022,28768377.0,1745,547,732,7974615.0,7974615.0,217866,509233,3.66,3.69,727099,26764393.0,1279,2023-11-29 18:15:00
1139,AFLT,881,349,9373970.0,9373970.0,255656,125298,3.67,3.64,380954,13940560.0,1230,747,259,8818508.0,8818508.0,240601,118415,3.67,3.69,359016,13191233.0,1006,2023-11-29 18:20:00
1140,AFLT,460,318,5140734.0,5140734.0,140821,87118,3.65,3.69,227939,8352414.0,778,374,211,5491500.0,5491500.0,149775,82525,3.67,3.71,232300,8550903.0,585,2023-11-29 18:25:00
1141,AFLT,514,350,5922150.0,5922150.0,164260,138157,3.61,3.68,302417,11008977.0,864,408,252,5839065.0,5839065.0,159047,128623,3.67,3.69,287670,10583202.0,660,2023-11-29 18:30:00
1142,AFLT,385,740,3537884.0,3537884.0,96567,494011,3.66,3.68,590578,21707431.0,1125,306,661,3388635.0,3388635.0,92401,487387,3.67,3.69,579788,21352922.0,967,2023-11-29 18:35:00
1143,AFLT,573,626,6582149.0,6582149.0,179859,335800,3.66,3.65,515659,18842010.0,1199,515,545,6506158.0,6506158.0,177416,340266,3.67,3.69,517682,19059836.0,1060,2023-11-29 18:40:00
1144,AFLT,1969,3849,27831643.0,27831643.0,779585,1836029,3.57,3.66,2615614,95011835.0,5818,981,2692,24059740.0,24059740.0,659856,1689914,3.65,3.67,2349770,86081711.0,3673,2023-11-30 10:05:00
1145,AFLT,1978,1874,54366493.0,54366493.0,1502118,1207793,3.62,3.67,2709911,98722146.0,3852,1713,1586,53067802.0,53067802.0,1453250,1143409,3.65,3.67,2596659,94992305.0,3299,2023-11-30 10:10:00
1146,AFLT,1658,2426,46842995.0,46842995.0,1285417,902288,3.64,3.67,2187705,79956303.0,4084,1262,1966,44815053.0,44815053.0,1226043,853823,3.66,3.67,2079866,76182429.0,3228,2023-11-30 10:15:00
1147,AFLT,658,1277,10779608.0,10779608.0,297735,455556,3.62,3.61,753291,27227342.0,1935,346,958,9476381.0,9476381.0,260571,384243,3.64,3.66,644814,23530231.0,1304,2023-11-30 10:20:00
1148,AFLT,1330,2001,39408444.0,39408444.0,1091068,1277217,3.61,3.64,2368285,85900061.0,3331,943,1570,37517902.0,37517902.0,1033390,1250683,3.63,3.65,2284073,83182812.0,2513,2023-11-30 10:25:00
1149,AFLT,525,1088,12803543.0,12803543.0,352894,451414,3.63,3.62,804308,29165657.0,1613,360,936,12462834.0,12462834.0,343181,448023,3.63,3.66,791204,28853125.0,1296,2023-11-30 10:30:00
1150,AFLT,682,1366,18574842.0,18574842.0,515209,1182694,3.61,3.62,1697903,61392167.0,2048,457,1184,17291714.0,17291714.0,476966,1163671,3.63,3.65,1640637,59724348.0,1641,2023-11-30 10:35:00
1151,AFLT,781,2226,19266272.0,19266272.0,532695,2143690,3.62,3.65,2676385,97523046.0,3007,597,2102,18908522.0,18908522.0,521266,2133051,3.63,3.65,2654317,96792428.0,2699,2023-11-30 10:40:00
1152,AFLT,580,489,10592306.0,10592306.0,292138,272561,3.63,3.65,564699,20530133.0,1069,465,356,10269354.0,10269354.0,283020,267310,3.63,3.65,550330,20023111.0,821,2023-11-30 10:45:00
1153,AFLT,272,314,6650856.0,6650856.0,184627,183480,3.6,3.64,368107,13333114.0,586,184,233,6554302.0,6554302.0,180737,179105,3.63,3.65,359842,13088892.0,417,2023-11-30 10:50:00
1154,AFLT,381,470,9636200.0,9636200.0,266284,286134,3.62,3.65,552418,20076136.0,851,292,359,8837466.0,8837466.0,243510,273606,3.63,3.65,517116,18829693.0,651,2023-11-30 10:55:00
1155,AFLT,1086,1581,32731219.0,32731219.0,903022,1063195,3.62,3.65,1966217,71515284.0,2667,903,1288,32009760.0,32009760.0,881626,1047456,3.63,3.65,1929082,70281785.0,2191,2023-11-30 11:00:00
1156,AFLT,420,862,13106842.0,13106842.0,364574,475599,3.6,3.6,840173,30248540.0,1282,297,697,12773099.0,12773099.0,353005,458743,3.62,3.64,811748,29486438.0,994,2023-11-30 11:05:00
1157,AFLT,624,870,16864644.0,16864644.0,467207,628669,3.61,3.63,1095876,39708876.0,1494,469,745,15921374.0,15921374.0,440154,622970,3.62,3.64,1063124,38615348.0,1214,2023-11-30 11:10:00
1158,AFLT,381,722,11615894.0,11615894.0,321361,412161,3.61,3.61,733522,26507193.0,1103,288,599,11242912.0,11242912.0,310876,406887,3.62,3.64,717763,26066558.0,887,2023-11-30 11:15:00
1159,AFLT,652,1154,23757001.0,23757001.0,657617,811430,3.61,3.64,1469047,53289202.0,1806,517,987,21331305.0,21331305.0,590099,798023,3.61,3.65,1388122,50428499.0,1504,2023-11-30 11:20:00
1160,AFLT,657,738,13576059.0,13576059.0,383026,442496,3.54,3.65,825522,29714789.0,1395,543,586,13028089.0,13028089.0,366692,433756,3.55,3.65,800448,28855597.0,1129,2023-11-30 11:25:00
1161,AFLT,429,600,13198017.0,13198017.0,368267,391819,3.58,3.65,760086,27488606.0,1029,332,494,12673712.0,12673712.0,349531,382964,3.63,3.65,732495,26657689.0,826,2023-11-30 11:30:00
1162,AFLT,634,940,18027505.0,18027505.0,497655,637600,3.62,3.65,1135255,41316480.0,1574,492,785,18062780.0,18062780.0,497601,625932,3.63,3.65,1123533,40939448.0,1277,2023-11-30 11:35:00
1163,AFLT,692,566,11235425.0,11235425.0,308980,319457,3.64,3.6,628437,22720497.0,1258,609,446,10810270.0,10810270.0,297223,305307,3.64,3.66,602530,21987545.0,1055,2023-11-30 11:40:00
1164,AFLT,682,615,11668949.0,11668949.0,321295,383086,3.63,3.66,704381,25687371.0,1297,641,502,11650258.0,11650258.0,320215,380253,3.64,3.66,700468,25572493.0,1143,2023-11-30 11:45:00
1165,AFLT,521,351,7369746.0,7369746.0,203675,195433,3.62,3.65,399108,14507839.0,872,485,274,7221498.0,7221498.0,198563,187199,3.64,3.66,385762,14074447.0,759,2023-11-30 11:50:00
1166,AFLT,207,170,3444953.0,3444953.0,95027,88701,3.63,3.65,183728,6686878.0,377,177,133,3237855.0,3237855.0,89011,87655,3.64,3.66,176666,6442290.0,310,2023-11-30 11:55:00
1167,AFLT,825,810,13414693.0,13414693.0,369767,736079,3.63,3.51,1105846,39248506.0,1635,697,695,12846574.0,12846574.0,353579,706812,3.63,3.65,1060391,38652347.0,1392,2023-11-30 12:00:00
1168,AFLT,275,4650,3197953.0,3197953.0,88748,5999146,3.6,3.64,6087894,221519475.0,4925,175,4541,2953002.0,2953002.0,81555,5988893,3.62,3.64,6070448,220900495.0,4716,2023-11-30 12:05:00
1169,AFLT,192,2239,5723291.0,5723291.0,158141,2790467,3.62,3.64,2948608,107389707.0,2431,141,2162,5687628.0,5687628.0,156938,2788311,3.62,3.64,2945249,107281880.0,2303,2023-11-30 12:10:00
1170,AFLT,389,1225,11593126.0,11593126.0,328564,1258425,3.53,3.64,1586989,57448717.0,1614,307,1144,10716571.0,10716571.0,295467,1235800,3.63,3.64,1531267,55760900.0,1451,2023-11-30 12:15:00
1171,AFLT,271,319,4180700.0,4180700.0,115908,127441,3.61,3.64,243349,8816588.0,590,187,236,4007178.0,4007178.0,110530,128175,3.63,3.65,238705,8679490.0,423,2023-11-30 12:20:00
1172,AFLT,389,834,10397404.0,10397404.0,287376,812159,3.62,3.64,1099535,39937327.0,1223,316,773,10428399.0,10428399.0,287351,811101,3.63,3.64,1098452,39968398.0,1089,2023-11-30 12:25:00
1173,AFLT,150,341,1927223.0,1927223.0,53174,218169,3.62,3.64,271343,9879361.0,491,116,292,1977701.0,1977701.0,54537,216381,3.63,3.65,270918,9868728.0,408,2023-11-30 12:30:00
1174,AFLT,186,446,1982293.0,1982293.0,55207,198631,3.59,3.64,253838,9207688.0,632,119,379,1975307.0,1975307.0,54544,197664,3.62,3.64,252208,9176588.0,498,2023-11-30 12:35:00
1175,AFLT,181,388,2044309.0,2044309.0,56442,195932,3.62,3.62,252374,9144396.0,569,151,340,2024853.0,2024853.0,55841,190687,3.63,3.65,246528,8978342.0,491,2023-11-30 12:40:00
1176,AFLT,200,640,3388881.0,3388881.0,93654,226043,3.62,3.63,319697,11597263.0,840,135,582,3332167.0,3332167.0,91880,224098,3.63,3.65,315978,11502999.0,717,2023-11-30 12:45:00
1177,AFLT,539,4877,19046833.0,19046833.0,532421,5827925,3.58,3.64,6360346,231130666.0,5416,464,4808,18151709.0,18151709.0,500322,5823838,3.63,3.64,6324160,230152566.0,5272,2023-11-30 12:50:00
1178,AFLT,560,2113,20454676.0,20454676.0,569546,2424129,3.59,3.64,2993675,108737882.0,2673,480,2042,19628125.0,19628125.0,541302,2420395,3.63,3.65,2961697,107854017.0,2522,2023-11-30 12:55:00
1179,AFLT,553,1109,19618867.0,19618867.0,541133,1191041,3.63,3.64,1732174,62973456.0,1662,482,1034,19688905.0,19688905.0,542930,1187408,3.63,3.64,1730338,62921264.0,1516,2023-11-30 13:00:00
1180,AFLT,593,1154,13319776.0,13319776.0,367821,1228659,3.62,3.64,1596480,58032296.0,1747,528,1096,13354641.0,13354641.0,368337,1227732,3.63,3.64,1596069,58036296.0,1624,2023-11-30 13:05:00
1181,AFLT,2381,7627,90383720.0,90383720.0,2490895,9613908,3.63,3.64,12104803,440106769.0,10008,2332,7564,90336966.0,90336966.0,2489199,9610461,3.63,3.64,12099660,439942497.0,9896,2023-11-30 13:10:00
1182,AFLT,619,3625,10810639.0,10810639.0,298730,4710513,3.62,3.63,5009243,181936949.0,4244,518,3545,10655043.0,10655043.0,294122,4703361,3.62,3.64,4997483,181707300.0,4063,2023-11-30 13:15:00
1183,AFLT,404,1106,9998950.0,9998950.0,276524,1301937,3.62,3.63,1578461,57296902.0,1510,280,1010,9538922.0,9538922.0,263446,1293396,3.62,3.63,1556842,56546015.0,1290,2023-11-30 13:20:00
1184,AFLT,429,1160,11443054.0,11443054.0,315922,1487078,3.62,3.64,1803000,65558010.0,1589,337,1088,11318670.0,11318670.0,312370,1481821,3.62,3.64,1794191,65245841.0,1425,2023-11-30 13:25:00
1185,AFLT,223,260,4209900.0,4209900.0,116564,90599,3.61,3.58,207163,7455967.0,483,162,184,4077723.0,4077723.0,112794,87548,3.62,3.64,200342,7263636.0,346,2023-11-30 13:30:00
1186,AFLT,171,172,2503008.0,2503008.0,70639,61153,3.54,3.63,131792,4724904.0,343,106,124,2398071.0,2398071.0,66322,62998,3.62,3.64,129320,4691284.0,230,2023-11-30 13:35:00
1187,AFLT,379,749,9052001.0,9052001.0,251866,791205,3.59,3.64,1043071,37818992.0,1128,298,682,8957476.0,8957476.0,247149,785881,3.62,3.64,1033030,37535070.0,980,2023-11-30 13:40:00
1188,AFLT,206,356,3962459.0,3962459.0,109398,289574,3.62,3.63,398972,14488249.0,562,163,299,3837443.0,3837443.0,105880,289106,3.62,3.64,394986,14353053.0,462,2023-11-30 13:45:00
1189,AFLT,1846,3565,68594280.0,68594280.0,1890745,4452779,3.63,3.64,6343524,230621845.0,5411,1789,3498,68482451.0,68482451.0,1886649,4453513,3.63,3.64,6340162,230539327.0,5287,2023-11-30 13:50:00
1190,AFLT,323,643,6739011.0,6739011.0,187031,540319,3.6,3.64,727350,26427992.0,966,255,540,6515837.0,6515837.0,179640,528222,3.63,3.64,707862,25760457.0,795,2023-11-30 13:55:00
1191,AFLT,246,287,3984882.0,3984882.0,115280,129534,3.46,3.66,244814,8720110.0,533,205,237,4110442.0,4110442.0,113210,125812,3.63,3.65,239022,8707829.0,442,2023-11-30 14:00:00
1192,AFLT,636,402,21832875.0,21832875.0,603301,271149,3.62,3.65,874450,31731943.0,1038,586,333,21430620.0,21430620.0,589625,267048,3.63,3.66,856673,31199714.0,919,2023-11-30 14:05:00
1193,AFLT,249,366,4583666.0,4583666.0,126364,149101,3.63,3.64,275465,10010855.0,615,213,289,4392459.0,4392459.0,120882,140490,3.63,3.65,261372,9524429.0,502,2023-11-30 14:10:00
1194,AFLT,217,278,3337428.0,3337428.0,92181,108038,3.62,3.64,200219,7270662.0,495,180,228,3413037.0,3413037.0,94006,109588,3.63,3.65,203594,7414667.0,408,2023-11-30 14:15:00
1195,AFLT,348,427,9729418.0,9729418.0,277983,270724,3.5,3.66,548707,19629820.0,775,306,330,9688008.0,9688008.0,266943,263933,3.63,3.66,530876,19342835.0,636,2023-11-30 14:20:00
1196,AFLT,452,391,13747202.0,13747202.0,381342,267268,3.6,3.66,648610,23536221.0,843,415,323,13695326.0,13695326.0,376556,261960,3.64,3.66,638516,23288296.0,738,2023-11-30 14:25:00
1197,AFLT,220,208,4756642.0,4756642.0,130976,99922,3.63,3.66,230898,8414660.0,428,181,169,4735546.0,4735546.0,130312,96486,3.63,3.66,226798,8263092.0,350,2023-11-30 14:30:00
1198,AFLT,300,489,7384909.0,7384909.0,203552,330551,3.63,3.65,534103,19457728.0,789,240,436,7213591.0,7213591.0,198643,319171,3.63,3.65,517814,18874179.0,676,2023-11-30 14:35:00
1199,AFLT,222,725,3560258.0,3560258.0,99054,447295,3.59,3.61,546349,19705870.0,947,181,675,3610471.0,3610471.0,99525,438198,3.63,3.64,537723,19581937.0,856,2023-11-30 14:40:00
1200,AFLT,227,522,3839197.0,3839197.0,107622,401860,3.57,3.65,509482,18514869.0,749,195,482,3815469.0,3815469.0,105229,401482,3.63,3.65,506711,18478110.0,677,2023-11-30 14:45:00
1201,AFLT,353,1014,8052216.0,8052216.0,222153,609379,3.62,3.65,831532,30278839.0,1367,319,947,7870720.0,7870720.0,217025,609766,3.63,3.65,826791,30114281.0,1266,2023-11-30 14:50:00
1202,AFLT,273,1260,5146104.0,5146104.0,141988,879991,3.62,3.63,1021979,37125227.0,1533,225,1201,5085073.0,5085073.0,140208,875328,3.63,3.64,1015536,36966975.0,1426,2023-11-30 14:55:00
1203,AFLT,239,412,4887880.0,4887880.0,136745,234424,3.57,3.65,371169,13452792.0,651,189,357,4825432.0,4825432.0,133004,233480,3.63,3.65,366484,13354577.0,546,2023-11-30 15:00:00
1204,AFLT,301,427,7123687.0,7123687.0,199298,192182,3.57,3.65,391480,14142260.0,728,246,351,6468040.0,6468040.0,178234,187734,3.63,3.66,365968,13338901.0,597,2023-11-30 15:05:00
1205,AFLT,140,265,1304055.0,1304055.0,36158,58567,3.61,3.65,94725,3444331.0,405,139,205,1339152.0,1339152.0,36876,58831,3.63,3.66,95707,3493239.0,344,2023-11-30 15:10:00
1206,AFLT,191,339,4213303.0,4213303.0,116044,129238,3.63,3.65,245282,8935578.0,530,151,291,4043891.0,4043891.0,111295,128729,3.63,3.66,240024,8756511.0,442,2023-11-30 15:15:00
1207,AFLT,734,1055,25244457.0,25244457.0,697103,456007,3.62,3.66,1153110,41947576.0,1789,644,877,24600288.0,24600288.0,676129,431925,3.64,3.66,1108054,40428714.0,1521,2023-11-30 15:20:00
1208,AFLT,502,628,16494003.0,16494003.0,453970,266003,3.63,3.66,719973,26233709.0,1130,452,559,16223899.0,16223899.0,445555,254749,3.64,3.66,700304,25557091.0,1011,2023-11-30 15:25:00
1209,AFLT,345,348,11576678.0,11576678.0,318079,120372,3.64,3.63,438451,15949261.0,693,343,284,11722679.0,11722679.0,322028,116589,3.64,3.66,438617,15988859.0,627,2023-11-30 15:30:00
1210,AFLT,194,398,4241281.0,4241281.0,116931,155369,3.63,3.64,272300,9897413.0,592,169,330,4311654.0,4311654.0,118691,152844,3.63,3.66,271535,9900320.0,499,2023-11-30 15:35:00
1211,AFLT,274,469,5167428.0,5167428.0,142225,142958,3.63,3.66,285183,10403095.0,743,273,411,5125378.0,5125378.0,140936,139216,3.64,3.66,280152,10219654.0,684,2023-11-30 15:40:00
1212,AFLT,167,194,2502589.0,2502589.0,69132,56048,3.62,3.62,125180,4531801.0,361,122,134,2356951.0,2356951.0,64869,54809,3.63,3.67,119678,4368131.0,256,2023-11-30 15:45:00
1213,AFLT,250,398,7285994.0,7285994.0,200727,182250,3.63,3.66,382977,13957917.0,648,224,325,7156158.0,7156158.0,196984,179460,3.63,3.66,376444,13716642.0,549,2023-11-30 15:50:00
1214,AFLT,405,760,12685457.0,12685457.0,349751,380653,3.63,3.66,730404,26613633.0,1165,374,677,12628663.0,12628663.0,347186,376220,3.64,3.66,723406,26399181.0,1051,2023-11-30 15:55:00
1215,AFLT,706,934,24657868.0,24657868.0,677592,384274,3.64,3.65,1061866,38696557.0,1640,630,835,24366709.0,24366709.0,669431,378220,3.64,3.66,1047651,38210089.0,1465,2023-11-30 16:00:00
1216,AFLT,238,600,4829560.0,4829560.0,133016,241590,3.63,3.65,374606,13650127.0,838,213,515,4745562.0,4745562.0,130687,237798,3.63,3.65,368485,13434339.0,728,2023-11-30 16:05:00
1217,AFLT,486,961,11668980.0,11668980.0,322734,338836,3.62,3.64,661570,24007964.0,1447,422,850,11459701.0,11459701.0,315440,332854,3.63,3.65,648294,23615523.0,1272,2023-11-30 16:10:00
1218,AFLT,333,479,6779128.0,6779128.0,186919,239420,3.63,3.58,426339,15340871.0,812,289,359,6519635.0,6519635.0,179492,226227,3.63,3.65,405719,14788175.0,648,2023-11-30 16:15:00
1219,AFLT,431,967,9517324.0,9517324.0,262491,383002,3.63,3.62,645493,23364424.0,1398,391,859,9528422.0,9528422.0,262717,373765,3.63,3.65,636482,23157657.0,1250,2023-11-30 16:20:00
1220,AFLT,252,430,4974537.0,4974537.0,138433,213844,3.59,3.64,352277,12764069.0,682,223,379,4836059.0,4836059.0,133267,213427,3.63,3.65,346694,12622516.0,602,2023-11-30 16:25:00
1221,AFLT,196,243,2213363.0,2213363.0,61027,73689,3.63,3.64,134716,4897024.0,439,142,198,2158419.0,2158419.0,59510,74325,3.63,3.64,133835,4865846.0,340,2023-11-30 16:30:00
1222,AFLT,178,453,3581859.0,3581859.0,99099,173228,3.61,3.62,272327,9854435.0,631,169,400,3691153.0,3691153.0,101876,172276,3.62,3.64,274152,9966390.0,569,2023-11-30 16:35:00
1223,AFLT,123,446,2543073.0,2543073.0,70329,151764,3.62,3.64,222093,8064216.0,569,102,403,2440003.0,2440003.0,67340,150409,3.62,3.64,217749,7917210.0,505,2023-11-30 16:40:00
1224,AFLT,287,1312,6558620.0,6558620.0,181622,552726,3.61,3.41,734348,25413252.0,1599,196,1205,6300378.0,6300378.0,173992,505334,3.62,3.64,679326,24699580.0,1401,2023-11-30 16:45:00
1225,AFLT,105,583,1337745.0,1337745.0,37258,115001,3.59,3.6,152259,5482091.0,688,102,483,1292214.0,1292214.0,35787,106595,3.61,3.64,142382,5166955.0,585,2023-11-30 16:50:00
1226,AFLT,449,631,6275857.0,6275857.0,174222,203074,3.6,3.52,377296,13432225.0,1080,310,420,6082029.0,6082029.0,168409,160629,3.61,3.64,329038,11933962.0,730,2023-11-30 16:55:00
1227,AFLT,605,402,11482504.0,11482504.0,323569,122681,3.55,3.63,446250,15941288.0,1007,512,281,11450804.0,11450804.0,316690,120884,3.62,3.64,437574,15845808.0,793,2023-11-30 17:00:00
1228,AFLT,262,294,5925034.0,5925034.0,164418,115501,3.6,3.61,279919,10090698.0,556,213,224,5117315.0,5117315.0,141686,111307,3.61,3.64,252993,9164206.0,437,2023-11-30 17:05:00
1229,AFLT,417,419,7159752.0,7159752.0,199237,163725,3.59,3.63,362962,13095665.0,836,321,292,6855513.0,6855513.0,189851,152691,3.61,3.63,342542,12404975.0,613,2023-11-30 17:10:00
1230,AFLT,630,1076,15307576.0,15307576.0,427150,957216,3.58,3.62,1384366,49914535.0,1706,459,931,13959578.0,13959578.0,387159,926496,3.61,3.63,1313655,47555637.0,1390,2023-11-30 17:15:00
1231,AFLT,407,470,8678547.0,8678547.0,246044,295786,3.53,3.62,541830,19398656.0,877,292,343,9070786.0,9070786.0,251674,274887,3.6,3.63,526561,19048088.0,635,2023-11-30 17:20:00
1232,AFLT,252,320,3662123.0,3662123.0,101730,104667,3.6,3.62,206397,7455468.0,572,166,207,3589688.0,3589688.0,99638,100887,3.6,3.63,200525,7250598.0,373,2023-11-30 17:25:00
1233,AFLT,192,219,4031828.0,4031828.0,112062,93022,3.6,3.57,205084,7348272.0,411,153,161,3729286.0,3729286.0,103483,94758,3.6,3.63,198241,7167887.0,314,2023-11-30 17:30:00
1234,AFLT,277,275,4226600.0,4226600.0,117629,140121,3.59,3.63,257750,9311062.0,552,196,227,4147735.0,4147735.0,115127,139793,3.6,3.63,254920,9224808.0,423,2023-11-30 17:35:00
1235,AFLT,270,422,2581336.0,2581336.0,73028,132367,3.53,3.63,205395,7382776.0,692,168,342,2426407.0,2426407.0,67275,128154,3.61,3.63,195429,7084731.0,510,2023-11-30 17:40:00
1236,AFLT,692,645,11506858.0,11506858.0,332983,299319,3.46,3.63,632302,22381924.0,1337,583,462,11159675.0,11159675.0,308917,293072,3.61,3.63,601989,21809833.0,1045,2023-11-30 17:45:00
1237,AFLT,999,973,28420052.0,28420052.0,789337,403653,3.6,3.55,1192990,42744958.0,1972,884,701,28112295.0,28112295.0,777361,389242,3.62,3.64,1166603,42266954.0,1585,2023-11-30 17:50:00
1238,AFLT,441,537,6418162.0,6418162.0,178137,124672,3.6,3.62,302809,10933776.0,978,378,384,6353413.0,6353413.0,175979,119562,3.61,3.63,295541,10695597.0,762,2023-11-30 17:55:00
1239,AFLT,836,293,16553769.0,16553769.0,457987,108003,3.61,3.63,565990,20470233.0,1129,771,232,16591597.0,16591597.0,458664,107256,3.62,3.63,565920,20489976.0,1003,2023-11-30 18:00:00
1240,AFLT,2584,456,91009238.0,91009238.0,2526590,191060,3.6,3.64,2717650,97961494.0,3040,2477,355,90843312.0,90843312.0,2508919,186569,3.62,3.64,2695488,97635005.0,2832,2023-11-30 18:05:00
1241,AFLT,1372,248,63591643.0,63591643.0,1760586,92981,3.61,3.63,1853567,66969178.0,1620,1326,184,63013957.0,63013957.0,1740552,91311,3.62,3.65,1831863,66343228.0,1510,2023-11-30 18:10:00
1242,AFLT,530,383,12317753.0,12317753.0,341641,131444,3.61,3.64,473085,17101981.0,913,476,301,12281942.0,12281942.0,338946,130408,3.62,3.65,469354,17037080.0,777,2023-11-30 18:15:00
1243,AFLT,577,251,14764103.0,14764103.0,407506,93269,3.62,3.65,500775,18171970.0,828,544,215,14648471.0,14648471.0,404370,92893,3.62,3.65,497263,18042481.0,759,2023-11-30 18:20:00
1244,AFLT,509,552,10987921.0,10987921.0,313100,212813,3.51,3.65,525913,18762625.0,1061,455,423,10915021.0,10915021.0,301045,204391,3.63,3.66,505436,18392095.0,878,2023-11-30 18:25:00
1245,AFLT,506,534,11077717.0,11077717.0,309752,158006,3.58,3.6,467758,16758364.0,1040,411,384,11039100.0,11039100.0,303925,156099,3.63,3.66,460024,16749746.0,795,2023-11-30 18:30:00
1246,AFLT,532,454,13032172.0,13032172.0,360479,138308,3.62,3.62,498787,18045341.0,986,451,339,12841589.0,12841589.0,353921,132982,3.63,3.66,486903,17702457.0,790,2023-11-30 18:35:00
1247,AFLT,397,331,7330048.0,7330048.0,202222,50210,3.62,3.65,252432,9163980.0,728,365,257,7346583.0,7346583.0,202502,47993,3.63,3.66,250495,9101821.0,622,2023-11-30 18:40:00
0,BANE,992,1944,233606476.0,441990703.0,114462,217259,2040.9,2034.4,331721,675597179.0,2936,858,1788,223830160.0,427706336.0,111251,210686,2011.9,2030.1,321937,651536496.0,2646,2023-11-01 10:05:00
1,BANE,1529,942,162452018.0,235328521.0,80715,116037,2012.7,2028.0,196752,397780539.0,2471,1495,908,163328431.0,235457643.0,80365,116103,2032.3,2028.0,196468,398786074.0,2403,2023-11-01 10:10:00
2,BANE,2081,2326,448628674.0,757093590.0,220294,370000,2036.5,2046.2,590294,1205722264.0,4407,2055,2302,446055272.0,756498989.0,219459,369713,2032.5,2046.2,589172,1202554261.0,4357,2023-11-01 10:15:00
3,BANE,1569,1789,406095158.0,390532490.0,201687,191862,2013.5,2035.5,393549,796627649.0,3358,1558,1770,405916734.0,390182789.0,201637,191682,2013.1,2035.6,393319,796099523.0,3328,2023-11-01 10:20:00
4,BANE,1602,1012,347396033.0,260491510.0,172329,128114,2015.9,2033.3,300443,607887543.0,2614,1597,1010,347105006.0,260469185.0,172184,128106,2015.9,2033.2,300290,607574191.0,2607,2023-11-01 10:25:00
5,BANE,1711,1720,432005097.0,421435836.0,214114,206747,2017.6,2038.4,420861,853440934.0,3431,1686,1706,430611822.0,421246345.0,213419,206619,2017.7,2038.8,420038,851858167.0,3392,2023-11-01 10:30:00
6,BANE,1924,2075,361516735.0,364381183.0,179047,179040,2019.1,2035.2,358087,725897919.0,3999,1911,2060,361156511.0,363953946.0,178867,178809,2019.1,2035.4,357676,725110457.0,3971,2023-11-01 10:35:00
7,BANE,1761,1199,371028699.0,224471139.0,184493,110084,2011.1,2039.1,294577,595499838.0,2960,1741,1189,370850324.0,223457734.0,184409,109594,2011.0,2039.0,294003,594308059.0,2930,2023-11-01 10:40:00
8,BANE,1742,679,224241635.0,171659773.0,111422,84303,2012.5,2036.2,195725,395901409.0,2421,1738,670,223948569.0,171364008.0,111275,84155,2012.6,2036.3,195430,395312577.0,2408,2023-11-01 10:45:00
9,BANE,1959,745,260167044.0,197465720.0,129196,97161,2013.7,2032.4,226357,457632765.0,2704,1950,745,260185198.0,196926028.0,129205,96895,2013.7,2032.4,226100,457111227.0,2695,2023-11-01 10:50:00
10,BANE,1778,500,273572822.0,92778749.0,135945,45802,2012.4,2025.6,181747,366351572.0,2278,1773,494,273415693.0,92737155.0,135864,45780,2012.4,2025.7,181644,366152848.0,2267,2023-11-01 10:55:00
11,BANE,1417,608,186586022.0,112339643.0,92683,55428,2013.2,2026.8,148111,298925665.0,2025,1408,605,186502417.0,112861401.0,92643,55683,2013.1,2026.9,148326,299363818.0,2013,2023-11-01 11:00:00
12,BANE,803,454,126238150.0,106743415.0,62778,52776,2010.9,2022.6,115554,232981565.0,1257,796,453,126325524.0,106210127.0,62820,52496,2010.9,2023.2,115316,232535651.0,1249,2023-11-01 11:05:00
13,BANE,649,438,96894687.0,104935807.0,48182,51915,2011.0,2021.3,100097,201830495.0,1087,633,436,96668115.0,104436167.0,48060,51677,2011.4,2020.9,99737,201104282.0,1069,2023-11-01 11:10:00
14,BANE,986,1233,154430121.0,266120283.0,76981,130971,2006.1,2031.9,207952,420550404.0,2219,939,1211,153778616.0,266821561.0,76673,131285,2005.6,2032.4,207958,420600177.0,2150,2023-11-01 11:15:00
15,BANE,3763,3101,1064370257.0,1111239262.0,528535,545370,2013.8,2037.6,1073905,2175609519.0,6864,3743,3077,1058976488.0,1107356149.0,526514,543453,2011.3,2037.6,1069967,2166332637.0,6820,2023-11-01 11:20:00
16,BANE,1674,1652,434851371.0,579024247.0,218023,285352,1994.5,2029.2,503375,1013875618.0,3326,1654,1632,436054028.0,579780520.0,218625,285722,1994.5,2029.2,504347,1015834548.0,3286,2023-11-01 11:25:00
17,BANE,1907,1656,544068041.0,509654431.0,271509,250370,2003.9,2035.6,521879,1053722472.0,3563,1877,1626,540212809.0,505120211.0,269388,248136,2005.3,2035.7,517524,1045333021.0,3503,2023-11-01 11:30:00
18,BANE,1362,648,363091263.0,171860274.0,179853,84742,2018.8,2028.0,264595,534951537.0,2010,1346,641,363646536.0,172637992.0,180110,85115,2019.0,2028.3,265225,536284528.0,1987,2023-11-01 11:35:00
19,BANE,631,312,117138446.0,88330317.0,58195,43576,2012.9,2027.0,101771,205468764.0,943,625,309,117042853.0,88076159.0,58149,43450,2012.8,2027.1,101599,205119012.0,934,2023-11-01 11:40:00
20,BANE,657,425,126813122.0,116299904.0,63034,57334,2011.8,2028.5,120368,243113026.0,1082,651,416,126384699.0,116451732.0,62820,57398,2011.9,2028.8,120218,242836431.0,1067,2023-11-01 11:45:00
21,BANE,546,558,110114530.0,156406745.0,54686,76872,2013.6,2034.6,131558,266521275.0,1104,525,537,108601342.0,155980286.0,53943,76671,2013.3,2034.4,130614,264581629.0,1062,2023-11-01 11:50:00
22,BANE,1314,1546,399330804.0,413163100.0,198264,203635,2014.1,2028.9,401899,812493905.0,2860,1296,1528,397484542.0,411108524.0,197397,202617,2013.6,2029.0,400014,808593066.0,2824,2023-11-01 11:55:00
23,BANE,908,418,163670473.0,128360555.0,81181,63245,2016.1,2029.6,144426,292031028.0,1326,904,416,163658529.0,128726651.0,81174,63421,2016.1,2029.7,144595,292385180.0,1320,2023-11-01 12:00:00
24,BANE,3359,435,1218572341.0,136833492.0,603922,67205,2017.8,2036.1,671127,1355405833.0,3794,3323,431,1217190976.0,136985391.0,603450,67303,2017.1,2035.4,670753,1354176368.0,3754,2023-11-01 12:05:00
25,BANE,4207,11143,557890098.0,5093178691.0,275986,2500315,2021.4,2037.0,2776301,5651068789.0,15350,4164,11105,558074970.0,5091659282.0,276085,2499542,2021.4,2037.0,2775627,5649734252.0,15269,2023-11-01 12:10:00
26,BANE,1216,149,88428469.0,24377229.0,43682,11953,2024.4,2039.4,55635,112805699.0,1365,1207,137,88106882.0,24245531.0,43529,11891,2024.1,2039.0,55420,112352413.0,1344,2023-11-01 12:15:00
27,BANE,1240,691,174103768.0,133149780.0,87055,65171,1999.9,2043.1,152226,307253548.0,1931,1228,674,171551422.0,130638340.0,85764,63976,2000.3,2042.0,149740,302189762.0,1902,2023-11-01 12:20:00
28,BANE,1245,488,134681295.0,83043745.0,67383,40701,1998.7,2040.3,108084,217725041.0,1733,1238,482,135828096.0,83732926.0,67965,41030,1998.5,2040.8,108995,219561022.0,1720,2023-11-01 12:25:00
29,BANE,1132,307,88580104.0,79226698.0,44039,38231,2011.4,2072.3,82270,167806803.0,1439,1114,291,87349992.0,78028454.0,43482,37524,2008.9,2079.4,81006,165378446.0,1405,2023-11-01 12:30:00
30,BANE,916,111,42594768.0,13614761.0,20981,6683,2030.2,2037.2,27664,56209529.0,1027,913,109,42639600.0,13487390.0,21004,6620,2030.1,2037.4,27624,56126990.0,1022,2023-11-01 12:35:00
31,BANE,1331,318,95776032.0,65452227.0,47287,32093,2025.4,2039.5,79380,161228259.0,1649,1324,308,95077170.0,65167627.0,46971,31962,2024.2,2038.9,78933,160244798.0,1632,2023-11-01 12:40:00
32,BANE,861,274,90033430.0,76555165.0,44373,37492,2029.0,2041.9,81865,166588595.0,1135,862,266,90728105.0,76437398.0,44082,37430,2058.2,2042.1,81512,167165503.0,1128,2023-11-01 12:45:00
33,BANE,259,128,31492971.0,38052498.0,15486,18575,2033.6,2048.6,34061,69545469.0,387,239,121,30963383.0,36009353.0,15241,17621,2031.6,2043.5,32862,66972736.0,360,2023-11-01 12:50:00
34,BANE,138,78,17320982.0,25367505.0,8516,12377,2033.9,2049.6,20893,42688488.0,216,122,70,16792921.0,24527081.0,8259,11989,2033.3,2045.8,20248,41320003.0,192,2023-11-01 12:55:00
35,BANE,242,144,40562254.0,29985537.0,19916,14620,2036.7,2051.0,34536,70547792.0,386,221,131,40112381.0,29383284.0,19722,14314,2033.9,2052.8,34036,69495666.0,352,2023-11-01 13:00:00
36,BANE,354,271,72206809.0,71124252.0,35512,34771,2033.3,2045.5,70283,143331061.0,625,340,247,71520208.0,70116970.0,35175,34245,2033.3,2047.5,69420,141637179.0,587,2023-11-01 13:05:00
37,BANE,268,152,37925385.0,36892646.0,18760,17856,2021.6,2066.1,36616,74818031.0,420,262,146,37276499.0,36711679.0,18431,17766,2022.5,2066.4,36197,73988178.0,408,2023-11-01 13:10:00
38,BANE,398,404,66977501.0,18542035.0,33187,9109,2018.2,2035.6,42296,85519536.0,802,390,394,66740398.0,18175776.0,33041,8900,2019.9,2042.2,41941,84916174.0,784,2023-11-01 13:15:00
39,BANE,111,73,11432526.0,10710074.0,5629,5251,2031.0,2039.6,10880,22142600.0,184,105,72,11466673.0,10585856.0,5646,5174,2030.9,2046.0,10820,22052529.0,177,2023-11-01 13:20:00
40,BANE,75,85,5962388.0,5579178.0,2936,2734,2030.8,2040.7,5670,11541566.0,160,69,81,5826250.0,5165956.0,2869,2531,2030.8,2041.1,5400,10992207.0,150,2023-11-01 13:25:00
41,BANE,45,50,3278370.0,3431015.0,1615,1688,2030.0,2032.6,3303,6709386.0,95,43,44,3195126.0,3340869.0,1574,1637,2029.9,2040.8,3211,6535995.0,87,2023-11-01 13:30:00
42,BANE,84,51,2602424.0,1953247.0,1284,958,2026.8,2038.9,2242,4555672.0,135,82,49,2677573.0,1898258.0,1322,931,2025.4,2038.9,2253,4575831.0,131,2023-11-01 13:35:00
43,BANE,118,79,15378661.0,8733844.0,7593,4315,2025.4,2024.1,11908,24112506.0,197,110,69,15427994.0,8186203.0,7616,4018,2025.7,2037.4,11634,23614197.0,179,2023-11-01 13:40:00
44,BANE,149,88,19445595.0,15541109.0,9600,7606,2025.6,2043.3,17206,34986704.0,237,145,84,19470664.0,15401662.0,9612,7535,2025.7,2044.0,17147,34872327.0,229,2023-11-01 13:45:00
45,BANE,110,47,13054414.0,9133121.0,6411,4460,2036.3,2047.8,10871,22187535.0,157,110,46,12257014.0,9245295.0,6064,4514,2021.3,2048.1,10578,21502309.0,156,2023-11-01 13:50:00
46,BANE,145,53,19781770.0,8755849.0,9775,4299,2023.7,2036.7,14074,28537619.0,198,143,52,19645606.0,8733781.0,9708,4288,2023.7,2036.8,13996,28379388.0,195,2023-11-01 13:55:00
47,BANE,121,72,15809491.0,12266113.0,7804,6025,2025.8,2035.9,13829,28075604.0,193,119,70,16379788.0,12644404.0,8086,6211,2025.7,2035.8,14297,29024192.0,189,2023-11-01 14:00:00
48,BANE,78,118,3245607.0,12353901.0,1600,6053,2028.5,2041.0,7653,15599509.0,196,78,121,3079002.0,12403741.0,1518,6077,2028.3,2041.1,7595,15482743.0,199,2023-11-01 14:05:00
49,BANE,40,82,4836305.0,7016823.0,2431,3447,1989.4,2035.6,5878,11853129.0,122,36,82,2715422.0,6958381.0,1339,3418,2027.9,2035.8,4757,9673803.0,118,2023-11-01 14:10:00
50,BANE,134,196,5173159.0,18051463.0,2543,8856,2034.3,2038.3,11399,23224623.0,330,130,194,5209791.0,18174808.0,2571,8915,2026.4,2038.7,11486,23384600.0,324,2023-11-01 14:15:00
51,BANE,232,192,17102493.0,14697477.0,8442,7204,2025.9,2040.2,15646,31799971.0,424,228,190,17111772.0,14737836.0,8451,7223,2024.8,2040.4,15674,31849608.0,418,2023-11-01 14:20:00
52,BANE,115,186,7873408.0,10737810.0,3891,5276,2023.5,2035.2,9167,18611218.0,301,106,183,7590780.0,10337796.0,3751,5079,2023.7,2035.4,8830,17928577.0,289,2023-11-01 14:25:00
53,BANE,171,133,28366809.0,21818760.0,14006,10725,2025.3,2034.4,24731,50185569.0,304,170,132,28111886.0,21316718.0,13881,10478,2025.2,2034.4,24359,49428604.0,302,2023-11-01 14:30:00
54,BANE,206,78,26525192.0,10833551.0,13101,5325,2024.7,2034.5,18426,37358743.0,284,201,72,26358305.0,10073631.0,13022,4951,2024.1,2034.7,17973,36431936.0,273,2023-11-01 14:35:00
55,BANE,634,371,81599212.0,39953290.0,40332,19636,2023.2,2034.7,59968,121552502.0,1005,622,365,81058323.0,39807324.0,40069,19563,2023.0,2034.8,59632,120865647.0,987,2023-11-01 14:40:00
56,BANE,1269,651,148633732.0,141755169.0,72941,69327,2037.7,2044.7,142268,290388901.0,1920,1259,638,147433021.0,141105712.0,72747,69001,2026.7,2045.0,141748,288538733.0,1897,2023-11-01 14:45:00
57,BANE,712,367,94727557.0,64274291.0,46924,31570,2018.7,2035.9,78494,159001848.0,1079,701,361,94312486.0,63905907.0,46718,31359,2018.8,2037.9,78077,158218393.0,1062,2023-11-01 14:50:00
58,BANE,1342,990,254992194.0,162935909.0,126469,80260,2016.2,2030.1,206729,417928104.0,2332,1327,985,254035078.0,163408664.0,125995,80494,2016.2,2030.1,206489,417443743.0,2312,2023-11-01 14:55:00
59,BANE,2023,638,208969720.0,105957309.0,103333,51780,2022.3,2046.3,155113,314927029.0,2661,2013,620,208441875.0,105360602.0,103118,51472,2021.4,2046.9,154590,313802477.0,2633,2023-11-01 15:00:00
60,BANE,1779,269,179930025.0,53309026.0,88923,26238,2023.4,2031.7,115161,233239052.0,2048,1773,266,179539716.0,53274639.0,88732,26221,2023.4,2031.8,114953,232814355.0,2039,2023-11-01 15:05:00
61,BANE,1664,233,201796263.0,59338695.0,99667,29153,2024.7,2035.4,128820,261134958.0,1897,1654,228,201904379.0,59425564.0,99727,29197,2024.6,2035.3,128924,261329943.0,1882,2023-11-01 15:10:00
62,BANE,1521,518,225359645.0,132374114.0,111447,64846,2022.1,2041.4,176293,357733759.0,2039,1512,506,224072811.0,132138940.0,110808,64730,2022.2,2041.4,175538,356211752.0,2018,2023-11-01 15:15:00
63,BANE,2849,759,402065018.0,252925234.0,198752,124006,2022.9,2039.6,322758,654990253.0,3608,2846,755,403206340.0,252986708.0,198920,124034,2027.0,2039.7,322954,656193048.0,3601,2023-11-01 15:20:00
64,BANE,2585,948,462042343.0,152309725.0,228852,74823,2019.0,2035.6,303675,614352068.0,3533,2580,945,462060128.0,152288311.0,228861,74808,2019.0,2035.7,303669,614348440.0,3525,2023-11-01 15:25:00
65,BANE,1968,828,307132426.0,140098126.0,151798,68718,2023.3,2038.7,220516,447230552.0,2796,1964,825,306869178.0,139978234.0,151670,68660,2023.3,2038.7,220330,446847412.0,2789,2023-11-01 15:30:00
66,BANE,2134,704,242729217.0,123859334.0,119931,60823,2023.9,2036.4,180754,366588551.0,2838,2139,704,243571237.0,123797188.0,120348,60790,2023.9,2036.5,181138,367368425.0,2843,2023-11-01 15:35:00
67,BANE,2496,1097,382258686.0,232023274.0,188994,113998,2022.6,2035.3,302992,614281960.0,3593,2491,1090,382823403.0,232030277.0,189277,114000,2022.6,2035.4,303277,614853680.0,3581,2023-11-01 15:40:00
68,BANE,2100,781,511380381.0,150549115.0,253345,73964,2018.5,2035.4,327309,661929496.0,2881,2095,776,511337259.0,150502507.0,253322,73942,2018.5,2035.4,327264,661839766.0,2871,2023-11-01 15:45:00
69,BANE,756,699,124071515.0,51186528.0,61169,25116,2028.3,2038.0,86285,175258043.0,1455,722,694,123218141.0,51079769.0,60780,25062,2027.3,2038.1,85842,174297911.0,1416,2023-11-01 15:50:00
70,BANE,483,233,87615166.0,46087243.0,43187,22607,2028.7,2038.6,65794,133702409.0,716,454,213,86033686.0,45109430.0,42474,22086,2025.6,2042.4,64560,131143117.0,667,2023-11-01 15:55:00
71,BANE,86,99,9359542.0,12463726.0,4604,6086,2032.9,2047.9,10690,21823268.0,185,82,96,8960261.0,12594656.0,4410,6149,2031.8,2048.2,10559,21554917.0,178,2023-11-01 16:00:00
72,BANE,139,410,19288563.0,46142037.0,9494,22607,2031.7,2041.1,32101,65430600.0,549,140,408,19484901.0,45691022.0,9591,22374,2031.6,2042.1,31965,65175923.0,548,2023-11-01 16:05:00
73,BANE,205,305,34777334.0,63252384.0,17111,30984,2032.5,2041.5,48095,98029719.0,510,203,306,34565739.0,63294454.0,17007,31005,2032.4,2041.4,48012,97860193.0,509,2023-11-01 16:10:00
74,BANE,790,873,145459184.0,183537628.0,71608,89824,2031.3,2043.3,161432,328996812.0,1663,777,867,145358551.0,183781625.0,71560,89941,2031.3,2043.4,161501,329140176.0,1644,2023-11-01 16:15:00
75,BANE,366,381,58311762.0,76487231.0,28704,37285,2031.5,2051.4,65989,134798993.0,747,365,380,58334748.0,76225613.0,28716,37159,2031.4,2051.3,65875,134560361.0,745,2023-11-01 16:20:00
76,BANE,343,1436,49127042.0,757746511.0,24185,366546,2031.3,2067.3,390731,806873553.0,1779,343,1434,49127397.0,758009022.0,24186,366671,2031.2,2067.3,390857,807136420.0,1777,2023-11-01 16:25:00
77,BANE,336,1052,43216568.0,470996752.0,21281,227983,2030.8,2065.9,249264,514213320.0,1388,333,1049,43267705.0,470852149.0,21308,227912,2030.6,2065.9,249220,514119854.0,1382,2023-11-01 16:30:00
78,BANE,308,931,54831833.0,356195608.0,26996,172721,2031.1,2062.3,199717,411027441.0,1239,311,929,55105174.0,356225811.0,27140,172724,2030.4,2062.4,199864,411330985.0,1240,2023-11-01 16:35:00
79,BANE,981,1114,215262698.0,270617516.0,105955,132591,2031.6,2041.0,238546,485880214.0,2095,979,1112,215250961.0,270187861.0,105949,132380,2031.6,2041.0,238329,485438823.0,2091,2023-11-01 16:40:00
80,BANE,891,681,155288762.0,201276809.0,76413,98594,2032.2,2041.5,175007,356565571.0,1572,873,680,155177618.0,201668000.0,76358,98786,2032.2,2041.5,175144,356845619.0,1553,2023-11-01 16:45:00
81,BANE,1472,1261,384202573.0,444376733.0,189116,217455,2031.6,2043.5,406571,828579306.0,2733,1461,1249,382975812.0,443537273.0,188515,217041,2031.5,2043.6,405556,826513086.0,2710,2023-11-01 16:50:00
82,BANE,398,442,76974860.0,129437318.0,37871,63328,2032.6,2043.9,101199,206412179.0,840,393,429,78645101.0,130983173.0,38695,64076,2032.4,2044.2,102771,209628274.0,822,2023-11-01 16:55:00
83,BANE,95,64,11087681.0,12062615.0,5450,5895,2034.4,2046.2,11345,23150296.0,159,93,62,10822131.0,11806364.0,5320,5770,2034.2,2046.2,11090,22628495.0,155,2023-11-01 17:00:00
84,BANE,515,573,44633125.0,103449514.0,21938,50488,2034.5,2049.0,72426,148082639.0,1088,504,564,44450198.0,103345028.0,21849,50437,2034.4,2049.0,72286,147795227.0,1068,2023-11-01 17:05:00
85,BANE,602,445,34319850.0,81900878.0,16732,39916,2051.2,2051.8,56648,116220728.0,1047,556,417,31734916.0,81447046.0,15572,39690,2037.9,2052.1,55262,113181962.0,973,2023-11-01 17:10:00
86,BANE,310,178,24276301.0,21340008.0,11901,10410,2039.9,2050.0,22311,45616309.0,488,306,171,24353955.0,21267893.0,11940,10367,2039.7,2051.5,22307,45621848.0,477,2023-11-01 17:15:00
87,BANE,652,242,37871044.0,18502161.0,18588,9069,2037.4,2040.2,27657,56373206.0,894,642,235,39751581.0,17931312.0,18670,8738,2129.2,2052.1,27408,57682894.0,877,2023-11-01 17:20:00
88,BANE,205,234,12634041.0,10172326.0,6202,4971,2037.1,2046.3,11173,22806367.0,439,197,221,12589620.0,10095379.0,6180,4931,2037.2,2047.3,11111,22684999.0,418,2023-11-01 17:25:00
89,BANE,237,485,19434821.0,29246170.0,9544,14304,2036.3,2044.6,23848,48680992.0,722,234,481,19376193.0,29150155.0,9516,14257,2036.2,2044.6,23773,48526348.0,715,2023-11-01 17:30:00
90,BANE,220,378,13975284.0,24039031.0,6863,11757,2036.3,2044.7,18620,38014315.0,598,218,378,13978925.0,24044544.0,6865,11759,2036.3,2044.8,18624,38023469.0,596,2023-11-01 17:35:00
91,BANE,75,152,3621471.0,8772255.0,1782,4280,2032.3,2049.6,6062,12393726.0,227,72,150,2893412.0,8748941.0,1421,4269,2036.2,2049.4,5690,11642354.0,222,2023-11-01 17:40:00
92,BANE,187,318,8342543.0,11121625.0,4092,5428,2038.7,2048.9,9520,19464168.0,505,137,312,8448469.0,11160080.0,4145,5447,2038.2,2048.8,9592,19608549.0,449,2023-11-01 17:45:00
93,BANE,258,68,15186598.0,6675371.0,7448,3255,2039.0,2050.8,10703,21861969.0,326,156,68,15164323.0,6633982.0,7438,3235,2038.8,2050.7,10673,21798306.0,224,2023-11-01 17:50:00
94,BANE,147,64,1533912.0,10149805.0,750,4942,2045.2,2053.8,5692,11683717.0,211,27,56,943760.0,10061300.0,463,4896,2038.4,2055.0,5359,11005060.0,83,2023-11-01 17:55:00
95,BANE,63,92,2910912.0,8226476.0,1377,3986,2114.0,2063.8,5363,11137388.0,155,57,77,2059675.0,8032921.0,1009,3892,2041.3,2064.0,4901,10092596.0,134,2023-11-01 18:00:00
96,BANE,315,179,8222099.0,26547594.0,4022,12905,2044.3,2057.2,16927,34769693.0,494,313,164,8898949.0,25594731.0,4359,12446,2041.5,2056.5,16805,34493680.0,477,2023-11-01 18:05:00
97,BANE,264,341,6615226.0,52830677.0,3240,25714,2041.7,2054.5,28954,59445904.0,605,261,331,6523349.0,52664694.0,3195,25632,2041.7,2054.6,28827,59188043.0,592,2023-11-01 18:10:00
98,BANE,157,250,18713581.0,34690610.0,9173,16919,2040.1,2050.4,26092,53404191.0,407,156,250,18575619.0,34274535.0,9105,16715,2040.2,2050.5,25820,52850155.0,406,2023-11-01 18:15:00
99,BANE,308,487,36834847.0,60729821.0,18070,29644,2038.5,2048.6,47714,97564669.0,795,304,484,36842910.0,60655075.0,18074,29594,2038.4,2049.6,47668,97497985.0,788,2023-11-01 18:20:00
100,BANE,531,591,48951897.0,60071451.0,24023,29291,2037.7,2050.9,53314,109023348.0,1122,530,584,48378119.0,60195235.0,23743,29355,2037.6,2050.6,53098,108573355.0,1114,2023-11-01 18:25:00
101,BANE,353,257,20604037.0,23842807.0,10084,11628,2043.2,2050.5,21712,44446844.0,610,347,243,20156805.0,22946250.0,9877,11188,2040.8,2051.0,21065,43103056.0,590,2023-11-01 18:30:00
102,BANE,274,155,10374144.0,10996759.0,5082,5366,2041.4,2049.3,10448,21370903.0,429,270,150,10405224.0,10888859.0,5097,5313,2041.4,2049.5,10410,21294083.0,420,2023-11-01 18:35:00
103,BANE,213,370,27911430.0,15993982.0,13700,7822,2037.3,2044.7,21522,43905412.0,583,213,370,27997246.0,16413239.0,13745,8012,2036.9,2048.6,21757,44410486.0,583,2023-11-01 18:40:00
104,BANE,2007,1155,215375979.0,200249004.0,103579,95365,2079.3,2099.8,198944,415624983.0,3162,1456,892,198021920.0,177575643.0,96510,84743,2051.8,2095.5,181253,375597563.0,2348,2023-11-02 10:05:00
105,BANE,1391,579,95739861.0,62784503.0,46385,30247,2064.0,2075.7,76632,158524364.0,1970,1340,493,92958359.0,63147578.0,44874,30458,2071.5,2073.3,75332,156105937.0,1833,2023-11-02 10:10:00
106,BANE,467,250,48053816.0,39177122.0,23342,18861,2058.7,2077.1,42203,87230938.0,717,434,208,47435825.0,37282868.0,23135,17905,2050.4,2082.3,41040,84718693.0,642,2023-11-02 10:15:00
107,BANE,503,295,68638906.0,22916984.0,33430,11057,2053.2,2072.6,44487,91555890.0,798,471,258,67046944.0,21041805.0,32679,10156,2051.7,2071.9,42835,88088749.0,729,2023-11-02 10:20:00
108,BANE,923,386,130880794.0,32404136.0,63755,15667,2052.9,2068.3,79422,163284930.0,1309,918,365,130948446.0,31791988.0,63786,15365,2052.9,2069.1,79151,162740434.0,1283,2023-11-02 10:25:00
109,BANE,707,717,105305049.0,107211563.0,50553,51878,2083.1,2066.6,102431,212516612.0,1424,656,688,102426372.0,104883929.0,49752,50620,2058.7,2072.0,100372,207310301.0,1344,2023-11-02 10:30:00
110,BANE,182,390,16075628.0,30914959.0,7867,14923,2043.4,2071.6,22790,46990587.0,572,166,373,15816797.0,30703514.0,7743,14824,2042.7,2071.2,22567,46520311.0,539,2023-11-02 10:35:00
111,BANE,406,237,33120897.0,17689885.0,16158,8547,2049.8,2069.7,24705,50810782.0,643,393,215,32959548.0,16563913.0,15924,8011,2069.8,2067.6,23935,49523461.0,608,2023-11-02 10:40:00
112,BANE,219,130,28888464.0,16274063.0,14020,7869,2060.5,2068.1,21889,45162527.0,349,202,122,26240047.0,15606623.0,12785,7549,2052.4,2067.4,20334,41846670.0,324,2023-11-02 10:45:00
113,BANE,172,161,19311934.0,14763364.0,9415,7125,2051.2,2072.1,16540,34075298.0,333,156,152,19310645.0,14244469.0,9415,6875,2051.1,2071.9,16290,33555114.0,308,2023-11-02 10:50:00
114,BANE,250,52,11131904.0,8617853.0,5415,4166,2055.8,2068.6,9581,19749757.0,302,249,46,12002380.0,7444058.0,5439,3604,2206.7,2065.5,9043,19446438.0,295,2023-11-02 10:55:00
115,BANE,196,99,21193194.0,9583624.0,10328,4624,2052.0,2072.6,14952,30776818.0,295,180,93,19271189.0,9911767.0,9379,4782,2054.7,2072.7,14161,29182956.0,273,2023-11-02 11:00:00
116,BANE,209,250,21273143.0,42739087.0,10365,20602,2052.4,2074.5,30967,64012230.0,459,200,239,20966056.0,42353138.0,10212,20414,2053.1,2074.7,30626,63319194.0,439,2023-11-02 11:05:00
117,BANE,132,143,25158414.0,27020130.0,12206,13042,2061.2,2071.8,25248,52178545.0,275,126,138,24161890.0,26470010.0,11789,12769,2049.5,2073.0,24558,50631900.0,264,2023-11-02 11:10:00
118,BANE,1965,3937,648869460.0,1260578092.0,316810,612034,2048.1,2059.7,928844,1909447552.0,5902,1953,3918,650093363.0,1259430695.0,317407,611466,2048.1,2059.7,928873,1909524058.0,5871,2023-11-02 11:15:00
119,BANE,926,1285,197291400.0,299283202.0,96285,145309,2049.0,2059.6,241594,496574602.0,2211,907,1278,196233613.0,298687425.0,95808,145005,2048.2,2059.8,240813,494921038.0,2185,2023-11-02 11:20:00
120,BANE,299,362,59672007.0,67190921.0,29056,32664,2053.7,2057.0,61720,126862928.0,661,289,328,59390990.0,67484161.0,29044,32801,2044.9,2057.4,61845,126875152.0,617,2023-11-02 11:25:00
121,BANE,343,765,35400504.0,138930074.0,17265,67309,2050.4,2064.1,84574,174330578.0,1108,321,758,34583238.0,138486519.0,16878,67103,2049.0,2063.8,83981,173069757.0,1079,2023-11-02 11:30:00
122,BANE,1267,1206,113353685.0,419090512.0,55210,201958,2053.1,2075.1,257168,532444197.0,2473,1262,1192,111625950.0,418799815.0,54436,201814,2050.6,2075.2,256250,530425765.0,2454,2023-11-02 11:35:00
123,BANE,2487,503,247750908.0,83936799.0,120227,40611,2060.7,2066.8,160838,331687707.0,2990,2470,509,247339823.0,84257803.0,120140,40767,2058.8,2066.8,160907,331597626.0,2979,2023-11-02 11:40:00
124,BANE,764,143,91062406.0,29237369.0,44348,14050,2053.4,2081.0,58398,120299775.0,907,757,135,90659809.0,29233293.0,44154,14047,2053.3,2081.1,58201,119893102.0,892,2023-11-02 11:45:00
125,BANE,352,149,41696250.0,6993513.0,20292,3371,2054.8,2074.6,23663,48689763.0,501,341,138,42253093.0,6863093.0,20569,3308,2054.2,2074.7,23877,49116186.0,479,2023-11-02 11:50:00
126,BANE,701,363,69773314.0,32228347.0,34007,15699,2051.7,2052.9,49706,102001661.0,1064,685,344,68562620.0,30673083.0,33411,14840,2052.1,2066.9,48251,99235704.0,1029,2023-11-02 11:55:00
127,BANE,839,1449,46406980.0,123240506.0,22568,59740,2056.3,2062.9,82308,169647487.0,2288,822,1441,45967457.0,123007146.0,22368,59625,2055.1,2063.0,81993,168974603.0,2263,2023-11-02 12:00:00
128,BANE,443,863,39629990.0,106216112.0,19291,51421,2054.3,2065.6,70712,145846102.0,1306,448,860,40152456.0,106253737.0,19547,51440,2054.1,2065.6,70987,146406193.0,1308,2023-11-02 12:05:00
129,BANE,656,283,26490693.0,30981045.0,12916,15011,2051.0,2063.9,27927,57471738.0,939,648,279,26085952.0,30815768.0,12718,14928,2051.1,2064.3,27646,56901720.0,927,2023-11-02 12:10:00
130,BANE,190,338,21943673.0,45684528.0,10717,22088,2047.6,2068.3,32805,67628201.0,528,187,332,21793821.0,45672699.0,10646,22083,2047.1,2068.2,32729,67466521.0,519,2023-11-02 12:15:00
131,BANE,870,347,39113446.0,38714010.0,19056,18717,2052.6,2068.4,37773,77827457.0,1217,866,344,38872898.0,38749584.0,18939,18722,2052.5,2069.7,37661,77622483.0,1210,2023-11-02 12:20:00
132,BANE,275,265,26086733.0,21307097.0,12688,10319,2056.0,2064.8,23007,47393830.0,540,276,264,26295747.0,21457895.0,12790,10392,2056.0,2064.8,23182,47753643.0,540,2023-11-02 12:25:00
133,BANE,472,97,37726632.0,7633545.0,18344,3689,2056.6,2069.3,22033,45360177.0,569,470,95,37537802.0,5531973.0,18252,2680,2056.6,2064.2,20932,43069775.0,565,2023-11-02 12:30:00
134,BANE,355,270,34222096.0,12555018.0,16642,6078,2056.4,2065.6,22720,46777115.0,625,350,266,33946090.0,12609047.0,16508,6103,2056.3,2066.0,22611,46555138.0,616,2023-11-02 12:35:00
135,BANE,206,276,17300373.0,14182447.0,8410,6872,2057.1,2063.8,15282,31482820.0,482,201,270,17390010.0,14089147.0,8459,6824,2055.8,2064.6,15283,31479158.0,471,2023-11-02 12:40:00
136,BANE,467,424,29857339.0,32287718.0,14521,15647,2056.1,2063.5,30168,62145057.0,891,464,419,29918695.0,32168798.0,14551,15589,2056.1,2063.6,30140,62087494.0,883,2023-11-02 12:45:00
137,BANE,485,320,35596900.0,20454794.0,17399,9912,2045.9,2063.6,27311,56051694.0,805,475,295,35479766.0,20046120.0,17344,9713,2045.7,2063.8,27057,55525886.0,770,2023-11-02 12:50:00
138,BANE,130,274,7794896.0,19087383.0,3808,9237,2047.0,2066.4,13045,26882279.0,404,121,264,7639072.0,17403275.0,3732,8418,2046.9,2067.4,12150,25042347.0,385,2023-11-02 12:55:00
139,BANE,375,375,12422776.0,19253655.0,6064,9373,2048.6,2054.2,15437,31676431.0,750,370,362,12236525.0,19097214.0,5972,9269,2049.0,2060.3,15241,31333740.0,732,2023-11-02 13:00:00
140,BANE,370,781,19093710.0,52292078.0,9312,25401,2050.4,2058.7,34713,71385788.0,1151,368,759,19194447.0,52119639.0,9362,25319,2050.3,2058.5,34681,71314087.0,1127,2023-11-02 13:05:00
141,BANE,208,234,14982662.0,23086823.0,7321,11217,2046.5,2058.2,18538,38069485.0,442,203,222,14554095.0,22264795.0,7111,10818,2046.7,2058.1,17929,36818891.0,425,2023-11-02 13:10:00
142,BANE,94,101,10523517.0,9316636.0,5153,4535,2042.2,2054.4,9688,19840153.0,195,92,63,10167424.0,8622096.0,4979,4190,2042.1,2057.8,9169,18789521.0,155,2023-11-02 13:15:00
143,BANE,32,31,1639250.0,4332630.0,798,2105,2054.2,2058.3,2903,5971880.0,63,28,26,1581737.0,4628548.0,773,2248,2046.2,2059.0,3021,6210285.0,54,2023-11-02 13:20:00
144,BANE,62,30,3928785.0,1612746.0,1920,783,2046.2,2059.7,2703,5541531.0,92,60,18,3947178.0,1513063.0,1929,735,2046.2,2058.6,2664,5460241.0,78,2023-11-02 13:25:00
145,BANE,105,83,14268621.0,10473172.0,6760,5086,2110.7,2059.2,11846,24741793.0,188,105,61,14082686.0,10042952.0,6669,4872,2111.7,2061.4,11541,24125638.0,166,2023-11-02 13:30:00
146,BANE,158,184,25022675.0,24906755.0,12301,12271,2034.2,2029.7,24572,49929430.0,342,133,138,23294495.0,21916768.0,11453,10659,2033.9,2056.2,22112,45211263.0,271,2023-11-02 13:35:00
147,BANE,55,101,7402900.0,11374724.0,2974,5543,2489.2,2052.1,8517,18777624.0,156,46,96,6263591.0,11668980.0,2841,5665,2204.7,2059.8,8506,17932571.0,142,2023-11-02 13:40:00
148,BANE,612,845,198921810.0,131064087.0,96426,63925,2062.9,2050.3,160351,329985897.0,1457,576,792,194473991.0,132120704.0,94245,64415,2063.5,2051.1,158660,326594695.0,1368,2023-11-02 13:45:00
149,BANE,81,34,7710997.0,2779220.0,3544,1365,2175.8,2036.1,4909,10490217.0,115,69,28,6897602.0,2650224.0,3381,1289,2040.1,2056.0,4670,9547826.0,97,2023-11-02 13:50:00
150,BANE,252,211,23867485.0,30837743.0,11327,14940,2107.1,2064.1,26267,54705228.0,463,248,205,24940446.0,30652362.0,11317,14863,2203.8,2062.3,26180,55592808.0,453,2023-11-02 13:55:00
151,BANE,382,79,24309308.0,7300667.0,11871,3552,2047.8,2055.4,15423,31609976.0,461,380,77,24532625.0,7650734.0,11980,3722,2047.8,2055.5,15702,32183359.0,457,2023-11-02 14:00:00
152,BANE,574,312,57534040.0,86477846.0,28137,41734,2044.8,2072.1,69871,144011886.0,886,565,305,57682207.0,86591409.0,28210,41775,2044.7,2072.8,69985,144273617.0,870,2023-11-02 14:05:00
153,BANE,505,248,46404656.0,55345566.0,22607,26855,2052.7,2060.9,49462,101750223.0,753,498,239,45145763.0,54309306.0,22072,26345,2045.4,2061.5,48417,99455069.0,737,2023-11-02 14:10:00
154,BANE,632,346,72238996.0,89827915.0,35327,43594,2044.9,2060.6,78921,162066911.0,978,613,344,71464764.0,89729423.0,34963,43546,2044.0,2060.6,78509,161194187.0,957,2023-11-02 14:15:00
155,BANE,90,56,13662326.0,11576555.0,6283,5624,2174.5,2058.4,11907,25238882.0,146,94,49,14976213.0,12346945.0,7003,5998,2138.5,2058.5,13001,27323159.0,143,2023-11-02 14:20:00
156,BANE,764,191,49082263.0,57555513.0,23994,27855,2045.6,2066.3,51849,106637777.0,955,757,184,47737324.0,57007150.0,23334,27588,2045.8,2066.4,50922,104744474.0,941,2023-11-02 14:25:00
157,BANE,327,356,39101497.0,76627373.0,19117,37094,2045.4,2065.8,56211,115728871.0,683,318,353,38755343.0,76695380.0,18956,37121,2044.5,2066.1,56077,115450723.0,671,2023-11-02 14:30:00
158,BANE,625,575,64393306.0,66528671.0,31412,32274,2050.0,2061.4,63686,130921978.0,1200,622,571,64171818.0,66418679.0,31304,32220,2050.0,2061.4,63524,130590497.0,1193,2023-11-02 14:35:00
159,BANE,412,291,58636713.0,24424159.0,28244,11873,2076.1,2057.1,40117,83060872.0,703,407,286,59908504.0,24702538.0,28839,11999,2077.3,2058.7,40838,84611043.0,693,2023-11-02 14:40:00
160,BANE,892,623,232196526.0,70690093.0,111625,34315,2080.1,2060.0,145940,302886620.0,1515,872,613,226680834.0,71322360.0,109408,34611,2071.9,2060.7,144019,298003194.0,1485,2023-11-02 14:45:00
161,BANE,1294,661,307483013.0,148800080.0,149795,72186,2052.7,2061.3,221981,456283093.0,1955,1286,651,306876699.0,148098933.0,149495,71784,2052.8,2063.1,221279,454975632.0,1937,2023-11-02 14:50:00
162,BANE,1625,943,382045620.0,194842150.0,186051,94456,2053.4,2062.8,280507,576887771.0,2568,1615,938,381965076.0,194787308.0,186022,94430,2053.3,2062.8,280452,576752384.0,2553,2023-11-02 14:55:00
163,BANE,1364,669,321321930.0,156858254.0,156470,76017,2053.6,2063.5,232487,478180185.0,2033,1360,666,320277669.0,156871783.0,155962,76024,2053.6,2063.5,231986,477149452.0,2026,2023-11-02 15:00:00
164,BANE,133,360,21937228.0,30033948.0,10296,14545,2130.7,2064.9,24841,51971176.0,493,129,354,23578389.0,27993466.0,11128,13564,2118.8,2063.8,24692,51571856.0,483,2023-11-02 15:05:00
165,BANE,70,291,10003210.0,17571289.0,4877,8513,2051.1,2064.1,13390,27574499.0,361,66,285,10748161.0,17307654.0,5238,8385,2052.0,2064.1,13623,28055815.0,351,2023-11-02 15:10:00
166,BANE,112,335,8667399.0,25802909.0,4232,12508,2048.1,2062.9,16740,34470308.0,447,113,328,9166006.0,26040686.0,4475,12621,2048.3,2063.3,17096,35206692.0,441,2023-11-02 15:15:00
167,BANE,223,358,14540928.0,24563191.0,7089,11913,2051.2,2061.9,19002,39104119.0,581,219,352,14642303.0,24386588.0,7140,11827,2050.7,2061.9,18967,39028891.0,571,2023-11-02 15:20:00
168,BANE,238,263,9546229.0,16022613.0,4642,7772,2056.5,2061.6,12414,25568842.0,501,236,257,9470335.0,15924618.0,4609,7724,2054.7,2061.7,12333,25394954.0,493,2023-11-02 15:25:00
169,BANE,421,488,66317178.0,45289310.0,32276,21960,2054.7,2062.4,54236,111606489.0,909,421,492,66949246.0,45653582.0,32584,22136,2054.7,2062.4,54720,112602828.0,913,2023-11-02 15:30:00
170,BANE,430,536,91458132.0,74313186.0,43995,36015,2078.8,2063.4,80010,165771319.0,966,423,533,91308261.0,74249364.0,43922,35984,2078.9,2063.4,79906,165557626.0,956,2023-11-02 15:35:00
171,BANE,578,336,78142459.0,59218887.0,37730,28500,2071.1,2077.9,66230,137361346.0,914,522,286,77242887.0,56707593.0,36828,27292,2097.4,2077.8,64120,133950480.0,808,2023-11-02 15:40:00
172,BANE,1945,1004,468512381.0,222418667.0,226389,106875,2069.5,2081.1,333264,690931048.0,2949,1892,880,460138741.0,209232341.0,223089,100694,2062.6,2077.9,323783,669371082.0,2772,2023-11-02 15:45:00
173,BANE,1038,682,82807401.0,36540385.0,40048,17567,2067.7,2080.1,57615,119347787.0,1720,1020,657,81225007.0,36085489.0,39338,17111,2064.8,2108.9,56449,117310496.0,1677,2023-11-02 15:50:00
174,BANE,367,142,39182772.0,16437666.0,18877,7909,2075.7,2078.3,26786,55620438.0,509,341,122,37582398.0,16473122.0,18184,7914,2066.8,2081.5,26098,54055520.0,463,2023-11-02 15:55:00
175,BANE,398,126,34723394.0,7734439.0,16807,3751,2066.0,2062.0,20558,42457834.0,524,379,101,34411416.0,7218868.0,16657,3478,2065.9,2075.6,20135,41630284.0,480,2023-11-02 16:00:00
176,BANE,1155,396,124491465.0,40673151.0,60278,19548,2065.3,2080.7,79826,165164616.0,1551,1143,379,124708252.0,48955266.0,60170,23506,2072.6,2082.7,83676,173663519.0,1522,2023-11-02 16:05:00
177,BANE,513,254,81919097.0,37351869.0,39600,17882,2068.7,2088.8,57482,119270966.0,767,505,232,81210807.0,37725116.0,39296,18061,2066.6,2088.8,57357,118935923.0,737,2023-11-02 16:10:00
178,BANE,163,214,26526292.0,9920765.0,12844,4780,2065.3,2075.5,17624,36447057.0,377,159,194,26062713.0,8999867.0,12619,4322,2065.4,2082.3,16941,35062580.0,353,2023-11-02 16:15:00
179,BANE,161,188,31576485.0,14879305.0,15303,7141,2063.4,2083.6,22444,46455790.0,349,150,183,31216173.0,15231074.0,15128,7307,2063.5,2084.4,22435,46447247.0,333,2023-11-02 16:20:00
180,BANE,585,586,99450002.0,78733728.0,47912,37790,2075.7,2083.5,85702,178183730.0,1171,558,562,95960393.0,76938022.0,46441,36924,2066.3,2083.7,83365,172898415.0,1120,2023-11-02 16:25:00
181,BANE,1721,814,504849473.0,163550468.0,244590,78505,2064.1,2083.3,323095,668399941.0,2535,1700,786,504347035.0,163008992.0,244353,78232,2064.0,2083.7,322585,667356027.0,2486,2023-11-02 16:30:00
182,BANE,1768,462,358599646.0,127669987.0,173798,61371,2063.3,2080.3,235169,486269634.0,2230,1740,396,358305418.0,121102212.0,173664,58178,2063.2,2081.6,231842,479407630.0,2136,2023-11-02 16:35:00
183,BANE,2438,469,655406907.0,213765760.0,316295,102849,2072.1,2078.4,419144,869172667.0,2907,2408,409,650801888.0,216971486.0,314233,104398,2071.1,2078.3,418631,867773374.0,2817,2023-11-02 16:40:00
184,BANE,977,321,263761415.0,83787619.0,127151,40163,2074.4,2086.2,167314,347549034.0,1298,943,292,261159819.0,82673236.0,125903,39619,2074.3,2086.7,165522,343833055.0,1235,2023-11-02 16:45:00
185,BANE,769,367,172176931.0,55786500.0,82846,26930,2078.3,2071.5,109776,227963432.0,1136,716,323,168538328.0,50457295.0,81109,24169,2077.9,2087.7,105278,218995623.0,1039,2023-11-02 16:50:00
186,BANE,266,227,54941912.0,24621012.0,26428,11803,2078.9,2086.0,38231,79562924.0,493,258,220,54621421.0,22519543.0,26279,10795,2078.5,2086.1,37074,77140965.0,478,2023-11-02 16:55:00
187,BANE,845,1244,162174876.0,295298752.0,78260,142201,2072.3,2076.6,220461,457473629.0,2089,828,1222,164385171.0,290412730.0,79337,139612,2072.0,2080.1,218949,454797901.0,2050,2023-11-02 17:00:00
188,BANE,487,1522,62805124.0,353213233.0,30361,169874,2068.6,2079.3,200235,416018357.0,2009,469,1511,62637844.0,354944419.0,30291,170692,2067.9,2079.4,200983,417582263.0,1980,2023-11-02 17:05:00
189,BANE,257,524,31653773.0,116408484.0,15325,56002,2065.5,2078.6,71327,148062257.0,781,246,515,31566799.0,116146451.0,15283,55873,2065.5,2078.8,71156,147713251.0,761,2023-11-02 17:10:00
190,BANE,716,697,79789471.0,163569602.0,38655,78700,2064.1,2078.4,117355,243359073.0,1413,715,696,80267575.0,162651430.0,38889,78265,2064.0,2078.2,117154,242919006.0,1411,2023-11-02 17:15:00
191,BANE,269,293,25756254.0,37169071.0,12498,17878,2060.8,2079.0,30376,62925325.0,562,255,289,23741866.0,37633818.0,11514,18089,2062.0,2080.5,29603,61375685.0,544,2023-11-02 17:20:00
192,BANE,127,191,15247273.0,26174065.0,7399,12596,2060.7,2078.0,19995,41421338.0,318,118,188,15254183.0,26197497.0,7405,12604,2060.0,2078.5,20009,41451680.0,306,2023-11-02 17:25:00
193,BANE,114,147,14610545.0,21687198.0,7108,10426,2055.5,2080.1,17534,36297743.0,261,109,141,14654966.0,21615416.0,7130,10384,2055.4,2081.6,17514,36270382.0,250,2023-11-02 17:30:00
194,BANE,520,836,74525904.0,150944703.0,36205,72834,2058.4,2072.4,109039,225470607.0,1356,510,819,74432504.0,147906698.0,36160,71361,2058.4,2072.7,107521,222339202.0,1329,2023-11-02 17:35:00
195,BANE,640,1607,66772430.0,260010225.0,32522,125684,2053.1,2068.8,158206,326782655.0,2247,628,1578,66985405.0,257370191.0,32628,124392,2053.0,2069.0,157020,324355597.0,2206,2023-11-02 17:40:00
196,BANE,1337,2113,270718756.0,420091091.0,132197,204061,2047.8,2058.7,336258,690809847.0,3450,1294,2077,269691646.0,419219914.0,131689,203508,2047.9,2060.0,335197,688911561.0,3371,2023-11-02 17:45:00
197,BANE,835,459,143079720.0,111852636.0,69949,54387,2045.5,2056.6,124336,254932356.0,1294,812,429,143669634.0,111049203.0,69381,53983,2070.7,2057.1,123364,254718837.0,1241,2023-11-02 17:50:00
198,BANE,805,235,92165883.0,50050322.0,44940,24288,2050.9,2060.7,69228,142216205.0,1040,787,215,88050939.0,48471979.0,42955,23524,2049.8,2060.5,66479,136522918.0,1002,2023-11-02 17:55:00
199,BANE,236,110,33273233.0,21061925.0,16241,10229,2048.7,2059.0,26470,54335158.0,346,227,103,35022361.0,21394520.0,17093,10381,2048.9,2060.9,27474,56416881.0,330,2023-11-02 18:00:00
200,BANE,185,224,17326096.0,27335612.0,8471,13251,2045.3,2062.9,21722,44661708.0,409,157,214,16993127.0,27316996.0,8311,13222,2044.7,2066.0,21533,44310124.0,371,2023-11-02 18:05:00
201,BANE,353,463,50558388.0,55122849.0,24784,26850,2040.0,2053.0,51634,105681237.0,816,330,428,49388021.0,53121181.0,24205,25840,2040.4,2055.8,50045,102509202.0,758,2023-11-02 18:10:00
202,BANE,1449,429,177767845.0,95648481.0,86967,46527,2044.1,2055.8,133494,273416326.0,1878,1433,421,177481848.0,95434686.0,86841,46425,2043.8,2055.7,133266,272916534.0,1854,2023-11-02 18:15:00
203,BANE,276,526,32673179.0,42374012.0,15980,20571,2044.6,2059.9,36551,75047191.0,802,256,525,32363495.0,42961203.0,15843,20849,2042.8,2060.6,36692,75324698.0,781,2023-11-02 18:20:00
204,BANE,93,115,11211762.0,16401341.0,5480,7959,2045.9,2060.7,13439,27613103.0,208,90,112,11123966.0,16381821.0,5439,7944,2045.2,2062.2,13383,27505787.0,202,2023-11-02 18:25:00
205,BANE,153,249,10599651.0,33182495.0,5186,16124,2043.9,2058.0,21310,43782147.0,402,146,248,12375282.0,34875700.0,6065,16921,2040.4,2061.1,22986,47250982.0,394,2023-11-02 18:30:00
206,BANE,424,373,29568846.0,54498975.0,14488,26568,2040.9,2051.3,41056,84067822.0,797,415,345,28543814.0,53794412.0,13980,26179,2041.8,2054.9,40159,82338226.0,760,2023-11-02 18:35:00
207,BANE,190,280,37019427.0,53201000.0,18152,25941,2039.4,2050.8,44093,90220427.0,470,177,278,37007723.0,53932433.0,18154,26266,2038.5,2053.3,44420,90940156.0,455,2023-11-02 18:40:00
208,BANE,3597,4608,855322856.0,925525673.0,419443,448943,2039.2,2061.6,868386,1780848530.0,8205,3479,4473,848943080.0,912148142.0,416239,442807,2039.6,2059.9,859046,1761091222.0,7952,2023-11-03 10:05:00
209,BANE,1765,3197,250569908.0,543408833.0,122560,264008,2044.5,2058.3,386568,793978741.0,4962,1745,3154,249401307.0,542943672.0,122026,263794,2043.8,2058.2,385820,792344979.0,4899,2023-11-03 10:10:00
210,BANE,599,674,37512369.0,50476610.0,18372,24540,2041.8,2056.9,42912,87988980.0,1273,592,659,37886480.0,52132105.0,18563,25336,2041.0,2057.6,43899,90018585.0,1251,2023-11-03 10:15:00
211,BANE,595,659,47145700.0,51786646.0,23158,25052,2035.8,2067.2,48210,98932346.0,1254,578,643,45524206.0,49800155.0,22299,24122,2041.5,2064.5,46421,95324361.0,1221,2023-11-03 10:20:00
212,BANE,464,1056,64967915.0,86984168.0,32548,42126,1996.1,2064.9,74674,151952083.0,1520,447,1046,64555989.0,86748025.0,32271,42011,2000.4,2064.9,74282,151304014.0,1493,2023-11-03 10:25:00
213,BANE,595,1534,108951536.0,179583451.0,53219,87148,2047.2,2060.7,140367,288534987.0,2129,575,1526,108374664.0,179357488.0,53033,87039,2043.5,2060.7,140072,287732152.0,2101,2023-11-03 10:30:00
214,BANE,411,1185,70943673.0,145600201.0,34614,70690,2049.6,2059.7,105304,216543874.0,1596,398,1179,70645941.0,145463373.0,34475,70604,2049.2,2060.3,105079,216109315.0,1577,2023-11-03 10:35:00
215,BANE,508,1018,111726377.0,94656142.0,55865,45933,1999.9,2060.7,101798,206382519.0,1526,493,1006,111476010.0,94313015.0,55750,45775,1999.6,2060.4,101525,205789025.0,1499,2023-11-03 10:40:00
216,BANE,263,830,24497364.0,122677908.0,11969,58318,2046.7,2103.6,70287,147175272.0,1093,259,824,24706631.0,123805413.0,12099,58843,2042.0,2104.0,70942,148512044.0,1083,2023-11-03 10:45:00
217,BANE,522,1802,24988034.0,497120207.0,12211,234298,2046.4,2121.7,246509,522108241.0,2324,514,1781,24144719.0,495608473.0,11807,233550,2044.9,2122.1,245357,519753193.0,2295,2023-11-03 10:50:00
218,BANE,414,1719,19172821.0,495612026.0,9354,235542,2049.7,2104.1,244896,514784848.0,2133,400,1712,18850506.0,495188263.0,9209,235338,2047.0,2104.2,244547,514038769.0,2112,2023-11-03 10:55:00
219,BANE,245,1804,13042414.0,552513166.0,6359,262344,2051.0,2106.1,268703,565555580.0,2049,235,1794,12775952.0,551336426.0,6233,261772,2049.7,2106.2,268005,564112378.0,2029,2023-11-03 11:00:00
220,BANE,468,602,27347932.0,67629583.0,13411,32732,2039.2,2066.2,46143,94977516.0,1070,460,588,27276435.0,66562210.0,13384,32196,2038.0,2067.4,45580,93838646.0,1048,2023-11-03 11:05:00
221,BANE,652,781,37732566.0,120615051.0,18477,58330,2042.1,2067.8,76807,158347617.0,1433,635,769,37514709.0,120327446.0,18374,58169,2041.7,2068.6,76543,157842155.0,1404,2023-11-03 11:10:00
222,BANE,651,711,36136981.0,116375489.0,17652,56241,2047.2,2069.2,73893,152512470.0,1362,642,699,36004290.0,115339576.0,17590,55736,2046.9,2069.4,73326,151343866.0,1341,2023-11-03 11:15:00
223,BANE,1129,1205,81245778.0,237399376.0,39783,114741,2042.2,2069.0,154524,318645155.0,2334,1127,1198,81541786.0,237002554.0,39936,114518,2041.8,2069.6,154454,318544340.0,2325,2023-11-03 11:20:00
224,BANE,990,862,51856950.0,132241060.0,25413,64146,2040.6,2061.6,89559,184098010.0,1852,983,841,50856720.0,131714433.0,24919,63891,2040.9,2061.5,88810,182571153.0,1824,2023-11-03 11:25:00
225,BANE,1145,1250,141899374.0,240177748.0,69790,117009,2033.2,2052.6,186799,382077122.0,2395,1133,1243,141398641.0,238970959.0,69542,116392,2033.3,2053.2,185934,380369600.0,2376,2023-11-03 11:30:00
226,BANE,672,841,88623006.0,182915123.0,43596,89519,2032.8,2043.3,133115,271538129.0,1513,639,784,88136904.0,181445684.0,43351,88588,2033.1,2048.2,131939,269582588.0,1423,2023-11-03 11:35:00
227,BANE,7117,1895,3304560727.0,300689535.0,1636691,146951,2019.0,2046.2,1783642,3605250262.0,9012,7071,1864,3300855658.0,299345343.0,1635422,146196,2018.4,2047.6,1781618,3600201002.0,8935,2023-11-03 11:40:00
228,BANE,498,1682,81985257.0,274997468.0,40363,134248,2031.2,2048.4,174611,356982726.0,2180,486,1673,82602837.0,274520956.0,40126,134018,2058.6,2048.4,174144,357123794.0,2159,2023-11-03 11:45:00
229,BANE,443,1465,91104124.0,176224592.0,44738,86018,2036.4,2048.7,130756,267328717.0,1908,433,1452,91523153.0,176005552.0,44952,85912,2036.0,2048.7,130864,267528705.0,1885,2023-11-03 11:50:00
230,BANE,1006,474,102250797.0,77266648.0,50180,37593,2037.7,2055.3,87773,179517445.0,1480,984,465,101382615.0,77407334.0,49779,37662,2036.7,2055.3,87441,178789950.0,1449,2023-11-03 11:55:00
231,BANE,1092,311,69336547.0,44322084.0,34080,21581,2034.5,2053.8,55661,113658632.0,1403,1086,302,69513730.0,42254830.0,34168,20567,2034.5,2054.5,54735,111768561.0,1388,2023-11-03 12:00:00
232,BANE,1266,437,200963364.0,115702862.0,98891,56656,2032.2,2042.2,155547,316666226.0,1703,1265,432,200270667.0,115519413.0,98535,56563,2032.5,2042.3,155098,315790081.0,1697,2023-11-03 12:05:00
233,BANE,3367,6429,1221477982.0,1953625934.0,601618,956834,2030.3,2041.8,1558452,3175103916.0,9796,3355,6418,1221108232.0,1952868679.0,601437,956460,2030.3,2041.8,1557897,3173976911.0,9773,2023-11-03 12:10:00
234,BANE,9367,18227,3432035634.0,5426618881.0,1692073,2660129,2028.3,2040.0,4352202,8858654515.0,27594,9360,18221,3431942393.0,5425913938.0,1692024,2659729,2028.3,2040.0,4351753,8857856331.0,27581,2023-11-03 12:15:00
235,BANE,2036,3006,622447195.0,753841097.0,307286,370385,2025.6,2035.3,677671,1376288293.0,5042,2012,2970,623030990.0,752272296.0,307570,369602,2025.7,2035.4,677172,1375303286.0,4982,2023-11-03 12:20:00
236,BANE,1327,1383,269294184.0,274661613.0,133181,135008,2022.0,2034.4,268189,543955797.0,2710,1310,1375,267907707.0,274498663.0,132497,134909,2022.0,2034.7,267406,542406370.0,2685,2023-11-03 12:25:00
237,BANE,1525,1349,407776784.0,263898464.0,202090,129727,2017.8,2034.3,331817,671675248.0,2874,1519,1342,407823290.0,263742398.0,202116,129648,2017.8,2034.3,331764,671565688.0,2861,2023-11-03 12:30:00
238,BANE,1285,762,246693486.0,177978528.0,121783,87505,2025.7,2033.9,209288,424672014.0,2047,1274,760,246795800.0,179034890.0,121843,88007,2025.5,2034.3,209850,425830690.0,2034,2023-11-03 12:35:00
239,BANE,735,1152,182246940.0,260753351.0,89941,128019,2026.3,2036.8,217960,443000291.0,1887,726,1149,181183693.0,260387867.0,89410,127841,2026.4,2036.8,217251,441571560.0,1875,2023-11-03 12:40:00
240,BANE,581,689,138530268.0,105476801.0,68376,51807,2026.0,2036.0,120183,244007070.0,1270,569,681,137824526.0,105116262.0,68034,51627,2025.8,2036.1,119661,242940788.0,1250,2023-11-03 12:45:00
241,BANE,262,235,62700566.0,46764798.0,30934,22970,2026.9,2035.9,53904,109465365.0,497,254,232,62227955.0,46747391.0,30702,22962,2026.8,2035.9,53664,108975347.0,486,2023-11-03 12:50:00
242,BANE,255,257,53754267.0,38450074.0,26532,18993,2026.0,2024.4,45525,92204341.0,512,237,249,51997840.0,37111172.0,25663,18213,2026.2,2037.6,43876,89109012.0,486,2023-11-03 12:55:00
243,BANE,117,119,22305462.0,22572516.0,11014,11067,2025.2,2039.6,22081,44877978.0,236,100,116,22225334.0,22661946.0,10975,11111,2025.1,2039.6,22086,44887281.0,216,2023-11-03 13:00:00
244,BANE,156,330,33637250.0,50427341.0,16619,24743,2024.0,2038.0,41362,84064591.0,486,146,322,34169400.0,50677994.0,16885,24843,2023.7,2039.9,41728,84847394.0,468,2023-11-03 13:05:00
245,BANE,90,214,14658060.0,32917257.0,7229,16150,2027.7,2038.2,23379,47575317.0,304,83,212,13468135.0,33346133.0,6649,16360,2025.6,2038.3,23009,46814268.0,295,2023-11-03 13:10:00
246,BANE,116,225,6671954.0,49449433.0,3288,24233,2029.2,2040.6,27521,56121388.0,341,115,221,6666241.0,48978072.0,3287,24001,2028.1,2040.7,27288,55644313.0,336,2023-11-03 13:15:00
247,BANE,343,362,25143745.0,85432466.0,12388,41828,2029.7,2042.5,54216,110576211.0,705,344,366,25212628.0,85043953.0,12423,41643,2029.5,2042.2,54066,110256581.0,710,2023-11-03 13:20:00
248,BANE,317,858,34406462.0,218717277.0,16954,107143,2029.4,2041.4,124097,253123739.0,1175,301,836,33308208.0,217797029.0,16414,106686,2029.3,2041.5,123100,251105237.0,1137,2023-11-03 13:25:00
249,BANE,418,1359,64883432.0,281979718.0,32081,138494,2022.5,2036.0,170575,346863150.0,1777,411,1346,64743257.0,280318132.0,31993,137680,2023.7,2036.0,169673,345061389.0,1757,2023-11-03 13:30:00
250,BANE,718,2527,218427179.0,618742793.0,108135,304448,2019.9,2032.3,412583,837169972.0,3245,709,2507,218381623.0,618726990.0,108112,304437,2020.0,2032.4,412549,837108613.0,3216,2023-11-03 13:35:00
251,BANE,117,321,10969436.0,30309399.0,5415,14942,2025.7,2028.5,20357,41278835.0,438,106,308,10788767.0,30050795.0,5341,14808,2020.0,2029.4,20149,40839562.0,414,2023-11-03 13:40:00
252,BANE,98,93,7315841.0,15164639.0,3618,7476,2022.1,2028.4,11094,22480481.0,191,84,77,7194270.0,14740800.0,3564,7263,2018.6,2029.6,10827,21935070.0,161,2023-11-03 13:45:00
253,BANE,245,378,31374910.0,41392135.0,15515,20351,2022.2,2033.9,35866,72767045.0,623,231,364,31351271.0,40158519.0,15513,19745,2021.0,2033.9,35258,71509790.0,595,2023-11-03 13:50:00
254,BANE,330,227,21636501.0,21362811.0,10770,10491,2009.0,2036.3,21261,42999312.0,557,325,223,21295593.0,21377260.0,10572,10492,2014.3,2037.5,21064,42672854.0,548,2023-11-03 13:55:00
255,BANE,303,458,36730791.0,68341421.0,18250,33730,2012.6,2026.1,51980,105072212.0,761,239,382,34082521.0,65773796.0,16953,32329,2010.4,2034.5,49282,99856317.0,621,2023-11-03 14:00:00
256,BANE,387,137,24664037.0,24136906.0,12267,11870,2010.6,2033.4,24137,48800943.0,524,334,107,23622715.0,23829405.0,11768,11701,2007.4,2036.5,23469,47452120.0,441,2023-11-03 14:05:00
257,BANE,544,373,56969146.0,65846274.0,28141,32379,2024.4,2033.6,60520,122815421.0,917,515,361,55485333.0,65205447.0,27543,32063,2014.5,2033.7,59606,120690781.0,876,2023-11-03 14:10:00
258,BANE,696,180,45624159.0,27523848.0,22577,13530,2020.8,2034.3,36107,73148007.0,876,693,175,45585403.0,27450085.0,22558,13494,2020.8,2034.2,36052,73035489.0,868,2023-11-03 14:15:00
259,BANE,992,458,86163987.0,107195755.0,42776,52557,2014.3,2039.6,95333,193359742.0,1450,842,444,84481864.0,105831321.0,42013,51827,2010.9,2042.0,93840,190313186.0,1286,2023-11-03 14:20:00
260,BANE,1041,225,46384331.0,56356859.0,22928,27520,2023.0,2047.9,50448,102741191.0,1266,1025,222,46221670.0,45895819.0,22846,22539,2023.2,2036.3,45385,92117490.0,1247,2023-11-03 14:25:00
261,BANE,914,370,58162494.0,22929082.0,28808,11261,2019.0,2036.1,40069,81091576.0,1284,909,369,58509887.0,23488197.0,28982,11537,2018.8,2035.9,40519,81998085.0,1278,2023-11-03 14:30:00
262,BANE,550,203,56158916.0,15439471.0,27811,7579,2019.3,2037.1,35390,71598387.0,753,545,198,55507512.0,14884528.0,27493,7304,2019.0,2037.9,34797,70392041.0,743,2023-11-03 14:35:00
263,BANE,537,323,132160349.0,8905539.0,65467,4384,2018.7,2031.4,69851,141065888.0,860,542,315,132030386.0,8766445.0,65404,4314,2018.7,2032.1,69718,140796831.0,857,2023-11-03 14:40:00
264,BANE,542,142,32109839.0,12726260.0,15879,6215,2022.2,2047.7,22094,44836100.0,684,532,135,31996420.0,12789227.0,15813,6256,2023.4,2044.3,22069,44785647.0,667,2023-11-03 14:45:00
265,BANE,555,201,45318731.0,7437111.0,22402,3651,2023.0,2037.0,26053,52755842.0,756,548,194,45194176.0,7388770.0,22341,3627,2022.9,2037.2,25968,52582946.0,742,2023-11-03 14:50:00
266,BANE,476,121,40243791.0,19808215.0,19894,9748,2022.9,2032.0,29642,60052006.0,597,470,109,39608228.0,19126247.0,19584,9414,2022.5,2031.7,28998,58734476.0,579,2023-11-03 14:55:00
267,BANE,636,124,43704629.0,22534789.0,21444,11054,2038.1,2038.6,32498,66239418.0,760,627,115,42574498.0,21196608.0,21026,10386,2024.9,2040.9,31412,63771106.0,742,2023-11-03 15:00:00
268,BANE,138,135,15397239.0,14643735.0,7605,7190,2024.6,2036.7,14795,30040974.0,273,134,126,15282318.0,14412445.0,7548,7076,2024.7,2036.8,14624,29694764.0,260,2023-11-03 15:05:00
269,BANE,280,75,15640186.0,3021705.0,7712,1487,2028.0,2032.1,9199,18661891.0,355,277,68,15507551.0,2870695.0,7647,1411,2027.9,2034.5,9058,18378246.0,345,2023-11-03 15:10:00
270,BANE,256,116,25055617.0,19266219.0,12371,9462,2025.4,2036.2,21833,44321836.0,372,250,111,24749146.0,19049943.0,12220,9354,2025.3,2036.6,21574,43799089.0,361,2023-11-03 15:15:00
271,BANE,258,386,12284921.0,62106767.0,6062,30505,2026.5,2036.0,36567,74391688.0,644,254,384,12149066.0,61940875.0,5996,30421,2026.2,2036.1,36417,74089941.0,638,2023-11-03 15:20:00
272,BANE,24,219,671158.0,4171743.0,332,2053,2021.6,2032.0,2385,4842901.0,243,25,212,699723.0,4096857.0,346,2016,2022.3,2032.2,2362,4796580.0,237,2023-11-03 15:25:00
273,BANE,505,151,22034688.0,14421775.0,10892,7093,2023.0,2033.2,17985,36456464.0,656,500,150,21907913.0,14072536.0,10828,6920,2023.3,2033.6,17748,35980450.0,650,2023-11-03 15:30:00
274,BANE,378,350,29409894.0,64211491.0,14560,31799,2019.9,2019.3,46359,93621385.0,728,358,341,29820765.0,63088735.0,14762,31086,2020.1,2029.5,45848,92909501.0,699,2023-11-03 15:35:00
275,BANE,160,254,17889357.0,41791306.0,8866,20628,2017.7,2026.0,29494,59680663.0,414,158,251,19037636.0,41798274.0,9440,20633,2016.7,2025.8,30073,60835910.0,409,2023-11-03 15:40:00
276,BANE,248,218,15256209.0,34652708.0,6674,17084,2285.9,2028.4,23758,49908917.0,466,242,215,13902570.0,33890461.0,6450,16709,2155.4,2028.3,23159,47793032.0,457,2023-11-03 15:45:00
277,BANE,288,307,14262934.0,63586422.0,7079,31390,2014.8,2025.7,38469,77849356.0,595,268,295,13709525.0,61773906.0,6803,30486,2015.2,2026.3,37289,75483432.0,563,2023-11-03 15:50:00
278,BANE,299,498,14619436.0,69972312.0,7259,34564,2014.0,2024.4,41823,84591748.0,797,281,495,13817017.0,69794395.0,6418,34477,2152.9,2024.4,40895,83611412.0,776,2023-11-03 15:55:00
279,BANE,85,338,3383312.0,17932515.0,1652,8856,2048.0,2024.9,10508,21315828.0,423,71,334,3353160.0,17301420.0,1664,8543,2015.1,2025.2,10207,20654581.0,405,2023-11-03 16:00:00
280,BANE,84,215,6894172.0,27727075.0,3421,13702,2015.3,2023.6,17123,34621248.0,299,80,208,5846821.0,27197678.0,2902,13438,2014.8,2023.9,16340,33044499.0,288,2023-11-03 16:05:00
281,BANE,156,170,15768070.0,30177943.0,7763,14899,2031.2,2025.5,22662,45946013.0,326,141,162,14406220.0,29487932.0,7152,14555,2014.3,2026.0,21707,43894152.0,303,2023-11-03 16:10:00
282,BANE,33,238,3934018.0,27959793.0,1952,13814,2015.4,2024.0,15766,31893811.0,271,30,234,3913797.0,27882158.0,1942,13778,2015.3,2023.7,15720,31795955.0,264,2023-11-03 16:15:00
283,BANE,18,251,1366479.0,31194693.0,680,15422,2009.5,2022.7,16102,32561173.0,269,19,250,1372202.0,30239834.0,681,14947,2015.0,2023.1,15628,31612036.0,269,2023-11-03 16:20:00
284,BANE,95,70,5035114.0,17457223.0,2451,8677,2054.3,2011.9,11128,22492337.0,165,89,65,4541498.0,17215173.0,2260,8508,2009.5,2023.4,10768,21756672.0,154,2023-11-03 16:25:00
285,BANE,46,44,3058026.0,3492357.0,1492,1731,2049.6,2017.5,3223,6550383.0,90,39,41,3440392.0,3188875.0,1712,1578,2009.6,2020.8,3290,6629268.0,80,2023-11-03 16:30:00
286,BANE,68,65,6727584.0,12530488.0,3345,6196,2011.2,2022.4,9541,19258073.0,133,65,60,6568523.0,12143031.0,3266,6003,2011.2,2022.8,9269,18711554.0,125,2023-11-03 16:35:00
287,BANE,69,51,5085028.0,7153097.0,2525,3529,2013.9,2026.9,6054,12238125.0,120,53,48,4591471.0,7112734.0,2283,3513,2011.2,2024.7,5796,11704205.0,101,2023-11-03 16:40:00
288,BANE,40,44,817135.0,4750874.0,406,2341,2012.6,2029.4,2747,5568009.0,84,32,42,681951.0,4796358.0,339,2359,2011.7,2033.2,2698,5478310.0,74,2023-11-03 16:45:00
289,BANE,47,47,3697571.0,4600874.0,1833,2274,2017.2,2023.3,4107,8298445.0,94,39,46,3237243.0,4536235.0,1608,2242,2013.2,2023.3,3850,7773479.0,85,2023-11-03 16:50:00
290,BANE,389,467,50993026.0,52538745.0,25311,25931,2014.7,2026.1,51242,103531771.0,856,373,468,50309699.0,54192136.0,24975,26742,2014.4,2026.5,51717,104501835.0,841,2023-11-03 16:55:00
291,BANE,385,554,42593752.0,45434295.0,21086,22393,2020.0,2029.0,43479,88028048.0,939,362,547,41192681.0,45142833.0,20402,22250,2019.1,2028.9,42652,86335514.0,909,2023-11-03 17:00:00
292,BANE,762,394,60311833.0,45628354.0,29835,22466,2021.5,2031.0,52301,105940187.0,1156,754,385,60603707.0,43792979.0,29981,21564,2021.4,2030.8,51545,104396686.0,1139,2023-11-03 17:05:00
293,BANE,699,409,73346791.0,36812490.0,36291,18134,2021.1,2030.0,54425,110159281.0,1108,690,400,71937018.0,36329043.0,35592,17895,2021.2,2030.1,53487,108266061.0,1090,2023-11-03 17:10:00
294,BANE,644,701,67712132.0,46802566.0,33496,23057,2021.5,2029.9,56553,114514699.0,1345,632,699,68666219.0,46835785.0,33977,23073,2021.0,2029.9,57050,115502005.0,1331,2023-11-03 17:15:00
295,BANE,625,521,50539456.0,47127066.0,24986,23215,2022.7,2030.0,48201,97666523.0,1146,617,515,50454252.0,47138739.0,24958,23221,2021.6,2030.0,48179,97592991.0,1132,2023-11-03 17:20:00
296,BANE,708,506,52675904.0,38509394.0,26049,18968,2022.2,2030.2,45017,91185298.0,1214,701,503,51483532.0,38586056.0,25465,19006,2021.7,2030.2,44471,90069589.0,1204,2023-11-03 17:25:00
297,BANE,378,234,24029902.0,17996742.0,11883,8863,2022.2,2030.5,20746,42026644.0,612,375,213,24782283.0,17005627.0,12255,8372,2022.2,2031.3,20627,41787910.0,588,2023-11-03 17:30:00
298,BANE,1092,281,61501277.0,17139710.0,30303,8434,2029.5,2032.2,38737,78640987.0,1373,1083,257,60505403.0,16491823.0,29898,8111,2023.7,2033.3,38009,76997226.0,1340,2023-11-03 17:35:00
299,BANE,571,381,52518525.0,12528195.0,25949,6166,2023.9,2031.8,32115,65046721.0,952,563,364,52559507.0,12248356.0,25972,6026,2023.7,2032.6,31998,64807863.0,927,2023-11-03 17:40:00
300,BANE,321,266,31937577.0,14263009.0,15783,7024,2023.5,2030.6,22807,46200586.0,587,318,259,31965867.0,14126486.0,15797,6953,2023.5,2031.7,22750,46092353.0,577,2023-11-03 17:45:00
301,BANE,493,280,46010099.0,15586128.0,22721,7666,2025.0,2033.2,30387,61596228.0,773,487,279,45537192.0,15990520.0,22501,7865,2023.8,2033.1,30366,61527713.0,766,2023-11-03 17:50:00
302,BANE,378,167,44296241.0,10451863.0,21882,5144,2024.3,2031.9,27026,54748104.0,545,375,162,44201124.0,10466707.0,21835,5145,2024.3,2034.3,26980,54667831.0,537,2023-11-03 17:55:00
303,BANE,668,406,62111496.0,13052663.0,30686,6422,2024.1,2032.5,37108,75164159.0,1074,670,403,62330440.0,13026691.0,30794,6409,2024.1,2032.6,37203,75357131.0,1073,2023-11-03 18:00:00
304,BANE,486,411,67985882.0,11789604.0,33588,5796,2024.1,2034.1,39384,79775486.0,897,484,413,67605055.0,12127046.0,33400,5965,2024.1,2033.0,39365,79732101.0,897,2023-11-03 18:05:00
305,BANE,123,89,12138891.0,6298071.0,5995,3118,2024.8,2019.9,9113,18436962.0,212,118,87,12239134.0,6044208.0,6045,2969,2024.7,2035.8,9014,18283342.0,205,2023-11-03 18:10:00
306,BANE,297,173,36646035.0,9830063.0,18100,4835,2024.6,2033.1,22935,46476098.0,470,296,171,36626060.0,9787568.0,18091,4814,2024.5,2033.1,22905,46413628.0,467,2023-11-03 18:15:00
307,BANE,157,74,10938467.0,7174349.0,5395,3529,2027.5,2033.0,8924,18112816.0,231,159,64,10908163.0,6892110.0,5393,3389,2022.7,2033.7,8782,17800273.0,223,2023-11-03 18:20:00
308,BANE,211,43,18444128.0,2656875.0,9119,1308,2022.6,2031.3,10427,21101004.0,254,212,41,18581665.0,2470715.0,9187,1216,2022.6,2031.8,10403,21052380.0,253,2023-11-03 18:25:00
309,BANE,544,141,21564363.0,14267769.0,10661,7032,2022.7,2029.0,17693,35832132.0,685,537,135,21331159.0,14182022.0,10549,6982,2022.1,2031.2,17531,35513181.0,672,2023-11-03 18:30:00
310,BANE,763,286,134118489.0,20953422.0,66367,10322,2020.9,2030.0,76689,155071911.0,1049,755,283,134115232.0,20713384.0,66365,10203,2020.9,2030.1,76568,154828616.0,1038,2023-11-03 18:35:00
311,BANE,1127,359,162439523.0,24030677.0,80369,11834,2021.2,2030.6,92203,186470201.0,1486,1131,357,162782926.0,23695419.0,80596,11667,2019.7,2031.0,92263,186478345.0,1488,2023-11-03 18:40:00
312,BANE,1652,2054,264529845.0,384818976.0,129504,187905,2042.6,2047.9,317409,649348822.0,3706,1545,1941,260459004.0,379034333.0,128303,185170,2030.0,2047.0,313473,639493337.0,3486,2023-11-06 10:05:00
313,BANE,1543,2102,298880718.0,255240179.0,147803,124989,2022.2,2042.1,272792,554120898.0,3645,1511,2066,297023517.0,253615687.0,146897,124151,2022.0,2042.8,271048,550639204.0,3577,2023-11-06 10:10:00
314,BANE,799,1100,156634529.0,86606727.0,77493,42474,2021.3,2039.1,119967,243241256.0,1899,784,1079,156174136.0,85221605.0,77266,41782,2021.3,2039.7,119048,241395742.0,1863,2023-11-06 10:15:00
315,BANE,1143,1130,149004234.0,123361148.0,73463,60415,2028.3,2041.9,133878,272365382.0,2273,1133,1107,149017765.0,122919580.0,73484,60205,2027.9,2041.7,133689,271937345.0,2240,2023-11-06 10:20:00
316,BANE,905,667,170283676.0,65238138.0,84112,31994,2024.5,2039.1,116106,235521814.0,1572,893,653,169721852.0,64616623.0,83843,31683,2024.3,2039.5,115526,234338476.0,1546,2023-11-06 10:25:00
317,BANE,1246,885,218034362.0,119407456.0,107489,58520,2028.4,2040.5,166009,337441819.0,2131,1230,870,217848912.0,118417728.0,107418,58039,2028.0,2040.3,165457,336266640.0,2100,2023-11-06 10:30:00
318,BANE,1370,1192,215463133.0,191637022.0,106071,93919,2031.3,2040.4,199990,407100155.0,2562,1362,1189,215328443.0,191577576.0,106005,93890,2031.3,2040.4,199895,406906019.0,2551,2023-11-06 10:35:00
319,BANE,559,499,73537759.0,63066959.0,36222,30815,2030.2,2046.6,67037,136604718.0,1058,549,493,73446757.0,62000945.0,36182,30387,2029.9,2040.4,66569,135447702.0,1042,2023-11-06 10:40:00
320,BANE,2565,1079,432590369.0,114343091.0,213333,55819,2027.8,2048.5,269152,546933460.0,3644,2530,1051,430029541.0,111339351.0,212084,54366,2027.6,2048.0,266450,541368892.0,3581,2023-11-06 10:45:00
321,BANE,2069,656,297343582.0,44366487.0,145816,21611,2039.2,2053.0,167427,341710069.0,2725,2044,628,296047502.0,44450057.0,145418,21649,2035.8,2053.2,167067,340497559.0,2672,2023-11-06 10:50:00
322,BANE,2166,1243,518369342.0,269054623.0,254450,131407,2037.2,2047.5,385857,787423965.0,3409,2153,1226,517785309.0,266912001.0,254161,130364,2037.2,2047.4,384525,784697310.0,3379,2023-11-06 10:55:00
323,BANE,633,725,179314189.0,112756105.0,87988,55107,2037.9,2046.1,143095,292070295.0,1358,628,724,179278899.0,113569608.0,87982,55495,2037.7,2046.5,143477,292848507.0,1352,2023-11-06 11:00:00
324,BANE,358,148,72263708.0,32392065.0,35443,15799,2038.9,2050.3,51242,104655773.0,506,349,145,71642081.0,32696296.0,35179,15949,2036.5,2050.1,51128,104338378.0,494,2023-11-06 11:05:00
325,BANE,1559,693,384361633.0,134456137.0,188628,65619,2037.7,2049.0,254247,518817770.0,2252,1553,681,384249964.0,134320651.0,188586,65553,2037.5,2049.0,254139,518570615.0,2234,2023-11-06 11:10:00
326,BANE,649,414,168493550.0,87928340.0,82676,42918,2038.0,2048.8,125594,256421890.0,1063,646,408,168478829.0,88288648.0,82667,43094,2038.0,2048.7,125761,256767477.0,1054,2023-11-06 11:15:00
327,BANE,287,240,48290151.0,10773226.0,23672,5253,2040.0,2050.9,28925,59063377.0,527,275,236,48006629.0,10611056.0,23583,5174,2035.6,2050.8,28757,58617685.0,511,2023-11-06 11:20:00
328,BANE,2492,762,690531282.0,187460705.0,338970,91339,2037.1,2052.4,430309,877991987.0,3254,2483,750,689862423.0,186844405.0,338663,91033,2037.0,2052.5,429696,876706828.0,3233,2023-11-06 11:25:00
329,BANE,2787,1399,604871646.0,362489946.0,296490,176735,2040.1,2051.0,473225,967361592.0,4186,2777,1394,605124375.0,362098514.0,296615,176546,2040.1,2051.0,473161,967222889.0,4171,2023-11-06 11:30:00
330,BANE,2036,1923,521210215.0,387270610.0,255636,188881,2038.9,2050.3,444517,908480826.0,3959,2028,1906,521006795.0,386692321.0,255535,188572,2038.9,2050.6,444107,907699116.0,3934,2023-11-06 11:35:00
331,BANE,1535,1574,438664536.0,240903393.0,215260,117607,2037.8,2048.4,332867,679567929.0,3109,1532,1573,438505356.0,240967698.0,215182,117637,2037.8,2048.4,332819,679473054.0,3105,2023-11-06 11:40:00
332,BANE,1156,1444,236576784.0,231427234.0,115962,112909,2040.1,2049.7,228871,468004018.0,2600,1146,1437,236518944.0,231147621.0,115937,112780,2040.1,2049.5,228717,467666565.0,2583,2023-11-06 11:45:00
333,BANE,599,551,140756647.0,112461439.0,68987,54838,2040.3,2050.8,123825,253218086.0,1150,597,548,140286943.0,112296162.0,68758,54759,2040.3,2050.7,123517,252583106.0,1145,2023-11-06 11:50:00
334,BANE,569,611,124094784.0,131185225.0,60810,63955,2040.7,2051.2,124765,255280009.0,1180,563,602,124115816.0,130723383.0,60820,63731,2040.7,2051.2,124551,254839199.0,1165,2023-11-06 11:55:00
335,BANE,333,397,71933516.0,40382768.0,35224,19690,2042.2,2050.9,54914,112316284.0,730,327,393,71853817.0,40039315.0,35221,19529,2040.1,2050.2,54750,111893132.0,720,2023-11-06 12:00:00
336,BANE,164,196,32166349.0,23125665.0,15763,11275,2040.6,2051.1,27038,55292014.0,360,161,189,31471080.0,23511684.0,15427,11461,2040.0,2051.5,26888,54982764.0,350,2023-11-06 12:05:00
337,BANE,373,273,109044384.0,49913652.0,53422,24334,2041.2,2051.2,77756,158958036.0,646,370,263,108319557.0,49260101.0,53081,24016,2040.6,2051.1,77097,157579658.0,633,2023-11-06 12:10:00
338,BANE,600,583,130567526.0,66754498.0,63842,32495,2045.2,2054.3,96337,197322025.0,1183,582,561,131284503.0,65957494.0,64198,32106,2045.0,2054.4,96304,197241998.0,1143,2023-11-06 12:15:00
339,BANE,408,352,94844842.0,42898620.0,46408,20897,2043.7,2052.9,67305,137743462.0,760,404,343,94719813.0,43740857.0,46349,21292,2043.6,2054.3,67641,138460670.0,747,2023-11-06 12:20:00
340,BANE,381,439,78737628.0,29629025.0,38553,14450,2042.3,2050.5,53003,108366653.0,820,380,433,78841900.0,29614574.0,38605,14436,2042.3,2051.4,53041,108456474.0,813,2023-11-06 12:25:00
341,BANE,419,407,106869442.0,42465912.0,52320,20702,2042.6,2051.3,73022,149335354.0,826,412,404,106184683.0,42442256.0,51986,20686,2042.6,2051.7,72672,148626939.0,816,2023-11-06 12:30:00
342,BANE,1289,741,282334602.0,92630847.0,137775,45038,2049.2,2056.7,182813,374965449.0,2030,1237,694,278854103.0,91791149.0,136242,44633,2046.8,2056.6,180875,370645252.0,1931,2023-11-06 12:35:00
343,BANE,1094,539,281701929.0,50975161.0,137496,24759,2048.8,2058.9,162255,332677090.0,1633,1079,514,281405340.0,50704505.0,137368,24627,2048.6,2058.9,161995,332109845.0,1593,2023-11-06 12:40:00
344,BANE,264,132,62948356.0,7021690.0,30715,3411,2049.4,2058.5,34126,69970047.0,396,256,121,62027012.0,6542180.0,30270,3178,2049.1,2058.6,33448,68569192.0,377,2023-11-06 12:45:00
345,BANE,209,135,40672378.0,18443478.0,19856,8961,2048.4,2058.2,28817,59115856.0,344,201,114,40575835.0,17369870.0,19810,8434,2048.3,2059.5,28244,57945705.0,315,2023-11-06 12:50:00
346,BANE,484,246,82247376.0,29461045.0,40182,14310,2046.9,2058.8,54492,111708421.0,730,467,222,81484794.0,28511416.0,39809,13831,2046.9,2061.4,53640,109996211.0,689,2023-11-06 12:55:00
347,BANE,447,1030,79502702.0,125971073.0,38852,61386,2046.3,2052.1,100238,205473775.0,1477,431,1023,78845124.0,124780109.0,38533,60732,2046.2,2054.6,99265,203625234.0,1454,2023-11-06 13:00:00
348,BANE,747,376,94073599.0,57542842.0,45851,27892,2051.7,2063.1,73743,151616441.0,1123,736,369,92988148.0,57531151.0,45395,27875,2048.4,2063.9,73270,150519300.0,1105,2023-11-06 13:05:00
349,BANE,893,285,125627448.0,40309015.0,61406,19541,2045.8,2062.8,80947,165936464.0,1178,890,278,126027953.0,40562167.0,61618,19659,2045.3,2063.3,81277,166590120.0,1168,2023-11-06 13:10:00
350,BANE,418,761,84648921.0,89118715.0,41377,43370,2045.8,2054.8,84747,173767636.0,1179,416,757,84647202.0,89177894.0,41380,43399,2045.6,2054.8,84779,173825096.0,1173,2023-11-06 13:15:00
351,BANE,608,825,108961044.0,101367204.0,53180,49294,2048.9,2056.4,102474,210328248.0,1433,600,818,108603469.0,101214939.0,53016,49218,2048.5,2056.5,102234,209818408.0,1418,2023-11-06 13:20:00
352,BANE,353,236,78143113.0,38268154.0,38203,18579,2045.5,2059.8,56782,116411267.0,589,346,229,77923338.0,38220243.0,38096,18552,2045.4,2060.2,56648,116143581.0,575,2023-11-06 13:25:00
353,BANE,570,338,118894964.0,68125359.0,58012,33057,2049.5,2060.8,91069,187020323.0,908,571,335,118930967.0,68026883.0,58030,33009,2049.5,2060.9,91039,186957850.0,906,2023-11-06 13:30:00
354,BANE,579,327,135059636.0,65748475.0,65901,31917,2049.4,2060.0,97818,200808112.0,906,573,322,134990301.0,65729416.0,65872,31894,2049.3,2060.9,97766,200719717.0,895,2023-11-06 13:35:00
355,BANE,604,248,141243003.0,47147401.0,68925,22883,2049.2,2060.4,91808,188390404.0,852,602,241,141208664.0,47184744.0,68909,22901,2049.2,2060.4,91810,188393408.0,843,2023-11-06 13:40:00
356,BANE,587,289,118219054.0,52574087.0,57696,25568,2049.0,2056.2,83264,170793141.0,876,582,289,117836488.0,52488094.0,57506,25515,2049.1,2057.1,83021,170324582.0,871,2023-11-06 13:45:00
357,BANE,471,388,71146007.0,49635510.0,34744,24137,2047.7,2056.4,58881,120781518.0,859,467,378,71159605.0,48668004.0,34751,23648,2047.7,2058.0,58399,119827609.0,845,2023-11-06 13:50:00
358,BANE,496,471,88988011.0,85047649.0,43434,41360,2048.8,2056.3,84794,174035660.0,967,487,468,88718649.0,84749246.0,43303,41214,2048.8,2056.3,84517,173467895.0,955,2023-11-06 13:55:00
359,BANE,586,917,76692018.0,97538094.0,37436,47435,2048.6,2056.2,84871,174230112.0,1503,584,914,77175600.0,97318608.0,37673,47328,2048.6,2056.3,85001,174494209.0,1498,2023-11-06 14:00:00
360,BANE,226,1020,13345341.0,111233086.0,6514,54120,2048.7,2055.3,60634,124578427.0,1246,226,1018,13065399.0,111378780.0,6378,54191,2048.5,2055.3,60569,124444179.0,1244,2023-11-06 14:05:00
361,BANE,222,251,33064404.0,38868065.0,16108,18885,2052.7,2058.1,34993,71932469.0,473,196,246,31541213.0,38980207.0,15416,18939,2046.0,2058.2,34355,70521420.0,442,2023-11-06 14:10:00
362,BANE,65,43,8164992.0,4632366.0,3985,2241,2048.9,2067.1,6226,12797358.0,108,58,38,8035521.0,4838542.0,3922,2340,2048.8,2067.8,6262,12874064.0,96,2023-11-06 14:15:00
363,BANE,91,66,16641701.0,6280077.0,8116,3054,2050.5,2056.3,11170,22921778.0,157,95,58,16140601.0,5633640.0,7871,2738,2050.6,2057.6,10609,21774241.0,153,2023-11-06 14:20:00
364,BANE,30,24,1177358.0,1652643.0,551,803,2136.8,2058.1,1354,2830001.0,54,17,22,863428.0,1424132.0,421,692,2050.9,2058.0,1113,2287560.0,39,2023-11-06 14:25:00
365,BANE,238,312,7512082.0,9946060.0,3657,4819,2054.2,2063.9,8476,17458143.0,550,225,306,6794495.0,9888304.0,3309,4793,2053.3,2063.1,8102,16682800.0,531,2023-11-06 14:30:00
366,BANE,135,237,21281716.0,9492592.0,10339,4599,2058.4,2064.1,14938,30774308.0,372,114,227,19567130.0,10327385.0,9536,5003,2051.9,2064.2,14539,29894516.0,341,2023-11-06 14:35:00
367,BANE,349,301,64514640.0,57190144.0,31359,27673,2057.3,2066.6,59032,121704785.0,650,309,282,62911515.0,56659746.0,30584,27337,2057.0,2072.6,57921,119571262.0,591,2023-11-06 14:40:00
368,BANE,133,136,19290164.0,14583162.0,9378,7039,2057.0,2071.8,16417,33873326.0,269,127,127,19486196.0,14361721.0,9476,6943,2056.4,2068.5,16419,33847917.0,254,2023-11-06 14:45:00
369,BANE,153,100,20261750.0,22190791.0,9860,10721,2054.9,2069.8,20581,42452541.0,253,146,86,20113752.0,21624862.0,9791,10445,2054.3,2070.4,20236,41738614.0,232,2023-11-06 14:50:00
370,BANE,392,410,72926857.0,75111605.0,35391,36199,2060.6,2075.0,71590,148038462.0,802,353,382,70025528.0,74428790.0,34041,35875,2057.1,2074.7,69916,144454318.0,735,2023-11-06 14:55:00
371,BANE,438,390,87586608.0,50513378.0,42530,24354,2059.4,2074.1,66884,138099986.0,828,407,356,86016143.0,50120507.0,41795,24157,2058.0,2074.8,65952,136136650.0,763,2023-11-06 15:00:00
372,BANE,151,223,30104653.0,23561330.0,14591,11377,2063.2,2071.0,25968,53665983.0,374,131,203,29661796.0,22803330.0,14387,10989,2061.7,2075.1,25376,52465126.0,334,2023-11-06 15:05:00
373,BANE,304,256,38106976.0,44734351.0,18432,21470,2067.4,2083.6,39902,82841327.0,560,273,225,37024108.0,43491217.0,17970,20849,2060.3,2086.0,38819,80515325.0,498,2023-11-06 15:10:00
374,BANE,207,370,34813739.0,57285415.0,16858,27602,2065.1,2075.4,44460,92099155.0,577,198,350,34317578.0,56055476.0,16640,27009,2062.4,2075.4,43649,90373054.0,548,2023-11-06 15:15:00
375,BANE,485,508,49905226.0,85578963.0,24194,41264,2062.7,2073.9,65458,135484189.0,993,479,501,50167200.0,84936662.0,24320,40954,2062.8,2074.0,65274,135103863.0,980,2023-11-06 15:20:00
376,BANE,531,459,75534060.0,98150665.0,36611,47337,2063.2,2073.4,83948,173684725.0,990,530,453,75496611.0,97937439.0,36593,47209,2063.1,2074.6,83802,173434050.0,983,2023-11-06 15:25:00
377,BANE,429,1023,96463928.0,191731064.0,46739,92414,2063.9,2074.7,139153,288194992.0,1452,416,1009,96249529.0,191616238.0,46640,92344,2063.7,2075.0,138984,287865767.0,1425,2023-11-06 15:30:00
378,BANE,606,1403,95840370.0,202576863.0,46413,97634,2064.9,2074.9,144047,298417233.0,2009,590,1389,95915000.0,202631512.0,46453,97668,2064.8,2074.7,144121,298546512.0,1979,2023-11-06 15:35:00
379,BANE,422,1093,28474778.0,139248953.0,13774,67128,2067.3,2074.4,80902,167723731.0,1515,419,1086,28413928.0,138634104.0,13744,66835,2067.4,2074.3,80579,167048032.0,1505,2023-11-06 15:40:00
380,BANE,264,1139,29532047.0,132101415.0,14289,63703,2066.8,2073.7,77992,161633462.0,1403,258,1138,29538693.0,132711411.0,14292,63994,2066.8,2073.8,78286,162250105.0,1396,2023-11-06 15:45:00
381,BANE,261,653,34039472.0,89177657.0,16509,42978,2061.9,2075.0,59487,123217130.0,914,253,637,33433330.0,90020613.0,16218,43380,2061.5,2075.2,59598,123453944.0,890,2023-11-06 15:50:00
382,BANE,82,189,4153342.0,16723036.0,2015,8061,2061.2,2074.6,10076,20876378.0,271,81,184,4123842.0,16370485.0,2001,7891,2060.9,2074.6,9892,20494327.0,265,2023-11-06 15:55:00
383,BANE,160,394,35023798.0,56517567.0,16953,27243,2065.9,2074.6,44196,91541365.0,554,149,380,34506941.0,56113646.0,16704,27027,2065.8,2076.2,43731,90620587.0,529,2023-11-06 16:00:00
384,BANE,1246,379,272624436.0,57530241.0,131565,27559,2072.2,2087.5,159124,330154677.0,1625,1141,292,261716485.0,50136501.0,126403,24006,2070.5,2088.5,150409,311852986.0,1433,2023-11-06 16:05:00
385,BANE,373,610,33091842.0,47854411.0,15999,22994,2068.4,2081.2,38993,80946253.0,983,353,559,34952249.0,48139535.0,16906,23096,2067.4,2084.3,40002,83091785.0,912,2023-11-06 16:10:00
386,BANE,193,460,7003342.0,87357725.0,3371,41946,2077.5,2082.6,45317,94361067.0,653,168,447,6879016.0,87125769.0,3319,41834,2072.6,2082.7,45153,94004785.0,615,2023-11-06 16:15:00
387,BANE,158,580,7767225.0,109700989.0,3746,52666,2073.5,2083.0,56412,117468214.0,738,159,569,9559668.0,109806451.0,4617,52712,2070.5,2083.1,57329,119366120.0,728,2023-11-06 16:20:00
388,BANE,345,960,20373516.0,140818954.0,9845,67796,2069.4,2077.1,77641,161192470.0,1305,337,950,23600544.0,140442659.0,11405,67571,2069.3,2078.4,78976,164043203.0,1287,2023-11-06 16:25:00
389,BANE,110,540,3446696.0,91589787.0,1663,44068,2072.6,2078.4,45731,95036483.0,650,107,538,3631831.0,91788171.0,1758,44164,2065.9,2078.3,45922,95420003.0,645,2023-11-06 16:30:00
390,BANE,79,284,3864714.0,49994390.0,1876,24072,2060.1,2076.9,25948,53859104.0,363,71,264,3787560.0,47675180.0,1837,22948,2061.8,2077.5,24785,51462740.0,335,2023-11-06 16:35:00
391,BANE,229,118,5958478.0,19858182.0,2873,9544,2074.0,2080.7,12417,25816660.0,347,210,119,4929426.0,20405994.0,2380,9820,2071.2,2078.0,12200,25335420.0,329,2023-11-06 16:40:00
392,BANE,143,289,6622776.0,39475607.0,3199,18998,2070.3,2077.9,22197,46098383.0,432,126,285,6118727.0,39482987.0,2955,19000,2070.6,2078.1,21955,45601714.0,411,2023-11-06 16:45:00
393,BANE,146,311,6707124.0,69643673.0,3237,33513,2072.0,2078.1,36750,76350797.0,457,137,302,6738453.0,70397534.0,3254,33866,2070.8,2078.7,37120,77135987.0,439,2023-11-06 16:50:00
394,BANE,164,952,6677583.0,157735072.0,3224,75935,2071.2,2077.2,79159,164412656.0,1116,155,946,6519130.0,158759232.0,3152,76401,2068.3,2078.0,79553,165278362.0,1101,2023-11-06 16:55:00
395,BANE,80,404,5557312.0,85428642.0,2681,41104,2072.9,2078.4,43785,90985954.0,484,74,396,5402891.0,85393839.0,2611,41072,2069.3,2079.1,43683,90796730.0,470,2023-11-06 17:00:00
396,BANE,140,511,8398112.0,77798240.0,4059,37418,2069.0,2079.2,41477,86196352.0,651,128,502,8146548.0,77081276.0,3944,37073,2065.6,2079.2,41017,85227825.0,630,2023-11-06 17:05:00
397,BANE,68,156,3312520.0,28075417.0,1604,13502,2065.2,2079.4,15106,31387938.0,224,62,152,3026275.0,28641196.0,1465,13773,2065.7,2079.5,15238,31667472.0,214,2023-11-06 17:10:00
398,BANE,173,473,10791133.0,83250636.0,5212,40030,2070.4,2079.7,45242,94041769.0,646,177,470,10847288.0,83017617.0,5242,39917,2069.3,2079.8,45159,93864905.0,647,2023-11-06 17:15:00
399,BANE,120,455,3455719.0,58205067.0,1670,27977,2069.3,2080.5,29647,61660786.0,575,107,452,3309699.0,58247302.0,1598,27991,2071.2,2080.9,29589,61557001.0,559,2023-11-06 17:20:00
400,BANE,109,375,3323919.0,79385180.0,1599,38191,2078.7,2078.6,39790,82709099.0,484,104,368,3252343.0,79048185.0,1570,38029,2071.6,2078.6,39599,82300528.0,472,2023-11-06 17:25:00
401,BANE,137,349,7135591.0,68625031.0,3440,33016,2074.3,2078.5,36456,75760622.0,486,131,346,7265424.0,69225672.0,3510,33303,2069.9,2078.7,36813,76491096.0,477,2023-11-06 17:30:00
402,BANE,189,1167,11921545.0,143554300.0,5759,69163,2070.1,2075.6,74922,155475846.0,1356,182,1138,11891503.0,141213238.0,5745,67977,2069.9,2077.4,73722,153104742.0,1320,2023-11-06 17:35:00
403,BANE,128,611,6032036.0,67528101.0,2914,32516,2070.0,2076.8,35430,73560137.0,739,126,612,6020195.0,67946375.0,2911,32717,2068.1,2076.8,35628,73966571.0,738,2023-11-06 17:40:00
404,BANE,427,332,40475463.0,37835107.0,19456,18201,2080.4,2078.7,37657,78310570.0,759,357,307,38620614.0,37416021.0,18650,17991,2070.8,2079.7,36641,76036635.0,664,2023-11-06 17:45:00
405,BANE,973,66,154994422.0,9338891.0,74898,4484,2069.4,2082.7,79382,164333313.0,1039,875,55,155692188.0,9784474.0,75241,4698,2069.2,2082.7,79939,165476663.0,930,2023-11-06 17:50:00
406,BANE,390,116,49162571.0,18989115.0,23711,9115,2073.4,2083.3,32826,68151686.0,506,364,107,47755901.0,18702463.0,23030,8977,2073.6,2083.4,32007,66458364.0,471,2023-11-06 17:55:00
407,BANE,235,74,30973246.0,9271323.0,14922,4455,2075.7,2081.1,19377,40244569.0,309,229,61,30407733.0,10591211.0,14648,5082,2075.9,2084.1,19730,40998944.0,290,2023-11-06 18:00:00
408,BANE,557,144,64423591.0,28006559.0,30868,13624,2087.1,2055.7,44492,92430150.0,701,487,91,55827228.0,24356903.0,26819,11644,2081.6,2091.8,38463,80184132.0,578,2023-11-06 18:05:00
409,BANE,584,367,70761989.0,37758961.0,33988,18140,2082.0,2081.5,52128,108520950.0,951,568,334,70080849.0,36702020.0,33700,17578,2079.6,2088.0,51278,106782869.0,902,2023-11-06 18:10:00
410,BANE,505,104,59382564.0,12333744.0,28473,5900,2085.6,2090.5,34373,71716309.0,609,471,78,56962953.0,11558812.0,27371,5530,2081.1,2090.2,32901,68521765.0,549,2023-11-06 18:15:00
411,BANE,344,45,61159244.0,6186811.0,29466,2968,2075.6,2084.5,32434,67346055.0,389,311,30,60504358.0,6042983.0,29173,2886,2074.0,2093.9,32059,66547341.0,341,2023-11-06 18:20:00
412,BANE,137,63,12014947.0,6213282.0,5761,3074,2085.6,2021.2,8835,18228229.0,200,116,33,11697252.0,5267120.0,5619,2519,2081.7,2091.0,8138,16964372.0,149,2023-11-06 18:25:00
413,BANE,149,122,13126255.0,7070656.0,6287,3392,2087.8,2084.5,9679,20196911.0,271,127,104,12333333.0,6766631.0,5921,3232,2083.0,2093.6,9153,19099964.0,231,2023-11-06 18:30:00
414,BANE,232,83,29826758.0,10367593.0,14287,4948,2087.7,2095.3,19235,40194351.0,315,224,71,29250679.0,9504966.0,14035,4542,2084.1,2092.7,18577,38755646.0,295,2023-11-06 18:35:00
415,BANE,245,232,27883278.0,25178321.0,13309,12017,2095.1,2095.2,25326,53061599.0,477,239,207,28499398.0,25201126.0,13671,12020,2084.7,2096.6,25691,53700525.0,446,2023-11-06 18:40:00
416,BANE,2490,2774,556072253.0,481764993.0,264398,228185,2103.2,2111.3,492583,1037837246.0,5264,2234,2534,535970497.0,462799610.0,256377,219170,2090.6,2111.6,475547,998770107.0,4768,2023-11-07 10:05:00
417,BANE,1044,1309,210013076.0,223509321.0,99432,106715,2112.1,2094.5,206147,433522397.0,2353,987,1245,202821676.0,219861490.0,96259,104761,2107.0,2098.7,201020,422683166.0,2232,2023-11-07 10:10:00
418,BANE,2114,2376,474496270.0,477103017.0,227451,226978,2086.1,2102.0,454429,951599287.0,4490,2051,2287,471928900.0,473426646.0,225718,225142,2090.8,2102.8,450860,945355546.0,4338,2023-11-07 10:15:00
419,BANE,1493,1695,326743799.0,243532408.0,155777,115467,2097.5,2109.1,271244,570276207.0,3188,1386,1414,319186845.0,235046190.0,152421,111291,2094.1,2112.0,263712,554233036.0,2800,2023-11-07 10:20:00
420,BANE,332,576,34267133.0,78426591.0,16285,37069,2104.2,2115.7,53354,112693725.0,908,289,491,31320274.0,76002807.0,14906,35873,2101.2,2118.7,50779,107323081.0,780,2023-11-07 10:25:00
421,BANE,1388,1330,277481594.0,237576068.0,131243,112234,2114.3,2116.8,243477,515057663.0,2718,1249,1092,260998048.0,224978899.0,124135,105817,2102.5,2126.1,229952,485976947.0,2341,2023-11-07 10:30:00
422,BANE,694,1142,110021087.0,161901133.0,52339,76366,2102.1,2120.1,128705,271922220.0,1836,640,1003,104711360.0,159511697.0,49805,75169,2102.4,2122.0,124974,264223057.0,1643,2023-11-07 10:35:00
423,BANE,784,907,107620494.0,202699290.0,50990,95642,2110.6,2119.4,146632,310319785.0,1691,748,861,107401266.0,201899720.0,51023,95199,2105.0,2120.8,146222,309300986.0,1609,2023-11-07 10:40:00
424,BANE,548,1541,73775171.0,250088128.0,35038,118161,2105.6,2116.5,153199,323863299.0,2089,518,1513,73284335.0,248472927.0,34813,117367,2105.1,2117.1,152180,321757262.0,2031,2023-11-07 10:45:00
425,BANE,579,1047,49642113.0,126839659.0,23576,59796,2105.6,2121.2,83372,176481773.0,1626,547,1002,48134669.0,125955827.0,22876,59370,2104.2,2121.5,82246,174090497.0,1549,2023-11-07 10:50:00
426,BANE,714,924,88969499.0,149820820.0,42359,70880,2100.4,2113.7,113239,238790319.0,1638,660,868,88033640.0,144478883.0,41918,68276,2100.1,2116.1,110194,232512523.0,1528,2023-11-07 10:55:00
427,BANE,288,296,48109819.0,34283232.0,23076,16452,2084.8,2083.8,39528,82393051.0,584,238,266,46387416.0,32229663.0,22287,15285,2081.4,2108.6,37572,78617079.0,504,2023-11-07 11:00:00
428,BANE,593,276,68887916.0,29381616.0,33044,14010,2084.7,2097.2,47054,98269532.0,869,565,266,68263226.0,28650140.0,32745,13638,2084.7,2100.8,46383,96913366.0,831,2023-11-07 11:05:00
429,BANE,271,164,30877131.0,18798117.0,14803,8936,2085.9,2103.6,23739,49675248.0,435,251,134,30447839.0,15502464.0,14607,7376,2084.5,2101.7,21983,45950303.0,385,2023-11-07 11:10:00
430,BANE,181,210,22905353.0,25135163.0,10986,11950,2085.0,2103.4,22936,48040516.0,391,175,206,22692653.0,25068835.0,10885,11916,2084.8,2103.8,22801,47761489.0,381,2023-11-07 11:15:00
431,BANE,812,818,154628604.0,162496939.0,74278,77298,2081.8,2102.2,151576,317125543.0,1630,766,803,151101074.0,161475710.0,72614,76692,2080.9,2105.5,149306,312576784.0,1569,2023-11-07 11:20:00
432,BANE,1046,651,112383132.0,73603402.0,53876,35024,2086.0,2101.5,88900,185986534.0,1697,1038,625,115908542.0,73718489.0,55604,35046,2084.5,2103.5,90650,189627032.0,1663,2023-11-07 11:25:00
433,BANE,758,610,84402712.0,123172066.0,40411,58893,2088.6,2091.5,99304,207574778.0,1368,733,601,83303543.0,122764042.0,40051,58531,2079.9,2097.4,98582,206067585.0,1334,2023-11-07 11:30:00
434,BANE,666,1206,72910680.0,205316436.0,35061,97795,2079.5,2099.5,132856,278227117.0,1872,654,1196,72291036.0,204443879.0,34787,97378,2078.1,2099.5,132165,276734915.0,1850,2023-11-07 11:35:00
435,BANE,236,534,34272655.0,78294629.0,16527,37400,2073.7,2093.4,53927,112567284.0,770,214,515,33595355.0,77615458.0,16213,37059,2072.1,2094.4,53272,111210813.0,729,2023-11-07 11:40:00
436,BANE,840,515,129492160.0,56497242.0,62101,26977,2085.2,2094.3,89078,185989402.0,1355,808,505,127607082.0,56618863.0,61318,27035,2081.1,2094.3,88353,184225945.0,1313,2023-11-07 11:45:00
437,BANE,477,296,56925011.0,29707908.0,27231,14117,2090.4,2104.4,41348,86632919.0,773,468,261,57078650.0,29167877.0,27208,13848,2097.9,2106.3,41056,86246527.0,729,2023-11-07 11:50:00
438,BANE,329,261,45876404.0,29966681.0,22009,14269,2084.4,2100.1,36278,75843085.0,590,316,247,46810977.0,29674416.0,22473,14113,2083.0,2102.6,36586,76485394.0,563,2023-11-07 11:55:00
439,BANE,1359,760,324719495.0,170009933.0,155033,80545,2094.5,2110.7,235578,494729429.0,2119,1327,700,315420290.0,165270292.0,151096,78298,2087.5,2110.8,229394,480690582.0,2027,2023-11-07 12:00:00
440,BANE,1398,983,364252351.0,159010529.0,174221,75438,2090.7,2107.8,249659,523262880.0,2381,1368,946,363336076.0,158962310.0,173987,75349,2088.3,2109.7,249336,522298386.0,2314,2023-11-07 12:05:00
441,BANE,1235,1614,230352506.0,216080147.0,110148,102443,2091.3,2109.3,212591,446432653.0,2849,1215,1565,229794144.0,213213319.0,109896,101078,2091.0,2109.4,210974,443007463.0,2780,2023-11-07 12:10:00
442,BANE,1122,793,164101029.0,119395599.0,78194,56564,2098.6,2110.8,134758,283496629.0,1915,1096,766,161293857.0,117727004.0,77024,55775,2094.1,2110.7,132799,279020861.0,1862,2023-11-07 12:15:00
443,BANE,278,712,51591176.0,34133778.0,24721,16159,2086.9,2112.4,40880,85724954.0,990,262,661,50109637.0,33888411.0,24014,16033,2086.7,2113.7,40047,83998049.0,923,2023-11-07 12:20:00
444,BANE,432,291,90692504.0,53443104.0,43358,25208,2091.7,2120.1,68566,144135608.0,723,439,253,90209939.0,52819435.0,43154,24915,2090.4,2120.0,68069,143029374.0,692,2023-11-07 12:25:00
445,BANE,253,245,63899815.0,24347778.0,30651,11519,2084.8,2113.7,42170,88247594.0,498,223,174,62638175.0,23618390.0,30044,11130,2084.9,2122.0,41174,86256565.0,397,2023-11-07 12:30:00
446,BANE,435,204,72187517.0,22726936.0,34540,10857,2090.0,2093.3,45397,94914454.0,639,427,188,71280591.0,22126364.0,34107,10470,2089.9,2113.3,44577,93406956.0,615,2023-11-07 12:35:00
447,BANE,49,51,6028171.0,4779158.0,2868,2250,2101.9,2124.1,5118,10807330.0,100,41,44,5630064.0,4597928.0,2689,2164,2093.7,2124.7,4853,10227992.0,85,2023-11-07 12:40:00
448,BANE,19,24,1636076.0,908425.0,781,431,2094.8,2107.7,1212,2544502.0,43,15,20,1730877.0,681165.0,828,323,2090.4,2108.9,1151,2412043.0,35,2023-11-07 12:45:00
449,BANE,472,296,81957573.0,26223916.0,39172,12437,2092.2,2108.5,51609,108181489.0,768,472,289,82619930.0,26360298.0,39501,12491,2091.6,2110.3,51992,108980228.0,761,2023-11-07 12:50:00
450,BANE,485,201,83533887.0,24548198.0,39908,11646,2093.2,2107.9,51554,108082085.0,686,473,184,83092206.0,23236441.0,39727,10999,2091.6,2112.6,50726,106328648.0,657,2023-11-07 12:55:00
451,BANE,832,285,161150524.0,29763332.0,76986,14171,2093.2,2100.3,91157,190913856.0,1117,826,276,160886473.0,29861871.0,76859,14192,2093.3,2104.1,91051,190748344.0,1102,2023-11-07 13:00:00
452,BANE,540,922,72382403.0,122918909.0,34611,58547,2091.3,2099.5,93158,195301312.0,1462,529,900,71674846.0,120926778.0,34281,57481,2090.8,2103.8,91762,192601625.0,1429,2023-11-07 13:05:00
453,BANE,564,646,73482235.0,97828512.0,35048,46516,2096.6,2103.1,81564,171310747.0,1210,562,637,72923233.0,97851503.0,34884,46516,2090.4,2103.6,81400,170774736.0,1199,2023-11-07 13:10:00
454,BANE,685,419,76540942.0,59892577.0,36575,28483,2092.7,2102.7,65058,136433519.0,1104,679,407,76630818.0,59102242.0,36617,28103,2092.8,2103.1,64720,135733060.0,1086,2023-11-07 13:15:00
455,BANE,1260,905,235872862.0,221450882.0,112844,105284,2090.3,2103.4,218128,457323744.0,2165,1252,897,235426748.0,221191822.0,112632,105159,2090.2,2103.4,217791,456618570.0,2149,2023-11-07 13:20:00
456,BANE,1511,435,274390704.0,112645954.0,131319,53579,2089.5,2102.4,184898,387036659.0,1946,1506,430,274151033.0,112219973.0,131212,53381,2089.4,2102.2,184593,386371007.0,1936,2023-11-07 13:25:00
457,BANE,1457,445,268607541.0,115089220.0,128454,54761,2091.1,2101.7,183215,383696761.0,1902,1458,448,268781235.0,115119026.0,128539,54775,2091.0,2101.7,183314,383900262.0,1906,2023-11-07 13:30:00
458,BANE,1413,521,293977989.0,114019315.0,140748,54245,2088.7,2101.9,194993,407997304.0,1934,1407,513,293873997.0,114035177.0,140699,54245,2088.7,2102.2,194944,407909174.0,1920,2023-11-07 13:35:00
459,BANE,222,92,43905897.0,21645128.0,21023,10304,2088.5,2100.7,31327,65551025.0,314,213,88,43849079.0,21503492.0,20995,10233,2088.5,2101.4,31228,65352571.0,301,2023-11-07 13:40:00
460,BANE,602,208,114233831.0,40281211.0,54586,19096,2092.7,2109.4,73682,154515043.0,810,594,196,113389650.0,39986741.0,54195,18958,2092.3,2109.2,73153,153376391.0,790,2023-11-07 13:45:00
461,BANE,648,160,127256239.0,28376428.0,60694,13465,2096.7,2107.4,74159,155632667.0,808,634,155,126280172.0,28312440.0,60274,13432,2095.1,2107.8,73706,154592612.0,789,2023-11-07 13:50:00
462,BANE,833,201,141840271.0,38220399.0,67647,18146,2096.8,2106.3,85793,180060671.0,1034,829,191,141675513.0,37262340.0,67614,17691,2095.4,2106.3,85305,178937853.0,1020,2023-11-07 13:55:00
463,BANE,330,121,64510773.0,18336945.0,30774,8729,2096.3,2100.7,39503,82847719.0,451,325,116,64228702.0,18965272.0,30643,8983,2096.0,2111.2,39626,83193974.0,441,2023-11-07 14:00:00
464,BANE,1084,741,174361218.0,55272546.0,82762,26059,2106.8,2121.1,108821,229633765.0,1825,1050,696,170818964.0,54027127.0,81340,25463,2100.1,2121.8,106803,224846092.0,1746,2023-11-07 14:05:00
465,BANE,1432,2153,341571779.0,520825820.0,162667,246491,2099.8,2113.0,409158,862397599.0,3585,1418,2130,340844996.0,519000295.0,162325,245622,2099.8,2113.0,407947,859845292.0,3548,2023-11-07 14:10:00
466,BANE,890,777,188587858.0,96914779.0,89794,45913,2100.2,2110.8,135707,285502637.0,1667,886,765,189198571.0,96509497.0,90091,45720,2100.1,2110.9,135811,285708069.0,1651,2023-11-07 14:15:00
467,BANE,86,44,26735694.0,4706516.0,12783,2221,2091.5,2119.1,15004,31442210.0,130,78,37,26524139.0,4581084.0,12695,2160,2089.3,2120.9,14855,31105223.0,115,2023-11-07 14:20:00
468,BANE,326,119,28741829.0,11544638.0,13673,5468,2102.1,2111.3,19141,40286467.0,445,291,111,27671937.0,11347384.0,13173,5375,2100.7,2111.1,18548,39019321.0,402,2023-11-07 14:25:00
469,BANE,118,68,16576335.0,4917400.0,7881,2354,2103.3,2089.0,10235,21493735.0,186,98,55,16400258.0,4559763.0,7811,2157,2099.6,2113.9,9968,20960021.0,153,2023-11-07 14:30:00
470,BANE,81,60,9082788.0,6449916.0,4309,3062,2107.9,2106.4,7371,15532705.0,141,60,53,8853042.0,6082892.0,4210,2879,2102.9,2112.8,7089,14935934.0,113,2023-11-07 14:35:00
471,BANE,282,217,53002446.0,27076972.0,25275,12806,2097.0,2114.4,38081,80079418.0,499,271,194,53152660.0,26409680.0,25344,12488,2097.2,2114.8,37832,79562340.0,465,2023-11-07 14:40:00
472,BANE,562,463,87918037.0,96714439.0,41881,45703,2099.2,2116.2,87584,184632477.0,1025,543,439,86496613.0,94383868.0,41246,44594,2097.1,2116.5,85840,180880481.0,982,2023-11-07 14:45:00
473,BANE,242,345,31958343.0,50205766.0,15209,23720,2101.3,2116.6,38929,82164110.0,587,228,340,31656268.0,50702851.0,15081,23955,2099.1,2116.6,39036,82359119.0,568,2023-11-07 14:50:00
474,BANE,97,66,13895038.0,11369896.0,6646,5370,2090.7,2117.3,12016,25264934.0,163,85,58,13646857.0,10926564.0,6528,5155,2090.5,2119.6,11683,24573421.0,143,2023-11-07 14:55:00
475,BANE,361,540,72227822.0,74981462.0,34171,35374,2113.7,2119.7,69545,147209284.0,901,338,523,68880333.0,73304778.0,32830,34586,2098.1,2119.5,67416,142185111.0,861,2023-11-07 15:00:00
476,BANE,479,1235,75062704.0,519559628.0,35891,244525,2091.4,2124.8,280416,594622332.0,1714,463,1207,74717148.0,513783218.0,35726,241780,2091.4,2125.0,277506,588500366.0,1670,2023-11-07 15:05:00
477,BANE,117,159,18147322.0,24764948.0,8672,11814,2092.6,2096.2,20486,42912271.0,276,106,145,17792387.0,24376550.0,8506,11574,2091.7,2106.1,20080,42168937.0,251,2023-11-07 15:10:00
478,BANE,617,891,122578232.0,139295245.0,58759,66322,2086.1,2100.3,125081,261873477.0,1508,586,855,121472710.0,136935973.0,58236,65152,2085.9,2101.8,123388,258408683.0,1441,2023-11-07 15:15:00
479,BANE,851,1543,126185762.0,269507568.0,60390,128366,2089.5,2099.5,188756,395693330.0,2394,819,1526,125527188.0,268969245.0,60085,128107,2089.2,2099.6,188192,394496433.0,2345,2023-11-07 15:20:00
480,BANE,145,318,20072578.0,53381737.0,9597,25416,2091.5,2100.3,35013,73454315.0,463,138,313,19829364.0,53011957.0,9485,25241,2090.6,2100.2,34726,72841321.0,451,2023-11-07 15:25:00
481,BANE,258,396,29176971.0,79186929.0,13957,37694,2090.5,2100.8,51651,108363900.0,654,244,388,29131387.0,79055763.0,13950,37632,2088.3,2100.8,51582,108187150.0,632,2023-11-07 15:30:00
482,BANE,271,299,34072117.0,70374291.0,16296,33518,2090.8,2099.6,49814,104446408.0,570,258,293,32973467.0,70405377.0,15772,33532,2090.6,2099.6,49304,103378845.0,551,2023-11-07 15:35:00
483,BANE,601,471,62947384.0,91751489.0,30071,43675,2093.3,2100.8,73746,154698873.0,1072,598,467,63094805.0,91651815.0,30160,43627,2092.0,2100.8,73787,154746621.0,1065,2023-11-07 15:40:00
484,BANE,765,586,115250387.0,101812653.0,55118,48463,2091.0,2100.8,103581,217063040.0,1351,761,578,114369552.0,101992434.0,54700,48546,2090.9,2100.9,103246,216361986.0,1339,2023-11-07 15:45:00
485,BANE,1285,1164,238960299.0,133759022.0,114278,63631,2091.0,2102.1,177909,372719321.0,2449,1277,1159,238677067.0,133449742.0,114153,63484,2090.9,2102.1,177637,372126810.0,2436,2023-11-07 15:50:00
486,BANE,911,472,138456969.0,72246002.0,66126,34366,2093.8,2102.3,100492,210702971.0,1383,903,465,138421226.0,72166380.0,66115,34326,2093.6,2102.4,100441,210587606.0,1368,2023-11-07 15:55:00
487,BANE,549,399,87286775.0,56075190.0,41716,26701,2092.4,2100.1,68417,143361966.0,948,541,390,86848491.0,55640224.0,41504,26470,2092.5,2102.0,67974,142488716.0,931,2023-11-07 16:00:00
488,BANE,719,867,107924818.0,140519950.0,51595,66803,2091.8,2103.5,118398,248444769.0,1586,708,867,106585245.0,141095899.0,50955,67068,2091.8,2103.8,118023,247681144.0,1575,2023-11-07 16:05:00
489,BANE,163,364,21317704.0,50257400.0,10178,23901,2094.5,2102.7,34079,71575104.0,527,165,362,21238563.0,50648145.0,10140,24075,2094.5,2103.8,34215,71886709.0,527,2023-11-07 16:10:00
490,BANE,135,291,16434275.0,38946810.0,7867,18520,2089.0,2103.0,26387,55381085.0,426,137,293,16530392.0,38920243.0,7914,18503,2088.8,2103.5,26417,55450635.0,430,2023-11-07 16:15:00
491,BANE,572,1003,79836736.0,162590483.0,38117,77298,2094.5,2103.4,115415,242427220.0,1575,567,1000,81390474.0,163756103.0,38919,77842,2091.3,2103.7,116761,245146577.0,1567,2023-11-07 16:20:00
492,BANE,179,392,22233368.0,54168810.0,10613,25749,2094.9,2103.7,36362,76402178.0,571,171,389,20210958.0,52078301.0,9645,24766,2095.5,2102.8,34411,72289260.0,560,2023-11-07 16:25:00
493,BANE,118,169,10713754.0,18071631.0,5112,8588,2095.8,2104.3,13700,28785386.0,287,116,166,10761179.0,18107921.0,5135,8605,2095.7,2104.3,13740,28869100.0,282,2023-11-07 16:30:00
494,BANE,278,191,10291667.0,26321191.0,4904,12456,2098.6,2113.1,17360,36612858.0,469,269,189,9663458.0,26537026.0,4610,12595,2096.2,2106.9,17205,36200484.0,458,2023-11-07 16:35:00
495,BANE,85,478,11207272.0,70049874.0,5344,33216,2097.2,2108.9,38560,81257146.0,563,84,476,11221353.0,69728698.0,5351,33064,2097.1,2108.9,38415,80950051.0,560,2023-11-07 16:40:00
496,BANE,292,651,47274156.0,108033709.0,22585,51306,2093.2,2105.7,73891,155307865.0,943,283,645,47297828.0,108122508.0,22563,51337,2096.3,2106.1,73900,155420336.0,928,2023-11-07 16:45:00
497,BANE,335,572,62164059.0,97413858.0,29644,46257,2097.0,2105.9,75901,159577917.0,907,336,570,62003336.0,97386606.0,29567,46243,2097.0,2106.0,75810,159389943.0,906,2023-11-07 16:50:00
498,BANE,732,799,151738273.0,164452193.0,72374,78100,2096.6,2105.7,150474,316190467.0,1531,731,793,152715419.0,164272527.0,72841,77998,2096.6,2106.1,150839,316987946.0,1524,2023-11-07 16:55:00
499,BANE,529,1054,129274194.0,130516150.0,61642,61983,2097.2,2105.7,123625,259790345.0,1583,521,1051,129009532.0,130413179.0,61519,61934,2097.1,2105.7,123453,259422712.0,1572,2023-11-07 17:00:00
500,BANE,284,956,69168728.0,104491329.0,32980,49618,2097.3,2105.9,82598,173660057.0,1240,283,950,69247868.0,104114889.0,33019,49442,2097.2,2105.8,82461,173362757.0,1233,2023-11-07 17:05:00
501,BANE,605,725,123263039.0,126536165.0,58724,60076,2099.0,2106.3,118800,249799204.0,1330,588,703,122233120.0,124575438.0,58235,59120,2099.0,2107.2,117355,246808558.0,1291,2023-11-07 17:10:00
502,BANE,570,1208,61534178.0,146305273.0,29329,69087,2098.1,2117.7,98416,207839451.0,1778,566,1203,61582338.0,146255795.0,29352,69145,2098.1,2115.2,98497,207838133.0,1769,2023-11-07 17:15:00
503,BANE,713,1596,110380720.0,225982106.0,52607,106536,2098.2,2121.2,159143,336362826.0,2309,713,1592,110381583.0,225830080.0,52608,106460,2098.2,2121.3,159068,336211664.0,2305,2023-11-07 17:20:00
504,BANE,484,1040,78141940.0,154838748.0,35799,73265,2182.8,2113.4,109064,232980689.0,1524,476,1030,74735684.0,154540968.0,35611,73116,2098.7,2113.6,108727,229276653.0,1506,2023-11-07 17:25:00
505,BANE,73,102,8164576.0,10648160.0,3891,5059,2098.3,2104.8,8950,18812736.0,175,68,104,8099736.0,10756698.0,3860,5108,2098.4,2105.9,8968,18856434.0,172,2023-11-07 17:30:00
506,BANE,121,283,12104562.0,28013706.0,5762,13048,2100.8,2147.0,18810,40118268.0,404,97,254,11964759.0,27757618.0,5702,12927,2098.3,2147.3,18629,39722377.0,351,2023-11-07 17:35:00
507,BANE,71,87,4052167.0,10309514.0,1946,4765,2082.3,2163.6,6711,14361681.0,158,66,81,3011878.0,10523982.0,1436,4864,2097.4,2163.6,6300,13535860.0,147,2023-11-07 17:40:00
508,BANE,180,369,29456329.0,60614547.0,14041,28751,2097.9,2108.3,42792,90070876.0,549,177,367,29404798.0,60413188.0,14058,28648,2091.7,2108.8,42706,89817986.0,544,2023-11-07 17:45:00
509,BANE,214,344,35044073.0,51948012.0,16733,24656,2094.3,2106.9,41389,86992085.0,558,213,332,36052073.0,51117662.0,17205,24255,2095.4,2107.5,41460,87169735.0,545,2023-11-07 17:50:00
510,BANE,224,262,37758195.0,53230809.0,18028,24880,2094.4,2139.5,42908,90989005.0,486,217,251,36337372.0,52031478.0,17355,24309,2093.8,2140.4,41664,88368850.0,468,2023-11-07 17:55:00
511,BANE,70,72,7867662.0,11458682.0,3751,5439,2097.5,2106.8,9190,19326344.0,142,65,72,7839455.0,11346557.0,3738,5385,2097.2,2107.1,9123,19186012.0,137,2023-11-07 18:00:00
512,BANE,60,68,8395120.0,12101581.0,4004,5623,2096.7,2152.2,9627,20496701.0,128,61,60,8554578.0,12042348.0,4080,5594,2096.7,2152.7,9674,20596926.0,121,2023-11-07 18:05:00
513,BANE,498,732,98121442.0,88113171.0,46913,40480,2091.6,2176.7,87393,186234613.0,1230,493,710,98325748.0,86841942.0,47010,39874,2091.6,2177.9,86884,185167691.0,1203,2023-11-07 18:10:00
514,BANE,101,160,12317633.0,9201537.0,5877,4397,2095.9,2092.7,10274,21519171.0,261,98,155,12309030.0,8974624.0,5873,4263,2095.9,2105.2,10136,21283655.0,253,2023-11-07 18:15:00
515,BANE,68,177,12605097.0,21604035.0,6022,10191,2093.2,2119.9,16213,34209133.0,245,70,176,12619856.0,22352783.0,6028,10364,2093.5,2156.8,16392,34972640.0,246,2023-11-07 18:20:00
516,BANE,201,422,32120136.0,63382901.0,15345,29354,2093.2,2159.3,44699,95503037.0,623,199,419,31937738.0,63203314.0,15260,29386,2092.9,2150.8,44646,95141052.0,618,2023-11-07 18:25:00
517,BANE,2218,1516,570769736.0,142641298.0,272885,67441,2091.6,2115.1,340326,713411034.0,3734,2204,1504,571240746.0,142403555.0,273155,67315,2091.3,2115.5,340470,713644302.0,3708,2023-11-07 18:30:00
518,BANE,2732,1515,765230091.0,100541348.0,366006,47392,2090.8,2121.5,413398,865771439.0,4247,2723,1508,763978229.0,100806297.0,365490,47516,2090.3,2121.5,413006,864784527.0,4231,2023-11-07 18:35:00
519,BANE,1759,1604,466950448.0,178008610.0,223388,84818,2090.3,2098.7,308206,644959058.0,3363,1753,1586,467884239.0,178177245.0,223853,84616,2090.1,2105.7,308469,646061484.0,3339,2023-11-07 18:40:00
520,BANE,1433,1169,223677204.0,213268542.0,106579,100694,2098.7,2118.0,207273,436945746.0,2602,1277,1037,216147748.0,199868419.0,103790,94718,2082.5,2110.1,198508,416016168.0,2314,2023-11-08 10:05:00
521,BANE,557,481,44536250.0,88602419.0,21366,42078,2084.4,2105.7,63444,133138669.0,1038,507,439,43135866.0,87400347.0,20698,41489,2084.1,2106.6,62187,130536213.0,946,2023-11-08 10:10:00
522,BANE,677,548,64888278.0,97253751.0,31115,46167,2085.4,2106.6,77282,162142030.0,1225,618,514,62597468.0,95280920.0,30114,45208,2078.7,2107.6,75322,157878388.0,1132,2023-11-08 10:15:00
523,BANE,221,277,15427283.0,17121235.0,7407,8183,2082.8,2092.3,15590,32548518.0,498,202,262,15200252.0,17083112.0,7299,8132,2082.5,2100.7,15431,32283364.0,464,2023-11-08 10:20:00
524,BANE,148,280,14573032.0,60356308.0,6993,28694,2083.9,2103.4,35687,74929341.0,428,124,265,13725702.0,59759545.0,6584,28374,2084.7,2106.1,34958,73485248.0,389,2023-11-08 10:25:00
525,BANE,178,189,13752621.0,31722863.0,6597,15147,2084.7,2094.3,21744,45475484.0,367,160,179,13804088.0,31374433.0,6627,14938,2083.0,2100.3,21565,45178521.0,339,2023-11-08 10:30:00
526,BANE,537,569,71093847.0,74634968.0,34151,35710,2081.8,2090.0,69861,145728815.0,1106,497,542,69123589.0,72485065.0,33200,34624,2082.0,2093.5,67824,141608655.0,1039,2023-11-08 10:35:00
527,BANE,550,383,130351040.0,111723109.0,62593,53423,2082.5,2091.3,116016,242074149.0,933,534,378,129830677.0,112877831.0,62348,53973,2082.4,2091.4,116321,242708509.0,912,2023-11-08 10:40:00
528,BANE,448,337,107282625.0,124969827.0,51262,59695,2092.8,2093.5,110957,232252452.0,785,435,333,105843904.0,124502587.0,50784,59468,2084.2,2093.6,110252,230346491.0,768,2023-11-08 10:45:00
529,BANE,1338,886,272945873.0,188285914.0,130695,89709,2088.4,2098.9,220404,461231787.0,2224,1319,860,272709943.0,187828400.0,130399,89486,2091.3,2099.0,219885,460538344.0,2179,2023-11-08 10:50:00
530,BANE,392,612,82137786.0,124973377.0,39282,59544,2091.0,2098.8,98826,207111164.0,1004,384,606,82006228.0,124628276.0,39227,59380,2090.6,2098.8,98607,206634504.0,990,2023-11-08 10:55:00
531,BANE,748,655,166684329.0,138332111.0,79874,65976,2086.8,2096.7,145850,305016441.0,1403,744,645,166656449.0,137700872.0,79858,65672,2086.9,2096.8,145530,304357322.0,1389,2023-11-08 11:00:00
532,BANE,1660,1282,305261592.0,314314008.0,146314,150006,2086.3,2095.3,296320,619575601.0,2942,1654,1273,305088310.0,314431228.0,146230,150023,2086.4,2095.9,296253,619519538.0,2927,2023-11-08 11:05:00
533,BANE,1397,1733,349429934.0,398590783.0,167447,190252,2086.8,2095.1,357699,748020718.0,3130,1377,1717,348994198.0,398096024.0,167271,190011,2086.4,2095.1,357282,747090223.0,3094,2023-11-08 11:10:00
534,BANE,1220,1241,214050662.0,248259595.0,102583,118498,2086.6,2095.1,221081,462310257.0,2461,1201,1216,213461573.0,248004371.0,102303,118374,2086.6,2095.1,220677,461465944.0,2417,2023-11-08 11:15:00
535,BANE,555,516,143236017.0,142330368.0,68617,67850,2087.5,2097.7,136467,285566385.0,1071,552,503,143096538.0,140393600.0,68551,66953,2087.4,2096.9,135504,283490139.0,1055,2023-11-08 11:20:00
536,BANE,635,488,151829133.0,114431273.0,72653,54483,2089.8,2100.3,127136,266260406.0,1123,615,482,151314114.0,114225259.0,72415,54388,2089.5,2100.2,126803,265539373.0,1097,2023-11-08 11:25:00
537,BANE,2440,1365,674017944.0,342828760.0,321626,162683,2095.7,2107.3,484309,1016846704.0,3805,2398,1336,670353898.0,341423512.0,319904,162017,2095.5,2107.3,481921,1011777410.0,3734,2023-11-08 11:30:00
538,BANE,257,216,37839521.0,40980265.0,18038,19416,2097.8,2110.6,37454,78819786.0,473,245,204,37363217.0,39364942.0,17817,18657,2097.1,2109.9,36474,76728159.0,449,2023-11-08 11:35:00
539,BANE,1058,720,192609152.0,127977442.0,91837,60753,2097.3,2106.5,152590,320586594.0,1778,1049,707,191905859.0,128080196.0,91512,60795,2097.1,2106.8,152307,319986056.0,1756,2023-11-08 11:40:00
540,BANE,817,431,182970008.0,115704786.0,87249,54877,2097.1,2108.4,142126,298674794.0,1248,810,429,183257291.0,115590812.0,87381,54829,2097.2,2108.2,142210,298848103.0,1239,2023-11-08 11:45:00
541,BANE,2415,1589,506891110.0,438694598.0,241562,207991,2098.4,2109.2,449553,945585708.0,4004,2393,1574,506103377.0,437434017.0,241200,207399,2098.3,2109.1,448599,943537394.0,3967,2023-11-08 11:50:00
542,BANE,1826,1401,464238012.0,376799134.0,221054,178627,2100.1,2109.4,399681,841037146.0,3227,1829,1396,464512218.0,376488062.0,221187,178427,2100.1,2110.0,399614,841000280.0,3225,2023-11-08 11:55:00
543,BANE,2497,1941,541991393.0,453523207.0,258187,215061,2099.2,2108.8,473248,995514600.0,4438,2481,1929,541739083.0,452408153.0,258070,214538,2099.2,2108.8,472608,994147236.0,4410,2023-11-08 12:00:00
544,BANE,1906,1447,439123027.0,371385664.0,209397,176204,2097.1,2107.7,385601,810508691.0,3353,1901,1439,439562601.0,370759093.0,209607,175904,2097.1,2107.7,385511,810321694.0,3340,2023-11-08 12:05:00
545,BANE,648,703,121588030.0,119672204.0,58006,56819,2096.1,2106.2,114825,241260235.0,1351,638,696,121042064.0,119520266.0,57745,56746,2096.1,2106.2,114491,240562330.0,1334,2023-11-08 12:10:00
546,BANE,200,147,35919975.0,30802897.0,17131,14609,2096.8,2108.5,31740,66722873.0,347,197,135,36031542.0,30436165.0,17187,14437,2096.4,2108.2,31624,66467707.0,332,2023-11-08 12:15:00
547,BANE,1638,1451,343082501.0,342004644.0,163489,162233,2098.5,2108.1,325722,685087145.0,3089,1631,1440,342609092.0,341908577.0,163263,162184,2098.5,2108.2,325447,684517669.0,3071,2023-11-08 12:20:00
548,BANE,787,441,144130943.0,121282978.0,68671,57531,2098.9,2108.1,126202,265413921.0,1228,777,437,144191210.0,121172467.0,68702,57478,2098.8,2108.2,126180,265363678.0,1214,2023-11-08 12:25:00
549,BANE,983,1015,216134512.0,212699764.0,103165,100961,2095.0,2106.8,204126,428834276.0,1998,972,1002,215751310.0,210859909.0,102973,100072,2095.2,2107.1,203045,426611219.0,1974,2023-11-08 12:30:00
550,BANE,1072,979,224147024.0,204588255.0,107007,97232,2094.7,2104.1,204239,428735280.0,2051,1067,972,224183668.0,204547424.0,107025,97212,2094.7,2104.1,204237,428731092.0,2039,2023-11-08 12:35:00
551,BANE,475,198,78285916.0,50962130.0,37367,24232,2095.1,2103.1,61599,129248046.0,673,468,191,78139909.0,50941006.0,37299,24222,2095.0,2103.1,61521,129080915.0,659,2023-11-08 12:40:00
552,BANE,1844,1034,391240166.0,301310579.0,186733,143218,2095.2,2103.9,329951,692550745.0,2878,1846,1033,391453998.0,301156544.0,186835,143144,2095.2,2103.9,329979,692610542.0,2879,2023-11-08 12:45:00
553,BANE,127,111,22028428.0,22698134.0,10511,10774,2095.7,2106.8,21285,44726562.0,238,124,108,21533116.0,22315798.0,10275,10592,2095.7,2106.9,20867,43848915.0,232,2023-11-08 12:50:00
554,BANE,728,357,146539375.0,113223982.0,69935,53798,2095.4,2104.6,123733,259763357.0,1085,726,354,146259289.0,112977717.0,69801,53681,2095.4,2104.6,123482,259237006.0,1080,2023-11-08 12:55:00
555,BANE,670,431,117618119.0,90149705.0,56079,42814,2097.4,2105.6,98893,207767825.0,1101,664,424,117287677.0,90285169.0,55968,42879,2095.6,2105.6,98847,207572846.0,1088,2023-11-08 13:00:00
556,BANE,733,373,157780724.0,102231190.0,75243,48571,2096.9,2104.8,123814,260011914.0,1106,726,360,157497708.0,102333960.0,75117,48610,2096.7,2105.2,123727,259831668.0,1086,2023-11-08 13:05:00
557,BANE,465,429,96815204.0,77186795.0,46191,36673,2096.0,2104.7,82864,174001999.0,894,465,426,96918375.0,76735313.0,46240,36456,2096.0,2104.9,82696,173653688.0,891,2023-11-08 13:10:00
558,BANE,757,659,111869001.0,93770696.0,53430,44560,2093.7,2104.4,97990,205639697.0,1416,751,655,111626577.0,93725702.0,53311,44525,2093.9,2105.0,97836,205352279.0,1406,2023-11-08 13:15:00
559,BANE,819,611,138549700.0,110655713.0,66246,52663,2091.4,2101.2,118909,249205413.0,1430,816,599,138594315.0,110444795.0,66265,52550,2091.5,2101.7,118815,249039111.0,1415,2023-11-08 13:20:00
560,BANE,457,346,52689834.0,55261645.0,25192,26288,2091.5,2102.2,51480,107951479.0,803,450,339,52663538.0,54595392.0,25182,25971,2091.3,2102.2,51153,107258930.0,789,2023-11-08 13:25:00
561,BANE,750,597,138849889.0,114647302.0,66339,54534,2093.0,2102.3,120873,253497191.0,1347,746,589,138573948.0,115173957.0,66219,54776,2092.7,2102.6,120995,253747905.0,1335,2023-11-08 13:30:00
562,BANE,189,59,14442430.0,9630353.0,6907,4586,2091.0,2099.9,11493,24072783.0,248,187,60,14380462.0,9388719.0,6877,4466,2091.1,2102.3,11343,23769181.0,247,2023-11-08 13:35:00
563,BANE,1416,823,140263076.0,163324240.0,67083,77676,2090.9,2102.6,144759,303587316.0,2239,1414,821,140101873.0,164177345.0,67008,78077,2090.8,2102.8,145085,304279219.0,2235,2023-11-08 13:40:00
564,BANE,1648,1274,223129177.0,243479511.0,106735,115921,2090.5,2100.4,222656,466608689.0,2922,1644,1270,222820509.0,243353693.0,106588,115851,2090.5,2100.6,222439,466174203.0,2914,2023-11-08 13:45:00
565,BANE,1435,1156,219177124.0,217331740.0,104865,103547,2090.1,2098.9,208412,436508864.0,2591,1427,1146,218913990.0,217036852.0,104741,103386,2090.1,2099.3,208127,435950842.0,2573,2023-11-08 13:50:00
566,BANE,1399,1351,230917854.0,276907831.0,110620,131898,2087.5,2099.4,242518,507825685.0,2750,1395,1329,231399773.0,276221457.0,110848,131567,2087.5,2099.5,242415,507621230.0,2724,2023-11-08 13:55:00
567,BANE,1212,1185,193411107.0,186745114.0,92664,89041,2087.2,2097.3,181705,380156222.0,2397,1205,1183,193647100.0,187973877.0,92780,89616,2087.2,2097.5,182396,381620977.0,2388,2023-11-08 14:00:00
568,BANE,1587,2641,152311565.0,351179760.0,73005,166942,2086.3,2103.6,239947,503491325.0,4228,1581,2635,152198567.0,351071988.0,72951,166887,2086.3,2103.7,239838,503270555.0,4216,2023-11-08 14:05:00
569,BANE,2394,1424,449911926.0,412019499.0,215379,195918,2088.9,2103.0,411297,861931425.0,3818,2389,1414,448586124.0,410539242.0,214826,195211,2088.1,2103.1,410037,859125366.0,3803,2023-11-08 14:10:00
570,BANE,692,426,124029939.0,84681167.0,59402,40356,2088.0,2098.4,99758,208711106.0,1118,689,420,123816945.0,83974295.0,59301,39979,2087.9,2100.5,99280,207791241.0,1109,2023-11-08 14:15:00
571,BANE,1681,837,271018239.0,203918231.0,129647,97106,2090.4,2100.0,226753,474936471.0,2518,1677,832,271147798.0,203977291.0,129708,97129,2090.4,2100.1,226837,475125090.0,2509,2023-11-08 14:20:00
572,BANE,366,289,61390395.0,57108680.0,29386,27224,2089.1,2097.7,56610,118499075.0,655,361,282,61205410.0,57002510.0,29297,27171,2089.1,2097.9,56468,118207920.0,643,2023-11-08 14:25:00
573,BANE,677,526,130768393.0,128881055.0,62630,61418,2088.0,2098.4,124048,259649449.0,1203,676,525,130668758.0,128915405.0,62582,61432,2088.0,2098.5,124014,259584163.0,1201,2023-11-08 14:30:00
574,BANE,608,621,115815976.0,132759966.0,55447,63317,2088.8,2096.8,118764,248575942.0,1229,608,616,115929265.0,132698837.0,55501,63286,2088.8,2096.8,118787,248628102.0,1224,2023-11-08 14:35:00
575,BANE,638,722,113588718.0,143340216.0,54404,68354,2087.9,2097.0,122758,256928934.0,1360,632,722,113564601.0,143351498.0,54393,68359,2087.9,2097.0,122752,256916099.0,1354,2023-11-08 14:40:00
576,BANE,1416,620,217060849.0,188480927.0,103906,89765,2089.0,2099.7,193671,405541776.0,2036,1415,617,216877848.0,188113575.0,103820,89591,2089.0,2099.7,193411,404991423.0,2032,2023-11-08 14:45:00
577,BANE,252,237,61118768.0,67520285.0,29265,32178,2088.5,2098.3,61443,128639054.0,489,251,239,61140231.0,67760394.0,29273,32291,2088.6,2098.4,61564,128900626.0,490,2023-11-08 14:50:00
578,BANE,466,377,89043013.0,93119032.0,42641,44420,2088.2,2096.3,87061,182162045.0,843,460,365,88798704.0,92806934.0,42524,44258,2088.2,2097.0,86782,181605638.0,825,2023-11-08 14:55:00
579,BANE,358,329,57788575.0,69433218.0,27674,33111,2088.2,2097.0,60785,127221793.0,687,354,324,57780534.0,69174884.0,27671,32982,2088.1,2097.4,60653,126955418.0,678,2023-11-08 15:00:00
580,BANE,532,539,109254747.0,126650278.0,52344,60391,2087.2,2097.2,112735,235905026.0,1071,530,537,109425481.0,126443898.0,52425,60295,2087.3,2097.1,112720,235869380.0,1067,2023-11-08 15:05:00
581,BANE,164,216,23157247.0,31072332.0,11101,14860,2086.1,2091.0,25961,54229580.0,380,153,203,21744382.0,30677708.0,10425,14628,2085.8,2097.2,25053,52422090.0,356,2023-11-08 15:10:00
582,BANE,70,371,11045371.0,27863833.0,5262,13287,2099.1,2097.1,18549,38909204.0,441,66,368,10760577.0,27333287.0,5151,13028,2089.0,2098.0,18179,38093865.0,434,2023-11-08 15:15:00
583,BANE,387,669,40006707.0,88092774.0,19143,41989,2089.9,2098.0,61132,128099481.0,1056,376,663,39631868.0,88099956.0,18992,41991,2086.8,2098.1,60983,127731824.0,1039,2023-11-08 15:20:00
584,BANE,197,980,17979085.0,89550006.0,8606,42707,2089.1,2096.8,51313,107529091.0,1177,196,979,17978678.0,89152740.0,8608,42518,2088.6,2096.8,51126,107131418.0,1175,2023-11-08 15:25:00
585,BANE,548,1057,59159189.0,130561754.0,28349,62229,2086.8,2098.1,90578,189720943.0,1605,542,1052,59044631.0,130524956.0,28295,62209,2086.8,2098.2,90504,189569587.0,1594,2023-11-08 15:30:00
586,BANE,607,1607,96385983.0,208756743.0,46167,99528,2087.8,2097.5,145695,305142727.0,2214,604,1602,96323440.0,208510979.0,46142,99410,2087.5,2097.5,145552,304834419.0,2206,2023-11-08 15:35:00
587,BANE,441,676,42779471.0,85139593.0,20510,40537,2085.8,2100.3,61047,127919065.0,1117,441,668,42945312.0,85080970.0,20589,40509,2085.8,2100.3,61098,128026282.0,1109,2023-11-08 15:40:00
588,BANE,192,343,14106981.0,29218301.0,6758,13935,2087.4,2096.8,20693,43325282.0,535,189,343,14104766.0,29203962.0,6757,13928,2087.4,2096.8,20685,43308728.0,532,2023-11-08 15:45:00
589,BANE,146,548,12166661.0,60403024.0,5824,28804,2089.1,2097.0,34628,72569685.0,694,143,541,12147890.0,60443246.0,5815,28823,2089.1,2097.0,34638,72591136.0,684,2023-11-08 15:50:00
590,BANE,160,849,21439778.0,83938869.0,10271,40021,2087.4,2097.4,50292,105378647.0,1009,155,839,21399869.0,83807914.0,10252,39959,2087.4,2097.3,50211,105207783.0,994,2023-11-08 15:55:00
591,BANE,290,717,26523395.0,77239152.0,12704,36836,2087.8,2096.8,49540,103762548.0,1007,289,713,26430229.0,76910490.0,12659,36678,2087.9,2096.9,49337,103340720.0,1002,2023-11-08 16:00:00
592,BANE,259,180,17559505.0,28007056.0,8411,13364,2087.7,2095.7,21775,45566561.0,439,257,172,17615069.0,27383818.0,8438,13062,2087.6,2096.4,21500,44998887.0,429,2023-11-08 16:05:00
593,BANE,111,73,21264090.0,13832647.0,10190,6600,2086.8,2095.9,16790,35096738.0,184,107,68,21221331.0,13810069.0,10171,6589,2086.5,2095.9,16760,35031400.0,175,2023-11-08 16:10:00
594,BANE,681,769,76786270.0,91357131.0,36825,43629,2085.2,2094.0,80454,168143402.0,1450,668,762,76664042.0,90717854.0,36741,43269,2086.6,2096.6,80010,167381897.0,1430,2023-11-08 16:15:00
595,BANE,1046,1478,148701613.0,265836414.0,71236,126656,2087.5,2098.9,197892,414538027.0,2524,1039,1476,148358809.0,265944106.0,71086,126708,2087.0,2098.9,197794,414302915.0,2515,2023-11-08 16:20:00
596,BANE,522,819,84817471.0,125053257.0,40728,59696,2082.5,2094.8,100424,209870728.0,1341,510,773,84451779.0,124272968.0,40549,59284,2082.7,2096.2,99833,208724747.0,1283,2023-11-08 16:25:00
597,BANE,144,304,16184590.0,34130336.0,7773,16306,2082.2,2093.1,24079,50314926.0,448,129,300,16112872.0,34077872.0,7745,16278,2080.4,2093.5,24023,50190744.0,429,2023-11-08 16:30:00
598,BANE,399,460,50020464.0,74280277.0,24022,35478,2082.3,2093.7,59500,124300742.0,859,390,458,49950473.0,74264343.0,23989,35471,2082.2,2093.7,59460,124214817.0,848,2023-11-08 16:35:00
599,BANE,270,316,33772964.0,55868320.0,16211,26701,2083.3,2092.4,42912,89641285.0,586,268,285,33609680.0,55486216.0,16132,26515,2083.4,2092.6,42647,89095897.0,553,2023-11-08 16:40:00
600,BANE,429,971,81346646.0,163028216.0,38351,77971,2121.1,2090.9,116322,244374863.0,1400,399,923,80186512.0,159600292.0,37803,76275,2121.2,2092.4,114078,239786805.0,1322,2023-11-08 16:45:00
601,BANE,1006,611,274284069.0,145237513.0,130866,69334,2095.9,2094.8,200200,419521582.0,1617,991,585,269394031.0,142624928.0,129652,68084,2077.8,2094.8,197736,412018959.0,1576,2023-11-08 16:50:00
602,BANE,512,391,108482737.0,78909532.0,50547,37631,2146.2,2096.9,88178,187392270.0,903,492,370,105620145.0,75727246.0,49893,36093,2116.9,2098.1,85986,181347391.0,862,2023-11-08 16:55:00
603,BANE,847,1620,178181376.0,297977834.0,86079,142691,2070.0,2088.3,228770,476159210.0,2467,818,1590,177295237.0,294334626.0,85648,140931,2070.0,2088.5,226579,471629864.0,2408,2023-11-08 17:00:00
604,BANE,501,531,36955439.0,84516774.0,17822,40588,2073.6,2082.3,58410,121472214.0,1032,481,523,36356390.0,84062519.0,17547,40361,2071.9,2082.8,57908,120418909.0,1004,2023-11-08 17:05:00
605,BANE,254,464,21897251.0,59161484.0,10562,28387,2073.2,2084.1,38949,81058736.0,718,247,464,21703640.0,59360149.0,10471,28483,2072.7,2084.1,38954,81063789.0,711,2023-11-08 17:10:00
606,BANE,782,1001,108458298.0,212447455.0,52251,101886,2075.7,2085.1,154137,320905754.0,1783,770,999,108239984.0,212356092.0,52151,101846,2075.5,2085.1,153997,320596077.0,1769,2023-11-08 17:15:00
607,BANE,72,73,1082176.0,4221303.0,520,2025,2081.1,2084.6,2545,5303479.0,145,67,68,1060878.0,4208915.0,510,2017,2080.2,2086.7,2527,5269794.0,135,2023-11-08 17:20:00
608,BANE,55,51,4230883.0,5881923.0,2030,2816,2084.2,2088.8,4846,10112806.0,106,53,45,3701511.0,5606367.0,1782,2684,2077.2,2088.8,4466,9307878.0,98,2023-11-08 17:25:00
609,BANE,300,471,74929868.0,95746697.0,36068,45882,2077.5,2086.8,81950,170676565.0,771,295,466,74864633.0,95633355.0,36043,45820,2077.1,2087.2,81863,170497988.0,761,2023-11-08 17:30:00
610,BANE,932,369,71190302.0,57585740.0,34211,27588,2080.9,2087.3,61799,128776042.0,1301,928,359,71189668.0,57483684.0,34233,27534,2079.6,2087.7,61767,128673353.0,1287,2023-11-08 17:35:00
611,BANE,196,187,18907181.0,17070285.0,9102,8182,2077.3,2086.3,17284,35977466.0,383,188,182,19284712.0,17082125.0,9284,8182,2077.2,2087.8,17466,36366837.0,370,2023-11-08 17:40:00
612,BANE,572,859,160377623.0,173487532.0,77221,83139,2076.9,2086.7,160360,333865155.0,1431,560,797,160170056.0,173340024.0,77122,83063,2076.8,2086.9,160185,333510080.0,1357,2023-11-08 17:45:00
613,BANE,666,636,226923944.0,154762731.0,109284,74157,2076.5,2087.0,183441,381686675.0,1302,648,617,225225128.0,154455755.0,108470,74010,2076.4,2087.0,182480,379680883.0,1265,2023-11-08 17:50:00
614,BANE,905,906,199029776.0,179728621.0,95802,86129,2077.5,2086.7,181931,378758397.0,1811,894,892,199901423.0,179327959.0,96225,85934,2077.4,2086.8,182159,379229382.0,1786,2023-11-08 17:55:00
615,BANE,532,828,91099743.0,120232976.0,43949,57580,2072.9,2088.1,101529,211332719.0,1360,526,829,92733316.0,122149267.0,44739,58474,2072.8,2089.0,103213,214882583.0,1355,2023-11-08 18:00:00
616,BANE,102,301,21400304.0,37036378.0,10323,17733,2073.1,2088.6,28056,58436682.0,403,102,295,21337497.0,36553330.0,10292,17499,2073.2,2088.9,27791,57890827.0,397,2023-11-08 18:05:00
617,BANE,244,784,17538533.0,117487261.0,8455,56288,2074.3,2087.3,64743,135025794.0,1028,240,779,17414235.0,117356166.0,8395,56212,2074.4,2087.7,64607,134770401.0,1019,2023-11-08 18:10:00
618,BANE,1387,1379,188211161.0,183565908.0,89347,88311,2106.5,2078.6,177658,371777069.0,2766,1276,1323,175182076.0,179310912.0,84567,85903,2071.5,2087.4,170470,354492988.0,2599,2023-11-08 18:15:00
619,BANE,377,92,83980011.0,20070518.0,39242,9612,2140.1,2088.1,48854,104050530.0,469,375,85,88323022.0,19945274.0,41230,9546,2142.2,2089.4,50776,108268296.0,460,2023-11-08 18:20:00
620,BANE,1325,588,165007278.0,141447793.0,77674,67856,2124.4,2084.5,145530,306455071.0,1913,1308,575,160821737.0,139544801.0,75868,66939,2119.8,2084.7,142807,300366538.0,1883,2023-11-08 18:25:00
621,BANE,1800,811,201368033.0,194150727.0,96733,93080,2081.7,2085.8,189813,395518760.0,2611,1789,800,200301519.0,193879807.0,96246,92950,2081.1,2085.9,189196,394181326.0,2589,2023-11-08 18:30:00
622,BANE,2826,707,369925890.0,221359961.0,178270,106138,2075.1,2085.6,284408,591285851.0,3533,2820,705,370887332.0,221359245.0,178772,106137,2074.6,2085.6,284909,592246577.0,3525,2023-11-08 18:35:00
623,BANE,3076,1651,521131257.0,364073021.0,251446,174871,2072.5,2082.0,426317,885204278.0,4727,3080,1637,521815548.0,364474375.0,251804,175035,2072.3,2082.3,426839,886289923.0,4717,2023-11-08 18:40:00
624,BANE,2167,1764,484479810.0,475918178.0,232187,226480,2086.6,2101.4,458667,960397988.0,3931,2055,1661,475462706.0,464413889.0,229397,221507,2072.7,2096.6,450904,939876595.0,3716,2023-11-09 10:05:00
625,BANE,1787,2207,184264273.0,485514334.0,87900,231743,2096.3,2095.1,319643,669778607.0,3994,1756,2173,183408270.0,484941921.0,87511,231458,2095.8,2095.2,318969,668350191.0,3929,2023-11-09 10:10:00
626,BANE,1280,1451,163201840.0,409270094.0,77538,195674,2104.8,2091.6,273212,572471935.0,2731,1263,1429,161301378.0,407179642.0,76606,194652,2105.6,2091.8,271258,568481020.0,2692,2023-11-09 10:15:00
627,BANE,2284,1390,398970179.0,300893501.0,192606,144209,2071.4,2086.5,336815,699863681.0,3674,2258,1375,398152274.0,300989514.0,192212,144185,2071.4,2087.5,336397,699141788.0,3633,2023-11-09 10:20:00
628,BANE,2499,1872,210354136.0,358940493.0,101856,172064,2065.2,2086.1,273920,569294629.0,4371,2484,1863,209080815.0,358333033.0,101242,171760,2065.2,2086.2,273002,567413848.0,4347,2023-11-09 10:25:00
629,BANE,1254,1506,97154957.0,334718729.0,47030,160271,2065.8,2088.5,207301,431873686.0,2760,1246,1487,99890967.0,332196391.0,47598,159036,2098.6,2088.8,206634,432087358.0,2733,2023-11-09 10:30:00
630,BANE,1945,1683,138719808.0,291715388.0,66588,139792,2083.3,2086.8,206380,430435197.0,3628,1927,1671,136723192.0,293123454.0,66183,140443,2065.8,2087.1,206626,429846646.0,3598,2023-11-09 10:35:00
631,BANE,1551,2929,96084220.0,497980039.0,44580,239554,2155.3,2078.8,284134,594064259.0,4480,1454,2888,90789990.0,495485905.0,42169,238273,2153.0,2079.5,280442,586275895.0,4342,2023-11-09 10:40:00
632,BANE,872,1606,41462748.0,288442288.0,19775,138809,2096.7,2078.0,158584,329905036.0,2478,819,1584,44345012.0,287118812.0,20816,138174,2130.3,2078.0,158990,331463825.0,2403,2023-11-09 10:45:00
633,BANE,545,1205,33099740.0,200978101.0,16081,96883,2058.3,2074.4,112964,234077841.0,1750,523,1195,31811430.0,201784398.0,15464,97267,2057.1,2074.5,112731,233595828.0,1718,2023-11-09 10:50:00
634,BANE,693,1006,74815327.0,174717619.0,36426,83611,2053.9,2089.6,120037,249532946.0,1699,672,980,63890744.0,173352482.0,31021,82820,2059.6,2093.1,113841,237243226.0,1652,2023-11-09 10:55:00
635,BANE,3913,2995,947730472.0,757238769.0,458110,363880,2068.8,2081.0,821990,1704969241.0,6908,3886,2969,948044950.0,756387080.0,458037,363470,2069.8,2081.0,821507,1704432031.0,6855,2023-11-09 11:00:00
636,BANE,1621,2564,358865325.0,496205280.0,173914,238679,2063.5,2079.0,412593,855070605.0,4185,1587,2544,356748140.0,495458965.0,172913,238308,2063.2,2079.1,411221,852207105.0,4131,2023-11-09 11:05:00
637,BANE,1803,1824,369533000.0,445256037.0,178655,213835,2068.4,2082.2,392490,814789037.0,3627,1791,1804,367839865.0,445137202.0,177863,213780,2068.1,2082.2,391643,812977068.0,3595,2023-11-09 11:10:00
638,BANE,1642,1567,266920732.0,309864796.0,128930,148702,2070.3,2083.8,277632,576785528.0,3209,1636,1549,267731176.0,309668454.0,129321,148610,2070.3,2083.8,277931,577399630.0,3185,2023-11-09 11:15:00
639,BANE,1711,495,218249984.0,108436023.0,105434,52061,2070.0,2082.9,157495,326686007.0,2206,1696,485,217738424.0,108337520.0,105199,52014,2069.8,2082.9,157213,326075944.0,2181,2023-11-09 11:20:00
640,BANE,860,594,129396998.0,48053636.0,62503,23034,2070.3,2086.2,85537,177450634.0,1454,853,585,129013969.0,47881805.0,62333,22960,2069.8,2085.4,85293,176895774.0,1438,2023-11-09 11:25:00
641,BANE,1495,1182,255938239.0,231313251.0,123642,110960,2070.0,2084.7,234602,487251490.0,2677,1490,1178,256089534.0,231002063.0,123712,110790,2070.0,2085.0,234502,487091597.0,2668,2023-11-09 11:30:00
642,BANE,1113,895,214814746.0,164628371.0,103527,78919,2075.0,2086.0,182446,379443118.0,2008,1107,889,212957828.0,164640398.0,103181,78924,2063.9,2086.1,182105,377598226.0,1996,2023-11-09 11:35:00
643,BANE,1739,1345,531773804.0,233281282.0,258090,112053,2060.4,2081.9,370143,765055087.0,3084,1732,1342,531363408.0,233142451.0,257915,111990,2060.2,2081.8,369905,764505859.0,3074,2023-11-09 11:40:00
644,BANE,1604,1180,370978697.0,166858488.0,178931,80185,2073.3,2080.9,259116,537837185.0,2784,1601,1170,371631153.0,166237310.0,179244,79846,2073.3,2082.0,259090,537868463.0,2771,2023-11-09 11:45:00
645,BANE,1233,1495,386667442.0,201514733.0,187210,96962,2065.4,2078.3,284172,588182176.0,2728,1230,1490,386334692.0,201539893.0,187050,96963,2065.4,2078.5,284013,587874585.0,2720,2023-11-09 11:50:00
646,BANE,1643,1808,281810766.0,247518735.0,136248,119021,2068.4,2079.6,255269,529329501.0,3451,1630,1793,282115146.0,247428036.0,136397,118975,2068.3,2079.7,255372,529543182.0,3423,2023-11-09 11:55:00
647,BANE,2405,2190,463546267.0,387708215.0,224018,186377,2069.2,2080.2,410395,851254483.0,4595,2394,2187,463025185.0,387388941.0,223768,186220,2069.2,2080.3,409988,850414126.0,4581,2023-11-09 12:00:00
648,BANE,1367,2030,284757881.0,319799253.0,137528,153727,2070.5,2080.3,291255,604557134.0,3397,1363,2023,284776221.0,319702995.0,137538,153681,2070.5,2080.3,291219,604479216.0,3386,2023-11-09 12:05:00
649,BANE,973,1188,197367679.0,178238819.0,95293,85644,2071.2,2081.2,180937,375606498.0,2161,967,1185,197174091.0,178413290.0,95200,85719,2071.2,2081.4,180919,375587381.0,2152,2023-11-09 12:10:00
650,BANE,1082,1245,234686231.0,166736385.0,113297,80140,2071.4,2080.6,193437,401422616.0,2327,1078,1239,236180381.0,166737952.0,113467,80140,2081.5,2080.6,193607,402918333.0,2317,2023-11-09 12:15:00
651,BANE,778,1370,206222296.0,185161346.0,99552,89008,2071.5,2080.3,188560,391383642.0,2148,773,1367,206201240.0,185032247.0,99542,88950,2071.5,2080.2,188492,391233488.0,2140,2023-11-09 12:20:00
652,BANE,818,836,144841080.0,90986596.0,69741,43640,2076.8,2084.9,113381,235827676.0,1654,811,825,143141940.0,90129023.0,69050,43231,2073.0,2084.8,112281,233270963.0,1636,2023-11-09 12:25:00
653,BANE,206,96,16935727.0,6371536.0,8160,3058,2075.5,2083.6,11218,23307263.0,302,204,96,16812500.0,6413100.0,8101,3078,2075.4,2083.5,11179,23225600.0,300,2023-11-09 12:30:00
654,BANE,344,331,46389541.0,28803022.0,22371,13840,2073.6,2081.1,36211,75192563.0,675,342,327,46429421.0,28655800.0,22390,13760,2073.7,2082.5,36150,75085221.0,669,2023-11-09 12:35:00
655,BANE,421,314,89007534.0,44074304.0,42919,21171,2073.8,2081.8,64090,133081838.0,735,414,308,88267785.0,44090687.0,42581,21179,2072.9,2081.8,63760,132358472.0,722,2023-11-09 12:40:00
656,BANE,125,173,22357557.0,20859724.0,10779,10016,2074.2,2082.6,20795,43217281.0,298,123,166,22523818.0,20806245.0,10860,9990,2074.0,2082.7,20850,43330063.0,289,2023-11-09 12:45:00
657,BANE,86,132,7829356.0,9085932.0,3773,4351,2075.1,2088.2,8124,16915288.0,218,81,121,8044282.0,8931183.0,3878,4277,2074.3,2088.2,8155,16975465.0,202,2023-11-09 12:50:00
658,BANE,481,568,80697156.0,41468806.0,38885,19913,2075.3,2082.5,58798,122165963.0,1049,475,567,80506641.0,41300799.0,38794,19832,2075.2,2082.5,58626,121807440.0,1042,2023-11-09 12:55:00
659,BANE,381,212,79780096.0,38420126.0,38465,18441,2074.1,2083.4,56906,118200222.0,593,363,205,75603650.0,38151963.0,36433,18313,2075.1,2083.3,54746,113755613.0,568,2023-11-09 13:00:00
660,BANE,468,259,86757104.0,42088068.0,41803,20217,2075.4,2081.8,62020,128845172.0,727,466,252,86344552.0,41826869.0,41604,20082,2075.4,2082.8,61686,128171422.0,718,2023-11-09 13:05:00
661,BANE,629,252,89137974.0,51644218.0,42958,24781,2075.0,2084.0,67739,140782192.0,881,628,249,89134049.0,51603498.0,42960,24762,2074.8,2084.0,67722,140737547.0,877,2023-11-09 13:10:00
662,BANE,239,118,39845275.0,26914725.0,19202,12910,2075.1,2084.8,32112,66760000.0,357,236,113,39995268.0,26848463.0,19274,12873,2075.1,2085.6,32147,66843732.0,349,2023-11-09 13:15:00
663,BANE,72,30,9508965.0,4574492.0,4582,2196,2075.3,2083.1,6778,14083457.0,102,72,30,9222394.0,4574470.0,4444,2196,2075.2,2083.1,6640,13796864.0,102,2023-11-09 13:20:00
664,BANE,189,129,39880678.0,27856678.0,19198,13367,2077.3,2084.0,32565,67737356.0,318,184,120,39571175.0,27684117.0,19067,13285,2075.4,2083.9,32352,67255292.0,304,2023-11-09 13:25:00
665,BANE,1039,545,187173759.0,140318100.0,90041,67236,2078.8,2086.9,157277,327491859.0,1584,1016,535,187959287.0,139743995.0,90548,66962,2075.8,2086.9,157510,327703282.0,1551,2023-11-09 13:30:00
666,BANE,865,529,218024223.0,146781652.0,104722,70149,2081.9,2092.4,174871,364805876.0,1394,841,505,217030345.0,145992371.0,104251,69768,2081.8,2092.5,174019,363022716.0,1346,2023-11-09 13:35:00
667,BANE,516,188,90354539.0,50609016.0,43376,24133,2083.1,2097.1,67509,140963555.0,704,492,167,86778617.0,46777228.0,41668,22325,2082.6,2095.3,63993,133555845.0,659,2023-11-09 13:40:00
668,BANE,984,320,143306512.0,70857714.0,68749,33856,2084.5,2092.9,102605,214164226.0,1304,977,303,143493550.0,71197841.0,68838,33946,2084.5,2097.4,102784,214691391.0,1280,2023-11-09 13:45:00
669,BANE,407,353,56788320.0,56218154.0,27247,26831,2084.2,2095.3,54078,113006474.0,760,390,346,55692622.0,53766789.0,26729,25641,2083.6,2096.9,52370,109459411.0,736,2023-11-09 13:50:00
670,BANE,396,560,42589521.0,71304725.0,20435,33959,2084.1,2099.7,54394,113894246.0,956,386,555,41024167.0,70411297.0,19692,33543,2083.3,2099.1,53235,111435464.0,941,2023-11-09 13:55:00
671,BANE,306,223,39198390.0,40037303.0,18778,19061,2087.5,2100.5,37839,79235693.0,529,282,217,39146195.0,40850997.0,18744,19440,2088.5,2101.4,38184,79997192.0,499,2023-11-09 14:00:00
672,BANE,1311,792,103384143.0,137825624.0,49539,65215,2086.9,2113.4,114754,241209768.0,2103,1304,777,101671932.0,135851151.0,48752,64281,2085.5,2113.4,113033,237523083.0,2081,2023-11-09 14:05:00
673,BANE,391,1019,73311220.0,139926650.0,35209,66777,2082.2,2095.4,101986,213237870.0,1410,391,1012,73580390.0,139262152.0,35338,66444,2082.2,2095.9,101782,212842542.0,1403,2023-11-09 14:10:00
674,BANE,112,263,26282013.0,56864860.0,12632,27148,2080.6,2094.6,39780,83146873.0,375,109,256,24790325.0,56605084.0,11912,27023,2081.1,2094.7,38935,81395410.0,365,2023-11-09 14:15:00
675,BANE,125,240,12479920.0,27836579.0,5991,13282,2083.1,2095.8,19273,40316500.0,365,123,234,12397908.0,27741503.0,5955,13237,2081.9,2095.8,19192,40139411.0,357,2023-11-09 14:20:00
676,BANE,40,104,6455945.0,11960030.0,3090,5704,2089.3,2096.8,8794,18415975.0,144,37,97,6339989.0,11679561.0,3041,5568,2084.8,2097.6,8609,18019550.0,134,2023-11-09 14:25:00
677,BANE,196,226,34682971.0,28626486.0,16679,13717,2079.4,2086.9,30396,63309458.0,422,189,213,34030544.0,28436740.0,16366,13590,2079.3,2092.5,29956,62467284.0,402,2023-11-09 14:30:00
678,BANE,720,671,123948625.0,78479968.0,59629,37496,2078.7,2093.0,97125,202428594.0,1391,723,662,124406829.0,78163228.0,59852,37342,2078.6,2093.2,97194,202570057.0,1385,2023-11-09 14:35:00
679,BANE,166,102,13617512.0,9179872.0,6543,4383,2081.2,2094.4,10926,22797384.0,268,167,94,13361257.0,9045735.0,6419,4313,2081.5,2097.3,10732,22406992.0,261,2023-11-09 14:40:00
680,BANE,39,38,3564328.0,3200362.0,1714,1542,2079.5,2075.5,3256,6764691.0,77,32,35,3463833.0,3096550.0,1667,1479,2077.9,2093.7,3146,6560383.0,67,2023-11-09 14:45:00
681,BANE,110,129,17303439.0,15471522.0,8275,7391,2091.1,2093.3,15666,32774961.0,239,104,128,18902161.0,15481884.0,9086,7396,2080.4,2093.3,16482,34384046.0,232,2023-11-09 14:50:00
682,BANE,212,317,44009587.0,44349904.0,21124,21153,2083.4,2096.6,42277,88359491.0,529,207,312,43815568.0,44426227.0,21034,21190,2083.1,2096.6,42224,88241795.0,519,2023-11-09 14:55:00
683,BANE,453,720,60398648.0,52410683.0,29002,25035,2082.6,2093.5,54037,112809331.0,1173,451,714,60540709.0,52298973.0,29070,24968,2082.6,2094.6,54038,112839682.0,1165,2023-11-09 15:00:00
684,BANE,650,363,62107259.0,56687714.0,29782,27054,2085.4,2095.4,56836,118794973.0,1013,650,363,62125408.0,56632599.0,29791,27028,2085.4,2095.3,56819,118758008.0,1013,2023-11-09 15:05:00
685,BANE,1278,752,182105918.0,121128124.0,87032,57539,2092.4,2105.1,144571,303234042.0,2030,781,709,177577021.0,119695487.0,85117,56870,2086.3,2104.7,141987,297272509.0,1490,2023-11-09 15:10:00
686,BANE,986,708,242553895.0,97746925.0,115739,46216,2095.7,2115.0,161955,340300820.0,1694,908,583,239746148.0,95645985.0,114472,45193,2094.4,2116.4,159665,335392133.0,1491,2023-11-09 15:15:00
687,BANE,1047,1211,151990587.0,244921235.0,72481,115823,2097.0,2114.6,188304,396911822.0,2258,1029,1180,151825619.0,244522893.0,72401,115582,2097.0,2115.6,187983,396348513.0,2209,2023-11-09 15:20:00
688,BANE,1844,813,219468632.0,184531151.0,103232,86490,2126.0,2133.6,189722,403999784.0,2657,1122,580,199423524.0,177591565.0,94567,83217,2108.8,2134.1,177784,377015089.0,1702,2023-11-09 15:25:00
689,BANE,2013,2089,346142276.0,325007028.0,161550,150890,2142.6,2153.9,312440,671149305.0,4102,1587,1355,305167546.0,272810869.0,143081,125992,2132.8,2165.3,269073,577978415.0,2942,2023-11-09 15:30:00
690,BANE,1053,1233,104300742.0,141211197.0,48965,66241,2130.1,2131.8,115206,245511939.0,2286,822,952,97197427.0,133987786.0,45798,62316,2122.3,2150.1,108114,231185214.0,1774,2023-11-09 15:35:00
691,BANE,776,837,97657729.0,88506490.0,45002,42266,2170.1,2094.0,87268,186164219.0,1613,554,672,99546365.0,68976871.0,47367,32207,2101.6,2141.7,79574,168523236.0,1226,2023-11-09 15:40:00
692,BANE,576,678,62021770.0,53422307.0,29149,25554,2127.7,2090.6,54703,115444077.0,1254,422,552,57208037.0,47852027.0,26887,22431,2127.7,2133.3,49318,105060064.0,974,2023-11-09 15:45:00
693,BANE,1291,834,168941364.0,67820228.0,79293,31216,2130.6,2172.6,110509,236761592.0,2125,1099,694,163454844.0,61146194.0,76597,28082,2134.0,2177.4,104679,224601038.0,1793,2023-11-09 15:50:00
694,BANE,683,519,87577730.0,48174052.0,41313,22642,2119.9,2127.6,63955,135751782.0,1202,664,472,88751869.0,47433746.0,41994,22201,2113.4,2136.6,64195,136185616.0,1136,2023-11-09 15:55:00
695,BANE,403,280,25149147.0,30286011.0,11908,14182,2112.0,2135.5,26090,55435158.0,683,386,252,25459403.0,28377805.0,12056,13254,2111.8,2141.1,25310,53837208.0,638,2023-11-09 16:00:00
696,BANE,1287,559,228414431.0,61480824.0,107251,28767,2129.7,2137.2,136018,289895256.0,1846,1223,465,222074066.0,59162706.0,104222,27628,2130.8,2141.4,131850,281236773.0,1688,2023-11-09 16:05:00
697,BANE,784,267,141536896.0,29142552.0,66736,13687,2120.8,2129.2,80423,170679448.0,1051,777,216,139384723.0,26619791.0,65856,12483,2116.5,2132.5,78339,166004514.0,993,2023-11-09 16:10:00
698,BANE,578,324,92693616.0,33760177.0,43738,15850,2119.3,2130.0,59588,126453793.0,902,569,286,91588123.0,33810545.0,43229,15836,2118.7,2135.0,59065,125398668.0,855,2023-11-09 16:15:00
699,BANE,102,86,10100501.0,10329489.0,4768,4844,2118.4,2132.4,9612,20429990.0,188,86,67,9781776.0,9493020.0,4617,4440,2118.6,2138.1,9057,19274796.0,153,2023-11-09 16:20:00
700,BANE,490,516,50377437.0,53848450.0,23776,25222,2118.8,2135.0,48998,104225887.0,1006,443,504,48069803.0,52980392.0,22698,24801,2117.8,2136.2,47499,101050196.0,947,2023-11-09 16:25:00
701,BANE,683,202,56623598.0,20849790.0,26710,9782,2119.9,2131.4,36492,77473388.0,885,658,176,57015202.0,19988754.0,26918,9375,2118.1,2132.1,36293,77003956.0,834,2023-11-09 16:30:00
702,BANE,239,259,44392129.0,17334652.0,20478,8136,2167.8,2130.6,28614,61726781.0,498,229,200,42152390.0,16539736.0,19545,7753,2156.7,2133.3,27298,58692127.0,429,2023-11-09 16:35:00
703,BANE,191,329,28475853.0,18914919.0,13393,8934,2126.2,2117.2,22327,47390772.0,520,180,225,26322555.0,23941082.0,12401,10906,2122.6,2195.2,23307,50263637.0,405,2023-11-09 16:40:00
704,BANE,335,231,24584617.0,14505063.0,11576,6824,2123.8,2125.6,18400,39089680.0,566,333,198,26573531.0,15371441.0,12522,7196,2122.1,2136.1,19718,41944972.0,531,2023-11-09 16:45:00
705,BANE,128,68,15330211.0,6817605.0,7241,3215,2117.1,2120.6,10456,22147817.0,196,117,57,15846486.0,6620584.0,7500,3094,2112.9,2139.8,10594,22467070.0,174,2023-11-09 16:50:00
706,BANE,358,94,28324657.0,12333708.0,13393,5700,2114.9,2163.8,19093,40658365.0,452,346,78,25744793.0,8825167.0,12227,4078,2105.6,2164.1,16305,34569960.0,424,2023-11-09 16:55:00
707,BANE,46,36,6490869.0,3714955.0,3067,1747,2116.4,2126.5,4814,10205824.0,82,36,20,5865686.0,3477390.0,2829,1628,2073.4,2136.0,4457,9343076.0,56,2023-11-09 17:00:00
708,BANE,235,107,28019490.0,8664893.0,13212,4066,2120.8,2131.1,17278,36684383.0,342,218,93,26911576.0,8154988.0,12717,3822,2116.2,2133.7,16539,35066564.0,311,2023-11-09 17:05:00
709,BANE,340,152,47601222.0,23792612.0,22503,11000,2115.3,2163.0,33503,71393835.0,492,324,116,48158621.0,22569741.0,22770,10452,2115.0,2159.4,33222,70728362.0,440,2023-11-09 17:10:00
710,BANE,343,44,55742627.0,7019028.0,26317,3280,2118.1,2139.9,29597,62761655.0,387,339,26,54095693.0,5919635.0,25557,2762,2116.7,2143.2,28319,60015329.0,365,2023-11-09 17:15:00
711,BANE,542,56,90931345.0,8101402.0,42948,3819,2117.2,2121.3,46767,99032747.0,598,548,46,91260292.0,7761030.0,43141,3633,2115.4,2136.3,46774,99021322.0,594,2023-11-09 17:20:00
712,BANE,1617,281,223528399.0,55727137.0,105225,26256,2124.3,2122.5,131481,279255537.0,1898,1598,265,224150696.0,54711705.0,105555,25637,2123.5,2134.1,131192,278862401.0,1863,2023-11-09 17:25:00
713,BANE,1562,688,269049716.0,106800814.0,126708,50091,2123.4,2132.1,176799,375850531.0,2250,1550,662,268430959.0,105355429.0,126421,49394,2123.3,2133.0,175815,373786388.0,2212,2023-11-09 17:30:00
714,BANE,988,311,144388976.0,57071208.0,67964,26750,2124.5,2133.5,94714,201460185.0,1299,983,302,145774982.0,58484432.0,68070,27405,2141.5,2134.1,95475,204259414.0,1285,2023-11-09 17:35:00
715,BANE,286,118,44985442.0,18763960.0,21311,8811,2110.9,2129.6,30122,63749402.0,404,267,99,44304151.0,17464559.0,20984,8160,2111.3,2140.3,29144,61768711.0,366,2023-11-09 17:40:00
716,BANE,602,443,84620885.0,61922056.0,35082,29026,2412.1,2133.3,64108,146542942.0,1045,532,421,74001542.0,53730845.0,35036,25218,2112.2,2130.7,60254,127732387.0,953,2023-11-09 17:45:00
717,BANE,455,88,29544081.0,13675966.0,13959,6137,2116.5,2228.4,20096,43220047.0,543,365,62,31212908.0,11142966.0,14756,5223,2115.3,2133.4,19979,42355875.0,427,2023-11-09 17:50:00
718,BANE,573,313,80271291.0,46332593.0,37982,21776,2113.4,2127.7,59758,126603884.0,886,498,284,78456795.0,45004129.0,37122,21151,2113.5,2127.8,58273,123460924.0,782,2023-11-09 17:55:00
719,BANE,281,344,56437581.0,40130057.0,26760,18781,2109.0,2136.7,45541,96567639.0,625,273,343,54102378.0,38094142.0,25651,17831,2109.2,2136.4,43482,92196521.0,616,2023-11-09 18:00:00
720,BANE,694,614,165608659.0,69593477.0,78242,32706,2116.6,2127.9,110948,235202136.0,1308,682,594,163987619.0,70599843.0,77424,33148,2118.0,2129.8,110572,234587462.0,1276,2023-11-09 18:05:00
721,BANE,1253,1389,169110207.0,237274868.0,80131,112910,2110.4,2101.5,193041,406385075.0,2642,1105,1278,158788068.0,219319613.0,75268,103356,2109.6,2122.0,178624,378107681.0,2383,2023-11-09 18:10:00
722,BANE,256,669,31620020.0,106703707.0,14864,50226,2127.3,2124.5,65090,138323728.0,925,214,637,24002645.0,104472929.0,11395,49167,2106.4,2124.9,60562,128475574.0,851,2023-11-09 18:15:00
723,BANE,595,1495,76379865.0,292521559.0,35510,138060,2150.9,2118.8,173570,368901425.0,2090,567,1471,73237238.0,289724151.0,34286,136607,2136.1,2120.9,170893,362961390.0,2038,2023-11-09 18:20:00
724,BANE,94,135,5923588.0,23499988.0,2773,11055,2136.2,2125.7,13828,29423576.0,229,90,133,5535411.0,23292078.0,2620,10956,2112.8,2126.0,13576,28827490.0,223,2023-11-09 18:25:00
725,BANE,315,338,15476007.0,42920623.0,7259,20248,2132.0,2119.7,27507,58396630.0,653,290,323,14589704.0,42643451.0,6904,20066,2113.2,2125.2,26970,57233155.0,613,2023-11-09 18:30:00
726,BANE,692,1284,31624759.0,186886144.0,14512,88125,2179.2,2120.7,102637,218510903.0,1976,662,1260,30693294.0,185933024.0,14268,87590,2151.2,2122.8,101858,216626318.0,1922,2023-11-09 18:35:00
727,BANE,589,2234,48714617.0,284795218.0,22941,134221,2123.5,2121.8,157162,333509835.0,2823,591,2236,54817104.0,286764677.0,25124,135095,2181.9,2122.7,160219,341581781.0,2827,2023-11-09 18:40:00
728,BANE,1679,1230,222102151.0,206374471.0,102572,96196,2165.3,2145.4,198768,428476622.0,2909,1514,1094,212785868.0,192606169.0,99777,90096,2132.6,2137.8,189873,405392037.0,2608,2023-11-10 10:05:00
729,BANE,1248,1929,167640757.0,407609550.0,78790,190549,2127.7,2139.1,269339,575250307.0,3177,1221,1853,164887182.0,404872802.0,77610,189268,2124.6,2139.2,266878,569759984.0,3074,2023-11-10 10:10:00
730,BANE,1654,2193,165719878.0,400546999.0,76980,187962,2152.8,2131.0,264942,566266877.0,3847,1571,2128,159816471.0,393849828.0,74885,184714,2134.2,2132.2,259599,553666300.0,3699,2023-11-10 10:15:00
731,BANE,2190,2372,293480018.0,390521287.0,135148,183087,2171.5,2133.0,318235,684001306.0,4562,2046,2243,277671051.0,380394511.0,127931,178228,2170.5,2134.3,306159,658065562.0,4289,2023-11-10 10:20:00
732,BANE,1852,1366,271416413.0,193162504.0,126293,89120,2149.1,2167.4,215413,464578917.0,3218,1573,1037,254959507.0,172528742.0,117644,79667,2167.2,2165.6,197311,427488250.0,2610,2023-11-10 10:25:00
733,BANE,2363,1382,385560996.0,246128537.0,176997,112384,2178.3,2190.1,289381,631689533.0,3745,1938,893,336823820.0,211362433.0,156034,95676,2158.7,2209.1,251710,548186253.0,2831,2023-11-10 10:30:00
734,BANE,1738,1258,258331605.0,156153960.0,116726,70720,2213.1,2208.1,187446,414485565.0,2996,1429,880,228618956.0,133094043.0,103581,59984,2207.2,2218.8,163565,361713000.0,2309,2023-11-10 10:35:00
735,BANE,1286,1475,178799355.0,246159250.0,82019,112025,2180.0,2197.4,194044,424958605.0,2761,999,1286,164850925.0,232066055.0,76269,105232,2161.4,2205.3,181501,396916980.0,2285,2023-11-10 10:40:00
736,BANE,4064,1765,468520328.0,312563147.0,213541,141426,2194.1,2210.1,354967,781083475.0,5829,2336,1266,418313158.0,270883699.0,192447,123040,2173.7,2201.6,315487,689196858.0,3602,2023-11-10 10:45:00
737,BANE,5342,2719,641100120.0,474385369.0,291922,214434,2196.1,2212.3,506356,1115485489.0,8061,2592,1855,574987593.0,410516303.0,262852,183573,2187.5,2236.3,446425,985503896.0,4447,2023-11-10 10:50:00
738,BANE,1646,2394,271232088.0,331144665.0,123008,151160,2205.0,2190.7,274168,602376753.0,4040,1258,1843,232931357.0,297293051.0,106533,134293,2186.5,2213.8,240826,530224408.0,3101,2023-11-10 10:55:00
739,BANE,1439,1037,247712730.0,170626144.0,112035,77147,2211.0,2211.7,189182,418338874.0,2476,1179,714,218180685.0,149415663.0,99677,67194,2188.9,2223.6,166871,367596349.0,1893,2023-11-10 11:00:00
740,BANE,917,1216,132764294.0,156161623.0,60252,70414,2203.5,2217.8,130666,288925918.0,2133,755,972,122146986.0,140630062.0,55797,63152,2189.1,2226.9,118949,262777049.0,1727,2023-11-10 11:05:00
741,BANE,681,1837,91506580.0,287055774.0,41754,131108,2191.6,2189.5,172862,378562354.0,2518,497,1591,76931813.0,268102210.0,35193,121440,2186.0,2207.7,156633,345034023.0,2088,2023-11-10 11:10:00
742,BANE,1427,597,247034148.0,81853418.0,112579,36727,2194.3,2228.7,149306,328887566.0,2024,1325,492,239502519.0,75334406.0,109473,33533,2187.8,2246.6,143006,314836925.0,1817,2023-11-10 11:15:00
743,BANE,1639,440,271861396.0,63067301.0,123840,28498,2195.3,2213.0,152338,334928697.0,2079,1531,294,262354918.0,55950016.0,119896,25170,2188.2,2222.9,145066,318304934.0,1825,2023-11-10 11:20:00
744,BANE,669,479,101418181.0,38152483.0,46382,17587,2186.6,2169.4,63969,139570664.0,1148,579,407,96065790.0,35183262.0,43961,15651,2185.3,2248.0,59612,131249052.0,986,2023-11-10 11:25:00
745,BANE,1561,839,250808218.0,97183085.0,114245,44199,2195.4,2198.8,158444,347991304.0,2400,1489,774,243884058.0,94690040.0,111263,42788,2192.0,2213.0,154051,338574099.0,2263,2023-11-10 11:30:00
746,BANE,397,635,37191937.0,66398661.0,16901,30113,2200.6,2205.0,47014,103590598.0,1032,307,551,32172985.0,63963002.0,14684,28949,2191.0,2209.5,43633,96135987.0,858,2023-11-10 11:35:00
747,BANE,467,445,53421698.0,35643841.0,24329,16154,2195.8,2206.5,40483,89065539.0,912,413,385,49373338.0,35619913.0,22674,16083,2177.5,2214.8,38757,84993252.0,798,2023-11-10 11:40:00
748,BANE,679,514,77231328.0,62550349.0,35028,28309,2204.8,2209.6,63337,139781678.0,1193,602,444,69247450.0,58634230.0,31646,26488,2188.2,2213.6,58134,127881680.0,1046,2023-11-10 11:45:00
749,BANE,1412,615,147754063.0,57558462.0,67121,26088,2201.3,2206.3,93209,205312525.0,2027,1198,499,145927720.0,52330217.0,66522,23600,2193.7,2217.4,90122,198257937.0,1697,2023-11-10 11:50:00
750,BANE,598,1392,67100435.0,207327160.0,30624,94123,2191.1,2202.7,124747,274427596.0,1990,494,1316,60399522.0,200628382.0,27617,90808,2187.0,2209.4,118425,261027904.0,1810,2023-11-10 11:55:00
751,BANE,347,2226,21157956.0,365058778.0,9667,165579,2188.7,2204.7,175246,386216734.0,2573,294,2200,21600820.0,364389251.0,9885,165166,2185.2,2206.2,175051,385990071.0,2494,2023-11-10 12:00:00
752,BANE,232,831,22550706.0,124496949.0,10292,56974,2191.1,2185.2,67266,147047656.0,1063,157,791,19900919.0,121615912.0,9111,55106,2184.3,2206.9,64217,141516832.0,948,2023-11-10 12:05:00
753,BANE,180,422,29514556.0,69807863.0,13295,31591,2220.0,2209.7,44886,99322419.0,602,150,375,26187978.0,63860591.0,11964,28860,2188.9,2212.8,40824,90048570.0,525,2023-11-10 12:10:00
754,BANE,98,246,12180042.0,27330130.0,5464,12360,2229.1,2211.2,17824,39510172.0,344,72,211,10375007.0,26263044.0,4740,11857,2188.8,2215.0,16597,36638051.0,283,2023-11-10 12:15:00
755,BANE,111,291,14871298.0,43369705.0,6727,19703,2210.7,2201.2,26430,58241003.0,402,80,242,12532342.0,37710303.0,5728,17032,2187.9,2214.1,22760,50242645.0,322,2023-11-10 12:20:00
756,BANE,197,238,37277010.0,25990679.0,17089,11878,2181.3,2188.1,28967,63267689.0,435,145,174,29742257.0,21184891.0,13669,9574,2175.9,2212.8,23243,50927148.0,319,2023-11-10 12:25:00
757,BANE,233,387,47740452.0,54048337.0,21034,25203,2269.7,2144.5,46237,101788789.0,620,140,294,38639187.0,46035889.0,17785,20870,2172.6,2205.8,38655,84675077.0,434,2023-11-10 12:30:00
758,BANE,539,185,63514149.0,22038058.0,28444,10023,2233.0,2198.7,38467,85552207.0,724,495,123,58055901.0,16341213.0,25725,7427,2256.8,2200.2,33152,74397114.0,618,2023-11-10 12:35:00
759,BANE,368,261,31852912.0,16996376.0,14352,7765,2219.4,2188.8,22117,48849289.0,629,325,208,25301989.0,14584440.0,11541,6609,2192.4,2206.8,18150,39886429.0,533,2023-11-10 12:40:00
760,BANE,274,489,33406482.0,37035328.0,15266,17108,2188.3,2164.8,32374,70441810.0,763,226,459,32346765.0,39235186.0,14833,17783,2180.7,2206.3,32616,71581951.0,685,2023-11-10 12:45:00
761,BANE,374,238,50055840.0,24974147.0,22086,11987,2266.4,2083.4,34073,75029987.0,612,344,214,44882873.0,20182796.0,20604,9155,2178.4,2204.6,29759,65065669.0,558,2023-11-10 12:50:00
762,BANE,1083,494,92604147.0,34099308.0,42326,15534,2187.9,2195.1,57860,126703455.0,1577,1047,463,87730573.0,34206944.0,40153,15526,2184.9,2203.2,55679,121937517.0,1510,2023-11-10 12:55:00
763,BANE,1098,422,93385052.0,29443576.0,42669,13369,2188.6,2202.4,56038,122828629.0,1520,1059,391,90552725.0,33447874.0,41373,15150,2188.7,2207.8,56523,124000599.0,1450,2023-11-10 13:00:00
764,BANE,708,242,66578144.0,35828749.0,30384,16267,2191.2,2202.5,46651,102406894.0,950,644,193,62658526.0,31540881.0,28754,14273,2179.1,2209.8,43027,94199407.0,837,2023-11-10 13:05:00
765,BANE,1351,424,127677278.0,35741891.0,58367,16271,2187.5,2196.7,74638,163419169.0,1775,1262,338,126370777.0,33737149.0,57775,15293,2187.3,2206.1,73068,160107926.0,1600,2023-11-10 13:10:00
766,BANE,1104,252,104920156.0,30968794.0,47928,14028,2189.1,2207.6,61956,135888950.0,1356,1037,220,102470834.0,31161206.0,46838,14110,2187.8,2208.4,60948,133632040.0,1257,2023-11-10 13:15:00
767,BANE,935,1217,157564016.0,151715585.0,72145,70208,2184.0,2160.9,142353,309279601.0,2152,795,1116,146318042.0,140393084.0,67122,63746,2179.9,2202.4,130868,286711126.0,1911,2023-11-10 13:20:00
768,BANE,584,1009,32483385.0,117786703.0,14857,53597,2186.4,2197.6,68454,150270088.0,1593,523,983,30762731.0,117220355.0,14107,53340,2180.7,2197.6,67447,147983086.0,1506,2023-11-10 13:25:00
769,BANE,1898,738,272424567.0,97263261.0,124806,44336,2182.8,2193.8,169142,369687829.0,2636,1789,665,268695862.0,94205407.0,123111,42819,2182.5,2200.1,165930,362901269.0,2454,2023-11-10 13:30:00
770,BANE,313,808,22488013.0,60221964.0,10330,27467,2177.0,2192.5,37797,82709977.0,1121,247,777,19358235.0,59265928.0,8906,26982,2173.6,2196.5,35888,78624164.0,1024,2023-11-10 13:35:00
771,BANE,601,404,55476968.0,54966625.0,25468,25155,2178.3,2185.1,50623,110443594.0,1005,524,358,54113720.0,54417723.0,24883,24752,2174.7,2198.5,49635,108531443.0,882,2023-11-10 13:40:00
772,BANE,324,192,29311458.0,27231672.0,13463,12357,2177.2,2203.7,25820,56543130.0,516,275,164,26224619.0,24484246.0,12060,11129,2174.5,2200.0,23189,50708865.0,439,2023-11-10 13:45:00
773,BANE,489,319,41478736.0,35554441.0,19022,16124,2180.6,2205.1,35146,77033177.0,808,433,273,40997806.0,34065956.0,18819,15401,2178.5,2211.9,34220,75063762.0,706,2023-11-10 13:50:00
774,BANE,382,200,24400995.0,19405862.0,11167,8830,2185.1,2197.7,19997,43806857.0,582,336,164,23141555.0,18270566.0,10607,8298,2181.7,2201.8,18905,41412122.0,500,2023-11-10 13:55:00
775,BANE,607,253,42556398.0,17012003.0,19480,7765,2184.6,2190.9,27245,59568401.0,860,557,226,40973344.0,16513850.0,18772,7476,2182.7,2208.9,26248,57487194.0,783,2023-11-10 14:00:00
776,BANE,391,821,21352772.0,39931602.0,9814,18460,2175.7,2163.1,28274,61284374.0,1212,301,759,19437438.0,37341302.0,8942,16957,2173.7,2202.1,25899,56778741.0,1060,2023-11-10 14:05:00
777,BANE,325,511,17971439.0,31308265.0,8275,14325,2171.8,2185.6,22600,49279705.0,836,287,488,17892754.0,30922945.0,8246,14113,2169.9,2191.1,22359,48815699.0,775,2023-11-10 14:10:00
778,BANE,377,1011,17290125.0,95308986.0,7961,43774,2171.9,2177.3,51735,112599111.0,1388,302,957,16343541.0,91875067.0,7535,41909,2169.0,2192.3,49444,108218608.0,1259,2023-11-10 14:15:00
779,BANE,326,209,12406287.0,17642232.0,5711,8065,2172.3,2187.5,13776,30048519.0,535,286,182,11009710.0,13678651.0,5074,6241,2169.8,2191.7,11315,24688361.0,468,2023-11-10 14:20:00
780,BANE,640,696,118520440.0,64548223.0,53862,29434,2200.4,2193.0,83296,183068663.0,1336,567,642,103955655.0,61987230.0,47746,28228,2177.3,2195.9,75974,165942886.0,1209,2023-11-10 14:25:00
781,BANE,344,309,17892615.0,18602333.0,8141,8531,2197.8,2180.6,16672,36494949.0,653,260,269,17207413.0,17146856.0,7874,7789,2185.3,2201.4,15663,34354269.0,529,2023-11-10 14:30:00
782,BANE,457,202,55884719.0,15394909.0,19859,7047,2814.1,2184.6,26906,71279628.0,659,385,134,46764871.0,9228896.0,17543,4185,2665.7,2205.2,21728,55993767.0,519,2023-11-10 14:35:00
783,BANE,555,315,65219031.0,32834369.0,29737,14924,2193.2,2200.1,44661,98053400.0,870,423,222,61712355.0,27767675.0,28172,12545,2190.6,2213.4,40717,89480030.0,645,2023-11-10 14:40:00
784,BANE,464,411,43139384.0,25692600.0,19646,11619,2195.8,2211.3,31265,68831985.0,875,405,366,42600102.0,26143349.0,19470,11814,2188.0,2212.9,31284,68743451.0,771,2023-11-10 14:45:00
785,BANE,552,149,43750944.0,11522255.0,18751,5237,2333.3,2200.2,23988,55273199.0,701,483,89,42623107.0,9993538.0,18371,4524,2320.1,2209.0,22895,52616646.0,572,2023-11-10 14:50:00
786,BANE,200,52,18195259.0,3674408.0,8260,1678,2202.8,2189.8,9938,21869667.0,252,146,28,17996394.0,3070321.0,8204,1389,2193.6,2210.5,9593,21066715.0,174,2023-11-10 14:55:00
787,BANE,263,110,20301643.0,11065861.0,9091,5045,2233.2,2193.4,14136,31367504.0,373,217,62,19443462.0,8425629.0,8886,3807,2188.1,2213.2,12693,27869092.0,279,2023-11-10 15:00:00
788,BANE,1868,1044,347966328.0,140017846.0,150643,63082,2309.9,2219.6,213725,487984174.0,2912,1373,739,298770826.0,116353550.0,133523,52270,2237.6,2226.0,185793,415124376.0,2112,2023-11-10 15:05:00
789,BANE,1527,865,195778117.0,153149113.0,80280,67819,2438.7,2258.2,148099,348927230.0,2392,806,567,178454241.0,138517172.0,72780,61586,2452.0,2249.2,134366,316971413.0,1373,2023-11-10 15:10:00
790,BANE,1051,677,169264282.0,101169618.0,71896,44259,2354.3,2285.9,116155,270433901.0,1728,889,319,165346387.0,77064824.0,67460,33179,2451.0,2322.7,100639,242411212.0,1208,2023-11-10 15:15:00
791,BANE,761,883,122924117.0,128976387.0,55167,58295,2228.2,2212.5,113462,251900505.0,1644,550,748,98023699.0,108232248.0,44104,47562,2222.6,2275.6,91666,206255948.0,1298,2023-11-10 15:20:00
792,BANE,420,707,86615279.0,65167585.0,36141,29606,2396.6,2201.2,65747,151782864.0,1127,312,627,71430145.0,57726108.0,32165,25726,2220.7,2243.9,57891,129156253.0,939,2023-11-10 15:25:00
793,BANE,698,2636,114654482.0,134621869.0,51621,60480,2221.1,2225.9,112101,249276351.0,3334,509,784,95473365.0,120204443.0,43199,53675,2210.1,2239.5,96874,215677808.0,1293,2023-11-10 15:30:00
794,BANE,410,229,51793326.0,27394244.0,23405,12384,2212.9,2212.1,35789,79187571.0,639,347,181,47099544.0,17926705.0,21381,8020,2202.9,2235.2,29401,65026249.0,528,2023-11-10 15:35:00
795,BANE,1440,728,215273889.0,108511571.0,96652,49638,2227.3,2186.1,146290,323785460.0,2168,1248,593,191297847.0,93878143.0,86518,42060,2211.1,2232.0,128578,285175990.0,1841,2023-11-10 15:40:00
796,BANE,1104,554,133588852.0,63665091.0,60325,28615,2214.5,2224.9,88940,197253943.0,1658,1019,462,133188159.0,56730969.0,58285,25309,2285.1,2241.5,83594,189919128.0,1481,2023-11-10 15:45:00
797,BANE,740,479,93735078.0,40730744.0,42267,18267,2217.7,2229.7,60534,134465823.0,1219,624,417,93549279.0,38189466.0,41411,17038,2259.0,2241.4,58449,131738745.0,1041,2023-11-10 15:50:00
798,BANE,252,57,13938894.0,3276942.0,6264,1504,2225.2,2178.8,7768,17215836.0,309,210,26,13690866.0,789424.0,6177,353,2216.4,2236.3,6530,14480291.0,236,2023-11-10 15:55:00
799,BANE,828,705,94731601.0,69917146.0,42723,31384,2217.3,2227.8,74107,164648747.0,1533,716,592,89198915.0,63679316.0,40336,28478,2211.4,2236.1,68814,152878231.0,1308,2023-11-10 16:00:00
800,BANE,511,594,62739992.0,61564290.0,28337,27597,2214.1,2230.8,55934,124304282.0,1105,424,559,54056013.0,58880948.0,24444,26389,2211.4,2231.3,50833,112936961.0,983,2023-11-10 16:05:00
801,BANE,385,260,47722173.0,31654006.0,21577,14248,2211.7,2221.6,35825,79376179.0,645,334,199,44626243.0,28412286.0,20206,12739,2208.6,2230.3,32945,73038530.0,533,2023-11-10 16:10:00
802,BANE,818,588,102406390.0,68343735.0,46151,30689,2218.9,2227.0,76840,170750125.0,1406,742,529,99358009.0,65717525.0,44936,29395,2211.1,2235.7,74331,165075534.0,1271,2023-11-10 16:15:00
803,BANE,624,175,58321253.0,21473968.0,26305,9701,2217.1,2213.6,36006,79795221.0,799,551,122,56476136.0,16867164.0,25529,7534,2212.2,2238.8,33063,73343300.0,673,2023-11-10 16:20:00
804,BANE,590,406,77813548.0,34941741.0,35029,15953,2221.4,2190.3,50982,112755290.0,996,487,332,71817251.0,30749370.0,32434,13734,2214.3,2238.9,46168,102566621.0,819,2023-11-10 16:25:00
805,BANE,665,268,86528904.0,28812899.0,39109,12978,2212.5,2220.1,52087,115341803.0,933,593,224,84880911.0,23796960.0,38396,10644,2210.7,2235.7,49040,108677871.0,817,2023-11-10 16:30:00
806,BANE,473,283,53351011.0,38184983.0,23992,17071,2223.7,2236.8,41063,91535995.0,756,397,211,47122978.0,38555308.0,21332,17203,2209.0,2241.2,38535,85678286.0,608,2023-11-10 16:35:00
807,BANE,280,125,28140320.0,18883077.0,12693,8477,2217.0,2227.6,21170,47023397.0,405,222,97,24099995.0,18503980.0,10881,8256,2214.9,2241.3,19137,42603975.0,319,2023-11-10 16:40:00
808,BANE,386,225,35086463.0,28296530.0,15822,12743,2217.6,2220.6,28565,63382993.0,611,302,196,32671553.0,27594127.0,14757,12321,2214.0,2239.6,27078,60265680.0,498,2023-11-10 16:45:00
809,BANE,401,233,48907833.0,39613667.0,21890,17659,2234.3,2243.3,39549,88521501.0,634,318,141,43502802.0,33469511.0,19653,14894,2213.5,2247.2,34547,76972313.0,459,2023-11-10 16:50:00
810,BANE,292,159,31285765.0,14202449.0,14065,6412,2224.4,2215.0,20477,45488214.0,451,222,105,27304700.0,12955851.0,12301,5770,2219.7,2245.4,18071,40260551.0,327,2023-11-10 16:55:00
811,BANE,336,336,29372591.0,23194009.0,13192,10591,2226.5,2190.0,23783,52566600.0,672,278,302,27628555.0,21285912.0,12441,9492,2220.8,2242.5,21933,48914468.0,580,2023-11-10 17:00:00
812,BANE,353,152,24862832.0,18906838.0,11161,8429,2227.7,2243.1,19590,43769670.0,505,314,118,22305773.0,20908976.0,10073,9125,2214.4,2291.4,19198,43214749.0,432,2023-11-10 17:05:00
813,BANE,386,117,48466624.0,20403514.0,21708,8891,2232.7,2294.9,30599,68870138.0,503,323,75,45050839.0,13563982.0,20292,6039,2220.1,2246.1,26331,58614821.0,398,2023-11-10 17:10:00
814,BANE,290,61,21994206.0,6934607.0,9842,3096,2234.7,2239.9,12938,28928813.0,351,240,30,20489059.0,12378389.0,9221,5506,2222.0,2248.2,14727,32867449.0,270,2023-11-10 17:15:00
815,BANE,272,163,23683557.0,24181374.0,10656,11010,2222.6,2196.3,21666,47864932.0,435,202,119,22113714.0,21513251.0,9958,9578,2220.7,2246.1,19536,43626965.0,321,2023-11-10 17:20:00
816,BANE,597,594,68560313.0,78101418.0,30891,34967,2219.4,2233.6,65858,146661731.0,1191,482,535,64091430.0,73613793.0,28914,32822,2216.6,2242.8,61736,137705223.0,1017,2023-11-10 17:25:00
817,BANE,338,244,35174459.0,29001039.0,15744,13025,2234.2,2226.6,28769,64175498.0,582,273,209,30855876.0,29286580.0,13913,13052,2217.8,2243.8,26965,60142456.0,482,2023-11-10 17:30:00
818,BANE,551,233,60176474.0,38805753.0,27022,17276,2226.9,2246.2,44298,98982228.0,784,466,138,55685889.0,30680435.0,25140,13660,2215.0,2246.0,38800,86366325.0,604,2023-11-10 17:35:00
819,BANE,340,110,42623644.0,14304916.0,19129,6400,2228.2,2235.1,25529,56928561.0,450,279,67,40533128.0,13498469.0,18300,5965,2214.9,2262.9,24265,54031598.0,346,2023-11-10 17:40:00
820,BANE,280,73,16299945.0,6890852.0,7320,3167,2226.8,2175.8,10487,23190797.0,353,225,54,13995385.0,5261331.0,6288,2344,2225.7,2244.6,8632,19256717.0,279,2023-11-10 17:45:00
821,BANE,229,172,13470001.0,19588352.0,6070,8808,2219.1,2223.9,14878,33058353.0,401,164,143,13019100.0,16949169.0,5864,7567,2220.2,2239.9,13431,29968270.0,307,2023-11-10 17:50:00
822,BANE,117,75,6616801.0,10297771.0,2968,4623,2229.4,2227.5,7591,16914572.0,192,79,65,4669323.0,8010742.0,2099,3580,2224.5,2237.6,5679,12680066.0,144,2023-11-10 17:55:00
823,BANE,250,205,29092367.0,15603852.0,12957,6984,2245.3,2234.2,19941,44696220.0,455,189,184,22874100.0,15049647.0,10296,6724,2221.6,2238.2,17020,37923747.0,373,2023-11-10 18:00:00
824,BANE,711,321,123947809.0,48279078.0,55116,21466,2248.9,2249.1,76582,172226887.0,1032,612,250,107949293.0,45330276.0,48472,20152,2227.0,2249.4,68624,153279569.0,862,2023-11-10 18:05:00
825,BANE,1146,967,165078261.0,136335995.0,73251,60692,2253.6,2246.4,133943,301414256.0,2113,944,729,159252480.0,122826762.0,70443,54373,2260.7,2259.0,124816,282079243.0,1673,2023-11-10 18:10:00
826,BANE,916,857,135405199.0,103009190.0,60274,46369,2246.5,2221.5,106643,238414390.0,1773,792,773,126956156.0,98016693.0,56517,43512,2246.3,2252.6,100029,224972849.0,1565,2023-11-10 18:15:00
827,BANE,516,1144,56922294.0,136264169.0,25072,60726,2270.4,2243.9,85798,193186463.0,1660,456,1085,55832485.0,133050538.0,24604,58899,2269.2,2259.0,83503,188883023.0,1541,2023-11-10 18:20:00
828,BANE,533,334,71747955.0,37349441.0,30106,16587,2383.2,2251.7,46693,109097397.0,867,465,259,62863920.0,35192477.0,28219,15608,2227.7,2254.8,43827,98056397.0,724,2023-11-10 18:25:00
829,BANE,679,443,62890911.0,61588033.0,27833,27578,2259.6,2233.2,55411,124478944.0,1122,563,324,55645917.0,49692907.0,24865,22004,2237.9,2258.4,46869,105338824.0,887,2023-11-10 18:30:00
830,BANE,794,362,93037481.0,67420987.0,41102,30010,2263.6,2246.6,71112,160458468.0,1156,718,212,81521756.0,61835762.0,34363,27312,2372.4,2264.1,61675,143357519.0,930,2023-11-10 18:35:00
831,BANE,977,668,129524202.0,92193557.0,56976,37712,2273.3,2444.7,94688,221717759.0,1645,833,397,114042797.0,77477372.0,50579,31458,2254.7,2462.9,82037,191520169.0,1230,2023-11-10 18:40:00
832,BANE,2251,1210,309025149.0,176641019.0,131105,77484,2357.1,2279.7,208589,485666168.0,3461,1787,790,268276053.0,147585355.0,116668,64134,2299.5,2301.2,180802,415861408.0,2577,2023-11-13 10:05:00
833,BANE,2201,1955,279441439.0,275456801.0,121060,119711,2308.3,2301.0,240771,554898240.0,4156,1928,1424,257093266.0,251916761.0,111284,109222,2310.2,2306.5,220506,509010027.0,3352,2023-11-13 10:10:00
834,BANE,1611,2097,125493441.0,271997506.0,54277,118529,2312.1,2294.8,172806,397490947.0,3708,1459,1954,106907041.0,265173567.0,46558,115364,2296.2,2298.6,161922,372080608.0,3413,2023-11-13 10:15:00
835,BANE,697,937,52251770.0,81946397.0,23029,35913,2269.0,2281.8,58942,134198167.0,1634,549,820,49312436.0,76680592.0,21825,33353,2259.4,2299.1,55178,125993028.0,1369,2023-11-13 10:20:00
836,BANE,795,1008,83703663.0,119395050.0,36737,52894,2278.5,2257.3,89631,203098714.0,1803,646,878,77991306.0,102707536.0,34050,44938,2290.5,2285.5,78988,180698842.0,1524,2023-11-13 10:25:00
837,BANE,801,649,91716899.0,70368467.0,39806,31190,2304.1,2256.1,70996,162085366.0,1450,622,527,77287524.0,65024120.0,34024,28616,2271.6,2272.3,62640,142311644.0,1149,2023-11-13 10:30:00
838,BANE,975,759,108850839.0,112612173.0,45909,49792,2371.0,2261.7,95701,221463013.0,1734,876,674,104255243.0,106641757.0,43334,46999,2405.9,2269.0,90333,210897000.0,1550,2023-11-13 10:35:00
839,BANE,886,876,119322934.0,127812454.0,51881,56919,2299.9,2245.5,108800,247135388.0,1762,663,703,104026472.0,116295131.0,44990,51093,2312.2,2276.1,96083,220321603.0,1366,2023-11-13 10:40:00
840,BANE,634,401,75100519.0,54640772.0,33186,24262,2263.0,2252.1,57448,129741291.0,1035,562,323,68117377.0,51894526.0,30340,22812,2245.1,2274.9,53152,120011904.0,885,2023-11-13 10:45:00
841,BANE,412,321,47575648.0,47531543.0,21006,21019,2264.9,2261.4,42025,95107191.0,733,368,263,46020079.0,44234628.0,20628,19515,2231.0,2266.7,40143,90254707.0,631,2023-11-13 10:50:00
842,BANE,416,220,45265587.0,31318328.0,19802,13913,2285.9,2251.0,33715,76583915.0,636,366,176,41290898.0,29391880.0,18498,13005,2232.2,2260.0,31503,70682779.0,542,2023-11-13 10:55:00
843,BANE,243,226,18689143.0,23865138.0,8329,10629,2243.9,2245.3,18958,42554281.0,469,209,184,17387672.0,22654510.0,7768,10021,2238.4,2260.7,17789,40042182.0,393,2023-11-13 11:00:00
844,BANE,264,238,26466398.0,35146872.0,11373,15595,2327.1,2253.7,26968,61613270.0,502,219,203,25700139.0,28241396.0,11031,12505,2329.8,2258.4,23536,53941536.0,422,2023-11-13 11:05:00
845,BANE,548,362,31842365.0,46695483.0,13730,20672,2319.2,2258.9,34402,78537849.0,910,506,312,32332449.0,44589032.0,14484,19722,2232.3,2260.9,34206,76921482.0,818,2023-11-13 11:10:00
846,BANE,208,221,22176115.0,35207225.0,9871,15554,2246.6,2263.5,25425,57383341.0,429,187,187,22345872.0,34174634.0,9997,15075,2235.3,2267.0,25072,56520507.0,374,2023-11-13 11:15:00
847,BANE,395,336,35439160.0,47229667.0,15707,20865,2256.3,2263.6,36572,82668827.0,731,339,297,30732850.0,45373638.0,13721,20011,2239.8,2267.4,33732,76106488.0,636,2023-11-13 11:20:00
848,BANE,357,177,22556685.0,25185892.0,9977,11085,2260.9,2272.1,21062,47742577.0,534,317,130,20529689.0,24044640.0,9157,10577,2242.0,2273.3,19734,44574330.0,447,2023-11-13 11:25:00
849,BANE,495,529,60062118.0,75680325.0,26089,33248,2302.2,2276.2,59337,135742443.0,1024,441,420,54494373.0,63795300.0,24159,27982,2255.7,2279.9,52141,118289673.0,861,2023-11-13 11:30:00
850,BANE,503,346,50367092.0,33991693.0,22290,15042,2259.6,2259.8,37332,84358785.0,849,459,272,47230182.0,31041940.0,20939,13634,2255.6,2276.8,34573,78272122.0,731,2023-11-13 11:35:00
851,BANE,597,264,50997981.0,18614362.0,22584,8238,2258.1,2259.6,30822,69612343.0,861,563,199,47976658.0,15362693.0,21263,6757,2256.3,2273.6,28020,63339351.0,762,2023-11-13 11:40:00
852,BANE,382,570,44771950.0,42793960.0,19858,19092,2254.6,2241.5,38950,87565910.0,952,319,493,40867202.0,38728738.0,18172,17078,2248.9,2267.8,35250,79595941.0,812,2023-11-13 11:45:00
853,BANE,602,790,74797372.0,93789365.0,33194,41484,2253.3,2260.9,74678,168586738.0,1392,537,704,71206480.0,90713862.0,31701,39948,2246.2,2270.8,71649,161920342.0,1241,2023-11-13 11:50:00
854,BANE,347,495,37713718.0,35530356.0,16816,15731,2242.7,2258.6,32547,73244074.0,842,307,447,38627510.0,34089355.0,16404,15053,2354.8,2264.6,31457,72716865.0,754,2023-11-13 11:55:00
855,BANE,385,232,23448139.0,13026732.0,10393,5753,2256.1,2264.3,16146,36474872.0,617,335,170,21946087.0,11746620.0,9763,5175,2247.9,2269.9,14938,33692707.0,505,2023-11-13 12:00:00
856,BANE,810,469,44359702.0,61796000.0,19722,27233,2249.2,2269.2,46955,106155702.0,1279,771,417,41899955.0,59929554.0,18634,26352,2248.6,2274.2,44986,101829509.0,1188,2023-11-13 12:05:00
857,BANE,274,374,29464364.0,28550300.0,13120,12610,2245.8,2264.1,25730,58014665.0,648,244,333,25603613.0,27109385.0,11430,11951,2240.0,2268.4,23381,52712999.0,577,2023-11-13 12:10:00
858,BANE,357,248,28961410.0,18343201.0,12913,8141,2242.8,2253.2,21054,47304612.0,605,318,197,25309432.0,14870877.0,11283,6573,2243.1,2262.4,17856,40180309.0,515,2023-11-13 12:15:00
859,BANE,217,341,12576139.0,23523892.0,5607,10481,2242.9,2244.4,16088,36100031.0,558,190,302,10111381.0,22070742.0,4515,9791,2239.5,2254.2,14306,32182123.0,492,2023-11-13 12:20:00
860,BANE,161,148,8142610.0,7977439.0,3610,3545,2255.6,2250.3,7155,16120050.0,309,119,99,8518684.0,7247744.0,3799,3213,2242.3,2255.8,7012,15766428.0,218,2023-11-13 12:25:00
861,BANE,111,120,8992255.0,8924768.0,4014,3976,2240.2,2244.7,7990,17917024.0,231,79,92,5439404.0,7892971.0,2431,3493,2237.5,2259.7,5924,13332375.0,171,2023-11-13 12:30:00
862,BANE,121,103,13305393.0,13831053.0,5807,6116,2291.3,2261.5,11923,27136446.0,224,102,63,12011045.0,12945723.0,5377,5714,2233.8,2265.6,11091,24956768.0,165,2023-11-13 12:35:00
863,BANE,211,351,17648689.0,30572777.0,7845,13506,2249.7,2263.6,21351,48221466.0,562,167,290,15476473.0,29429806.0,6908,12994,2240.4,2264.9,19902,44906279.0,457,2023-11-13 12:40:00
864,BANE,198,273,13604442.0,30158503.0,6057,13330,2246.1,2262.5,19387,43762945.0,471,180,230,13778316.0,29285611.0,6142,12935,2243.3,2264.1,19077,43063927.0,410,2023-11-13 12:45:00
865,BANE,110,153,4935157.0,9302065.0,2206,4174,2237.2,2228.6,6380,14237222.0,263,84,115,5902869.0,8568813.0,2637,3795,2238.5,2257.9,6432,14471682.0,199,2023-11-13 12:50:00
866,BANE,142,459,17676717.0,49029475.0,7857,22030,2249.8,2225.6,29887,66706192.0,601,112,396,15780111.0,43262501.0,7067,19141,2232.9,2260.2,26208,59042613.0,508,2023-11-13 12:55:00
867,BANE,392,1011,70697938.0,118423493.0,31539,52868,2241.6,2240.0,84407,189121431.0,1403,254,637,56307739.0,102835051.0,25355,45681,2220.8,2251.2,71036,159142790.0,891,2023-11-13 13:00:00
868,BANE,111,208,10690764.0,15120228.0,4257,6758,2511.3,2237.4,11015,25810993.0,319,61,165,8953587.0,14750546.0,3773,6577,2373.1,2242.7,10350,23704134.0,226,2023-11-13 13:05:00
869,BANE,129,238,16905723.0,23905758.0,7557,10664,2237.1,2241.7,18221,40811481.0,367,71,180,15575690.0,22704763.0,7016,10081,2220.0,2252.2,17097,38280454.0,251,2023-11-13 13:10:00
870,BANE,108,421,14977772.0,41039726.0,6723,18330,2227.8,2238.9,25053,56017498.0,529,59,369,11544729.0,40015487.0,5203,17811,2218.9,2246.7,23014,51560217.0,428,2023-11-13 13:15:00
871,BANE,97,226,12446171.0,32871168.0,5588,14632,2227.3,2246.5,20220,45317339.0,323,44,169,9439331.0,31263630.0,4254,13898,2218.9,2249.5,18152,40702961.0,213,2023-11-13 13:20:00
872,BANE,90,120,11142270.0,7387237.0,4999,3301,2228.9,2237.9,8300,18529507.0,210,51,83,12788869.0,6499437.0,5763,2897,2219.1,2243.5,8660,19288307.0,134,2023-11-13 13:25:00
873,BANE,70,106,5699797.0,8288158.0,2555,3709,2230.8,2234.6,6264,13987955.0,176,45,66,5576006.0,7533249.0,2502,3357,2228.6,2244.0,5859,13109255.0,111,2023-11-13 13:30:00
874,BANE,74,129,6053207.0,8572234.0,2698,3895,2243.6,2200.8,6593,14625441.0,203,57,77,5485296.0,6696812.0,2471,2989,2219.9,2240.5,5460,12182108.0,134,2023-11-13 13:35:00
875,BANE,32,87,2572187.0,7246956.0,1158,3236,2221.2,2239.5,4394,9819143.0,119,26,64,2442044.0,6801400.0,1098,3036,2224.1,2240.3,4134,9243444.0,90,2023-11-13 13:40:00
876,BANE,119,167,18079900.0,31159695.0,8068,13903,2240.9,2241.2,21971,49239596.0,286,81,130,15025348.0,30103159.0,6764,13375,2221.4,2250.7,20139,45128507.0,211,2023-11-13 13:45:00
877,BANE,155,151,20895869.0,21265879.0,9335,9436,2238.4,2253.7,18771,42161748.0,306,110,80,18630312.0,18293996.0,8372,8115,2225.3,2254.3,16487,36924309.0,190,2023-11-13 13:50:00
878,BANE,61,110,10240148.0,9480062.0,4558,4218,2246.6,2247.5,8776,19720211.0,171,51,72,10005107.0,9633018.0,4483,4275,2231.8,2253.3,8758,19638125.0,123,2023-11-13 13:55:00
879,BANE,127,138,18527725.0,20024792.0,8242,8899,2248.0,2250.2,17141,38552517.0,265,109,105,16783167.0,19628642.0,7528,8717,2229.4,2251.8,16245,36411809.0,214,2023-11-13 14:00:00
880,BANE,140,147,22241260.0,24110960.0,9279,10680,2396.9,2257.6,19959,46352221.0,287,110,107,18518547.0,22962560.0,8296,10154,2232.2,2261.4,18450,41481108.0,217,2023-11-13 14:05:00
881,BANE,206,242,34171724.0,35401166.0,15015,15695,2275.8,2255.6,30710,69572890.0,448,176,186,31376265.0,32382293.0,14012,14349,2239.2,2256.8,28361,63758559.0,362,2023-11-13 14:10:00
882,BANE,89,147,14032569.0,13386305.0,6269,6000,2238.4,2231.1,12269,27418874.0,236,73,98,13172399.0,11918844.0,5887,5278,2237.5,2258.2,11165,25091244.0,171,2023-11-13 14:15:00
883,BANE,52,140,8934318.0,13425640.0,3331,6015,2682.2,2232.0,9346,22359958.0,192,37,105,7121251.0,13506511.0,2601,5996,2737.9,2252.6,8597,20627763.0,142,2023-11-13 14:20:00
884,BANE,85,192,12747109.0,29803533.0,5027,13217,2535.7,2254.9,18244,42550643.0,277,75,160,12893579.0,32669925.0,5100,14424,2528.2,2265.0,19524,45563505.0,235,2023-11-13 14:25:00
885,BANE,95,138,28765535.0,19439337.0,12887,8636,2232.1,2251.0,21523,48204872.0,233,82,103,27679051.0,19792843.0,12400,8774,2232.2,2255.9,21174,47471895.0,185,2023-11-13 14:30:00
886,BANE,115,122,19417245.0,26690133.0,8234,11829,2358.2,2256.3,20063,46107378.0,237,102,88,21019770.0,26120115.0,8743,11576,2404.2,2256.4,20319,47139885.0,190,2023-11-13 14:35:00
887,BANE,166,205,15365017.0,21432972.0,6871,9518,2236.2,2251.8,16389,36797989.0,371,119,150,14611190.0,20707169.0,6536,9192,2235.5,2252.7,15728,35318359.0,269,2023-11-13 14:40:00
888,BANE,211,270,18616308.0,33248026.0,8340,14743,2232.2,2255.2,23083,51864334.0,481,118,192,19649763.0,32679945.0,8805,14486,2231.7,2256.0,23291,52329709.0,310,2023-11-13 14:45:00
889,BANE,125,284,22025728.0,27359483.0,9920,12159,2220.3,2250.1,22079,49385211.0,409,86,214,19041869.0,26040978.0,8569,11546,2222.2,2255.4,20115,45082847.0,300,2023-11-13 14:50:00
890,BANE,80,145,20891949.0,12660329.0,9406,5624,2221.1,2251.1,15030,33552278.0,225,54,92,15772121.0,11057841.0,7107,4901,2219.2,2256.2,12008,26829962.0,146,2023-11-13 14:55:00
891,BANE,93,138,19630042.0,18768470.0,8414,8358,2333.0,2245.6,16772,38398513.0,231,64,97,18005030.0,16658035.0,7678,7395,2345.0,2252.6,15073,34663065.0,161,2023-11-13 15:00:00
892,BANE,49,274,10366009.0,14120914.0,4668,6260,2220.7,2255.7,10928,24486923.0,323,36,246,8474296.0,13873639.0,3831,6144,2212.0,2258.1,9975,22347936.0,282,2023-11-13 15:05:00
893,BANE,231,538,36835167.0,75623476.0,16465,33559,2237.2,2253.4,50024,112458644.0,769,206,500,36473582.0,75462177.0,15931,33478,2289.5,2254.1,49409,111935759.0,706,2023-11-13 15:10:00
894,BANE,1104,750,211641460.0,175464439.0,93568,77321,2261.9,2269.3,170889,387105900.0,1854,958,563,200622347.0,154825962.0,89565,68225,2240.0,2269.3,157790,355448309.0,1521,2023-11-13 15:15:00
895,BANE,569,324,102129592.0,55793517.0,44539,24654,2293.0,2263.1,69193,157923109.0,893,489,253,95488671.0,51497274.0,42213,22719,2262.1,2266.7,64932,146985945.0,742,2023-11-13 15:20:00
896,BANE,1018,2217,184674776.0,636587399.0,80607,281337,2291.1,2262.7,361944,821262175.0,3235,881,2045,169896186.0,618335087.0,74518,273171,2279.9,2263.5,347689,788231273.0,2926,2023-11-13 15:25:00
897,BANE,223,169,27283686.0,31094203.0,12123,13738,2250.6,2263.4,25861,58377889.0,392,157,130,22766027.0,30404417.0,10137,13410,2245.8,2267.3,23547,53170444.0,287,2023-11-13 15:30:00
898,BANE,284,394,53342875.0,57502909.0,22909,25559,2328.5,2249.8,48468,110845784.0,678,225,316,47772162.0,58597331.0,20507,25906,2329.6,2261.9,46413,106369493.0,541,2023-11-13 15:35:00
899,BANE,212,445,47749605.0,59836748.0,20759,26527,2300.2,2255.7,47286,107586354.0,657,154,382,44969234.0,54557762.0,19410,24151,2316.8,2259.0,43561,99526996.0,536,2023-11-13 15:40:00
900,BANE,184,294,24981190.0,31695162.0,10892,14059,2293.5,2254.4,24951,56676352.0,478,138,248,23390350.0,28781679.0,10210,12751,2290.9,2257.2,22961,52172030.0,386,2023-11-13 15:45:00
901,BANE,582,572,154060234.0,102302469.0,67809,45244,2272.0,2261.1,113053,256362703.0,1154,554,473,148755202.0,93215579.0,66104,41165,2250.3,2264.4,107269,241970781.0,1027,2023-11-13 15:50:00
902,BANE,192,166,31922304.0,24271679.0,14236,10334,2242.4,2348.7,24570,56193983.0,358,166,125,37026425.0,21152449.0,16364,9136,2262.7,2315.3,25500,58178874.0,291,2023-11-13 15:55:00
903,BANE,287,224,63133336.0,47773672.0,27752,21066,2274.9,2267.8,48818,110907008.0,511,259,174,56832291.0,46655915.0,25284,20555,2247.8,2269.8,45839,103488206.0,433,2023-11-13 16:00:00
904,BANE,69,75,6058411.0,6073189.0,2684,2684,2257.2,2262.7,5368,12131600.0,144,46,32,4828611.0,5313109.0,2147,2341,2249.0,2269.6,4488,10141720.0,78,2023-11-13 16:05:00
905,BANE,199,285,33886701.0,26348718.0,15082,11665,2246.8,2258.8,26747,60235419.0,484,165,239,31560709.0,24845799.0,14051,10779,2246.2,2305.0,24830,56406509.0,404,2023-11-13 16:10:00
906,BANE,252,255,43919883.0,28511934.0,19482,12817,2254.4,2224.5,32299,72431818.0,507,206,199,41599259.0,24540255.0,18515,10866,2246.8,2258.4,29381,66139514.0,405,2023-11-13 16:15:00
907,BANE,1424,217,454768183.0,19081523.0,202100,8649,2250.2,2206.2,210749,473849706.0,1641,1370,176,453130618.0,18033227.0,201375,7975,2250.2,2261.2,209350,471163845.0,1546,2023-11-13 16:20:00
908,BANE,153,176,22202912.0,15482825.0,9903,6893,2242.0,2246.2,16796,37685737.0,329,113,143,20464618.0,15292431.0,9133,6768,2240.7,2259.5,15901,35757049.0,256,2023-11-13 16:25:00
909,BANE,145,224,16475693.0,20729313.0,7314,9179,2252.6,2258.3,16493,37205006.0,369,111,155,15873232.0,18369383.0,7076,8113,2243.2,2264.2,15189,34242616.0,266,2023-11-13 16:30:00
910,BANE,107,161,17096595.0,10595878.0,7629,4740,2241.0,2235.4,12369,27692473.0,268,81,113,16512791.0,10203531.0,7376,4516,2238.7,2259.4,11892,26716322.0,194,2023-11-13 16:35:00
911,BANE,178,280,33029857.0,29301473.0,14752,13089,2239.0,2238.6,27841,62331330.0,458,164,242,32294583.0,27986431.0,14431,12375,2237.9,2261.5,26806,60281014.0,406,2023-11-13 16:40:00
912,BANE,109,163,17835397.0,23674577.0,7958,10469,2241.2,2261.4,18427,41509975.0,272,67,122,9913741.0,22898766.0,4427,10119,2239.4,2262.9,14546,32812507.0,189,2023-11-13 16:45:00
913,BANE,136,175,17498532.0,17063472.0,7172,7560,2439.8,2257.1,14732,34562005.0,311,95,133,14774390.0,15966354.0,6388,7067,2312.8,2259.3,13455,30740744.0,228,2023-11-13 16:50:00
914,BANE,105,191,13182086.0,20839640.0,5898,9283,2235.0,2244.9,15181,34021726.0,296,74,138,12152891.0,18302744.0,5446,8115,2231.5,2255.4,13561,30455635.0,212,2023-11-13 16:55:00
915,BANE,190,216,40324171.0,34735548.0,17564,14595,2295.8,2380.0,32159,75059719.0,406,136,165,26500056.0,32961025.0,11436,14165,2317.2,2326.9,25601,59461082.0,301,2023-11-13 17:00:00
916,BANE,223,312,41513133.0,50793095.0,18542,22504,2238.9,2257.1,41046,92306229.0,535,177,259,51703125.0,45987342.0,23106,20338,2237.6,2261.2,43444,97690468.0,436,2023-11-13 17:05:00
917,BANE,593,605,121718204.0,124287246.0,53386,54764,2280.0,2269.5,108150,246005450.0,1198,462,443,100761972.0,110924100.0,44325,48920,2273.3,2267.5,93245,211686072.0,905,2023-11-13 17:10:00
918,BANE,448,368,63771235.0,53014910.0,28241,23396,2258.1,2266.0,51637,116786145.0,816,361,254,62929574.0,51618900.0,28066,22743,2242.2,2269.7,50809,114548474.0,615,2023-11-13 17:15:00
919,BANE,323,141,36432229.0,15634647.0,16207,6945,2247.9,2251.2,23152,52066876.0,464,291,100,28155783.0,15077609.0,12538,6655,2245.6,2265.6,19193,43233393.0,391,2023-11-13 17:20:00
920,BANE,164,132,18244263.0,12005734.0,8099,5308,2252.7,2261.8,13407,30249997.0,296,147,69,16071050.0,8362242.0,7173,3694,2240.5,2263.7,10867,24433292.0,216,2023-11-13 17:25:00
921,BANE,186,213,34309915.0,42329273.0,15309,19273,2241.2,2196.3,34582,76639188.0,399,131,160,21677072.0,30602374.0,9697,13162,2235.4,2325.1,22859,52279446.0,291,2023-11-13 17:30:00
922,BANE,404,198,89477915.0,39191770.0,39205,16668,2282.3,2351.3,55873,128669685.0,602,276,107,79650582.0,36734513.0,35425,15482,2248.4,2372.7,50907,116385095.0,383,2023-11-13 17:35:00
923,BANE,331,256,55946243.0,44384900.0,23860,19469,2344.8,2279.8,43329,100331144.0,587,198,167,52836581.0,43055854.0,22156,18712,2384.8,2301.0,40868,95892435.0,365,2023-11-13 17:40:00
924,BANE,234,225,24818098.0,50995681.0,10545,21781,2353.5,2341.3,32326,75813780.0,459,138,180,44284498.0,47018258.0,19350,19942,2288.6,2357.8,39292,91302756.0,318,2023-11-13 17:45:00
925,BANE,178,341,20032841.0,57507076.0,8384,25602,2389.4,2246.2,33986,77539918.0,519,125,273,10328495.0,54147921.0,4287,23631,2409.3,2291.4,27918,64476416.0,398,2023-11-13 17:50:00
926,BANE,100,162,14628217.0,26358722.0,6559,11723,2230.3,2248.5,18282,40986939.0,262,58,122,14953719.0,27184450.0,6151,12067,2431.1,2252.8,18218,42138169.0,180,2023-11-13 17:55:00
927,BANE,207,435,26940353.0,89989314.0,12073,40018,2231.5,2248.7,52091,116929667.0,642,148,340,33137915.0,86811991.0,14383,38555,2304.0,2251.6,52938,119949906.0,488,2023-11-13 18:00:00
928,BANE,238,409,35694657.0,81356568.0,16039,36150,2225.5,2250.5,52189,117051225.0,647,178,363,32686263.0,80745692.0,14707,35870,2222.5,2251.1,50577,113431955.0,541,2023-11-13 18:05:00
929,BANE,774,452,85226187.0,74965604.0,38171,33302,2232.7,2251.1,71473,160191791.0,1226,696,385,85980302.0,73714728.0,38579,32748,2228.7,2251.0,71327,159695030.0,1081,2023-11-13 18:10:00
930,BANE,2403,1119,610812009.0,174156671.0,272164,77361,2244.3,2251.2,349525,784968681.0,3522,2350,1033,604666835.0,168506903.0,270201,74851,2237.8,2251.2,345052,773173738.0,3383,2023-11-13 18:15:00
931,BANE,258,522,50691114.0,69768494.0,22689,30998,2234.2,2250.7,53687,120459608.0,780,225,480,48086490.0,68485188.0,21525,30423,2234.0,2251.1,51948,116571678.0,705,2023-11-13 18:20:00
932,BANE,151,567,18963233.0,75140653.0,8479,33461,2236.5,2245.6,41940,94103886.0,718,135,545,25299046.0,73156691.0,11371,32558,2224.9,2247.0,43929,98455737.0,680,2023-11-13 18:25:00
933,BANE,146,139,17924898.0,24122947.0,7558,10738,2371.6,2246.5,18296,42047845.0,285,121,126,15195681.0,23608121.0,6383,10482,2380.6,2252.3,16865,38803802.0,247,2023-11-13 18:30:00
934,BANE,129,112,15718072.0,13292013.0,7030,5945,2235.9,2235.8,12975,29010085.0,241,123,97,14409211.0,13398029.0,6475,5946,2225.4,2253.3,12421,27807240.0,220,2023-11-13 18:35:00
935,BANE,129,137,13275847.0,24679197.0,5876,11018,2259.3,2239.9,16894,37955045.0,266,125,132,14756536.0,26282308.0,6185,11688,2385.9,2248.7,17873,41038845.0,257,2023-11-13 18:40:00
936,BANE,1301,1948,248379710.0,345268644.0,112349,157485,2210.8,2192.4,269834,593648354.0,3249,721,1415,205463621.0,293431379.0,93613,131371,2194.8,2233.6,224984,498895000.0,2136,2023-11-14 10:05:00
937,BANE,1106,1798,186179875.0,337245093.0,84560,152453,2201.7,2212.1,237013,523424968.0,2904,862,1603,172597338.0,326219964.0,79898,146804,2160.2,2222.1,226702,498817302.0,2465,2023-11-14 10:10:00
938,BANE,1004,1274,122613020.0,134694037.0,55705,60185,2201.1,2238.0,115890,257307058.0,2278,856,1082,112675525.0,121794639.0,51517,54642,2187.2,2229.0,106159,234470165.0,1938,2023-11-14 10:15:00
939,BANE,381,1245,33772233.0,151006963.0,15514,68988,2176.9,2188.9,84502,184779197.0,1626,265,1126,28850208.0,138366372.0,12389,62803,2328.7,2203.2,75192,167216580.0,1391,2023-11-14 10:20:00
940,BANE,390,788,60985256.0,174598787.0,28225,79343,2160.7,2200.6,107568,235584043.0,1178,274,668,51228110.0,169049630.0,23780,76701,2154.3,2204.0,100481,220277740.0,942,2023-11-14 10:25:00
941,BANE,744,7140,102577667.0,2086330839.0,46291,946723,2215.9,2203.7,993014,2188908506.0,7884,658,7052,91158615.0,2080240152.0,41767,943948,2182.6,2203.8,985715,2171398767.0,7710,2023-11-14 10:30:00
942,BANE,1456,9380,199349339.0,2173920910.0,91063,987342,2189.1,2201.8,1078405,2373270249.0,10836,1414,9309,195976456.0,2171252245.0,89646,986042,2186.1,2202.0,1075688,2367228701.0,10723,2023-11-14 10:35:00
943,BANE,722,308,107277980.0,34508310.0,49151,15560,2182.6,2217.8,64711,141786291.0,1030,681,260,105427401.0,32645337.0,48298,14674,2182.9,2224.7,62972,138072738.0,941,2023-11-14 10:40:00
944,BANE,1055,286,146985350.0,49639938.0,67134,21958,2189.4,2260.7,89092,196625288.0,1341,1009,263,142716694.0,44394731.0,65234,19592,2187.8,2266.0,84826,187111425.0,1272,2023-11-14 10:45:00
945,BANE,769,108,122275044.0,13756191.0,55867,6203,2188.7,2217.7,62070,136031235.0,877,733,96,118429202.0,12819210.0,54126,5768,2188.0,2222.5,59894,131248412.0,829,2023-11-14 10:50:00
946,BANE,1509,292,264565422.0,34343607.0,119337,15510,2217.0,2214.3,134847,298909030.0,1801,1458,252,259874879.0,34321269.0,118344,15461,2195.9,2219.9,133805,294196148.0,1710,2023-11-14 10:55:00
947,BANE,473,221,88170833.0,24246939.0,39318,10928,2242.5,2218.8,50246,112417772.0,694,439,186,87516849.0,22277827.0,39071,10023,2239.9,2222.7,49094,109794676.0,625,2023-11-14 11:00:00
948,BANE,749,169,69094548.0,34503428.0,30865,15534,2238.6,2221.2,46399,103597976.0,918,694,123,61836504.0,29289939.0,27996,13165,2208.8,2224.8,41161,91126444.0,817,2023-11-14 11:05:00
949,BANE,614,228,83182378.0,37793282.0,36732,16925,2264.6,2233.0,53657,120975660.0,842,504,137,73703210.0,35278159.0,32951,15782,2236.8,2235.3,48733,108981369.0,641,2023-11-14 11:10:00
950,BANE,845,516,116174751.0,59445819.0,52378,26695,2218.0,2226.9,79073,175620570.0,1361,793,449,115245700.0,62588332.0,52040,27893,2214.6,2243.9,79933,177834032.0,1242,2023-11-14 11:15:00
951,BANE,913,433,149021264.0,53512518.0,65925,23874,2260.5,2241.5,89799,202533782.0,1346,832,301,128303768.0,43222263.0,57741,19314,2222.1,2237.9,77055,171526031.0,1133,2023-11-14 11:20:00
952,BANE,1035,674,142154838.0,57000138.0,60772,25344,2339.2,2249.1,86116,199154976.0,1709,874,473,139104181.0,41678361.0,60550,18396,2297.3,2265.6,78946,180782542.0,1347,2023-11-14 11:25:00
953,BANE,400,903,44254165.0,113536040.0,17999,50392,2458.7,2253.1,68391,157790205.0,1303,334,880,38227523.0,113255140.0,16313,50245,2343.4,2254.1,66558,151482663.0,1214,2023-11-14 11:30:00
954,BANE,621,569,25061157.0,65931551.0,11107,29329,2256.3,2248.0,40436,90992708.0,1190,559,507,20643969.0,61292246.0,9219,27135,2239.3,2258.8,36354,81936215.0,1066,2023-11-14 11:35:00
955,BANE,1336,672,272170383.0,75989715.0,120236,33514,2263.6,2267.4,153750,348160099.0,2008,1190,486,260269226.0,65585066.0,115554,28893,2252.4,2269.9,144447,325854292.0,1676,2023-11-14 11:40:00
956,BANE,544,372,67641951.0,14705367.0,29383,6501,2302.1,2262.0,35884,82347318.0,916,392,173,53198226.0,10652172.0,23517,4655,2262.1,2288.3,28172,63850398.0,565,2023-11-14 11:45:00
957,BANE,513,707,78438406.0,58785419.0,34664,26145,2262.8,2248.4,60809,137223825.0,1220,386,474,71243121.0,50176594.0,31498,21966,2261.8,2284.3,53464,121419715.0,860,2023-11-14 11:50:00
958,BANE,297,385,31197851.0,41756448.0,13587,18534,2296.2,2253.0,32121,72954300.0,682,213,259,27790935.0,27212296.0,11180,11919,2485.8,2283.1,23099,55003231.0,472,2023-11-14 11:55:00
959,BANE,187,331,22818575.0,31466459.0,10095,14018,2260.4,2244.7,24113,54285034.0,518,123,249,19494604.0,26990684.0,8634,11867,2257.9,2274.4,20501,46485288.0,372,2023-11-14 12:00:00
960,BANE,140,143,15964387.0,15963696.0,7061,7083,2260.9,2253.8,14144,31928083.0,283,108,114,14870297.0,20524733.0,6614,8986,2248.3,2284.1,15600,35395030.0,222,2023-11-14 12:05:00
961,BANE,465,350,29896163.0,32366723.0,13226,14372,2260.4,2252.1,27598,62262886.0,815,392,295,25450382.0,30514034.0,11307,13446,2250.9,2269.4,24753,55964416.0,687,2023-11-14 12:10:00
962,BANE,203,439,16946240.0,43317322.0,7073,19141,2395.9,2263.1,26214,60263563.0,642,148,384,14883163.0,41348574.0,6602,18200,2254.3,2271.9,24802,56231737.0,532,2023-11-14 12:15:00
963,BANE,222,388,23014690.0,38195734.0,10100,16843,2278.7,2267.8,26943,61210425.0,610,137,304,17816320.0,32595872.0,7875,14343,2262.4,2272.6,22218,50412192.0,441,2023-11-14 12:20:00
964,BANE,80,225,4480292.0,17165729.0,1957,7586,2289.4,2262.8,9543,21646021.0,305,58,190,5750024.0,17059320.0,2226,7506,2583.1,2272.8,9732,22809344.0,248,2023-11-14 12:25:00
965,BANE,198,425,35192186.0,47498885.0,14860,21044,2368.2,2257.1,35904,82691071.0,623,150,387,33356684.0,44154860.0,14446,19511,2309.1,2263.1,33957,77511544.0,537,2023-11-14 12:30:00
966,BANE,206,173,27087975.0,15208292.0,12069,6767,2244.4,2247.4,18836,42296267.0,379,174,133,26854512.0,15160826.0,11337,6698,2368.7,2263.5,18035,42015338.0,307,2023-11-14 12:35:00
967,BANE,163,172,19325752.0,11862434.0,8207,5353,2354.8,2216.0,13560,31188186.0,335,129,148,16948479.0,10751334.0,7143,4753,2372.7,2262.0,11896,27699813.0,277,2023-11-14 12:40:00
968,BANE,191,134,23194619.0,10607331.0,10345,4714,2242.1,2250.2,15059,33801951.0,325,173,119,23517403.0,9936243.0,10532,4391,2232.9,2262.9,14923,33453646.0,292,2023-11-14 12:45:00
969,BANE,257,109,24321171.0,10004812.0,10865,4429,2238.5,2258.9,15294,34325983.0,366,247,86,22812081.0,9413731.0,10212,4165,2233.9,2260.2,14377,32225813.0,333,2023-11-14 12:50:00
970,BANE,197,363,18112976.0,83715677.0,8078,37188,2242.3,2251.1,45266,101828653.0,560,155,316,17555553.0,77564763.0,7832,34418,2241.5,2253.6,42250,95120316.0,471,2023-11-14 12:55:00
971,BANE,93,125,14173097.0,14739927.0,6259,6563,2264.4,2245.9,12822,28913024.0,218,70,87,12178023.0,12297554.0,5440,5455,2238.6,2254.4,10895,24475578.0,157,2023-11-14 13:00:00
972,BANE,80,53,8575486.0,7927551.0,3824,3559,2242.5,2227.5,7383,16503038.0,133,64,42,7842520.0,6508977.0,3496,2888,2243.3,2253.8,6384,14351497.0,106,2023-11-14 13:05:00
973,BANE,100,103,14288049.0,9124555.0,5118,4108,2791.7,2221.2,9226,23412604.0,203,85,90,12781026.0,8307241.0,4447,3687,2874.1,2253.1,8134,21088267.0,175,2023-11-14 13:10:00
974,BANE,197,179,21608582.0,14239008.0,9645,6382,2240.4,2231.1,16027,35847590.0,376,174,151,19311296.0,13426360.0,8621,5961,2240.0,2252.4,14582,32737656.0,325,2023-11-14 13:15:00
975,BANE,82,100,9548928.0,8694412.0,3408,3903,2801.9,2227.6,7311,18243340.0,182,68,76,9964031.0,7302999.0,4099,3245,2430.8,2250.5,7344,17267030.0,144,2023-11-14 13:20:00
976,BANE,172,74,17967426.0,7767835.0,7933,3475,2264.9,2235.3,11408,25735261.0,246,160,54,16820705.0,6889502.0,7502,3055,2242.2,2255.2,10557,23710207.0,214,2023-11-14 13:25:00
977,BANE,182,196,26435759.0,26295318.0,11694,11627,2260.6,2261.6,23321,52731078.0,378,165,182,23101758.0,26859136.0,10280,11871,2247.3,2262.6,22151,49960894.0,347,2023-11-14 13:30:00
978,BANE,2336,174,676796514.0,22341519.0,300630,9869,2251.3,2263.8,310499,699138033.0,2510,2328,151,676229435.0,22103724.0,300440,9754,2250.8,2266.1,310194,698333159.0,2479,2023-11-14 13:35:00
979,BANE,463,291,38336848.0,40693915.0,17030,18001,2251.1,2260.6,35031,79030763.0,754,430,255,36722691.0,38407502.0,16350,16967,2246.0,2263.7,33317,75130194.0,685,2023-11-14 13:40:00
980,BANE,138,218,14782986.0,17410743.0,6581,7724,2246.3,2254.1,14305,32193729.0,356,115,191,14143472.0,17385179.0,6296,7689,2246.4,2261.0,13985,31528651.0,306,2023-11-14 13:45:00
981,BANE,88,167,10816355.0,13774594.0,4808,6108,2249.7,2255.2,10916,24590949.0,255,75,156,10355612.0,13427058.0,4609,5934,2246.8,2262.7,10543,23782670.0,231,2023-11-14 13:50:00
982,BANE,84,196,6844560.0,20181205.0,3039,8927,2252.2,2260.7,11966,27025765.0,280,75,188,6770506.0,19802210.0,3010,8750,2249.3,2263.1,11760,26572717.0,263,2023-11-14 13:55:00
983,BANE,90,220,16123467.0,26579034.0,7180,11811,2245.6,2250.4,18991,42702501.0,310,84,202,16259645.0,24000626.0,7250,10631,2242.7,2257.6,17881,40260272.0,286,2023-11-14 14:00:00
984,BANE,99,529,13331889.0,62767985.0,5939,27862,2244.8,2252.8,33801,76099874.0,628,101,522,14450202.0,59909505.0,6446,26567,2241.7,2255.0,33013,74359707.0,623,2023-11-14 14:05:00
985,BANE,363,1198,72944059.0,216452498.0,31696,98096,2301.4,2206.5,129792,289396557.0,1561,293,1116,67775281.0,202567390.0,28813,90677,2352.2,2233.9,119490,270342671.0,1409,2023-11-14 14:10:00
986,BANE,392,499,44433162.0,68787368.0,19427,30480,2287.2,2256.8,49907,113220530.0,891,284,432,38119820.0,66214996.0,17016,29196,2240.2,2267.9,46212,104334816.0,716,2023-11-14 14:15:00
987,BANE,408,318,48741256.0,29302324.0,20818,13149,2341.3,2228.5,33967,78043580.0,726,364,255,42828677.0,27153042.0,18839,12145,2273.4,2235.7,30984,69981719.0,619,2023-11-14 14:20:00
988,BANE,355,458,39021507.0,40374333.0,15742,18468,2478.8,2186.2,34210,79395840.0,813,241,384,33426092.0,35493282.0,13082,16022,2555.1,2215.3,29104,68919375.0,625,2023-11-14 14:25:00
989,BANE,340,606,27508663.0,56421522.0,11825,25936,2326.3,2175.4,37761,83930185.0,946,221,542,22566057.0,51066065.0,9147,23112,2467.0,2209.5,32259,73632122.0,763,2023-11-14 14:30:00
990,BANE,460,566,60891494.0,83335161.0,27673,37524,2200.4,2220.8,65197,144226655.0,1026,383,485,52134514.0,78554330.0,23872,35242,2183.9,2229.0,59114,130688844.0,868,2023-11-14 14:35:00
991,BANE,226,267,22897115.0,28451866.0,9239,13025,2478.3,2184.4,22264,51348981.0,493,163,225,22112407.0,25775713.0,8864,11699,2494.6,2203.2,20563,47888120.0,388,2023-11-14 14:40:00
992,BANE,277,584,32426638.0,114843279.0,14575,52097,2224.8,2204.4,66672,147269917.0,861,244,549,28334956.0,114090380.0,12959,51750,2186.5,2204.6,64709,142425337.0,793,2023-11-14 14:45:00
993,BANE,267,221,32270406.0,33266071.0,14499,15013,2225.7,2215.8,29512,65536478.0,488,242,181,28980919.0,29705512.0,13209,13405,2194.0,2216.0,26614,58686432.0,423,2023-11-14 14:50:00
994,BANE,212,178,28184400.0,24263161.0,12801,11314,2201.7,2144.5,24115,52447561.0,390,174,143,25458708.0,22222438.0,11606,10042,2193.6,2212.9,21648,47681146.0,317,2023-11-14 14:55:00
995,BANE,126,307,22163030.0,49325725.0,10125,22231,2188.9,2218.8,32356,71488755.0,433,105,292,20704866.0,49967942.0,9448,22519,2191.5,2218.9,31967,70672808.0,397,2023-11-14 15:00:00
996,BANE,174,335,33936812.0,44654782.0,15472,20211,2193.4,2209.4,35683,78591594.0,509,150,308,33041458.0,42911504.0,15084,19424,2190.5,2209.2,34508,75952962.0,458,2023-11-14 15:05:00
997,BANE,122,177,20022539.0,30865881.0,9093,13955,2202.0,2211.8,23048,50888420.0,299,107,168,18920646.0,30763642.0,8616,13908,2196.0,2211.9,22524,49684289.0,275,2023-11-14 15:10:00
998,BANE,322,189,32729964.0,23022400.0,14772,10540,2215.7,2184.3,25312,55752364.0,511,303,170,31827510.0,20958432.0,14081,9479,2260.3,2211.0,23560,52785942.0,473,2023-11-14 15:15:00
999,BANE,198,829,18139520.0,116828717.0,7877,52867,2302.8,2209.9,60744,134968237.0,1027,171,810,15196212.0,116063249.0,6920,52477,2196.0,2211.7,59397,131259462.0,981,2023-11-14 15:20:00
1000,BANE,70,770,2018687.0,86283667.0,917,39064,2201.4,2208.8,39981,88302354.0,840,51,756,1764132.0,84607027.0,805,38303,2191.5,2208.9,39108,86371160.0,807,2023-11-14 15:25:00
1001,BANE,1140,283,97480703.0,25563962.0,44289,11603,2201.0,2203.2,55892,123044666.0,1423,1099,258,93909730.0,22918750.0,42710,10352,2198.8,2213.9,53062,116828480.0,1357,2023-11-14 15:30:00
1002,BANE,1259,154,93816410.0,18135626.0,42622,8190,2201.1,2214.4,50812,111952036.0,1413,1237,147,93010161.0,17828222.0,42270,8033,2200.4,2219.4,50303,110838383.0,1384,2023-11-14 15:35:00
1003,BANE,425,327,26894120.0,41053421.0,12103,18547,2222.1,2213.5,30650,67947541.0,752,397,300,25882792.0,38060694.0,11757,17183,2201.5,2215.0,28940,63943486.0,697,2023-11-14 15:40:00
1004,BANE,115,248,3833322.0,34074516.0,1738,15401,2205.6,2212.5,17139,37907838.0,363,105,242,3703134.0,35758755.0,1593,16147,2324.6,2214.6,17740,39461890.0,347,2023-11-14 15:45:00
1005,BANE,65,118,3340309.0,19888289.0,1518,9019,2200.5,2205.2,10537,23228598.0,183,49,111,2748023.0,18938927.0,1248,8540,2201.9,2217.7,9788,21686950.0,160,2023-11-14 15:50:00
1006,BANE,63,67,3812044.0,11544186.0,1732,5188,2200.9,2225.2,6920,15356230.0,130,64,67,3646036.0,11543295.0,1657,5189,2200.4,2224.6,6846,15189331.0,131,2023-11-14 15:55:00
1007,BANE,199,316,16711243.0,44560533.0,7557,20086,2211.4,2218.5,27643,61271776.0,515,176,296,14651273.0,43740437.0,6644,19713,2205.2,2218.9,26357,58391710.0,472,2023-11-14 16:00:00
1008,BANE,94,303,5167016.0,32105948.0,2346,14456,2202.5,2220.9,16802,37272964.0,397,74,291,3265453.0,31611530.0,1479,14217,2207.9,2223.5,15696,34876984.0,365,2023-11-14 16:05:00
1009,BANE,47,201,1961095.0,19303536.0,888,8713,2208.4,2215.5,9601,21264631.0,248,36,187,1510801.0,18613420.0,684,8379,2208.8,2221.4,9063,20124221.0,223,2023-11-14 16:10:00
1010,BANE,33,49,3026185.0,4255862.0,1365,1918,2217.0,2218.9,3283,7282047.0,82,29,42,1342658.0,3960048.0,611,1784,2197.5,2219.8,2395,5302707.0,71,2023-11-14 16:15:00
1011,BANE,87,126,11013163.0,22190735.0,4907,10019,2244.4,2214.9,14926,33203898.0,213,69,104,8989060.0,20055322.0,4082,9019,2202.1,2223.7,13101,29044382.0,173,2023-11-14 16:20:00
1012,BANE,62,112,11103241.0,15133297.0,4997,6890,2222.0,2196.4,11887,26236538.0,174,52,87,9429154.0,10834860.0,4269,4879,2208.8,2220.7,9148,20264015.0,139,2023-11-14 16:25:00
1013,BANE,136,163,31595761.0,23680054.0,14338,10708,2203.6,2211.4,25046,55275815.0,299,129,151,32587992.0,23393545.0,14790,10559,2203.4,2215.5,25349,55981537.0,280,2023-11-14 16:30:00
1014,BANE,58,98,10328302.0,12769891.0,4691,5836,2201.7,2188.1,10527,23098193.0,156,50,84,10510082.0,11593914.0,4771,5235,2202.9,2214.7,10006,22103996.0,134,2023-11-14 16:35:00
1015,BANE,39,71,3962401.0,6554027.0,1809,2983,2190.4,2197.1,4792,10516428.0,110,21,62,3251805.0,6370407.0,1478,2867,2200.1,2222.0,4345,9622212.0,83,2023-11-14 16:40:00
1016,BANE,95,159,12243576.0,18954827.0,5569,8586,2198.5,2207.6,14155,31198404.0,254,80,153,12655912.0,18412043.0,5753,8327,2199.9,2211.1,14080,31067956.0,233,2023-11-14 16:45:00
1017,BANE,117,225,13132744.0,27959836.0,5080,12745,2585.2,2193.8,17825,41092581.0,342,80,209,12487596.0,27115068.0,4829,12244,2586.0,2214.6,17073,39602664.0,289,2023-11-14 16:50:00
1018,BANE,72,73,8315415.0,19316277.0,3806,8685,2184.8,2224.1,12491,27631693.0,145,55,67,5978204.0,16689799.0,2734,7515,2186.6,2220.9,10249,22668003.0,122,2023-11-14 16:55:00
1019,BANE,64,177,9788148.0,63725291.0,4449,28370,2200.1,2246.2,32819,73513439.0,241,55,178,8411790.0,65398608.0,3827,29117,2198.0,2246.1,32944,73810399.0,233,2023-11-14 17:00:00
1020,BANE,26,66,2255822.0,7251205.0,1023,3273,2205.1,2215.5,4296,9507028.0,92,19,63,2128750.0,6240724.0,969,2817,2196.9,2215.4,3786,8369475.0,82,2023-11-14 17:05:00
1021,BANE,15,71,1681088.0,6018979.0,762,2732,2206.2,2203.1,3494,7700067.0,86,10,68,1645576.0,5913226.0,748,2676,2200.0,2209.7,3424,7558802.0,78,2023-11-14 17:10:00
1022,BANE,42,233,1594009.0,30394371.0,723,13712,2204.7,2216.6,14435,31988380.0,275,45,235,4201306.0,30695958.0,1921,13844,2187.0,2217.3,15765,34897264.0,280,2023-11-14 17:15:00
1023,BANE,66,975,1989660.0,159261733.0,905,71997,2198.5,2212.1,72902,161251393.0,1041,56,956,1866841.0,158367911.0,850,71567,2196.3,2212.9,72417,160234752.0,1012,2023-11-14 17:20:00
1024,BANE,166,1424,25113484.0,227975088.0,10753,103493,2335.5,2202.8,114246,253088573.0,1590,107,1382,20575546.0,225236683.0,9506,101946,2164.5,2209.4,111452,245812230.0,1489,2023-11-14 17:25:00
1025,BANE,188,1273,42114045.0,219663116.0,18381,99843,2291.2,2200.1,118224,261777161.0,1461,138,1237,39477700.0,218857584.0,17472,99407,2259.5,2201.6,116879,258335284.0,1375,2023-11-14 17:30:00
1026,BANE,530,305,75212814.0,66266994.0,34472,30034,2181.9,2206.4,64506,141479808.0,835,506,287,74312445.0,65364116.0,34069,29620,2181.2,2206.8,63689,139676562.0,793,2023-11-14 17:35:00
1027,BANE,253,219,23536049.0,38169513.0,10747,17309,2190.0,2205.2,28056,61705562.0,472,221,201,21896981.0,37347275.0,10027,16920,2183.8,2207.3,26947,59244257.0,422,2023-11-14 17:40:00
1028,BANE,334,1398,17332025.0,198975082.0,7931,90436,2185.4,2200.2,98367,216307107.0,1732,317,1384,18291080.0,197012432.0,7984,89540,2291.0,2200.3,97524,215303512.0,1701,2023-11-14 17:45:00
1029,BANE,186,344,34408127.0,51005239.0,15760,23203,2183.3,2198.2,38963,85413367.0,530,161,324,32027467.0,49601022.0,14678,22518,2182.0,2202.7,37196,81628489.0,485,2023-11-14 17:50:00
1030,BANE,98,164,18693119.0,23532995.0,8530,10680,2191.5,2203.5,19210,42226115.0,262,87,149,18041360.0,22384191.0,8262,10141,2183.7,2207.3,18403,40425552.0,236,2023-11-14 17:55:00
1031,BANE,64,111,8515096.0,12257928.0,3892,5588,2187.8,2193.6,9480,20773024.0,175,52,87,7771231.0,11219125.0,3557,5085,2184.8,2206.3,8642,18990356.0,139,2023-11-14 18:00:00
1032,BANE,200,134,35801253.0,22816520.0,16223,10339,2206.8,2206.8,26562,58617774.0,334,186,107,35551339.0,22281168.0,16313,10085,2179.3,2209.3,26398,57832508.0,293,2023-11-14 18:05:00
1033,BANE,176,72,19599739.0,12227471.0,8860,5543,2212.2,2205.9,14403,31827210.0,248,176,69,18869568.0,11506629.0,8635,5217,2185.2,2205.6,13852,30376197.0,245,2023-11-14 18:10:00
1034,BANE,455,510,118223766.0,135544511.0,53965,61343,2190.7,2209.6,115308,253768277.0,965,421,468,115974077.0,131530723.0,52972,59519,2189.3,2209.9,112491,247504800.0,889,2023-11-14 18:15:00
1035,BANE,148,592,22716804.0,53972977.0,10371,24478,2190.4,2205.0,34849,76689781.0,740,133,579,22322362.0,53686525.0,10193,24344,2190.0,2205.3,34537,76008887.0,712,2023-11-14 18:20:00
1036,BANE,294,470,49102028.0,80754707.0,22366,36592,2195.4,2206.9,58958,129856735.0,764,282,456,48532333.0,80294564.0,22139,36354,2192.2,2208.7,58493,128826897.0,738,2023-11-14 18:25:00
1037,BANE,257,726,64875509.0,148027699.0,29623,67157,2190.0,2204.2,96780,212903208.0,983,247,713,64466386.0,147978836.0,29432,67109,2190.4,2205.1,96541,212445223.0,960,2023-11-14 18:30:00
1038,BANE,160,139,27778893.0,32164295.0,12689,14592,2189.2,2204.2,27281,59943188.0,299,148,135,28269566.0,31210511.0,12534,14151,2255.4,2205.5,26685,59480077.0,283,2023-11-14 18:35:00
1039,BANE,222,169,33539698.0,35690183.0,15313,16219,2190.3,2200.5,31532,69229882.0,391,227,167,36077851.0,37529960.0,16392,17047,2200.9,2201.6,33439,73607812.0,394,2023-11-14 18:40:00
1040,BANE,2992,1903,519845670.0,519845670.0,229565,93966,2264.5,2236.4,323531,729995218.0,4895,2192,1162,472300700.0,472300700.0,193776,56386,2437.4,2461.4,250162,611089767.0,3354,2023-11-29 10:05:00
1041,BANE,1750,3087,217818627.0,217818627.0,93327,138086,2333.9,2295.8,231413,534837193.0,4837,1249,2611,188084858.0,188084858.0,77491,119661,2427.2,2446.6,197152,480848940.0,3860,2023-11-29 10:10:00
1042,BANE,726,726,121115008.0,121115008.0,51788,33527,2338.7,2396.1,85315,201449152.0,1452,583,527,114314858.0,114314858.0,47205,27144,2421.7,2463.0,74349,181169274.0,1110,2023-11-29 10:15:00
1043,BANE,273,458,46280880.0,46280880.0,19579,11734,2363.8,2315.5,31313,73451149.0,731,188,357,42063497.0,42063497.0,17432,10331,2413.0,2460.5,27763,67482524.0,545,2023-11-29 10:20:00
1044,BANE,522,715,85089795.0,85089795.0,35636,35151,2387.7,2307.4,70787,166196526.0,1237,371,597,77110193.0,77110193.0,31827,31058,2422.8,2452.7,62885,153286736.0,968,2023-11-29 10:25:00
1045,BANE,272,291,32787060.0,32787060.0,14108,12260,2324.0,2305.6,26368,61053185.0,563,182,221,27019521.0,27019521.0,11159,11212,2421.3,2447.5,22371,54460607.0,403,2023-11-29 10:30:00
1046,BANE,996,992,218947818.0,218947818.0,92625,63410,2363.8,2300.7,156035,364832404.0,1988,907,867,213188732.0,213188732.0,87960,58215,2423.7,2442.5,146175,355377382.0,1774,2023-11-29 10:35:00
1047,BANE,1134,3467,195275528.0,195275528.0,84911,206666,2299.8,2344.8,291577,679856050.0,4601,722,3202,160785824.0,160785824.0,67268,194602,2390.2,2419.7,261870,631669821.0,3924,2023-11-29 10:40:00
1048,BANE,323,529,42377556.0,42377556.0,18340,17442,2310.7,2349.8,35782,83362828.0,852,190,452,38373080.0,38373080.0,16120,16165,2380.5,2412.1,32285,77364911.0,642,2023-11-29 10:45:00
1049,BANE,473,1032,77788903.0,77788903.0,34499,39347,2254.8,2391.2,73846,171873762.0,1505,367,909,75260696.0,75260696.0,31516,35898,2388.0,2416.6,67414,162012149.0,1276,2023-11-29 10:50:00
1050,BANE,317,696,71542831.0,71542831.0,30328,37061,2359.0,2329.8,67389,157887697.0,1013,226,611,67221844.0,67221844.0,28203,34141,2383.5,2410.8,62344,149528894.0,837,2023-11-29 10:55:00
1051,BANE,491,637,116804500.0,116804500.0,50712,30303,2303.3,2386.3,81015,189115113.0,1128,390,566,115455554.0,115455554.0,48498,29130,2380.6,2403.5,77628,185469633.0,956,2023-11-29 11:00:00
1052,BANE,3222,854,724744546.0,724744546.0,303277,60748,2389.7,2404.6,364025,870819271.0,4076,3118,708,719274795.0,719274795.0,299130,56497,2404.6,2419.6,355627,855974248.0,3826,2023-11-29 11:05:00
1053,BANE,672,450,87518236.0,87518236.0,37395,19707,2340.4,2280.5,57102,132460280.0,1122,596,359,84931413.0,84931413.0,35352,17210,2402.5,2423.4,52562,126637840.0,955,2023-11-29 11:10:00
1054,BANE,1138,104,174630696.0,174630696.0,72894,4559,2395.7,2407.6,77453,185607104.0,1242,1107,65,174602388.0,174602388.0,72736,4138,2400.5,2423.7,76874,184631790.0,1172,2023-11-29 11:15:00
1055,BANE,136,58,11796546.0,11796546.0,5193,3582,2271.6,2417.6,8775,20456394.0,194,116,31,11773449.0,11773449.0,4901,1735,2402.3,2431.0,6636,15991225.0,147,2023-11-29 11:20:00
1056,BANE,962,147,123144248.0,123144248.0,51449,8055,2393.5,2373.8,59504,142265498.0,1109,938,111,122890404.0,122890404.0,51181,8055,2401.1,2425.7,59236,142429538.0,1049,2023-11-29 11:25:00
1057,BANE,148,79,15446767.0,15446767.0,6455,4291,2393.0,2410.5,10746,25790392.0,227,136,63,15255005.0,15255005.0,6365,4038,2396.7,2418.8,10403,25022002.0,199,2023-11-29 11:30:00
1058,BANE,431,131,78318559.0,78318559.0,32699,6151,2395.1,2416.0,38850,93179091.0,562,393,108,77175785.0,77175785.0,32199,5964,2396.8,2419.0,38163,91602963.0,501,2023-11-29 11:35:00
1059,BANE,246,67,44991044.0,44991044.0,18813,3292,2391.5,2419.0,22105,52954402.0,313,210,50,45594965.0,45594965.0,19055,2898,2392.8,2427.2,21953,52629110.0,260,2023-11-29 11:40:00
1060,BANE,787,209,153014599.0,153014599.0,64163,15637,2384.8,2407.0,79800,190653511.0,996,730,156,151731899.0,151731899.0,63279,14810,2397.8,2422.4,78089,187606965.0,886,2023-11-29 11:45:00
1061,BANE,1040,612,221701153.0,221701153.0,92692,46801,2391.8,2308.3,139493,329732531.0,1652,940,543,219556422.0,219556422.0,91663,43140,2395.3,2417.4,134803,323843115.0,1483,2023-11-29 11:50:00
1062,BANE,1177,638,215129730.0,215129730.0,90964,55579,2365.0,2393.8,146543,348174799.0,1815,1082,576,208759302.0,208759302.0,87017,53915,2399.1,2419.8,140932,339224310.0,1658,2023-11-29 11:55:00
1063,BANE,145,127,21036501.0,21036501.0,8926,3545,2356.8,2285.1,12471,29137125.0,272,105,64,20269729.0,20269729.0,8480,3640,2390.3,2463.5,12120,29236807.0,169,2023-11-29 12:00:00
1064,BANE,126,94,13504760.0,13504760.0,5771,3041,2340.1,2369.8,8812,20711180.0,220,87,75,12855692.0,12855692.0,5374,2866,2392.2,2415.9,8240,19779553.0,162,2023-11-29 12:05:00
1065,BANE,239,189,27362479.0,27362479.0,11678,4587,2343.1,2395.2,16265,38349116.0,428,188,164,27801444.0,27801444.0,11628,4263,2390.9,2424.6,15891,38137559.0,352,2023-11-29 12:10:00
1066,BANE,366,2069,68133099.0,68133099.0,28798,222451,2365.9,2407.9,251249,603765326.0,2435,279,2014,66836470.0,66836470.0,27909,219998,2394.8,2415.6,247907,598263966.0,2293,2023-11-29 12:15:00
1067,BANE,255,212,30696813.0,30696813.0,12915,16033,2376.8,2422.0,28948,69528881.0,467,216,178,29274543.0,29274543.0,12239,14630,2391.9,2420.4,26869,64684643.0,394,2023-11-29 12:20:00
1068,BANE,285,242,28567187.0,28567187.0,11914,15806,2397.8,2424.6,27720,66891002.0,527,243,221,27539914.0,27539914.0,11482,15783,2398.5,2424.2,27265,65801056.0,464,2023-11-29 12:25:00
1069,BANE,398,236,61295683.0,61295683.0,25951,17471,2362.0,2419.2,43422,103561731.0,634,332,194,58836850.0,58836850.0,24483,16550,2403.2,2430.0,41033,99053081.0,526,2023-11-29 12:30:00
1070,BANE,355,1182,59491378.0,59491378.0,25268,151580,2354.4,2419.4,176848,426223800.0,1537,274,1099,57629238.0,57629238.0,24022,149796,2399.0,2424.3,173818,420773007.0,1373,2023-11-29 12:35:00
1071,BANE,522,172,14113602.0,14113602.0,5984,14907,2358.6,2387.1,20891,49697596.0,694,453,126,11746916.0,11746916.0,4878,14060,2408.1,2427.7,18938,45880654.0,579,2023-11-29 12:40:00
1072,BANE,488,229,32435895.0,32435895.0,13553,15811,2393.3,2410.5,29364,70547613.0,717,420,185,30137290.0,30137290.0,12546,15602,2402.1,2423.6,28148,67950179.0,605,2023-11-29 12:45:00
1073,BANE,505,118,33063628.0,33063628.0,13916,8076,2375.9,2424.2,21992,52641822.0,623,466,105,32290070.0,32290070.0,13448,8527,2401.1,2423.5,21975,52955470.0,571,2023-11-29 12:50:00
1074,BANE,346,266,50889362.0,50889362.0,21500,17254,2366.9,2406.2,38754,92406351.0,612,253,164,48406074.0,48406074.0,20183,16239,2398.4,2430.9,36422,87880704.0,417,2023-11-29 12:55:00
1075,BANE,188,174,24313634.0,24313634.0,10160,6202,2393.1,2391.6,16362,39146217.0,362,110,76,23728351.0,23728351.0,9890,6090,2399.2,2421.0,15980,38471993.0,186,2023-11-29 13:00:00
1076,BANE,255,83,31759734.0,31759734.0,13217,4175,2402.9,2420.4,17392,41864970.0,338,211,78,21316525.0,21316525.0,8849,4259,2408.9,2424.7,13108,31643365.0,289,2023-11-29 13:05:00
1077,BANE,284,116,16060496.0,16060496.0,6850,3501,2344.6,2397.3,10351,24453540.0,400,230,94,14871161.0,14871161.0,6181,3179,2405.9,2421.6,9360,22569303.0,324,2023-11-29 13:10:00
1078,BANE,198,148,27238652.0,27238652.0,11331,8348,2403.9,2429.7,19679,47522031.0,346,154,127,25248644.0,25248644.0,10494,8342,2406.0,2427.5,18836,45498864.0,281,2023-11-29 13:15:00
1079,BANE,368,247,55564657.0,55564657.0,24524,18388,2265.7,2428.7,42912,100223629.0,615,279,172,52833678.0,52833678.0,21896,17470,2412.9,2443.7,39366,95524771.0,451,2023-11-29 13:20:00
1080,BANE,414,366,64243975.0,64243975.0,26819,28495,2395.5,2420.5,55314,133214936.0,780,346,282,61108975.0,61108975.0,25271,25740,2418.1,2445.6,51011,124058352.0,628,2023-11-29 13:25:00
1081,BANE,389,328,75029348.0,75029348.0,31229,19547,2402.6,2351.6,50776,120995467.0,717,283,227,72192120.0,72192120.0,29855,17361,2418.1,2448.7,47216,114703871.0,510,2023-11-29 13:30:00
1082,BANE,254,225,34570860.0,34570860.0,14923,14657,2316.6,2412.1,29580,69925259.0,479,206,204,34430387.0,34430387.0,14237,14963,2418.4,2446.3,29200,71034539.0,410,2023-11-29 13:35:00
1083,BANE,290,146,23722763.0,23722763.0,9868,4184,2404.0,2298.8,14052,33340785.0,436,246,120,21422262.0,21422262.0,8838,3664,2423.9,2445.0,12502,30380639.0,366,2023-11-29 13:40:00
1084,BANE,226,164,29746690.0,29746690.0,12451,7556,2389.1,2435.0,20007,48145359.0,390,188,131,28269010.0,28269010.0,11708,6850,2414.5,2446.2,18558,45025787.0,319,2023-11-29 13:45:00
1085,BANE,350,219,63807309.0,63807309.0,26963,6578,2366.5,2437.5,33541,79841277.0,569,305,144,59109605.0,59109605.0,24406,5183,2421.9,2451.7,29589,71816686.0,449,2023-11-29 13:50:00
1086,BANE,680,813,170408338.0,170408338.0,70920,38170,2402.8,2375.3,109090,261075070.0,1493,528,596,155710821.0,155710821.0,63952,30661,2434.8,2467.7,94613,231374197.0,1124,2023-11-29 13:55:00
1087,BANE,1130,574,270818252.0,270818252.0,113138,45877,2393.7,2413.2,159015,381526809.0,1704,1016,440,263589436.0,263589436.0,107868,41475,2443.6,2469.9,149343,366028312.0,1456,2023-11-29 14:00:00
1088,BANE,745,623,161302359.0,161302359.0,67370,56474,2394.3,2352.9,123844,294181256.0,1368,556,425,140264187.0,140264187.0,57772,44507,2427.9,2470.0,102279,250194893.0,981,2023-11-29 14:05:00
1089,BANE,341,324,80305813.0,80305813.0,33502,22667,2397.0,2386.2,56169,134393422.0,665,279,233,76366564.0,76366564.0,31427,19546,2430.0,2466.4,50973,124575708.0,512,2023-11-29 14:10:00
1090,BANE,290,227,44151297.0,44151297.0,18559,15282,2379.0,2422.7,33841,81174893.0,517,228,178,45287705.0,45287705.0,18617,13728,2432.6,2469.1,32345,79183846.0,406,2023-11-29 14:15:00
1091,BANE,232,149,31986749.0,31986749.0,13682,7860,2337.9,2463.2,21542,51347749.0,381,153,85,23967044.0,23967044.0,9852,6042,2432.7,2485.3,15894,38983348.0,238,2023-11-29 14:20:00
1092,BANE,260,359,55978848.0,55978848.0,23038,30011,2429.8,2399.8,53049,127998418.0,619,163,288,42672230.0,42672230.0,17563,26894,2429.7,2468.1,44457,109050430.0,451,2023-11-29 14:25:00
1093,BANE,117,212,20584664.0,20584664.0,8493,10147,2423.7,2427.1,18640,45212642.0,329,66,147,14936639.0,14936639.0,6143,7540,2431.5,2468.8,13683,33551061.0,213,2023-11-29 14:30:00
1094,BANE,209,164,20975237.0,20975237.0,9731,9948,2155.5,2428.7,19679,45136406.0,373,149,121,19028259.0,19028259.0,7799,9461,2439.8,2468.1,17260,42379261.0,270,2023-11-29 14:35:00
1095,BANE,198,167,16959216.0,16959216.0,7264,9167,2334.7,2384.1,16431,38813874.0,365,124,103,15170343.0,15170343.0,6275,11857,2417.6,2470.2,18132,44458963.0,227,2023-11-29 14:40:00
1096,BANE,178,160,22903443.0,22903443.0,9423,9691,2430.6,2435.0,19114,46501318.0,338,109,105,21771610.0,21771610.0,8967,8516,2428.0,2469.4,17483,42801099.0,214,2023-11-29 14:45:00
1097,BANE,141,98,27932716.0,27932716.0,13325,5921,2096.3,2418.8,19246,42254702.0,239,99,62,23873798.0,23873798.0,9790,5193,2438.6,2471.7,14983,36709298.0,161,2023-11-29 14:50:00
1098,BANE,325,279,68000458.0,68000458.0,29291,17080,2321.5,2438.7,46371,109652657.0,604,221,170,63021731.0,63021731.0,25825,11340,2440.3,2472.1,37165,91055524.0,391,2023-11-29 14:55:00
1099,BANE,178,139,18056843.0,18056843.0,7840,3629,2303.2,2463.0,11469,26994967.0,317,97,52,19231778.0,19231778.0,7925,3148,2426.7,2478.4,11073,27033721.0,149,2023-11-29 15:00:00
1100,BANE,119,88,11201022.0,11201022.0,4630,4573,2419.2,2317.7,9203,21799809.0,207,61,34,6608848.0,6608848.0,2724,5822,2426.2,2468.7,8546,20981752.0,95,2023-11-29 15:05:00
1101,BANE,83,70,5766726.0,5766726.0,2418,3188,2384.9,2455.8,5606,13595684.0,153,58,37,4943402.0,4943402.0,2022,947,2444.8,2468.7,2969,7281274.0,95,2023-11-29 15:10:00
1102,BANE,89,47,9809147.0,9809147.0,4156,3567,2360.2,2361.8,7723,18233524.0,136,57,25,7555049.0,7555049.0,3116,1649,2424.6,2483.6,4765,11650562.0,82,2023-11-29 15:15:00
1103,BANE,78,47,13576336.0,13576336.0,5609,2388,2420.5,2188.5,7997,18802437.0,125,40,18,7869357.0,7869357.0,3234,1124,2433.3,2480.5,4358,10657463.0,58,2023-11-29 15:20:00
1104,BANE,103,49,25737900.0,25737900.0,10632,3341,2420.8,2335.8,13973,33541827.0,152,71,31,26418619.0,26418619.0,10827,1867,2440.1,2468.8,12694,31027848.0,102,2023-11-29 15:25:00
1105,BANE,92,56,13156276.0,13156276.0,5535,3878,2376.9,2361.9,9413,22315777.0,148,61,28,12598930.0,12598930.0,5186,1944,2429.4,2467.3,7130,17395321.0,89,2023-11-29 15:30:00
1106,BANE,112,51,20984326.0,20984326.0,8753,2201,2397.4,2464.5,10954,26408717.0,163,72,26,20803249.0,20803249.0,8572,2573,2426.9,2472.3,11145,27164487.0,98,2023-11-29 15:35:00
1107,BANE,111,97,19227064.0,19227064.0,8142,2462,2361.5,2225.2,10604,24705482.0,208,50,44,16353346.0,16353346.0,6710,2598,2437.2,2477.5,9308,22790019.0,94,2023-11-29 15:40:00
1108,BANE,302,338,70005153.0,70005153.0,28970,26556,2416.5,2276.0,55526,130447439.0,640,204,231,60974783.0,60974783.0,25044,20426,2434.7,2467.6,45470,111377034.0,435,2023-11-29 15:45:00
1109,BANE,139,113,12537735.0,12537735.0,5170,5705,2425.1,2308.5,10875,25707680.0,252,87,82,9677607.0,9677607.0,3969,5230,2438.3,2469.9,9199,22595012.0,169,2023-11-29 15:50:00
1110,BANE,143,171,23386528.0,23386528.0,9626,9084,2429.5,2244.7,18710,43777176.0,314,92,141,21638820.0,21638820.0,8895,8802,2432.7,2469.3,17697,43373590.0,233,2023-11-29 15:55:00
1111,BANE,494,467,73625418.0,73625418.0,30560,31807,2409.2,2370.2,62367,149014950.0,961,375,360,68596823.0,68596823.0,28209,30260,2431.7,2459.2,58469,143011776.0,735,2023-11-29 16:00:00
1112,BANE,265,195,27820497.0,27820497.0,11717,10994,2374.4,2376.0,22711,53942357.0,460,185,138,27450684.0,27450684.0,11265,9216,2436.8,2468.1,20481,50196623.0,323,2023-11-29 16:05:00
1113,BANE,234,153,20417646.0,20417646.0,8482,6338,2407.2,2402.9,14820,35647256.0,387,169,98,19872158.0,19872158.0,8128,5703,2444.9,2467.8,13831,33946192.0,267,2023-11-29 16:10:00
1114,BANE,235,254,18472349.0,18472349.0,7674,13038,2407.1,2337.2,20712,48944557.0,489,133,164,13695296.0,13695296.0,5611,11437,2440.8,2468.1,17048,41923248.0,297,2023-11-29 16:15:00
1115,BANE,193,151,26645551.0,26645551.0,11044,8225,2412.7,2395.3,19269,46346547.0,344,147,101,27922223.0,27922223.0,11475,6099,2433.3,2466.4,17574,42964606.0,248,2023-11-29 16:20:00
1116,BANE,196,124,30194172.0,30194172.0,13047,8525,2314.3,2368.8,21572,50388054.0,320,127,98,26080711.0,26080711.0,10725,8544,2431.8,2461.2,19269,47109335.0,225,2023-11-29 16:25:00
1117,BANE,238,189,26503729.0,26503729.0,10884,10963,2435.1,2457.0,21847,53440203.0,427,177,118,30575263.0,30575263.0,12576,10766,2431.2,2467.8,23342,57144106.0,295,2023-11-29 16:30:00
1118,BANE,181,99,22203416.0,22203416.0,9179,5960,2418.9,2453.5,15139,36826197.0,280,135,73,18968870.0,18968870.0,7816,4518,2426.9,2473.4,12334,30143911.0,208,2023-11-29 16:35:00
1119,BANE,154,84,17203125.0,17203125.0,7086,1905,2427.8,2287.4,8991,21560648.0,238,112,60,16588385.0,16588385.0,6822,1503,2431.6,2461.4,8325,20287797.0,172,2023-11-29 16:40:00
1120,BANE,141,57,12289314.0,12289314.0,5100,1617,2409.7,2337.5,6717,16069050.0,198,86,40,11306960.0,11306960.0,4647,1550,2433.2,2462.2,6197,15123370.0,126,2023-11-29 16:45:00
1121,BANE,147,68,20091358.0,20091358.0,8301,4762,2420.4,2448.3,13063,31749955.0,215,112,46,19362141.0,19362141.0,7960,3755,2432.4,2468.6,11715,28631632.0,158,2023-11-29 16:50:00
1122,BANE,152,77,9011036.0,9011036.0,3742,4010,2408.1,2455.7,7752,18858546.0,229,112,43,8696793.0,8696793.0,3549,3694,2450.5,2484.5,7243,17874687.0,155,2023-11-29 16:55:00
1123,BANE,174,63,14752932.0,14752932.0,6092,1447,2421.7,2426.5,7539,18264084.0,237,126,31,13618041.0,13618041.0,5571,1238,2444.5,2463.1,6809,16667343.0,157,2023-11-29 17:00:00
1124,BANE,185,80,17064683.0,17064683.0,7164,1912,2382.0,2365.2,9076,21587023.0,265,152,46,17162626.0,17162626.0,7032,1338,2440.6,2464.4,8370,20459937.0,198,2023-11-29 17:05:00
1125,BANE,188,81,35557245.0,35557245.0,14597,4171,2435.9,2449.2,18768,45772842.0,269,156,61,35300741.0,35300741.0,14483,4318,2437.4,2470.6,18801,45968803.0,217,2023-11-29 17:10:00
1126,BANE,184,125,20489576.0,20489576.0,8481,3942,2415.9,2395.7,12423,29933351.0,309,146,93,19916112.0,19916112.0,8155,3258,2442.2,2467.4,11413,27954785.0,239,2023-11-29 17:15:00
1127,BANE,328,426,53559641.0,53559641.0,22190,28170,2413.7,2408.2,50360,121398166.0,754,244,363,48816190.0,48816190.0,20054,26188,2434.2,2462.4,46242,113301119.0,607,2023-11-29 17:20:00
1128,BANE,196,242,39012393.0,39012393.0,16275,14145,2397.1,2461.6,30420,73832202.0,438,142,201,35389015.0,35389015.0,14498,13000,2441.0,2464.9,27498,67432068.0,343,2023-11-29 17:25:00
1129,BANE,116,176,11565304.0,11565304.0,4813,11039,2402.9,2209.8,15852,35959289.0,292,74,132,10588566.0,10588566.0,4347,9168,2435.8,2465.6,13515,33193238.0,206,2023-11-29 17:30:00
1130,BANE,150,207,16275648.0,16275648.0,6724,9153,2420.5,2307.9,15877,37399669.0,357,93,178,17073068.0,17073068.0,7014,8226,2434.1,2458.2,15240,37294069.0,271,2023-11-29 17:35:00
1131,BANE,132,112,7810352.0,7810352.0,3227,2974,2420.3,2125.4,6201,14131148.0,244,73,83,4379811.0,4379811.0,1793,2370,2442.7,2457.3,4163,10203663.0,156,2023-11-29 17:40:00
1132,BANE,103,108,9595666.0,9595666.0,3945,6653,2432.4,2438.8,10598,25821106.0,211,53,90,6360887.0,6360887.0,2606,6257,2440.9,2461.0,8863,21759082.0,143,2023-11-29 17:45:00
1133,BANE,88,166,11749507.0,11749507.0,4834,7399,2430.6,2306.7,12233,28816727.0,254,47,127,10066280.0,10066280.0,4131,6452,2436.8,2460.7,10583,25942675.0,174,2023-11-29 17:50:00
1134,BANE,158,178,29321104.0,29321104.0,12500,11753,2345.7,2465.4,24253,58296400.0,336,102,145,18792679.0,18792679.0,7700,11192,2440.6,2466.4,18892,46396624.0,247,2023-11-29 17:55:00
1135,BANE,251,172,38257804.0,38257804.0,15877,9285,2409.6,2388.2,25162,60432116.0,423,215,120,45032860.0,45032860.0,18443,8194,2441.7,2469.0,26637,65263928.0,335,2023-11-29 18:00:00
1136,BANE,206,124,18612054.0,18612054.0,7629,7988,2439.6,2461.5,15617,38274397.0,330,171,91,18642418.0,18642418.0,7641,7905,2439.8,2469.5,15546,38163654.0,262,2023-11-29 18:05:00
1137,BANE,218,147,37712274.0,37712274.0,15723,9342,2398.5,2460.3,25065,60696262.0,365,179,119,34029716.0,34029716.0,13938,8062,2441.5,2468.3,22000,53928780.0,298,2023-11-29 18:10:00
1138,BANE,396,137,49078940.0,49078940.0,20094,5310,2442.5,2396.4,25404,61803915.0,533,354,75,45781653.0,45781653.0,18707,4787,2447.3,2468.9,23494,57600336.0,429,2023-11-29 18:15:00
1139,BANE,605,134,67984949.0,67984949.0,27919,4280,2435.1,2404.7,32199,78277042.0,739,547,81,66561706.0,66561706.0,27136,3390,2452.9,2465.2,30526,74918665.0,628,2023-11-29 18:20:00
1140,BANE,173,356,29084015.0,29084015.0,12313,16608,2362.1,2464.4,28921,70012401.0,529,143,326,28915460.0,28915460.0,11834,15493,2443.4,2465.8,27327,67118554.0,469,2023-11-29 18:25:00
1141,BANE,491,271,17945944.0,17945944.0,7383,13471,2430.7,2416.0,20854,50491832.0,762,477,204,17191548.0,17191548.0,7040,13405,2442.0,2468.4,20445,50280999.0,681,2023-11-29 18:30:00
1142,BANE,301,295,16839712.0,16839712.0,6920,23012,2433.5,2410.5,29932,72310007.0,596,284,273,15852326.0,15852326.0,6491,21661,2442.2,2467.2,28152,69294391.0,557,2023-11-29 18:35:00
1143,BANE,110,109,11116453.0,11116453.0,5948,5012,1868.9,2231.9,10960,22302723.0,219,91,77,15334429.0,15334429.0,6288,4874,2438.7,2474.1,11162,27393287.0,168,2023-11-29 18:40:00
1144,BANE,3257,3247,522601977.0,522601977.0,220474,253912,2370.4,2404.9,474386,1133245207.0,6504,2423,2619,453713465.0,453713465.0,184398,219190,2460.5,2487.0,403588,998839582.0,5042,2023-11-30 10:05:00
1145,BANE,1570,1615,227412212.0,227412212.0,97405,111820,2334.7,2369.5,209225,492370737.0,3185,1178,1261,200078705.0,200078705.0,81920,97536,2442.4,2465.0,179456,440509764.0,2439,2023-11-30 10:10:00
1146,BANE,1195,1525,178625824.0,178625824.0,74750,114961,2389.6,2369.1,189711,450977237.0,2720,863,1262,150523374.0,150523374.0,61992,98644,2428.1,2453.3,160636,392527295.0,2125,2023-11-30 10:15:00
1147,BANE,1627,1740,264926069.0,264926069.0,112997,123509,2344.5,2294.1,236506,548270558.0,3367,1164,1417,229794334.0,229794334.0,95332,109542,2410.5,2435.7,204874,496604930.0,2581,2023-11-30 10:20:00
1148,BANE,920,603,137255419.0,137255419.0,59045,48992,2324.6,2386.1,108037,254153720.0,1523,761,455,125458615.0,125458615.0,51852,43271,2419.6,2449.6,95123,231456523.0,1216,2023-11-30 10:25:00
1149,BANE,1352,789,295001381.0,295001381.0,123562,70963,2387.5,2390.0,194525,464603709.0,2141,1115,539,290575356.0,290575356.0,119383,61105,2434.0,2458.9,180488,440827279.0,1654,2023-11-30 10:30:00
1150,BANE,1237,470,218860466.0,218860466.0,91250,33118,2398.5,2362.3,124368,297096167.0,1707,1118,383,210654982.0,210654982.0,86662,29007,2430.8,2452.9,115669,281805225.0,1501,2023-11-30 10:35:00
1151,BANE,961,184,115791742.0,115791742.0,47640,16647,2430.6,2452.9,64287,156624777.0,1145,916,122,113103102.0,113103102.0,46454,8883,2434.7,2454.7,55337,134908037.0,1038,2023-11-30 10:40:00
1152,BANE,1009,291,136525641.0,136525641.0,56244,14788,2427.4,2429.2,71032,172448502.0,1300,953,244,132099166.0,132099166.0,54251,13659,2435.0,2455.8,67910,165643470.0,1197,2023-11-30 10:45:00
1153,BANE,646,166,69272933.0,69272933.0,28581,9292,2423.7,2436.2,37873,91910498.0,812,614,139,67669898.0,67669898.0,27744,8859,2439.1,2457.7,36603,89442264.0,753,2023-11-30 10:50:00
1154,BANE,810,249,98437874.0,98437874.0,41566,13344,2368.2,2422.3,54910,130761180.0,1059,758,175,96599883.0,96599883.0,39654,10916,2436.1,2457.6,50570,123426611.0,933,2023-11-30 10:55:00
1155,BANE,1017,747,122514761.0,122514761.0,50644,54358,2419.1,2421.6,105002,254147617.0,1764,948,689,118231180.0,118231180.0,48652,51841,2430.1,2458.1,100493,245659328.0,1637,2023-11-30 11:00:00
1156,BANE,631,973,122695066.0,122695066.0,52060,90176,2356.8,2378.9,142236,337213542.0,1604,523,894,114495478.0,114495478.0,47341,85813,2418.5,2446.3,133154,324421332.0,1417,2023-11-30 11:05:00
1157,BANE,728,944,140072224.0,140072224.0,58860,65906,2379.8,2410.9,124766,298968133.0,1672,674,901,133379133.0,133379133.0,55091,63928,2421.1,2447.0,119019,289810024.0,1575,2023-11-30 11:10:00
1158,BANE,336,1137,60087398.0,60087398.0,24968,65297,2406.6,2399.0,90265,216737185.0,1473,292,1082,58106865.0,58106865.0,24014,62386,2419.7,2440.6,86400,210367914.0,1374,2023-11-30 11:15:00
1159,BANE,421,715,62114533.0,62114533.0,26412,29046,2351.8,2422.1,55458,132467182.0,1136,351,689,59712059.0,59712059.0,24712,28378,2416.3,2439.3,53090,128934133.0,1040,2023-11-30 11:20:00
1160,BANE,200,283,27790375.0,27790375.0,12118,9268,2293.3,2329.9,21386,49383611.0,483,147,247,23883157.0,23883157.0,9868,8401,2420.3,2440.2,18269,44383060.0,394,2023-11-30 11:25:00
1161,BANE,451,790,62997679.0,62997679.0,26474,64312,2379.6,2317.7,90786,212051495.0,1241,380,715,61131742.0,61131742.0,25263,61558,2419.8,2438.1,86821,211215551.0,1095,2023-11-30 11:30:00
1162,BANE,158,191,17736593.0,17736593.0,7742,15631,2291.0,2394.4,23373,55164084.0,349,119,161,13322525.0,13322525.0,5529,16180,2409.6,2440.8,21709,52814330.0,280,2023-11-30 11:35:00
1163,BANE,1078,1299,130084235.0,130084235.0,55475,111165,2344.9,2188.1,166640,373328767.0,2377,591,1019,79858158.0,79858158.0,33428,93056,2389.0,2412.3,126484,304336830.0,1610,2023-11-30 11:40:00
1164,BANE,1333,843,155694579.0,155694579.0,69380,67212,2244.1,2379.0,136592,315591189.0,2176,1054,639,137883295.0,137883295.0,57862,56996,2383.0,2404.7,114858,274941348.0,1693,2023-11-30 11:45:00
1165,BANE,910,528,121101968.0,121101968.0,55448,41242,2184.1,2398.2,96690,220009619.0,1438,787,393,115012579.0,115012579.0,48023,38940,2394.9,2417.8,86963,209160106.0,1180,2023-11-30 11:50:00
1166,BANE,1025,538,140543958.0,140543958.0,59282,29927,2370.8,2342.7,89209,210655414.0,1563,900,436,140665753.0,140665753.0,58691,26773,2396.7,2424.2,85464,205568404.0,1336,2023-11-30 11:55:00
1167,BANE,605,393,67913535.0,67913535.0,28415,19721,2390.1,2407.5,48136,115391270.0,998,509,327,65341920.0,65341920.0,27256,19476,2397.3,2424.1,46732,112552778.0,836,2023-11-30 12:00:00
1168,BANE,447,106,47037529.0,47037529.0,19635,3973,2395.6,2377.0,23608,56481495.0,553,398,88,46661575.0,46661575.0,19427,4799,2401.9,2449.2,24226,58415413.0,486,2023-11-30 12:05:00
1169,BANE,460,104,62178028.0,62178028.0,25936,2866,2397.4,2395.3,28802,69043082.0,564,414,80,61341875.0,61341875.0,25541,2850,2401.7,2438.6,28391,68291852.0,494,2023-11-30 12:10:00
1170,BANE,234,213,30655570.0,30655570.0,12988,19258,2360.3,2419.7,32246,77253650.0,447,187,186,30418604.0,30418604.0,12698,16201,2395.5,2423.8,28899,69686368.0,373,2023-11-30 12:15:00
1171,BANE,142,203,18848859.0,18848859.0,7911,15573,2382.6,2419.9,23484,56534307.0,345,106,178,17610257.0,17610257.0,7345,15346,2397.6,2426.1,22691,54841498.0,284,2023-11-30 12:20:00
1172,BANE,595,297,122500837.0,122500837.0,51401,22742,2383.2,2430.4,74143,177773086.0,892,522,227,121863025.0,121863025.0,50675,20227,2404.8,2430.2,70902,171019591.0,749,2023-11-30 12:25:00
1173,BANE,1479,730,325671643.0,325671643.0,135859,46672,2397.1,2405.7,182531,437949838.0,2209,1373,620,322096561.0,322096561.0,133727,45167,2408.6,2433.4,178894,432006374.0,1993,2023-11-30 12:30:00
1174,BANE,563,329,57033891.0,57033891.0,23803,13657,2396.1,2370.9,37460,89413218.0,892,495,284,57360157.0,57360157.0,23878,12868,2402.2,2434.7,36746,88689604.0,779,2023-11-30 12:35:00
1175,BANE,489,372,57980785.0,57980785.0,24555,21413,2361.3,2431.0,45968,110035782.0,861,444,325,56718197.0,56718197.0,23524,14647,2411.1,2435.9,38171,92396729.0,769,2023-11-30 12:40:00
1176,BANE,957,252,147297262.0,147297262.0,62281,14546,2365.0,2367.0,76827,181727904.0,1209,863,164,144632305.0,144632305.0,59863,11745,2416.1,2439.0,71608,173278795.0,1027,2023-11-30 12:45:00
1177,BANE,689,197,105133544.0,105133544.0,43621,12130,2410.2,2357.3,55751,133727588.0,886,611,129,87916260.0,87916260.0,36331,10812,2419.9,2445.4,47143,114356104.0,740,2023-11-30 12:50:00
1178,BANE,1056,352,149729823.0,149729823.0,62500,31516,2395.7,2450.7,94016,226964708.0,1408,959,253,144698798.0,144698798.0,59631,28323,2426.6,2455.7,87954,214252747.0,1212,2023-11-30 12:55:00
1179,BANE,391,262,47829595.0,47829595.0,19781,14730,2418.0,2316.6,34511,81953335.0,653,310,219,45800773.0,45800773.0,18894,13230,2424.1,2449.7,32124,78210727.0,529,2023-11-30 13:00:00
1180,BANE,167,223,15456589.0,15456589.0,6410,8571,2411.3,2347.7,14981,35578339.0,390,117,197,13415453.0,13415453.0,5541,7800,2421.1,2447.9,13341,32508695.0,314,2023-11-30 13:05:00
1181,BANE,444,319,73110635.0,73110635.0,30266,22065,2415.6,2394.1,52331,125935473.0,763,377,280,70660437.0,70660437.0,29252,20933,2415.6,2442.2,50185,121783082.0,657,2023-11-30 13:10:00
1182,BANE,130,119,9493446.0,9493446.0,4079,9642,2327.4,2437.5,13721,32995617.0,249,79,96,8457871.0,8457871.0,3490,6332,2423.5,2442.7,9822,23924969.0,175,2023-11-30 13:15:00
1183,BANE,812,550,89211669.0,89211669.0,37151,30692,2401.3,2442.1,67843,164163905.0,1362,719,473,93193494.0,93193494.0,38468,30259,2422.6,2442.5,68727,167100204.0,1192,2023-11-30 13:20:00
1184,BANE,890,209,92698723.0,92698723.0,38195,6028,2427.0,2441.0,44223,107413343.0,1099,823,161,92422832.0,92422832.0,38053,5724,2428.8,2448.0,43777,106435383.0,984,2023-11-30 13:25:00
1185,BANE,259,95,26352014.0,26352014.0,10909,7081,2415.6,2368.5,17990,43123501.0,354,216,72,25709551.0,25709551.0,10585,6247,2428.9,2454.2,16832,41040928.0,288,2023-11-30 13:30:00
1186,BANE,495,265,61329824.0,61329824.0,25550,11580,2400.4,2433.9,37130,89514735.0,760,437,210,64903062.0,64903062.0,26858,11950,2416.5,2460.3,38808,94304080.0,647,2023-11-30 13:35:00
1187,BANE,607,145,75895089.0,75895089.0,31491,3252,2410.1,2371.4,34743,83607008.0,752,498,77,74211110.0,74211110.0,30548,2857,2429.3,2452.6,33405,81218202.0,575,2023-11-30 13:40:00
1188,BANE,178,53,23563936.0,23563936.0,9940,2196,2370.6,2361.1,12136,28748931.0,231,134,27,20781463.0,20781463.0,8561,1547,2427.5,2458.4,10108,24584674.0,161,2023-11-30 13:45:00
1189,BANE,658,134,70887635.0,70887635.0,29456,12656,2406.6,2451.7,42112,101915963.0,792,595,107,66151230.0,66151230.0,27185,8273,2433.4,2456.8,35458,86476597.0,702,2023-11-30 13:50:00
1190,BANE,340,141,48010361.0,48010361.0,20290,6039,2366.2,2455.5,26329,62839377.0,481,261,96,42408903.0,42408903.0,17434,6646,2432.5,2463.2,24080,58779098.0,357,2023-11-30 13:55:00
1191,BANE,266,247,33252276.0,33252276.0,13810,16202,2407.8,2390.2,30012,71978572.0,513,192,192,31031999.0,31031999.0,12873,14922,2410.6,2456.9,27795,67693120.0,384,2023-11-30 14:00:00
1192,BANE,861,510,134353786.0,134353786.0,55235,23779,2432.4,2443.5,79014,192457639.0,1371,807,469,135393251.0,135393251.0,55649,23271,2433.0,2446.8,78920,192332830.0,1276,2023-11-30 14:05:00
1193,BANE,644,696,125522939.0,125522939.0,51689,40401,2428.4,2437.9,92090,224017934.0,1340,590,676,122724678.0,122724678.0,50529,42786,2428.8,2443.3,93315,227264962.0,1266,2023-11-30 14:10:00
1194,BANE,1145,8185,214960956.0,214960956.0,89413,1003252,2404.1,2432.6,1092665,2655496544.0,9330,1042,8119,208568499.0,208568499.0,85949,1000621,2426.7,2435.3,1086570,2645331248.0,9161,2023-11-30 14:15:00
1195,BANE,1000,496,159945157.0,159945157.0,66600,24934,2401.6,2439.3,91534,220767485.0,1496,880,391,158493152.0,158493152.0,65067,22253,2435.8,2456.2,87320,213151050.0,1271,2023-11-30 14:20:00
1196,BANE,528,187,61379381.0,61379381.0,25369,6234,2419.5,2450.8,31603,76657440.0,715,455,141,51800253.0,51800253.0,21232,5868,2439.7,2460.2,27100,66236570.0,596,2023-11-30 14:25:00
1197,BANE,275,286,22755336.0,22755336.0,9678,5062,2351.2,2418.6,14740,34998307.0,561,218,255,22147409.0,22147409.0,9087,4826,2437.3,2459.5,13913,34016873.0,473,2023-11-30 14:30:00
1198,BANE,409,617,61032521.0,61032521.0,25911,38691,2355.5,2434.9,64602,155240018.0,1026,337,547,58225319.0,58225319.0,23877,33856,2438.6,2472.2,57733,141924241.0,884,2023-11-30 14:35:00
1199,BANE,343,782,73122739.0,73122739.0,30128,43422,2427.1,2368.4,73550,175961691.0,1125,282,718,73275748.0,73275748.0,30064,41947,2437.3,2456.8,72011,176329465.0,1000,2023-11-30 14:40:00
1200,BANE,267,266,50698681.0,50698681.0,21063,16267,2407.0,2461.4,37330,90737854.0,533,232,248,47425197.0,47425197.0,19538,15974,2427.3,2462.0,35512,86752529.0,480,2023-11-30 14:45:00
1201,BANE,132,137,14303083.0,14303083.0,6369,8034,2245.7,2424.1,14403,33778546.0,269,91,102,14285931.0,14285931.0,5957,6782,2398.2,2466.6,12739,31014187.0,193,2023-11-30 14:50:00
1202,BANE,422,229,65627106.0,65627106.0,27325,11509,2401.7,2455.5,38834,93886891.0,651,385,206,64809243.0,64809243.0,26643,11128,2432.5,2460.2,37771,92185864.0,591,2023-11-30 14:55:00
1203,BANE,468,169,87470054.0,87470054.0,36057,5060,2425.9,2440.4,41117,99818558.0,637,448,136,87085657.0,87085657.0,35693,4713,2439.9,2461.2,40406,98685142.0,584,2023-11-30 15:00:00
1204,BANE,633,115,118149654.0,118149654.0,48850,3998,2418.6,2464.5,52848,128002792.0,748,593,85,117967489.0,117967489.0,48244,3736,2445.2,2466.6,51980,127182655.0,678,2023-11-30 15:05:00
1205,BANE,1023,161,199946560.0,199946560.0,82064,7451,2436.5,2460.8,89515,218281868.0,1184,987,122,198932081.0,198932081.0,81391,7274,2444.2,2473.9,88665,216927267.0,1109,2023-11-30 15:10:00
1206,BANE,309,175,100255137.0,100255137.0,41009,5052,2444.7,2410.2,46061,112431639.0,484,303,144,99332218.0,99332218.0,40630,4623,2444.8,2461.9,45253,110713680.0,447,2023-11-30 15:15:00
1207,BANE,381,112,110755665.0,110755665.0,45403,4160,2439.4,2465.0,49563,121009962.0,493,358,87,110849654.0,110849654.0,45315,4024,2446.2,2466.1,49339,120773375.0,445,2023-11-30 15:20:00
1208,BANE,378,183,141737276.0,141737276.0,58303,12797,2431.0,2450.7,71100,173099275.0,561,355,153,140289858.0,140289858.0,57405,11513,2443.9,2465.9,68918,168680123.0,508,2023-11-30 15:25:00
1209,BANE,388,204,143451268.0,143451268.0,58735,9645,2442.3,2453.1,68380,167110950.0,592,376,183,142932028.0,142932028.0,58509,9384,2442.9,2460.1,67893,166017957.0,559,2023-11-30 15:30:00
1210,BANE,846,587,191669977.0,191669977.0,78919,59044,2428.7,2313.4,137963,328261056.0,1433,719,512,178332300.0,178332300.0,73205,53590,2436.1,2454.3,126795,309856494.0,1231,2023-11-30 15:35:00
1211,BANE,272,191,43184178.0,43184178.0,18359,6661,2352.2,2463.2,25020,59591257.0,463,239,147,41713138.0,41713138.0,17127,5507,2435.5,2461.2,22634,55267102.0,386,2023-11-30 15:40:00
1212,BANE,499,188,61140656.0,61140656.0,25109,6657,2435.0,2456.7,31766,77494748.0,687,482,165,61048561.0,61048561.0,24973,6194,2444.6,2460.1,31167,76286562.0,647,2023-11-30 15:45:00
1213,BANE,539,176,111283525.0,111283525.0,45640,12035,2438.3,2451.1,57675,140782040.0,715,528,140,111097599.0,111097599.0,45561,11548,2438.4,2461.5,57109,139523102.0,668,2023-11-30 15:50:00
1214,BANE,323,119,43026312.0,43026312.0,17617,6385,2442.3,2431.4,24002,58550514.0,442,320,100,43964051.0,43964051.0,18003,6170,2442.0,2458.1,24173,59130266.0,420,2023-11-30 15:55:00
1215,BANE,812,815,121175827.0,121175827.0,50185,55610,2414.6,2406.4,105795,254993567.0,1627,680,698,118315432.0,118315432.0,48694,53037,2429.8,2453.7,101731,248449848.0,1378,2023-11-30 16:00:00
1216,BANE,199,317,20815448.0,20815448.0,8589,18994,2423.5,2426.9,27583,66912538.0,516,141,285,21040853.0,21040853.0,8678,19517,2424.6,2455.6,28195,68967517.0,426,2023-11-30 16:05:00
1217,BANE,289,598,41460403.0,41460403.0,17337,15001,2391.4,2348.3,32338,76687413.0,887,222,566,37295852.0,37295852.0,15362,13737,2427.8,2445.8,29099,70893232.0,788,2023-11-30 16:10:00
1218,BANE,871,934,145295372.0,145295372.0,60243,39958,2411.8,2272.4,100201,236094263.0,1805,739,822,138315579.0,138315579.0,57357,34697,2411.5,2437.5,92054,222887989.0,1561,2023-11-30 16:15:00
1219,BANE,680,647,99916838.0,99916838.0,41781,61251,2391.4,2397.9,103032,246789931.0,1327,591,576,98112584.0,98112584.0,40619,57409,2415.4,2437.1,98028,238023188.0,1167,2023-11-30 16:20:00
1220,BANE,276,302,31486933.0,31486933.0,13262,30205,2374.2,2405.2,43467,104136621.0,578,206,281,30739231.0,30739231.0,12741,31710,2412.6,2439.0,44451,108080648.0,487,2023-11-30 16:25:00
1221,BANE,305,670,22782023.0,22782023.0,9711,25928,2346.0,2444.1,35639,86153770.0,975,232,621,20769744.0,20769744.0,8602,24071,2414.5,2437.2,32673,79435227.0,853,2023-11-30 16:30:00
1222,BANE,290,403,31586105.0,31586105.0,13749,26892,2297.3,2434.9,40641,97064662.0,693,207,363,29718158.0,29718158.0,12398,25941,2397.0,2442.1,38339,93068518.0,570,2023-11-30 16:35:00
1223,BANE,358,424,44491741.0,44491741.0,18445,29423,2412.1,2409.0,47868,115372812.0,782,325,373,44083173.0,44083173.0,18252,28229,2415.3,2436.0,46481,112849083.0,698,2023-11-30 16:40:00
1224,BANE,743,1083,123753198.0,123753198.0,51664,92358,2395.3,2389.4,144022,344429231.0,1826,644,1028,117166644.0,117166644.0,48670,89995,2407.4,2430.4,138665,335889063.0,1672,2023-11-30 16:45:00
1225,BANE,939,2300,95472012.0,95472012.0,39881,176098,2393.9,2428.3,215979,523083106.0,3239,889,2275,94193048.0,94193048.0,39117,174709,2408.0,2428.8,213826,518521123.0,3164,2023-11-30 16:50:00
1226,BANE,1163,2023,194718907.0,194718907.0,82438,176884,2362.0,2355.7,259322,611404696.0,3186,826,1819,172528489.0,172528489.0,72432,171109,2381.9,2418.1,243541,586291733.0,2645,2023-11-30 16:55:00
1227,BANE,3062,1764,395883194.0,395883194.0,166306,121007,2380.5,2407.2,287313,687168701.0,4826,2934,1589,397116490.0,397116490.0,165531,117999,2399.0,2420.1,283530,682680714.0,4523,2023-11-30 17:00:00
1228,BANE,3096,832,512598078.0,512598078.0,214355,47886,2391.4,2398.6,262241,627457605.0,3928,2995,735,511551437.0,511551437.0,212792,46175,2404.0,2423.2,258967,623441187.0,3730,2023-11-30 17:05:00
1229,BANE,846,362,138177439.0,138177439.0,57516,24617,2402.4,2410.0,82133,197504420.0,1208,769,299,136534028.0,136534028.0,56792,24149,2404.1,2427.4,80941,195154152.0,1068,2023-11-30 17:10:00
1230,BANE,688,387,108681591.0,108681591.0,46146,23573,2355.2,2410.4,69719,165503120.0,1075,611,296,104166351.0,104166351.0,43195,21080,2411.5,2436.6,64275,155529433.0,907,2023-11-30 17:15:00
1231,BANE,568,330,90381848.0,90381848.0,37995,22318,2378.8,2440.2,60313,144843257.0,898,503,260,89192918.0,89192918.0,36891,20252,2417.7,2443.1,57143,138669574.0,763,2023-11-30 17:20:00
1232,BANE,476,218,98467636.0,98467636.0,41449,17133,2375.6,2371.1,58582,139091878.0,694,427,166,97716173.0,97716173.0,40473,15059,2414.4,2441.4,55532,134480856.0,593,2023-11-30 17:25:00
1233,BANE,394,230,76009699.0,76009699.0,31515,14150,2411.9,2416.7,45665,110206252.0,624,340,200,74771012.0,74771012.0,30986,14355,2413.1,2433.6,45341,109705307.0,540,2023-11-30 17:30:00
1234,BANE,522,332,87347498.0,87347498.0,36214,32093,2412.0,2439.5,68307,165637324.0,854,481,295,84773092.0,84773092.0,34985,31383,2423.1,2442.0,66368,161411639.0,776,2023-11-30 17:35:00
1235,BANE,525,583,81334466.0,81334466.0,33986,33738,2393.2,2389.1,67724,161936435.0,1108,456,535,84035501.0,84035501.0,34894,31902,2408.3,2441.6,66796,161925836.0,991,2023-11-30 17:40:00
1236,BANE,425,180,66350461.0,66350461.0,27380,10087,2423.3,2450.1,37467,91064780.0,605,377,162,64166479.0,64166479.0,26490,9484,2422.3,2450.7,35974,87408794.0,539,2023-11-30 17:45:00
1237,BANE,398,241,57496964.0,57496964.0,23768,8389,2419.1,2364.9,32157,77336099.0,639,334,195,55286681.0,55286681.0,22804,8179,2424.4,2508.6,30983,75804618.0,529,2023-11-30 17:50:00
1238,BANE,472,133,77658390.0,77658390.0,31967,7943,2429.3,2449.2,39910,97112339.0,605,440,100,77140841.0,77140841.0,31760,6233,2428.9,2450.5,37993,92414560.0,540,2023-11-30 17:55:00
1239,BANE,504,138,79549404.0,79549404.0,33508,10724,2374.0,2448.9,44232,105811885.0,642,464,108,79508716.0,79508716.0,32750,10598,2427.7,2453.7,43348,105512774.0,572,2023-11-30 18:00:00
1240,BANE,592,76,84876420.0,84876420.0,35063,4902,2420.7,2453.8,39965,96904839.0,668,565,58,83782182.0,83782182.0,34457,4304,2431.5,2454.9,38761,94348244.0,623,2023-11-30 18:05:00
1241,BANE,1007,490,191362527.0,191362527.0,79191,30551,2416.5,2370.7,109742,263789803.0,1497,951,458,189843884.0,189843884.0,78168,28948,2428.7,2447.3,107116,260687404.0,1409,2023-11-30 18:10:00
1242,BANE,1353,491,255819557.0,255819557.0,105255,27729,2430.5,2444.3,132984,323598860.0,1844,1308,459,254761187.0,254761187.0,104818,27652,2430.5,2446.6,132470,322415383.0,1767,2023-11-30 18:15:00
1243,BANE,896,281,164350035.0,164350035.0,67561,26699,2432.6,2448.9,94260,229734005.0,1177,860,256,163784041.0,163784041.0,67226,26702,2436.3,2453.2,93928,229289477.0,1116,2023-11-30 18:20:00
1244,BANE,1721,2202,346342686.0,346342686.0,142620,245758,2428.4,2430.0,388378,943527790.0,3923,1677,2170,343543961.0,343543961.0,141456,245153,2428.6,2439.3,386609,941553979.0,3847,2023-11-30 18:25:00
1245,BANE,1560,1053,226294461.0,226294461.0,93187,68691,2428.4,2431.7,161878,393330436.0,2613,1556,1049,230161334.0,230161334.0,94803,69148,2427.8,2439.3,163951,398836099.0,2605,2023-11-30 18:30:00
1246,BANE,417,30352,30656381.0,30656381.0,12953,4135253,2366.7,2434.0,4148206,10095720126.0,30769,415,30341,33096621.0,33096621.0,13704,4134397,2415.1,2434.1,4148101,10096607872.0,30756,2023-11-30 18:35:00
1247,BANE,486,3541,89366922.0,89366922.0,37457,226016,2385.9,2397.5,263473,631247536.0,4027,413,3514,84731305.0,84731305.0,35148,225515,2410.7,2428.3,260663,632349675.0,3927,2023-11-30 18:40:00
0,DSKY,125,327,24655661.0,14473685.0,35658,17182,69.14,84.24,52840,39129346.0,452,44,43,14087534.0,1779257.0,19922,2476,70.71,71.86,22398,15866791.0,87,2023-11-01 10:05:00
1,DSKY,7,47,137317.0,1071832.0,214,1499,64.17,71.5,1713,1209150.0,54,2,18,97452.0,359199.0,140,497,69.61,72.27,637,456651.0,20,2023-11-01 10:10:00
2,DSKY,17,35,2254200.0,508379.0,3325,780,67.8,65.18,4105,2762580.0,52,11,13,2298971.0,59675.0,3312,83,69.41,71.9,3395,2358646.0,24,2023-11-01 10:15:00
3,DSKY,8,37,2989606.0,2087061.0,4200,2916,71.18,71.57,7116,5076667.0,45,5,18,79163.0,261310.0,111,364,71.32,71.79,475,340473.0,23,2023-11-01 10:20:00
4,DSKY,10,31,279709.0,1866509.0,391,2672,71.54,69.85,3063,2146218.0,41,5,6,223960.0,211204.0,314,294,71.32,71.84,608,435164.0,11,2023-11-01 10:25:00
5,DSKY,3,22,515187.0,2374967.0,746,3329,69.06,71.34,4075,2890155.0,25,3,7,515187.0,425395.0,746,582,69.06,73.09,1328,940583.0,10,2023-11-01 10:30:00
6,DSKY,2,49,35650.0,1958410.0,50,2582,71.3,75.85,2632,1994060.0,51,2,15,35546.0,807863.0,50,1126,71.09,71.75,1176,843409.0,17,2023-11-01 10:35:00
7,DSKY,7,63,77187.0,1095822.0,114,1498,67.71,73.15,1612,1173009.0,70,2,13,63670.0,281720.0,95,393,67.02,71.68,488,345390.0,15,2023-11-01 10:40:00
8,DSKY,4,64,104741.0,4703152.0,146,5179,71.74,90.81,5325,4807894.0,68,2,21,84134.0,331548.0,118,464,71.3,71.45,582,415682.0,23,2023-11-01 10:45:00
9,DSKY,2,29,4285.0,562597.0,6,798,71.42,70.5,804,566882.0,31,0,16,0.0,314419.0,0,440,,71.46,440,314419.0,16,2023-11-01 10:50:00
10,DSKY,3,56,2504.0,1199089.0,3,1760,83.47,68.13,1763,1201593.0,59,0,33,0.0,725614.0,0,1014,,71.56,1014,725614.0,33,2023-11-01 10:55:00
11,DSKY,1,56,1071.0,808186.0,1,1131,107.18,71.46,1132,809257.0,57,0,32,0.0,748700.0,0,1048,,71.44,1048,748700.0,32,2023-11-01 11:00:00
12,DSKY,5,76,142055.0,2521849.0,200,3595,71.03,70.15,3795,2663904.0,81,4,47,80422.0,2264332.0,113,3167,71.17,71.5,3280,2344754.0,51,2023-11-01 11:05:00
13,DSKY,7,34,10035360.0,1015037.0,14061,1403,71.37,72.35,15464,11050397.0,41,2,17,35666.0,627760.0,50,878,71.33,71.5,928,663426.0,19,2023-11-01 11:10:00
14,DSKY,3,37,38881.0,956491.0,53,1361,73.36,70.28,1414,995372.0,40,6,24,1500893.0,819997.0,2155,1147,69.65,71.49,3302,2320890.0,30,2023-11-01 11:15:00
15,DSKY,5,35,21785.0,965220.0,30,1345,72.62,71.76,1375,987006.0,40,1,24,10632.0,785266.0,15,1096,70.88,71.65,1111,795898.0,25,2023-11-01 11:20:00
16,DSKY,11,34,3276967.0,1348725.0,4610,1901,71.08,70.95,6511,4625693.0,45,7,24,1772527.0,1113294.0,2538,1544,69.84,72.1,4082,2885821.0,31,2023-11-01 11:25:00
17,DSKY,5,29,1485309.0,305628.0,2108,485,70.46,63.02,2593,1790937.0,34,0,10,0.0,162248.0,0,227,,71.47,227,162248.0,10,2023-11-01 11:30:00
18,DSKY,8,35,76278.0,997648.0,107,1451,71.29,68.76,1558,1073927.0,43,2,14,119323.0,658612.0,168,919,71.03,71.67,1087,777936.0,16,2023-11-01 11:35:00
19,DSKY,24,30,1010830.0,1407190.0,1429,1941,70.74,72.5,3370,2418021.0,54,22,15,1357493.0,928598.0,1931,1282,70.3,72.43,3213,2286092.0,37,2023-11-01 11:40:00
20,DSKY,22,33,4188085.0,1553489.0,5870,2053,71.35,75.67,7923,5741575.0,55,15,7,352575.0,468078.0,494,641,71.37,73.02,1135,820654.0,22,2023-11-01 11:45:00
21,DSKY,27,38,759455.0,1486153.0,1064,2071,71.38,71.76,3135,2245608.0,65,21,29,674507.0,1817065.0,945,2531,71.38,71.79,3476,2491572.0,50,2023-11-01 11:50:00
22,DSKY,12,38,501107.0,1044771.0,702,1467,71.38,71.22,2169,1545879.0,50,12,11,517507.0,405584.0,725,565,71.38,71.78,1290,923091.0,23,2023-11-01 11:55:00
23,DSKY,8,24,489213.0,300565.0,686,445,71.31,67.54,1131,789778.0,32,8,11,408709.0,270890.0,573,376,71.33,72.05,949,679600.0,19,2023-11-01 12:00:00
24,DSKY,34,26,4186298.0,823002.0,5871,1237,71.3,66.53,7108,5009301.0,60,30,18,4238369.0,1277451.0,5945,1780,71.29,71.77,7725,5515820.0,48,2023-11-01 12:05:00
25,DSKY,25,26,858028.0,880137.0,1207,1237,71.09,71.15,2444,1738165.0,51,26,5,2233406.0,188654.0,3156,262,70.77,72.01,3418,2422061.0,31,2023-11-01 12:10:00
26,DSKY,14,16,444744.0,275779.0,623,385,71.39,71.63,1008,720523.0,30,14,2,406902.0,93652.0,570,130,71.39,72.04,700,500554.0,16,2023-11-01 12:15:00
27,DSKY,30,16,2206124.0,77832.0,3220,133,68.51,58.52,3353,2283957.0,46,27,4,835610.0,20024.0,1171,28,71.36,71.52,1199,855634.0,31,2023-11-01 12:20:00
28,DSKY,15,33,286647.0,503351.0,400,710,71.66,70.89,1110,789999.0,48,5,11,179746.0,375909.0,252,526,71.33,71.47,778,555655.0,16,2023-11-01 12:25:00
29,DSKY,3,25,1457207.0,443484.0,2041,636,71.4,69.73,2677,1900692.0,28,1,12,28552.0,398923.0,40,556,71.38,71.75,596,427475.0,13,2023-11-01 12:30:00
30,DSKY,4,36,86711.0,499583.0,121,748,71.66,66.79,869,586295.0,40,3,22,85624.0,622783.0,120,870,71.35,71.58,990,708407.0,25,2023-11-01 12:35:00
31,DSKY,26,25,964881.0,697136.0,1352,1023,71.37,68.15,2375,1662018.0,51,24,6,961138.0,311230.0,1347,434,71.35,71.71,1781,1272369.0,30,2023-11-01 12:40:00
32,DSKY,26,38,3855995.0,1439110.0,5401,2015,71.39,71.42,7416,5295105.0,64,24,28,965091.0,1282958.0,1357,1789,71.12,71.71,3146,2248049.0,52,2023-11-01 12:45:00
33,DSKY,99,39,36400544.0,3342974.0,52294,5923,69.61,56.44,58217,39743518.0,138,98,13,34212461.0,3735039.0,49313,5024,69.38,74.34,54337,37947500.0,111,2023-11-01 12:50:00
34,DSKY,0,19,0.0,653448.0,0,925,,70.64,925,653448.0,19,0,11,0.0,2180705.0,0,3038,,71.78,3038,2180705.0,11,2023-11-01 12:55:00
35,DSKY,2,16,29234.0,105757.0,41,158,71.3,66.93,199,134991.0,18,1,3,28528.0,235474.0,40,328,71.32,71.79,368,264002.0,4,2023-11-01 13:00:00
36,DSKY,4,24,96310.0,896971.0,130,1319,74.08,68.0,1449,993281.0,28,3,11,85624.0,201750.0,120,282,71.35,71.54,402,287374.0,14,2023-11-01 13:05:00
37,DSKY,4,13,14294.0,636874.0,20,927,71.47,68.7,947,651169.0,17,0,5,0.0,184788.0,0,256,,72.18,256,184788.0,5,2023-11-01 13:10:00
38,DSKY,1,17,5014.0,431642.0,7,649,71.64,66.51,656,436657.0,18,0,1,0.0,215460.0,0,300,,71.82,300,215460.0,1,2023-11-01 13:15:00
39,DSKY,5,31,39941.0,1064658.0,56,1489,71.32,71.5,1545,1104600.0,36,3,24,114087.0,823647.0,160,1149,71.3,71.68,1309,937734.0,27,2023-11-01 13:20:00
40,DSKY,7,24,149036.0,11035133.0,209,10565,71.31,104.45,10774,11184169.0,31,15,8,173870.0,406617.0,244,566,71.26,71.84,810,580487.0,23,2023-11-01 13:25:00
41,DSKY,4,18,48850.0,2539811.0,68,3551,71.84,71.52,3619,2588661.0,22,1,2,4282.0,100214.0,6,132,71.38,75.92,138,104497.0,3,2023-11-01 13:30:00
42,DSKY,17,26,2070032.0,318718.0,2977,658,69.53,48.44,3635,2388750.0,43,14,4,2050195.0,56452.0,2937,79,69.81,71.46,3016,2106647.0,18,2023-11-01 13:35:00
43,DSKY,12,17,245315.0,233137.0,401,330,61.18,70.65,731,478453.0,29,9,8,173271.0,368501.0,243,514,71.31,71.69,757,541773.0,17,2023-11-01 13:40:00
44,DSKY,7,32,140230.0,779526.0,201,1096,69.77,71.12,1297,919756.0,39,3,20,46971.0,463569.0,66,648,71.17,71.54,714,510541.0,23,2023-11-01 13:45:00
45,DSKY,6,13,10630.0,47038.0,15,69,70.87,68.17,84,57668.0,19,1,0,7130.0,0.0,10,0,71.3,,10,7130.0,1,2023-11-01 13:50:00
46,DSKY,1,30,2143.0,1177587.0,2,1443,107.18,81.61,1445,1179730.0,31,0,9,0.0,382525.0,0,533,,71.77,533,382525.0,9,2023-11-01 13:55:00
47,DSKY,0,14,0.0,1092796.0,0,1545,,70.73,1545,1092796.0,14,0,4,0.0,97133.0,0,135,,71.95,135,97133.0,4,2023-11-01 14:00:00
48,DSKY,1,15,28536.0,239481.0,40,326,71.34,73.46,366,268017.0,16,1,2,28536.0,36444.0,40,51,71.34,71.46,91,64980.0,3,2023-11-01 14:05:00
49,DSKY,3,16,59190.0,140711.0,83,208,71.31,67.65,291,199901.0,19,2,3,57032.0,51475.0,80,72,71.29,71.49,152,108507.0,5,2023-11-01 14:10:00
50,DSKY,6,13,96252.0,292867.0,135,453,71.3,64.65,588,389119.0,19,5,6,120477.0,445724.0,169,579,71.29,76.98,748,566201.0,11,2023-11-01 14:15:00
51,DSKY,15,23,105967.0,482961.0,148,919,71.6,52.55,1067,588928.0,38,13,10,103463.0,289830.0,145,404,71.35,71.74,549,393293.0,23,2023-11-01 14:20:00
52,DSKY,11,24,145073.0,601984.0,201,834,72.18,72.18,1035,747058.0,35,8,12,114100.0,386808.0,160,540,71.31,71.63,700,500908.0,20,2023-11-01 14:25:00
53,DSKY,8,11,111245.0,46962.0,156,66,71.31,71.16,222,158207.0,19,7,1,136194.0,715.0,191,1,71.31,71.5,192,136909.0,8,2023-11-01 14:30:00
54,DSKY,3,20,7200637.0,216502.0,10085,349,71.4,62.04,10434,7417139.0,23,4,6,334094.0,91785.0,482,128,69.31,71.71,610,425880.0,10,2023-11-01 14:35:00
55,DSKY,4,20,64590.0,1442370.0,87,2061,74.24,69.98,2148,1506960.0,24,2,9,57088.0,1615924.0,80,2260,71.36,71.5,2340,1673012.0,11,2023-11-01 14:40:00
56,DSKY,2,26,39222.0,518744.0,50,745,78.44,69.63,795,557966.0,28,1,18,28504.0,437408.0,40,612,71.26,71.47,652,465912.0,19,2023-11-01 14:45:00
57,DSKY,4,34,48487.0,611881.0,93,865,52.14,70.74,958,660368.0,38,6,22,102029.0,557319.0,143,779,71.35,71.54,922,659349.0,28,2023-11-01 14:50:00
58,DSKY,3,16,329812.0,297074.0,476,436,69.29,68.14,912,626886.0,19,2,5,7168552.0,4438049.0,10040,6206,71.4,71.51,16246,11606601.0,7,2023-11-01 14:55:00
59,DSKY,0,25,0.0,338004.0,0,518,,65.25,518,338004.0,25,0,15,0.0,381695.0,0,534,,71.48,534,381695.0,15,2023-11-01 15:00:00
60,DSKY,2,12,1788.0,189948.0,2,266,89.41,71.41,268,191736.0,14,1,7,3570.0,160729.0,5,225,71.4,71.44,230,164299.0,8,2023-11-01 15:05:00
61,DSKY,4,40,68391.0,954846.0,96,1339,71.24,71.31,1435,1023238.0,44,1,26,22084.0,877490.0,31,1214,71.24,72.28,1245,899574.0,27,2023-11-01 15:10:00
62,DSKY,4,21,61331.0,263749.0,85,396,72.16,66.6,481,325080.0,25,2,8,57032.0,215819.0,80,302,71.29,71.46,382,272851.0,10,2023-11-01 15:15:00
63,DSKY,2,31,9273.0,657291.0,12,939,77.28,70.0,951,666565.0,33,1,20,7130.0,594923.0,10,832,71.3,71.51,842,602053.0,21,2023-11-01 15:20:00
64,DSKY,4,10,6830828.0,377642.0,9558,559,71.47,67.56,10117,7208471.0,14,3,5,329812.0,340027.0,476,474,69.29,71.74,950,669839.0,8,2023-11-01 15:25:00
65,DSKY,2,19,33551.0,1489092.0,47,2086,71.39,71.39,2133,1522644.0,21,1,9,28536.0,1452560.0,40,2033,71.34,71.45,2073,1481096.0,10,2023-11-01 15:30:00
66,DSKY,1,13,716.0,211417.0,1,301,71.64,70.24,302,212133.0,14,0,4,0.0,198215.0,0,277,,71.56,277,198215.0,4,2023-11-01 15:35:00
67,DSKY,2,21,39186.0,275875.0,55,389,71.25,70.92,444,315062.0,23,2,14,59770.0,260886.0,84,365,71.16,71.48,449,320656.0,16,2023-11-01 15:40:00
68,DSKY,1,20,28528.0,415960.0,40,593,71.32,70.15,633,444488.0,21,1,13,28520.0,258735.0,40,362,71.3,71.47,402,287255.0,14,2023-11-01 15:45:00
69,DSKY,1,23,7130.0,1511910.0,10,2145,71.3,70.49,2155,1519040.0,24,1,16,7130.0,1321927.0,10,1847,71.3,71.57,1857,1329057.0,17,2023-11-01 15:50:00
70,DSKY,4,33,201081.0,1200128.0,291,1712,69.1,70.1,2003,1401209.0,37,0,13,0.0,1139902.0,0,1591,,71.65,1591,1139902.0,13,2023-11-01 15:55:00
71,DSKY,6,15,88097.0,314473.0,123,460,71.62,68.36,583,402570.0,21,3,14,85600.0,272779.0,120,381,71.33,71.6,501,358379.0,17,2023-11-01 16:00:00
72,DSKY,1,23,1432.0,334334.0,2,510,71.64,65.56,512,335767.0,24,0,14,0.0,312976.0,0,438,,71.46,438,312976.0,14,2023-11-01 16:05:00
73,DSKY,2,41,12847.0,685739.0,18,1048,71.38,65.43,1066,698587.0,43,1,29,33482.0,587189.0,47,821,71.24,71.52,868,620672.0,30,2023-11-01 16:10:00
74,DSKY,4,37,4102218.0,1315549.0,5745,1844,71.41,71.34,7589,5417767.0,41,2,24,204153.0,853666.0,295,1191,69.2,71.68,1486,1057819.0,26,2023-11-01 16:15:00
75,DSKY,2,9,9267.0,266314.0,13,374,71.29,71.21,387,275581.0,11,1,3,7130.0,207553.0,10,290,71.3,71.57,300,214683.0,4,2023-11-01 16:20:00
76,DSKY,0,13,0.0,324499.0,0,571,,56.83,571,324499.0,13,0,3,0.0,430560.0,0,600,,71.76,600,430560.0,3,2023-11-01 16:25:00
77,DSKY,8,21,8058086.0,366964.0,11286,619,71.4,59.28,11905,8425050.0,29,5,4,805506.0,205739.0,1130,288,71.28,71.44,1418,1011245.0,9,2023-11-01 16:30:00
78,DSKY,3,16,44990.0,1266532.0,63,1502,71.41,84.32,1565,1311522.0,19,2,11,133518.0,908272.0,187,1269,71.4,71.57,1456,1041790.0,13,2023-11-01 16:35:00
79,DSKY,3,22,6787.0,227582.0,9,354,75.42,64.29,363,234369.0,25,0,11,0.0,177965.0,0,249,,71.47,249,177965.0,11,2023-11-01 16:40:00
80,DSKY,5,33,124854.0,3408606.0,175,4753,71.35,71.71,4928,3533460.0,38,5,15,124848.0,2494170.0,175,3488,71.34,71.51,3663,2619018.0,20,2023-11-01 16:45:00
81,DSKY,3,25,255743.0,1094484.0,355,1528,72.04,71.63,1883,1350227.0,28,0,16,0.0,1250991.0,0,1735,,72.1,1735,1250991.0,16,2023-11-01 16:50:00
82,DSKY,1,23,4287.0,678194.0,4,949,107.18,71.46,953,682481.0,24,3,10,1455600.0,432226.0,2100,603,69.31,71.68,2703,1887826.0,13,2023-11-01 16:55:00
83,DSKY,4,21,35323.0,540103.0,48,763,73.59,70.79,811,575427.0,25,1,16,28504.0,551637.0,40,772,71.26,71.46,812,580141.0,17,2023-11-01 17:00:00
84,DSKY,4,37,2803468.0,1797703.0,3925,2531,71.43,71.03,6456,4601172.0,41,2,28,2833770.0,1477004.0,3970,2059,71.38,71.73,6029,4310774.0,30,2023-11-01 17:05:00
85,DSKY,0,29,0.0,1380802.0,0,1944,,71.03,1944,1380802.0,29,0,20,0.0,1283306.0,0,1792,,71.61,1792,1283306.0,20,2023-11-01 17:10:00
86,DSKY,8,20,252489.0,713352.0,354,1015,71.32,70.28,1369,965842.0,28,9,5,223937.0,401730.0,314,560,71.32,71.74,874,625667.0,14,2023-11-01 17:15:00
87,DSKY,13,13,347356.0,236311.0,487,350,71.33,67.52,837,583667.0,26,12,2,349672.0,7143.0,490,10,71.36,71.43,500,356815.0,14,2023-11-01 17:20:00
88,DSKY,3,14,58468.0,1842940.0,82,2579,71.3,71.46,2661,1901408.0,17,2,9,57088.0,811818.0,80,1133,71.36,71.65,1213,868906.0,11,2023-11-01 17:25:00
89,DSKY,2,24,22497.0,461304.0,31,652,72.57,70.75,683,483802.0,26,0,13,0.0,517304.0,0,723,,71.55,723,517304.0,13,2023-11-01 17:30:00
90,DSKY,3,29,10971.0,2226272.0,16,3108,68.57,71.63,3124,2237244.0,32,0,21,0.0,2141653.0,0,2990,,71.63,2990,2141653.0,21,2023-11-01 17:35:00
91,DSKY,2,22,6434.0,1439960.0,9,2012,71.5,71.57,2021,1446395.0,24,0,14,0.0,1418899.0,0,1981,,71.63,1981,1418899.0,14,2023-11-01 17:40:00
92,DSKY,3,29,30346.0,1050795.0,42,1615,72.25,65.06,1657,1081141.0,32,2,12,38458.0,707374.0,54,987,71.22,71.67,1041,745832.0,14,2023-11-01 17:45:00
93,DSKY,4,32,51939.0,1186770.0,73,1742,71.15,68.13,1815,1238710.0,36,2,18,66967.0,1298388.0,94,1813,71.24,71.62,1907,1365356.0,20,2023-11-01 17:50:00
94,DSKY,2,25,32821.0,575124.0,46,812,71.35,70.83,858,607946.0,27,1,12,28504.0,415994.0,40,581,71.26,71.6,621,444498.0,13,2023-11-01 17:55:00
95,DSKY,2,22,1432.0,347972.0,2,536,71.64,64.92,538,349404.0,24,1,14,9898.0,303074.0,14,424,70.7,71.48,438,312972.0,15,2023-11-01 18:00:00
96,DSKY,3,27,43761.0,617990.0,59,883,74.17,69.99,942,661751.0,30,1,22,28536.0,368870.0,40,516,71.34,71.49,556,397406.0,23,2023-11-01 18:05:00
97,DSKY,1,13,1071.0,162174.0,1,250,107.18,64.87,251,163246.0,14,1,10,643.0,83598.0,1,117,64.3,71.45,118,84241.0,11,2023-11-01 18:10:00
98,DSKY,3,23,1456203.0,695094.0,2039,1075,71.42,64.66,3114,2151298.0,26,3,12,1466058.0,449020.0,2054,627,71.38,71.61,2681,1915078.0,15,2023-11-01 18:15:00
99,DSKY,5,12,54877.0,343417.0,76,483,72.21,71.1,559,398294.0,17,2,3,40608.0,244881.0,57,342,71.24,71.6,399,285490.0,5,2023-11-01 18:20:00
100,DSKY,1,22,4298.0,1388901.0,6,1941,71.64,71.56,1947,1393199.0,23,0,16,0.0,1196124.0,0,1670,,71.62,1670,1196124.0,16,2023-11-01 18:25:00
101,DSKY,2,31,78526.0,445485.0,110,697,71.39,63.91,807,524011.0,33,1,17,7132.0,480057.0,10,671,71.32,71.54,681,487189.0,18,2023-11-01 18:30:00
102,DSKY,4,32,59972.0,2249581.0,83,3160,72.26,71.19,3243,2309553.0,36,2,22,57056.0,1242007.0,80,1723,71.32,72.08,1803,1299063.0,24,2023-11-01 18:35:00
103,DSKY,2,16,57112.0,363435.0,80,658,71.39,55.23,738,420547.0,18,4,4,285598.0,373718.0,410,510,69.66,73.28,920,659316.0,8,2023-11-01 18:40:00
104,DSKY,264,430,43500355.0,19592725.0,62011,25248,70.15,77.6,87259,63093080.0,694,188,53,34869139.0,5708127.0,48955,7971,71.23,71.61,56926,40577267.0,241,2023-11-02 10:05:00
105,DSKY,70,134,11173964.0,4153698.0,15772,4716,70.85,88.08,20488,15327663.0,204,56,21,11525684.0,1796822.0,16200,2495,71.15,72.02,18695,13322507.0,77,2023-11-02 10:10:00
106,DSKY,32,94,1962279.0,1345836.0,2753,1971,71.28,68.28,4724,3308115.0,126,21,19,2002908.0,917706.0,2812,1263,71.23,72.66,4075,2920614.0,40,2023-11-02 10:15:00
107,DSKY,57,72,9704527.0,2432903.0,14024,3431,69.2,70.91,17455,12137431.0,129,46,10,9439209.0,206186.0,13662,284,69.09,72.6,13946,9645395.0,56,2023-11-02 10:20:00
108,DSKY,159,61,13746519.0,1541666.0,15385,2092,89.35,73.69,17477,15288185.0,220,150,14,10915911.0,658355.0,15323,915,71.24,71.95,16238,11574267.0,164,2023-11-02 10:25:00
109,DSKY,27,71,1722699.0,1682695.0,814,2437,211.63,69.05,3251,3405395.0,98,17,18,271357.0,316341.0,381,443,71.22,71.41,824,587699.0,35,2023-11-02 10:30:00
110,DSKY,35,57,1002172.0,986093.0,1427,1388,70.23,71.04,2815,1988266.0,92,23,17,982616.0,760438.0,1404,1058,69.99,71.88,2462,1743054.0,40,2023-11-02 10:35:00
111,DSKY,18,60,926637.0,1181863.0,1319,1662,70.25,71.11,2981,2108500.0,78,12,11,586004.0,627004.0,841,874,69.68,71.74,1715,1213008.0,23,2023-11-02 10:40:00
112,DSKY,47,69,10352667.0,827252.0,14541,1196,71.2,69.17,15737,11179920.0,116,40,17,13548243.0,2470460.0,19048,2713,71.13,91.06,21761,16018703.0,57,2023-11-02 10:45:00
113,DSKY,39,68,9215279.0,623205.0,12994,841,70.92,74.1,13835,9838485.0,107,26,6,11508312.0,13904.0,16176,17,71.14,81.79,16193,11522216.0,32,2023-11-02 10:50:00
114,DSKY,32,53,2779544.0,4124416.0,3898,4750,71.31,86.83,8648,6903961.0,85,25,1,1424278.0,714.0,2000,1,71.21,71.4,2001,1424992.0,26,2023-11-02 10:55:00
115,DSKY,25,61,546255.0,1704236.0,768,2509,71.13,67.92,3277,2250491.0,86,19,28,363160.0,1159062.0,510,1613,71.21,71.86,2123,1522223.0,47,2023-11-02 11:00:00
116,DSKY,45,58,16940596.0,1734075.0,23906,2886,70.86,60.09,26792,18674672.0,103,38,36,11088664.0,1136441.0,11025,1589,100.58,71.52,12614,12225105.0,74,2023-11-02 11:05:00
117,DSKY,12,44,2037670.0,529612.0,2927,783,69.62,67.64,3710,2567282.0,56,10,14,2000277.0,425717.0,2876,595,69.55,71.55,3471,2425994.0,24,2023-11-02 11:10:00
118,DSKY,4,57,3549.0,2124358.0,4,2998,88.75,70.86,3002,2127907.0,61,0,14,0.0,313549.0,0,439,,71.42,439,313549.0,14,2023-11-02 11:15:00
119,DSKY,6,24,17512.0,1134891.0,24,1479,72.97,76.73,1503,1152404.0,30,0,7,0.0,178831.0,0,249,,71.82,249,178831.0,7,2023-11-02 11:20:00
120,DSKY,5,34,2140732.0,199048.0,3005,329,71.24,60.5,3334,2339780.0,39,2,1,1424600.0,14284.0,2000,20,71.23,71.42,2020,1438884.0,3,2023-11-02 11:25:00
121,DSKY,11,35,2024269.0,204619.0,2907,292,69.63,70.08,3199,2228888.0,46,8,7,2019178.0,229631.0,2901,321,69.6,71.54,3222,2248809.0,15,2023-11-02 11:30:00
122,DSKY,10,41,318467.0,638023.0,448,886,71.09,72.01,1334,956490.0,51,8,12,452728.0,344236.0,637,482,71.07,71.42,1119,796965.0,20,2023-11-02 11:35:00
123,DSKY,1,24,4297.0,1169939.0,6,1671,71.62,70.01,1677,1174236.0,25,0,6,0.0,197315.0,0,275,,71.75,275,197315.0,6,2023-11-02 11:40:00
124,DSKY,3,24,37941.0,462433.0,53,664,71.59,69.64,717,500375.0,27,1,7,35540.0,357153.0,50,481,71.08,74.25,531,392693.0,8,2023-11-02 11:45:00
125,DSKY,1,31,35520.0,217526.0,50,400,71.04,54.38,450,253046.0,32,1,3,35530.0,15710.0,50,22,71.06,71.41,72,51240.0,4,2023-11-02 11:50:00
126,DSKY,5,28,69519.0,117715.0,97,230,71.67,51.18,327,187235.0,33,5,4,69108.0,11437.0,97,16,71.25,71.48,113,80545.0,9,2023-11-02 11:55:00
127,DSKY,9,30,112122.0,214559.0,154,425,72.81,50.48,579,326682.0,39,3,2,62712.0,20706.0,88,29,71.26,71.4,117,83418.0,5,2023-11-02 12:00:00
128,DSKY,10,18,536257.0,69608.0,752,114,71.31,61.06,866,605866.0,28,8,0,496759.0,0.0,698,0,71.17,,698,496759.0,8,2023-11-02 12:05:00
129,DSKY,3,19,214672.0,107163.0,302,157,71.08,68.26,459,321835.0,22,2,3,213540.0,172466.0,300,241,71.18,71.56,541,386006.0,5,2023-11-02 12:10:00
130,DSKY,10,22,175319.0,362135.0,246,504,71.27,71.85,750,537454.0,32,5,3,184783.0,94743.0,261,132,70.8,71.78,393,279526.0,8,2023-11-02 12:15:00
131,DSKY,2,17,36271.0,106683.0,51,154,71.12,69.27,205,142955.0,19,0,1,0.0,714.0,0,1,,71.4,1,714.0,1,2023-11-02 12:20:00
132,DSKY,3,29,7517.0,345939.0,10,520,75.18,66.53,530,353457.0,32,0,5,0.0,187394.0,0,261,,71.8,261,187394.0,5,2023-11-02 12:25:00
133,DSKY,5,43,738677.0,401616.0,1036,603,71.3,66.6,1639,1140293.0,48,3,3,736437.0,57904.0,1034,81,71.22,71.49,1115,794341.0,6,2023-11-02 12:30:00
134,DSKY,6,34,100568.0,198744.0,141,297,71.32,66.92,438,299313.0,40,3,1,85528.0,4998.0,120,7,71.27,71.4,127,90526.0,4,2023-11-02 12:35:00
135,DSKY,21,42,4777562.0,1390194.0,6703,2089,71.27,66.55,8792,6167757.0,63,18,6,5488778.0,46470.0,7712,65,71.17,71.49,7777,5535248.0,24,2023-11-02 12:40:00
136,DSKY,14,40,566138.0,283799.0,795,422,71.21,67.25,1217,849937.0,54,9,7,510120.0,19389.0,716,27,71.25,71.81,743,529509.0,16,2023-11-02 12:45:00
137,DSKY,1,44,1071.0,348055.0,1,622,107.18,55.96,623,349127.0,45,1,12,650.0,135383.0,1,189,65.0,71.63,190,136033.0,13,2023-11-02 12:50:00
138,DSKY,11,41,3610425.0,832537.0,5078,1181,71.1,70.49,6259,4442963.0,52,10,15,4088116.0,520255.0,5746,718,71.15,72.46,6464,4608372.0,25,2023-11-02 12:55:00
139,DSKY,14,49,335402.0,578369.0,469,861,71.51,67.17,1330,913771.0,63,13,9,366339.0,737720.0,514,1033,71.27,71.42,1547,1104059.0,22,2023-11-02 13:00:00
140,DSKY,22,46,6052755.0,814132.0,8550,1652,70.79,49.28,10202,6866887.0,68,21,11,6327083.0,869207.0,8937,1209,70.8,71.89,10146,7196290.0,32,2023-11-02 13:05:00
141,DSKY,7,44,14342074.0,485729.0,20171,693,71.1,70.09,20864,14827804.0,51,4,13,318492.0,320186.0,456,447,69.84,71.63,903,638678.0,17,2023-11-02 13:10:00
142,DSKY,20,56,3383210.0,233499.0,4789,370,70.65,63.11,5159,3616710.0,76,14,10,3297686.0,253764.0,4682,347,70.43,73.13,5029,3551450.0,24,2023-11-02 13:15:00
143,DSKY,4,51,12746.0,250443.0,18,397,70.82,63.08,415,263190.0,55,3,12,155752.0,149758.0,219,209,71.12,71.65,428,305510.0,15,2023-11-02 13:20:00
144,DSKY,4,44,787094.0,430326.0,1113,643,70.72,66.92,1756,1217420.0,48,4,15,718727.0,473602.0,1017,663,70.67,71.43,1680,1192329.0,19,2023-11-02 13:25:00
145,DSKY,16,63,4534212.0,699820.0,6382,1022,71.05,68.48,7404,5234032.0,79,13,12,3546695.0,202841.0,4992,284,71.05,71.42,5276,3749537.0,25,2023-11-02 13:30:00
146,DSKY,9,46,583441.0,383019.0,818,578,71.33,66.27,1396,966461.0,55,5,9,896952.0,142506.0,1257,199,71.36,71.61,1456,1039458.0,14,2023-11-02 13:35:00
147,DSKY,15,47,3983729.0,888167.0,5613,1340,70.97,66.28,6953,4871896.0,62,11,11,4560494.0,283137.0,6411,388,71.14,72.97,6799,4843631.0,22,2023-11-02 13:40:00
148,DSKY,24,55,1350903.0,669538.0,1894,965,71.33,69.38,2859,2020442.0,79,20,11,1399509.0,359051.0,1964,501,71.26,71.67,2465,1758560.0,31,2023-11-02 13:45:00
149,DSKY,8,54,609857.0,1175995.0,856,1678,71.24,70.08,2534,1785853.0,62,6,9,491605.0,194723.0,690,271,71.25,71.85,961,686328.0,15,2023-11-02 13:50:00
150,DSKY,4,57,4998.0,224585.0,6,356,83.3,63.09,362,229583.0,61,0,9,0.0,12642.0,0,17,,74.36,17,12642.0,9,2023-11-02 13:55:00
151,DSKY,6,49,86816.0,10630524.0,122,10022,71.16,106.07,10144,10717340.0,55,5,8,71043.0,29275.0,100,41,71.04,71.4,141,100319.0,13,2023-11-02 14:00:00
152,DSKY,2,47,7481.0,508728.0,11,722,68.01,70.46,733,516209.0,49,3,5,415038.0,286713.0,601,400,69.06,71.68,1001,701751.0,8,2023-11-02 14:05:00
153,DSKY,8,49,4049818.0,674855.0,5710,961,70.93,70.22,6671,4724673.0,57,4,10,3589873.0,583263.0,5056,808,71.0,72.19,5864,4173136.0,14,2023-11-02 14:10:00
154,DSKY,5,24,232682.0,291158.0,327,415,71.16,70.16,742,523841.0,29,3,1,230656.0,42540.0,324,50,71.19,85.08,374,273196.0,4,2023-11-02 14:15:00
155,DSKY,8,37,232108.0,135830.0,326,204,71.2,66.58,530,367939.0,45,7,1,260655.0,1428.0,366,2,71.22,71.42,368,262083.0,8,2023-11-02 14:20:00
156,DSKY,18,35,1206283.0,277577.0,1693,484,71.25,57.35,2177,1483860.0,53,15,7,1219492.0,337463.0,1714,472,71.15,71.5,2186,1556955.0,22,2023-11-02 14:25:00
157,DSKY,19,53,3541543.0,528791.0,4996,784,70.89,67.45,5780,4070334.0,72,17,6,4093540.0,251413.0,5803,343,70.54,73.3,6146,4344953.0,23,2023-11-02 14:30:00
158,DSKY,11,66,3458207.0,3963542.0,1073,5418,322.29,73.16,6491,7421750.0,77,7,23,217527.0,3885835.0,305,5296,71.32,73.37,5601,4103362.0,30,2023-11-02 14:35:00
159,DSKY,26,56,685595.0,2709453.0,961,3724,71.34,72.76,4685,3395048.0,82,26,18,1066347.0,2493343.0,1514,3398,70.43,73.38,4912,3559690.0,44,2023-11-02 14:40:00
160,DSKY,14,50,571971.0,663213.0,821,928,69.67,71.47,1749,1235184.0,64,7,6,159058.0,439076.0,223,598,71.33,73.42,821,598134.0,13,2023-11-02 14:45:00
161,DSKY,21,31,1734610.0,317425.0,2470,454,70.23,69.92,2924,2052036.0,52,17,8,1720743.0,280877.0,2444,393,70.41,71.47,2837,2001620.0,25,2023-11-02 14:50:00
162,DSKY,14,38,778716.0,456085.0,1095,642,71.12,71.04,1737,1234801.0,52,11,4,789446.0,57831.0,1110,81,71.12,71.4,1191,847277.0,15,2023-11-02 14:55:00
163,DSKY,16,35,368606.0,350579.0,517,505,71.3,69.42,1022,719186.0,51,15,4,633797.0,363056.0,908,500,69.8,72.61,1408,996854.0,19,2023-11-02 15:00:00
164,DSKY,24,28,384033.0,141532.0,538,296,71.38,47.81,834,525565.0,52,19,3,366179.0,138861.0,514,194,71.24,71.58,708,505040.0,22,2023-11-02 15:05:00
165,DSKY,39,35,2196031.0,507564.0,3120,865,70.39,58.68,3985,2703596.0,74,36,10,2097816.0,394360.0,2984,543,70.3,72.63,3527,2492176.0,46,2023-11-02 15:10:00
166,DSKY,32,45,2476897.0,236336.0,3536,335,70.05,70.55,3871,2713233.0,77,29,6,2493145.0,23031.0,3557,32,70.09,71.97,3589,2516177.0,35,2023-11-02 15:15:00
167,DSKY,32,45,9318073.0,184583.0,13203,276,70.58,66.88,13479,9502657.0,77,23,3,5715440.0,7865.0,8157,11,70.07,71.5,8168,5723305.0,26,2023-11-02 15:20:00
168,DSKY,19,55,2691834.0,360056.0,3799,533,70.86,67.55,4332,3051890.0,74,10,4,1635306.0,10722.0,2298,15,71.16,71.48,2313,1646028.0,14,2023-11-02 15:25:00
169,DSKY,36,47,3338389.0,105480.0,4767,162,70.03,65.11,4929,3443870.0,83,31,5,3323860.0,206662.0,4751,289,69.96,71.51,5040,3530523.0,36,2023-11-02 15:30:00
170,DSKY,53,59,6735197.0,1038104.0,9543,1482,70.58,70.05,11025,7773301.0,112,50,10,6599406.0,551818.0,9344,763,70.63,72.32,10107,7151224.0,60,2023-11-02 15:35:00
171,DSKY,28,48,11382946.0,2749866.0,16009,3846,71.1,71.5,19855,14132813.0,76,24,5,2865986.0,430720.0,4078,595,70.28,72.39,4673,3296706.0,29,2023-11-02 15:40:00
172,DSKY,11,55,6253551.0,477055.0,2266,680,275.97,70.16,2946,6730606.0,66,13,5,4241854.0,37727.0,2156,39,196.75,96.74,2195,4279582.0,18,2023-11-02 15:45:00
173,DSKY,17,84,1614812.0,614276.0,2262,945,71.39,65.0,3207,2229089.0,101,16,8,201059.0,522760.0,282,714,71.3,73.22,996,723819.0,24,2023-11-02 15:50:00
174,DSKY,24,51,997216.0,714076.0,1436,1065,69.44,67.05,2501,1711292.0,75,23,5,15217922.0,108033.0,21437,150,70.99,72.02,21587,15325956.0,28,2023-11-02 15:55:00
175,DSKY,20,48,989134.0,552970.0,1405,849,70.4,65.13,2254,1542105.0,68,13,8,131916.0,319198.0,185,436,71.31,73.21,621,451114.0,21,2023-11-02 16:00:00
176,DSKY,14,47,163641.0,558507.0,229,800,71.46,69.81,1029,722149.0,61,12,3,168931.0,217711.0,237,304,71.28,71.62,541,386643.0,15,2023-11-02 16:05:00
177,DSKY,25,48,597067.0,125432.0,857,202,69.67,62.1,1059,722499.0,73,24,3,7719093.0,540998.0,10843,689,71.19,78.52,11532,8260092.0,27,2023-11-02 16:10:00
178,DSKY,25,39,1797048.0,861097.0,2533,1265,70.95,68.07,3798,2658146.0,64,19,3,353670.0,157080.0,497,220,71.16,71.4,717,510750.0,22,2023-11-02 16:15:00
179,DSKY,38,33,200438.0,167407.0,281,243,71.33,68.89,524,367845.0,71,36,2,196859.0,9432.0,276,12,71.33,78.6,288,206291.0,38,2023-11-02 16:20:00
180,DSKY,38,35,408214.0,361480.0,572,536,71.37,67.44,1108,769694.0,73,34,8,400952.0,133610.0,563,187,71.22,71.45,750,534563.0,42,2023-11-02 16:25:00
181,DSKY,15,31,1160925.0,261763.0,1627,370,71.35,70.75,1997,1422688.0,46,11,11,1086557.0,197051.0,1525,275,71.25,71.66,1800,1283608.0,22,2023-11-02 16:30:00
182,DSKY,16,27,3181069.0,170517.0,4490,252,70.85,67.67,4742,3351586.0,43,15,4,5289963.0,294213.0,7472,411,70.8,71.58,7883,5584177.0,19,2023-11-02 16:35:00
183,DSKY,4,30,95847.0,221846.0,127,372,75.47,59.64,499,317693.0,34,2,3,33463.0,78562.0,47,110,71.2,71.42,157,112025.0,5,2023-11-02 16:40:00
184,DSKY,10,28,151803.0,280914.0,213,398,71.27,70.58,611,432717.0,38,10,9,196343.0,167166.0,279,234,70.37,71.44,513,363509.0,19,2023-11-02 16:45:00
185,DSKY,12,16,84167.0,69892.0,118,126,71.33,55.47,244,154060.0,28,12,3,84167.0,4481.0,118,6,71.33,74.69,124,88648.0,15,2023-11-02 16:50:00
186,DSKY,10,23,102936.0,165793.0,143,234,71.98,70.85,377,268729.0,33,6,4,94015.0,38568.0,132,54,71.22,71.42,186,132584.0,10,2023-11-02 16:55:00
187,DSKY,4,27,32108.0,356678.0,44,568,72.97,62.8,612,388787.0,31,1,3,4281.0,94741.0,6,132,71.36,71.77,138,99023.0,4,2023-11-02 17:00:00
188,DSKY,29,30,2227476.0,3665862.0,3154,5352,70.62,68.5,8506,5893338.0,59,28,4,2211712.0,224654.0,3132,313,70.62,71.77,3445,2436366.0,32,2023-11-02 17:05:00
189,DSKY,26,47,644865.0,996234.0,905,1403,71.26,71.01,2308,1641099.0,73,24,14,519050.0,749104.0,728,1048,71.3,71.48,1776,1268155.0,38,2023-11-02 17:10:00
190,DSKY,31,96,2793845.0,3763147.0,3965,5260,70.46,71.54,9225,6556993.0,127,30,48,2924854.0,1444153.0,4139,2022,70.67,71.42,6161,4369008.0,78,2023-11-02 17:15:00
191,DSKY,3,33,24220.0,187092.0,34,263,71.24,71.14,297,211313.0,36,3,12,20552.0,42184.0,29,59,70.87,71.5,88,62737.0,15,2023-11-02 17:20:00
192,DSKY,1,39,2140.0,172329.0,3,273,71.36,63.12,276,174470.0,40,0,5,0.0,208783.0,0,292,,71.5,292,208783.0,5,2023-11-02 17:25:00
193,DSKY,32,37,2995908.0,408531.0,4298,616,69.7,66.32,4914,3404439.0,69,32,17,2988846.0,298292.0,4288,412,69.7,72.4,4700,3287138.0,49,2023-11-02 17:30:00
194,DSKY,11,30,1331308.0,126944.0,1865,221,71.38,57.44,2086,1458253.0,41,8,5,2989966.0,31415.0,4193,44,71.31,71.4,4237,3021382.0,13,2023-11-02 17:35:00
195,DSKY,4,33,1572505.0,711172.0,2203,1273,71.38,55.87,3476,2283677.0,37,7,4,297662.0,333169.0,419,466,71.04,71.5,885,630832.0,11,2023-11-02 17:40:00
196,DSKY,15,43,2040558.0,1058166.0,2921,1501,69.86,70.5,4422,3098725.0,58,14,20,2052022.0,1963819.0,2920,2747,70.27,71.49,5667,4015841.0,34,2023-11-02 17:45:00
197,DSKY,37,77,463828.0,2558105.0,652,3626,71.14,70.55,4278,3021933.0,114,30,55,163878.0,2359966.0,230,3304,71.25,71.43,3534,2523845.0,85,2023-11-02 17:50:00
198,DSKY,28,48,142588.0,1493112.0,199,2122,71.65,70.36,2321,1635701.0,76,23,28,103346.0,1437744.0,145,1996,71.27,72.03,2141,1541090.0,51,2023-11-02 17:55:00
199,DSKY,37,25,2978485.0,814856.0,4173,1139,71.38,71.54,5312,3793342.0,62,31,8,118310.0,605483.0,166,831,71.27,72.86,997,723794.0,39,2023-11-02 18:00:00
200,DSKY,6,54,117592.0,291621.0,226,454,52.03,64.23,680,409213.0,60,3,29,42760.0,196648.0,60,275,71.27,71.51,335,239408.0,32,2023-11-02 18:05:00
201,DSKY,13,53,2092473.0,691965.0,2932,1022,71.37,67.71,3954,2784438.0,66,11,24,5121809.0,119429.0,678,167,755.43,71.51,845,5241239.0,35,2023-11-02 18:10:00
202,DSKY,32,26,691689.0,502751.0,970,960,71.31,52.37,1930,1194440.0,58,33,6,1043487.0,197741.0,1465,276,71.23,71.65,1741,1241228.0,39,2023-11-02 18:15:00
203,DSKY,35,29,736905.0,557720.0,1035,837,71.2,66.63,1872,1294625.0,64,34,1,703310.0,4284.0,988,6,71.19,71.4,994,707594.0,35,2023-11-02 18:20:00
204,DSKY,3,24,241768.0,137416.0,340,304,71.11,45.2,644,379184.0,27,3,3,242076.0,6432.0,340,9,71.2,71.47,349,248508.0,6,2023-11-02 18:25:00
205,DSKY,9,33,1768413.0,269283.0,2503,413,70.65,65.2,2916,2037697.0,42,10,4,3117321.0,2049149.0,4502,2866,69.24,71.5,7368,5166470.0,14,2023-11-02 18:30:00
206,DSKY,6,27,126758.0,352215.0,178,515,71.21,68.39,693,478973.0,33,6,4,125432.0,122916.0,176,172,71.27,71.46,348,248348.0,10,2023-11-02 18:35:00
207,DSKY,9,28,396189.0,511982.0,558,822,71.0,62.28,1380,908171.0,37,11,8,842613.0,621907.0,1203,843,70.04,73.77,2046,1464521.0,19,2023-11-02 18:40:00
208,DSKY,3757,855,357602409.0,52335533.0,512951,72025,69.71,72.66,584976,409937942.0,4612,3633,543,351993254.0,43445973.0,504017,60941,69.84,71.29,564958,395439228.0,4176,2023-11-03 10:05:00
209,DSKY,984,356,97433357.0,29523825.0,148296,41533,65.7,71.09,189829,126957182.0,1340,952,307,96269386.0,29088385.0,144719,40875,66.52,71.16,185594,125357771.0,1259,2023-11-03 10:10:00
210,DSKY,522,284,50731027.0,25784617.0,73464,36357,69.06,70.92,109821,76515644.0,806,501,235,53549615.0,25094004.0,79547,35334,67.32,71.02,114881,78643619.0,736,2023-11-03 10:15:00
211,DSKY,199,233,29362386.0,26861862.0,42510,38033,69.07,70.63,80543,56224248.0,432,179,201,27632601.0,26025705.0,40012,36799,69.06,70.72,76811,53658306.0,380,2023-11-03 10:20:00
212,DSKY,885,821,81962037.0,108883343.0,118176,154432,69.36,70.51,272608,190845381.0,1706,845,794,81347632.0,108140622.0,117357,153114,69.32,70.63,270471,189488255.0,1639,2023-11-03 10:25:00
213,DSKY,145,72,19079714.0,1992788.0,27791,2859,68.65,69.7,30650,21072503.0,217,127,46,19160754.0,1564743.0,27900,2218,68.68,70.55,30118,20725497.0,173,2023-11-03 10:30:00
214,DSKY,144,48,14926338.0,1263647.0,21515,1794,69.38,70.44,23309,16189986.0,192,132,35,14883711.0,1276719.0,21500,1804,69.23,70.77,23304,16160431.0,167,2023-11-03 10:35:00
215,DSKY,1192,618,38348140.0,68126711.0,54977,96574,69.75,70.54,151551,106474852.0,1810,1174,580,38043369.0,68894784.0,54582,97570,69.7,70.61,152152,106938154.0,1754,2023-11-03 10:40:00
216,DSKY,661,1095,43464609.0,126886757.0,62442,169714,69.61,74.77,232156,170351366.0,1756,635,1067,43277182.0,115618068.0,62180,158847,69.6,72.79,221027,158895251.0,1702,2023-11-03 10:45:00
217,DSKY,195,886,5911193.0,81237813.0,8445,115087,70.0,70.59,123532,87149007.0,1081,196,871,5882829.0,80956508.0,8411,114710,69.94,70.57,123121,86839337.0,1067,2023-11-03 10:50:00
218,DSKY,115,621,2771524.0,55050475.0,3938,78084,70.38,70.5,82022,57821999.0,736,107,600,2928172.0,54843459.0,4479,77764,65.38,70.53,82243,57771631.0,707,2023-11-03 10:55:00
219,DSKY,181,767,10206672.0,69477395.0,15152,98512,67.36,70.53,113664,79684068.0,948,162,745,9832780.0,68712660.0,14234,97407,69.08,70.54,111641,78545441.0,907,2023-11-03 11:00:00
220,DSKY,1268,622,112083976.0,38866167.0,162903,55749,68.8,69.72,218652,150950143.0,1890,1237,570,111838500.0,38386804.0,162520,54875,68.82,69.95,217395,150225304.0,1807,2023-11-03 11:05:00
221,DSKY,1954,538,245993421.0,43322761.0,360611,62189,68.22,69.66,422800,289316182.0,2492,1924,506,245600110.0,43631268.0,360052,62425,68.21,69.89,422477,289231378.0,2430,2023-11-03 11:10:00
222,DSKY,2380,829,248974157.0,60344788.0,364689,86964,68.27,69.39,451653,309318946.0,3209,2301,785,245140439.0,59578530.0,358619,85538,68.36,69.65,444157,304718969.0,3086,2023-11-03 11:15:00
223,DSKY,1262,1823,90379480.0,207579277.0,131254,298357,68.86,69.57,429611,297958757.0,3085,1234,1780,89998949.0,205946600.0,130635,296047,68.89,69.57,426682,295945550.0,3014,2023-11-03 11:20:00
224,DSKY,38,2469,3099073.0,323023364.0,4570,463865,67.81,69.64,468435,326122437.0,2507,14,2462,2889084.0,323142940.0,4258,463987,67.85,69.64,468245,326032024.0,2476,2023-11-03 11:25:00
225,DSKY,59,1786,2203469.0,191681746.0,3194,275279,68.99,69.63,278473,193885215.0,1845,18,1752,1869680.0,191226808.0,2758,274580,67.79,69.64,277338,193096489.0,1770,2023-11-03 11:30:00
226,DSKY,65,1863,11665409.0,234653023.0,17173,337028,67.93,69.62,354201,246318433.0,1928,45,1844,12427431.0,233948254.0,18374,335885,67.64,69.65,354259,246375685.0,1889,2023-11-03 11:35:00
227,DSKY,23,2330,1893976.0,310613725.0,2779,445909,68.15,69.66,448688,312507701.0,2353,23,2307,2414283.0,310212296.0,3557,445329,67.87,69.66,448886,312626580.0,2330,2023-11-03 11:40:00
228,DSKY,41,2238,3601414.0,245409019.0,5371,352409,67.05,69.64,357780,249010433.0,2279,20,2210,2903436.0,245093461.0,4279,351877,67.85,69.65,356156,247996898.0,2230,2023-11-03 11:45:00
229,DSKY,91,1779,13239610.0,169368748.0,19505,243402,67.88,69.58,262907,182608359.0,1870,70,1755,13280841.0,169432136.0,19569,243379,67.87,69.62,262948,182712977.0,1825,2023-11-03 11:50:00
230,DSKY,34,225,5835307.0,26880732.0,8600,38658,67.85,69.53,47258,32716040.0,259,22,218,5764498.0,26840825.0,8498,38563,67.83,69.6,47061,32605323.0,240,2023-11-03 11:55:00
231,DSKY,51,86,5991545.0,6135663.0,8801,8768,68.08,69.98,17569,12127209.0,137,31,60,5741018.0,5938195.0,8464,8472,67.83,70.09,16936,11679213.0,91,2023-11-03 12:00:00
232,DSKY,146,2205,14118996.0,204864958.0,20639,294040,68.41,69.67,314679,218983954.0,2351,116,2170,14574744.0,204924639.0,21544,294041,67.65,69.69,315585,219499383.0,2286,2023-11-03 12:05:00
233,DSKY,38,647,3115914.0,51267088.0,4586,73631,67.94,69.63,78217,54383002.0,685,25,638,3072790.0,51188058.0,4525,73478,67.91,69.66,78003,54260848.0,663,2023-11-03 12:10:00
234,DSKY,138,2527,17582795.0,240208529.0,25773,344468,68.22,69.73,370241,257791324.0,2665,108,2497,17121756.0,239772637.0,25204,343921,67.93,69.72,369125,256894393.0,2605,2023-11-03 12:15:00
235,DSKY,39,1751,2265081.0,176190362.0,3361,252050,67.39,69.9,255411,178455444.0,1790,22,1718,1886754.0,173004876.0,2785,248423,67.75,69.64,251208,174891631.0,1740,2023-11-03 12:20:00
236,DSKY,24,1215,287459.0,108211459.0,415,155492,69.27,69.59,155907,108498919.0,1239,20,1195,212014.0,108045124.0,307,155249,69.06,69.59,155556,108257139.0,1215,2023-11-03 12:25:00
237,DSKY,91,1710,3331410.0,164294376.0,4870,235934,68.41,69.64,240804,167625786.0,1801,64,1693,3258177.0,163711898.0,4795,235096,67.95,69.64,239891,166970075.0,1757,2023-11-03 12:30:00
238,DSKY,117,724,4005729.0,68476961.0,5864,98146,68.31,69.77,104010,72482691.0,841,109,706,3961073.0,68403281.0,5825,98027,68.0,69.78,103852,72364354.0,815,2023-11-03 12:35:00
239,DSKY,72,2568,4782876.0,263159493.0,7017,378066,68.16,69.61,385083,267942369.0,2640,53,2551,4621529.0,262979486.0,6778,377755,68.18,69.62,384533,267601016.0,2604,2023-11-03 12:40:00
240,DSKY,72,2667,2070672.0,274134226.0,3026,393854,68.43,69.6,396880,276204898.0,2739,47,2642,1855050.0,273983342.0,2720,393618,68.2,69.61,396338,275838392.0,2689,2023-11-03 12:45:00
241,DSKY,104,3023,10360836.0,337219012.0,15238,484604,67.99,69.59,499842,347579848.0,3127,69,2991,10253757.0,337127983.0,15093,484394,67.94,69.6,499487,347381741.0,3060,2023-11-03 12:50:00
242,DSKY,175,3051,22459475.0,349957696.0,32902,502734,68.26,69.61,535636,372417171.0,3226,150,3018,22212577.0,349788585.0,32545,502469,68.25,69.61,535014,372001163.0,3168,2023-11-03 12:55:00
243,DSKY,716,1145,58763174.0,100663091.0,85901,144508,68.41,69.66,230409,159426265.0,1861,699,1123,59049354.0,100519779.0,86380,144283,68.36,69.67,230663,159569133.0,1822,2023-11-03 13:00:00
244,DSKY,143,338,14144286.0,15478586.0,20708,22304,68.3,69.4,43012,29622873.0,481,120,311,13810324.0,15256018.0,20189,21917,68.41,69.61,42106,29066342.0,431,2023-11-03 13:05:00
245,DSKY,76,49,562152.0,411051.0,803,596,70.01,68.97,1399,973203.0,125,60,43,503368.0,455587.0,729,656,69.05,69.45,1385,958956.0,103,2023-11-03 13:10:00
246,DSKY,22,93,1548319.0,827959.0,2277,1204,68.0,68.77,3481,2376278.0,115,16,77,1461343.0,727402.0,2143,1048,68.19,69.41,3191,2188746.0,93,2023-11-03 13:15:00
247,DSKY,52,82,7490870.0,1548819.0,9253,2233,80.96,69.36,11486,9039689.0,134,38,64,5915234.0,1303419.0,8675,1880,68.19,69.33,10555,7218654.0,102,2023-11-03 13:20:00
248,DSKY,32,99,1698884.0,1754836.0,828,2550,205.18,68.82,3378,3453721.0,131,11,76,25534.0,1577281.0,37,2277,69.01,69.27,2314,1602816.0,87,2023-11-03 13:25:00
249,DSKY,22,83,1468374.0,1651537.0,2184,2406,67.23,68.64,4590,3119911.0,105,13,72,1492402.0,1600680.0,2196,2309,67.96,69.32,4505,3093082.0,85,2023-11-03 13:30:00
250,DSKY,28,148,2374660.0,2651318.0,2598,3840,91.4,69.04,6438,5025978.0,176,22,135,2276845.0,2510970.0,2454,3622,92.78,69.33,6076,4787815.0,157,2023-11-03 13:35:00
251,DSKY,7,34,42488.0,348593.0,55,513,77.25,67.95,568,391082.0,41,2,21,24783.0,302849.0,36,437,68.84,69.3,473,327632.0,23,2023-11-03 13:40:00
252,DSKY,7,33,10547.0,260044.0,12,383,87.9,67.9,395,270592.0,40,0,13,0.0,170545.0,0,246,,69.33,246,170545.0,13,2023-11-03 13:45:00
253,DSKY,14,53,91283.0,698189.0,131,1017,69.68,68.65,1148,789473.0,67,12,45,2645458.0,537639.0,523,776,505.82,69.28,1299,3183097.0,57,2023-11-03 13:50:00
254,DSKY,10,56,1439228.0,626265.0,2120,950,67.89,65.92,3070,2065494.0,66,5,30,1478142.0,306764.0,2201,443,67.16,69.25,2644,1784906.0,35,2023-11-03 13:55:00
255,DSKY,15,41,540632.0,792683.0,784,1153,68.96,68.75,1937,1333315.0,56,13,30,454552.0,699917.0,661,1002,68.77,69.85,1663,1154469.0,43,2023-11-03 14:00:00
256,DSKY,19,67,354181.0,918406.0,514,1350,68.91,68.03,1864,1272587.0,86,6,43,236557.0,804126.0,344,1162,68.77,69.2,1506,1040683.0,49,2023-11-03 14:05:00
257,DSKY,22,57,1829582.0,1014051.0,2693,1507,67.94,67.29,4200,2843633.0,79,13,36,1817422.0,917579.0,2672,1324,68.02,69.3,3996,2735001.0,49,2023-11-03 14:10:00
258,DSKY,160,464,8100245.0,7688796.0,11761,11227,68.87,68.48,22988,15789042.0,624,145,474,7608754.0,7723749.0,11075,11189,68.7,69.03,22264,15332503.0,619,2023-11-03 14:15:00
259,DSKY,19,54,300101.0,902677.0,432,1364,69.47,66.18,1796,1202778.0,73,11,44,141039.0,703040.0,205,1016,68.8,69.2,1221,844080.0,55,2023-11-03 14:20:00
260,DSKY,18,33,1590794.0,459818.0,2319,692,68.6,66.45,3011,2050612.0,51,5,18,1431353.0,469877.0,2118,676,67.58,69.51,2794,1901231.0,23,2023-11-03 14:25:00
261,DSKY,32,72,2343211.0,1543399.0,2565,2253,91.35,68.5,4818,3886610.0,104,11,56,1445562.0,1229765.0,2134,1778,67.74,69.17,3912,2675327.0,67,2023-11-03 14:30:00
262,DSKY,42,210,1869271.0,2434812.0,2739,3533,68.25,68.92,6272,4304083.0,252,24,192,1861148.0,2238282.0,2741,3238,67.9,69.13,5979,4099430.0,216,2023-11-03 14:35:00
263,DSKY,28,254,2483435.0,6287788.0,2721,9062,91.27,69.39,11783,8771223.0,282,20,240,2082093.0,6216983.0,3054,8943,68.18,69.52,11997,8299076.0,260,2023-11-03 14:40:00
264,DSKY,651,183,46078140.0,19183251.0,67837,27495,67.92,69.77,95332,65261392.0,834,636,160,46011317.0,19021562.0,67035,27292,68.64,69.7,94327,65032879.0,796,2023-11-03 14:45:00
265,DSKY,122,2567,11895162.0,307552697.0,17611,441775,67.54,69.62,459386,319447859.0,2689,104,2543,10109362.0,306918789.0,15024,440712,67.29,69.64,455736,317028151.0,2647,2023-11-03 14:50:00
266,DSKY,99,3000,5784993.0,352534259.0,8346,506174,69.31,69.65,514520,358319252.0,3099,87,2982,5486868.0,352368938.0,8023,505877,68.39,69.66,513900,357855806.0,3069,2023-11-03 14:55:00
267,DSKY,319,561,28763133.0,65285393.0,42265,93847,68.05,69.57,136112,94048526.0,880,296,543,28175088.0,64986277.0,41445,93316,67.98,69.64,134761,93161366.0,839,2023-11-03 15:00:00
268,DSKY,304,3555,24588866.0,396131440.0,35991,568993,68.32,69.62,604984,420720306.0,3859,291,3551,24782651.0,396411079.0,36270,569395,68.33,69.62,605665,421193730.0,3842,2023-11-03 15:05:00
269,DSKY,945,4217,68747121.0,490211323.0,100395,703783,68.48,69.65,804178,558958444.0,5162,925,4206,68555821.0,489756166.0,100170,703104,68.44,69.66,803274,558311987.0,5131,2023-11-03 15:10:00
270,DSKY,498,3681,25844244.0,437129215.0,37646,627356,68.65,69.68,665002,462973460.0,4179,492,3671,25709095.0,437144655.0,37496,627347,68.56,69.68,664843,462853751.0,4163,2023-11-03 15:15:00
271,DSKY,203,3745,24908083.0,467110708.0,36458,670458,68.32,69.67,706916,492018791.0,3948,187,3723,25484917.0,466970964.0,36437,670209,69.94,69.68,706646,492455882.0,3910,2023-11-03 15:20:00
272,DSKY,28,1633,2753753.0,180319148.0,3137,257722,87.78,69.97,260859,183072902.0,1661,15,1627,1984481.0,179779871.0,2905,257798,68.31,69.74,260703,181764352.0,1642,2023-11-03 15:25:00
273,DSKY,117,400,9089015.0,6150058.0,13243,8901,68.63,69.09,22144,15239073.0,517,106,389,9085931.0,6069650.0,13235,8779,68.65,69.14,22014,15155581.0,495,2023-11-03 15:30:00
274,DSKY,170,2617,10486589.0,297185922.0,15397,428526,68.11,69.35,443923,307672511.0,2787,156,2604,10505165.0,297110292.0,15423,428405,68.11,69.35,443828,307615457.0,2760,2023-11-03 15:35:00
275,DSKY,297,2435,24835156.0,427108931.0,36613,616474,67.83,69.28,653087,451944087.0,2732,259,2421,24170280.0,427270575.0,35654,616527,67.79,69.3,652181,451440855.0,2680,2023-11-03 15:40:00
276,DSKY,309,741,41474071.0,102169071.0,61156,147439,67.82,69.3,208595,143643143.0,1050,276,719,41538874.0,102054338.0,61253,147253,67.82,69.31,208506,143593212.0,995,2023-11-03 15:45:00
277,DSKY,361,916,31439968.0,136852495.0,45390,197089,69.27,69.44,242479,168292464.0,1277,328,887,30627911.0,136704094.0,44615,196866,68.65,69.44,241481,167332005.0,1215,2023-11-03 15:50:00
278,DSKY,229,167,16328294.0,15278087.0,24070,22027,67.84,69.36,46097,31606381.0,396,218,158,16247459.0,14741388.0,23968,21242,67.79,69.4,45210,30988847.0,376,2023-11-03 15:55:00
279,DSKY,165,1043,8221105.0,217844613.0,11231,313993,73.2,69.38,325224,226065719.0,1208,151,1032,7824868.0,217727561.0,11085,313819,70.59,69.38,324904,225552429.0,1183,2023-11-03 16:00:00
280,DSKY,158,298,11288319.0,47974431.0,16587,69168,68.06,69.36,85755,59262751.0,456,146,286,11180198.0,48007051.0,16486,69188,67.82,69.39,85674,59187249.0,432,2023-11-03 16:05:00
281,DSKY,62,165,7474025.0,25158718.0,11040,36339,67.7,69.23,47379,32632743.0,227,55,153,7430019.0,24934911.0,10971,35956,67.72,69.35,46927,32364930.0,208,2023-11-03 16:10:00
282,DSKY,124,1796,23498270.0,229194735.0,34674,331405,67.77,69.16,366079,252693005.0,1920,86,1767,23097636.0,228870558.0,34194,330814,67.55,69.18,365008,251968194.0,1853,2023-11-03 16:15:00
283,DSKY,81,3189,13319780.0,393278524.0,19717,568529,67.55,69.17,588246,406598304.0,3270,57,3158,12940856.0,393186561.0,19155,568314,67.56,69.18,587469,406127418.0,3215,2023-11-03 16:20:00
284,DSKY,87,1928,13397665.0,233463150.0,19598,337509,68.36,69.17,357107,246860815.0,2015,53,1901,12897319.0,232586533.0,19104,336138,67.51,69.19,355242,245483852.0,1954,2023-11-03 16:25:00
285,DSKY,75,1106,8117704.0,100506891.0,12095,145752,67.12,68.96,157847,108624595.0,1181,53,1091,7844774.0,100548764.0,11704,145802,67.03,68.96,157506,108393538.0,1144,2023-11-03 16:30:00
286,DSKY,283,1568,35701216.0,181610226.0,52939,262744,67.44,69.12,315683,217311442.0,1851,259,1545,35567323.0,181542805.0,52771,262595,67.4,69.13,315366,217110128.0,1804,2023-11-03 16:35:00
287,DSKY,195,896,22966236.0,136059416.0,34142,196752,67.27,69.15,230894,159025653.0,1091,184,882,22786366.0,135988936.0,33877,196647,67.26,69.15,230524,158775302.0,1066,2023-11-03 16:40:00
288,DSKY,257,2160,25638113.0,274460066.0,38003,396630,67.46,69.2,434633,300098179.0,2417,233,2138,25818223.0,274428393.0,38316,396578,67.38,69.2,434894,300246616.0,2371,2023-11-03 16:45:00
289,DSKY,118,2609,13311164.0,296522314.0,19832,430216,67.12,68.92,450048,309833479.0,2727,63,2583,12905402.0,295053522.0,19228,428029,67.12,68.93,447257,307958925.0,2646,2023-11-03 16:50:00
290,DSKY,125,3672,2750205.0,531962480.0,4047,773232,67.96,68.8,777279,534712685.0,3797,115,3656,4067377.0,531460956.0,6053,772494,67.2,68.8,778547,535528333.0,3771,2023-11-03 16:55:00
291,DSKY,42,3417,486165.0,481502506.0,713,700244,68.19,68.76,700957,481988672.0,3459,15,3398,75579.0,481132706.0,111,699691,68.09,68.76,699802,481208285.0,3413,2023-11-03 17:00:00
292,DSKY,179,1044,726821.0,148979669.0,1007,216549,72.18,68.8,217556,149706491.0,1223,149,1032,541284.0,148910824.0,793,216452,68.26,68.8,217245,149452108.0,1181,2023-11-03 17:05:00
293,DSKY,169,2118,943331.0,322270204.0,1384,468811,68.16,68.74,470195,323213535.0,2287,152,2100,576830.0,322205033.0,850,468700,67.86,68.74,469550,322781864.0,2252,2023-11-03 17:10:00
294,DSKY,54,1403,263125.0,208325412.0,386,302622,68.17,68.84,303008,208588537.0,1457,40,1391,190703.0,208300448.0,280,302585,68.11,68.84,302865,208491151.0,1431,2023-11-03 17:15:00
295,DSKY,50,1307,322147.0,172211523.0,472,249992,68.25,68.89,250464,172533671.0,1357,33,1289,245114.0,172083227.0,359,249804,68.28,68.89,250163,172328341.0,1322,2023-11-03 17:20:00
296,DSKY,64,1495,295304.0,202379843.0,484,294046,61.01,68.83,294530,202675147.0,1559,45,1481,154230.0,202396985.0,226,294062,68.24,68.83,294288,202551215.0,1526,2023-11-03 17:25:00
297,DSKY,63,542,1233126.0,53402130.0,1890,77606,65.24,68.81,79496,54635257.0,605,49,529,304196.0,52880442.0,500,76849,60.84,68.81,77349,53184639.0,578,2023-11-03 17:30:00
298,DSKY,12,512,265428.0,15579211.0,390,22789,68.06,68.36,23179,15844640.0,524,2,501,211422.0,15514292.0,310,22652,68.2,68.49,22962,15725714.0,503,2023-11-03 17:35:00
299,DSKY,66,335,1200545.0,23340897.0,1737,33989,69.12,68.67,35726,24541443.0,401,39,319,388355.0,23410437.0,573,34080,67.78,68.69,34653,23798792.0,358,2023-11-03 17:40:00
300,DSKY,59,23,973574.0,836982.0,1408,1062,69.15,78.81,2470,1810556.0,82,39,9,850672.0,37654.0,1258,55,67.62,68.46,1313,888326.0,48,2023-11-03 17:45:00
301,DSKY,52,136,162417.0,2075108.0,236,3039,68.82,68.28,3275,2237526.0,188,36,126,286001.0,1948944.0,420,2843,68.1,68.55,3263,2234945.0,162,2023-11-03 17:50:00
302,DSKY,83,65,1038558.0,847374.0,1524,1233,68.15,68.72,2757,1885933.0,148,69,49,758503.0,737772.0,1124,1077,67.48,68.5,2201,1496275.0,118,2023-11-03 17:55:00
303,DSKY,48,24,277350.0,443528.0,338,650,82.06,68.24,988,720878.0,72,25,11,114720.0,383064.0,168,558,68.29,68.65,726,497785.0,36,2023-11-03 18:00:00
304,DSKY,17,19,791338.0,287871.0,1132,425,69.91,67.73,1557,1079210.0,36,19,10,67621.0,184954.0,99,269,68.3,68.76,368,252576.0,29,2023-11-03 18:05:00
305,DSKY,135,1011,2382108.0,93881621.0,3459,136150,68.87,68.95,139609,96263730.0,1146,105,989,1700804.0,93558928.0,2515,134775,67.63,69.42,137290,95259733.0,1094,2023-11-03 18:10:00
306,DSKY,89,1179,1576123.0,127143271.0,2286,184440,68.95,68.93,186726,128719395.0,1268,49,1165,997104.0,126964076.0,1473,184152,67.69,68.95,185625,127961180.0,1214,2023-11-03 18:15:00
307,DSKY,94,3123,907216.0,374180378.0,1271,542922,71.38,68.92,544193,375087595.0,3217,85,3103,1515075.0,374057647.0,2215,542656,68.4,68.93,544871,375572722.0,3188,2023-11-03 18:20:00
308,DSKY,140,3479,907738.0,427320829.0,1307,619640,69.45,68.96,620947,428228568.0,3619,116,3464,1048538.0,427648338.0,1508,620092,69.53,68.97,621600,428696876.0,3580,2023-11-03 18:25:00
309,DSKY,86,3212,771879.0,336337456.0,1134,487715,68.07,68.96,488849,337109335.0,3298,67,3197,397318.0,335426217.0,582,486381,68.27,68.96,486963,335823535.0,3264,2023-11-03 18:30:00
310,DSKY,42,3032,188399.0,300186400.0,275,435379,68.51,68.95,435654,300374800.0,3074,37,3026,498961.0,300323110.0,756,435536,66.0,68.95,436292,300822071.0,3063,2023-11-03 18:35:00
311,DSKY,117,2080,1299355.0,256914433.0,1927,373031,67.43,68.87,374958,258213789.0,2197,91,2064,1287801.0,257236469.0,1912,373307,67.35,68.91,375219,258524270.0,2155,2023-11-03 18:40:00
312,DSKY,709,4382,102878527.0,398348170.0,151155,570932,68.06,69.77,722087,501226697.0,5091,589,4119,96719676.0,390886273.0,143437,562811,67.43,69.45,706248,487605949.0,4708,2023-11-06 10:05:00
313,DSKY,1908,1093,263283011.0,37463860.0,387815,49832,67.89,75.18,437647,300746871.0,3001,1886,1060,263786954.0,27015884.0,388643,39242,67.87,68.84,427885,290802838.0,2946,2023-11-06 10:10:00
314,DSKY,2379,952,350667502.0,26655286.0,518786,38574,67.59,69.1,557360,377322788.0,3331,2364,934,349583538.0,25322067.0,517104,36732,67.6,68.94,553836,374905606.0,3298,2023-11-06 10:15:00
315,DSKY,1447,625,261142774.0,19740171.0,386346,28638,67.59,68.93,414984,280882945.0,2072,1425,606,260991389.0,19394664.0,386149,28136,67.59,68.93,414285,280386053.0,2031,2023-11-06 10:20:00
316,DSKY,2118,1053,293008577.0,39210410.0,429820,56230,68.17,69.73,486050,332218987.0,3171,2098,1042,292933842.0,39204735.0,429728,56212,68.17,69.74,485940,332138578.0,3140,2023-11-06 10:25:00
317,DSKY,2157,455,328533557.0,15525227.0,482851,22484,68.04,69.05,505335,344058785.0,2612,2144,442,328303692.0,15322997.0,482631,22194,68.02,69.04,504825,343626689.0,2586,2023-11-06 10:30:00
318,DSKY,480,84,55871265.0,1603815.0,82652,2333,67.6,68.74,84985,57475080.0,564,471,72,55858705.0,1556998.0,82625,2260,67.61,68.89,84885,57415704.0,543,2023-11-06 10:35:00
319,DSKY,249,35,40306349.0,557774.0,59778,724,67.43,77.04,60502,40864124.0,284,240,28,40286457.0,551438.0,59765,713,67.41,77.34,60478,40837895.0,268,2023-11-06 10:40:00
320,DSKY,419,223,96289548.0,6119339.0,143441,9099,67.13,67.25,152540,102408888.0,642,399,208,96216298.0,6076691.0,143315,8818,67.14,68.91,152133,102292989.0,607,2023-11-06 10:45:00
321,DSKY,124,306,19035896.0,8282171.0,28323,12039,67.21,68.79,40362,27318067.0,430,105,300,18999139.0,8615872.0,28277,12524,67.19,68.79,40801,27615012.0,405,2023-11-06 10:50:00
322,DSKY,34,190,3725451.0,6223486.0,5527,9036,67.4,68.87,14563,9948938.0,224,24,173,3499173.0,5785115.0,5187,8399,67.46,68.88,13586,9284289.0,197,2023-11-06 10:55:00
323,DSKY,1217,262,181447880.0,14868094.0,267335,21581,67.87,68.89,288916,196315974.0,1479,1203,249,181247077.0,14749943.0,267133,21418,67.85,68.87,288551,195997021.0,1452,2023-11-06 11:00:00
324,DSKY,773,221,92998269.0,11798097.0,137094,17066,67.84,69.13,154160,104796366.0,994,763,201,92896465.0,11354680.0,136952,16489,67.83,68.86,153441,104251145.0,964,2023-11-06 11:05:00
325,DSKY,331,269,41411695.0,5149803.0,61441,7524,67.4,68.45,68965,46561499.0,600,326,263,41399626.0,5102562.0,61423,7428,67.4,68.69,68851,46502188.0,589,2023-11-06 11:10:00
326,DSKY,117,167,10903237.0,4795310.0,16152,6959,67.5,68.91,23111,15698548.0,284,109,167,10881518.0,4746420.0,16124,6903,67.49,68.76,23027,15627938.0,276,2023-11-06 11:15:00
327,DSKY,703,495,92653741.0,12819214.0,135870,18629,68.19,68.81,154499,105472955.0,1198,686,489,92525977.0,12804710.0,135709,18609,68.18,68.81,154318,105330688.0,1175,2023-11-06 11:20:00
328,DSKY,840,567,101869622.0,16228920.0,149507,23599,68.14,68.77,173106,118098542.0,1407,825,557,101813218.0,16208417.0,149432,23556,68.13,68.81,172988,118021636.0,1382,2023-11-06 11:25:00
329,DSKY,1538,525,176312263.0,19941150.0,258367,28971,68.24,68.83,287338,196253413.0,2063,1523,520,175847333.0,19865707.0,257801,28862,68.21,68.83,286663,195713041.0,2043,2023-11-06 11:30:00
330,DSKY,3171,431,450666855.0,20608436.0,660972,29854,68.18,69.03,690826,471275292.0,3602,3163,425,450678072.0,20549627.0,660988,29769,68.18,69.03,690757,471227700.0,3588,2023-11-06 11:35:00
331,DSKY,1769,180,266890426.0,6910346.0,391490,10002,68.17,69.09,401492,273800772.0,1949,1760,169,266599972.0,6660577.0,391204,9651,68.15,69.01,400855,273260549.0,1929,2023-11-06 11:40:00
332,DSKY,2101,276,316413453.0,8339949.0,460373,11973,68.73,69.66,472346,324753402.0,2377,2074,212,315676435.0,7318584.0,459332,10495,68.73,69.73,469827,322995020.0,2286,2023-11-06 11:45:00
333,DSKY,2663,397,539979631.0,7305990.0,787876,10495,68.54,69.61,798371,547285622.0,3060,2640,363,539909122.0,7043250.0,787857,10121,68.53,69.59,797978,546952373.0,3003,2023-11-06 11:50:00
334,DSKY,2093,221,452319842.0,6070444.0,659846,7414,68.55,81.88,667260,458390286.0,2314,2081,204,452185555.0,4880823.0,659573,7036,68.56,69.37,666609,457066379.0,2285,2023-11-06 11:55:00
335,DSKY,2678,328,523569935.0,7402258.0,761866,10664,68.72,69.41,772530,530972193.0,3006,2670,321,523601949.0,7393520.0,761921,10650,68.72,69.42,772571,530995469.0,2991,2023-11-06 12:00:00
336,DSKY,1599,233,328979815.0,5259798.0,479434,7573,68.62,69.45,487007,334239613.0,1832,1591,225,328975318.0,5140525.0,479433,7400,68.62,69.47,486833,334115844.0,1816,2023-11-06 12:05:00
337,DSKY,1487,552,280477212.0,13384181.0,408646,19349,68.64,69.17,427995,293861394.0,2039,1462,531,280326116.0,13248479.0,408421,19050,68.64,69.55,427471,293574595.0,1993,2023-11-06 12:10:00
338,DSKY,1608,1182,355101069.0,33814905.0,517076,48337,68.67,69.96,565413,388915974.0,2790,1598,1160,355081363.0,33003761.0,517051,47469,68.67,69.53,564520,388085124.0,2758,2023-11-06 12:15:00
339,DSKY,1917,1127,362869215.0,31898725.0,528496,45717,68.66,69.77,574213,394767940.0,3044,1910,1098,362994128.0,31058116.0,528677,44702,68.66,69.48,573379,394052245.0,3008,2023-11-06 12:20:00
340,DSKY,1928,578,353497148.0,17198293.0,514955,23991,68.65,71.69,538946,370695442.0,2506,1919,565,353156617.0,14286609.0,514453,20629,68.65,69.25,535082,367443227.0,2484,2023-11-06 12:25:00
341,DSKY,2034,422,327391423.0,13514616.0,477106,19512,68.62,69.26,496618,340906039.0,2456,2033,417,327533280.0,13580946.0,477319,19601,68.62,69.29,496920,341114227.0,2450,2023-11-06 12:30:00
342,DSKY,2979,679,435431423.0,21059318.0,634231,30299,68.66,69.5,664530,456490741.0,3658,2971,675,435350143.0,20804553.0,634119,29939,68.65,69.49,664058,456154696.0,3646,2023-11-06 12:35:00
343,DSKY,2862,1034,410804124.0,29748476.0,598299,42781,68.66,69.54,641080,440552600.0,3896,2852,1023,410700553.0,29591849.0,598149,42574,68.66,69.51,640723,440292403.0,3875,2023-11-06 12:40:00
344,DSKY,3401,1204,469374565.0,34766728.0,683539,50054,68.67,69.46,733593,504141293.0,4605,3378,1197,468162891.0,34780425.0,681611,50061,68.68,69.48,731672,502943316.0,4575,2023-11-06 12:45:00
345,DSKY,2942,571,394738232.0,16930508.0,574457,24246,68.72,69.83,598703,411668740.0,3513,2933,566,394562197.0,16846488.0,574137,24135,68.72,69.8,598272,411408686.0,3499,2023-11-06 12:50:00
346,DSKY,2730,485,402460331.0,13837007.0,586696,19697,68.6,70.25,606393,416297339.0,3215,2714,479,402880057.0,13842692.0,587294,19681,68.6,70.34,606975,416722749.0,3193,2023-11-06 12:55:00
347,DSKY,2825,488,431346513.0,14534740.0,629144,20986,68.56,69.26,650130,445881253.0,3313,2819,479,430904872.0,14437503.0,628502,20846,68.56,69.26,649348,445342375.0,3298,2023-11-06 13:00:00
348,DSKY,3597,498,566844095.0,13469033.0,827213,19475,68.52,69.16,846688,580313128.0,4095,3592,491,566942724.0,13475432.0,827383,19484,68.52,69.16,846867,580418156.0,4083,2023-11-06 13:05:00
349,DSKY,2438,454,391845278.0,12420016.0,572660,17918,68.43,69.32,590578,404265295.0,2892,2427,449,391655102.0,12378393.0,572442,17859,68.42,69.31,590301,404033496.0,2876,2023-11-06 13:10:00
350,DSKY,4124,389,644619654.0,9642266.0,942402,13919,68.4,69.27,956321,654261920.0,4513,4116,380,644655233.0,9638249.0,942442,13908,68.4,69.3,956350,654293482.0,4496,2023-11-06 13:15:00
351,DSKY,3625,478,578526346.0,15373381.0,846446,22206,68.35,69.23,868652,593899727.0,4103,3596,461,578373713.0,15373946.0,846281,22061,68.34,69.69,868342,593747659.0,4057,2023-11-06 13:20:00
352,DSKY,3209,637,493097882.0,19188139.0,719699,27710,68.51,69.25,747409,512286022.0,3846,3201,633,493104806.0,19187831.0,719714,27709,68.51,69.25,747423,512292637.0,3834,2023-11-06 13:25:00
353,DSKY,3992,801,608026802.0,16400004.0,887784,23710,68.49,69.17,911494,624426806.0,4793,3991,797,607875177.0,16396230.0,887563,23700,68.49,69.18,911263,624271407.0,4788,2023-11-06 13:30:00
354,DSKY,2907,331,453603049.0,6497527.0,663049,9392,68.41,69.18,672441,460100576.0,3238,2907,328,453694175.0,6460657.0,663173,9338,68.41,69.19,672511,460154832.0,3235,2023-11-06 13:35:00
355,DSKY,1783,427,288027276.0,10353250.0,421906,14972,68.27,69.15,436878,298380526.0,2210,1776,424,288116774.0,10342243.0,422045,14956,68.27,69.15,437001,298459017.0,2200,2023-11-06 13:40:00
356,DSKY,4124,533,597443394.0,15413904.0,873925,22288,68.36,69.16,896213,612857298.0,4657,4114,525,597309122.0,15294774.0,873730,22114,68.36,69.16,895844,612603897.0,4639,2023-11-06 13:45:00
357,DSKY,2574,65,391399914.0,546940.0,572645,795,68.35,68.8,573440,391946855.0,2639,2568,60,391378385.0,627444.0,572614,907,68.35,69.18,573521,392005830.0,2628,2023-11-06 13:50:00
358,DSKY,3277,335,484684133.0,11945712.0,709263,17255,68.34,69.23,726518,496629845.0,3612,3264,330,484528205.0,11973896.0,709045,17292,68.34,69.25,726337,496502101.0,3594,2023-11-06 13:55:00
359,DSKY,5082,665,665905382.0,29377196.0,971823,42367,68.52,69.34,1014190,695282578.0,5747,5067,660,666038126.0,29329818.0,972018,42299,68.52,69.34,1014317,695367944.0,5727,2023-11-06 14:00:00
360,DSKY,4569,708,570772210.0,32948540.0,831977,47572,68.6,69.26,879549,603720750.0,5277,4561,702,570711204.0,32970944.0,831899,47612,68.6,69.25,879511,603682149.0,5263,2023-11-06 14:05:00
361,DSKY,3466,275,470340500.0,12202692.0,687130,17626,68.45,69.23,704756,482543193.0,3741,3461,268,470184866.0,12216097.0,686891,17642,68.45,69.24,704533,482400964.0,3729,2023-11-06 14:10:00
362,DSKY,2359,8,353160696.0,128756.0,516472,186,68.38,69.22,516658,353289453.0,2367,2354,6,353136474.0,122590.0,516440,177,68.38,69.26,516617,353259064.0,2360,2023-11-06 14:15:00
363,DSKY,2940,11,430996418.0,234754.0,628963,332,68.52,70.71,629295,431231172.0,2951,2940,5,430854005.0,22696.0,628746,32,68.53,70.92,628778,430876701.0,2945,2023-11-06 14:20:00
364,DSKY,2483,20,356222141.0,297199.0,519770,431,68.53,68.96,520201,356519340.0,2503,2484,13,356217255.0,226202.0,519764,327,68.53,69.18,520091,356443458.0,2497,2023-11-06 14:25:00
365,DSKY,1396,134,207515678.0,4680736.0,303403,6766,68.4,69.18,310169,212196415.0,1530,1388,135,207492375.0,4883760.0,303373,7060,68.4,69.18,310433,212376135.0,1523,2023-11-06 14:30:00
366,DSKY,3299,69,478373565.0,2351175.0,700520,3394,68.29,69.27,703914,480724740.0,3368,3296,64,478504221.0,1895661.0,700710,2733,68.29,69.36,703443,480399882.0,3360,2023-11-06 14:35:00
367,DSKY,3598,117,455803421.0,3933518.0,668388,5683,68.19,69.22,674071,459736940.0,3715,3597,106,456460560.0,3631711.0,669350,5247,68.19,69.22,674597,460092272.0,3703,2023-11-06 14:40:00
368,DSKY,2788,54,396912234.0,1691669.0,582216,2448,68.17,69.1,584664,398603903.0,2842,2784,54,396738700.0,1700673.0,581962,2461,68.17,69.1,584423,398439374.0,2838,2023-11-06 14:45:00
369,DSKY,3812,450,393345261.0,13591054.0,574264,19721,68.5,68.92,593985,406936315.0,4262,3798,441,392945735.0,13579182.0,573686,19654,68.49,69.09,593340,406524918.0,4239,2023-11-06 14:50:00
370,DSKY,5038,751,417460556.0,17390345.0,609561,25192,68.49,69.03,634753,434850901.0,5789,5033,744,417769873.0,17299239.0,610044,25057,68.48,69.04,635101,435069112.0,5777,2023-11-06 14:55:00
371,DSKY,4247,944,409490479.0,29792559.0,599505,43128,68.3,69.08,642633,439283038.0,5191,4222,926,408708237.0,29825486.0,598364,43162,68.3,69.1,641526,438533723.0,5148,2023-11-06 15:00:00
372,DSKY,4473,1247,352682271.0,34974681.0,514417,50613,68.56,69.1,565030,387656952.0,5720,4467,1244,353287800.0,34938240.0,515304,50561,68.56,69.1,565865,388226040.0,5711,2023-11-06 15:05:00
373,DSKY,3996,1155,457058295.0,36284335.0,669974,52506,68.22,69.11,722480,493342630.0,5151,3991,1147,456417023.0,36268438.0,669035,52476,68.22,69.11,721511,492685461.0,5138,2023-11-06 15:10:00
374,DSKY,2592,755,280420027.0,22670857.0,410834,32807,68.26,69.1,443641,303090885.0,3347,2588,755,281211741.0,22680197.0,411996,32820,68.26,69.1,444816,303891939.0,3343,2023-11-06 15:15:00
375,DSKY,4542,790,410434175.0,26000722.0,598829,37623,68.54,69.11,636452,436434897.0,5332,4523,783,410014929.0,25915458.0,598231,37500,68.54,69.11,635731,435930387.0,5306,2023-11-06 15:20:00
376,DSKY,5086,922,436342253.0,28931813.0,636160,41862,68.59,69.11,678022,465274066.0,6008,5082,917,436559088.0,28909594.0,636474,41830,68.59,69.11,678304,465468682.0,5999,2023-11-06 15:25:00
377,DSKY,4958,987,415710024.0,34393959.0,605695,49748,68.63,69.14,655443,450103984.0,5945,4946,987,415876237.0,34478436.0,605940,49870,68.63,69.14,655810,450354673.0,5933,2023-11-06 15:30:00
378,DSKY,3863,1010,436975860.0,24763912.0,639691,35907,68.31,68.97,675598,461739773.0,4873,3819,986,435473647.0,24640468.0,638410,35675,68.21,69.07,674085,460114116.0,4805,2023-11-06 15:35:00
379,DSKY,4167,850,486240082.0,40591828.0,711736,58781,68.32,69.06,770517,526831910.0,5017,4168,847,487377241.0,40499678.0,712495,58647,68.4,69.06,771142,527876919.0,5015,2023-11-06 15:40:00
380,DSKY,4430,930,480716779.0,33897289.0,703319,49084,68.35,69.06,752403,514614068.0,5360,4423,926,480884996.0,33896711.0,703361,49083,68.37,69.06,752444,514781707.0,5349,2023-11-06 15:45:00
381,DSKY,3731,930,446375671.0,19615320.0,653718,28454,68.28,68.94,682172,465990992.0,4661,3724,919,445569909.0,19572266.0,652544,28351,68.28,69.04,680895,465142175.0,4643,2023-11-06 15:50:00
382,DSKY,3474,1014,381808392.0,32060285.0,558551,46441,68.36,69.03,604992,413868677.0,4488,3454,1008,382517003.0,32034156.0,559590,46402,68.36,69.04,605992,414551159.0,4462,2023-11-06 15:55:00
383,DSKY,4585,659,443891716.0,17840117.0,648640,25870,68.43,68.96,674510,461731834.0,5244,4563,643,442958048.0,17783668.0,647278,25776,68.43,68.99,673054,460741716.0,5206,2023-11-06 16:00:00
384,DSKY,4297,933,471209687.0,35123690.0,689892,50880,68.3,69.03,740772,506333377.0,5230,4290,927,471287412.0,35041093.0,690003,50756,68.3,69.04,740759,506328505.0,5217,2023-11-06 16:05:00
385,DSKY,2461,731,218960152.0,20737327.0,320081,30041,68.41,69.03,350122,239697479.0,3192,2462,723,220399865.0,20662970.0,322192,29936,68.41,69.02,352128,241062835.0,3185,2023-11-06 16:10:00
386,DSKY,2081,545,200556406.0,15863799.0,292772,22983,68.5,69.02,315755,216420206.0,2626,2059,536,201111259.0,15818680.0,293625,22918,68.49,69.02,316543,216929939.0,2595,2023-11-06 16:15:00
387,DSKY,3711,594,352957498.0,17395309.0,514723,25213,68.57,68.99,539936,370352807.0,4305,3698,590,352522693.0,17398549.0,514085,25213,68.57,69.01,539298,369921242.0,4288,2023-11-06 16:20:00
388,DSKY,2317,491,250046289.0,13848294.0,365028,20061,68.5,69.03,385089,263894584.0,2808,2315,492,249840265.0,13862058.0,364719,20081,68.5,69.03,384800,263702323.0,2807,2023-11-06 16:25:00
389,DSKY,3246,597,314610491.0,16060725.0,458905,23278,68.56,69.0,482183,330671216.0,3843,3246,595,315258098.0,16036543.0,459859,23238,68.56,69.01,483097,331294641.0,3841,2023-11-06 16:30:00
390,DSKY,3024,489,287205737.0,15510607.0,418748,22480,68.59,69.0,441228,302716344.0,3513,3015,485,286911303.0,15549022.0,418326,22536,68.59,69.0,440862,302460325.0,3500,2023-11-06 16:35:00
391,DSKY,3226,452,339340457.0,14374225.0,494829,20836,68.58,68.99,515665,353714683.0,3678,3224,450,338862214.0,14394154.0,494135,20865,68.58,68.99,515000,353256369.0,3674,2023-11-06 16:40:00
392,DSKY,1528,234,195825878.0,5788408.0,285614,8399,68.56,68.92,294013,201614286.0,1762,1527,231,195947110.0,5720199.0,285787,8291,68.56,68.99,294078,201667310.0,1758,2023-11-06 16:45:00
393,DSKY,1044,374,116693737.0,8090827.0,170896,11728,68.28,68.99,182624,124784564.0,1418,1039,370,116829428.0,8166388.0,171082,11837,68.29,68.99,182919,124995816.0,1409,2023-11-06 16:50:00
394,DSKY,1468,377,182509414.0,9233844.0,266217,13380,68.56,69.01,279597,191743259.0,1845,1462,371,182062915.0,9147982.0,265596,13256,68.55,69.01,278852,191210898.0,1833,2023-11-06 16:55:00
395,DSKY,2199,87,281220425.0,2447263.0,409941,3547,68.6,69.0,413488,283667689.0,2286,2194,80,281304101.0,2431432.0,410058,3519,68.6,69.09,413577,283735533.0,2274,2023-11-06 17:00:00
396,DSKY,2106,104,258222617.0,2084249.0,376635,3039,68.56,68.58,379674,260306866.0,2210,2106,98,258307820.0,1858033.0,376761,2691,68.56,69.05,379452,260165853.0,2204,2023-11-06 17:05:00
397,DSKY,1679,218,199931626.0,2234190.0,291592,3244,68.57,68.87,294836,202165816.0,1897,1676,218,199776958.0,2383583.0,291372,3454,68.56,69.01,294826,202160541.0,1894,2023-11-06 17:10:00
398,DSKY,1468,251,173950809.0,3573550.0,253699,5183,68.57,68.95,258882,177524359.0,1719,1468,245,174579975.0,3460492.0,254616,5016,68.57,68.99,259632,178040467.0,1713,2023-11-06 17:15:00
399,DSKY,1235,459,118899163.0,9269933.0,173435,13435,68.56,69.0,186870,128169096.0,1694,1233,459,118770284.0,9343875.0,173246,13542,68.56,69.0,186788,128114159.0,1692,2023-11-06 17:20:00
400,DSKY,1148,438,122801519.0,7910724.0,179794,11472,68.3,68.96,191266,130712244.0,1586,1145,434,122445696.0,7914819.0,179276,11477,68.3,68.96,190753,130360516.0,1579,2023-11-06 17:25:00
401,DSKY,1246,237,136811638.0,5205570.0,199860,7546,68.45,68.98,207406,142017208.0,1483,1232,231,136732152.0,5042999.0,199735,7310,68.46,68.99,207045,141775152.0,1463,2023-11-06 17:30:00
402,DSKY,1369,58,178225967.0,1512468.0,259966,2197,68.56,68.84,262163,179738435.0,1427,1363,57,178256048.0,1507008.0,260027,2185,68.55,68.97,262212,179763056.0,1420,2023-11-06 17:35:00
403,DSKY,1997,96,228158695.0,2592418.0,332716,3757,68.57,69.0,336473,230751114.0,2093,1998,95,227953603.0,2568699.0,332422,3723,68.57,69.0,336145,230522302.0,2093,2023-11-06 17:40:00
404,DSKY,5,46,139852.0,1164433.0,202,1761,69.23,66.12,1963,1304285.0,51,11,42,142609.0,1067802.0,207,1545,68.89,69.11,1752,1210411.0,53,2023-11-06 17:45:00
405,DSKY,29,10,2448451.0,172831.0,3579,250,68.41,69.13,3829,2621283.0,39,30,7,2368779.0,163244.0,3467,236,68.32,69.17,3703,2532023.0,37,2023-11-06 17:50:00
406,DSKY,2,4,687051.0,107208.0,115,155,597.44,69.17,270,794259.0,6,2,3,7562.0,52608.0,11,76,68.75,69.22,87,60171.0,5,2023-11-06 17:55:00
407,DSKY,20,53,107392.0,1628931.0,155,2371,69.29,68.7,2526,1736323.0,73,17,53,194981.0,1804097.0,288,2609,67.7,69.15,2897,1999078.0,70,2023-11-06 18:00:00
408,DSKY,44,19,2695262.0,492273.0,3941,709,68.39,69.43,4650,3187535.0,63,41,9,2226590.0,232522.0,3245,334,68.62,69.62,3579,2459112.0,50,2023-11-06 18:05:00
409,DSKY,35,26,3426406.0,605487.0,4984,1031,68.75,58.73,6015,4031894.0,61,27,16,3035361.0,453564.0,4452,653,68.18,69.46,5105,3488926.0,43,2023-11-06 18:10:00
410,DSKY,40,32,6738745.0,487679.0,9822,705,68.61,69.17,10527,7226425.0,72,36,30,6737098.0,446251.0,9820,645,68.61,69.19,10465,7183350.0,66,2023-11-06 18:15:00
411,DSKY,476,137,63985600.0,1981218.0,93374,2864,68.53,69.18,96238,65966818.0,613,473,132,64251120.0,1912855.0,93841,2764,68.47,69.21,96605,66163975.0,605,2023-11-06 18:20:00
412,DSKY,724,81,110543687.0,1487051.0,161212,2176,68.57,68.34,163388,112030738.0,805,717,74,110365944.0,1429807.0,160978,2066,68.56,69.21,163044,111795752.0,791,2023-11-06 18:25:00
413,DSKY,370,44,37934343.0,1012328.0,55199,1494,68.72,67.76,56693,38946672.0,414,356,37,37561687.0,1100192.0,54736,1589,68.62,69.24,56325,38661879.0,393,2023-11-06 18:30:00
414,DSKY,198,72,19219557.0,1068352.0,28020,1545,68.59,69.15,29565,20287909.0,270,195,57,19651205.0,832562.0,28653,1198,68.58,69.5,29851,20483767.0,252,2023-11-06 18:35:00
415,DSKY,76,40,7326941.0,1012884.0,10677,1466,68.62,69.09,12143,8339825.0,116,72,36,7481691.0,673010.0,10910,968,68.58,69.53,11878,8154701.0,108,2023-11-06 18:40:00
416,DSKY,1582,2670,158029031.0,210477363.0,231178,290241,68.36,72.52,521419,368506395.0,4252,1501,2449,154413898.0,192795300.0,225563,274189,68.46,70.31,499752,347209198.0,3950,2023-11-07 10:05:00
417,DSKY,4322,3598,612488263.0,306571985.0,903933,439849,67.76,69.7,1343782,919060248.0,7920,4308,3573,611268011.0,305530267.0,902131,438349,67.76,69.7,1340480,916798278.0,7881,2023-11-07 10:10:00
418,DSKY,1024,3300,82252619.0,316656551.0,120712,454426,68.14,69.68,575138,398909171.0,4324,1005,3279,82005696.0,316726766.0,120343,454504,68.14,69.69,574847,398732463.0,4284,2023-11-07 10:15:00
419,DSKY,103,4204,4792727.0,388633079.0,6944,557898,69.02,69.66,564842,393425807.0,4307,102,4193,4749251.0,387880561.0,6962,556756,68.22,69.67,563718,392629813.0,4295,2023-11-07 10:20:00
420,DSKY,646,2778,60520693.0,268605533.0,89114,385599,67.91,69.66,474713,329126227.0,3424,646,2774,60530697.0,268776540.0,89127,385848,67.92,69.66,474975,329307238.0,3420,2023-11-07 10:25:00
421,DSKY,1834,3626,215196855.0,365698012.0,318495,525091,67.57,69.64,843586,580894867.0,5460,1813,3602,215079983.0,365142105.0,318307,524140,67.57,69.66,842447,580222088.0,5415,2023-11-07 10:30:00
422,DSKY,333,3744,27538556.0,412087090.0,40425,591637,68.12,69.65,632062,439625646.0,4077,319,3734,27483894.0,412067770.0,40284,591603,68.23,69.65,631887,439551665.0,4053,2023-11-07 10:35:00
423,DSKY,44,4472,1348010.0,493695382.0,1963,709154,68.67,69.62,711117,495043393.0,4516,41,4456,1344391.0,493379547.0,1958,708725,68.66,69.62,710683,494723939.0,4497,2023-11-07 10:40:00
424,DSKY,88,4556,6008000.0,501130677.0,8923,720101,67.33,69.59,729024,507138677.0,4644,77,4550,5946217.0,501067545.0,8761,719994,67.87,69.59,728755,507013763.0,4627,2023-11-07 10:45:00
425,DSKY,122,4705,18049529.0,480896592.0,26688,690761,67.63,69.62,717449,498946122.0,4827,98,4693,17988010.0,480899945.0,26595,690742,67.64,69.62,717337,498887956.0,4791,2023-11-07 10:50:00
426,DSKY,91,4365,11467391.0,441705823.0,17186,635072,66.73,69.55,652258,453173214.0,4456,78,4341,11285033.0,441231875.0,16725,634376,67.47,69.55,651101,452516908.0,4419,2023-11-07 10:55:00
427,DSKY,130,4212,15662559.0,432663865.0,23151,622233,67.65,69.53,645384,448326424.0,4342,118,4201,14860037.0,432562206.0,21981,622042,67.6,69.54,644023,447422244.0,4319,2023-11-07 11:00:00
428,DSKY,72,4841,8677420.0,507777284.0,12820,730878,67.69,69.47,743698,516454704.0,4913,62,4834,9471327.0,507754993.0,13992,730832,67.69,69.48,744824,517226321.0,4896,2023-11-07 11:05:00
429,DSKY,106,3797,8098872.0,412298170.0,11942,593328,67.82,69.49,605270,420397042.0,3903,85,3787,8002581.0,412301440.0,11828,593336,67.66,69.49,605164,420304021.0,3872,2023-11-07 11:10:00
430,DSKY,117,3994,8338161.0,398507281.0,12274,573415,67.93,69.5,585689,406845442.0,4111,110,3969,8011512.0,398215164.0,11836,572973,67.69,69.5,584809,406226676.0,4079,2023-11-07 11:15:00
431,DSKY,169,4755,18356262.0,455199774.0,27089,655717,67.76,69.42,682806,473556036.0,4924,155,4737,18210415.0,454939120.0,26873,655379,67.76,69.42,682252,473149535.0,4892,2023-11-07 11:20:00
432,DSKY,73,2980,8316630.0,289301699.0,12299,416184,67.62,69.51,428483,297618329.0,3053,69,2950,8296040.0,287577007.0,12286,414154,67.52,69.44,426440,295873047.0,3019,2023-11-07 11:25:00
433,DSKY,103,3733,7514254.0,413038855.0,11108,594220,67.65,69.51,605328,420553110.0,3836,93,3709,7524521.0,410588080.0,11112,591381,67.72,69.43,602493,418112601.0,3802,2023-11-07 11:30:00
434,DSKY,53,3352,7434005.0,351848123.0,11026,506630,67.42,69.45,517656,359282128.0,3405,46,3339,7315129.0,351704640.0,10861,506415,67.35,69.45,517276,359019770.0,3385,2023-11-07 11:35:00
435,DSKY,86,1881,8057794.0,175499412.0,11967,252853,67.33,69.41,264820,183557206.0,1967,67,1871,7413324.0,175353422.0,11013,252622,67.31,69.41,263635,182766747.0,1938,2023-11-07 11:40:00
436,DSKY,111,568,7074876.0,46027189.0,10480,66423,67.51,69.29,76903,53102066.0,679,101,567,6931849.0,46025180.0,10268,66411,67.51,69.3,76679,52957030.0,668,2023-11-07 11:45:00
437,DSKY,50,1492,2195467.0,129519151.0,3253,186747,67.49,69.36,190000,131714619.0,1542,46,1484,2531715.0,129500489.0,4346,186716,58.25,69.36,191062,132032205.0,1530,2023-11-07 11:50:00
438,DSKY,45,2605,6719202.0,248863990.0,9950,358641,67.53,69.39,368591,255583193.0,2650,44,2599,6860679.0,248733639.0,10166,358442,67.49,69.39,368608,255594318.0,2643,2023-11-07 11:55:00
439,DSKY,152,324,12195663.0,13049255.0,17968,18875,67.87,69.14,36843,25244918.0,476,139,314,11661132.0,12923518.0,17167,18692,67.93,69.14,35859,24584651.0,453,2023-11-07 12:00:00
440,DSKY,33,279,3869474.0,19500022.0,5736,28167,67.46,69.23,33903,23369497.0,312,22,270,3477174.0,19112157.0,5166,27595,67.31,69.26,32761,22589331.0,292,2023-11-07 12:05:00
441,DSKY,25,148,2148728.0,8738819.0,3172,12632,67.74,69.18,15804,10887548.0,173,20,144,1997495.0,8582789.0,2966,12405,67.35,69.19,15371,10580284.0,164,2023-11-07 12:10:00
442,DSKY,8,59,34882.0,2024629.0,48,2942,72.67,68.82,2990,2059511.0,67,4,51,83546.0,2017521.0,122,2932,68.48,68.81,3054,2101068.0,55,2023-11-07 12:15:00
443,DSKY,19,39,724135.0,1375198.0,1990,1999,36.39,68.79,3989,2099334.0,58,12,35,331519.0,1276353.0,925,1855,35.84,68.81,2780,1607872.0,47,2023-11-07 12:20:00
444,DSKY,4,24,4114.0,816664.0,6,1185,68.57,68.92,1191,820778.0,28,5,21,25988.0,791439.0,38,1150,68.39,68.82,1188,817427.0,26,2023-11-07 12:25:00
445,DSKY,10,43,1557489.0,1009963.0,2313,1479,67.34,68.29,3792,2567453.0,53,7,38,1543881.0,995871.0,2292,1448,67.36,68.78,3740,2539753.0,45,2023-11-07 12:30:00
446,DSKY,9,153,197613.0,7088972.0,290,10307,68.14,68.78,10597,7286586.0,162,6,147,92220.0,6993727.0,135,10167,68.31,68.79,10302,7085947.0,153,2023-11-07 12:35:00
447,DSKY,23,30,396775.0,1100424.0,580,1601,68.41,68.73,2181,1497199.0,53,18,23,384450.0,1082980.0,562,1574,68.41,68.8,2136,1467431.0,41,2023-11-07 12:40:00
448,DSKY,21,2,63696.0,2068.0,88,5,72.38,41.37,93,65764.0,23,15,1,49220.0,42000.0,72,60,68.36,70.0,132,91220.0,16,2023-11-07 12:45:00
449,DSKY,19,33,43025.0,1380594.0,52,2002,82.74,68.96,2054,1423619.0,52,8,31,10960.0,1376503.0,16,1996,68.5,68.96,2012,1387463.0,39,2023-11-07 12:50:00
450,DSKY,38,72,3867174.0,2070032.0,5749,3076,67.27,67.3,8825,5937207.0,110,30,65,3823787.0,1980428.0,5685,2871,67.26,68.98,8556,5804215.0,95,2023-11-07 12:55:00
451,DSKY,164,126,21260070.0,3151222.0,31470,4588,67.56,68.68,36058,24411292.0,290,156,118,21125490.0,3079967.0,31331,4479,67.43,68.76,35810,24205458.0,274,2023-11-07 13:00:00
452,DSKY,24,45,323825.0,709145.0,502,1028,64.51,68.98,1530,1032971.0,69,17,37,180394.0,648838.0,263,940,68.59,69.03,1203,829232.0,54,2023-11-07 13:05:00
453,DSKY,50,51,814308.0,896884.0,1193,1299,68.26,69.04,2492,1711192.0,101,47,46,807304.0,892269.0,1178,1292,68.53,69.06,2470,1699574.0,93,2023-11-07 13:10:00
454,DSKY,28,19,6570177.0,305277.0,9750,446,67.39,68.45,10196,6875454.0,47,27,12,6514436.0,291418.0,9671,422,67.36,69.06,10093,6805854.0,39,2023-11-07 13:15:00
455,DSKY,97,19,14413084.0,331454.0,21403,483,67.34,68.62,21886,14744538.0,116,90,16,14378738.0,327127.0,21355,474,67.33,69.01,21829,14705865.0,106,2023-11-07 13:20:00
456,DSKY,18,17,1991246.0,313634.0,2953,459,67.43,68.33,3412,2304881.0,35,16,11,1979863.0,280144.0,2931,407,67.55,68.83,3338,2260008.0,27,2023-11-07 13:25:00
457,DSKY,605,40,66495285.0,215249.0,99114,316,67.09,68.12,99430,66710534.0,645,601,37,65938406.0,278619.0,97705,405,67.49,68.79,98110,66217025.0,638,2023-11-07 13:30:00
458,DSKY,149,6,22033185.0,41273.0,32702,60,67.38,68.79,32762,22074459.0,155,146,3,22030858.0,28961.0,32704,42,67.36,68.96,32746,22059819.0,149,2023-11-07 13:35:00
459,DSKY,55,25,4416705.0,754886.0,6537,1098,67.56,68.75,7635,5171591.0,80,50,24,4415352.0,743891.0,6531,1082,67.61,68.75,7613,5159244.0,74,2023-11-07 13:40:00
460,DSKY,444,18,17190256.0,392287.0,25388,571,67.71,68.7,25959,17582543.0,462,439,11,17170413.0,167764.0,25370,244,67.68,68.76,25614,17338177.0,450,2023-11-07 13:45:00
461,DSKY,146,154,18111025.0,3144011.0,26877,4724,67.38,66.55,31601,21255036.0,300,134,144,18102522.0,3048431.0,26866,4425,67.38,68.89,31291,21150954.0,278,2023-11-07 13:50:00
462,DSKY,64,177,3369655.0,3542394.0,4973,5418,67.76,65.38,10391,6912049.0,241,52,169,3337268.0,3350937.0,4931,4874,67.68,68.75,9805,6688206.0,221,2023-11-07 13:55:00
463,DSKY,199,280,13029790.0,9446416.0,19171,13687,67.97,69.02,32858,22476207.0,479,190,268,13018755.0,9385398.0,19149,13598,67.99,69.02,32747,22404154.0,458,2023-11-07 14:00:00
464,DSKY,83,56,5790074.0,1169894.0,8548,1699,67.74,68.86,10247,6959968.0,139,72,45,5680824.0,1140717.0,8400,1660,67.63,68.72,10060,6821541.0,117,2023-11-07 14:05:00
465,DSKY,47,91,1727126.0,2549093.0,2527,3707,68.35,68.76,6234,4276220.0,138,39,87,1655361.0,2522683.0,2422,3667,68.35,68.79,6089,4178044.0,126,2023-11-07 14:10:00
466,DSKY,11,60,146863.0,2108561.0,213,3056,68.95,69.0,3269,2255425.0,71,6,61,81998.0,2155098.0,128,3133,64.06,68.79,3261,2237096.0,67,2023-11-07 14:15:00
467,DSKY,11,86,39026.0,3993856.0,54,5800,72.27,68.86,5854,4032883.0,97,1,82,10209.0,4011037.0,15,5823,68.06,68.88,5838,4021246.0,83,2023-11-07 14:20:00
468,DSKY,4,58,22830.0,2570752.0,33,3729,69.18,68.94,3762,2593582.0,62,2,50,20421.0,2443724.0,30,3548,68.07,68.88,3578,2464145.0,52,2023-11-07 14:25:00
469,DSKY,7,174,142693.0,12176569.0,208,17616,68.6,69.12,17824,12319263.0,181,4,167,135174.0,12113321.0,198,17523,68.27,69.13,17721,12248495.0,171,2023-11-07 14:30:00
470,DSKY,8,32,114793.0,711830.0,168,1034,68.33,68.84,1202,826623.0,40,4,37,37495.0,826032.0,55,1199,68.17,68.89,1254,863527.0,41,2023-11-07 14:35:00
471,DSKY,9,110,24262.0,4090387.0,35,5824,69.32,70.23,5859,4114649.0,119,2,100,49177.0,3925894.0,72,5686,68.3,69.04,5758,3975072.0,102,2023-11-07 14:40:00
472,DSKY,8,18,79620.0,581177.0,117,739,68.05,78.64,856,660797.0,26,1,10,10209.0,543198.0,15,684,68.06,79.41,699,553407.0,11,2023-11-07 14:45:00
473,DSKY,3,7,6160.0,114060.0,9,150,68.45,76.04,159,120221.0,10,1,3,2056.0,68004.0,3,99,68.56,68.69,102,70061.0,4,2023-11-07 14:50:00
474,DSKY,4,22,41409.0,576665.0,59,841,70.19,68.57,900,618074.0,26,2,17,18396.0,570834.0,27,830,68.13,68.78,857,589230.0,19,2023-11-07 14:55:00
475,DSKY,11,15,124853.0,1139295.0,185,1643,67.49,69.34,1828,1264148.0,26,5,10,118897.0,1046597.0,174,1508,68.33,69.4,1682,1165494.0,15,2023-11-07 15:00:00
476,DSKY,9,19,71073.0,1256325.0,104,567,68.34,221.57,671,1327399.0,28,5,16,68368.0,1315857.0,100,569,68.37,231.26,669,1384225.0,21,2023-11-07 15:05:00
477,DSKY,5,14,17741.0,324593.0,26,473,68.23,68.62,499,342334.0,19,3,11,14310.0,296514.0,21,431,68.15,68.8,452,310825.0,14,2023-11-07 15:10:00
478,DSKY,4,11,9952.0,337714.0,14,503,71.09,67.14,517,347667.0,15,0,8,0.0,353460.0,0,511,,69.17,511,353460.0,8,2023-11-07 15:15:00
479,DSKY,11,87,47348.0,3808529.0,68,4513,69.63,84.39,4581,3855878.0,98,4,76,24520.0,3917140.0,36,4429,68.11,88.44,4465,3941660.0,80,2023-11-07 15:20:00
480,DSKY,9,69,29997.0,2907535.0,44,4231,68.17,68.72,4275,2937532.0,78,3,63,24522.0,2861088.0,36,4162,68.12,68.74,4198,2885610.0,66,2023-11-07 15:25:00
481,DSKY,2,78,32065.0,1285468.0,47,1892,68.22,67.94,1939,1317533.0,80,4,35,4789.0,1061292.0,7,1545,68.42,68.69,1552,1066082.0,39,2023-11-07 15:30:00
482,DSKY,5,96,68373.0,2302919.0,100,3352,68.37,68.7,3452,2371293.0,101,5,84,70314.0,2317038.0,103,3373,68.27,68.69,3476,2387353.0,89,2023-11-07 15:35:00
483,DSKY,10,46,1638734.0,1027958.0,2437,1552,67.24,66.23,3989,2666692.0,56,7,42,1636616.0,960575.0,2434,1399,67.24,68.66,3833,2597191.0,49,2023-11-07 15:40:00
484,DSKY,155,73,33091469.0,1478471.0,49158,2150,67.32,68.77,51308,34569940.0,228,145,56,32910718.0,1386311.0,48901,2014,67.3,68.83,50915,34297029.0,201,2023-11-07 15:45:00
485,DSKY,231,61,53568808.0,771359.0,79611,1114,67.29,69.24,80725,54340167.0,292,229,49,53566045.0,710750.0,79598,1028,67.3,69.14,80626,54276796.0,278,2023-11-07 15:50:00
486,DSKY,29,8,3408104.0,323729.0,5064,483,67.3,67.02,5547,3731833.0,37,19,8,3322466.0,255603.0,4941,371,67.24,68.9,5312,3578069.0,27,2023-11-07 15:55:00
487,DSKY,55,55,9602959.0,1684055.0,14262,2460,67.33,68.46,16722,11287015.0,110,49,46,9584709.0,1715980.0,14239,2490,67.31,68.91,16729,11300690.0,95,2023-11-07 16:00:00
488,DSKY,3,22,15070.0,159941.0,22,233,68.5,68.64,255,175011.0,25,2,17,80833.0,139415.0,118,203,68.5,68.68,321,220249.0,19,2023-11-07 16:05:00
489,DSKY,22,81,1880075.0,2503671.0,2785,3646,67.51,68.67,6431,4383746.0,103,16,77,1780802.0,2482759.0,2644,3613,67.35,68.72,6257,4263562.0,93,2023-11-07 16:10:00
490,DSKY,3,22,15080.0,557982.0,22,815,68.55,68.46,837,573063.0,25,1,21,12333.0,584673.0,18,851,68.52,68.7,869,597007.0,22,2023-11-07 16:15:00
491,DSKY,9,15,158032.0,420730.0,234,611,67.54,68.86,845,578762.0,24,9,10,1568903.0,340615.0,2328,494,67.39,68.95,2822,1909518.0,19,2023-11-07 16:20:00
492,DSKY,6,37,1429682.0,730750.0,2124,1078,67.31,67.79,3202,2160432.0,43,2,29,13705.0,660041.0,20,960,68.53,68.75,980,673746.0,31,2023-11-07 16:25:00
493,DSKY,6,33,37504.0,1383057.0,74,2012,50.68,68.74,2086,1420562.0,39,3,35,15077.0,1451951.0,22,2112,68.53,68.75,2134,1467029.0,38,2023-11-07 16:30:00
494,DSKY,4,8,71927.0,329185.0,105,478,68.5,68.87,583,401112.0,12,1,5,1371.0,254748.0,2,370,68.56,68.85,372,256119.0,6,2023-11-07 16:35:00
495,DSKY,6,12,81875.0,136345.0,118,195,69.39,69.92,313,218220.0,18,2,3,69756.0,90412.0,102,131,68.39,69.02,233,160168.0,5,2023-11-07 16:40:00
496,DSKY,2,8,5505.0,38297.0,7,58,78.65,66.03,65,43803.0,10,0,1,0.0,27448.0,0,40,,68.62,40,27448.0,1,2023-11-07 16:45:00
497,DSKY,116,17,34651205.0,394571.0,52575,553,65.91,71.35,53128,35045776.0,133,109,11,34676850.0,360364.0,52592,524,65.94,68.77,53116,35037214.0,120,2023-11-07 16:50:00
498,DSKY,7,48,14793.0,1677047.0,18,2452,82.19,68.4,2470,1691840.0,55,1,44,2734.0,1602909.0,4,2330,68.36,68.79,2334,1605643.0,45,2023-11-07 16:55:00
499,DSKY,12,16,389555.0,407475.0,569,624,68.46,65.3,1193,797030.0,28,10,11,375801.0,366828.0,549,532,68.45,68.95,1081,742630.0,21,2023-11-07 17:00:00
500,DSKY,9,16,24670.0,963435.0,36,1400,68.53,68.82,1436,988106.0,25,3,14,19864.0,950902.0,29,1382,68.5,68.81,1411,970767.0,17,2023-11-07 17:05:00
501,DSKY,4,8,91056.0,142907.0,133,208,68.46,68.71,341,233963.0,12,3,5,22543.0,77576.0,33,113,68.31,68.65,146,100120.0,8,2023-11-07 17:10:00
502,DSKY,12,4,202379.0,10625.0,299,20,67.69,53.13,319,213005.0,16,8,0,156141.0,0.0,230,0,67.89,,230,156141.0,8,2023-11-07 17:15:00
503,DSKY,9,7,35293.0,186123.0,51,285,69.2,65.31,336,221417.0,16,4,5,24643.0,198698.0,36,289,68.45,68.75,325,223342.0,9,2023-11-07 17:20:00
504,DSKY,32,31,162726.0,915300.0,236,1330,68.95,68.82,1566,1078026.0,63,23,27,146577.0,934625.0,214,1358,68.49,68.82,1572,1081203.0,50,2023-11-07 17:25:00
505,DSKY,41,17,1902001.0,446850.0,2789,649,68.2,68.85,3438,2348852.0,58,36,14,1792784.0,448615.0,2690,651,66.65,68.91,3341,2241399.0,50,2023-11-07 17:30:00
506,DSKY,35,16,184314.0,204872.0,269,298,68.52,68.75,567,389186.0,51,35,14,215008.0,193929.0,314,282,68.47,68.77,596,408938.0,49,2023-11-07 17:35:00
507,DSKY,25,12,261282.0,123520.0,376,180,69.49,68.62,556,384803.0,37,22,10,238612.0,115275.0,349,168,68.37,68.62,517,353888.0,32,2023-11-07 17:40:00
508,DSKY,12,14,58203.0,210310.0,85,312,68.48,67.41,397,268514.0,26,2,4,13698.0,67292.0,20,98,68.49,68.67,118,80990.0,6,2023-11-07 17:45:00
509,DSKY,4,7,117423.0,133197.0,125,192,93.94,69.37,317,250620.0,11,4,3,75823.0,59033.0,111,86,68.31,68.64,197,134856.0,7,2023-11-07 17:50:00
510,DSKY,16,9,234073.0,243514.0,337,355,69.46,68.6,692,477588.0,25,3,7,12327.0,239329.0,18,348,68.48,68.77,366,251656.0,10,2023-11-07 17:55:00
511,DSKY,13,27,64399.0,571771.0,91,832,70.77,68.72,923,636171.0,40,8,17,43089.0,557184.0,63,809,68.4,68.87,872,600273.0,25,2023-11-07 18:00:00
512,DSKY,9,17,77049.0,204861.0,91,300,84.67,68.29,391,281910.0,26,7,9,35479.0,176461.0,52,257,68.23,68.66,309,211941.0,16,2023-11-07 18:05:00
513,DSKY,201,587,30081090.0,59578120.0,46479,87391,64.72,68.17,133870,89659210.0,788,181,577,29947031.0,59066820.0,46221,85784,64.79,68.86,132005,89013851.0,758,2023-11-07 18:10:00
514,DSKY,51,631,597204.0,52255681.0,870,75919,68.64,68.83,76789,52852885.0,682,44,625,580816.0,52445897.0,854,76233,68.01,68.8,77087,53026713.0,669,2023-11-07 18:15:00
515,DSKY,121,443,13464507.0,34409059.0,20150,50036,66.82,68.77,70186,47873566.0,564,112,432,12690670.0,34275525.0,19076,49838,66.53,68.77,68914,46966195.0,544,2023-11-07 18:20:00
516,DSKY,141,94,15386003.0,3202579.0,22929,4659,67.1,68.74,27588,18588582.0,235,137,92,15391905.0,2862406.0,22937,4171,67.11,68.63,27108,18254312.0,229,2023-11-07 18:25:00
517,DSKY,79,74,8634046.0,1786210.0,12839,2602,67.25,68.65,15441,10420256.0,153,68,66,8275764.0,1764817.0,12303,2570,67.27,68.67,14873,10040581.0,134,2023-11-07 18:30:00
518,DSKY,43,37,5795263.0,1239290.0,8607,1795,67.33,69.04,10402,7034553.0,80,37,14,5681361.0,670732.0,8441,970,67.31,69.15,9411,6352094.0,51,2023-11-07 18:35:00
519,DSKY,6,6,139123.0,231079.0,192,337,72.46,68.57,529,370202.0,12,7,6,1775804.0,515148.0,2677,743,66.34,69.33,3420,2290952.0,13,2023-11-07 18:40:00
520,DSKY,501,2467,99933683.0,180045027.0,150378,258418,66.45,69.67,408796,279978710.0,2968,402,2217,95995589.0,173041396.0,143694,251245,66.81,68.87,394939,269036986.0,2619,2023-11-08 10:05:00
521,DSKY,232,795,37197207.0,53951179.0,55701,78329,66.78,68.88,134030,91148386.0,1027,219,780,37755857.0,53045202.0,56624,77057,66.68,68.84,133681,90801059.0,999,2023-11-08 10:10:00
522,DSKY,216,288,22425858.0,14044430.0,33556,20427,66.83,68.75,53983,36470288.0,504,188,273,22057991.0,13748250.0,33012,19984,66.82,68.8,52996,35806241.0,461,2023-11-08 10:15:00
523,DSKY,195,649,23935325.0,47142912.0,35942,68395,66.59,68.93,104337,71078237.0,844,174,633,23897999.0,46765511.0,35878,67821,66.61,68.95,103699,70663511.0,807,2023-11-08 10:20:00
524,DSKY,177,1104,19257115.0,80615174.0,28981,117117,66.45,68.83,146098,99872290.0,1281,148,1083,17535355.0,80240290.0,26341,116561,66.57,68.84,142902,97775646.0,1231,2023-11-08 10:25:00
525,DSKY,104,788,6339547.0,58760548.0,9429,85398,67.23,68.81,94827,65100096.0,892,89,779,6213360.0,58667296.0,9261,85249,67.09,68.82,94510,64880656.0,868,2023-11-08 10:30:00
526,DSKY,68,45,5272819.0,1499593.0,7859,2190,67.09,68.47,10049,6772413.0,113,53,36,5247160.0,1458772.0,7835,2129,66.97,68.52,9964,6705933.0,89,2023-11-08 10:35:00
527,DSKY,451,52,30050424.0,1701673.0,44611,2483,67.36,68.53,47094,31752097.0,503,434,42,30010875.0,1648766.0,44552,2397,67.36,68.78,46949,31659641.0,476,2023-11-08 10:40:00
528,DSKY,73,113,3100334.0,2546363.0,4589,3728,67.56,68.3,8317,5646698.0,186,45,106,3046163.0,3294630.0,4513,4791,67.5,68.77,9304,6340793.0,151,2023-11-08 10:45:00
529,DSKY,83,145,4765361.0,3455431.0,7054,5047,67.56,68.47,12101,8220792.0,228,77,112,4739017.0,2982263.0,7031,4358,67.4,68.43,11389,7721281.0,189,2023-11-08 10:50:00
530,DSKY,33,183,1652171.0,10964609.0,2464,16027,67.05,68.41,18491,12616780.0,216,16,168,1620424.0,10942747.0,2404,15950,67.41,68.61,18354,12563172.0,184,2023-11-08 10:55:00
531,DSKY,25,622,600955.0,47181541.0,887,68761,67.75,68.62,69648,47782496.0,647,8,616,302566.0,47150093.0,444,68712,68.15,68.62,69156,47452659.0,624,2023-11-08 11:00:00
532,DSKY,51,71,1708002.0,2538136.0,2518,3713,67.83,68.36,6231,4246139.0,122,24,64,1228893.0,2526388.0,1811,3686,67.86,68.54,5497,3755282.0,88,2023-11-08 11:05:00
533,DSKY,15,27,216798.0,423942.0,516,620,42.02,68.38,1136,640740.0,42,5,21,193976.0,365491.0,482,534,40.24,68.44,1016,559468.0,26,2023-11-08 11:10:00
534,DSKY,20,16,55739.0,148383.0,73,217,76.36,68.38,290,204122.0,36,8,9,19773.0,55444.0,29,81,68.18,68.45,110,75217.0,17,2023-11-08 11:15:00
535,DSKY,40,226,2102768.0,8261618.0,3118,12094,67.44,68.31,15212,10364387.0,266,30,211,1715059.0,8201210.0,2560,11930,66.99,68.74,14490,9916269.0,241,2023-11-08 11:20:00
536,DSKY,44,251,1193660.0,11051534.0,1746,16131,68.37,68.51,17877,12245194.0,295,36,243,1169672.0,10957815.0,1714,15967,68.24,68.63,17681,12127487.0,279,2023-11-08 11:25:00
537,DSKY,30,5,411314.0,75577.0,601,110,68.44,68.71,711,486892.0,35,32,1,710780.0,16435.0,1050,24,67.69,68.48,1074,727215.0,33,2023-11-08 11:30:00
538,DSKY,24,13,792492.0,193398.0,1222,282,64.85,68.58,1504,985891.0,37,16,6,725235.0,113525.0,1090,166,66.54,68.39,1256,838761.0,22,2023-11-08 11:35:00
539,DSKY,14,27,1776655.0,14271280.0,2639,14693,67.32,97.13,17332,16047935.0,41,8,8,1754522.0,147229.0,2602,215,67.43,68.48,2817,1901751.0,16,2023-11-08 11:40:00
540,DSKY,13,15,1474356.0,133429.0,2201,180,66.99,74.13,2381,1607786.0,28,9,4,1422628.0,50283.0,2112,73,67.36,68.88,2185,1472911.0,13,2023-11-08 11:45:00
541,DSKY,18,12,72396.0,93484.0,106,151,68.3,61.91,257,165881.0,30,12,3,57021.0,34900.0,84,51,67.88,68.43,135,91922.0,15,2023-11-08 11:50:00
542,DSKY,21,18,578573.0,575782.0,856,940,67.59,61.25,1796,1154356.0,39,18,10,519196.0,460057.0,770,669,67.43,68.77,1439,979254.0,28,2023-11-08 11:55:00
543,DSKY,69,304,10083820.0,27235539.0,15071,39817,66.91,68.4,54888,37319359.0,373,57,292,10001854.0,33872242.0,15002,44544,66.67,76.04,59546,43874096.0,349,2023-11-08 12:00:00
544,DSKY,40,139,3366821.0,18157073.0,4952,21879,67.99,82.99,26831,21523894.0,179,31,136,3331717.0,11939455.0,4899,17441,68.01,68.46,22340,15271172.0,167,2023-11-08 12:05:00
545,DSKY,22,93,458609.0,3207887.0,673,4687,68.14,68.44,5360,3666497.0,115,14,88,412788.0,2739999.0,607,4007,68.0,68.38,4614,3152787.0,102,2023-11-08 12:10:00
546,DSKY,33,92,1580250.0,2980113.0,2356,4357,67.07,68.4,6713,4560364.0,125,21,92,1534856.0,3395513.0,2290,4960,67.02,68.46,7250,4930369.0,113,2023-11-08 12:15:00
547,DSKY,95,97,12427631.0,2470411.0,18560,3867,66.96,63.88,22427,14898042.0,192,84,86,12344724.0,2107021.0,18435,3078,66.96,68.45,21513,14451746.0,170,2023-11-08 12:20:00
548,DSKY,43,37,2923122.0,1167478.0,4354,1694,67.14,68.92,6048,4090601.0,80,33,31,2811135.0,633097.0,4180,928,67.25,68.22,5108,3444232.0,64,2023-11-08 12:25:00
549,DSKY,55,15,7776143.0,889527.0,11666,1329,66.66,66.93,12995,8665670.0,70,33,8,7534946.0,151029.0,11378,220,66.22,68.65,11598,7685975.0,41,2023-11-08 12:30:00
550,DSKY,57,50,7665013.0,1635975.0,11506,2415,66.62,67.74,13921,9300988.0,107,36,40,7538424.0,1814900.0,11323,2660,66.58,68.23,13983,9353324.0,76,2023-11-08 12:35:00
551,DSKY,12,17,924485.0,846711.0,1431,1245,64.6,68.01,2676,1771196.0,29,4,10,736903.0,685191.0,1126,1003,65.44,68.31,2129,1422094.0,14,2023-11-08 12:40:00
552,DSKY,19,255,3011983.0,24098330.0,4522,35165,66.61,68.53,39687,27110314.0,274,11,249,2905168.0,24196884.0,4367,35309,66.53,68.53,39676,27102053.0,260,2023-11-08 12:45:00
553,DSKY,71,1156,11244793.0,123850375.0,16771,180980,67.05,68.43,197751,135095169.0,1227,63,1143,12533053.0,123621607.0,18840,180652,66.52,68.43,199492,136154660.0,1206,2023-11-08 12:50:00
554,DSKY,27,529,1707449.0,47962168.0,2540,70195,67.22,68.33,72735,49669617.0,556,17,521,1596712.0,47754761.0,2397,69898,66.61,68.32,72295,49351474.0,538,2023-11-08 12:55:00
555,DSKY,42,85,4866825.0,4114496.0,7272,6020,66.93,68.35,13292,8981321.0,127,39,78,4818558.0,4127022.0,7208,6037,66.85,68.36,13245,8945580.0,117,2023-11-08 13:00:00
556,DSKY,59,177,1480760.0,4514938.0,2222,6639,66.64,68.01,8861,5995699.0,236,48,163,1334970.0,4613459.0,1962,6749,68.04,68.36,8711,5948430.0,211,2023-11-08 13:05:00
557,DSKY,30,66,2559137.0,1734159.0,3823,2539,66.94,68.3,6362,4293296.0,96,11,63,836637.0,1680909.0,1247,2461,67.09,68.3,3708,2517546.0,74,2023-11-08 13:10:00
558,DSKY,29,92,996654.0,4435758.0,1465,6489,68.03,68.36,7954,5432413.0,121,24,90,917213.0,4161001.0,1352,6090,67.84,68.33,7442,5078215.0,114,2023-11-08 13:15:00
559,DSKY,86,439,9285606.0,29105314.0,13820,42509,67.19,68.47,56329,38390920.0,525,76,437,10697382.0,29522390.0,16026,43112,66.75,68.48,59138,40219772.0,513,2023-11-08 13:20:00
560,DSKY,171,577,11796465.0,28376340.0,17620,41403,66.95,68.54,59023,40172805.0,748,151,555,10145470.0,27935924.0,15083,40767,67.26,68.53,55850,38081394.0,706,2023-11-08 13:25:00
561,DSKY,62,159,7864502.0,4287570.0,11716,6276,67.13,68.32,17992,12152072.0,221,55,155,7792892.0,4154833.0,11624,6081,67.04,68.32,17705,11947725.0,210,2023-11-08 13:30:00
562,DSKY,5,8,139352.0,114370.0,200,167,69.68,68.49,367,253722.0,13,3,7,106667.0,147776.0,157,216,67.94,68.42,373,254444.0,10,2023-11-08 13:35:00
563,DSKY,13,10,283523.0,116772.0,401,172,70.7,67.89,573,400296.0,23,7,4,251539.0,29398.0,370,43,67.98,68.37,413,280937.0,11,2023-11-08 13:40:00
564,DSKY,31,11,875369.0,123287.0,1283,192,68.23,64.21,1475,998656.0,42,29,3,837196.0,82024.0,1236,120,67.73,68.35,1356,919220.0,32,2023-11-08 13:45:00
565,DSKY,40,29,1532569.0,1263772.0,2254,1843,67.99,68.57,4097,2796342.0,69,39,24,1582334.0,946221.0,2328,1384,67.97,68.37,3712,2528555.0,63,2023-11-08 13:50:00
566,DSKY,50,50,1688802.0,2124109.0,2490,3103,67.82,68.45,5593,3812911.0,100,47,48,3308058.0,2083624.0,4960,3044,66.69,68.45,8004,5391682.0,95,2023-11-08 13:55:00
567,DSKY,35,23,704242.0,373176.0,1027,548,68.57,68.1,1575,1077418.0,58,28,20,661394.0,162105.0,972,237,68.04,68.4,1209,823499.0,48,2023-11-08 14:00:00
568,DSKY,19,11,1876535.0,272396.0,2815,399,66.66,68.27,3214,2148932.0,30,9,5,1830631.0,40989.0,2739,60,66.84,68.32,2799,1871621.0,14,2023-11-08 14:05:00
569,DSKY,35,11,6397986.0,267588.0,9578,395,66.8,67.74,9973,6665574.0,46,20,3,4564463.0,161979.0,6868,237,66.46,68.35,7105,4726443.0,23,2023-11-08 14:10:00
570,DSKY,12,20,137087.0,544403.0,202,793,67.87,68.65,995,681491.0,32,6,9,136464.0,684232.0,201,997,67.89,68.63,1198,820696.0,15,2023-11-08 14:15:00
571,DSKY,8,7,87849.0,83495.0,128,136,68.63,61.39,264,171345.0,15,2,2,13602.0,3410.0,20,5,68.01,68.2,25,17012.0,4,2023-11-08 14:20:00
572,DSKY,19,16,113988.0,153734.0,163,229,69.93,67.13,392,267723.0,35,8,10,95880.0,168161.0,141,246,68.0,68.36,387,264041.0,18,2023-11-08 14:25:00
573,DSKY,16,9,1921692.0,179884.0,2863,262,67.12,68.66,3125,2101577.0,25,7,6,1422058.0,153986.0,2139,225,66.48,68.44,2364,1576044.0,13,2023-11-08 14:30:00
574,DSKY,23,18,3525169.0,343660.0,5342,504,65.99,68.19,5846,3868830.0,41,15,15,3450872.0,386246.0,5173,563,66.71,68.61,5736,3837118.0,30,2023-11-08 14:35:00
575,DSKY,29,28,4467336.0,669003.0,6708,982,66.6,68.13,7690,5136339.0,57,24,23,4424920.0,551479.0,6651,809,66.53,68.17,7460,4976400.0,47,2023-11-08 14:40:00
576,DSKY,20,9,3351629.0,80684.0,5027,121,66.67,66.68,5148,3432313.0,29,15,3,3334580.0,28613.0,5010,42,66.56,68.13,5052,3363193.0,18,2023-11-08 14:45:00
577,DSKY,8,15,10885.0,136006.0,16,214,68.03,63.55,230,146892.0,23,2,7,37412.0,90644.0,55,133,68.02,68.15,188,128056.0,9,2023-11-08 14:50:00
578,DSKY,5,16,4775.0,1688327.0,6,2384,79.59,70.82,2390,1693103.0,21,0,10,0.0,980615.0,0,1390,,70.55,1390,980615.0,10,2023-11-08 14:55:00
579,DSKY,6,22,9887.0,868775.0,13,1244,76.06,69.84,1257,878662.0,28,1,15,3400.0,795178.0,5,1165,68.0,68.26,1170,798578.0,16,2023-11-08 15:00:00
580,DSKY,15,16,3115123.0,236927.0,4667,352,66.75,67.31,5019,3352051.0,31,10,11,3104797.0,209936.0,4657,308,66.67,68.16,4965,3314733.0,21,2023-11-08 15:05:00
581,DSKY,27,12,3403699.0,155424.0,5120,228,66.48,68.17,5348,3559123.0,39,24,9,3369360.0,299479.0,5083,439,66.29,68.22,5522,3668840.0,33,2023-11-08 15:10:00
582,DSKY,9,23,18713.0,429787.0,26,635,71.97,67.68,661,448500.0,32,2,15,9505.0,315677.0,14,463,67.89,68.18,477,325182.0,17,2023-11-08 15:15:00
583,DSKY,19,27,457050.0,355613.0,642,531,71.19,66.97,1173,812663.0,46,3,12,35283.0,286973.0,52,421,67.85,68.16,473,322256.0,15,2023-11-08 15:20:00
584,DSKY,10,5,1738194.0,80185.0,2603,119,66.78,67.38,2722,1818380.0,15,7,2,1697225.0,36872.0,2544,54,66.71,68.28,2598,1734097.0,9,2023-11-08 15:25:00
585,DSKY,8,5,198946.0,95151.0,301,147,66.1,64.73,448,294098.0,13,10,6,1864359.0,94454.0,2801,138,66.56,68.45,2939,1958814.0,16,2023-11-08 15:30:00
586,DSKY,8,11,31657.0,122524.0,45,183,70.35,66.95,228,154181.0,19,0,2,0.0,98409.0,0,144,,68.34,144,98409.0,2,2023-11-08 15:35:00
587,DSKY,10,24,323625.0,668583.0,483,981,67.0,68.15,1464,992209.0,34,5,20,330594.0,636550.0,496,934,66.65,68.15,1430,967144.0,25,2023-11-08 15:40:00
588,DSKY,20,24,3419727.0,550941.0,5140,856,66.53,64.36,5996,3970669.0,44,11,12,3384950.0,352398.0,5089,517,66.52,68.16,5606,3737348.0,23,2023-11-08 15:45:00
589,DSKY,8,15,64624.0,146622.0,94,217,68.75,67.57,311,211246.0,23,1,5,6794.0,75624.0,10,111,67.94,68.13,121,82418.0,6,2023-11-08 15:50:00
590,DSKY,8,6,1360977.0,40678.0,2055,77,66.23,52.83,2132,1401655.0,14,2,2,365313.0,28018.0,552,41,66.18,68.34,593,393332.0,4,2023-11-08 15:55:00
591,DSKY,8,21,905841.0,568494.0,1365,883,66.36,64.38,2248,1474336.0,29,1,27,182877.0,593211.0,276,869,66.26,68.26,1145,776089.0,28,2023-11-08 16:00:00
592,DSKY,4,20,66104.0,570679.0,98,837,67.45,68.18,935,636784.0,24,3,14,11488.0,875753.0,17,1273,67.58,68.79,1290,887241.0,17,2023-11-08 16:05:00
593,DSKY,5,17,134152.0,1308009.0,198,1914,67.75,68.34,2112,1442162.0,22,5,18,239535.0,1342106.0,354,1964,67.67,68.34,2318,1581641.0,23,2023-11-08 16:10:00
594,DSKY,3,24,23502.0,776096.0,35,1140,67.15,68.08,1175,799598.0,27,0,17,0.0,971545.0,0,1422,,68.32,1422,971545.0,17,2023-11-08 16:15:00
595,DSKY,4,13,9863.0,836614.0,14,1224,70.45,68.35,1238,846477.0,17,2,12,7470.0,802427.0,11,1174,67.91,68.35,1185,809897.0,14,2023-11-08 16:20:00
596,DSKY,4,13,80658.0,205618.0,108,307,74.68,66.98,415,286277.0,17,0,8,0.0,192381.0,0,282,,68.22,282,192381.0,8,2023-11-08 16:25:00
597,DSKY,6,14,30502.0,265517.0,45,390,67.78,68.08,435,296020.0,20,2,13,24991.0,240295.0,37,353,67.54,68.07,390,265287.0,15,2023-11-08 16:30:00
598,DSKY,8,25,91761.0,867380.0,135,1270,67.97,68.3,1405,959142.0,33,2,23,6081.0,912206.0,9,1335,67.58,68.33,1344,918288.0,25,2023-11-08 16:35:00
599,DSKY,12,38,258000.0,1372776.0,379,2017,68.07,68.06,2396,1630776.0,50,7,28,242397.0,1241800.0,358,1822,67.71,68.16,2180,1484198.0,35,2023-11-08 16:40:00
600,DSKY,5,27,10202.0,1864730.0,15,2746,68.02,67.91,2761,1874933.0,32,1,24,4080.0,1923684.0,6,2817,68.0,68.29,2823,1927764.0,25,2023-11-08 16:45:00
601,DSKY,10,13,114750.0,783839.0,168,1147,68.3,68.34,1315,898589.0,23,7,8,56871.0,551465.0,84,807,67.7,68.34,891,608337.0,15,2023-11-08 16:50:00
602,DSKY,6,9,108770.0,823206.0,160,1180,67.98,69.76,1340,931976.0,15,5,4,52981.0,428433.0,78,627,67.92,68.33,705,481414.0,9,2023-11-08 16:55:00
603,DSKY,5,13,264082.0,253004.0,389,374,67.89,67.65,763,517087.0,18,3,7,143667.0,212187.0,212,311,67.77,68.23,523,355854.0,10,2023-11-08 17:00:00
604,DSKY,5,9,14699.0,149499.0,17,221,86.47,67.65,238,164199.0,14,0,4,0.0,132557.0,0,194,,68.33,194,132557.0,4,2023-11-08 17:05:00
605,DSKY,10,13,241448.0,1179699.0,356,1727,67.82,68.31,2083,1421148.0,23,8,12,188883.0,1023066.0,278,1498,67.94,68.3,1776,1211949.0,20,2023-11-08 17:10:00
606,DSKY,30,12,2414817.0,146434.0,3553,219,67.97,66.87,3772,2561252.0,42,30,9,3944617.0,142618.0,5923,209,66.6,68.24,6132,4087236.0,39,2023-11-08 17:15:00
607,DSKY,13,12,369126.0,224253.0,543,337,67.98,66.54,880,593379.0,25,12,5,368393.0,155918.0,542,228,67.97,68.39,770,524311.0,17,2023-11-08 17:20:00
608,DSKY,9,3,222399.0,60418.0,327,84,68.01,71.93,411,282818.0,12,9,1,211376.0,16401.0,311,24,67.97,68.34,335,227778.0,10,2023-11-08 17:25:00
609,DSKY,25,10,4929175.0,22557.0,7385,35,66.75,64.45,7420,4951733.0,35,17,2,4948839.0,2045.0,7425,3,66.65,68.17,7428,4950884.0,19,2023-11-08 17:30:00
610,DSKY,11,55,94350.0,1378553.0,109,2016,86.56,68.38,2125,1472904.0,66,0,29,0.0,1297664.0,0,1896,,68.44,1896,1297664.0,29,2023-11-08 17:35:00
611,DSKY,4,12,3402.0,245695.0,5,358,68.04,68.63,363,249098.0,16,1,3,680.0,60086.0,1,88,68.0,68.28,89,60766.0,4,2023-11-08 17:40:00
612,DSKY,20,6,1909367.0,88552.0,2830,130,67.47,68.12,2960,1997919.0,26,20,4,1929675.0,195370.0,2867,287,67.31,68.07,3154,2125045.0,24,2023-11-08 17:45:00
613,DSKY,19,40,602211.0,2527764.0,898,3804,67.06,66.45,4702,3129975.0,59,15,33,687712.0,2386050.0,1027,3485,66.96,68.47,4512,3073763.0,48,2023-11-08 17:50:00
614,DSKY,18,30,145071.0,444459.0,213,652,68.11,68.17,865,589530.0,48,9,22,131222.0,433911.0,193,636,67.99,68.23,829,565133.0,31,2023-11-08 17:55:00
615,DSKY,53,232,1548106.0,13589969.0,2289,19863,67.63,68.42,22152,15138075.0,285,49,229,2753566.0,13752103.0,4085,20092,67.41,68.45,24177,16505669.0,278,2023-11-08 18:00:00
616,DSKY,21,114,627835.0,4808778.0,924,7041,67.95,68.3,7965,5436614.0,135,20,110,574197.0,4799984.0,845,7028,67.95,68.3,7873,5374181.0,130,2023-11-08 18:05:00
617,DSKY,14,112,90504.0,4804796.0,132,7039,68.56,68.26,7171,4895300.0,126,9,106,107734.0,4792763.0,159,7018,67.76,68.29,7177,4900497.0,115,2023-11-08 18:10:00
618,DSKY,3,31,28580.0,1249309.0,42,1829,68.05,68.31,1871,1277889.0,34,3,28,13608.0,1292278.0,20,1892,68.04,68.3,1912,1305887.0,31,2023-11-08 18:15:00
619,DSKY,8,58,365016.0,2443059.0,536,3578,68.1,68.28,4114,2808076.0,66,6,55,362647.0,2452945.0,534,3591,67.91,68.31,4125,2815593.0,61,2023-11-08 18:20:00
620,DSKY,27,109,358013.0,4975492.0,523,7284,68.45,68.31,7807,5333505.0,136,23,106,298540.0,4801173.0,439,7029,68.0,68.31,7468,5099714.0,129,2023-11-08 18:25:00
621,DSKY,31,94,1063602.0,4516908.0,1562,6611,68.09,68.32,8173,5580511.0,125,29,92,1054218.0,4641317.0,1551,6793,67.97,68.33,8344,5695535.0,121,2023-11-08 18:30:00
622,DSKY,27,91,1132874.0,4032717.0,1666,5911,68.0,68.22,7577,5165591.0,118,24,85,1149301.0,4035845.0,1691,5907,67.97,68.32,7598,5185147.0,109,2023-11-08 18:35:00
623,DSKY,143,159,3915637.0,6419729.0,5757,9446,68.02,67.96,15203,10335367.0,302,138,148,4131145.0,6726549.0,6087,9836,67.87,68.39,15923,10857694.0,286,2023-11-08 18:40:00
624,DSKY,509,1089,71095759.0,81262851.0,106997,115025,66.45,70.65,222022,152358611.0,1598,427,847,67523961.0,74225268.0,100925,108093,66.91,68.67,209018,141749229.0,1274,2023-11-09 10:05:00
625,DSKY,54,323,4172539.0,28652620.0,6253,41673,66.73,68.76,47926,32825159.0,377,42,309,3953008.0,28321505.0,5916,41198,66.82,68.74,47114,32274513.0,351,2023-11-09 10:10:00
626,DSKY,102,520,3977562.0,48879244.0,6059,66442,65.65,73.57,72501,52856807.0,622,56,497,3418998.0,38656758.0,5135,56356,66.58,68.59,61491,42075757.0,553,2023-11-09 10:15:00
627,DSKY,71,243,3420107.0,12386143.0,5120,18130,66.8,68.32,23250,15806251.0,314,50,234,3403788.0,12275207.0,5103,17975,66.7,68.29,23078,15678996.0,284,2023-11-09 10:20:00
628,DSKY,72,282,3867440.0,12630047.0,5793,18430,66.76,68.53,24223,16497487.0,354,54,271,3653782.0,12284331.0,5486,17995,66.6,68.27,23481,15938113.0,325,2023-11-09 10:25:00
629,DSKY,51,94,3597811.0,2647359.0,5397,3881,66.66,68.21,9278,6245170.0,145,39,84,3557524.0,2743194.0,5335,4018,66.68,68.27,9353,6300718.0,123,2023-11-09 10:30:00
630,DSKY,54,110,5543982.0,5009600.0,8297,7364,66.82,68.03,15661,10553582.0,164,39,102,5379047.0,4363727.0,8066,6391,66.69,68.28,14457,9742774.0,141,2023-11-09 10:35:00
631,DSKY,94,243,4003166.0,10108936.0,5937,14818,67.43,68.22,20755,14112103.0,337,76,232,3838161.0,10016246.0,5743,14658,66.83,68.33,20401,13854407.0,308,2023-11-09 10:40:00
632,DSKY,89,204,463934.0,8440149.0,679,12340,68.33,68.4,13019,8904084.0,293,69,188,433578.0,8382017.0,637,12271,68.07,68.31,12908,8815595.0,257,2023-11-09 10:45:00
633,DSKY,71,128,4277720.0,4801350.0,6387,6972,66.98,68.87,13359,9079070.0,199,46,106,3953665.0,4592806.0,5917,6725,66.82,68.29,12642,8546471.0,152,2023-11-09 10:50:00
634,DSKY,28,74,328495.0,2031120.0,534,2972,61.52,68.34,3506,2359616.0,102,20,65,283973.0,1872719.0,417,2741,68.1,68.32,3158,2156693.0,85,2023-11-09 10:55:00
635,DSKY,22,56,1988880.0,1653767.0,2975,2423,66.85,68.25,5398,3642647.0,78,14,49,1896565.0,1621720.0,2838,2373,66.83,68.34,5211,3518286.0,63,2023-11-09 11:00:00
636,DSKY,98,227,3440114.0,6370178.0,5077,9316,67.76,68.38,14393,9810293.0,325,90,197,3535461.0,6308721.0,5249,9232,67.35,68.34,14481,9844182.0,287,2023-11-09 11:05:00
637,DSKY,32,117,889869.0,2873202.0,1315,4166,67.67,68.97,5481,3763072.0,149,23,93,526459.0,2598855.0,778,3806,67.67,68.28,4584,3125314.0,116,2023-11-09 11:10:00
638,DSKY,32,38,1180094.0,5840392.0,1933,7294,61.05,80.07,9227,7020486.0,70,27,11,1150862.0,1042822.0,1889,1514,60.92,68.88,3403,2193685.0,38,2023-11-09 11:15:00
639,DSKY,25,14,570704.0,504820.0,833,741,68.51,68.13,1574,1075525.0,39,18,8,528224.0,484321.0,776,706,68.07,68.6,1482,1012545.0,26,2023-11-09 11:20:00
640,DSKY,16,26,1820303.0,715077.0,2722,1047,66.87,68.3,3769,2535380.0,42,13,21,1811293.0,673500.0,2710,985,66.84,68.38,3695,2484793.0,34,2023-11-09 11:25:00
641,DSKY,41,45,923372.0,1633245.0,1853,2389,49.83,68.37,4242,2556618.0,86,27,46,575250.0,1652243.0,847,2416,67.92,68.39,3263,2227494.0,73,2023-11-09 11:30:00
642,DSKY,11,61,98159.0,2114999.0,144,3097,68.17,68.29,3241,2213158.0,72,10,56,47569.0,2041420.0,70,2989,67.96,68.3,3059,2088989.0,66,2023-11-09 11:35:00
643,DSKY,8,76,46632.0,2507406.0,68,3684,68.58,68.06,3752,2554039.0,84,7,68,84266.0,2492606.0,124,3648,67.96,68.33,3772,2576872.0,75,2023-11-09 11:40:00
644,DSKY,7,52,27924.0,1227260.0,35,1799,79.78,68.22,1834,1255184.0,59,2,50,22001.0,1247895.0,33,1827,66.67,68.3,1860,1269896.0,52,2023-11-09 11:45:00
645,DSKY,5,26,76072.0,596407.0,111,873,68.53,68.32,984,672480.0,31,4,23,34820.0,555881.0,52,814,66.96,68.29,866,590701.0,27,2023-11-09 11:50:00
646,DSKY,2,51,10198.0,1612531.0,15,2360,67.99,68.33,2375,1622729.0,53,1,49,3362.0,1596730.0,5,2337,67.24,68.32,2342,1600092.0,50,2023-11-09 11:55:00
647,DSKY,9,39,160721.0,1323889.0,229,1934,70.18,68.45,2163,1484611.0,48,5,38,143338.0,1271168.0,211,1856,67.93,68.49,2067,1414506.0,43,2023-11-09 12:00:00
648,DSKY,11,21,32326.0,2409582.0,50,3502,64.65,68.81,3552,2441908.0,32,1,13,5396.0,2023774.0,8,2942,67.46,68.79,2950,2029171.0,14,2023-11-09 12:05:00
649,DSKY,14,38,2062256.0,1820406.0,3084,2655,66.87,68.57,5739,3882662.0,52,6,33,1927052.0,2032779.0,2888,2965,66.73,68.56,5853,3959831.0,39,2023-11-09 12:10:00
650,DSKY,9,19,54107.0,475433.0,79,697,68.49,68.21,776,529541.0,28,2,12,133184.0,457117.0,196,668,67.95,68.43,864,590301.0,14,2023-11-09 12:15:00
651,DSKY,15,33,117516.0,375500.0,172,563,68.32,66.7,735,493016.0,48,10,26,95765.0,406959.0,141,596,67.92,68.28,737,502724.0,36,2023-11-09 12:20:00
652,DSKY,9,45,95218.0,1273658.0,140,1856,68.01,68.62,1996,1368877.0,54,5,38,57114.0,1185728.0,84,1736,67.99,68.3,1820,1242843.0,43,2023-11-09 12:25:00
653,DSKY,6,24,160354.0,375320.0,236,550,67.95,68.24,786,535674.0,30,4,21,163077.0,359737.0,240,527,67.95,68.26,767,522815.0,25,2023-11-09 12:30:00
654,DSKY,23,27,460555.0,387877.0,702,563,65.61,68.89,1265,848432.0,50,16,23,317042.0,372852.0,466,546,68.03,68.29,1012,689894.0,39,2023-11-09 12:35:00
655,DSKY,5,13,16715.0,528373.0,39,774,42.86,68.27,813,545088.0,18,0,4,0.0,518860.0,0,755,,68.72,755,518860.0,4,2023-11-09 12:40:00
656,DSKY,9,20,291642.0,583807.0,428,855,68.14,68.28,1283,875449.0,29,6,18,144002.0,581228.0,212,851,67.93,68.3,1063,725230.0,24,2023-11-09 12:45:00
657,DSKY,2,26,137598.0,531661.0,202,766,68.12,69.41,968,669259.0,28,2,20,2024.0,518095.0,3,744,67.47,69.64,747,520119.0,22,2023-11-09 12:50:00
658,DSKY,5,50,15668.0,1263337.0,21,1840,74.61,68.66,1861,1279005.0,55,2,45,2721.0,1231657.0,4,1803,68.03,68.31,1807,1234378.0,47,2023-11-09 12:55:00
659,DSKY,39,79,4471607.0,2461626.0,6489,3598,68.91,68.42,10087,6933233.0,118,29,71,3973926.0,2454294.0,5951,3585,66.78,68.46,9536,6428220.0,100,2023-11-09 13:00:00
660,DSKY,230,138,47150433.0,4707015.0,70638,6886,66.75,68.36,77524,51857448.0,368,223,129,47129972.0,4496092.0,70616,6577,66.74,68.36,77193,51626064.0,352,2023-11-09 13:05:00
661,DSKY,192,313,25474675.0,19232892.0,38154,28017,66.77,68.65,66171,44707568.0,505,185,309,25440223.0,19346266.0,38105,28181,66.76,68.65,66286,44786489.0,494,2023-11-09 13:10:00
662,DSKY,254,364,9574467.0,27645972.0,14184,40240,67.5,68.7,54424,37220440.0,618,248,360,9636009.0,27662368.0,14274,40260,67.51,68.71,54534,37298378.0,608,2023-11-09 13:15:00
663,DSKY,61,98,1832381.0,2106730.0,2704,3086,67.77,68.27,5790,3939111.0,159,54,90,1790073.0,2274839.0,2644,3313,67.7,68.66,5957,4064912.0,144,2023-11-09 13:20:00
664,DSKY,13,24,93501.0,714358.0,138,1040,67.75,68.69,1178,807860.0,37,7,21,70161.0,517432.0,103,756,68.12,68.44,859,587593.0,28,2023-11-09 13:25:00
665,DSKY,35,38,4064171.0,501291.0,6051,767,67.17,65.36,6818,4565463.0,73,35,29,4076488.0,438809.0,6080,642,67.05,68.35,6722,4515298.0,64,2023-11-09 13:30:00
666,DSKY,30,78,2693630.0,1282670.0,4013,1928,67.12,66.53,5941,3976301.0,108,21,68,2623150.0,1226144.0,3896,1796,67.33,68.27,5692,3849294.0,89,2023-11-09 13:35:00
667,DSKY,11,73,1806417.0,2516919.0,2712,3878,66.61,64.9,6590,4323336.0,84,8,63,1738234.0,2325553.0,2612,3399,66.55,68.42,6011,4063787.0,71,2023-11-09 13:40:00
668,DSKY,31,294,274142.0,18353238.0,403,26811,68.03,68.45,27214,18627380.0,325,26,285,321787.0,18353122.0,473,26804,68.03,68.47,27277,18674909.0,311,2023-11-09 13:45:00
669,DSKY,25,920,1476169.0,71229891.0,2189,104025,67.44,68.47,106214,72706060.0,945,15,902,1468793.0,71136860.0,2178,103872,67.44,68.49,106050,72605653.0,917,2023-11-09 13:50:00
670,DSKY,9,380,51058.0,26116416.0,72,38127,70.91,68.5,38199,26167475.0,389,3,373,17686.0,26100534.0,26,38119,68.02,68.47,38145,26118221.0,376,2023-11-09 13:55:00
671,DSKY,21,97,896068.0,2206709.0,1252,3243,71.57,68.05,4495,3102777.0,118,9,89,436388.0,2171999.0,650,3183,67.14,68.24,3833,2608387.0,98,2023-11-09 14:00:00
672,DSKY,102,132,2824845.0,2470229.0,4203,3641,67.21,67.84,7844,5295075.0,234,91,120,2812653.0,2247485.0,4189,3293,67.14,68.25,7482,5060138.0,211,2023-11-09 14:05:00
673,DSKY,32,103,1308187.0,2602666.0,1922,3776,68.06,68.93,5698,3910854.0,135,36,98,1529525.0,2550792.0,2253,3737,67.89,68.26,5990,4080318.0,134,2023-11-09 14:10:00
674,DSKY,38,399,1731037.0,28178706.0,2585,40879,66.96,68.93,43464,29909743.0,437,33,389,1519543.0,27881950.0,2274,40441,66.82,68.94,42715,29401493.0,422,2023-11-09 14:15:00
675,DSKY,63,233,982118.0,12142781.0,1443,17736,68.06,68.46,19179,13124899.0,296,59,224,964045.0,12255472.0,1417,17907,68.03,68.44,19324,13219518.0,283,2023-11-09 14:20:00
676,DSKY,86,193,2521845.0,8700578.0,3704,12714,68.08,68.43,16418,11222423.0,279,77,180,2451009.0,8710124.0,3600,12703,68.08,68.57,16303,11161134.0,257,2023-11-09 14:25:00
677,DSKY,24,95,758419.0,2518501.0,1115,3682,68.02,68.4,4797,3276920.0,119,19,79,695487.0,2459393.0,1022,3592,68.05,68.47,4614,3154880.0,98,2023-11-09 14:30:00
678,DSKY,36,222,2611309.0,6284775.0,3912,9215,66.75,68.2,13127,8896084.0,258,29,219,2554430.0,6479743.0,3828,9462,66.73,68.48,13290,9034173.0,248,2023-11-09 14:35:00
679,DSKY,29,86,1984879.0,1482596.0,2987,2152,66.45,68.89,5139,3467476.0,115,22,77,2013711.0,1145081.0,3015,1679,66.79,68.2,4694,3158792.0,99,2023-11-09 14:40:00
680,DSKY,15,47,221597.0,713390.0,311,1073,71.25,66.49,1384,934987.0,62,8,40,171500.0,673268.0,252,978,68.06,68.84,1230,844769.0,48,2023-11-09 14:45:00
681,DSKY,5,46,9493.0,451262.0,14,661,67.81,68.27,675,460755.0,51,0,44,0.0,454701.0,0,666,,68.27,666,454701.0,44,2023-11-09 14:50:00
682,DSKY,3,12,10569.0,73727.0,11,108,96.09,68.27,119,84296.0,15,0,9,0.0,53290.0,0,78,,68.32,78,53290.0,9,2023-11-09 14:55:00
683,DSKY,10,19,15678.0,248546.0,20,369,78.39,67.36,389,264224.0,29,0,22,0.0,454419.0,0,665,,68.33,665,454419.0,22,2023-11-09 15:00:00
684,DSKY,5,10,348049.0,200640.0,512,293,67.98,68.48,805,548689.0,15,4,10,211200.0,250685.0,312,366,67.69,68.49,678,461885.0,14,2023-11-09 15:05:00
685,DSKY,3,4,38714.0,127294.0,57,187,67.92,68.07,244,166008.0,7,3,0,38765.0,0.0,57,0,68.01,,57,38765.0,3,2023-11-09 15:10:00
686,DSKY,6,16,28568.0,276378.0,42,404,68.02,68.41,446,304947.0,22,4,12,21732.0,281841.0,32,412,67.91,68.41,444,303573.0,16,2023-11-09 15:15:00
687,DSKY,10,42,35407.0,881982.0,46,1345,76.97,65.57,1391,917389.0,52,13,31,353910.0,723475.0,520,1060,68.06,68.25,1580,1077386.0,44,2023-11-09 15:20:00
688,DSKY,12,7,39463.0,223143.0,58,321,68.04,69.51,379,262606.0,19,7,1,27220.0,32822.0,40,48,68.05,68.38,88,60043.0,8,2023-11-09 15:25:00
689,DSKY,6,12,8504.0,304775.0,12,445,70.87,68.49,457,313280.0,18,4,10,8160.0,232647.0,12,341,68.0,68.23,353,240807.0,14,2023-11-09 15:30:00
690,DSKY,18,11,564774.0,162638.0,797,239,70.86,68.05,1036,727412.0,29,11,6,414942.0,147938.0,618,216,67.14,68.49,834,562881.0,17,2023-11-09 15:35:00
691,DSKY,24,25,1882194.0,382150.0,2813,635,66.91,60.18,3448,2264344.0,49,22,15,1891823.0,253419.0,2827,371,66.92,68.31,3198,2145242.0,37,2023-11-09 15:40:00
692,DSKY,18,4,295684.0,22389.0,434,33,68.13,67.85,467,318073.0,22,15,1,302478.0,1361.0,445,2,67.97,68.06,447,303839.0,16,2023-11-09 15:45:00
693,DSKY,5,3,48243.0,2729.0,71,4,67.95,68.23,75,50972.0,8,3,0,46869.0,0.0,69,0,67.93,,69,46869.0,3,2023-11-09 15:50:00
694,DSKY,37,17,255070.0,132184.0,372,195,68.57,67.79,567,387255.0,54,25,8,190417.0,67447.0,280,97,68.01,69.53,377,257864.0,33,2023-11-09 15:55:00
695,DSKY,22,21,499958.0,268438.0,739,406,67.65,66.12,1145,768397.0,43,15,15,404261.0,241169.0,599,354,67.49,68.13,953,645430.0,30,2023-11-09 16:00:00
696,DSKY,11,5,116632.0,134865.0,168,198,69.42,68.11,366,251497.0,16,5,3,38077.0,90634.0,56,132,67.99,68.66,188,128711.0,8,2023-11-09 16:05:00
697,DSKY,4,3,126253.0,46398.0,186,68,67.88,68.23,254,172651.0,7,0,3,0.0,71025.0,0,104,,68.29,104,71025.0,3,2023-11-09 16:10:00
698,DSKY,5,3,24969.0,28671.0,37,42,67.49,68.26,79,53640.0,8,2,1,7440.0,35401.0,11,52,67.64,68.08,63,42842.0,3,2023-11-09 16:15:00
699,DSKY,4,7,21459.0,58646.0,28,87,76.64,67.41,115,80106.0,11,1,4,12863.0,81175.0,19,119,67.7,68.21,138,94038.0,5,2023-11-09 16:20:00
700,DSKY,7,10,28618.0,308915.0,41,453,69.8,68.19,494,337533.0,17,3,8,35315.0,288293.0,52,422,67.91,68.32,474,323608.0,11,2023-11-09 16:25:00
701,DSKY,21,11,2239516.0,381160.0,3340,563,67.05,67.7,3903,2620677.0,32,20,11,2237352.0,315231.0,3340,462,66.99,68.23,3802,2552584.0,31,2023-11-09 16:30:00
702,DSKY,14,8,81907.0,247707.0,120,362,68.26,68.43,482,329614.0,22,11,8,63881.0,247682.0,94,362,67.96,68.42,456,311564.0,19,2023-11-09 16:35:00
703,DSKY,15,25,70020.0,616053.0,99,893,70.73,68.99,992,686073.0,40,10,20,161206.0,463395.0,240,679,67.17,68.25,919,624601.0,30,2023-11-09 16:40:00
704,DSKY,13,28,725552.0,615160.0,1087,902,66.75,68.2,1989,1340712.0,41,10,27,2113520.0,684799.0,3160,1004,66.88,68.21,4164,2798320.0,37,2023-11-09 16:45:00
705,DSKY,4,14,36076.0,270446.0,51,397,70.74,68.12,448,306522.0,18,0,13,0.0,270145.0,0,396,,68.22,396,270145.0,13,2023-11-09 16:50:00
706,DSKY,1,7,683.0,122074.0,1,179,68.3,68.2,180,122757.0,8,0,6,0.0,121393.0,0,178,,68.2,178,121393.0,6,2023-11-09 16:55:00
707,DSKY,12,23,1632689.0,406751.0,2432,597,67.13,68.13,3029,2039441.0,35,3,20,196810.0,403782.0,298,592,66.04,68.21,890,600592.0,23,2023-11-09 17:00:00
708,DSKY,273,121,49044079.0,13100055.0,72828,19081,67.34,68.65,91909,62144134.0,394,263,113,48334944.0,12910055.0,72091,18800,67.05,68.67,90891,61245000.0,376,2023-11-09 17:05:00
709,DSKY,115,71,20272886.0,5128848.0,30278,7466,66.96,68.7,37744,25401734.0,186,118,67,21683441.0,5042417.0,32379,7345,66.97,68.65,39724,26725859.0,185,2023-11-09 17:10:00
710,DSKY,216,406,7343212.0,41212160.0,10831,60071,67.8,68.61,70902,48555372.0,622,213,402,5946717.0,41327129.0,8750,60238,67.96,68.61,68988,47273846.0,615,2023-11-09 17:15:00
711,DSKY,223,472,4148018.0,51092676.0,6093,74449,68.08,68.63,80542,55240694.0,695,213,468,4133684.0,50924506.0,6072,74204,68.08,68.63,80276,55058190.0,681,2023-11-09 17:20:00
712,DSKY,32,58,506281.0,6102163.0,741,8895,68.32,68.6,9636,6608444.0,90,31,57,504573.0,6210913.0,741,9051,68.09,68.62,9792,6715486.0,88,2023-11-09 17:25:00
713,DSKY,108,194,5681613.0,16195481.0,8485,23636,66.96,68.52,32121,21877095.0,302,101,190,5661623.0,16121123.0,8432,23503,67.14,68.59,31935,21782747.0,291,2023-11-09 17:30:00
714,DSKY,79,64,2155618.0,3932395.0,3169,5719,68.02,68.76,8888,6088013.0,143,76,47,2104260.0,3917976.0,3106,5705,67.75,68.68,8811,6022236.0,123,2023-11-09 17:35:00
715,DSKY,34,70,904898.0,3695524.0,1330,5387,68.04,68.6,6717,4600423.0,104,28,65,905061.0,3522211.0,1330,5134,68.05,68.61,6464,4427273.0,93,2023-11-09 17:40:00
716,DSKY,24,35,382346.0,1354145.0,562,1996,68.03,67.84,2558,1736492.0,59,27,30,384400.0,1363427.0,565,1995,68.04,68.34,2560,1747828.0,57,2023-11-09 17:45:00
717,DSKY,32,9,2041967.0,434217.0,3066,639,66.6,67.95,3705,2476185.0,41,33,5,3431601.0,202220.0,5167,297,66.41,68.09,5464,3633822.0,38,2023-11-09 17:50:00
718,DSKY,46,13,1087626.0,193241.0,1618,315,67.22,61.35,1933,1280867.0,59,43,9,1076543.0,342200.0,1602,502,67.2,68.17,2104,1418743.0,52,2023-11-09 17:55:00
719,DSKY,40,12,2417392.0,606504.0,3599,888,67.17,68.3,4487,3023897.0,52,25,8,823353.0,545956.0,1228,795,67.05,68.67,2023,1369309.0,33,2023-11-09 18:00:00
720,DSKY,136,336,8020522.0,62553561.0,11827,91335,67.82,68.49,103162,70574083.0,472,135,334,9429739.0,62515918.0,13929,91280,67.7,68.49,105209,71945657.0,469,2023-11-09 18:05:00
721,DSKY,41,8,1135107.0,144209.0,1662,196,68.3,73.58,1858,1279317.0,49,34,2,1118440.0,83099.0,1644,114,68.03,72.89,1758,1201540.0,36,2023-11-09 18:10:00
722,DSKY,21,7,313191.0,38195.0,424,61,73.87,62.62,485,351387.0,28,17,5,172158.0,25245.0,253,37,68.05,68.23,290,197403.0,22,2023-11-09 18:15:00
723,DSKY,17,13,178687.0,183765.0,262,269,68.2,68.31,531,362453.0,30,17,8,179580.0,152462.0,264,223,68.02,68.37,487,332043.0,25,2023-11-09 18:20:00
724,DSKY,7,5,373700.0,22485.0,549,48,68.07,46.84,597,396185.0,12,7,1,45582.0,682.0,67,1,68.03,68.28,68,46265.0,8,2023-11-09 18:25:00
725,DSKY,6,8,96618.0,575616.0,142,839,68.04,68.61,981,672234.0,14,4,6,85035.0,574519.0,125,835,68.03,68.8,960,659555.0,10,2023-11-09 18:30:00
726,DSKY,7,7,271076.0,118216.0,400,187,67.77,63.22,587,389292.0,14,7,2,266942.0,74492.0,393,109,67.92,68.34,502,341435.0,9,2023-11-09 18:35:00
727,DSKY,50,27,718636.0,941341.0,1056,1379,68.05,68.26,2435,1659977.0,77,51,25,1035694.0,1438961.0,1536,2101,67.43,68.49,3637,2474655.0,76,2023-11-09 18:40:00
728,DSKY,873,1377,32927829.0,176378271.0,49785,254621,66.14,69.27,304406,209306100.0,2250,770,1139,32278283.0,169092879.0,48150,247288,67.04,68.38,295438,201371163.0,1909,2023-11-10 10:05:00
729,DSKY,940,1716,33910587.0,252417415.0,50293,369013,67.43,68.4,419306,286328003.0,2656,919,1696,33658640.0,252309885.0,49922,368874,67.42,68.4,418796,285968525.0,2615,2023-11-10 10:10:00
730,DSKY,618,1489,15197370.0,171854865.0,22522,250929,67.48,68.49,273451,187052235.0,2107,603,1484,15072006.0,171711954.0,22323,251047,67.52,68.4,273370,186783960.0,2087,2023-11-10 10:15:00
731,DSKY,643,1330,43716242.0,132596788.0,65436,194174,66.81,68.29,259610,176313031.0,1973,621,1312,42096281.0,131826019.0,62912,193064,66.91,68.28,255976,173922300.0,1933,2023-11-10 10:20:00
732,DSKY,295,80,44583685.0,6411833.0,66844,9841,66.7,65.15,76685,50995518.0,375,271,78,44365668.0,5999143.0,66532,8751,66.68,68.55,75283,50364811.0,349,2023-11-10 10:25:00
733,DSKY,261,2348,30845460.0,225843511.0,46402,331572,66.47,68.11,377974,256688971.0,2609,222,2317,30127350.0,225300874.0,45329,330785,66.46,68.11,376114,255428225.0,2539,2023-11-10 10:30:00
734,DSKY,235,1833,21802357.0,190298067.0,32584,279378,66.91,68.11,311962,212100425.0,2068,218,1819,21321493.0,190116360.0,31917,279114,66.8,68.11,311031,211437853.0,2037,2023-11-10 10:35:00
735,DSKY,43,1372,1249436.0,148498047.0,1868,217863,66.89,68.16,219731,149747484.0,1415,26,1363,1111928.0,148322561.0,1658,217576,67.06,68.17,219234,149434489.0,1389,2023-11-10 10:40:00
736,DSKY,23,17,1728886.0,404112.0,2590,593,66.75,68.15,3183,2132999.0,40,16,10,1748081.0,263718.0,2622,388,66.67,67.97,3010,2011799.0,26,2023-11-10 10:45:00
737,DSKY,30,28,221561.0,1023504.0,323,1506,68.59,67.96,1829,1245065.0,58,17,23,108670.0,1073008.0,161,1575,67.5,68.13,1736,1181678.0,40,2023-11-10 10:50:00
738,DSKY,46,33,301551.0,1271525.0,401,1864,75.2,68.21,2265,1573077.0,79,19,21,137569.0,1156777.0,204,1696,67.44,68.21,1900,1294346.0,40,2023-11-10 10:55:00
739,DSKY,44,34,3680672.0,770080.0,5541,1251,66.43,61.56,6792,4450752.0,78,26,19,3605397.0,1134547.0,5425,1660,66.46,68.35,7085,4739945.0,45,2023-11-10 11:00:00
740,DSKY,8,20,75490.0,215849.0,112,319,67.4,67.66,431,291340.0,28,5,14,65471.0,203287.0,97,300,67.5,67.76,397,268759.0,19,2023-11-10 11:05:00
741,DSKY,20,31,271376.0,11441914.0,599,11877,45.3,96.34,12476,11713291.0,51,9,20,223261.0,1195700.0,529,1757,42.2,68.05,2286,1418962.0,29,2023-11-10 11:10:00
742,DSKY,6,186,142851.0,5895626.0,212,8695,67.38,67.8,8907,6038477.0,192,2,175,68175.0,5858489.0,101,8640,67.5,67.81,8741,5926665.0,177,2023-11-10 11:15:00
743,DSKY,302,152,49087473.0,4716023.0,73702,7090,66.6,66.52,80792,53803496.0,454,278,135,48355299.0,4449968.0,72631,6412,66.58,69.4,79043,52805268.0,413,2023-11-10 11:20:00
744,DSKY,253,75,25484499.0,3475855.0,38216,2484,66.69,139.93,40700,28960355.0,328,238,65,25400591.0,2690381.0,38080,3018,66.7,89.14,41098,28090972.0,303,2023-11-10 11:25:00
745,DSKY,53,53,2149470.0,1071458.0,3184,1583,67.51,67.69,4767,3220928.0,106,46,51,2011192.0,1054007.0,2981,1556,67.47,67.74,4537,3065199.0,97,2023-11-10 11:30:00
746,DSKY,51,58,4357297.0,2377684.0,6530,3435,66.73,69.22,9965,6734981.0,109,39,49,4270251.0,1612955.0,6402,2015,66.7,80.05,8417,5883206.0,88,2023-11-10 11:35:00
747,DSKY,12,14,1589292.0,241499.0,2386,360,66.61,67.08,2746,1830791.0,26,7,3,1563778.0,64455.0,2347,95,66.63,67.85,2442,1628233.0,10,2023-11-10 11:40:00
748,DSKY,15,4,1516997.0,47286.0,2276,70,66.65,67.55,2346,1564284.0,19,11,3,1503837.0,33130.0,2260,49,66.54,67.61,2309,1536967.0,14,2023-11-10 11:45:00
749,DSKY,19,5,771683.0,41241.0,1142,61,67.57,67.61,1203,812925.0,24,17,3,768330.0,37861.0,1139,56,67.46,67.61,1195,806192.0,20,2023-11-10 11:50:00
750,DSKY,31,20,3681878.0,330790.0,5512,573,66.8,57.73,6085,4012668.0,51,23,11,3640834.0,245291.0,5457,360,66.72,68.14,5817,3886126.0,34,2023-11-10 11:55:00
751,DSKY,25,11,1533377.0,184785.0,2295,275,66.81,67.19,2570,1718162.0,36,12,8,1473522.0,616272.0,2214,897,66.55,68.7,3111,2089794.0,20,2023-11-10 12:00:00
752,DSKY,27,65,2868480.0,1485161.0,4315,2199,66.48,67.54,6514,4353641.0,92,22,55,2846346.0,1066416.0,4283,1576,66.46,67.67,5859,3912762.0,77,2023-11-10 12:05:00
753,DSKY,31,70,4508946.0,993871.0,6779,1474,66.51,67.43,8253,5502817.0,101,26,65,4390232.0,990802.0,6605,1464,66.47,67.68,8069,5381035.0,91,2023-11-10 12:10:00
754,DSKY,8,25,1415317.0,391930.0,2131,581,66.42,67.46,2712,1807247.0,33,6,21,1420312.0,424910.0,2136,628,66.49,67.66,2764,1845222.0,27,2023-11-10 12:15:00
755,DSKY,19,49,1594229.0,2205093.0,2388,1282,66.76,172.0,3670,3799322.0,68,14,41,1574845.0,1921142.0,2368,1118,66.51,171.84,3486,3495987.0,55,2023-11-10 12:20:00
756,DSKY,38,46,8653644.0,1050773.0,13020,1552,66.46,67.7,14572,9704418.0,84,35,46,8628487.0,1015695.0,12984,1499,66.45,67.76,14483,9644183.0,81,2023-11-10 12:25:00
757,DSKY,6,24,15117.0,395007.0,22,584,68.71,67.64,606,410124.0,30,5,17,1406074.0,349595.0,2116,517,66.45,67.62,2633,1755670.0,22,2023-11-10 12:30:00
758,DSKY,10,49,101848.0,927294.0,131,1325,77.75,69.98,1456,1029142.0,59,6,30,50432.0,704369.0,75,1042,67.24,67.6,1117,754801.0,36,2023-11-10 12:35:00
759,DSKY,10,34,13138.0,1115896.0,19,1409,69.15,79.2,1428,1129035.0,44,4,12,2694.0,158110.0,4,234,67.37,67.57,238,160805.0,16,2023-11-10 12:40:00
760,DSKY,9,42,6065.0,3526524.0,9,4250,67.4,82.98,4259,3532589.0,51,9,24,6739.0,331886.0,10,491,67.39,67.59,501,338625.0,33,2023-11-10 12:45:00
761,DSKY,63,69,9314304.0,1696897.0,12144,2496,76.7,67.98,14640,11011202.0,132,45,56,6805929.0,1103028.0,10203,1630,66.71,67.67,11833,7908957.0,101,2023-11-10 12:50:00
762,DSKY,42,13,742705.0,279565.0,1101,411,67.46,68.02,1512,1022270.0,55,34,4,690650.0,223708.0,1024,329,67.45,68.0,1353,914358.0,38,2023-11-10 12:55:00
763,DSKY,19,4,489753.0,48456.0,726,72,67.46,67.3,798,538209.0,23,16,1,425873.0,46754.0,632,69,67.38,67.76,701,472627.0,17,2023-11-10 13:00:00
764,DSKY,55,16,1998715.0,538840.0,2956,794,67.62,67.86,3750,2537555.0,71,47,10,1779679.0,431600.0,2643,636,67.34,67.86,3279,2211280.0,57,2023-11-10 13:05:00
765,DSKY,22,7,1022765.0,21703.0,1516,48,67.46,45.22,1564,1044468.0,29,22,0,1023788.0,0.0,1518,0,67.44,,1518,1023788.0,22,2023-11-10 13:10:00
766,DSKY,14,2,325533.0,6096.0,482,9,67.54,67.74,491,331630.0,16,12,1,284891.0,5420.0,422,8,67.51,67.76,430,290312.0,13,2023-11-10 13:15:00
767,DSKY,34,20,1771793.0,1153334.0,2621,1697,67.6,67.96,4318,2925128.0,54,36,20,1723318.0,1017161.0,2569,1496,67.08,67.99,4065,2740479.0,56,2023-11-10 13:20:00
768,DSKY,54,25,1265175.0,1556498.0,1880,2291,67.3,67.94,4171,2821673.0,79,40,14,1177452.0,1149819.0,1750,1691,67.28,68.0,3441,2327271.0,54,2023-11-10 13:25:00
769,DSKY,12,14,195571.0,180947.0,289,266,67.67,68.03,555,376519.0,26,8,11,189426.0,166982.0,281,246,67.41,67.88,527,356408.0,19,2023-11-10 13:30:00
770,DSKY,28,16,2188117.0,500656.0,3264,647,67.04,77.38,3911,2688774.0,44,24,5,2215270.0,90347.0,3306,133,67.01,67.93,3439,2305617.0,29,2023-11-10 13:35:00
771,DSKY,15,18,778666.0,580796.0,1153,857,67.53,67.77,2010,1359462.0,33,15,17,1354032.0,567947.0,2015,837,67.2,67.86,2852,1921980.0,32,2023-11-10 13:40:00
772,DSKY,17,27,635989.0,1152467.0,942,1697,67.51,67.91,2639,1788456.0,44,15,25,570181.0,1103139.0,845,1627,67.48,67.8,2472,1673320.0,40,2023-11-10 13:45:00
773,DSKY,56,154,2953137.0,13636032.0,4194,20005,70.41,68.16,24199,16589169.0,210,48,140,2018059.0,13558267.0,2992,19885,67.45,68.18,22877,15576326.0,188,2023-11-10 13:50:00
774,DSKY,63,12,1513735.0,279738.0,2247,413,67.37,67.73,2660,1793474.0,75,56,7,1403248.0,272389.0,2085,401,67.3,67.93,2486,1675637.0,63,2023-11-10 13:55:00
775,DSKY,11,11,47959.0,442706.0,71,651,67.55,68.0,722,490665.0,22,3,10,28400.0,441974.0,42,650,67.62,68.0,692,470374.0,13,2023-11-10 14:00:00
776,DSKY,4,17,13217.0,692075.0,19,1019,69.57,67.92,1038,705292.0,21,2,13,1349.0,635105.0,2,935,67.47,67.93,937,636455.0,15,2023-11-10 14:05:00
777,DSKY,4,54,29734.0,2738591.0,43,4006,69.15,68.36,4049,2768325.0,58,1,52,27032.0,2759909.0,40,4047,67.58,68.2,4087,2786941.0,53,2023-11-10 14:10:00
778,DSKY,24,17,610845.0,292313.0,896,430,68.17,67.98,1326,903159.0,41,17,10,477523.0,175775.0,707,259,67.54,67.87,966,653298.0,27,2023-11-10 14:15:00
779,DSKY,57,56,2352340.0,2557101.0,3488,3772,67.44,67.79,7260,4909442.0,113,50,49,2342061.0,2452834.0,3475,3612,67.4,67.91,7087,4794895.0,99,2023-11-10 14:20:00
780,DSKY,27,11,994878.0,160235.0,1473,236,67.54,67.9,1709,1155113.0,38,25,4,976240.0,243176.0,1445,358,67.56,67.93,1803,1219416.0,29,2023-11-10 14:25:00
781,DSKY,38,12,2119478.0,563243.0,3137,830,67.56,67.86,3967,2682721.0,50,36,10,2094054.0,521900.0,3100,769,67.55,67.87,3869,2615955.0,46,2023-11-10 14:30:00
782,DSKY,30,18,734622.0,1129824.0,1086,1669,67.64,67.69,2755,1864447.0,48,26,13,697926.0,1039851.0,1033,1530,67.56,67.96,2563,1737777.0,39,2023-11-10 14:35:00
783,DSKY,27,4,1140387.0,33960.0,1691,47,67.44,72.26,1738,1174348.0,31,23,0,1155372.0,0.0,1710,0,67.57,,1710,1155372.0,23,2023-11-10 14:40:00
784,DSKY,4,2,12609.0,1367.0,13,2,97.0,68.36,15,13976.0,6,1,0,677.0,0.0,1,0,67.72,,1,677.0,1,2023-11-10 14:45:00
785,DSKY,25,82,1332051.0,2315398.0,2017,3441,66.04,67.29,5458,3647449.0,107,20,74,1324320.0,1603005.0,1991,2365,66.52,67.78,4356,2927326.0,94,2023-11-10 14:50:00
786,DSKY,40,97,558160.0,2144736.0,822,3155,67.9,67.98,3977,2702896.0,137,39,96,543578.0,2548332.0,805,3739,67.53,68.16,4544,3091910.0,135,2023-11-10 14:55:00
787,DSKY,65,168,1503090.0,4354813.0,2249,6405,66.83,67.99,8654,5857904.0,233,59,164,1455828.0,4118367.0,2178,6051,66.84,68.06,8229,5574195.0,223,2023-11-10 15:00:00
788,DSKY,119,179,3174729.0,6634416.0,3779,9743,84.01,68.09,13522,9809146.0,298,112,173,2495286.0,6398517.0,3717,9406,67.13,68.03,13123,8893804.0,285,2023-11-10 15:05:00
789,DSKY,72,10,3782624.0,54964.0,5656,81,66.88,67.86,5737,3837589.0,82,67,5,3310131.0,24412.0,4986,36,66.39,67.81,5022,3334543.0,72,2023-11-10 15:10:00
790,DSKY,227,21,14397416.0,162706.0,21650,240,66.5,67.79,21890,14560122.0,248,221,15,14288607.0,162032.0,21489,239,66.49,67.8,21728,14450639.0,236,2023-11-10 15:15:00
791,DSKY,71,15,3230093.0,156747.0,4819,232,67.03,67.56,5051,3386841.0,86,71,14,2936380.0,153701.0,4386,226,66.95,68.01,4612,3090082.0,85,2023-11-10 15:20:00
792,DSKY,904,56,72641615.0,2353183.0,108739,1515,66.8,155.33,110254,74994798.0,960,899,51,72392286.0,877825.0,108378,1286,66.8,68.26,109664,73270112.0,950,2023-11-10 15:25:00
793,DSKY,370,41,35963816.0,190460.0,54095,280,66.48,68.02,54375,36154276.0,411,361,37,35945159.0,189146.0,54072,278,66.48,68.04,54350,36134306.0,398,2023-11-10 15:30:00
794,DSKY,111,50,4106087.0,194365.0,6104,290,67.27,67.02,6394,4300453.0,161,109,44,4036666.0,183847.0,6007,270,67.2,68.09,6277,4220514.0,153,2023-11-10 15:35:00
795,DSKY,47,51,1515015.0,244428.0,2236,360,67.76,67.9,2596,1759443.0,98,45,47,1511603.0,239361.0,2231,352,67.75,68.0,2583,1750965.0,92,2023-11-10 15:40:00
796,DSKY,22,21,564833.0,156560.0,832,236,67.89,66.34,1068,721393.0,43,20,18,570231.0,143116.0,841,210,67.8,68.15,1051,713347.0,38,2023-11-10 15:45:00
797,DSKY,20,22,509315.0,237885.0,747,348,68.18,68.36,1095,747201.0,42,18,20,503164.0,218088.0,742,321,67.81,67.94,1063,721253.0,38,2023-11-10 15:50:00
798,DSKY,42,45,1158786.0,308434.0,1709,454,67.8,67.94,2163,1467221.0,87,40,41,1108698.0,301676.0,1635,444,67.81,67.95,2079,1410374.0,81,2023-11-10 15:55:00
799,DSKY,24,35,970879.0,571917.0,1433,843,67.75,67.84,2276,1542796.0,59,24,29,1029435.0,265784.0,1519,391,67.77,67.98,1910,1295219.0,53,2023-11-10 16:00:00
800,DSKY,61,17,3247236.0,268037.0,4858,401,66.84,66.84,5259,3515273.0,78,60,13,3311806.0,251121.0,4954,370,66.85,67.87,5324,3562928.0,73,2023-11-10 16:05:00
801,DSKY,21,14,599511.0,129610.0,881,196,68.05,66.13,1077,729121.0,35,16,8,581914.0,120790.0,860,178,67.66,67.86,1038,702704.0,24,2023-11-10 16:10:00
802,DSKY,122,90,5275422.0,1091441.0,7810,1610,67.55,67.79,9420,6366864.0,212,122,89,5317561.0,1109096.0,7871,1634,67.56,67.88,9505,6426657.0,211,2023-11-10 16:15:00
803,DSKY,364,237,30452175.0,7029415.0,45520,10294,66.9,68.29,55814,37481591.0,601,364,231,30246289.0,7289616.0,45212,10671,66.9,68.31,55883,37535905.0,595,2023-11-10 16:20:00
804,DSKY,205,239,11944019.0,10059191.0,17855,14721,66.89,68.33,32576,22003210.0,444,201,235,11929774.0,10078203.0,17834,14748,66.89,68.34,32582,22007977.0,436,2023-11-10 16:25:00
805,DSKY,176,319,10433210.0,14854782.0,15585,21790,66.94,68.17,37375,25287992.0,495,170,313,10482228.0,14711550.0,15659,21529,66.94,68.33,37188,25193779.0,483,2023-11-10 16:30:00
806,DSKY,333,498,19798806.0,26434961.0,29629,38717,66.82,68.28,68346,46233768.0,831,321,490,19722307.0,26422126.0,29519,38689,66.81,68.29,68208,46144433.0,811,2023-11-10 16:35:00
807,DSKY,274,485,7205223.0,23129323.0,10659,33890,67.6,68.25,44549,30334547.0,759,264,473,7164885.0,23108156.0,10600,33860,67.59,68.25,44460,30273041.0,737,2023-11-10 16:40:00
808,DSKY,145,224,4106947.0,12294113.0,6075,18038,67.6,68.16,24113,16401060.0,369,141,221,4146537.0,12044698.0,6135,17661,67.59,68.2,23796,16191235.0,362,2023-11-10 16:45:00
809,DSKY,90,104,2697701.0,1797315.0,3989,2651,67.63,67.8,6640,4495016.0,194,87,100,2626242.0,1800059.0,3884,2655,67.62,67.8,6539,4426301.0,187,2023-11-10 16:50:00
810,DSKY,265,191,9334854.0,6943689.0,13808,10219,67.6,67.95,24027,16278543.0,456,258,190,9398734.0,6959211.0,13904,10237,67.6,67.98,24141,16357946.0,448,2023-11-10 16:55:00
811,DSKY,216,255,8767545.0,9054214.0,12968,13315,67.61,68.0,26283,17821760.0,471,214,254,8733125.0,9017583.0,12918,13261,67.6,68.0,26179,17750708.0,468,2023-11-10 17:00:00
812,DSKY,262,318,11081523.0,9971799.0,16472,14674,67.27,67.96,31146,21053323.0,580,260,313,11019979.0,9965945.0,16391,14651,67.23,68.02,31042,20985925.0,573,2023-11-10 17:05:00
813,DSKY,112,107,4413620.0,2886944.0,6519,4247,67.7,67.98,10766,7300565.0,219,109,107,4420106.0,2907876.0,6539,4280,67.6,67.94,10819,7327982.0,216,2023-11-10 17:10:00
814,DSKY,133,112,3696208.0,2145394.0,5464,3160,67.65,67.89,8624,5841602.0,245,132,110,3691481.0,2121656.0,5457,3125,67.65,67.89,8582,5813138.0,242,2023-11-10 17:15:00
815,DSKY,108,162,5752128.0,6295578.0,8585,9276,67.0,67.87,17861,12047706.0,270,107,157,5683271.0,6279950.0,8485,9237,66.98,67.99,17722,11963222.0,264,2023-11-10 17:20:00
816,DSKY,133,164,2992910.0,3074937.0,4443,4531,67.36,67.86,8974,6067848.0,297,131,163,2912941.0,3055802.0,4326,4502,67.34,67.88,8828,5968744.0,294,2023-11-10 17:25:00
817,DSKY,91,136,1649947.0,2632896.0,2437,3880,67.7,67.86,6317,4282844.0,227,86,132,1613073.0,2651229.0,2385,3906,67.63,67.88,6291,4264303.0,218,2023-11-10 17:30:00
818,DSKY,31,38,544909.0,792798.0,805,1168,67.69,67.88,1973,1337707.0,69,28,37,528954.0,739812.0,782,1090,67.64,67.87,1872,1268766.0,65,2023-11-10 17:35:00
819,DSKY,28,78,272146.0,1629160.0,401,2401,67.87,67.85,2802,1901306.0,106,26,72,276825.0,1654235.0,409,2436,67.68,67.91,2845,1931061.0,98,2023-11-10 17:40:00
820,DSKY,43,104,628749.0,2530839.0,929,3738,67.68,67.71,4667,3159588.0,147,41,102,615207.0,2496605.0,909,3677,67.68,67.9,4586,3111812.0,143,2023-11-10 17:45:00
821,DSKY,12,53,94711.0,1263455.0,140,1860,67.65,67.93,2000,1358166.0,65,10,53,85922.0,1276335.0,127,1879,67.66,67.93,2006,1362257.0,63,2023-11-10 17:50:00
822,DSKY,16,58,518520.0,1265009.0,766,1876,67.69,67.43,2642,1783529.0,74,13,55,502783.0,1253828.0,744,1847,67.58,67.88,2591,1756612.0,68,2023-11-10 17:55:00
823,DSKY,10,33,126926.0,800929.0,187,1209,67.87,66.25,1396,927855.0,43,7,28,79831.0,737247.0,118,1086,67.65,67.89,1204,817078.0,35,2023-11-10 18:00:00
824,DSKY,16,41,123618.0,1062044.0,183,1565,67.55,67.86,1748,1185663.0,57,13,40,119528.0,1060347.0,177,1562,67.53,67.88,1739,1179875.0,53,2023-11-10 18:05:00
825,DSKY,31,102,450543.0,2443084.0,665,3603,67.75,67.81,4268,2893628.0,133,26,98,423444.0,2435286.0,627,3586,67.53,67.91,4213,2858731.0,124,2023-11-10 18:10:00
826,DSKY,34,66,828566.0,2657309.0,1247,3896,66.44,68.21,5143,3485875.0,100,27,64,1436956.0,2662260.0,1248,3897,115.14,68.32,5145,4099217.0,91,2023-11-10 18:15:00
827,DSKY,22,15,1124707.0,460263.0,1695,678,66.35,67.89,2373,1584970.0,37,17,13,1143572.0,467101.0,1720,686,66.49,68.09,2406,1610674.0,30,2023-11-10 18:20:00
828,DSKY,33,6,898457.0,335515.0,1332,492,67.45,68.19,1824,1233972.0,39,26,10,1250080.0,333979.0,1875,491,66.67,68.02,2366,1584059.0,36,2023-11-10 18:25:00
829,DSKY,32,24,1665623.0,1289670.0,2464,1885,67.6,68.42,4349,2955294.0,56,21,19,1354906.0,1114888.0,2011,1634,67.37,68.23,3645,2469795.0,40,2023-11-10 18:30:00
830,DSKY,9,13,264367.0,390824.0,390,575,67.79,67.97,965,655192.0,22,6,13,295596.0,373143.0,437,549,67.64,67.97,986,668739.0,19,2023-11-10 18:35:00
831,DSKY,45,28,1615015.0,1345631.0,2384,1979,67.74,68.0,4363,2960646.0,73,46,28,2547039.0,1865700.0,2886,2732,88.26,68.29,5618,4412740.0,74,2023-11-10 18:40:00
832,DSKY,152,1748,12332630.0,154288111.0,17343,218710,71.11,70.54,236053,166620741.0,1900,83,1497,8693831.0,144986783.0,13029,212049,66.73,68.37,225078,153680614.0,1580,2023-11-13 10:05:00
833,DSKY,72,704,2180646.0,60751755.0,3263,88561,66.83,68.6,91824,62932402.0,776,56,690,2074724.0,60422539.0,3083,88157,67.3,68.54,91240,62497263.0,746,2023-11-13 10:10:00
834,DSKY,44,36,1512308.0,630878.0,2247,902,67.3,69.94,3149,2143186.0,80,37,21,1409051.0,751257.0,2096,1092,67.23,68.8,3188,2160308.0,58,2023-11-13 10:15:00
835,DSKY,30,17,837227.0,712342.0,1240,1032,67.52,69.03,2272,1549569.0,47,30,7,829707.0,530621.0,1236,777,67.13,68.29,2013,1360328.0,37,2023-11-13 10:20:00
836,DSKY,49,20,1782697.0,398215.0,2716,585,65.64,68.07,3301,2180913.0,69,34,9,1671211.0,384039.0,2498,563,66.9,68.21,3061,2055251.0,43,2023-11-13 10:25:00
837,DSKY,99,30,4059083.0,269072.0,6031,400,67.3,67.27,6431,4328155.0,129,90,25,4019250.0,256104.0,5976,377,67.26,67.93,6353,4275355.0,115,2023-11-13 10:30:00
838,DSKY,25,30,1208733.0,913047.0,1798,1284,67.23,71.11,3082,2121781.0,55,19,19,891466.0,270456.0,1327,398,67.18,67.95,1725,1161923.0,38,2023-11-13 10:35:00
839,DSKY,26,34,2203332.0,609993.0,3287,875,67.03,69.71,4162,2813325.0,60,21,23,1992482.0,932821.0,2979,1357,66.88,68.74,4336,2925303.0,44,2023-11-13 10:40:00
840,DSKY,24,25,1012275.0,239741.0,1485,337,68.17,71.14,1822,1252017.0,49,15,20,1134331.0,208877.0,1687,307,67.24,68.04,1994,1343209.0,35,2023-11-13 10:45:00
841,DSKY,24,67,595836.0,2336011.0,778,3518,76.59,66.4,4296,2931847.0,91,14,33,279430.0,1574359.0,413,2296,67.66,68.57,2709,1853790.0,47,2023-11-13 10:50:00
842,DSKY,48,487,2601995.0,57933942.0,3793,83122,68.6,69.7,86915,60535937.0,535,30,433,2525777.0,53229799.0,3760,77518,67.17,68.67,81278,55755576.0,463,2023-11-13 10:55:00
843,DSKY,190,975,4919839.0,112095990.0,7369,163187,66.76,68.69,170556,117015829.0,1165,181,971,4933971.0,112056489.0,7478,163125,65.98,68.69,170603,116990460.0,1152,2023-11-13 11:00:00
844,DSKY,190,834,5667151.0,79285070.0,8397,115211,67.49,68.82,123608,84952221.0,1024,171,812,5184455.0,78448081.0,7684,114277,67.47,68.65,121961,83632536.0,983,2023-11-13 11:05:00
845,DSKY,112,137,3171935.0,12868923.0,4688,18742,67.66,68.66,23430,16040859.0,249,106,129,3125371.0,12916177.0,4621,18811,67.63,68.66,23432,16041549.0,235,2023-11-13 11:10:00
846,DSKY,75,53,1711078.0,544885.0,2535,860,67.5,63.36,3395,2255963.0,128,65,38,1675218.0,1049659.0,2482,1526,67.49,68.79,4008,2724877.0,103,2023-11-13 11:15:00
847,DSKY,44,32,266705.0,207497.0,392,296,68.04,70.1,688,474202.0,76,32,23,254147.0,129968.0,375,191,67.77,68.05,566,384116.0,55,2023-11-13 11:20:00
848,DSKY,113,216,12748779.0,16749869.0,18937,24463,67.32,68.47,43400,29498649.0,329,98,202,12435658.0,16074934.0,18523,23474,67.14,68.48,41997,28510593.0,300,2023-11-13 11:25:00
849,DSKY,697,351,45602856.0,30343347.0,67481,44260,67.58,68.56,111741,75946204.0,1048,685,345,45543111.0,30084385.0,67388,43924,67.58,68.49,111312,75627496.0,1030,2023-11-13 11:30:00
850,DSKY,417,98,28977931.0,4325380.0,43049,6295,67.31,68.71,49344,33303312.0,515,410,94,28951341.0,4237381.0,43024,6205,67.29,68.29,49229,33188722.0,504,2023-11-13 11:35:00
851,DSKY,344,60,28216310.0,451848.0,41994,694,67.19,65.11,42688,28668158.0,404,338,51,28192522.0,357368.0,41961,523,67.19,68.33,42484,28549890.0,389,2023-11-13 11:40:00
852,DSKY,730,1123,62382232.0,110429726.0,92641,161182,67.34,68.51,253823,172811958.0,1853,712,1116,62120178.0,110222976.0,92262,160868,67.33,68.52,253130,172343154.0,1828,2023-11-13 11:45:00
853,DSKY,583,100,43016126.0,2199269.0,63432,3219,67.81,68.32,66651,45215396.0,683,578,87,43064095.0,2065378.0,63518,3021,67.8,68.37,66539,45129474.0,665,2023-11-13 11:50:00
854,DSKY,705,396,56216503.0,19252744.0,82985,28086,67.74,68.55,111071,75469247.0,1101,694,384,56120378.0,19287230.0,82846,28123,67.74,68.58,110969,75407609.0,1078,2023-11-13 11:55:00
855,DSKY,763,1740,62914246.0,162808784.0,92970,237222,67.67,68.63,330192,225723031.0,2503,756,1730,62964152.0,162856368.0,93035,237285,67.68,68.63,330320,225820520.0,2486,2023-11-13 12:00:00
856,DSKY,610,1259,47014101.0,111308869.0,69333,162195,67.81,68.63,231528,158322970.0,1869,607,1252,47016863.0,111218326.0,69350,162016,67.8,68.65,231366,158235189.0,1859,2023-11-13 12:05:00
857,DSKY,765,741,59292404.0,54374112.0,87529,79209,67.74,68.65,166738,113666516.0,1506,758,737,59379767.0,54364780.0,87662,79194,67.74,68.65,166856,113744548.0,1495,2023-11-13 12:10:00
858,DSKY,1052,1390,88291024.0,117294830.0,130640,170865,67.58,68.65,301505,205585855.0,2442,1040,1384,88140936.0,117208126.0,130423,170742,67.58,68.65,301165,205349063.0,2424,2023-11-13 12:15:00
859,DSKY,818,604,64772873.0,41192144.0,95740,60062,67.65,68.58,155802,105965017.0,1422,808,597,64599944.0,41151455.0,95491,59975,67.65,68.61,155466,105751399.0,1405,2023-11-13 12:20:00
860,DSKY,335,61,22128553.0,1357120.0,32752,1970,67.56,68.89,34722,23485674.0,396,336,54,22115525.0,1130554.0,32752,1643,67.52,68.81,34395,23246079.0,390,2023-11-13 12:25:00
861,DSKY,348,50,22110752.0,731587.0,32727,1082,67.56,67.61,33809,22842340.0,398,345,47,22273028.0,732666.0,32985,1073,67.52,68.28,34058,23005694.0,392,2023-11-13 12:30:00
862,DSKY,290,51,17275547.0,537498.0,25510,795,67.72,67.61,26305,17813046.0,341,291,44,17317580.0,486192.0,25574,712,67.72,68.29,26286,17803773.0,335,2023-11-13 12:35:00
863,DSKY,575,117,38684273.0,5223525.0,57266,7652,67.55,68.26,64918,43907799.0,692,566,105,38594837.0,5421117.0,57135,7929,67.55,68.37,65064,44015954.0,671,2023-11-13 12:40:00
864,DSKY,361,354,29427791.0,25534074.0,43902,37427,67.03,68.22,81329,54961866.0,715,359,349,29426594.0,25181870.0,43903,36919,67.03,68.21,80822,54608464.0,708,2023-11-13 12:45:00
865,DSKY,588,832,47648544.0,70839576.0,71067,98992,67.05,71.56,170059,118488120.0,1420,585,825,47479960.0,60916305.0,70808,89237,67.05,68.26,160045,108396265.0,1410,2023-11-13 12:50:00
866,DSKY,531,644,43866693.0,45352391.0,65441,66477,67.03,68.22,131918,89219084.0,1175,526,639,43865548.0,45332578.0,65437,66448,67.03,68.22,131885,89198126.0,1165,2023-11-13 12:55:00
867,DSKY,363,1177,34867856.0,97249913.0,52585,142622,66.31,68.19,195207,132117770.0,1540,360,1176,34845715.0,97426132.0,52558,142875,66.3,68.19,195433,132271847.0,1536,2023-11-13 13:00:00
868,DSKY,966,1902,81452465.0,175903004.0,122911,257947,66.27,68.19,380858,257355469.0,2868,962,1896,81453447.0,175639266.0,122913,257556,66.27,68.19,380469,257092714.0,2858,2023-11-13 13:05:00
869,DSKY,297,1572,8747098.0,152017132.0,12928,222940,67.66,68.19,235868,160764230.0,1869,294,1569,8745871.0,152039261.0,12926,222971,67.66,68.19,235897,160785133.0,1863,2023-11-13 13:10:00
870,DSKY,387,1014,20287528.0,94305449.0,30144,138346,67.3,68.17,168490,114592977.0,1401,380,999,19450675.0,94343435.0,28893,138399,67.32,68.17,167292,113794110.0,1379,2023-11-13 13:15:00
871,DSKY,237,218,20439694.0,9748738.0,30434,14294,67.16,68.2,44728,30188433.0,455,231,214,20271462.0,9640485.0,30195,14134,67.14,68.21,44329,29911947.0,445,2023-11-13 13:20:00
872,DSKY,1334,182,145479678.0,3918688.0,215712,5747,67.44,68.19,221459,149398366.0,1516,1328,175,145303514.0,3954912.0,215526,5797,67.42,68.22,221323,149258426.0,1503,2023-11-13 13:25:00
873,DSKY,1264,306,143153327.0,6122201.0,212660,9040,67.32,67.72,221700,149275529.0,1570,1261,303,143140439.0,6039671.0,212631,8855,67.32,68.21,221486,149180110.0,1564,2023-11-13 13:30:00
874,DSKY,163,55,23521116.0,1338313.0,34962,1964,67.28,68.14,36926,24859429.0,218,158,52,21800850.0,1297802.0,32439,1903,67.21,68.2,34342,23098652.0,210,2023-11-13 13:35:00
875,DSKY,13,2,792958.0,1061577.0,1189,210,66.69,505.51,1399,1854536.0,15,9,0,731180.0,0.0,1101,0,66.41,,1101,731180.0,9,2023-11-13 13:40:00
876,DSKY,8,12,35486.0,414686.0,50,605,70.97,68.54,655,450172.0,20,4,10,26429.0,412307.0,39,602,67.77,68.49,641,438736.0,14,2023-11-13 13:45:00
877,DSKY,10,8,93566.0,89753.0,138,143,67.8,62.76,281,183320.0,18,5,1,55823.0,37011.0,82,54,68.08,68.54,136,92834.0,6,2023-11-13 13:50:00
878,DSKY,7,3,1269725.0,89414.0,1881,131,67.5,68.26,2012,1359140.0,10,6,2,1268648.0,89258.0,1880,130,67.48,68.66,2010,1357906.0,8,2023-11-13 13:55:00
879,DSKY,6,7,20361.0,15275.0,29,34,70.21,44.93,63,35637.0,13,4,0,71058.0,0.0,105,0,67.67,,105,71058.0,4,2023-11-13 14:00:00
880,DSKY,13,11,148354.0,367003.0,219,548,67.74,66.97,767,515357.0,24,10,5,145659.0,254172.0,215,372,67.75,68.33,587,399831.0,15,2023-11-13 14:05:00
881,DSKY,12,7,1426848.0,162545.0,2113,238,67.53,68.3,2351,1589393.0,19,10,2,1347261.0,130950.0,1996,191,67.5,68.56,2187,1478211.0,12,2023-11-13 14:10:00
882,DSKY,0,6,0.0,223675.0,0,326,,68.61,326,223675.0,6,0,6,0.0,1884033.0,0,499,,377.56,499,1884033.0,6,2023-11-13 14:15:00
883,DSKY,6,14,240534.0,742222.0,353,1086,68.14,68.34,1439,982756.0,20,4,11,12164.0,562553.0,18,821,67.58,68.52,839,574717.0,15,2023-11-13 14:20:00
884,DSKY,1,15,681.0,443610.0,1,651,68.16,68.14,652,444291.0,16,0,11,0.0,462676.0,0,675,,68.54,675,462676.0,11,2023-11-13 14:25:00
885,DSKY,22,33,1299807.0,1378509.0,1922,2019,67.63,68.28,3941,2678316.0,55,18,25,1286167.0,1299271.0,1906,1896,67.48,68.53,3802,2585439.0,43,2023-11-13 14:30:00
886,DSKY,15,13,1386135.0,395497.0,2052,580,67.55,68.19,2632,1781633.0,28,12,8,1382416.0,418082.0,2048,610,67.5,68.54,2658,1800498.0,20,2023-11-13 14:35:00
887,DSKY,9,3,144398.0,4073.0,211,6,68.44,67.89,217,148472.0,12,6,0,140243.0,0.0,207,0,67.75,,207,140243.0,6,2023-11-13 14:40:00
888,DSKY,6,9,607535.0,185300.0,904,280,67.21,66.18,1184,792835.0,15,4,3,607119.0,154170.0,902,225,67.31,68.52,1127,761289.0,7,2023-11-13 14:45:00
889,DSKY,16,7,2425913.0,90111.0,3608,132,67.24,68.27,3740,2516025.0,23,15,2,2491638.0,82238.0,3706,120,67.23,68.53,3826,2573876.0,17,2023-11-13 14:50:00
890,DSKY,9,22,612213.0,355403.0,908,520,67.42,68.35,1428,967616.0,31,7,10,607540.0,328033.0,905,480,67.13,68.34,1385,935573.0,17,2023-11-13 14:55:00
891,DSKY,19,47,1829564.0,1491877.0,2723,2185,67.19,68.28,4908,3321442.0,66,14,42,1822874.0,1437135.0,2711,2102,67.24,68.37,4813,3260010.0,56,2023-11-13 15:00:00
892,DSKY,19,42,1960362.0,1150166.0,2914,1686,67.27,68.22,4600,3110529.0,61,19,38,1958612.0,1114697.0,2914,1633,67.21,68.26,4547,3073310.0,57,2023-11-13 15:05:00
893,DSKY,23,22,2028594.0,620092.0,3010,905,67.4,68.52,3915,2648687.0,45,22,19,2017025.0,603013.0,2993,883,67.39,68.29,3876,2620039.0,41,2023-11-13 15:10:00
894,DSKY,15,12,1827528.0,441563.0,2716,646,67.29,68.35,3362,2269092.0,27,10,11,1818738.0,364452.0,2705,533,67.24,68.38,3238,2183191.0,21,2023-11-13 15:15:00
895,DSKY,14,8,1827680.0,79132.0,2717,120,67.27,65.94,2837,1906813.0,22,10,3,1816400.0,102311.0,2704,150,67.17,68.21,2854,1918712.0,13,2023-11-13 15:20:00
896,DSKY,10,5,154494.0,128891.0,227,192,68.06,67.13,419,283386.0,15,11,4,227036.0,133676.0,335,196,67.77,68.2,531,360712.0,15,2023-11-13 15:25:00
897,DSKY,13,12,34983.0,321629.0,50,472,69.97,68.14,522,356612.0,25,9,9,21657.0,269160.0,32,393,67.68,68.49,425,290817.0,18,2023-11-13 15:30:00
898,DSKY,12,36,127745.0,862169.0,188,1262,67.95,68.32,1450,989914.0,48,9,27,125360.0,895604.0,185,1310,67.76,68.37,1495,1020964.0,36,2023-11-13 15:35:00
899,DSKY,6,28,46232.0,962482.0,68,1411,67.99,68.21,1479,1008715.0,34,3,22,28474.0,951715.0,42,1394,67.8,68.27,1436,980189.0,25,2023-11-13 15:40:00
900,DSKY,8,10,7112.0,302075.0,9,495,79.02,61.03,504,309187.0,18,6,5,4058.0,212634.0,6,311,67.65,68.37,317,216693.0,11,2023-11-13 15:45:00
901,DSKY,3,6,13231.0,66896.0,13,99,101.78,67.57,112,80127.0,9,0,4,0.0,65539.0,0,96,,68.27,96,65539.0,4,2023-11-13 15:50:00
902,DSKY,10,6,306567.0,200533.0,452,324,67.82,61.89,776,507101.0,16,9,4,294731.0,109225.0,435,160,67.75,68.27,595,403957.0,13,2023-11-13 15:55:00
903,DSKY,3,4,76685.0,33786.0,76,51,100.9,66.25,127,110471.0,7,1,2,4744.0,32769.0,7,48,67.78,68.27,55,37514.0,3,2023-11-13 16:00:00
904,DSKY,8,12,139956.0,231146.0,207,338,67.61,68.39,545,371103.0,20,6,11,108088.0,264672.0,160,386,67.56,68.57,546,372760.0,17,2023-11-13 16:05:00
905,DSKY,11,13,138645.0,201612.0,166,295,83.52,68.34,461,340257.0,24,7,6,89414.0,150158.0,132,220,67.74,68.25,352,239573.0,13,2023-11-13 16:10:00
906,DSKY,8,15,88293.0,546105.0,128,800,68.98,68.26,928,634399.0,23,6,13,64903.0,597035.0,96,874,67.61,68.31,970,661938.0,19,2023-11-13 16:15:00
907,DSKY,4,11,22800.0,226596.0,30,332,76.0,68.25,362,249396.0,15,1,5,681.0,186685.0,1,273,68.16,68.38,274,187367.0,6,2023-11-13 16:20:00
908,DSKY,13,16,492585.0,509228.0,726,746,67.85,68.26,1472,1001813.0,29,11,18,481202.0,809771.0,710,1185,67.77,68.34,1895,1290973.0,29,2023-11-13 16:25:00
909,DSKY,14,21,1473944.0,627409.0,2179,917,67.64,68.42,3096,2101353.0,35,12,13,1421428.0,351598.0,2107,514,67.46,68.4,2621,1773027.0,25,2023-11-13 16:30:00
910,DSKY,5,12,49579.0,234175.0,72,338,68.86,69.28,410,283755.0,17,1,5,33860.0,120738.0,50,177,67.72,68.21,227,154598.0,6,2023-11-13 16:35:00
911,DSKY,2,0,28632.0,0.0,42,0,68.17,,42,28632.0,2,1,0,25211.0,0.0,37,0,68.14,,37,25211.0,1,2023-11-13 16:40:00
912,DSKY,11,9,228494.0,187843.0,334,275,68.41,68.31,609,416337.0,20,8,12,257213.0,485212.0,379,709,67.87,68.44,1088,742426.0,20,2023-11-13 16:45:00
913,DSKY,28,34,780645.0,1007795.0,1151,1472,67.82,68.46,2623,1788440.0,62,28,32,786779.0,1006434.0,1160,1470,67.83,68.46,2630,1793213.0,60,2023-11-13 16:50:00
914,DSKY,28,51,960713.0,4266835.0,1418,6274,67.75,68.01,7692,5227548.0,79,29,38,935264.0,3744524.0,1380,5472,67.77,68.43,6852,4679788.0,67,2023-11-13 16:55:00
915,DSKY,4,23,47809.0,1842558.0,69,2664,69.29,69.17,2733,1890367.0,27,2,18,58724.0,2009221.0,87,2927,67.5,68.64,3014,2067945.0,20,2023-11-13 17:00:00
916,DSKY,4,20,62813.0,1985098.0,89,2903,70.58,68.38,2992,2047911.0,24,1,18,33860.0,1970101.0,50,2879,67.72,68.43,2929,2003961.0,19,2023-11-13 17:05:00
917,DSKY,16,14,372420.0,892915.0,551,1311,67.59,68.11,1862,1265335.0,30,15,8,367671.0,874538.0,544,1278,67.59,68.43,1822,1242209.0,23,2023-11-13 17:10:00
918,DSKY,2,2,12196.0,17068.0,18,25,67.76,68.27,43,29264.0,4,1,2,10158.0,21872.0,15,32,67.72,68.35,47,32030.0,3,2023-11-13 17:15:00
919,DSKY,8,12,174966.0,147747.0,258,236,67.82,62.6,494,322713.0,20,8,7,195653.0,117889.0,289,172,67.7,68.54,461,313543.0,15,2023-11-13 17:20:00
920,DSKY,15,9,443241.0,407764.0,653,596,67.88,68.42,1249,851005.0,24,10,7,417791.0,407784.0,617,596,67.71,68.42,1213,825575.0,17,2023-11-13 17:25:00
921,DSKY,4,13,29482.0,376893.0,43,554,68.56,68.03,597,406375.0,17,2,14,48824.0,576185.0,72,842,67.81,68.43,914,625009.0,16,2023-11-13 17:30:00
922,DSKY,3,12,45465.0,529726.0,67,774,67.86,68.44,841,575191.0,15,1,2,33860.0,3574.0,50,5,67.72,71.48,55,37434.0,3,2023-11-13 17:35:00
923,DSKY,7,9,65739.0,165348.0,90,313,73.04,52.83,403,231087.0,16,4,2,45279.0,56220.0,67,82,67.58,68.56,149,101499.0,6,2023-11-13 17:40:00
924,DSKY,11,14,760700.0,38372.0,1121,58,67.86,66.16,1179,799072.0,25,10,4,771882.0,7565.0,1138,11,67.83,68.78,1149,779448.0,14,2023-11-13 17:45:00
925,DSKY,20,5,1060166.0,45956.0,1563,67,67.83,68.59,1630,1106122.0,25,16,2,1195400.0,41854.0,1763,61,67.8,68.61,1824,1237254.0,18,2023-11-13 17:50:00
926,DSKY,6,5,123386.0,92312.0,182,136,67.79,67.88,318,215699.0,11,4,2,120659.0,89232.0,178,130,67.79,68.64,308,209891.0,6,2023-11-13 17:55:00
927,DSKY,6,14,242180.0,492047.0,357,735,67.84,66.95,1092,734228.0,20,3,9,112720.0,654918.0,166,957,67.9,68.43,1123,767638.0,12,2023-11-13 18:00:00
928,DSKY,22,27,559060.0,1345303.0,824,1967,67.85,68.39,2791,1904363.0,49,20,21,517473.0,1028732.0,763,1504,67.82,68.4,2267,1546205.0,41,2023-11-13 18:05:00
929,DSKY,4,4,64414.0,5434.0,80,14,80.52,38.82,94,69848.0,8,1,0,33860.0,0.0,50,0,67.72,,50,33860.0,1,2023-11-13 18:10:00
930,DSKY,2,3,84758.0,32160.0,125,38,67.81,84.63,163,116918.0,5,1,1,27112.0,683.0,40,1,67.78,68.3,41,27795.0,2,2023-11-13 18:15:00
931,DSKY,4,7,72944.0,9192.0,88,16,82.89,57.45,104,82137.0,11,2,2,84758.0,2728.0,125,4,67.81,68.2,129,87486.0,4,2023-11-13 18:20:00
932,DSKY,30,9,1427069.0,363119.0,2068,529,69.01,68.64,2597,1790188.0,39,22,8,1140760.0,508174.0,1689,743,67.54,68.39,2432,1648935.0,30,2023-11-13 18:25:00
933,DSKY,3,2,114529.0,5089.0,168,13,68.17,39.15,181,119619.0,5,2,1,138262.0,687.0,204,1,67.78,68.7,205,138949.0,3,2023-11-13 18:30:00
934,DSKY,1,13,5089.0,330332.0,5,485,101.78,68.11,490,335421.0,14,0,10,0.0,327938.0,0,479,,68.46,479,327938.0,10,2023-11-13 18:35:00
935,DSKY,29,16,1907404.0,927615.0,2746,1410,69.46,65.79,4156,2835019.0,45,25,22,2809356.0,1065937.0,4186,1520,67.11,70.13,5706,3875293.0,47,2023-11-13 18:40:00
936,DSKY,2832,1930,280890988.0,161003369.0,418064,219020,67.19,73.51,637084,441894357.0,4762,2765,1715,277439444.0,141916329.0,413167,203059,67.15,69.89,616226,419355773.0,4480,2023-11-14 10:05:00
937,DSKY,1485,3130,134453418.0,268204186.0,201289,393777,66.8,68.11,595066,402657605.0,4615,1478,3104,135000468.0,267790675.0,202110,393055,66.8,68.13,595165,402791143.0,4582,2023-11-14 10:10:00
938,DSKY,377,3563,23441394.0,283184242.0,35173,416046,66.65,68.07,451219,306625637.0,3940,359,3546,23214938.0,282838327.0,34837,415578,66.64,68.06,450415,306053265.0,3905,2023-11-14 10:15:00
939,DSKY,539,1910,22274888.0,160776143.0,33306,236349,66.88,68.02,269655,183051032.0,2449,526,1891,21887078.0,160020777.0,32699,235248,66.94,68.02,267947,181907855.0,2417,2023-11-14 10:20:00
940,DSKY,630,2690,30965865.0,216809629.0,46542,318617,66.53,68.05,365159,247775495.0,3320,602,2672,30146175.0,216138924.0,45315,317565,66.53,68.06,362880,246285099.0,3274,2023-11-14 10:25:00
941,DSKY,661,3348,20715137.0,334336512.0,30925,491477,66.99,68.03,522402,355051649.0,4009,643,3340,20707841.0,334403361.0,30923,491567,66.97,68.03,522490,355111203.0,3983,2023-11-14 10:30:00
942,DSKY,658,2621,24579106.0,256293308.0,36669,376513,67.03,68.07,413182,280872415.0,3279,650,2615,24542331.0,256304774.0,36645,376533,66.97,68.07,413178,280847105.0,3265,2023-11-14 10:35:00
943,DSKY,436,1326,19602937.0,117204222.0,29291,172148,66.92,68.08,201439,136807160.0,1762,432,1313,19527704.0,117071636.0,29176,171965,66.93,68.08,201141,136599341.0,1745,2023-11-14 10:40:00
944,DSKY,472,50,75527782.0,830804.0,114504,1229,65.96,67.6,115733,76358586.0,522,469,39,75494270.0,737426.0,114453,1088,65.96,67.78,115541,76231696.0,508,2023-11-14 10:45:00
945,DSKY,585,1391,37757916.0,130784771.0,56856,192390,66.41,67.98,249246,168542688.0,1976,569,1382,37583399.0,129984269.0,56625,191265,66.37,67.96,247890,167567669.0,1951,2023-11-14 10:50:00
946,DSKY,167,2806,5552051.0,277529481.0,8269,408342,67.14,67.96,416611,283081533.0,2973,164,2801,5378703.0,277689166.0,8009,408576,67.16,67.97,416585,283067870.0,2965,2023-11-14 10:55:00
947,DSKY,67,2803,2151554.0,235038282.0,3245,345955,66.3,67.94,349200,237189836.0,2870,59,2788,2106737.0,234859891.0,3173,345648,66.4,67.95,348821,236966628.0,2847,2023-11-14 11:00:00
948,DSKY,45,2770,39413.0,239073051.0,58,351849,67.95,67.95,351907,239112464.0,2815,30,2769,26254.0,238844017.0,39,351519,67.32,67.95,351558,238870272.0,2799,2023-11-14 11:05:00
949,DSKY,299,3373,7265014.0,295825862.0,10817,435221,67.16,67.97,446038,303090876.0,3672,291,3360,7769631.0,295753750.0,11586,435117,67.06,67.97,446703,303523381.0,3651,2023-11-14 11:10:00
950,DSKY,410,3130,15655486.0,238511646.0,23323,350562,67.12,68.04,373885,254167133.0,3540,404,3125,15212755.0,238517849.0,22637,350572,67.2,68.04,373209,253730604.0,3529,2023-11-14 11:15:00
951,DSKY,483,3212,20328694.0,239099559.0,30295,349169,67.1,68.48,379464,259428254.0,3695,481,3208,20292556.0,237634117.0,30241,349333,67.1,68.03,379574,257926674.0,3689,2023-11-14 11:20:00
952,DSKY,514,4419,18321022.0,316795126.0,27232,465767,67.28,68.02,492999,335116149.0,4933,512,4412,18329413.0,316779285.0,27245,465744,67.28,68.02,492989,335108698.0,4924,2023-11-14 11:25:00
953,DSKY,333,3643,13934058.0,278674349.0,20751,410214,67.15,67.93,430965,292608407.0,3976,331,3620,13921502.0,278481477.0,20733,409882,67.15,67.94,430615,292402980.0,3951,2023-11-14 11:30:00
954,DSKY,213,3500,7310843.0,267374580.0,10873,393331,67.24,67.98,404204,274685423.0,3713,212,3473,7761531.0,266962449.0,11561,392897,67.14,67.95,404458,274723980.0,3685,2023-11-14 11:35:00
955,DSKY,128,2155,3738952.0,159699720.0,5573,234018,67.09,68.24,239591,163438673.0,2283,121,2130,3280173.0,155992078.0,4873,229560,67.31,67.95,234433,159272252.0,2251,2023-11-14 11:40:00
956,DSKY,128,2245,4248459.0,169784136.0,6315,249880,67.28,67.95,256195,174032596.0,2373,125,2241,4222928.0,169760888.0,6277,249845,67.28,67.95,256122,173983816.0,2366,2023-11-14 11:45:00
957,DSKY,59,1283,1205067.0,97393075.0,1790,143336,67.32,67.95,145126,98598142.0,1342,58,1279,1199614.0,97368045.0,1782,143295,67.32,67.95,145077,98567659.0,1337,2023-11-14 11:50:00
958,DSKY,98,848,3237656.0,59568365.0,4830,87678,67.03,67.94,92508,62806021.0,946,96,843,3270626.0,59714372.0,4879,87895,67.03,67.94,92774,62984998.0,939,2023-11-14 11:55:00
959,DSKY,233,2885,6474171.0,195957208.0,9621,288153,67.29,68.0,297774,202431379.0,3118,225,2875,5901500.0,195446402.0,8779,287421,67.22,68.0,296200,201347902.0,3100,2023-11-14 12:00:00
960,DSKY,29,1132,359949.0,77619347.0,535,113993,67.28,68.09,114528,77979296.0,1161,28,1128,358865.0,77693575.0,534,114100,67.2,68.09,114634,78052440.0,1156,2023-11-14 12:05:00
961,DSKY,29,1001,314168.0,64499467.0,467,94749,67.27,68.07,95216,64813635.0,1030,29,994,314164.0,64538066.0,467,94796,67.27,68.08,95263,64852230.0,1023,2023-11-14 12:10:00
962,DSKY,20,701,226050.0,48137019.0,336,70724,67.28,68.06,71060,48363070.0,721,20,702,682019.0,48325504.0,1032,71000,66.09,68.06,72032,49007523.0,722,2023-11-14 12:15:00
963,DSKY,8,1518,523684.0,119896687.0,800,176096,65.46,68.09,176896,120420371.0,1526,5,1509,52458.0,119520178.0,78,175543,67.25,68.09,175621,119572637.0,1514,2023-11-14 12:20:00
964,DSKY,1,1113,673.0,92167949.0,1,135372,67.32,68.08,135373,92168622.0,1114,0,1111,0.0,92163047.0,0,135364,,68.09,135364,92163047.0,1111,2023-11-14 12:25:00
965,DSKY,9,2626,241421.0,204182094.0,358,299832,67.44,68.1,300190,204423516.0,2635,6,2621,247792.0,204145523.0,368,299774,67.33,68.1,300142,204393315.0,2627,2023-11-14 12:30:00
966,DSKY,9,2684,274309.0,191621174.0,407,281303,67.4,68.12,281710,191895484.0,2693,9,2677,392348.0,191591271.0,583,281270,67.3,68.12,281853,191983619.0,2686,2023-11-14 12:35:00
967,DSKY,17,746,289236.0,52213372.0,430,76704,67.26,68.07,77134,52502608.0,763,13,745,149812.0,52131885.0,223,76581,67.18,68.07,76804,52281698.0,758,2023-11-14 12:40:00
968,DSKY,14,722,151764.0,50482046.0,225,74136,67.45,68.09,74361,50633811.0,736,15,722,597017.0,50848297.0,906,74669,65.9,68.1,75575,51445315.0,737,2023-11-14 12:45:00
969,DSKY,9,310,530608.0,23708097.0,810,34814,65.51,68.1,35624,24238705.0,319,3,308,48288.0,23386536.0,72,34346,67.07,68.09,34418,23434824.0,311,2023-11-14 12:50:00
970,DSKY,12,2227,86014.0,156490064.0,128,229866,67.2,68.08,229994,156576078.0,2239,7,2215,82635.0,156585420.0,123,229997,67.18,68.08,230120,156668055.0,2222,2023-11-14 12:55:00
971,DSKY,5,920,55239.0,73168514.0,85,107494,64.99,68.07,107579,73223753.0,925,4,917,50305.0,72964770.0,75,107193,67.07,68.07,107268,73015075.0,921,2023-11-14 13:00:00
972,DSKY,22,1593,188921.0,123944515.0,281,182048,67.23,68.08,182329,124133436.0,1615,18,1587,182040.0,123898923.0,271,181944,67.17,68.1,182215,124080963.0,1605,2023-11-14 13:05:00
973,DSKY,24,826,380765.0,57950990.0,566,85061,67.27,68.13,85627,58331756.0,850,25,821,362345.0,57897807.0,539,84988,67.23,68.12,85527,58260153.0,846,2023-11-14 13:10:00
974,DSKY,184,1525,9447956.0,94167288.0,14346,140428,65.86,67.06,154774,103615245.0,1709,108,1503,8426362.0,93135137.0,12794,137701,65.86,67.64,150495,101561500.0,1611,2023-11-14 13:15:00
975,DSKY,127,2699,1933210.0,216921905.0,2932,320382,65.93,67.71,323314,218855115.0,2826,116,2687,1990119.0,216666683.0,3022,320000,65.85,67.71,323022,218656803.0,2803,2023-11-14 13:20:00
976,DSKY,97,2670,1087386.0,219736313.0,1642,324293,66.22,67.76,325935,220823700.0,2767,85,2661,1016858.0,219528285.0,1538,323982,66.12,67.76,325520,220545143.0,2746,2023-11-14 13:25:00
977,DSKY,260,3238,7219988.0,276854272.0,10721,408876,67.34,67.71,419597,284074260.0,3498,251,3232,7002574.0,276778396.0,10401,408764,67.33,67.71,419165,283780970.0,3483,2023-11-14 13:30:00
978,DSKY,277,3079,5985479.0,261401171.0,8035,385881,74.49,67.74,393916,267386650.0,3356,275,3071,5298218.0,261437375.0,7912,385958,66.96,67.74,393870,266735593.0,3346,2023-11-14 13:35:00
979,DSKY,152,1145,2235464.0,91341118.0,3318,134691,67.37,67.82,138009,93576583.0,1297,151,1145,2189677.0,91318711.0,3250,134657,67.37,67.82,137907,93508389.0,1296,2023-11-14 13:40:00
980,DSKY,448,2757,6628119.0,216157008.0,9842,318907,67.35,67.78,328749,222785127.0,3205,443,2750,6630413.0,216146469.0,9845,318886,67.35,67.78,328731,222776883.0,3193,2023-11-14 13:45:00
981,DSKY,455,2968,7444039.0,240237702.0,11055,354553,67.34,67.76,365608,247681741.0,3423,455,2959,7454096.0,240225881.0,11070,354525,67.34,67.76,365595,247679978.0,3414,2023-11-14 13:50:00
982,DSKY,195,2412,3810944.0,187476640.0,5661,276726,67.32,67.75,282387,191287585.0,2607,199,2408,3966164.0,187331597.0,5894,276519,67.29,67.75,282413,191297762.0,2607,2023-11-14 13:55:00
983,DSKY,91,2925,3850682.0,246837497.0,5775,363760,66.68,67.86,369535,250688179.0,3016,85,2905,3821616.0,245032415.0,5731,362050,66.68,67.68,367781,248854031.0,2990,2023-11-14 14:00:00
984,DSKY,53,1571,1031917.0,138388767.0,1546,204462,66.75,67.68,206008,139420684.0,1624,53,1564,1065635.0,138432409.0,1596,204524,66.77,67.69,206120,139498044.0,1617,2023-11-14 14:05:00
985,DSKY,84,2667,2243511.0,211806072.0,2379,312802,94.3,67.71,315181,214049584.0,2751,86,2667,1505821.0,211766982.0,2259,312740,66.66,67.71,314999,213272803.0,2753,2023-11-14 14:10:00
986,DSKY,71,2776,1739497.0,221858589.0,1821,327522,95.52,67.74,329343,223598086.0,2847,66,2766,1083440.0,221800048.0,1626,327468,66.63,67.73,329094,222883488.0,2832,2023-11-14 14:15:00
987,DSKY,30,2090,440340.0,197903809.0,664,292267,66.32,67.71,292931,198344149.0,2120,26,2084,433017.0,197905452.0,653,292260,66.31,67.72,292913,198338470.0,2110,2023-11-14 14:20:00
988,DSKY,36,1412,458110.0,112335465.0,690,165791,66.39,67.76,166481,112793575.0,1448,35,1409,448561.0,112239056.0,673,165650,66.65,67.76,166323,112687618.0,1444,2023-11-14 14:25:00
989,DSKY,39,1474,376037.0,118175070.0,563,174406,66.79,67.76,174969,118551107.0,1513,36,1469,367007.0,118099174.0,550,174258,66.73,67.77,174808,118466181.0,1505,2023-11-14 14:30:00
990,DSKY,115,4027,3149588.0,352423163.0,4724,520422,66.67,67.72,525146,355572752.0,4142,108,4016,2920560.0,352221982.0,4383,520119,66.63,67.72,524502,355142542.0,4124,2023-11-14 14:35:00
991,DSKY,43,1779,1615991.0,170046653.0,2426,251260,66.61,67.68,253686,171662645.0,1822,43,1776,2276230.0,169968166.0,2434,251144,93.52,67.68,253578,172244397.0,1819,2023-11-14 14:40:00
992,DSKY,110,4038,3064086.0,325359848.0,4100,480901,74.73,67.66,485001,328423935.0,4148,107,4034,2720086.0,325228095.0,4077,480554,66.72,67.68,484631,327948182.0,4141,2023-11-14 14:45:00
993,DSKY,356,3752,28553307.0,316703305.0,43172,468916,66.14,67.54,512088,345256613.0,4108,348,3737,27793791.0,316308881.0,42040,467824,66.11,67.61,509864,344102673.0,4085,2023-11-14 14:50:00
994,DSKY,100,3620,1573131.0,289767527.0,1759,429063,89.43,67.53,430822,291340658.0,3720,87,3608,1467531.0,289670326.0,1705,428858,86.07,67.54,430563,291137858.0,3695,2023-11-14 14:55:00
995,DSKY,157,2533,5853848.0,234747184.0,8883,346720,65.9,67.71,355603,240601032.0,2690,144,2505,5186728.0,234579004.0,7819,346471,66.33,67.71,354290,239765733.0,2649,2023-11-14 15:00:00
996,DSKY,179,2833,10766800.0,251412400.0,16224,371169,66.36,67.74,387393,262179200.0,3012,177,2825,10709829.0,251352344.0,16144,370980,66.34,67.75,387124,262062173.0,3002,2023-11-14 15:05:00
997,DSKY,388,2596,15321358.0,222226380.0,22984,327853,66.66,67.78,350837,237547739.0,2984,383,2577,15266703.0,222180456.0,22905,327773,66.65,67.78,350678,237447159.0,2960,2023-11-14 15:10:00
998,DSKY,347,1548,13945980.0,127197970.0,21013,187892,66.37,67.7,208905,141143950.0,1895,347,1538,14031225.0,127220365.0,21134,187921,66.39,67.7,209055,141251590.0,1885,2023-11-14 15:15:00
999,DSKY,231,1139,6858547.0,93264910.0,10355,137799,66.23,67.68,148154,100123457.0,1370,221,1130,6735584.0,93138326.0,10173,137610,66.21,67.68,147783,99873910.0,1351,2023-11-14 15:20:00
1000,DSKY,193,1202,12168476.0,90380746.0,18371,133500,66.24,67.7,151871,102549222.0,1395,195,1203,12568327.0,90755646.0,18975,134021,66.24,67.72,152996,103323974.0,1398,2023-11-14 15:25:00
1001,DSKY,297,949,17926564.0,64837027.0,27048,95705,66.28,67.75,122753,82763592.0,1246,289,934,17467713.0,64506495.0,26347,95214,66.3,67.75,121561,81974208.0,1223,2023-11-14 15:30:00
1002,DSKY,381,1438,30605666.0,122967506.0,46198,181621,66.25,67.71,227819,153573172.0,1819,377,1425,30604457.0,122962259.0,46201,181604,66.24,67.71,227805,153566716.0,1802,2023-11-14 15:35:00
1003,DSKY,378,1462,27876094.0,115006004.0,42071,169796,66.26,67.73,211867,142882099.0,1840,375,1438,27794790.0,114917541.0,41945,169655,66.26,67.74,211600,142712331.0,1813,2023-11-14 15:40:00
1004,DSKY,395,1283,32149320.0,95868429.0,48528,141604,66.25,67.7,190132,128017749.0,1678,392,1271,32212679.0,95834660.0,48633,141535,66.24,67.71,190168,128047340.0,1663,2023-11-14 15:45:00
1005,DSKY,101,160,8070529.0,7505082.0,12193,11117,66.19,67.51,23310,15575612.0,261,99,158,7761175.0,7491601.0,11721,11096,66.22,67.52,22817,15252777.0,257,2023-11-14 15:50:00
1006,DSKY,345,838,13552917.0,70207905.0,20324,103626,66.68,67.75,123950,83760822.0,1183,334,827,13426122.0,69960689.0,20151,103260,66.63,67.75,123411,83386811.0,1161,2023-11-14 15:55:00
1007,DSKY,468,1434,27600526.0,133001292.0,41485,196002,66.53,67.86,237487,160601818.0,1902,466,1424,27535961.0,131799808.0,41380,185431,66.54,71.08,226811,159335770.0,1890,2023-11-14 16:00:00
1008,DSKY,639,2110,37864524.0,188632482.0,56782,278461,66.68,67.74,335243,226497006.0,2749,636,2106,37979024.0,188616756.0,56951,278440,66.69,67.74,335391,226595780.0,2742,2023-11-14 16:05:00
1009,DSKY,899,4089,53548319.0,362855446.0,80023,535644,66.92,67.74,615667,416403765.0,4988,895,4082,53538113.0,362840015.0,80014,535621,66.91,67.74,615635,416378128.0,4977,2023-11-14 16:10:00
1010,DSKY,1123,4081,68307622.0,361369983.0,101968,533476,66.99,67.74,635444,429677606.0,5204,1122,4081,68266143.0,361567180.0,101913,533765,66.98,67.74,635678,429833323.0,5203,2023-11-14 16:15:00
1011,DSKY,920,3071,58746051.0,262229722.0,87544,386993,67.1,67.76,474537,320975774.0,3991,920,3059,58904201.0,262017934.0,87777,386670,67.11,67.76,474447,320922136.0,3979,2023-11-14 16:20:00
1012,DSKY,289,1843,15558587.0,165810450.0,23265,244854,66.88,67.72,268119,181369037.0,2132,290,1839,15715645.0,165813766.0,23503,244840,66.87,67.72,268343,181529411.0,2129,2023-11-14 16:25:00
1013,DSKY,419,2658,20162191.0,235492912.0,29270,347765,68.88,67.72,377035,255655104.0,3077,414,2656,19471051.0,235606004.0,29118,347934,66.87,67.72,377052,255077056.0,3070,2023-11-14 16:30:00
1014,DSKY,448,2946,21401029.0,261503202.0,31968,386292,66.95,67.7,418260,282904232.0,3394,449,2935,21073438.0,261235261.0,31469,385783,66.97,67.72,417252,282308700.0,3384,2023-11-14 16:35:00
1015,DSKY,165,1785,4558352.0,151302943.0,6826,223532,66.78,67.69,230358,155861295.0,1950,164,1774,4563106.0,151264233.0,6833,223472,66.78,67.69,230305,155827339.0,1938,2023-11-14 16:40:00
1016,DSKY,1020,3680,68374289.0,301815355.0,101978,445411,67.05,67.76,547389,370189644.0,4700,1011,3671,68216518.0,301776168.0,101802,445349,67.01,67.76,547151,369992687.0,4682,2023-11-14 16:45:00
1017,DSKY,1036,3902,66341771.0,352017087.0,98922,519530,67.06,67.76,618452,418358858.0,4938,1031,3896,66588600.0,351999128.0,98901,519489,67.33,67.76,618390,418587729.0,4927,2023-11-14 16:50:00
1018,DSKY,2000,4009,180849777.0,344389233.0,270494,508071,66.86,67.78,778565,525239010.0,6009,1993,4003,180241310.0,344171686.0,269582,507750,66.86,67.78,777332,524412997.0,5996,2023-11-14 16:55:00
1019,DSKY,1592,3487,124041144.0,303239714.0,185265,447550,66.95,67.76,632815,427280858.0,5079,1588,3478,124037410.0,303235296.0,185246,447541,66.96,67.76,632787,427272707.0,5066,2023-11-14 17:00:00
1020,DSKY,701,2206,36555284.0,188066471.0,54449,277646,67.14,67.74,332095,224621756.0,2907,700,2205,36552545.0,188131257.0,54445,277742,67.14,67.74,332187,224683802.0,2905,2023-11-14 17:05:00
1021,DSKY,1137,2875,81411883.0,247293335.0,121952,365125,66.76,67.73,487077,328705218.0,4012,1134,2872,81414440.0,247165842.0,121945,364938,66.76,67.73,486883,328580282.0,4006,2023-11-14 17:10:00
1022,DSKY,369,1082,62814779.0,92280957.0,95266,136220,65.94,67.74,231486,155095737.0,1451,371,1080,63162179.0,92270409.0,95783,136206,65.94,67.74,231989,155432588.0,1451,2023-11-14 17:15:00
1023,DSKY,514,3092,37280123.0,250558254.0,55959,370041,66.62,67.71,426000,287838377.0,3606,506,3076,36843624.0,250682487.0,55310,370175,66.61,67.72,425485,287526111.0,3582,2023-11-14 17:20:00
1024,DSKY,100,2766,6584684.0,208149043.0,9990,307261,65.91,67.74,317251,214733728.0,2866,95,2759,6577714.0,207905601.0,9965,306960,66.01,67.73,316925,214483316.0,2854,2023-11-14 17:25:00
1025,DSKY,90,3860,202286.0,312383499.0,302,461173,66.98,67.74,461475,312585785.0,3950,87,3856,1158256.0,312206624.0,845,460913,137.07,67.74,461758,313364881.0,3943,2023-11-14 17:30:00
1026,DSKY,38,2147,279813.0,179640550.0,424,265264,65.99,67.72,265688,179920364.0,2185,33,2143,229852.0,179593141.0,349,265188,65.86,67.72,265537,179822994.0,2176,2023-11-14 17:35:00
1027,DSKY,18,2420,77438.0,199037898.0,116,293995,66.76,67.7,294111,199115337.0,2438,17,2420,84891.0,199038631.0,127,293995,66.84,67.7,294122,199123523.0,2437,2023-11-14 17:40:00
1028,DSKY,1,526,670.0,43030411.0,1,63566,67.0,67.69,63567,43031081.0,527,0,524,0.0,43004898.0,0,63527,,67.7,63527,43004898.0,524,2023-11-14 17:45:00
1029,DSKY,18,1813,2681698.0,150588028.0,4059,222461,66.07,67.69,226520,153269727.0,1831,12,1810,2325539.0,150550063.0,3526,222388,65.95,67.7,225914,152875602.0,1822,2023-11-14 17:50:00
1030,DSKY,143,4408,9339590.0,371698264.0,13955,549013,66.93,67.7,562968,381037854.0,4551,143,4404,9340424.0,371654791.0,13955,548949,66.93,67.7,562904,380995215.0,4547,2023-11-14 17:55:00
1031,DSKY,14,2455,145297.0,208124876.0,217,307487,66.96,67.69,307704,208270174.0,2469,12,2449,118178.0,208117649.0,177,307479,66.77,67.69,307656,208235827.0,2461,2023-11-14 18:00:00
1032,DSKY,163,3425,12390138.0,280461282.0,18663,414260,66.39,67.7,432923,292851421.0,3588,157,3420,12356957.0,280471878.0,18614,414272,66.39,67.7,432886,292828835.0,3577,2023-11-14 18:05:00
1033,DSKY,177,2583,7488271.0,224554712.0,11227,331548,66.7,67.73,342775,232042983.0,2760,176,2579,7804335.0,224548555.0,11699,331533,66.71,67.73,343232,232352891.0,2755,2023-11-14 18:10:00
1034,DSKY,238,2888,9432697.0,246706111.0,14054,364257,67.12,67.73,378311,256138809.0,3126,231,2880,9285257.0,246726649.0,13839,364286,67.09,67.73,378125,256011907.0,3111,2023-11-14 18:15:00
1035,DSKY,394,2637,32678651.0,222999093.0,46787,329261,69.85,67.73,376048,255677745.0,3031,381,2630,30345119.0,223052683.0,45547,329342,66.62,67.73,374889,253397802.0,3011,2023-11-14 18:20:00
1036,DSKY,137,3516,1728620.0,296641048.0,2575,437931,67.13,67.74,440506,298369668.0,3653,137,3513,1917085.0,296463737.0,2563,437611,74.8,67.75,440174,298380822.0,3650,2023-11-14 18:25:00
1037,DSKY,15,1628,36948.0,131386013.0,55,193921,67.18,67.75,193976,131422961.0,1643,12,1622,28209.0,131387082.0,42,193922,67.17,67.75,193964,131415292.0,1634,2023-11-14 18:30:00
1038,DSKY,9,2104,137728.0,179972771.0,208,265612,66.22,67.76,265820,180110500.0,2113,9,2102,245450.0,179821433.0,272,265402,90.24,67.75,265674,180066884.0,2111,2023-11-14 18:35:00
1039,DSKY,188,2506,2525218.0,214414492.0,3762,316471,67.12,67.75,320233,216939710.0,2694,186,2504,3462006.0,214755926.0,5165,316955,67.03,67.76,322120,218217932.0,2690,2023-11-14 18:40:00
1040,DSKY,636,1605,7014544.0,7014544.0,101287,99598,6.93,7.92,200885,14905860.0,2241,580,1422,6862937.0,6862937.0,98701,70447,6.95,6.99,169148,11790648.0,2002,2023-11-29 10:05:00
1041,DSKY,801,1890,11366007.0,11366007.0,163797,78668,6.94,6.99,242465,16867448.0,2691,789,1873,11308271.0,11308271.0,162925,78506,6.94,7.0,241431,16800959.0,2662,2023-11-29 10:10:00
1042,DSKY,154,1284,1869289.0,1869289.0,26881,53419,6.95,6.99,80300,5603965.0,1438,152,1269,1878403.0,1878403.0,27012,52997,6.95,6.99,80009,5582694.0,1421,2023-11-29 10:15:00
1043,DSKY,201,1271,3127956.0,3127956.0,44987,87862,6.95,6.99,132849,9273157.0,1472,192,1260,3097423.0,3097423.0,44528,87410,6.96,6.99,131938,9211030.0,1452,2023-11-29 10:20:00
1044,DSKY,14,522,27068.0,27068.0,400,46759,6.77,6.99,47159,3297102.0,536,12,514,55343.0,55343.0,804,46740,6.88,6.99,47544,3324368.0,526,2023-11-29 10:25:00
1045,DSKY,8,158,93631.0,93631.0,1363,14394,6.87,7.19,15757,1127866.0,166,7,127,81630.0,81630.0,1191,12352,6.85,7.0,13543,945684.0,134,2023-11-29 10:30:00
1046,DSKY,8,670,17971.0,17971.0,258,65929,6.97,7.06,66187,4669467.0,678,5,650,14493.0,14493.0,208,62995,6.97,6.99,63203,4420107.0,655,2023-11-29 10:35:00
1047,DSKY,17,800,25081.0,25081.0,361,93247,6.95,6.99,93608,6539914.0,817,12,791,16269.0,16269.0,234,93375,6.95,6.99,93609,6545871.0,803,2023-11-29 10:40:00
1048,DSKY,6,581,2073.0,2073.0,30,85471,6.91,6.99,85501,5980075.0,587,6,573,2073.0,2073.0,30,85009,6.91,6.99,85039,5947452.0,579,2023-11-29 10:45:00
1049,DSKY,19,403,17709.0,17709.0,270,58743,6.56,7.0,59013,4130471.0,422,16,392,14133.0,14133.0,204,58323,6.93,7.01,58527,4099952.0,408,2023-11-29 10:50:00
1050,DSKY,10,1314,34060.0,34060.0,738,166757,4.62,7.0,167495,11699094.0,1324,8,1307,2624.0,2624.0,38,166404,6.91,7.0,166442,11644677.0,1315,2023-11-29 10:55:00
1051,DSKY,12,1096,30340.0,30340.0,686,158138,4.42,7.01,158824,11118791.0,1108,9,1083,13256.0,13256.0,191,157656,6.94,7.01,157847,11068916.0,1092,2023-11-29 11:00:00
1052,DSKY,23,657,208310.0,208310.0,3022,85549,6.89,6.99,88571,6187526.0,680,21,656,177467.0,177467.0,2580,85543,6.88,6.99,88123,6159155.0,677,2023-11-29 11:05:00
1053,DSKY,16,491,32940.0,32940.0,474,64874,6.95,6.99,65348,4566273.0,507,13,482,19547.0,19547.0,281,64750,6.96,6.99,65031,4546241.0,495,2023-11-29 11:10:00
1054,DSKY,5,790,404.0,404.0,6,96202,6.74,6.99,96208,6726058.0,795,4,786,683.0,683.0,10,96129,6.84,6.99,96139,6721164.0,790,2023-11-29 11:15:00
1055,DSKY,15,800,33850.0,33850.0,486,90120,6.97,6.99,90606,6333978.0,815,13,794,44598.0,44598.0,641,89992,6.96,6.99,90633,6335902.0,807,2023-11-29 11:20:00
1056,DSKY,6,761,23902.0,23902.0,349,95234,6.85,6.99,95583,6685479.0,767,5,753,9602.0,9602.0,138,95138,6.96,6.99,95276,6664492.0,758,2023-11-29 11:25:00
1057,DSKY,10,108,16331.0,16331.0,237,11021,6.89,7.02,11258,790457.0,118,9,93,32553.0,32553.0,469,10037,6.94,6.99,10506,734409.0,102,2023-11-29 11:30:00
1058,DSKY,21,22,49226.0,49226.0,708,478,6.95,7.01,1186,82728.0,43,19,14,49159.0,49159.0,706,423,6.96,7.0,1129,78757.0,33,2023-11-29 11:35:00
1059,DSKY,28,31,99223.0,99223.0,1428,1689,6.95,6.99,3117,217357.0,59,25,27,77990.0,77990.0,1129,1916,6.91,7.02,3045,212433.0,52,2023-11-29 11:40:00
1060,DSKY,8,27,19855.0,19855.0,286,1120,6.94,5.62,1406,82765.0,35,7,19,7779.0,7779.0,112,836,6.95,6.99,948,66223.0,26,2023-11-29 11:45:00
1061,DSKY,30,254,149843.0,149843.0,2218,31949,6.76,6.98,34167,2380866.0,284,28,244,172831.0,172831.0,2507,31886,6.89,6.99,34393,2400516.0,272,2023-11-29 11:50:00
1062,DSKY,7,61,12943.0,12943.0,187,2955,6.92,6.99,3142,219592.0,68,2,58,132.0,132.0,2,2948,6.61,6.99,2950,206283.0,60,2023-11-29 11:55:00
1063,DSKY,20,551,84815.0,84815.0,1253,49779,6.77,6.99,51032,3563203.0,571,19,549,84532.0,84532.0,1249,49740,6.77,6.99,50989,3560079.0,568,2023-11-29 12:00:00
1064,DSKY,5,56,20832.0,20832.0,308,3280,6.76,7.0,3588,250342.0,61,5,53,20415.0,20415.0,302,3337,6.76,7.0,3639,253945.0,58,2023-11-29 12:05:00
1065,DSKY,19,50,40205.0,40205.0,590,3715,6.81,7.0,4305,300273.0,69,18,48,39369.0,39369.0,578,3774,6.81,7.0,4352,303460.0,66,2023-11-29 12:10:00
1066,DSKY,7,20,14852.0,14852.0,214,641,6.94,6.98,855,59609.0,27,6,15,2562.0,2562.0,37,661,6.93,7.01,698,48893.0,21,2023-11-29 12:15:00
1067,DSKY,9,34,2560.0,2560.0,37,1684,6.92,6.91,1721,118977.0,43,9,30,2351.0,2351.0,34,1501,6.92,7.0,1535,107396.0,39,2023-11-29 12:20:00
1068,DSKY,6,47,11245.0,11245.0,162,2546,6.94,6.94,2708,187933.0,53,7,36,11700.0,11700.0,169,2477,6.92,6.99,2646,184962.0,43,2023-11-29 12:25:00
1069,DSKY,7,41,1588.0,1588.0,23,2209,6.91,6.98,2232,155747.0,48,7,39,1170.0,1170.0,17,2225,6.89,6.99,2242,156741.0,46,2023-11-29 12:30:00
1070,DSKY,14,24,352361.0,352361.0,5070,1107,6.95,6.96,6177,429452.0,38,12,23,169613.0,169613.0,2444,1046,6.94,6.99,3490,242695.0,35,2023-11-29 12:35:00
1071,DSKY,14,37,7221.0,7221.0,113,2663,6.39,6.97,2776,192911.0,51,9,40,2560.0,2560.0,37,2910,6.92,7.0,2947,206150.0,49,2023-11-29 12:40:00
1072,DSKY,10,17,20403.0,20403.0,301,635,6.78,6.88,936,64089.0,27,9,9,17548.0,17548.0,255,619,6.88,6.99,874,60823.0,18,2023-11-29 12:45:00
1073,DSKY,23,29,53871.0,53871.0,774,2230,6.96,6.98,3004,209495.0,52,22,27,53407.0,53407.0,768,2296,6.95,7.0,3064,214021.0,49,2023-11-29 12:50:00
1074,DSKY,32,29,109811.0,109811.0,1590,2392,6.91,7.0,3982,277192.0,61,28,28,99058.0,99058.0,1431,2413,6.92,7.0,3844,267930.0,56,2023-11-29 12:55:00
1075,DSKY,14,14,67047.0,67047.0,985,712,6.81,7.03,1697,117096.0,28,12,8,66800.0,66800.0,981,601,6.81,7.04,1582,109105.0,20,2023-11-29 13:00:00
1076,DSKY,8,17,2623.0,2623.0,38,1032,6.9,6.98,1070,74688.0,25,8,14,2623.0,2623.0,38,1058,6.9,6.99,1096,76575.0,22,2023-11-29 13:05:00
1077,DSKY,541,254,3895080.0,3895080.0,56409,18655,6.91,7.01,75064,5203087.0,795,494,193,3662744.0,3662744.0,52546,16308,6.97,7.04,68854,4810238.0,687,2023-11-29 13:10:00
1078,DSKY,953,303,8149837.0,8149837.0,116877,22181,6.97,7.01,139058,9705802.0,1256,934,248,8119072.0,8119072.0,116317,20087,6.98,7.04,136404,9532541.0,1182,2023-11-29 13:15:00
1079,DSKY,55,2044,529819.0,529819.0,7683,248133,6.9,7.01,255816,17919941.0,2099,44,2017,411578.0,411578.0,5975,247168,6.89,7.01,253143,17736275.0,2061,2023-11-29 13:20:00
1080,DSKY,14,951,10093.0,10093.0,148,97875,6.82,7.02,98023,6883446.0,965,7,943,6401.0,6401.0,92,97731,6.96,7.02,97823,6869732.0,950,2023-11-29 13:25:00
1081,DSKY,5,1452,3198.0,3198.0,47,145601,6.81,7.01,145648,10204371.0,1457,3,1444,110915.0,110915.0,1602,145448,6.92,7.01,147050,10299566.0,1447,2023-11-29 13:30:00
1082,DSKY,16,949,18389.0,18389.0,264,104795,6.97,7.01,105059,7361268.0,965,13,942,17134.0,17134.0,246,104712,6.97,7.01,104958,7354279.0,955,2023-11-29 13:35:00
1083,DSKY,8,1022,7298.0,7298.0,105,111528,6.95,7.03,111633,7852683.0,1030,7,1016,4932.0,4932.0,71,111502,6.95,7.03,111573,7848353.0,1023,2023-11-29 13:40:00
1084,DSKY,10,943,29071.0,29071.0,428,129982,6.79,7.02,130410,9150239.0,953,7,937,9206.0,9206.0,133,129702,6.92,7.02,129835,9110861.0,944,2023-11-29 13:45:00
1085,DSKY,14,398,18093.0,18093.0,261,62298,6.93,7.01,62559,4386337.0,412,13,395,17120.0,17120.0,246,62134,6.96,7.01,62380,4369700.0,408,2023-11-29 13:50:00
1086,DSKY,14,1177,34042.0,34042.0,490,158736,6.95,7.0,159226,11153369.0,1191,15,1173,49385.0,49385.0,719,158906,6.87,7.01,159625,11180923.0,1188,2023-11-29 13:55:00
1087,DSKY,14,780,85994.0,85994.0,1255,82123,6.85,6.99,83378,5829732.0,794,7,774,63573.0,63573.0,923,81553,6.89,7.0,82476,5770979.0,781,2023-11-29 14:00:00
1088,DSKY,10,268,66064.0,66064.0,959,27286,6.89,7.0,28245,1976169.0,278,11,262,85361.0,85361.0,1246,27552,6.85,7.0,28798,2014227.0,273,2023-11-29 14:05:00
1089,DSKY,9,16,4293.0,4293.0,62,284,6.93,7.02,346,24234.0,25,8,13,2207.0,2207.0,32,169,6.9,7.0,201,14036.0,21,2023-11-29 14:10:00
1090,DSKY,8,19,2497.0,2497.0,36,383,6.94,7.31,419,30497.0,27,7,8,1310.0,1310.0,19,177,6.9,7.0,196,13694.0,15,2023-11-29 14:15:00
1091,DSKY,8,12,1659.0,1659.0,24,468,6.91,6.86,492,33750.0,20,3,10,616.0,616.0,9,433,6.85,6.99,442,30902.0,13,2023-11-29 14:20:00
1092,DSKY,13,1420,37201.0,37201.0,545,214116,6.83,7.0,214661,15024639.0,1433,13,1419,33235.0,33235.0,487,214109,6.82,7.0,214596,15020536.0,1432,2023-11-29 14:25:00
1093,DSKY,9,370,2947.0,2947.0,43,78830,6.85,7.02,78873,5537688.0,379,6,365,2072.0,2072.0,30,78756,6.91,7.02,78786,5531890.0,371,2023-11-29 14:30:00
1094,DSKY,11,254,21318.0,21318.0,315,58430,6.77,7.03,58745,4131716.0,265,7,245,1310.0,1310.0,19,58101,6.9,7.03,58120,4088426.0,252,2023-11-29 14:35:00
1095,DSKY,6,438,1656.0,1656.0,24,93564,6.9,7.02,93588,6571483.0,444,7,434,20898.0,20898.0,309,93726,6.76,7.02,94035,6603902.0,441,2023-11-29 14:40:00
1096,DSKY,12,188,21451.0,21451.0,319,40519,6.72,7.03,40838,2868451.0,200,7,182,21030.0,21030.0,311,40469,6.76,7.03,40780,2864789.0,189,2023-11-29 14:45:00
1097,DSKY,20147,19951,390298027.0,390298027.0,5780480,5686615,6.75,6.99,11467095,787550810.0,40098,20145,19946,390298113.0,390298113.0,5780482,5686596,6.75,6.99,11467078,787549544.0,40091,2023-11-29 14:50:00
1098,DSKY,20744,20428,401712928.0,401712928.0,5949531,5827182,6.75,6.98,11776713,808497609.0,41172,20739,20421,401700078.0,401700078.0,5949339,5826832,6.75,6.98,11776171,808460328.0,41160,2023-11-29 14:55:00
1099,DSKY,13,23,27563.0,27563.0,396,1163,6.96,6.99,1559,108853.0,36,12,21,43247.0,43247.0,630,1424,6.86,7.0,2054,142888.0,33,2023-11-29 15:00:00
1100,DSKY,13,19,34464.0,34464.0,504,602,6.84,6.19,1106,71717.0,32,11,13,16130.0,16130.0,232,197,6.95,6.99,429,29896.0,24,2023-11-29 15:05:00
1101,DSKY,19,46,41662.0,41662.0,599,3760,6.96,7.0,4359,304717.0,65,19,42,41107.0,41107.0,591,3624,6.96,7.02,4215,295519.0,61,2023-11-29 15:10:00
1102,DSKY,29,34,64711.0,64711.0,932,2646,6.94,7.01,3578,250315.0,63,25,31,80601.0,80601.0,1167,2864,6.91,7.04,4031,282139.0,56,2023-11-29 15:15:00
1103,DSKY,12,15,10287.0,10287.0,149,151,6.9,6.3,300,19802.0,27,7,7,10984.0,10984.0,158,61,6.95,7.0,219,15251.0,14,2023-11-29 15:20:00
1104,DSKY,11,26,38184.0,38184.0,558,2441,6.84,7.01,2999,209319.0,37,10,23,31369.0,31369.0,460,2426,6.82,7.01,2886,201519.0,33,2023-11-29 15:25:00
1105,DSKY,29,32,68020.0,68020.0,992,926,6.86,6.77,1918,130676.0,61,15,27,44532.0,44532.0,640,933,6.96,6.99,1573,109756.0,42,2023-11-29 15:30:00
1106,DSKY,25,14,62816.0,62816.0,903,318,6.96,6.91,1221,84804.0,39,23,8,64970.0,64970.0,933,306,6.96,7.0,1239,86387.0,31,2023-11-29 15:35:00
1107,DSKY,14,16,40884.0,40884.0,587,481,6.96,6.99,1068,74506.0,30,16,16,42554.0,42554.0,611,464,6.96,7.0,1075,75018.0,32,2023-11-29 15:40:00
1108,DSKY,6,20,14339.0,14339.0,206,1606,6.96,6.99,1812,126570.0,26,5,19,11693.0,11693.0,168,1626,6.96,6.99,1794,125341.0,24,2023-11-29 15:45:00
1109,DSKY,27,27,84137.0,84137.0,1208,1678,6.97,7.11,2886,203466.0,54,25,24,85939.0,85939.0,1234,1587,6.96,6.99,2821,196844.0,49,2023-11-29 15:50:00
1110,DSKY,264,26,4638503.0,4638503.0,68675,320,6.75,6.96,68995,4660789.0,290,258,17,4644679.0,4644679.0,68749,186,6.76,6.99,68935,4657672.0,275,2023-11-29 15:55:00
1111,DSKY,18,16,45355.0,45355.0,683,295,6.64,6.97,978,65929.0,34,11,11,48476.0,48476.0,705,270,6.88,7.03,975,67465.0,22,2023-11-29 16:00:00
1112,DSKY,18,16,46262.0,46262.0,674,415,6.86,7.06,1089,75566.0,34,11,10,28482.0,28482.0,409,130,6.96,6.99,539,37573.0,21,2023-11-29 16:05:00
1113,DSKY,27,42,67288.0,67288.0,968,1681,6.95,7.01,2649,185147.0,69,21,34,85502.0,85502.0,1237,1805,6.91,7.01,3042,212058.0,55,2023-11-29 16:10:00
1114,DSKY,20,18,39755.0,39755.0,603,403,6.59,7.03,1006,68088.0,38,17,12,39126.0,39126.0,562,352,6.96,6.99,914,63738.0,29,2023-11-29 16:15:00
1115,DSKY,14,18,37392.0,37392.0,537,1894,6.96,7.06,2431,171197.0,32,14,15,35301.0,35301.0,507,997,6.96,6.99,1504,104999.0,29,2023-11-29 16:20:00
1116,DSKY,20,27,64417.0,64417.0,927,637,6.95,6.98,1564,108872.0,47,18,21,66832.0,66832.0,961,476,6.95,6.99,1437,100098.0,39,2023-11-29 16:25:00
1117,DSKY,15,13,37210.0,37210.0,543,165,6.85,6.95,708,48675.0,28,15,10,97188.0,97188.0,1406,160,6.91,6.99,1566,108372.0,25,2023-11-29 16:30:00
1118,DSKY,19,31,115602.0,115602.0,1687,2104,6.85,6.98,3791,262447.0,50,14,28,56660.0,56660.0,814,2089,6.96,6.99,2903,202620.0,42,2023-11-29 16:35:00
1119,DSKY,17,27,49604.0,49604.0,713,1863,6.96,6.99,2576,179807.0,44,16,24,48562.0,48562.0,698,1813,6.96,6.99,2511,175262.0,40,2023-11-29 16:40:00
1120,DSKY,28,22,97112.0,97112.0,1396,1969,6.96,6.99,3365,234664.0,50,27,18,97670.0,97670.0,1404,1962,6.96,6.99,3366,234769.0,45,2023-11-29 16:45:00
1121,DSKY,12,31,16823.0,16823.0,242,1630,6.95,6.77,1872,127214.0,43,11,29,16752.0,16752.0,241,1569,6.95,6.98,1810,126340.0,40,2023-11-29 16:50:00
1122,DSKY,19,15,78578.0,78578.0,1129,492,6.96,6.98,1621,112910.0,34,19,13,78572.0,78572.0,1129,490,6.96,6.99,1619,112829.0,32,2023-11-29 16:55:00
1123,DSKY,18,34,52341.0,52341.0,753,1402,6.95,6.98,2155,150157.0,52,18,33,52278.0,52278.0,752,1421,6.95,6.99,2173,151586.0,51,2023-11-29 17:00:00
1124,DSKY,18,33,37069.0,37069.0,535,2430,6.93,6.64,2965,198473.0,51,17,28,33870.0,33870.0,488,2266,6.94,6.99,2754,192209.0,45,2023-11-29 17:05:00
1125,DSKY,6,55,16690.0,16690.0,240,5031,6.95,6.97,5271,367375.0,61,7,52,20446.0,20446.0,294,5022,6.95,6.98,5316,371195.0,59,2023-11-29 17:10:00
1126,DSKY,4,15,3677.0,3677.0,53,1208,6.94,7.0,1261,88263.0,19,4,10,3606.0,3606.0,52,953,6.94,6.99,1005,70183.0,14,2023-11-29 17:15:00
1127,DSKY,25,59,583125.0,583125.0,8600,5927,6.78,6.97,14527,996156.0,84,23,55,563355.0,563355.0,8311,5509,6.78,6.99,13820,948321.0,78,2023-11-29 17:20:00
1128,DSKY,14,41,71063.0,71063.0,1036,3330,6.86,6.96,4366,302924.0,55,13,31,66818.0,66818.0,960,3287,6.96,6.99,4247,296454.0,44,2023-11-29 17:25:00
1129,DSKY,22,20,85977.0,85977.0,1238,568,6.94,6.88,1806,125040.0,42,21,18,108502.0,108502.0,1568,841,6.92,6.98,2409,167219.0,39,2023-11-29 17:30:00
1130,DSKY,29,41,162263.0,162263.0,2341,4896,6.93,6.99,7237,504290.0,70,28,37,137178.0,137178.0,1972,4402,6.96,6.99,6374,444796.0,65,2023-11-29 17:35:00
1131,DSKY,20,30,95729.0,95729.0,1375,2361,6.96,6.97,3736,260240.0,50,19,25,98162.0,98162.0,1410,2342,6.96,6.99,3752,261818.0,44,2023-11-29 17:40:00
1132,DSKY,12,13,41158.0,41158.0,591,21,6.96,5.33,612,42278.0,25,12,10,44082.0,44082.0,633,45,6.96,6.99,678,47227.0,22,2023-11-29 17:45:00
1133,DSKY,9,32,26109.0,26109.0,385,1719,6.78,6.98,2104,146083.0,41,7,28,24090.0,24090.0,346,1699,6.96,6.99,2045,142825.0,35,2023-11-29 17:50:00
1134,DSKY,3,5,9318.0,9318.0,134,23,6.95,6.97,157,10921.0,8,3,3,5284.0,5284.0,76,18,6.95,6.99,94,6542.0,6,2023-11-29 17:55:00
1135,DSKY,2,18,131.0,131.0,2,318,6.57,6.93,320,22181.0,20,2,16,131.0,131.0,2,308,6.57,6.98,310,21623.0,18,2023-11-29 18:00:00
1136,DSKY,33,252,208843.0,208843.0,3036,25214,6.88,6.99,28250,1971339.0,285,33,250,214550.0,214550.0,3118,25194,6.88,6.99,28312,1975728.0,283,2023-11-29 18:05:00
1137,DSKY,27,39,246664.0,246664.0,3613,5311,6.83,7.0,8924,618511.0,66,28,38,247219.0,247219.0,3621,5290,6.83,7.0,8911,617583.0,66,2023-11-29 18:10:00
1138,DSKY,25,37,176446.0,176446.0,2544,2234,6.94,6.4,4778,319448.0,62,24,36,86895.0,86895.0,1266,2322,6.86,6.98,3588,249076.0,60,2023-11-29 18:15:00
1139,DSKY,11,14,111699.0,111699.0,1606,780,6.96,6.98,2386,166157.0,25,11,11,110718.0,110718.0,1591,757,6.96,6.99,2348,163610.0,22,2023-11-29 18:20:00
1140,DSKY,17,47,16800.0,16800.0,242,5250,6.94,6.99,5492,383883.0,64,16,45,17988.0,17988.0,259,5503,6.95,7.0,5762,403177.0,61,2023-11-29 18:25:00
1141,DSKY,22,12,94044.0,94044.0,1366,948,6.88,6.95,2314,159926.0,34,19,9,90658.0,90658.0,1325,942,6.84,6.98,2267,156410.0,28,2023-11-29 18:30:00
1142,DSKY,14,45,192061.0,192061.0,2783,4587,6.9,6.98,7370,512211.0,59,14,45,188214.0,188214.0,2719,4587,6.92,6.98,7306,508353.0,59,2023-11-29 18:35:00
1143,DSKY,11,60,11780.0,11780.0,171,6710,6.89,6.98,6881,480115.0,71,12,56,72246.0,72246.0,1061,6694,6.81,6.98,7755,539612.0,68,2023-11-29 18:40:00
1144,DSKY,79,3101,364439.0,364439.0,5598,316619,6.51,7.02,322217,22580879.0,3180,22,2913,218595.0,218595.0,3178,310997,6.88,6.99,314175,21952229.0,2935,2023-11-30 10:05:00
1145,DSKY,21,2818,69374.0,69374.0,1099,294845,6.31,6.99,295944,20669079.0,2839,15,2807,47522.0,47522.0,696,293335,6.83,6.99,294031,20541144.0,2822,2023-11-30 10:10:00
1146,DSKY,11,1384,23286.0,23286.0,347,141546,6.71,6.98,141893,9905825.0,1395,7,1365,33866.0,33866.0,493,137648,6.87,6.98,138141,9640953.0,1372,2023-11-30 10:15:00
1147,DSKY,36,514,226873.0,226873.0,3312,86900,6.85,7.93,90212,7118808.0,550,31,497,190692.0,190692.0,2778,62706,6.86,6.97,65484,4562274.0,528,2023-11-30 10:20:00
1148,DSKY,26,133,331053.0,331053.0,4809,14644,6.88,7.48,19453,1426190.0,159,22,97,322759.0,322759.0,4700,9314,6.87,6.97,14014,972260.0,119,2023-11-30 10:25:00
1149,DSKY,6,19,7508.0,7508.0,112,793,6.7,7.03,905,63241.0,25,6,13,1864.0,1864.0,27,694,6.91,6.99,721,50370.0,19,2023-11-30 10:30:00
1150,DSKY,8,48,76425.0,76425.0,1117,3721,6.84,6.98,4838,336133.0,56,7,36,49482.0,49482.0,730,3130,6.78,6.98,3860,267840.0,43,2023-11-30 10:35:00
1151,DSKY,8,14,749.0,749.0,11,121,6.81,6.27,132,8334.0,22,4,5,5716.0,5716.0,83,5,6.89,6.99,88,6065.0,9,2023-11-30 10:40:00
1152,DSKY,43,1049,510008.0,510008.0,7380,153780,6.91,6.99,161160,11257086.0,1092,23,1032,301744.0,301744.0,4400,152976,6.86,6.99,157376,10992775.0,1055,2023-11-30 10:45:00
1153,DSKY,103,846,236622.0,236622.0,3419,115859,6.92,6.99,119278,8333967.0,949,102,845,240082.0,240082.0,3462,115902,6.93,6.99,119364,8340168.0,947,2023-11-30 10:50:00
1154,DSKY,79,645,147768.0,147768.0,2664,85543,5.55,6.99,88207,6130302.0,724,75,630,109677.0,109677.0,1575,85623,6.96,7.0,87198,6104420.0,705,2023-11-30 10:55:00
1155,DSKY,187,954,307563.0,307563.0,4416,117149,6.96,6.99,121565,8497143.0,1141,187,932,306176.0,306176.0,4396,116770,6.96,6.99,121166,8466692.0,1119,2023-11-30 11:00:00
1156,DSKY,78,1827,210509.0,210509.0,3052,237027,6.9,6.99,240079,16772678.0,1905,71,1820,212495.0,212495.0,3073,236796,6.91,6.99,239869,16758799.0,1891,2023-11-30 11:05:00
1157,DSKY,22,208,16553.0,16553.0,242,22766,6.84,6.99,23008,1607335.0,230,15,201,15927.0,15927.0,230,22726,6.92,6.99,22956,1604103.0,216,2023-11-30 11:10:00
1158,DSKY,29,95,29328.0,29328.0,427,8403,6.87,6.94,8830,612610.0,124,23,87,28218.0,28218.0,408,8272,6.92,6.99,8680,606308.0,110,2023-11-30 11:15:00
1159,DSKY,18,104,64959.0,64959.0,954,10527,6.81,6.99,11481,800555.0,122,15,99,63522.0,63522.0,931,10513,6.82,7.0,11444,799122.0,114,2023-11-30 11:20:00
1160,DSKY,5,31,11875.0,11875.0,204,2496,5.82,7.08,2700,188566.0,36,5,25,342.0,342.0,5,2416,6.84,7.0,2421,169398.0,30,2023-11-30 11:25:00
1161,DSKY,37,59,128474.0,128474.0,1858,3686,6.91,6.99,5544,385968.0,96,31,51,101285.0,101285.0,1459,3322,6.94,7.0,4781,333720.0,82,2023-11-30 11:30:00
1162,DSKY,12,39,83046.0,83046.0,1197,2392,6.94,6.93,3589,248770.0,51,10,35,72361.0,72361.0,1040,2412,6.96,6.99,3452,241050.0,45,2023-11-30 11:35:00
1163,DSKY,21,47,83381.0,83381.0,1198,3769,6.96,6.98,4967,346408.0,68,16,42,86525.0,86525.0,1248,3687,6.93,6.99,4935,344250.0,58,2023-11-30 11:40:00
1164,DSKY,47,39,112513.0,112513.0,1633,1659,6.89,4.62,3292,189162.0,86,33,32,107932.0,107932.0,1572,959,6.87,6.99,2531,174999.0,65,2023-11-30 11:45:00
1165,DSKY,13,25,42969.0,42969.0,617,1726,6.96,6.99,2343,163609.0,38,9,23,14336.0,14336.0,206,1701,6.96,6.99,1907,133242.0,32,2023-11-30 11:50:00
1166,DSKY,11,18,12663.0,12663.0,344,307,3.68,6.54,651,32727.0,29,6,11,2293.0,2293.0,43,167,5.33,7.0,210,13979.0,17,2023-11-30 11:55:00
1167,DSKY,7,40,1667.0,1667.0,25,2856,6.67,7.0,2881,201529.0,47,7,32,2920.0,2920.0,42,2779,6.95,6.99,2821,197299.0,39,2023-11-30 12:00:00
1168,DSKY,15,24,10928.0,10928.0,157,1263,6.96,6.99,1420,99206.0,39,13,20,9953.0,9953.0,143,1020,6.96,7.0,1163,81333.0,33,2023-11-30 12:05:00
1169,DSKY,16,14,38211.0,38211.0,559,733,6.84,6.97,1292,89288.0,30,13,9,20487.0,20487.0,299,367,6.85,6.99,666,46137.0,22,2023-11-30 12:10:00
1170,DSKY,11,32,62109.0,62109.0,892,2162,6.96,7.01,3054,213772.0,43,9,28,15890.0,15890.0,229,2128,6.94,6.99,2357,164650.0,37,2023-11-30 12:15:00
1171,DSKY,4,30,10944.0,10944.0,162,2236,6.76,6.88,2398,164840.0,34,5,24,17925.0,17925.0,262,2173,6.84,7.0,2435,170015.0,29,2023-11-30 12:20:00
1172,DSKY,4,78,553.0,553.0,8,8859,6.91,6.96,8867,616937.0,82,2,75,134.0,134.0,2,8785,6.74,6.99,8787,614100.0,77,2023-11-30 12:25:00
1173,DSKY,5,10,13589.0,13589.0,196,672,6.93,6.99,868,60576.0,15,5,9,9145.0,9145.0,132,662,6.93,6.99,794,55419.0,14,2023-11-30 12:30:00
1174,DSKY,7,24,11061.0,11061.0,160,1395,6.91,6.74,1555,105081.0,31,8,16,13786.0,13786.0,199,1314,6.93,6.99,1513,105625.0,24,2023-11-30 12:35:00
1175,DSKY,8,38,3268.0,3268.0,47,3155,6.95,6.99,3202,223844.0,46,4,33,1178.0,1178.0,17,3091,6.93,6.99,3108,217346.0,37,2023-11-30 12:40:00
1176,DSKY,6,43,42663.0,42663.0,630,2825,6.77,6.99,3455,240225.0,49,3,33,3609.0,3609.0,52,2632,6.94,6.99,2684,187612.0,36,2023-11-30 12:45:00
1177,DSKY,8,20,6598.0,6598.0,95,1132,6.95,6.99,1227,85674.0,28,8,12,7856.0,7856.0,113,1084,6.95,6.99,1197,83673.0,20,2023-11-30 12:50:00
1178,DSKY,6,48,4872.0,4872.0,85,4541,5.73,6.99,4626,322104.0,54,4,45,3895.0,3895.0,56,4519,6.96,6.99,4575,319669.0,49,2023-11-30 12:55:00
1179,DSKY,7,20,27516.0,27516.0,395,1375,6.97,6.97,1770,123406.0,27,6,17,5845.0,5845.0,84,1392,6.96,6.99,1476,103122.0,23,2023-11-30 13:00:00
1180,DSKY,13,33,18109.0,18109.0,261,1672,6.94,6.99,1933,134974.0,46,13,27,59289.0,59289.0,870,1583,6.81,6.99,2453,169984.0,40,2023-11-30 13:05:00
1181,DSKY,26,20,28206.0,28206.0,405,946,6.96,6.95,1351,93985.0,46,25,18,27719.0,27719.0,398,990,6.96,6.99,1388,96940.0,43,2023-11-30 13:10:00
1182,DSKY,16,52,93493.0,93493.0,1377,3335,6.79,6.99,4712,326468.0,68,14,50,93631.0,93631.0,1379,3331,6.79,6.99,4710,326452.0,64,2023-11-30 13:15:00
1183,DSKY,7,43,7730.0,7730.0,111,2246,6.96,6.99,2357,164702.0,50,7,39,8427.0,8427.0,121,2160,6.96,6.99,2281,159380.0,46,2023-11-30 13:20:00
1184,DSKY,7,26,8007.0,8007.0,115,1042,6.96,7.08,1157,81776.0,33,7,20,7867.0,7867.0,113,147,6.96,6.99,260,18145.0,27,2023-11-30 13:25:00
1185,DSKY,6,18,12732.0,12732.0,183,231,6.96,5.23,414,24816.0,24,2,14,134.0,134.0,2,169,6.74,6.99,171,11945.0,16,2023-11-30 13:30:00
1186,DSKY,24,61,103641.0,103641.0,1510,7337,6.86,6.99,8847,616175.0,85,18,60,43401.0,43401.0,624,7375,6.96,6.99,7999,558808.0,78,2023-11-30 13:35:00
1187,DSKY,15,66,32877.0,32877.0,473,7318,6.95,6.98,7791,543784.0,81,17,60,72201.0,72201.0,1054,7191,6.85,6.99,8245,574767.0,77,2023-11-30 13:40:00
1188,DSKY,19,18,46336.0,46336.0,701,311,6.61,6.95,1012,67941.0,37,17,15,59433.0,59433.0,873,289,6.81,6.99,1162,79638.0,32,2023-11-30 13:45:00
1189,DSKY,8,20,16390.0,16390.0,248,1454,6.61,6.97,1702,117670.0,28,6,22,15416.0,15416.0,222,1818,6.94,6.99,2040,142550.0,28,2023-11-30 13:50:00
1190,DSKY,28,48,99702.0,99702.0,1432,4658,6.96,6.99,6090,425484.0,76,28,42,99709.0,99709.0,1432,4284,6.96,7.0,5716,399468.0,70,2023-11-30 13:55:00
1191,DSKY,5,17,7851.0,7851.0,113,114,6.95,6.94,227,15758.0,22,5,15,7853.0,7853.0,113,112,6.95,7.0,225,15692.0,20,2023-11-30 14:00:00
1192,DSKY,2,6,134.0,134.0,2,12,6.75,7.09,14,985.0,8,2,3,134.0,134.0,2,10,6.75,7.05,12,840.0,5,2023-11-30 14:05:00
1193,DSKY,30,46,296133.0,296133.0,4320,2922,6.85,6.99,7242,500398.0,76,24,41,263319.0,263319.0,3838,2898,6.86,6.99,6736,465913.0,65,2023-11-30 14:10:00
1194,DSKY,12,151,67747.0,67747.0,996,13078,6.8,6.97,14074,979725.0,163,13,148,44310.0,44310.0,639,13056,6.93,6.99,13695,956345.0,161,2023-11-30 14:15:00
1195,DSKY,9,248,52298.0,52298.0,773,24622,6.77,6.98,25395,1771892.0,257,6,244,52507.0,52507.0,776,24618,6.77,6.98,25394,1771827.0,250,2023-11-30 14:20:00
1196,DSKY,13,21,6817.0,6817.0,99,552,6.89,5.81,651,38884.0,34,14,17,56544.0,56544.0,834,451,6.78,6.99,1285,88057.0,31,2023-11-30 14:25:00
1197,DSKY,14,12,8701.0,8701.0,126,521,6.91,6.99,647,45141.0,26,13,10,9396.0,9396.0,135,477,6.96,6.99,612,42734.0,23,2023-11-30 14:30:00
1198,DSKY,18,144,8425.0,8425.0,121,12666,6.96,6.99,12787,893766.0,162,9,139,6055.0,6055.0,87,12655,6.96,6.99,12742,890630.0,148,2023-11-30 14:35:00
1199,DSKY,9,29,52778.0,52778.0,780,1403,6.77,6.5,2183,143981.0,38,7,18,2970.0,2970.0,43,1254,6.91,6.99,1297,90625.0,25,2023-11-30 14:40:00
1200,DSKY,22,14,27945.0,27945.0,402,1025,6.95,7.01,1427,99787.0,36,22,11,27942.0,27942.0,402,949,6.95,6.99,1351,94241.0,33,2023-11-30 14:45:00
1201,DSKY,6,5,2555.0,2555.0,37,34,6.91,6.99,71,4933.0,11,4,6,2012.0,2012.0,29,29,6.94,7.0,58,4043.0,10,2023-11-30 14:50:00
1202,DSKY,10,68,3537.0,3537.0,52,8570,6.8,6.99,8622,602314.0,78,8,65,9091.0,9091.0,131,8560,6.94,6.99,8691,607310.0,73,2023-11-30 14:55:00
1203,DSKY,9,12,7366.0,7366.0,106,209,6.95,6.98,315,21964.0,21,11,6,28150.0,28150.0,405,137,6.95,6.99,542,37719.0,17,2023-11-30 15:00:00
1204,DSKY,7,19,4593.0,4593.0,66,1217,6.96,6.96,1283,89283.0,26,7,15,4871.0,4871.0,70,1095,6.96,6.99,1165,81401.0,22,2023-11-30 15:05:00
1205,DSKY,16,12,13231.0,13231.0,190,508,6.96,6.99,698,48739.0,28,19,11,14692.0,14692.0,211,461,6.96,6.99,672,46923.0,30,2023-11-30 15:10:00
1206,DSKY,16,10,24808.0,24808.0,357,126,6.95,7.0,483,33633.0,26,14,6,17508.0,17508.0,252,97,6.95,6.99,349,24286.0,20,2023-11-30 15:15:00
1207,DSKY,7,9,8144.0,8144.0,117,84,6.96,6.98,201,14011.0,16,5,5,5498.0,5498.0,79,102,6.96,6.99,181,12628.0,10,2023-11-30 15:20:00
1208,DSKY,4,19,5145.0,5145.0,74,428,6.95,6.98,502,35031.0,23,4,17,4938.0,4938.0,71,422,6.96,6.98,493,34406.0,21,2023-11-30 15:25:00
1209,DSKY,6,27,43466.0,43466.0,624,2668,6.97,6.95,3292,228922.0,33,4,27,3677.0,3677.0,53,2710,6.94,6.99,2763,193057.0,31,2023-11-30 15:30:00
1210,DSKY,2,47,135.0,135.0,2,4030,6.75,6.96,4032,280435.0,49,2,44,135.0,135.0,2,3930,6.75,6.99,3932,274740.0,46,2023-11-30 15:35:00
1211,DSKY,18,25,68068.0,68068.0,1002,2238,6.79,6.98,3240,224206.0,43,17,20,69150.0,69150.0,1015,2221,6.81,6.99,3236,224464.0,37,2023-11-30 15:40:00
1212,DSKY,20,32,28162.0,28162.0,405,3803,6.95,6.94,4208,292230.0,52,20,30,28161.0,28161.0,405,3806,6.95,6.99,4211,294191.0,50,2023-11-30 15:45:00
1213,DSKY,14,14,17269.0,17269.0,248,710,6.96,6.9,958,66249.0,28,14,9,17409.0,17409.0,250,693,6.96,6.99,943,65853.0,23,2023-11-30 15:50:00
1214,DSKY,9,38,18849.0,18849.0,273,3805,6.9,6.97,4078,284218.0,47,8,32,18715.0,18715.0,270,3738,6.93,6.99,4008,279983.0,40,2023-11-30 15:55:00
1215,DSKY,7,22,13358.0,13358.0,193,3048,6.92,7.25,3241,234432.0,29,7,20,12963.0,12963.0,187,2499,6.93,6.99,2686,187627.0,27,2023-11-30 16:00:00
1216,DSKY,3,9,2428.0,2428.0,35,167,6.94,6.98,202,14078.0,12,3,4,2221.0,2221.0,32,48,6.94,6.99,80,5575.0,7,2023-11-30 16:05:00
1217,DSKY,3,23,1109.0,1109.0,16,863,6.93,6.98,879,61331.0,26,4,20,1166.0,1166.0,17,833,6.86,6.98,850,59292.0,24,2023-11-30 16:10:00
1218,DSKY,4,14,7727.0,7727.0,112,233,6.9,6.95,345,23913.0,18,5,11,7796.0,7796.0,113,192,6.9,6.98,305,21198.0,16,2023-11-30 16:15:00
1219,DSKY,4,16,1600.0,1600.0,27,668,5.93,6.95,695,48018.0,20,2,12,134.0,134.0,2,698,6.75,6.99,700,48908.0,14,2023-11-30 16:20:00
1220,DSKY,3,66,1109.0,1109.0,16,7067,6.93,6.79,7083,480981.0,69,4,64,40046.0,40046.0,592,6832,6.76,6.99,7424,517493.0,68,2023-11-30 16:25:00
1221,DSKY,5,12,3729.0,3729.0,54,649,6.91,6.99,703,49084.0,17,4,11,3678.0,3678.0,53,677,6.94,6.99,730,50983.0,15,2023-11-30 16:30:00
1222,DSKY,13,12,416012.0,416012.0,6627,128,6.28,6.49,6755,424315.0,25,9,7,229058.0,229058.0,3588,92,6.38,7.0,3680,235496.0,16,2023-11-30 16:35:00
1223,DSKY,3,6,552.0,552.0,8,135,6.9,6.95,143,9937.0,9,3,2,413.0,413.0,6,2,6.88,7.29,8,558.0,5,2023-11-30 16:40:00
1224,DSKY,8,15,19072.0,19072.0,276,1560,6.91,6.99,1836,128042.0,23,8,13,19211.0,19211.0,278,1580,6.91,6.99,1858,129642.0,21,2023-11-30 16:45:00
1225,DSKY,4,5,451.0,451.0,8,27,5.65,5.18,35,1851.0,9,3,4,201.0,201.0,3,14,6.73,7.15,17,1202.0,7,2023-11-30 16:50:00
1226,DSKY,3,34,1109.0,1109.0,16,4134,6.93,6.99,4150,289932.0,37,3,33,1108.0,1108.0,16,4127,6.93,6.99,4143,289573.0,36,2023-11-30 16:55:00
1227,DSKY,4,52,134.0,134.0,10,6880,1.34,6.97,6890,479504.0,56,3,49,268.0,268.0,4,6823,6.71,6.99,6827,477227.0,52,2023-11-30 17:00:00
1228,DSKY,3,196,28161.0,28161.0,404,26475,6.97,6.99,26879,1878594.0,199,5,191,49887.0,49887.0,738,26378,6.76,6.99,27116,1893582.0,196,2023-11-30 17:05:00
1229,DSKY,6,52,2710.0,2710.0,39,4501,6.95,6.99,4540,317246.0,58,5,48,1806.0,1806.0,26,4486,6.95,7.0,4512,315705.0,53,2023-11-30 17:10:00
1230,DSKY,7,15,14156.0,14156.0,204,460,6.94,6.74,664,45158.0,22,7,10,14406.0,14406.0,208,422,6.93,7.0,630,43932.0,17,2023-11-30 17:15:00
1231,DSKY,11,16,11407.0,11407.0,164,1293,6.96,6.63,1457,97194.0,27,10,15,9265.0,9265.0,133,1226,6.97,7.0,1359,95052.0,25,2023-11-30 17:20:00
1232,DSKY,5,10,1246.0,1246.0,18,23,6.92,7.02,41,2860.0,15,4,5,1176.0,1176.0,17,7,6.92,7.11,24,1673.0,9,2023-11-30 17:25:00
1233,DSKY,11,14,79053.0,79053.0,1159,144,6.82,6.95,1303,89063.0,25,6,13,75249.0,75249.0,1103,147,6.82,7.0,1250,85540.0,19,2023-11-30 17:30:00
1234,DSKY,6,22,7523.0,7523.0,108,632,6.97,6.83,740,50673.0,28,7,20,54357.0,54357.0,1120,608,4.85,6.99,1728,96869.0,27,2023-11-30 17:35:00
1235,DSKY,5,18,1875.0,1875.0,27,1055,6.95,7.0,1082,75687.0,23,5,16,1874.0,1874.0,27,1048,6.94,7.0,1075,75194.0,21,2023-11-30 17:40:00
1236,DSKY,21,32,117587.0,117587.0,1713,3708,6.86,7.0,5421,377042.0,53,15,33,56261.0,56261.0,808,3610,6.96,7.0,4418,308889.0,48,2023-11-30 17:45:00
1237,DSKY,16,25,44489.0,44489.0,639,395,6.96,6.95,1034,71961.0,41,18,19,94170.0,94170.0,1374,324,6.85,6.99,1698,116832.0,37,2023-11-30 17:50:00
1238,DSKY,9,25,14207.0,14207.0,234,1051,6.07,6.98,1285,87605.0,34,8,21,15459.0,15459.0,222,1023,6.96,7.0,1245,87039.0,29,2023-11-30 17:55:00
1239,DSKY,78,25,725486.0,725486.0,10411,971,6.97,6.92,11382,792658.0,103,70,14,435814.0,435814.0,6272,834,6.95,7.0,7106,494164.0,84,2023-11-30 18:00:00
1240,DSKY,1091,12,7239642.0,7239642.0,103774,151,6.98,6.91,103925,7250078.0,1103,1083,6,7207410.0,7207410.0,103310,117,6.98,7.05,103427,7215659.0,1089,2023-11-30 18:05:00
1241,DSKY,432,24,3427257.0,3427257.0,49110,581,6.98,6.98,49691,3467827.0,456,431,15,3418930.0,3418930.0,48991,254,6.98,7.01,49245,3436739.0,446,2023-11-30 18:10:00
1242,DSKY,1262,174,7681671.0,7681671.0,110093,722,6.98,7.0,110815,7732202.0,1436,1257,173,7677291.0,7677291.0,109979,872,6.98,7.01,110851,7738435.0,1430,2023-11-30 18:15:00
1243,DSKY,1006,128,8543258.0,8543258.0,122368,571,6.98,6.95,122939,8582957.0,1134,1006,125,8562607.0,8562607.0,122646,611,6.98,7.01,123257,8605457.0,1131,2023-11-30 18:20:00
1244,DSKY,1107,82,9477117.0,9477117.0,135790,307,6.98,6.69,136097,9497657.0,1189,1103,78,9452514.0,9452514.0,135446,293,6.98,7.01,135739,9473053.0,1181,2023-11-30 18:25:00
1245,DSKY,1271,136,12386817.0,12386817.0,177469,703,6.98,6.98,178172,12435863.0,1407,1273,134,12455859.0,12455859.0,178468,745,6.98,7.02,179213,12508127.0,1407,2023-11-30 18:30:00
1246,DSKY,335,56,2979287.0,2979287.0,42678,383,6.98,7.01,43061,3006136.0,391,333,54,2973181.0,2973181.0,42590,388,6.98,7.01,42978,3000389.0,387,2023-11-30 18:35:00
1247,DSKY,208,83,1718482.0,1718482.0,24636,1411,6.98,6.35,26047,1808021.0,291,201,74,1725165.0,1725165.0,24729,1194,6.98,7.01,25923,1808902.0,275,2023-11-30 18:40:00
0,FEES,2445,7121,459826694.0,1826616977.0,350360,1380793,0.13124,0.13229,1731153,2286443671.0,9566,1925,6550,410023651.0,1779991903.0,311995,1346022,0.13142,0.13224,1658017,2190015554.0,8475,2023-11-01 10:05:00
1,FEES,1606,1178,205255336.0,163706640.0,155474,123597,0.13202,0.13245,279071,368961976.0,2784,1442,975,191825748.0,138715890.0,145816,104679,0.13155,0.13252,250495,330541639.0,2417,2023-11-01 10:10:00
2,FEES,1545,1878,266890126.0,373458962.0,203581,282750,0.1311,0.13208,486331,640349088.0,3423,1361,1737,252452927.0,354947873.0,193041,268512,0.13078,0.13219,461553,607400800.0,3098,2023-11-01 10:15:00
3,FEES,877,3324,210484668.0,844154691.0,161723,639468,0.13015,0.13201,801191,1054639360.0,4201,756,3246,205232800.0,838216933.0,157744,634446,0.1301,0.13212,792190,1043449733.0,4002,2023-11-01 10:20:00
4,FEES,601,2263,98055611.0,494789511.0,74896,374575,0.13092,0.13209,449471,592845122.0,2864,501,2193,90890840.0,490453073.0,69519,371552,0.13074,0.132,441071,581343913.0,2694,2023-11-01 10:25:00
5,FEES,235,526,30262147.0,75404613.0,23121,57141,0.13089,0.13196,80262,105666761.0,761,201,484,27841105.0,72923533.0,21290,55234,0.13077,0.13203,76524,100764639.0,685,2023-11-01 10:30:00
6,FEES,1618,2182,491812452.0,776345754.0,379013,590518,0.12976,0.13147,969531,1268158206.0,3800,1242,1877,458825008.0,742251592.0,354220,562358,0.12953,0.13199,916578,1201076600.0,3119,2023-11-01 10:35:00
7,FEES,1150,1097,344517617.0,322081730.0,264873,244029,0.13007,0.13199,508902,666599348.0,2247,1036,950,334427919.0,316002126.0,257714,239372,0.12977,0.13201,497086,650430045.0,1986,2023-11-01 10:40:00
8,FEES,674,875,113526582.0,184224197.0,87362,139489,0.12995,0.13207,226851,297750779.0,1549,580,735,111047416.0,175339963.0,85471,132707,0.12992,0.13213,218178,286387380.0,1315,2023-11-01 10:45:00
9,FEES,5424,4559,1735289679.0,1822508930.0,1344200,1397532,0.12909,0.13041,2741732,3557798609.0,9983,4554,4032,1653115618.0,1749628823.0,1284197,1337744,0.12873,0.13079,2621941,3402744442.0,8586,2023-11-01 10:50:00
10,FEES,2018,2161,582822570.0,598943157.0,451803,458853,0.129,0.13053,910656,1181765728.0,4179,1775,1878,563384206.0,579888688.0,436975,443573,0.12893,0.13073,880548,1143272895.0,3653,2023-11-01 10:55:00
11,FEES,905,1159,228969084.0,310445142.0,177325,237651,0.12912,0.13063,414976,539414226.0,2064,792,1052,223509892.0,303427545.0,173239,232370,0.12902,0.13058,405609,526937437.0,1844,2023-11-01 11:00:00
12,FEES,451,547,111385585.0,165545769.0,86292,127101,0.12908,0.13025,213393,276931355.0,998,403,511,105397287.0,166148924.0,81712,127204,0.12899,0.13062,208916,271546212.0,914,2023-11-01 11:05:00
13,FEES,713,666,179078078.0,232383723.0,138717,178565,0.1291,0.13014,317282,411461801.0,1379,622,533,177024298.0,225606856.0,137172,173309,0.12905,0.13018,310481,402631154.0,1155,2023-11-01 11:10:00
14,FEES,1217,1607,390722851.0,502072081.0,303433,387088,0.12877,0.1297,690521,892794932.0,2824,1050,1506,374547859.0,493112687.0,290852,379781,0.12878,0.12984,670633,867660547.0,2556,2023-11-01 11:15:00
15,FEES,1560,1855,492825340.0,677320796.0,381493,520512,0.12918,0.13013,902005,1170146136.0,3415,1470,1741,486990846.0,671077534.0,377319,515664,0.12907,0.13014,892983,1158068380.0,3211,2023-11-01 11:20:00
16,FEES,931,669,260006169.0,242928105.0,201311,184364,0.12916,0.13177,385675,502934274.0,1600,886,612,260387833.0,219553181.0,201726,168579,0.12908,0.13024,370305,479941014.0,1498,2023-11-01 11:25:00
17,FEES,623,470,121551675.0,113366053.0,94088,87067,0.12919,0.13021,181155,234917729.0,1093,570,409,122007529.0,108368136.0,94509,83239,0.1291,0.13019,177748,230375665.0,979,2023-11-01 11:30:00
18,FEES,690,624,124277867.0,159842728.0,96369,122845,0.12896,0.13012,219214,284120596.0,1314,578,550,116749372.0,156411297.0,90496,120105,0.12901,0.13023,210601,273160670.0,1128,2023-11-01 11:35:00
19,FEES,409,539,93058966.0,95728195.0,72052,73514,0.12916,0.13022,145566,188787161.0,948,312,507,90163447.0,95284401.0,69879,73226,0.12903,0.13012,143105,185447848.0,819,2023-11-01 11:40:00
20,FEES,738,912,217061446.0,188300367.0,167908,144523,0.12927,0.13029,312431,405361814.0,1650,566,816,213069366.0,177073710.0,164940,135947,0.12918,0.13025,300887,390143076.0,1382,2023-11-01 11:45:00
21,FEES,2743,2409,913372463.0,720033831.0,702493,551702,0.13002,0.13051,1254195,1633406294.0,5152,2590,2277,903636684.0,717718936.0,695883,549790,0.12985,0.13054,1245673,1621355620.0,4867,2023-11-01 11:50:00
22,FEES,951,810,109513189.0,129174355.0,84148,98808,0.13014,0.13073,182956,238687544.0,1761,744,689,105861552.0,123080033.0,81497,94082,0.1299,0.13082,175579,228941585.0,1433,2023-11-01 11:55:00
23,FEES,991,956,174356687.0,130824542.0,134487,100529,0.12965,0.13014,235016,305181230.0,1947,882,874,171013014.0,126381291.0,131902,96883,0.12965,0.13045,228785,297394306.0,1756,2023-11-01 12:00:00
24,FEES,668,875,109561255.0,106108749.0,87286,81372,0.12552,0.1304,168658,215670004.0,1543,553,820,83593565.0,105557222.0,64523,80917,0.12956,0.13045,145440,189150788.0,1373,2023-11-01 12:05:00
25,FEES,838,727,139463546.0,90003940.0,107332,68875,0.12994,0.13068,176207,229467487.0,1565,782,651,134154068.0,83306527.0,103337,63728,0.12982,0.13072,167065,217460596.0,1433,2023-11-01 12:10:00
26,FEES,1033,938,161498397.0,109108847.0,124380,83575,0.12984,0.13055,207955,270607244.0,1971,938,700,156513629.0,104675350.0,120607,80125,0.12977,0.13064,200732,261188980.0,1638,2023-11-01 12:15:00
27,FEES,592,485,110919009.0,101220828.0,85963,76797,0.12903,0.1318,162760,212139837.0,1077,534,426,103294441.0,91868253.0,80038,69601,0.12906,0.13199,149639,195162695.0,960,2023-11-01 12:20:00
28,FEES,297,623,69651726.0,65546859.0,54115,50084,0.12871,0.13087,104199,135198586.0,920,265,574,67696800.0,62732135.0,52622,47944,0.12865,0.13084,100566,130428935.0,839,2023-11-01 12:25:00
29,FEES,593,633,111567227.0,112080872.0,86260,85678,0.12934,0.13082,171938,223648100.0,1226,528,577,107472512.0,110637551.0,83390,84380,0.12888,0.13112,167770,218110064.0,1105,2023-11-01 12:30:00
30,FEES,343,418,61058003.0,94031295.0,47139,72045,0.12953,0.13052,119184,155089299.0,761,303,373,59592573.0,91647812.0,46024,70205,0.12948,0.13054,116229,151240386.0,676,2023-11-01 12:35:00
31,FEES,551,776,94863992.0,148481700.0,73267,113894,0.12948,0.13037,187161,243345693.0,1327,484,723,92906812.0,148740929.0,71791,114025,0.12941,0.13045,185816,241647742.0,1207,2023-11-01 12:40:00
32,FEES,839,1411,272306940.0,343432785.0,210729,263725,0.12922,0.13022,474454,615739726.0,2250,697,1313,260750967.0,338523205.0,201801,259794,0.12921,0.1303,461595,599274173.0,2010,2023-11-01 12:45:00
33,FEES,651,871,137411747.0,283785899.0,106190,217674,0.1294,0.13037,323864,421197647.0,1522,570,797,137413866.0,278562725.0,106230,213654,0.12936,0.13038,319884,415976591.0,1367,2023-11-01 12:50:00
34,FEES,802,880,201644808.0,313960086.0,155759,240785,0.12946,0.13039,396544,515604894.0,1682,728,799,197683773.0,312038023.0,152820,239222,0.12936,0.13044,392042,509721796.0,1527,2023-11-01 12:55:00
35,FEES,810,1094,200931903.0,332471468.0,154914,254835,0.12971,0.13047,409749,533403371.0,1904,759,1015,194020639.0,329866215.0,149619,252793,0.12968,0.13049,402412,523886854.0,1774,2023-11-01 13:00:00
36,FEES,315,891,88363713.0,165396489.0,68250,126772,0.12947,0.13047,195022,253760203.0,1206,281,827,87835842.0,162027588.0,67834,124168,0.12949,0.13049,192002,249863430.0,1108,2023-11-01 13:05:00
37,FEES,536,657,80339165.0,125558927.0,62200,96076,0.12916,0.13069,158276,205898092.0,1193,490,605,80192541.0,123016987.0,62054,94116,0.12923,0.13071,156170,203209528.0,1095,2023-11-01 13:10:00
38,FEES,239,266,47967454.0,55726128.0,37189,42737,0.12898,0.13039,79926,103693582.0,505,189,216,46029244.0,53800868.0,35687,41120,0.12898,0.13084,76807,99830112.0,405,2023-11-01 13:15:00
39,FEES,183,357,28788162.0,35434307.0,22327,27302,0.12894,0.12979,49629,64222469.0,540,140,336,25901163.0,38710386.0,20078,29637,0.129,0.13062,49715,64611549.0,476,2023-11-01 13:20:00
40,FEES,300,240,70297683.0,57615646.0,54538,44134,0.1289,0.13055,98672,127913330.0,540,256,202,66493844.0,56304231.0,51715,43100,0.12858,0.13064,94815,122798075.0,458,2023-11-01 13:25:00
41,FEES,380,448,92681908.0,116605161.0,72018,89135,0.12869,0.13082,161153,209287069.0,828,321,387,90525733.0,114880939.0,70378,87771,0.12863,0.13089,158149,205406673.0,708,2023-11-01 13:30:00
42,FEES,904,820,188615966.0,257139588.0,145468,196022,0.12966,0.13118,341490,445755555.0,1724,841,735,179439057.0,254941674.0,138801,194323,0.12928,0.13119,333124,434380731.0,1576,2023-11-01 13:35:00
43,FEES,723,434,136020806.0,73097634.0,105205,55935,0.12929,0.13068,161140,209118440.0,1157,686,386,135718667.0,71135170.0,104961,54400,0.1293,0.13076,159361,206853837.0,1072,2023-11-01 13:40:00
44,FEES,429,803,126387138.0,157048224.0,98228,120187,0.12867,0.13067,218415,283435363.0,1232,355,725,121976425.0,152734253.0,94839,116792,0.12861,0.13077,211631,274710678.0,1080,2023-11-01 13:45:00
45,FEES,800,811,169492221.0,247575111.0,131442,189275,0.12895,0.1308,320717,417067333.0,1611,704,727,163595572.0,244871188.0,127051,187134,0.12876,0.13085,314185,408466760.0,1431,2023-11-01 13:50:00
46,FEES,468,520,101835081.0,212173835.0,78845,162998,0.12916,0.13017,241843,314008917.0,988,390,469,100166732.0,210939218.0,77587,162023,0.1291,0.13019,239610,311105950.0,859,2023-11-01 13:55:00
47,FEES,566,519,73308636.0,176367441.0,56750,135485,0.12918,0.13017,192235,249676077.0,1085,509,479,75857947.0,176863774.0,58748,135841,0.12912,0.1302,194589,252721722.0,988,2023-11-01 14:00:00
48,FEES,493,901,53135043.0,172743621.0,41308,132039,0.12863,0.13083,173347,225878665.0,1394,418,855,50999097.0,170921899.0,39678,130597,0.12853,0.13088,170275,221920996.0,1273,2023-11-01 14:05:00
49,FEES,593,790,148902761.0,204540854.0,115593,156419,0.12882,0.13076,272012,353443616.0,1383,507,719,144343545.0,201084229.0,112227,153695,0.12862,0.13083,265922,345427774.0,1226,2023-11-01 14:10:00
50,FEES,812,948,147250428.0,206971204.0,114249,158304,0.12889,0.13074,272553,354221632.0,1760,711,853,143567991.0,202246270.0,111451,154634,0.12882,0.13079,266085,345814262.0,1564,2023-11-01 14:15:00
51,FEES,518,464,61536104.0,134188498.0,46732,102647,0.13168,0.13073,149379,195724602.0,982,433,432,57887720.0,133756288.0,44863,102292,0.12903,0.13076,147155,191644009.0,865,2023-11-01 14:20:00
52,FEES,385,478,62482702.0,143047876.0,47922,109330,0.13038,0.13084,157252,205530578.0,863,320,446,53654359.0,142197466.0,41318,108665,0.12986,0.13086,149983,195851826.0,766,2023-11-01 14:25:00
53,FEES,894,562,192151713.0,135250606.0,147049,103554,0.13067,0.13061,250603,327402320.0,1456,811,477,185923588.0,130659400.0,143056,99976,0.12997,0.13069,243032,316582988.0,1288,2023-11-01 14:30:00
54,FEES,1826,1108,520020821.0,343954510.0,402447,262710,0.12921,0.13093,665157,863975332.0,2934,1691,987,514457518.0,339125331.0,398740,258964,0.12902,0.13095,657704,853582849.0,2678,2023-11-01 14:35:00
55,FEES,1384,733,412786089.0,216525673.0,318600,165921,0.12956,0.1305,484521,629311762.0,2117,1282,646,409997646.0,211793580.0,316616,162306,0.12949,0.13049,478922,621791227.0,1928,2023-11-01 14:40:00
56,FEES,667,800,247258781.0,157492863.0,191292,120969,0.12926,0.13019,312261,404751644.0,1467,588,723,245961361.0,153189278.0,190303,117622,0.12925,0.13024,307925,399150639.0,1311,2023-11-01 14:45:00
57,FEES,476,652,113246696.0,220142549.0,87713,169281,0.12911,0.13005,256994,333389246.0,1128,384,583,108477885.0,214686050.0,84071,165038,0.12903,0.13008,249109,323163936.0,967,2023-11-01 14:50:00
58,FEES,836,677,234535402.0,198270924.0,181639,152765,0.12912,0.12979,334404,432806327.0,1513,713,604,227560004.0,193004327.0,176512,148501,0.12892,0.12997,325013,420564332.0,1317,2023-11-01 14:55:00
59,FEES,1044,566,185087084.0,223744796.0,143357,172102,0.12911,0.13001,315459,408831881.0,1610,991,521,184194465.0,222866066.0,142716,171407,0.12906,0.13002,314123,407060531.0,1512,2023-11-01 15:00:00
60,FEES,555,587,138454436.0,203514694.0,107417,157054,0.12889,0.12958,264471,341969130.0,1142,470,541,135351400.0,198657106.0,105084,152996,0.1288,0.12984,258080,334008507.0,1011,2023-11-01 15:05:00
61,FEES,441,348,99439923.0,86786643.0,75519,66819,0.13168,0.12988,142338,186226567.0,789,381,297,91739723.0,83975764.0,69634,64655,0.13175,0.12988,134289,175715487.0,678,2023-11-01 15:10:00
62,FEES,898,509,181431471.0,93964282.0,140886,72033,0.12878,0.13045,212919,275395753.0,1407,866,474,181812896.0,94365717.0,141165,72352,0.12879,0.13043,213517,276178613.0,1340,2023-11-01 15:15:00
63,FEES,534,703,158119091.0,227094761.0,123207,173897,0.12834,0.13059,297104,385213853.0,1237,454,637,155454741.0,223295579.0,121188,170796,0.12828,0.13074,291984,378750320.0,1091,2023-11-01 15:20:00
64,FEES,804,987,228892198.0,337966036.0,163169,258402,0.14028,0.13079,421571,566858234.0,1791,728,919,199961349.0,335134380.0,155633,256220,0.12848,0.1308,411853,535095730.0,1647,2023-11-01 15:25:00
65,FEES,1635,892,393575279.0,346138055.0,305111,264915,0.12899,0.13066,570026,739713335.0,2527,1559,808,389426363.0,342364710.0,302118,261729,0.1289,0.13081,563847,731791074.0,2367,2023-11-01 15:30:00
66,FEES,552,470,82358536.0,75492283.0,63764,57778,0.12916,0.13066,121542,157850819.0,1022,519,444,80676283.0,76010386.0,62476,58182,0.12913,0.13064,120658,156686669.0,963,2023-11-01 15:35:00
67,FEES,358,289,64286435.0,68284481.0,49884,52191,0.12887,0.13084,102075,132570916.0,647,322,249,82867577.0,67372320.0,49803,51479,0.16639,0.13087,101282,150239897.0,571,2023-11-01 15:40:00
68,FEES,592,381,109831164.0,126792528.0,85043,96796,0.12915,0.13099,181839,236623692.0,973,528,340,106865916.0,125170476.0,82981,95542,0.12878,0.13101,178523,232036392.0,868,2023-11-01 15:45:00
69,FEES,437,273,56450618.0,61516740.0,43758,47036,0.12901,0.13079,90794,117967358.0,710,414,234,56827135.0,60834466.0,44053,46475,0.129,0.1309,90528,117661601.0,648,2023-11-01 15:50:00
70,FEES,420,317,92278563.0,83481801.0,71549,63873,0.12897,0.1307,135422,175760364.0,737,388,265,90608484.0,81954117.0,70268,62679,0.12895,0.13075,132947,172562602.0,653,2023-11-01 15:55:00
71,FEES,409,522,91084753.0,145014188.0,70684,110816,0.12886,0.13086,181500,236098941.0,931,355,466,91092461.0,143739899.0,70726,109762,0.1288,0.13096,180488,234832360.0,821,2023-11-01 16:00:00
72,FEES,269,341,69744706.0,126045091.0,54224,96317,0.12862,0.13086,150541,195789797.0,610,235,319,67648604.0,125274402.0,52598,95690,0.12861,0.13092,148288,192923006.0,554,2023-11-01 16:05:00
73,FEES,589,613,72743228.0,202348897.0,56493,154599,0.12877,0.13089,211092,275092125.0,1202,544,564,70581533.0,198358469.0,54840,151500,0.1287,0.13093,206340,268940002.0,1108,2023-11-01 16:10:00
74,FEES,864,467,154458047.0,86076828.0,120118,65909,0.12859,0.1306,186027,240534876.0,1331,805,447,151845608.0,87652532.0,118155,67119,0.12851,0.13059,185274,239498141.0,1252,2023-11-01 16:15:00
75,FEES,448,476,95321999.0,110104938.0,73950,84138,0.1289,0.13086,158088,205426937.0,924,414,423,92565850.0,106502573.0,71852,81436,0.12883,0.13078,153288,199068423.0,837,2023-11-01 16:20:00
76,FEES,145,239,16687864.0,62868137.0,12895,47983,0.12941,0.13102,60878,79556002.0,384,135,194,16581452.0,61133304.0,12820,46625,0.12934,0.13112,59445,77714757.0,329,2023-11-01 16:25:00
77,FEES,646,691,121725991.0,173639221.0,94623,132668,0.12864,0.13088,227291,295365212.0,1337,608,625,120123629.0,170046892.0,93390,129863,0.12863,0.13094,223253,290170521.0,1233,2023-11-01 16:30:00
78,FEES,245,415,63671562.0,100877200.0,49450,77132,0.12876,0.13079,126582,164548762.0,660,199,387,60311189.0,97714568.0,46896,74661,0.12861,0.13088,121557,158025757.0,586,2023-11-01 16:35:00
79,FEES,168,218,45526351.0,65045240.0,35257,49995,0.12913,0.1301,85252,110571592.0,386,135,180,43797127.0,62134619.0,33925,47736,0.1291,0.13016,81661,105931747.0,315,2023-11-01 16:40:00
80,FEES,169,257,42832391.0,104657057.0,33111,80377,0.12936,0.13021,113488,147489449.0,426,137,210,48387769.0,100962047.0,37469,77545,0.12914,0.1302,115014,149349816.0,347,2023-11-01 16:45:00
81,FEES,263,340,96093220.0,126728226.0,74406,97685,0.12915,0.12973,172091,222821446.0,603,236,306,90623066.0,123778890.0,70287,95176,0.12893,0.13005,165463,214401957.0,542,2023-11-01 16:50:00
82,FEES,261,309,45639694.0,47828818.0,35391,36813,0.12896,0.12992,72204,93468512.0,570,215,267,50408567.0,51924278.0,39090,39942,0.12896,0.13,79032,102332846.0,482,2023-11-01 16:55:00
83,FEES,265,539,38382280.0,49104207.0,29753,37896,0.129,0.12958,67649,87486487.0,804,233,497,36407661.0,47109383.0,28245,36267,0.1289,0.1299,64512,83517044.0,730,2023-11-01 17:00:00
84,FEES,162,190,21813499.0,17239016.0,16909,13326,0.12901,0.12936,30235,39052516.0,352,127,130,22234856.0,16526345.0,17250,12724,0.1289,0.12988,29974,38761201.0,257,2023-11-01 17:05:00
85,FEES,139,127,15180636.0,13104524.0,11796,10100,0.12869,0.12975,21896,28285161.0,266,110,95,13929983.0,10411909.0,10807,8014,0.1289,0.12992,18821,24341893.0,205,2023-11-01 17:10:00
86,FEES,223,294,17934591.0,32392199.0,13897,24941,0.12905,0.12988,38838,50326790.0,517,176,247,16491228.0,31295219.0,12785,24082,0.12899,0.12995,36867,47786447.0,423,2023-11-01 17:15:00
87,FEES,410,346,27388866.0,27984115.0,21182,21622,0.1293,0.12942,42804,55372982.0,756,357,298,26369773.0,26606793.0,20429,20480,0.12908,0.12992,40909,52976567.0,655,2023-11-01 17:20:00
88,FEES,440,359,16586129.0,28656731.0,12845,22114,0.12913,0.12959,34959,45242860.0,799,365,335,15310471.0,27763040.0,11867,21374,0.12902,0.12989,33241,43073511.0,700,2023-11-01 17:25:00
89,FEES,386,381,29438997.0,30711858.0,22639,21833,0.13004,0.14067,44472,60150855.0,767,337,305,24555115.0,27002807.0,19005,20793,0.1292,0.12986,39798,51557922.0,642,2023-11-01 17:30:00
90,FEES,164,192,13956287.0,14370759.0,10835,11093,0.12881,0.12955,21928,28327046.0,356,137,157,14097114.0,15607983.0,10916,10156,0.12914,0.15368,21072,29705098.0,294,2023-11-01 17:35:00
91,FEES,429,331,16553964.0,26567589.0,12751,20635,0.12982,0.12875,33386,43121553.0,760,384,293,15518842.0,24738521.0,12006,19044,0.12926,0.1299,31050,40257363.0,677,2023-11-01 17:40:00
92,FEES,280,266,16383058.0,22502724.0,12661,15482,0.1294,0.14535,28143,38885782.0,546,229,234,13904408.0,19164066.0,10767,14757,0.12914,0.12986,25524,33068475.0,463,2023-11-01 17:45:00
93,FEES,174,193,8841850.0,14318144.0,6833,11049,0.1294,0.12959,17882,23159995.0,367,139,160,7802403.0,12676638.0,6031,9763,0.12937,0.12984,15794,20479042.0,299,2023-11-01 17:50:00
94,FEES,424,191,26976581.0,14228217.0,20675,10954,0.13048,0.12989,31629,41204798.0,615,383,149,25363818.0,13085512.0,19602,10063,0.12939,0.13004,29665,38449331.0,532,2023-11-01 17:55:00
95,FEES,613,233,40506635.0,13688481.0,31293,10612,0.12944,0.12899,41905,54195116.0,846,572,205,40509321.0,11872847.0,31297,9138,0.12944,0.12993,40435,52382168.0,777,2023-11-01 18:00:00
96,FEES,235,200,18972446.0,15020999.0,14640,11572,0.12959,0.1298,26212,33993445.0,435,209,166,18054780.0,13605594.0,13969,10474,0.12925,0.1299,24443,31660374.0,375,2023-11-01 18:05:00
97,FEES,552,506,39340620.0,28527920.0,30172,21976,0.13039,0.12981,52148,67868540.0,1058,483,421,35999733.0,26565025.0,27828,20452,0.12937,0.12989,48280,62564758.0,904,2023-11-01 18:10:00
98,FEES,277,256,22037498.0,18242877.0,16959,14353,0.12995,0.1271,31312,40280375.0,533,233,221,19173070.0,14293577.0,14828,11002,0.1293,0.12992,25830,33466647.0,454,2023-11-01 18:15:00
99,FEES,148,402,20704918.0,22231222.0,16055,17290,0.12896,0.12858,33345,42936140.0,550,114,371,21413143.0,19763117.0,16623,15235,0.12882,0.12972,31858,41176261.0,485,2023-11-01 18:20:00
100,FEES,202,285,13906149.0,14037457.0,10724,10842,0.12967,0.12947,21566,27943607.0,487,165,254,11438045.0,12875682.0,8864,9915,0.12904,0.12986,18779,24313727.0,419,2023-11-01 18:25:00
101,FEES,71,131,9426734.0,7720338.0,6480,5973,0.14547,0.12925,12453,17147073.0,202,49,103,8235725.0,8136070.0,6386,6275,0.12897,0.12966,12661,16371796.0,152,2023-11-01 18:30:00
102,FEES,233,388,18186685.0,43059279.0,13864,33157,0.13118,0.12986,47021,61245965.0,621,184,362,15335843.0,41360449.0,11862,31849,0.12929,0.12986,43711,56696292.0,546,2023-11-01 18:35:00
103,FEES,209,405,17835853.0,35043169.0,13764,26993,0.12958,0.12982,40757,52879023.0,614,176,391,16201376.0,30262232.0,12519,23311,0.12941,0.12982,35830,46463608.0,567,2023-11-01 18:40:00
104,FEES,3331,9245,423297014.0,1744686967.0,328209,1347612,0.12897,0.12947,1675821,2167983981.0,12576,2840,8743,388723564.0,1714116627.0,301775,1325321,0.12881,0.12934,1627096,2102840191.0,11583,2023-11-02 10:05:00
105,FEES,953,1728,131778249.0,276004276.0,102494,213496,0.12857,0.12928,315990,407782526.0,2681,825,1605,122913587.0,272471982.0,95587,210633,0.12859,0.12936,306220,395385570.0,2430,2023-11-02 10:10:00
106,FEES,695,1031,129633394.0,220817139.0,100816,169497,0.12858,0.13028,270313,350450534.0,1726,607,956,120662527.0,212111967.0,93901,162854,0.1285,0.13025,256755,332774494.0,1563,2023-11-02 10:15:00
107,FEES,393,489,72944301.0,99386264.0,56813,76523,0.12839,0.12988,133336,172330565.0,882,354,445,70280169.0,95280771.0,54785,73383,0.12828,0.12984,128168,165560940.0,799,2023-11-02 10:20:00
108,FEES,967,998,211331964.0,244703509.0,163681,186482,0.12911,0.13122,350163,456035474.0,1965,861,847,201906355.0,235830236.0,157019,179633,0.12859,0.13128,336652,437736591.0,1708,2023-11-02 10:25:00
109,FEES,1181,1024,275310475.0,257002182.0,213015,196179,0.12924,0.131,409194,532312658.0,2205,1016,748,257805959.0,244881567.0,199384,186828,0.1293,0.13107,386212,502687526.0,1764,2023-11-02 10:30:00
110,FEES,839,988,248005445.0,259689176.0,191884,198029,0.12925,0.13114,389913,507694621.0,1827,745,868,241672191.0,247174596.0,187067,188452,0.12919,0.13116,375519,488846787.0,1613,2023-11-02 10:35:00
111,FEES,415,395,85362750.0,99437791.0,66030,75839,0.12928,0.13112,141869,184800541.0,810,356,313,80335489.0,94700712.0,62184,72237,0.12919,0.1311,134421,175036201.0,669,2023-11-02 10:40:00
112,FEES,725,717,173732879.0,196625516.0,134433,150027,0.12923,0.13106,284460,370358396.0,1442,614,631,170318283.0,185782892.0,131959,141691,0.12907,0.13112,273650,356101175.0,1245,2023-11-02 10:45:00
113,FEES,824,847,161173439.0,224617346.0,124844,172243,0.1291,0.13041,297087,385790786.0,1671,703,776,156874729.0,216688292.0,121568,165924,0.12904,0.13059,287492,373563021.0,1479,2023-11-02 10:50:00
114,FEES,560,1243,109899532.0,328814718.0,85004,253163,0.12929,0.12988,338167,438714251.0,1803,482,1175,106145680.0,326156833.0,82190,250948,0.12915,0.12997,333138,432302513.0,1657,2023-11-02 10:55:00
115,FEES,457,643,85034049.0,205720262.0,65638,157782,0.12955,0.13038,223420,290754312.0,1100,404,561,74461277.0,204431244.0,57574,156776,0.12933,0.1304,214350,278892521.0,965,2023-11-02 11:00:00
116,FEES,672,761,158020359.0,217177772.0,122201,166763,0.12931,0.13023,288964,375198132.0,1433,625,686,159697858.0,204760190.0,123488,157156,0.12932,0.13029,280644,364458049.0,1311,2023-11-02 11:05:00
117,FEES,1051,958,251919541.0,259982419.0,194589,199451,0.12946,0.13035,394040,511901961.0,2009,973,852,232225691.0,251042678.0,179479,192516,0.12939,0.1304,371995,483268370.0,1825,2023-11-02 11:10:00
118,FEES,496,476,88142075.0,187125689.0,67998,143340,0.12962,0.13055,211338,275267765.0,972,420,364,84092118.0,182766356.0,64888,139960,0.1296,0.13058,204848,266858474.0,784,2023-11-02 11:15:00
119,FEES,1039,916,235218039.0,319876535.0,181254,244969,0.12977,0.13058,426223,555094574.0,1955,942,823,222414935.0,310309155.0,171497,237500,0.12969,0.13066,408997,532724090.0,1765,2023-11-02 11:20:00
120,FEES,592,542,150345843.0,192235435.0,115809,144991,0.12982,0.13258,260800,342581278.0,1134,544,471,147148618.0,165680531.0,113409,126708,0.12975,0.13076,240117,312829150.0,1015,2023-11-02 11:25:00
121,FEES,409,586,99755655.0,114881027.0,77006,88205,0.12954,0.13024,165211,214636683.0,995,374,526,97092272.0,110788630.0,74985,84930,0.12948,0.13045,159915,207880903.0,900,2023-11-02 11:30:00
122,FEES,1355,3627,399534006.0,928043331.0,308220,713080,0.12963,0.13015,1021300,1327577338.0,4982,1206,3497,379035048.0,922274113.0,292566,708476,0.12956,0.13018,1001042,1301309162.0,4703,2023-11-02 11:35:00
123,FEES,2043,1843,422959839.0,277563834.0,324547,211911,0.13032,0.13098,536458,700523673.0,3886,1672,1594,411104564.0,264942604.0,315827,202148,0.13017,0.13106,517975,676047169.0,3266,2023-11-02 11:40:00
124,FEES,1139,1094,266514220.0,136766729.0,205186,104911,0.12989,0.13036,310097,403280950.0,2233,1043,990,265846449.0,125769288.0,204673,96144,0.12989,0.13081,300817,391615738.0,2033,2023-11-02 11:45:00
125,FEES,456,413,107546820.0,56654645.0,82670,42978,0.13009,0.13182,125648,164201466.0,869,402,350,101720225.0,53775975.0,78329,41087,0.12986,0.13088,119416,155496201.0,752,2023-11-02 11:50:00
126,FEES,609,333,118413901.0,46380408.0,91088,35449,0.13,0.13084,126537,164794309.0,942,570,235,117864400.0,40958493.0,90666,31257,0.13,0.13104,121923,158822893.0,805,2023-11-02 11:55:00
127,FEES,674,446,169847461.0,80055282.0,130479,61271,0.13017,0.13066,191750,249902744.0,1120,634,369,167941790.0,71979772.0,128195,54919,0.131,0.13107,183114,239921563.0,1003,2023-11-02 12:00:00
128,FEES,885,2154,285510802.0,411787025.0,219648,314988,0.12999,0.13073,534636,697297827.0,3039,843,2108,283933237.0,409721900.0,218447,313313,0.12998,0.13077,531760,693655138.0,2951,2023-11-02 12:05:00
129,FEES,451,502,136268795.0,131735126.0,105424,101387,0.12926,0.12993,206811,268003922.0,953,416,451,135329442.0,121666965.0,104641,92990,0.12933,0.13084,197631,256996407.0,867,2023-11-02 12:10:00
130,FEES,463,552,147900244.0,124201320.0,114701,95051,0.12894,0.13067,209752,272101564.0,1015,432,524,145211072.0,123025478.0,112676,94152,0.12887,0.13067,206828,268236551.0,956,2023-11-02 12:15:00
131,FEES,1002,1557,266709890.0,422676715.0,206610,322812,0.12909,0.13094,529422,689386606.0,2559,957,1492,259770694.0,412804602.0,201351,315279,0.12901,0.13093,516630,672575296.0,2449,2023-11-02 12:20:00
132,FEES,526,361,146712357.0,110167058.0,113522,83687,0.12924,0.13164,197209,256879416.0,887,511,315,146356392.0,107972786.0,113251,82070,0.12923,0.13156,195321,254329179.0,826,2023-11-02 12:25:00
133,FEES,1366,1115,439432329.0,278834960.0,340648,212631,0.129,0.13114,553279,718267290.0,2481,1291,1063,438175958.0,278775556.0,339689,212458,0.12899,0.13121,552147,716951515.0,2354,2023-11-02 12:30:00
134,FEES,1096,1008,263085343.0,214519334.0,203986,164076,0.12897,0.13074,368062,477604677.0,2104,1044,963,261447380.0,212312186.0,202721,162222,0.12897,0.13088,364943,473759567.0,2007,2023-11-02 12:35:00
135,FEES,739,431,139261796.0,98553244.0,108022,75263,0.12892,0.13095,183285,237815040.0,1170,705,386,138481542.0,95863997.0,107423,73102,0.12891,0.13114,180525,234345539.0,1091,2023-11-02 12:40:00
136,FEES,371,409,82791474.0,114504364.0,64078,87427,0.1292,0.13097,151505,197295838.0,780,323,376,81932399.0,113502359.0,63421,86648,0.12919,0.13099,150069,195434758.0,699,2023-11-02 12:45:00
137,FEES,202,242,33261296.0,34606390.0,25734,26522,0.12925,0.13048,52256,67867687.0,444,176,202,32336400.0,32609824.0,25029,24961,0.1292,0.13064,49990,64946225.0,378,2023-11-02 12:50:00
138,FEES,187,327,39975228.0,49289050.0,30884,37789,0.12944,0.13043,68673,89264279.0,514,161,302,39396830.0,49232431.0,30454,37681,0.12937,0.13066,68135,88629262.0,463,2023-11-02 12:55:00
139,FEES,367,2057,107130673.0,506069663.0,83072,387846,0.12896,0.13048,470918,613200336.0,2424,329,2019,107564221.0,500354062.0,83388,383474,0.12899,0.13048,466862,607918284.0,2348,2023-11-02 13:00:00
140,FEES,252,954,43660658.0,281928384.0,33752,215967,0.12936,0.13054,249719,325589043.0,1206,213,929,40284256.0,285337100.0,31135,218516,0.12939,0.13058,249651,325621356.0,1142,2023-11-02 13:05:00
141,FEES,497,597,154027408.0,158909194.0,122353,121412,0.12589,0.13088,243765,312936603.0,1094,454,538,129363121.0,151641950.0,100306,115772,0.12897,0.13098,216078,281005071.0,992,2023-11-02 13:10:00
142,FEES,891,1083,205415401.0,355952321.0,158328,272050,0.12974,0.13084,430378,561367723.0,1974,838,1013,197396433.0,351743884.0,152663,268566,0.1293,0.13097,421229,549140317.0,1851,2023-11-02 13:15:00
143,FEES,1312,911,367782536.0,310871447.0,284072,236911,0.12947,0.13122,520983,678653983.0,2223,1259,840,365341793.0,304196523.0,282277,231758,0.12943,0.13126,514035,669538316.0,2099,2023-11-02 13:20:00
144,FEES,503,444,100609376.0,140136883.0,78007,106938,0.12897,0.13104,184945,240746260.0,947,471,401,98533838.0,135962075.0,76392,103649,0.12898,0.13118,180041,234495914.0,872,2023-11-02 13:25:00
145,FEES,604,415,87187752.0,83897579.0,67495,64378,0.12918,0.13032,131873,171085331.0,1019,579,380,85812707.0,81845981.0,66435,62709,0.12917,0.13052,129144,167658688.0,959,2023-11-02 13:30:00
146,FEES,752,540,179316740.0,172297808.0,138719,132049,0.12927,0.13048,270768,351614548.0,1292,704,487,178776491.0,171661379.0,138381,131516,0.12919,0.13053,269897,350437871.0,1191,2023-11-02 13:35:00
147,FEES,382,489,89555370.0,177841771.0,69202,136432,0.12941,0.13035,205634,267397142.0,871,350,461,89046604.0,182432144.0,68817,139959,0.1294,0.13035,208776,271478748.0,811,2023-11-02 13:40:00
148,FEES,742,638,270116929.0,170006963.0,208666,130374,0.12945,0.1304,339040,440123893.0,1380,695,598,266255309.0,166612359.0,205705,127777,0.12944,0.13039,333482,432867668.0,1293,2023-11-02 13:45:00
149,FEES,659,739,104813264.0,170827748.0,80914,130878,0.12954,0.13052,211792,275641013.0,1398,620,707,104915360.0,170813706.0,80955,130889,0.1296,0.1305,211844,275729066.0,1327,2023-11-02 13:50:00
150,FEES,259,425,40108869.0,170930552.0,31054,130822,0.12916,0.13066,161876,211039422.0,684,241,397,39597640.0,156820400.0,30657,119952,0.12916,0.13074,150609,196418040.0,638,2023-11-02 13:55:00
151,FEES,949,1093,267473720.0,320344477.0,206944,244695,0.12925,0.13092,451639,587818198.0,2042,899,1065,241068632.0,321146077.0,186691,245285,0.12913,0.13093,431976,562214709.0,1964,2023-11-02 14:00:00
152,FEES,6928,1464,1969600577.0,458367674.0,1513010,347356,0.13018,0.13196,1860366,2427968252.0,8392,6787,1187,1944197604.0,445420287.0,1495048,337461,0.13004,0.13199,1832509,2389617892.0,7974,2023-11-02 14:05:00
153,FEES,1095,1074,297753390.0,300077490.0,228905,227149,0.13008,0.13211,456054,597830881.0,2169,964,872,289139333.0,287339572.0,222497,217430,0.12995,0.13215,439927,576478905.0,1836,2023-11-02 14:10:00
154,FEES,884,689,227086833.0,170013898.0,174547,128746,0.1301,0.13205,303293,397100732.0,1573,814,566,219847459.0,160551940.0,169039,121530,0.13006,0.13211,290569,380399399.0,1380,2023-11-02 14:15:00
155,FEES,1077,749,291427678.0,210094475.0,223908,159301,0.13016,0.13189,383209,501522153.0,1826,1006,664,289177331.0,205586281.0,222240,155861,0.13012,0.1319,378101,494763612.0,1670,2023-11-02 14:20:00
156,FEES,401,309,101843187.0,71227702.0,78276,54114,0.13011,0.13163,132390,173070889.0,710,361,251,99857130.0,68138469.0,76797,51712,0.13003,0.13177,128509,167995599.0,612,2023-11-02 14:25:00
157,FEES,313,257,85573723.0,66196025.0,65631,50372,0.13039,0.13141,116003,151769749.0,570,266,217,83628617.0,64619920.0,64194,49181,0.13027,0.13139,113375,148248537.0,483,2023-11-02 14:30:00
158,FEES,318,249,69911828.0,67091776.0,53647,51070,0.13032,0.13137,104717,137003604.0,567,280,218,69176833.0,66162175.0,53095,50352,0.13029,0.1314,103447,135339008.0,498,2023-11-02 14:35:00
159,FEES,292,199,63433409.0,62092731.0,48597,47328,0.13053,0.1312,95925,125526141.0,491,268,165,62591515.0,61168058.0,47959,46610,0.13051,0.13123,94569,123759573.0,433,2023-11-02 14:40:00
160,FEES,336,228,28093392.0,23951546.0,21608,18227,0.13001,0.13141,39835,52044939.0,564,305,179,27766137.0,22682288.0,21375,17258,0.1299,0.13143,38633,50448425.0,484,2023-11-02 14:45:00
161,FEES,339,176,49060865.0,45248795.0,37490,34360,0.13086,0.13169,71850,94309660.0,515,306,140,46090623.0,43724035.0,35330,33217,0.13046,0.13163,68547,89814658.0,446,2023-11-02 14:50:00
162,FEES,393,337,134462319.0,116199003.0,103445,88290,0.12998,0.13161,191735,250661323.0,730,356,295,134926399.0,114221638.0,103830,86772,0.12995,0.13163,190602,249148037.0,651,2023-11-02 14:55:00
163,FEES,399,539,136185746.0,89582811.0,105066,68145,0.12962,0.13146,173211,225768557.0,938,382,504,137012929.0,88033266.0,105696,66931,0.12963,0.13153,172627,225046196.0,886,2023-11-02 15:00:00
164,FEES,546,511,166085563.0,106621134.0,128050,81073,0.1297,0.13151,209123,272706698.0,1057,477,480,162983689.0,105026428.0,125660,79770,0.1297,0.13166,205430,268010117.0,957,2023-11-02 15:05:00
165,FEES,640,489,97608318.0,77691201.0,74991,59466,0.13016,0.13065,134457,175299520.0,1129,584,460,100216533.0,81659677.0,77041,62246,0.13008,0.13119,139287,181876210.0,1044,2023-11-02 15:10:00
166,FEES,189,155,18878570.0,17626058.0,14503,13464,0.13017,0.13091,27967,36504629.0,344,160,128,18228284.0,16819338.0,14008,12825,0.13013,0.13114,26833,35047623.0,288,2023-11-02 15:15:00
167,FEES,183,174,64076582.0,47596180.0,49809,35932,0.12864,0.13246,85741,111672762.0,357,165,141,58199777.0,46381517.0,45055,35356,0.12917,0.13118,80411,104581294.0,306,2023-11-02 15:20:00
168,FEES,276,515,64196470.0,81180888.0,50040,60519,0.12829,0.13414,110559,145377359.0,791,255,484,60826001.0,79893738.0,47473,59741,0.12813,0.13373,107214,140719740.0,739,2023-11-02 15:25:00
169,FEES,412,815,133176858.0,144402400.0,104710,109758,0.12719,0.13156,214468,277579258.0,1227,381,762,132461326.0,140028759.0,104174,106082,0.12715,0.132,210256,272490085.0,1143,2023-11-02 15:30:00
170,FEES,390,615,134820055.0,99520617.0,105318,75723,0.12801,0.13143,181041,234340672.0,1005,349,593,126591194.0,97355530.0,99079,73879,0.12777,0.13178,172958,223946724.0,942,2023-11-02 15:35:00
171,FEES,425,664,117228336.0,83193485.0,90944,63183,0.1289,0.13167,154127,200421821.0,1089,376,621,115984712.0,83038845.0,89994,63068,0.12888,0.13167,153062,199023557.0,997,2023-11-02 15:40:00
172,FEES,397,201,39390947.0,38232330.0,30305,29028,0.12998,0.13171,59333,77623278.0,598,370,172,38369677.0,37556239.0,29533,28496,0.12992,0.13179,58029,75925917.0,542,2023-11-02 15:45:00
173,FEES,809,293,142143457.0,71766689.0,109806,54390,0.12945,0.13195,164196,213910146.0,1102,783,261,142421694.0,71248494.0,110048,54004,0.12942,0.13193,164052,213670189.0,1044,2023-11-02 15:50:00
174,FEES,397,670,109816128.0,115760665.0,84858,87960,0.12941,0.13161,172818,225576793.0,1067,344,625,107430823.0,114817397.0,83048,87160,0.12936,0.13173,170208,222248220.0,969,2023-11-02 15:55:00
175,FEES,903,998,184226448.0,223559357.0,141411,169539,0.13028,0.13186,310950,407785805.0,1901,860,968,182131595.0,223482013.0,139815,169457,0.13027,0.13188,309272,405613608.0,1828,2023-11-02 16:00:00
176,FEES,238,293,42455199.0,44872682.0,32715,34250,0.12977,0.13102,66965,87327881.0,531,221,272,41443494.0,42109207.0,31942,32006,0.12975,0.13157,63948,83552701.0,493,2023-11-02 16:05:00
177,FEES,420,294,77220960.0,40278358.0,59402,30769,0.13,0.13091,90171,117499318.0,714,395,271,75512609.0,33945877.0,58100,25821,0.12997,0.13147,83921,109458486.0,666,2023-11-02 16:10:00
178,FEES,415,283,75819313.0,74844118.0,58430,56691,0.12976,0.13202,115121,150663432.0,698,392,260,74539070.0,74132147.0,57417,56127,0.12982,0.13208,113544,148671217.0,652,2023-11-02 16:15:00
179,FEES,380,227,64991543.0,45574773.0,50153,34827,0.12959,0.13086,84980,110566317.0,607,364,193,64110594.0,43422382.0,49487,32994,0.12955,0.13161,82481,107532976.0,557,2023-11-02 16:20:00
180,FEES,411,487,74318588.0,56460886.0,57339,43043,0.12961,0.13117,100382,130779474.0,898,381,462,71535867.0,58059627.0,55209,44256,0.12957,0.13119,99465,129595495.0,843,2023-11-02 16:25:00
181,FEES,182,200,32760717.0,32483274.0,25244,24926,0.12978,0.13032,50170,65243991.0,382,165,164,33531010.0,30147242.0,25828,22997,0.12982,0.13109,48825,63678253.0,329,2023-11-02 16:30:00
182,FEES,538,358,209439046.0,92896121.0,162186,71137,0.12914,0.13059,233323,302335167.0,896,478,317,206240323.0,87734637.0,159759,66801,0.12909,0.13134,226560,293974960.0,795,2023-11-02 16:35:00
183,FEES,379,366,85750931.0,140736884.0,66163,107808,0.12961,0.13054,173971,226487816.0,745,310,340,81139002.0,139257932.0,62618,106238,0.12958,0.13108,168856,220396934.0,650,2023-11-02 16:40:00
184,FEES,393,354,95160278.0,91966038.0,73484,70517,0.1295,0.13042,144001,187126316.0,747,339,320,91571328.0,90267249.0,70720,69106,0.12948,0.13062,139826,181838578.0,659,2023-11-02 16:45:00
185,FEES,287,347,54651775.0,109005023.0,42163,83601,0.12962,0.13039,125764,163656799.0,634,233,318,54019262.0,105014197.0,41714,80449,0.1295,0.13054,122163,159033460.0,551,2023-11-02 16:50:00
186,FEES,196,479,37566615.0,100309088.0,28992,76747,0.12958,0.1307,105739,137875703.0,675,175,453,36772943.0,99413420.0,28394,76079,0.12951,0.13067,104473,136186364.0,628,2023-11-02 16:55:00
187,FEES,246,287,45313246.0,107257581.0,34938,82098,0.1297,0.13065,117036,152570828.0,533,219,266,46402320.0,106574096.0,35817,81569,0.12955,0.13066,117386,152976416.0,485,2023-11-02 17:00:00
188,FEES,503,565,140477939.0,139485003.0,108312,106802,0.1297,0.1306,215114,279962942.0,1068,465,531,140182207.0,138275411.0,108120,105874,0.12965,0.1306,213994,278457618.0,996,2023-11-02 17:05:00
189,FEES,538,390,62615509.0,130411822.0,48122,99610,0.13012,0.13092,147732,193027332.0,928,496,303,52911487.0,115712807.0,40706,88380,0.12998,0.13093,129086,168624295.0,799,2023-11-02 17:10:00
190,FEES,971,1078,180195343.0,237116042.0,139324,181139,0.12934,0.1309,320463,417311385.0,2049,956,1046,180979006.0,236902889.0,139879,180837,0.12938,0.131,320716,417881896.0,2002,2023-11-02 17:15:00
191,FEES,566,449,99024299.0,99325478.0,76657,75834,0.12918,0.13098,152491,198349778.0,1015,544,427,99259787.0,99469396.0,76930,75904,0.12903,0.13105,152834,198729183.0,971,2023-11-02 17:20:00
192,FEES,877,1356,200869869.0,370492774.0,155957,282880,0.1288,0.13097,438837,571362643.0,2233,817,1280,196194110.0,366999217.0,152334,279977,0.12879,0.13108,432311,563193327.0,2097,2023-11-02 17:25:00
193,FEES,499,1391,94954808.0,337232313.0,73702,258054,0.12884,0.13068,331756,432187121.0,1890,436,1371,94628245.0,337701039.0,73484,258315,0.12877,0.13073,331799,432329284.0,1807,2023-11-02 17:30:00
194,FEES,426,1220,67980899.0,316457628.0,52629,242596,0.12917,0.13045,295225,384438527.0,1646,397,1180,67577219.0,315544687.0,52377,241840,0.12902,0.13048,294217,383121907.0,1577,2023-11-02 17:35:00
195,FEES,573,1311,142806064.0,322283484.0,110971,247443,0.12869,0.13025,358414,465089549.0,1884,503,1273,144154227.0,315734152.0,111999,241927,0.12871,0.13051,353926,459888379.0,1776,2023-11-02 17:40:00
196,FEES,696,565,54607535.0,82409269.0,42440,63547,0.12867,0.12968,105987,137016805.0,1261,649,481,53651339.0,79457142.0,41711,61217,0.12863,0.1298,102928,133108481.0,1130,2023-11-02 17:45:00
197,FEES,1673,1272,280285154.0,137467955.0,217021,106218,0.12915,0.12942,323239,417753110.0,2945,1531,1099,276813116.0,137014542.0,214409,105318,0.12911,0.1301,319727,413827659.0,2630,2023-11-02 17:50:00
198,FEES,914,959,131688071.0,105407705.0,101522,80846,0.12971,0.13038,182368,237095777.0,1873,849,791,118421759.0,98061826.0,91576,75079,0.12932,0.13061,166655,216483586.0,1640,2023-11-02 17:55:00
199,FEES,623,495,64201111.0,30734962.0,49454,23765,0.12982,0.12933,73219,94936074.0,1118,595,437,62843227.0,26058968.0,48511,20048,0.12954,0.12998,68559,88902195.0,1032,2023-11-02 18:00:00
200,FEES,723,551,128022353.0,51335377.0,99154,39573,0.12911,0.12972,138727,179357730.0,1274,685,509,127561434.0,47485555.0,98806,36494,0.1291,0.13012,135300,175046990.0,1194,2023-11-02 18:05:00
201,FEES,725,1103,153415654.0,146301136.0,118984,113601,0.12894,0.12879,232585,299716790.0,1828,642,1014,148481998.0,136217879.0,115167,105048,0.12893,0.12967,220215,284699877.0,1656,2023-11-02 18:10:00
202,FEES,631,2540,58875976.0,583515779.0,45704,451434,0.12882,0.12926,497138,642391755.0,3171,524,2484,55428609.0,577042965.0,43043,446077,0.12877,0.12936,489120,632471574.0,3008,2023-11-02 18:15:00
203,FEES,276,970,24334948.0,189165032.0,18950,146414,0.12842,0.1292,165364,213499981.0,1246,186,921,17967184.0,186698580.0,13990,144374,0.12843,0.12932,158364,204665764.0,1107,2023-11-02 18:20:00
204,FEES,1257,1299,206340620.0,222641487.0,159900,172178,0.12904,0.12931,332078,428982108.0,2556,1198,1247,200954082.0,218117637.0,155935,168545,0.12887,0.12941,324480,419071719.0,2445,2023-11-02 18:25:00
205,FEES,2133,1341,402139953.0,214003499.0,312933,166022,0.12851,0.1289,478955,616143453.0,3474,1966,1208,395875890.0,210043323.0,308141,162654,0.12847,0.12914,470795,605919213.0,3174,2023-11-02 18:30:00
206,FEES,963,3792,130106499.0,736875060.0,101237,572179,0.12852,0.12878,673416,866981560.0,4755,902,3735,125525970.0,732708437.0,97666,568745,0.12853,0.12883,666411,858234408.0,4637,2023-11-02 18:35:00
207,FEES,502,1992,40022251.0,303964686.0,31158,236141,0.12845,0.12872,267299,343986937.0,2494,430,1909,34731879.0,298089416.0,27076,231492,0.12828,0.12877,258568,332821295.0,2339,2023-11-02 18:40:00
208,FEES,3716,3450,774115213.0,457280321.0,597752,349297,0.1295,0.13091,947049,1231395535.0,7166,3305,3081,746325110.0,431739605.0,575337,330420,0.12972,0.13066,905757,1178064716.0,6386,2023-11-03 10:05:00
209,FEES,1904,833,579023277.0,98237758.0,446659,75031,0.12963,0.13093,521690,677261035.0,2737,1850,722,576224485.0,85022119.0,444488,64817,0.12964,0.13117,509305,661246604.0,2572,2023-11-03 10:10:00
210,FEES,755,648,105317771.0,53325321.0,81365,40787,0.12944,0.13074,122152,158643092.0,1403,703,600,101946699.0,55895305.0,78691,42788,0.12955,0.13063,121479,157842005.0,1303,2023-11-03 10:15:00
211,FEES,466,390,81578650.0,65694225.0,53291,50022,0.15308,0.13133,103313,147272875.0,856,405,311,65822935.0,52536173.0,51039,40129,0.12897,0.13092,91168,118359108.0,716,2023-11-03 10:20:00
212,FEES,302,300,82774039.0,47890314.0,54285,36695,0.15248,0.13051,90980,130664353.0,602,253,249,78598262.0,43188028.0,51071,33073,0.1539,0.13058,84144,121786290.0,502,2023-11-03 10:25:00
213,FEES,530,268,46138437.0,41680773.0,35696,31916,0.12925,0.1306,67612,87819211.0,798,426,186,45321726.0,45155648.0,35119,34535,0.12905,0.13075,69654,90477375.0,612,2023-11-03 10:30:00
214,FEES,450,312,54158898.0,47386620.0,42025,36228,0.12887,0.1308,78253,101545519.0,762,410,285,52167200.0,44324643.0,40484,33884,0.12886,0.13081,74368,96491843.0,695,2023-11-03 10:35:00
215,FEES,317,314,63536557.0,78257769.0,49294,60373,0.12889,0.12962,109667,141794326.0,631,274,251,60948944.0,69435300.0,47300,53125,0.12886,0.1307,100425,130384245.0,525,2023-11-03 10:40:00
216,FEES,233,248,48039055.0,47659465.0,28988,36838,0.16572,0.12938,65826,95698521.0,481,208,210,36092877.0,43792778.0,27996,33445,0.12892,0.13094,61441,79885655.0,418,2023-11-03 10:45:00
217,FEES,141,115,17531141.0,15043440.0,13558,11574,0.1293,0.12998,25132,32574581.0,256,135,93,19708474.0,13861310.0,15248,10543,0.12925,0.13147,25791,33569785.0,228,2023-11-03 10:50:00
218,FEES,240,374,48510197.0,86946777.0,37613,66226,0.12897,0.13129,103839,135456975.0,614,202,240,45508114.0,72477395.0,35293,55354,0.12894,0.13093,90647,117985509.0,442,2023-11-03 10:55:00
219,FEES,157,415,23667114.0,91253174.0,18278,69690,0.12948,0.13094,87968,114920288.0,572,137,385,23652437.0,89037990.0,18298,67904,0.12926,0.13112,86202,112690427.0,522,2023-11-03 11:00:00
220,FEES,810,826,208857520.0,188257827.0,162351,144311,0.12865,0.13045,306662,397115348.0,1636,753,733,202643383.0,184162921.0,157555,140946,0.12862,0.13066,298501,386806305.0,1486,2023-11-03 11:05:00
221,FEES,634,913,131875484.0,206785583.0,102109,157944,0.12915,0.13092,260053,338661068.0,1547,590,855,127146155.0,205723386.0,98690,157070,0.12883,0.13098,255760,332869541.0,1445,2023-11-03 11:10:00
222,FEES,4317,937,996281100.0,348702242.0,768816,265479,0.12959,0.13135,1034295,1344983343.0,5254,4260,853,990896592.0,344424810.0,764752,262110,0.12957,0.1314,1026862,1335321402.0,5113,2023-11-03 11:15:00
223,FEES,611,485,99717508.0,61639856.0,77384,47297,0.12886,0.13033,124681,161357364.0,1096,579,459,96714903.0,59073708.0,75053,45163,0.12886,0.1308,120216,155788611.0,1038,2023-11-03 11:20:00
224,FEES,1481,2157,445788961.0,442326268.0,346003,339094,0.12884,0.13044,685097,888115229.0,3638,1419,2085,440638186.0,433193363.0,341992,331650,0.12884,0.13062,673642,873831550.0,3504,2023-11-03 11:25:00
225,FEES,983,822,162646954.0,184215276.0,126440,141192,0.12864,0.13047,267632,346862230.0,1805,947,776,160555493.0,183675198.0,124809,140731,0.12864,0.13052,265540,344230692.0,1723,2023-11-03 11:30:00
226,FEES,954,1240,182749631.0,200239079.0,142383,153984,0.12835,0.13004,296367,382988710.0,2194,908,1167,177185105.0,192309146.0,138072,147636,0.12833,0.13026,285708,369494251.0,2075,2023-11-03 11:35:00
227,FEES,1054,1801,250230362.0,425174753.0,195338,326910,0.1281,0.13006,522248,675405115.0,2855,964,1493,240288402.0,424180303.0,187630,325877,0.12807,0.13017,513507,664468706.0,2457,2023-11-03 11:40:00
228,FEES,495,824,109880517.0,158355287.0,85662,122007,0.12827,0.12979,207669,268235804.0,1319,427,762,107469688.0,157116084.0,83827,120964,0.1282,0.12989,204791,264585772.0,1189,2023-11-03 11:45:00
229,FEES,1298,1613,311861343.0,354923165.0,242313,272336,0.1287,0.13033,514649,666784509.0,2911,1205,1401,303015803.0,347321264.0,235497,266319,0.12867,0.13042,501816,650337068.0,2606,2023-11-03 11:50:00
230,FEES,796,624,165574487.0,114055893.0,122323,87240,0.13536,0.13074,209563,279630381.0,1420,732,499,153700947.0,108770969.0,119100,83123,0.12905,0.13086,202223,262471917.0,1231,2023-11-03 11:55:00
231,FEES,835,540,169430455.0,171043910.0,126587,130240,0.13385,0.13133,256827,340474365.0,1375,803,442,173079340.0,166323947.0,123786,126594,0.13982,0.13138,250380,339403287.0,1245,2023-11-03 12:00:00
232,FEES,519,449,140706160.0,144470467.0,108995,108213,0.12909,0.13351,217208,285176628.0,968,486,367,139590371.0,118396479.0,108185,90263,0.12903,0.13117,198448,257986851.0,853,2023-11-03 12:05:00
233,FEES,925,658,175111159.0,159698301.0,138351,122032,0.12657,0.13087,260383,334809460.0,1583,881,595,150756526.0,153392057.0,116789,117149,0.12908,0.13094,233938,304148583.0,1476,2023-11-03 12:10:00
234,FEES,884,951,165453928.0,271324810.0,127605,206807,0.12966,0.1312,334412,436778739.0,1835,720,815,159748001.0,263732388.0,123593,200939,0.12925,0.13125,324532,423480390.0,1535,2023-11-03 12:15:00
235,FEES,659,1166,128008676.0,175323284.0,99218,134237,0.12902,0.13061,233455,303331961.0,1825,637,1110,129448906.0,172455927.0,100310,131985,0.12905,0.13066,232295,301904834.0,1747,2023-11-03 12:20:00
236,FEES,968,747,182118195.0,132723231.0,141191,101782,0.12899,0.1304,242973,314841427.0,1715,940,707,181864674.0,130909034.0,140997,100355,0.12898,0.13045,241352,312773709.0,1647,2023-11-03 12:25:00
237,FEES,604,1012,158432972.0,151138583.0,123216,116129,0.12858,0.13015,239345,309571555.0,1616,567,980,157369589.0,152556782.0,122420,117236,0.12855,0.13013,239656,309926371.0,1547,2023-11-03 12:30:00
238,FEES,571,708,124329153.0,125293342.0,96306,96091,0.1291,0.13039,192397,249622496.0,1279,537,656,122289403.0,123885310.0,94764,94958,0.12905,0.13046,189722,246174713.0,1193,2023-11-03 12:35:00
239,FEES,988,886,367973727.0,213903739.0,284039,163968,0.12955,0.13045,448007,581877467.0,1874,934,811,361845919.0,210574804.0,279558,161401,0.12944,0.13047,440959,572420723.0,1745,2023-11-03 12:40:00
240,FEES,356,280,80275726.0,40914149.0,62037,31446,0.1294,0.13011,93483,121189875.0,636,328,246,78666344.0,39146699.0,60720,30009,0.12956,0.13045,90729,117813043.0,574,2023-11-03 12:45:00
241,FEES,204,259,23863732.0,17224624.0,18424,13237,0.12953,0.13012,31661,41088357.0,463,179,235,23321518.0,16835012.0,18007,12917,0.12951,0.13033,30924,40156531.0,414,2023-11-03 12:50:00
242,FEES,255,183,40011395.0,31070645.0,30917,23714,0.12942,0.13102,54631,71082041.0,438,222,155,38885862.0,29979570.0,30048,22929,0.12941,0.13075,52977,68865432.0,377,2023-11-03 12:55:00
243,FEES,323,556,79224640.0,34575497.0,61193,26544,0.12947,0.13026,87737,113800137.0,879,304,532,78985236.0,33949954.0,61005,26060,0.12947,0.13028,87065,112935190.0,836,2023-11-03 13:00:00
244,FEES,423,283,63804806.0,52679601.0,49330,40448,0.12934,0.13024,89778,116484407.0,706,386,259,60199456.0,51403780.0,46521,39427,0.1294,0.13038,85948,111603236.0,645,2023-11-03 13:05:00
245,FEES,194,423,38253961.0,40828003.0,29575,31271,0.12935,0.13056,60846,79081965.0,617,184,393,36599410.0,38627677.0,28306,29584,0.1293,0.13057,57890,75227088.0,577,2023-11-03 13:10:00
246,FEES,138,125,23649741.0,22151517.0,18287,17032,0.12933,0.13006,35319,45801259.0,263,126,93,21664384.0,41168801.0,16754,29574,0.12931,0.13921,46328,62833186.0,219,2023-11-03 13:15:00
247,FEES,156,171,39039159.0,30850120.0,30216,23707,0.1292,0.13013,53923,69889279.0,327,150,147,40846531.0,29411037.0,31609,22590,0.12922,0.13019,54199,70257569.0,297,2023-11-03 13:20:00
248,FEES,441,400,112240108.0,70387463.0,86953,54204,0.12908,0.12986,141157,182627571.0,841,409,362,111264772.0,68585314.0,86208,52732,0.12907,0.13006,138940,179850087.0,771,2023-11-03 13:25:00
249,FEES,161,203,25480350.0,34889749.0,19791,26804,0.12875,0.13017,46595,60370100.0,364,139,187,25794643.0,34129523.0,19981,26234,0.1291,0.1301,46215,59924166.0,326,2023-11-03 13:30:00
250,FEES,233,203,37973754.0,22133047.0,29415,17089,0.1291,0.12952,46504,60106801.0,436,209,164,35634391.0,20163805.0,27606,15505,0.12908,0.13005,43111,55798196.0,373,2023-11-03 13:35:00
251,FEES,433,380,67532339.0,53604287.0,52309,41283,0.1291,0.12985,93592,121136627.0,813,366,337,65068426.0,51194119.0,50453,39397,0.12897,0.12994,89850,116262545.0,703,2023-11-03 13:40:00
252,FEES,534,331,71274573.0,54505044.0,55138,41864,0.12927,0.1302,97002,125779618.0,865,475,254,67992803.0,51466235.0,52619,39531,0.12922,0.13019,92150,119459039.0,729,2023-11-03 13:45:00
253,FEES,330,305,46171275.0,36443795.0,35698,28043,0.12934,0.12996,63741,82615070.0,635,304,268,45673186.0,35759479.0,35321,27453,0.12931,0.13026,62774,81432666.0,572,2023-11-03 13:50:00
254,FEES,727,518,105806324.0,56133018.0,81906,43107,0.12918,0.13022,125013,161939343.0,1245,698,480,104129526.0,56272848.0,80682,43166,0.12906,0.13036,123848,160402374.0,1178,2023-11-03 13:55:00
255,FEES,517,630,113012394.0,103745929.0,87713,79464,0.12884,0.13056,167177,216758323.0,1147,489,582,114909966.0,102179289.0,89229,78245,0.12878,0.13059,167474,217089255.0,1071,2023-11-03 14:00:00
256,FEES,576,689,89538013.0,72052302.0,69574,55274,0.12869,0.13035,124848,161590315.0,1265,538,660,87113967.0,71108796.0,67727,54466,0.12863,0.13056,122193,158222764.0,1198,2023-11-03 14:05:00
257,FEES,772,749,200274170.0,125260961.0,155571,96172,0.12873,0.13025,251743,325535131.0,1521,719,692,196488393.0,119669660.0,152701,91593,0.12868,0.13065,244294,316158053.0,1411,2023-11-03 14:10:00
258,FEES,236,235,33633606.0,54641128.0,26070,41870,0.12901,0.1305,67940,88274734.0,471,232,211,33915030.0,54614337.0,26298,41841,0.12896,0.13053,68139,88529368.0,443,2023-11-03 14:15:00
259,FEES,303,264,42544410.0,79108748.0,33103,60557,0.12852,0.13064,93660,121653159.0,567,277,245,43092689.0,78590474.0,33528,60156,0.12853,0.13064,93684,121683164.0,522,2023-11-03 14:20:00
260,FEES,468,327,73914890.0,86362766.0,57400,66182,0.12877,0.13049,123582,160277656.0,795,421,287,73303045.0,85446205.0,56953,65476,0.12871,0.1305,122429,158749250.0,708,2023-11-03 14:25:00
261,FEES,773,2067,145299368.0,632872267.0,112995,485568,0.12859,0.13034,598563,778171636.0,2840,729,2037,144205185.0,631284065.0,112176,484405,0.12855,0.13032,596581,775489251.0,2766,2023-11-03 14:30:00
262,FEES,1630,3346,411882821.0,864775461.0,320109,665019,0.12867,0.13004,985128,1276658283.0,4976,1581,3303,408244466.0,862603759.0,317350,663303,0.12864,0.13005,980653,1270848225.0,4884,2023-11-03 14:35:00
263,FEES,350,431,105915251.0,104077117.0,82073,80028,0.12905,0.13005,162101,209992369.0,781,289,396,104408157.0,103057682.0,80925,79228,0.12902,0.13008,160153,207465840.0,685,2023-11-03 14:40:00
264,FEES,455,870,156078387.0,213609186.0,120883,164309,0.12912,0.13,285192,369687573.0,1325,416,817,154848076.0,210993504.0,119950,162282,0.12909,0.13002,282232,365841581.0,1233,2023-11-03 14:45:00
265,FEES,272,1598,58213848.0,372957437.0,45089,287174,0.12911,0.12987,332263,431171285.0,1870,236,1568,57761000.0,372437979.0,44751,286759,0.12907,0.12988,331510,430198979.0,1804,2023-11-03 14:50:00
266,FEES,641,958,230809488.0,172653870.0,178681,132761,0.12917,0.13005,311442,403463358.0,1599,615,915,230142166.0,171356630.0,178172,131739,0.12917,0.13007,309911,401498796.0,1530,2023-11-03 14:55:00
267,FEES,226,318,64131039.0,59706591.0,49671,45895,0.12911,0.13009,95566,123837631.0,544,191,286,64589796.0,58674440.0,50006,45085,0.12916,0.13014,95091,123264237.0,477,2023-11-03 15:00:00
268,FEES,158,125,17741100.0,26494682.0,13731,20365,0.1292,0.1301,34096,44235783.0,283,137,99,17144166.0,25494703.0,13271,19593,0.12919,0.13012,32864,42638870.0,236,2023-11-03 15:05:00
269,FEES,165,234,39391789.0,37195948.0,30506,28593,0.12913,0.13009,59099,76587738.0,399,149,205,38788074.0,36407478.0,30046,27987,0.1291,0.13009,58033,75195552.0,354,2023-11-03 15:10:00
270,FEES,623,2029,70553827.0,382504768.0,54494,294095,0.12947,0.13006,348589,453058595.0,2652,575,1980,69557219.0,381439264.0,53896,293266,0.12906,0.13007,347162,450996483.0,2555,2023-11-03 15:15:00
271,FEES,437,853,101195213.0,194314968.0,78223,149241,0.12937,0.1302,227464,295510181.0,1290,378,806,97174606.0,192897863.0,75188,148149,0.12924,0.13021,223337,290072469.0,1184,2023-11-03 15:20:00
272,FEES,366,614,61897562.0,113756156.0,47859,87348,0.12933,0.13023,135207,175653718.0,980,308,575,61042112.0,112944192.0,47224,86728,0.12926,0.13023,133952,173986304.0,883,2023-11-03 15:25:00
273,FEES,303,442,66931757.0,71184626.0,51793,54684,0.12923,0.13017,106477,138116383.0,745,261,408,66542774.0,70273483.0,51495,53945,0.12922,0.13027,105440,136816257.0,669,2023-11-03 15:30:00
274,FEES,430,628,102595478.0,143851035.0,79367,110414,0.12927,0.13028,189781,246446514.0,1058,370,580,102107292.0,143167479.0,79015,109888,0.12923,0.13028,188903,245274772.0,950,2023-11-03 15:35:00
275,FEES,259,228,60890951.0,54161409.0,47111,41586,0.12925,0.13024,88697,115052360.0,487,234,192,59126355.0,51013917.0,45732,39156,0.12929,0.13028,84888,110140272.0,426,2023-11-03 15:40:00
276,FEES,237,290,28651480.0,43407691.0,22151,33382,0.12935,0.13003,55533,72059171.0,527,222,265,28053627.0,39507446.0,21696,30345,0.1293,0.13019,52041,67561074.0,487,2023-11-03 15:45:00
277,FEES,381,1178,56917997.0,161072618.0,44060,124074,0.12918,0.12982,168134,217990615.0,1559,371,1154,56695105.0,160294386.0,43881,123399,0.1292,0.1299,167280,216989492.0,1525,2023-11-03 15:50:00
278,FEES,206,219,37469385.0,47185495.0,29015,36296,0.12914,0.13,65311,84654880.0,425,182,197,37400246.0,45564559.0,28961,35044,0.12914,0.13002,64005,82964805.0,379,2023-11-03 15:55:00
279,FEES,374,524,64911138.0,152830666.0,50337,117613,0.12895,0.12994,167950,217741805.0,898,328,494,64121087.0,152479084.0,49722,117335,0.12896,0.12995,167057,216600171.0,822,2023-11-03 16:00:00
280,FEES,592,630,151768226.0,150811701.0,117608,116117,0.12905,0.12988,233725,302579928.0,1222,529,580,149578829.0,148236560.0,115962,114016,0.12899,0.13001,229978,297815390.0,1109,2023-11-03 16:05:00
281,FEES,172,263,45246793.0,57165108.0,35072,43768,0.12901,0.13061,78840,102411901.0,435,159,230,45123308.0,49830708.0,34977,38349,0.12901,0.12994,73326,94954017.0,389,2023-11-03 16:10:00
282,FEES,139,258,13316339.0,43481591.0,10318,33112,0.12906,0.13132,43430,56797931.0,397,126,240,12912777.0,38350424.0,10007,29506,0.12904,0.12998,39513,51263202.0,366,2023-11-03 16:15:00
283,FEES,371,479,64741148.0,114318328.0,50100,87944,0.12922,0.12999,138044,179059477.0,850,318,425,61807097.0,114155990.0,47901,87804,0.12903,0.13001,135705,175963087.0,743,2023-11-03 16:20:00
284,FEES,413,490,81308294.0,122757700.0,62978,94380,0.12911,0.13007,157358,204065994.0,903,367,433,80589088.0,121180582.0,62474,93189,0.129,0.13004,155663,201769670.0,800,2023-11-03 16:25:00
285,FEES,359,355,82375109.0,111866935.0,63834,86050,0.12905,0.13,149884,194242044.0,714,315,316,80821922.0,111348129.0,62668,85649,0.12897,0.13001,148317,192170051.0,631,2023-11-03 16:30:00
286,FEES,251,285,51631843.0,70577889.0,40052,54392,0.12891,0.12976,94444,122209732.0,536,232,246,51424883.0,68830620.0,39883,52969,0.12894,0.12995,92852,120255504.0,478,2023-11-03 16:35:00
287,FEES,217,249,34505609.0,80923252.0,26823,62020,0.12864,0.13048,88843,115428862.0,466,186,217,33060292.0,80523854.0,25663,61741,0.12882,0.13042,87404,113584147.0,403,2023-11-03 16:40:00
288,FEES,153,368,19508724.0,37145441.0,15183,28526,0.12849,0.13022,43709,56654165.0,521,142,355,18950940.0,37031454.0,14750,28427,0.12848,0.13027,43177,55982395.0,497,2023-11-03 16:45:00
289,FEES,510,469,41926709.0,107885496.0,32538,82687,0.12885,0.13047,115225,149812205.0,979,466,437,40356351.0,107033249.0,31360,82008,0.12869,0.13052,113368,147389600.0,903,2023-11-03 16:50:00
290,FEES,620,1067,72479963.0,118268327.0,56246,91113,0.12886,0.1298,147359,190748291.0,1687,558,1018,75146590.0,121324379.0,58370,93399,0.12874,0.1299,151769,196470970.0,1576,2023-11-03 16:55:00
291,FEES,397,705,45805074.0,80687358.0,35460,62163,0.12917,0.1298,97623,126492432.0,1102,363,669,43906539.0,79785305.0,34046,61452,0.12896,0.12983,95498,123691844.0,1032,2023-11-03 17:00:00
292,FEES,9831,7558,1819506752.0,1276292393.0,1368286,853516,0.13298,0.14953,2221802,3095799145.0,17389,7575,5409,1578391960.0,990453117.0,1191484,697798,0.13247,0.14194,1889282,2568845077.0,12984,2023-11-03 17:05:00
293,FEES,4853,3875,714146620.0,714459231.0,541139,455401,0.13197,0.15689,996540,1428605852.0,8728,3553,2961,585278502.0,551328146.0,444988,356811,0.13153,0.15452,801799,1136606649.0,6514,2023-11-03 17:10:00
294,FEES,3817,2937,556992135.0,500922450.0,423295,330281,0.13158,0.15167,753576,1057914585.0,6754,2945,2166,447346941.0,382436485.0,341492,270223,0.131,0.14153,611715,829783426.0,5111,2023-11-03 17:15:00
295,FEES,2393,2246,414878640.0,372272333.0,317186,244087,0.1308,0.15252,561273,787150973.0,4639,1664,1809,331601235.0,278882135.0,253759,190065,0.13068,0.14673,443824,610483370.0,3473,2023-11-03 17:20:00
296,FEES,1387,2054,170075761.0,220782951.0,129651,162225,0.13118,0.1361,291876,390858713.0,3441,1056,1403,154382973.0,194137425.0,118140,139849,0.13068,0.13882,257989,348520398.0,2459,2023-11-03 17:25:00
297,FEES,1162,1169,170961706.0,164888822.0,130530,117236,0.13098,0.14065,247766,335850528.0,2331,921,934,155646421.0,155140501.0,119268,104647,0.1305,0.14825,223915,310786922.0,1855,2023-11-03 17:30:00
298,FEES,1393,1189,165398735.0,166103046.0,126270,127041,0.13099,0.13075,253311,331501782.0,2582,1038,1018,137516023.0,146121074.0,105339,111136,0.13055,0.13148,216475,283637097.0,2056,2023-11-03 17:35:00
299,FEES,973,879,104415630.0,127383721.0,79826,97570,0.1308,0.13056,177396,231799352.0,1852,767,773,83453355.0,109905539.0,63983,83673,0.13043,0.13135,147656,193358894.0,1540,2023-11-03 17:40:00
300,FEES,517,468,60183412.0,80263396.0,45792,61243,0.13143,0.13106,107035,140446809.0,985,442,362,47977761.0,57121000.0,36755,43461,0.13053,0.13143,80216,105098762.0,804,2023-11-03 17:45:00
301,FEES,1127,970,135442630.0,149681597.0,103717,115309,0.13059,0.12981,219026,285124227.0,2097,887,823,123595910.0,136154438.0,94804,103730,0.13037,0.13126,198534,259750348.0,1710,2023-11-03 17:50:00
302,FEES,524,536,52277647.0,79736141.0,39860,61179,0.13115,0.13033,101039,132013789.0,1060,364,443,40750877.0,64530432.0,31336,49253,0.13004,0.13102,80589,105281309.0,807,2023-11-03 17:55:00
303,FEES,791,529,58533019.0,61882140.0,40870,47353,0.14322,0.13068,88223,120415159.0,1320,603,444,45986129.0,52971154.0,35270,40416,0.13038,0.13106,75686,98957283.0,1047,2023-11-03 18:00:00
304,FEES,328,535,29704898.0,43126226.0,19603,32907,0.15153,0.13105,52510,72831124.0,863,227,463,26517460.0,34579905.0,15414,26386,0.17203,0.13105,41800,61097366.0,690,2023-11-03 18:05:00
305,FEES,1022,1118,81492123.0,140781436.0,61536,108537,0.13243,0.12971,170073,222273559.0,2140,750,976,69749112.0,124406124.0,53540,94954,0.13027,0.13102,148494,194155236.0,1726,2023-11-03 18:10:00
306,FEES,1512,1342,163120139.0,208122813.0,125466,160595,0.13001,0.12959,286061,371242952.0,2854,1168,1122,137094638.0,160669133.0,105704,123190,0.1297,0.13042,228894,297763771.0,2290,2023-11-03 18:15:00
307,FEES,965,838,80740828.0,106155725.0,62200,81673,0.12981,0.12998,143873,186896553.0,1803,793,749,66850267.0,91956404.0,51612,69937,0.12952,0.13148,121549,158806671.0,1542,2023-11-03 18:20:00
308,FEES,1102,1046,129885989.0,112320765.0,99419,86394,0.13065,0.13001,185813,242206754.0,2148,978,908,117864329.0,104848569.0,90951,80446,0.12959,0.13033,171397,222712898.0,1886,2023-11-03 18:25:00
309,FEES,826,475,84675415.0,57600936.0,65298,44225,0.12968,0.13025,109523,142276352.0,1301,763,386,78647055.0,52910178.0,60686,40577,0.1296,0.13039,101263,131557233.0,1149,2023-11-03 18:30:00
310,FEES,593,476,86285615.0,56170786.0,66339,43276,0.13007,0.1298,109615,142456401.0,1069,539,444,76211947.0,47034015.0,58732,36061,0.12976,0.13043,94793,123245963.0,983,2023-11-03 18:35:00
311,FEES,693,330,91861614.0,85609331.0,70675,65343,0.12998,0.13102,136018,177470945.0,1023,649,308,88531979.0,57695165.0,68285,43782,0.12965,0.13178,112067,146227145.0,957,2023-11-03 18:40:00
312,FEES,1936,2362,187462148.0,346491420.0,147972,265416,0.12669,0.13055,413388,533953569.0,4298,1441,1999,157618961.0,308691026.0,124046,240807,0.12706,0.12819,364853,466309987.0,3440,2023-11-06 10:05:00
313,FEES,2148,1965,413294056.0,517508946.0,328404,405812,0.12585,0.12752,734216,930803003.0,4113,1705,1672,376524390.0,510271513.0,299553,397948,0.1257,0.12823,697501,886795903.0,3377,2023-11-06 10:10:00
314,FEES,1558,1270,266335574.0,271196617.0,210916,211877,0.12628,0.128,422793,537532191.0,2828,1295,1119,252932327.0,255760166.0,200817,199025,0.12595,0.12851,399842,508692494.0,2414,2023-11-06 10:15:00
315,FEES,1675,2704,388102825.0,715478847.0,308630,563146,0.12575,0.12705,871776,1103581673.0,4379,1258,2491,364214056.0,697792486.0,290103,548007,0.12555,0.12733,838110,1062006542.0,3749,2023-11-06 10:20:00
316,FEES,1063,1622,243216803.0,340425578.0,194348,268336,0.12514,0.12687,462684,583642381.0,2685,824,1472,218464065.0,330842790.0,173624,260756,0.12583,0.12688,434380,549306856.0,2296,2023-11-06 10:25:00
317,FEES,993,1389,254319401.0,307946013.0,201835,242819,0.126,0.12682,444654,562265415.0,2382,800,1289,250196655.0,299521607.0,198647,235972,0.12595,0.12693,434619,549718262.0,2089,2023-11-06 10:30:00
318,FEES,654,808,76972813.0,111480983.0,60881,84605,0.12643,0.13177,145486,188453796.0,1462,425,704,65549199.0,104979262.0,52131,82824,0.12574,0.12675,134955,170528461.0,1129,2023-11-06 10:35:00
319,FEES,621,752,93347662.0,166510071.0,74100,130784,0.12598,0.12732,204884,259857733.0,1373,522,696,88979584.0,165344247.0,70750,129895,0.12577,0.12729,200645,254323831.0,1218,2023-11-06 10:40:00
320,FEES,532,611,103978344.0,101634847.0,82867,79765,0.12548,0.12742,162632,205613192.0,1143,447,563,100878237.0,97021093.0,80431,76199,0.12542,0.12733,156630,197899330.0,1010,2023-11-06 10:45:00
321,FEES,799,815,185591364.0,187523605.0,147722,147023,0.12564,0.12755,294745,373114970.0,1614,707,722,182146667.0,187336898.0,145131,146790,0.12551,0.12762,291921,369483566.0,1429,2023-11-06 10:50:00
322,FEES,1221,1174,220320203.0,271122118.0,175230,212431,0.12573,0.12763,387661,491442321.0,2395,1127,1108,219096483.0,266516073.0,174522,208802,0.12554,0.12764,383324,485612556.0,2235,2023-11-06 10:55:00
323,FEES,928,377,113236050.0,107066791.0,89425,81201,0.12663,0.13185,170626,220302841.0,1305,868,321,108423347.0,100424576.0,85938,78791,0.12616,0.12746,164729,208847924.0,1189,2023-11-06 11:00:00
324,FEES,540,543,102774312.0,133237421.0,81447,102902,0.12619,0.12948,184349,236011734.0,1083,438,481,99191679.0,128382939.0,78668,97226,0.12609,0.13205,175894,227574618.0,919,2023-11-06 11:05:00
325,FEES,910,950,239257292.0,282062343.0,190366,221878,0.12568,0.12712,412244,521319635.0,1860,746,885,230700605.0,275106557.0,183620,215932,0.12564,0.1274,399552,505807162.0,1631,2023-11-06 11:10:00
326,FEES,1118,953,194536386.0,263008958.0,154376,204161,0.12601,0.12882,358537,457545344.0,2071,976,883,189881363.0,255735478.0,150897,201712,0.12584,0.12678,352609,445616841.0,1859,2023-11-06 11:15:00
327,FEES,854,552,140950058.0,186713084.0,111638,137883,0.12626,0.13541,249521,327663142.0,1406,784,502,136124845.0,166542902.0,107944,121338,0.12611,0.13726,229282,302667747.0,1286,2023-11-06 11:20:00
328,FEES,870,699,139569275.0,180302627.0,110555,141892,0.12624,0.12707,252447,319871902.0,1569,803,643,136789283.0,177459871.0,108428,139594,0.12616,0.12713,248022,314249155.0,1446,2023-11-06 11:25:00
329,FEES,506,711,90798466.0,130175123.0,71672,102251,0.12669,0.12731,173923,220973589.0,1217,434,658,88844482.0,126927649.0,70331,99746,0.12632,0.12725,170077,215772131.0,1092,2023-11-06 11:30:00
330,FEES,1721,1563,528059486.0,263973264.0,415888,207034,0.12697,0.1275,622922,792032750.0,3284,1627,1405,521043841.0,279455374.0,410921,216642,0.1268,0.12899,627563,800499216.0,3032,2023-11-06 11:35:00
331,FEES,919,875,200862218.0,208511832.0,158692,163333,0.12657,0.12766,322025,409374050.0,1794,792,785,189598227.0,193572617.0,149932,151739,0.12646,0.12757,301671,383170844.0,1577,2023-11-06 11:40:00
332,FEES,846,1358,250130794.0,360611483.0,198028,283032,0.12631,0.12741,481060,610742277.0,2204,733,1291,244517739.0,357235331.0,193632,280370,0.12628,0.12742,474002,601753070.0,2024,2023-11-06 11:45:00
333,FEES,742,1012,197964315.0,209683594.0,156174,164455,0.12676,0.1275,320629,407647910.0,1754,663,959,193975653.0,205333763.0,153416,161002,0.12644,0.12753,314418,399309417.0,1622,2023-11-06 11:50:00
334,FEES,431,933,74988249.0,87344593.0,59284,68571,0.12649,0.12738,127855,162332842.0,1364,354,863,70748463.0,84197701.0,55943,66116,0.12647,0.12735,122059,154946165.0,1217,2023-11-06 11:55:00
335,FEES,415,750,67139297.0,98529607.0,53104,77395,0.12643,0.12731,130499,165668905.0,1165,387,725,69769065.0,95479349.0,55302,74999,0.12616,0.12731,130301,165248414.0,1112,2023-11-06 12:00:00
336,FEES,1121,597,176951354.0,120267461.0,139608,94189,0.12675,0.12769,233797,297218815.0,1718,850,545,172906804.0,115954158.0,136481,90903,0.12669,0.12756,227384,288860963.0,1395,2023-11-06 12:05:00
337,FEES,628,506,106137849.0,104897108.0,83779,75061,0.12669,0.13975,158840,211034957.0,1134,532,471,100745975.0,88904695.0,79691,69807,0.12642,0.12736,149498,189650670.0,1003,2023-11-06 12:10:00
338,FEES,810,1144,174785173.0,241334223.0,138664,190029,0.12605,0.127,328693,416119397.0,1954,692,1061,169082167.0,235823871.0,134162,185652,0.12603,0.12702,319814,404906038.0,1753,2023-11-06 12:15:00
339,FEES,670,1005,233454297.0,212350235.0,185092,167376,0.12613,0.12687,352468,445804533.0,1675,532,932,230966950.0,209175575.0,183152,164915,0.12611,0.12684,348067,440142525.0,1464,2023-11-06 12:20:00
340,FEES,333,238,30505414.0,43027800.0,24180,33872,0.12616,0.12703,58052,73533214.0,571,295,214,31721595.0,43247447.0,25176,34047,0.126,0.12702,59223,74969043.0,509,2023-11-06 12:25:00
341,FEES,183,190,40801273.0,45162712.0,32290,35552,0.12636,0.12703,67842,85963986.0,373,116,168,39697582.0,44088378.0,31436,34716,0.12628,0.127,66152,83785960.0,284,2023-11-06 12:30:00
342,FEES,699,1104,140492871.0,335153058.0,111806,265096,0.12566,0.12643,376902,475645929.0,1803,564,1001,134975482.0,318470122.0,107339,251750,0.12575,0.1265,359089,453445604.0,1565,2023-11-06 12:35:00
343,FEES,1329,1241,265871164.0,479461541.0,211266,379037,0.12585,0.12649,590303,745332705.0,2570,1247,1201,258903630.0,479144101.0,205788,378807,0.12581,0.12649,584595,738047732.0,2448,2023-11-06 12:40:00
344,FEES,495,755,81035163.0,117342051.0,64464,92907,0.12571,0.1263,157371,198377215.0,1250,388,713,78008393.0,115586461.0,62112,91274,0.12559,0.12664,153386,193594854.0,1101,2023-11-06 12:45:00
345,FEES,383,833,73257310.0,134841551.0,58294,106609,0.12567,0.12648,164903,208098862.0,1216,290,766,69193692.0,131169159.0,55096,103655,0.12559,0.12654,158751,200362851.0,1056,2023-11-06 12:50:00
346,FEES,401,428,104971242.0,97855251.0,83612,77406,0.12555,0.12642,161018,202826493.0,829,298,373,93324410.0,92106340.0,74406,72831,0.12543,0.12647,147237,185430750.0,671,2023-11-06 12:55:00
347,FEES,248,363,45473959.0,62672628.0,36124,49509,0.12588,0.12659,85633,108146587.0,611,190,335,46699690.0,60810211.0,37206,48050,0.12552,0.12656,85256,107509901.0,525,2023-11-06 13:00:00
348,FEES,346,415,82982429.0,96086735.0,66143,76026,0.12546,0.12639,142169,179069165.0,761,277,370,76687458.0,89497590.0,61111,70653,0.12549,0.12667,131764,166185049.0,647,2023-11-06 13:05:00
349,FEES,559,497,120883813.0,127134508.0,96653,98147,0.12507,0.12953,194800,248018321.0,1056,435,451,114766480.0,119383281.0,91767,94270,0.12506,0.12664,186037,234149761.0,886,2023-11-06 13:10:00
350,FEES,1309,1667,410228324.0,346027186.0,330121,274203,0.12427,0.12619,604324,756255511.0,2976,963,1500,389357284.0,329790614.0,313542,260967,0.12418,0.12637,574509,719147899.0,2463,2023-11-06 13:15:00
351,FEES,672,453,72005077.0,74549236.0,57281,58952,0.1257,0.12646,116233,146554313.0,1125,573,390,68473965.0,72113913.0,54820,56995,0.12491,0.12653,111815,140587879.0,963,2023-11-06 13:20:00
352,FEES,790,697,186494660.0,155440639.0,149944,120566,0.12438,0.12893,270510,341935300.0,1487,665,648,180342824.0,128550243.0,145093,101746,0.12429,0.12634,246839,308893067.0,1313,2023-11-06 13:25:00
353,FEES,894,707,221426037.0,181418398.0,178107,143615,0.12432,0.12632,321722,402844435.0,1601,771,663,215434018.0,175205607.0,173344,138604,0.12428,0.12641,311948,390639626.0,1434,2023-11-06 13:30:00
354,FEES,521,639,132305323.0,149723410.0,106449,118574,0.12429,0.12627,225023,282028734.0,1160,366,593,125714764.0,140049894.0,101215,110809,0.12421,0.12639,212024,265764658.0,959,2023-11-06 13:35:00
355,FEES,929,848,244512050.0,173383930.0,197289,137696,0.12394,0.12592,334985,417895980.0,1777,680,768,237697671.0,164813536.0,191895,130668,0.12387,0.12613,322563,402511207.0,1448,2023-11-06 13:40:00
356,FEES,845,1040,265869339.0,236488767.0,214539,187498,0.12393,0.12613,402037,502358106.0,1885,579,916,250658661.0,228042174.0,202402,180627,0.12384,0.12625,383029,478700835.0,1495,2023-11-06 13:45:00
357,FEES,612,576,119678711.0,133250984.0,96199,105703,0.12441,0.12606,201902,252929696.0,1188,463,523,112523184.0,126881916.0,90700,100597,0.12406,0.12613,191297,239405100.0,986,2023-11-06 13:50:00
358,FEES,391,338,55755454.0,64163794.0,44625,50923,0.12494,0.126,95548,119919248.0,729,283,299,50566955.0,63562738.0,40637,50432,0.12444,0.12604,91069,114129693.0,582,2023-11-06 13:55:00
359,FEES,660,448,127949823.0,139756056.0,102777,110638,0.12449,0.12632,213415,267705880.0,1108,555,405,122576845.0,133802942.0,98745,105960,0.12413,0.12628,204705,256379787.0,960,2023-11-06 14:00:00
360,FEES,452,364,89546803.0,81076378.0,71601,64283,0.12506,0.12612,135884,170623182.0,816,352,270,83760340.0,76976642.0,67197,60974,0.12465,0.12625,128171,160736983.0,622,2023-11-06 14:05:00
361,FEES,352,297,66690360.0,65774374.0,53300,52344,0.12512,0.12566,105644,132464734.0,649,225,239,61282426.0,64563294.0,49090,51280,0.12484,0.1259,100370,125845721.0,464,2023-11-06 14:10:00
362,FEES,529,793,111945737.0,129426781.0,89687,102951,0.12482,0.12572,192638,241372519.0,1322,372,693,106132259.0,123541216.0,85066,98217,0.12476,0.12578,183283,229673476.0,1065,2023-11-06 14:15:00
363,FEES,963,1469,290206669.0,377242770.0,232883,301029,0.12461,0.12532,533912,667449440.0,2432,750,1366,275154771.0,367220722.0,220954,292431,0.12453,0.12558,513385,642375494.0,2116,2023-11-06 14:20:00
364,FEES,776,803,161477570.0,152856585.0,129215,121521,0.12497,0.12579,250736,314334156.0,1579,683,706,148027949.0,148001641.0,118487,117599,0.12493,0.12585,236086,296029591.0,1389,2023-11-06 14:25:00
365,FEES,791,966,177317072.0,185508991.0,141544,144102,0.12527,0.12873,285646,362826064.0,1757,693,903,171958055.0,175388831.0,137681,139450,0.1249,0.12577,277131,347346886.0,1596,2023-11-06 14:30:00
366,FEES,473,516,105380590.0,102600561.0,84314,81457,0.12499,0.12596,165771,207981151.0,989,402,479,100259010.0,99095624.0,80302,78715,0.12485,0.12589,159017,199354635.0,881,2023-11-06 14:35:00
367,FEES,914,611,159129849.0,138133896.0,127298,109896,0.12501,0.1257,237194,297263745.0,1525,811,557,154365602.0,132851122.0,123550,105547,0.12494,0.12587,229097,287216725.0,1368,2023-11-06 14:40:00
368,FEES,554,538,93435573.0,101260859.0,71640,80103,0.13042,0.12641,151743,194696433.0,1092,473,494,84584176.0,98250612.0,67820,77806,0.12472,0.12628,145626,182834789.0,967,2023-11-06 14:45:00
369,FEES,1068,874,182628547.0,169470922.0,145641,133940,0.1254,0.12653,279581,352099469.0,1942,924,729,174089098.0,161118172.0,139221,127374,0.12505,0.12649,266595,335207271.0,1653,2023-11-06 14:50:00
370,FEES,450,265,87473331.0,60070024.0,69856,47275,0.12522,0.12707,117131,147543356.0,715,424,209,83929520.0,51858536.0,67089,40886,0.1251,0.12684,107975,135788056.0,633,2023-11-06 14:55:00
371,FEES,201,158,26571297.0,26801781.0,21188,21149,0.12541,0.12673,42337,53373079.0,359,157,117,24834871.0,23791898.0,19833,18764,0.12522,0.1268,38597,48626770.0,274,2023-11-06 15:00:00
372,FEES,326,155,59884536.0,22379903.0,47693,17727,0.12556,0.12625,65420,82264439.0,481,281,117,27839770.0,21366695.0,22186,16912,0.12548,0.12634,39098,49206465.0,398,2023-11-06 15:05:00
373,FEES,279,261,65426557.0,76541845.0,52403,51500,0.12485,0.14862,103903,141968402.0,540,232,224,94644624.0,62336670.0,75675,49136,0.12507,0.12687,124811,156981295.0,456,2023-11-06 15:10:00
374,FEES,456,731,120235049.0,109102710.0,96501,86515,0.12459,0.12611,183016,229337760.0,1187,356,698,117162755.0,103307850.0,94055,81809,0.12457,0.12628,175864,220470606.0,1054,2023-11-06 15:15:00
375,FEES,544,741,122079284.0,142252480.0,97843,112664,0.12477,0.12626,210507,264331764.0,1285,461,699,118003347.0,140970080.0,94715,111624,0.12459,0.12629,206339,258973428.0,1160,2023-11-06 15:20:00
376,FEES,308,214,42764198.0,48067886.0,34063,38070,0.12554,0.12626,72133,90832084.0,522,268,182,41118144.0,47440226.0,32864,37561,0.12512,0.1263,70425,88558370.0,450,2023-11-06 15:25:00
377,FEES,445,798,58843121.0,105284942.0,47063,83569,0.12503,0.12599,130632,164128064.0,1243,416,775,56002708.0,102744488.0,44843,81516,0.12489,0.12604,126359,158747196.0,1191,2023-11-06 15:30:00
378,FEES,258,503,62888023.0,85250759.0,50121,67541,0.12547,0.12622,117662,148138783.0,761,195,477,59887326.0,82857329.0,47997,65635,0.12477,0.12624,113632,142744655.0,672,2023-11-06 15:35:00
379,FEES,658,1893,149482128.0,244564189.0,119228,186451,0.12538,0.13117,305679,394046317.0,2551,624,1871,148405421.0,245205045.0,118463,185665,0.12528,0.13207,304128,393610466.0,2495,2023-11-06 15:40:00
380,FEES,137,1121,27514288.0,147210823.0,22010,116849,0.12501,0.12598,138859,174725112.0,1258,104,1119,24316015.0,148437353.0,19482,117804,0.12481,0.126,137286,172753368.0,1223,2023-11-06 15:45:00
381,FEES,140,116,17348844.0,18858388.0,13856,14979,0.12521,0.1259,28835,36207232.0,256,109,90,16237673.0,17839775.0,12970,14139,0.12519,0.12617,27109,34077449.0,199,2023-11-06 15:50:00
382,FEES,154,96,20158949.0,14032436.0,16079,11069,0.12537,0.12677,27148,34191385.0,250,108,85,19132130.0,12711209.0,15326,10070,0.12483,0.12623,25396,31843339.0,193,2023-11-06 15:55:00
383,FEES,250,200,30224184.0,30617574.0,24077,24275,0.12553,0.12613,48352,60841759.0,450,202,171,27772114.0,27903023.0,22156,22109,0.12535,0.12621,44265,55675138.0,373,2023-11-06 16:00:00
384,FEES,263,271,56167962.0,53071049.0,44732,41931,0.12557,0.12657,86663,109239011.0,534,166,252,44428895.0,51095626.0,35504,40375,0.12514,0.12655,75879,95524521.0,418,2023-11-06 16:05:00
385,FEES,214,167,38458790.0,43017581.0,30657,34047,0.12545,0.12635,64704,81476371.0,381,178,153,42796747.0,49269272.0,34186,38842,0.12519,0.12685,73028,92066019.0,331,2023-11-06 16:10:00
386,FEES,517,442,80518343.0,76679611.0,64245,61073,0.12533,0.12555,125318,157197954.0,959,480,413,86039507.0,74635724.0,68647,59119,0.12534,0.12625,127766,160675231.0,893,2023-11-06 16:15:00
387,FEES,232,161,25245022.0,19565069.0,20055,15514,0.12588,0.12611,35569,44810092.0,393,188,145,27102355.0,19033624.0,18621,15094,0.14555,0.1261,33715,46135979.0,333,2023-11-06 16:20:00
388,FEES,224,132,24251362.0,20218036.0,19234,15999,0.12609,0.12637,35233,44469399.0,356,185,118,23216055.0,19488898.0,18513,15428,0.1254,0.12632,33941,42704953.0,303,2023-11-06 16:25:00
389,FEES,202,309,38377672.0,50952323.0,27543,40395,0.13934,0.12614,67938,89329995.0,511,179,289,33952824.0,49119225.0,27106,38944,0.12526,0.12613,66050,83072050.0,468,2023-11-06 16:30:00
390,FEES,131,164,21185542.0,21444876.0,16876,17016,0.12554,0.12603,33892,42630419.0,295,109,148,21374552.0,20948440.0,17046,16606,0.12539,0.12615,33652,42322993.0,257,2023-11-06 16:35:00
391,FEES,180,207,23581216.0,27687927.0,18812,21958,0.12535,0.12609,40770,51269143.0,387,147,191,22824397.0,26933565.0,18210,21354,0.12534,0.12613,39564,49757963.0,338,2023-11-06 16:40:00
392,FEES,251,389,32164485.0,30225258.0,25657,23987,0.12536,0.12601,49644,62389743.0,640,226,375,32593353.0,30284392.0,26008,24024,0.12532,0.12606,50032,62877745.0,601,2023-11-06 16:45:00
393,FEES,262,183,22268902.0,17365831.0,17747,13769,0.12548,0.12612,31516,39634733.0,445,235,177,21020857.0,17022027.0,16772,13497,0.12533,0.12612,30269,38042884.0,412,2023-11-06 16:50:00
394,FEES,387,351,19630934.0,33089451.0,15601,26267,0.12583,0.12597,41868,52720385.0,738,357,332,18786390.0,32037501.0,14991,25426,0.12532,0.126,40417,50823891.0,689,2023-11-06 16:55:00
395,FEES,302,66,12723624.0,10235844.0,10147,8104,0.12539,0.12631,18251,22959468.0,368,283,54,12626183.0,9381485.0,10067,7430,0.12542,0.12626,17497,22007669.0,337,2023-11-06 17:00:00
396,FEES,240,283,19958990.0,24528902.0,15925,19514,0.12533,0.1257,35439,44487893.0,523,190,262,18186429.0,23013749.0,14516,18256,0.12529,0.12606,32772,41200178.0,452,2023-11-06 17:05:00
397,FEES,271,453,21467690.0,34977688.0,17136,27820,0.12528,0.12573,44956,56445378.0,724,193,430,19563518.0,33263394.0,15626,26425,0.1252,0.12588,42051,52826912.0,623,2023-11-06 17:10:00
398,FEES,123,328,13983061.0,30154061.0,11141,23991,0.12551,0.12569,35132,44137123.0,451,97,308,15549440.0,29166227.0,12428,23162,0.12512,0.12592,35590,44715667.0,405,2023-11-06 17:15:00
399,FEES,326,106,12968789.0,9505221.0,10343,7544,0.12539,0.126,17887,22474011.0,432,306,90,11693580.0,9520463.0,9334,7561,0.12528,0.12592,16895,21214043.0,396,2023-11-06 17:20:00
400,FEES,374,204,21411605.0,19953635.0,16968,15838,0.12619,0.12599,32806,41365240.0,578,343,184,19491315.0,19276815.0,15536,15301,0.12546,0.12598,30837,38768131.0,527,2023-11-06 17:25:00
401,FEES,201,192,14060761.0,18500041.0,11195,14730,0.1256,0.12559,25925,32560803.0,393,180,171,13943135.0,17532388.0,11118,13912,0.12541,0.12602,25030,31475524.0,351,2023-11-06 17:30:00
402,FEES,204,112,25098213.0,17210016.0,19548,13637,0.12839,0.1262,33185,42308229.0,316,188,89,20589854.0,15787841.0,16399,12513,0.12556,0.12617,28912,36377695.0,277,2023-11-06 17:35:00
403,FEES,316,118,30769507.0,11443593.0,24300,9077,0.12662,0.12607,33377,42213100.0,434,285,96,29107005.0,11000386.0,23168,8717,0.12563,0.12619,31885,40107392.0,381,2023-11-06 17:40:00
404,FEES,248,175,25412056.0,17066368.0,20021,11932,0.12693,0.14303,31953,42478424.0,423,192,155,19823784.0,13475274.0,15787,10673,0.12557,0.12626,26460,33299059.0,347,2023-11-06 17:45:00
405,FEES,131,125,12645931.0,9074883.0,10045,7214,0.12589,0.1258,17259,21720814.0,256,84,109,9220362.0,8250775.0,7336,6533,0.12569,0.12629,13869,17471137.0,193,2023-11-06 17:50:00
406,FEES,244,129,24330631.0,12227486.0,19290,9755,0.12613,0.12535,29045,36558117.0,373,203,120,25128006.0,11732990.0,20001,9253,0.12563,0.1268,29254,36860996.0,323,2023-11-06 17:55:00
407,FEES,347,189,30554331.0,25612793.0,24322,20300,0.12562,0.12617,44622,56167124.0,536,317,181,31536951.0,27230306.0,25144,21564,0.12543,0.12628,46708,58767258.0,498,2023-11-06 18:00:00
408,FEES,347,181,47281678.0,24997070.0,37569,19823,0.12585,0.1261,57392,72278748.0,528,305,163,45935078.0,21871140.0,36543,17317,0.1257,0.1263,53860,67806218.0,468,2023-11-06 18:05:00
409,FEES,211,146,14906087.0,14038497.0,11838,11023,0.12592,0.12736,22861,28944584.0,357,172,122,13734153.0,10903402.0,10943,8640,0.12551,0.1262,19583,24637556.0,294,2023-11-06 18:10:00
410,FEES,83,54,5637124.0,4922158.0,4444,3854,0.12685,0.12772,8298,10559283.0,137,53,32,3559492.0,4936420.0,2830,3897,0.12578,0.12667,6727,8495912.0,85,2023-11-06 18:15:00
411,FEES,187,109,18802547.0,15248186.0,15186,12073,0.12382,0.1263,27259,34050733.0,296,158,90,15367899.0,14235143.0,12239,11261,0.12556,0.12641,23500,29603042.0,248,2023-11-06 18:20:00
412,FEES,202,106,16130851.0,11421299.0,12796,8975,0.12606,0.12726,21771,27552150.0,308,157,98,14585411.0,12636139.0,11610,9948,0.12563,0.12702,21558,27221550.0,255,2023-11-06 18:25:00
413,FEES,601,362,69043650.0,34213902.0,54541,27038,0.12659,0.12654,81579,103257553.0,963,535,338,66027990.0,32269762.0,52668,25531,0.12537,0.12639,78199,98297752.0,873,2023-11-06 18:30:00
414,FEES,542,501,45839048.0,34495148.0,36290,24907,0.12631,0.1385,61197,80334197.0,1043,487,453,43079082.0,26624727.0,34198,21075,0.12597,0.12633,55273,69703809.0,940,2023-11-06 18:35:00
415,FEES,357,339,40276081.0,39098448.0,31753,28575,0.12684,0.13683,60328,79374530.0,696,310,294,35610381.0,35764538.0,28270,25869,0.12597,0.13825,54139,71374920.0,604,2023-11-06 18:40:00
416,FEES,3832,2415,737502811.0,401286098.0,585228,313806,0.12602,0.12788,899034,1138788909.0,6247,3423,1897,701455079.0,349101291.0,557330,276699,0.12586,0.12617,834029,1050556371.0,5320,2023-11-07 10:05:00
417,FEES,905,866,140135547.0,150401545.0,112167,118992,0.12493,0.1264,231159,290537093.0,1771,695,768,127966010.0,137187006.0,102471,108278,0.12488,0.1267,210749,265153017.0,1463,2023-11-07 10:10:00
418,FEES,1276,1397,293614308.0,298855022.0,236201,236206,0.12431,0.12652,472407,592469330.0,2673,994,1273,276276158.0,289991958.0,222321,229049,0.12427,0.12661,451370,566268117.0,2267,2023-11-07 10:15:00
419,FEES,550,483,81741707.0,52028250.0,65814,41434,0.1242,0.12557,107248,133769957.0,1033,383,428,75661183.0,45616015.0,60952,36227,0.12413,0.12592,97179,121277198.0,811,2023-11-07 10:20:00
420,FEES,686,613,135536907.0,123673417.0,109046,98149,0.12429,0.12601,207195,259210324.0,1299,490,550,127302247.0,116661146.0,102582,92474,0.1241,0.12616,195056,243963394.0,1040,2023-11-07 10:25:00
421,FEES,1876,1902,545100358.0,437935410.0,442612,348888,0.12316,0.12552,791500,983035769.0,3778,1334,1582,485042426.0,406984042.0,392119,323765,0.1237,0.1257,715884,892026469.0,2916,2023-11-07 10:30:00
422,FEES,832,1115,195456340.0,230059381.0,157212,183672,0.12433,0.12526,340884,425515721.0,1947,587,1032,184564155.0,225037484.0,148508,179593,0.12428,0.1253,328101,409601639.0,1619,2023-11-07 10:35:00
423,FEES,450,293,111297048.0,71358621.0,86153,56932,0.12919,0.12534,143085,182655670.0,743,308,244,92550066.0,66046594.0,74398,52634,0.1244,0.12548,127032,158596660.0,552,2023-11-07 10:40:00
424,FEES,537,655,73968507.0,115796557.0,59302,92383,0.12473,0.12534,151685,189765064.0,1192,440,606,75540071.0,113735640.0,60633,90652,0.12459,0.12546,151285,189275711.0,1046,2023-11-07 10:45:00
425,FEES,678,693,124174120.0,153689896.0,99739,122751,0.1245,0.1252,222490,277864016.0,1371,543,632,118826702.0,143234093.0,95763,114243,0.12408,0.12538,210006,262060796.0,1175,2023-11-07 10:50:00
426,FEES,708,828,164820171.0,178311794.0,131879,142482,0.12498,0.12515,274361,343131966.0,1536,563,628,161227277.0,158866578.0,129815,126882,0.1242,0.12521,256697,320093856.0,1191,2023-11-07 10:55:00
427,FEES,1708,1743,399719721.0,443718879.0,323009,356134,0.12375,0.12459,679143,843438601.0,3451,1192,1464,378901338.0,431613931.0,303393,346042,0.12489,0.12473,649435,810515269.0,2656,2023-11-07 11:00:00
428,FEES,733,686,130716536.0,151858681.0,105327,121108,0.12411,0.12539,226435,282575218.0,1419,564,544,125614263.0,140660257.0,101289,112547,0.12402,0.12498,213836,266274521.0,1108,2023-11-07 11:05:00
429,FEES,659,622,115725070.0,140740194.0,93362,112733,0.12395,0.12484,206095,256465264.0,1281,503,592,111638695.0,134523013.0,90094,107712,0.12391,0.12489,197806,246161708.0,1095,2023-11-07 11:10:00
430,FEES,538,553,134026699.0,123402918.0,108260,98790,0.1238,0.12491,207050,257429617.0,1091,443,516,130841216.0,124030045.0,105701,99284,0.12378,0.12492,204985,254871261.0,959,2023-11-07 11:15:00
431,FEES,489,464,73832502.0,91048458.0,59690,72769,0.12369,0.12512,132459,164880961.0,953,384,420,68238299.0,84145857.0,55237,67199,0.12354,0.12522,122436,152384156.0,804,2023-11-07 11:20:00
432,FEES,438,346,70429874.0,85334126.0,56747,67977,0.12411,0.12553,124724,155764000.0,784,329,296,62077255.0,80686882.0,50187,64324,0.12369,0.12544,114511,142764137.0,625,2023-11-07 11:25:00
433,FEES,321,356,80178400.0,90532583.0,65018,72471,0.12332,0.12492,137489,170710984.0,677,241,321,76758482.0,84400857.0,62254,67265,0.1233,0.12548,129519,161159339.0,562,2023-11-07 11:30:00
434,FEES,971,953,238025919.0,235306193.0,190325,187375,0.12506,0.12558,377700,473332112.0,1924,866,805,219508008.0,228441071.0,177774,181883,0.12348,0.1256,359657,447949080.0,1671,2023-11-07 11:35:00
435,FEES,350,349,64960178.0,116707168.0,51075,91033,0.12719,0.1282,142108,181667347.0,699,291,277,64348912.0,92047285.0,50700,73263,0.12692,0.12564,123963,156396198.0,568,2023-11-07 11:40:00
436,FEES,506,366,135030398.0,77538233.0,109221,61813,0.12363,0.12544,171034,212568632.0,872,426,309,129971522.0,71783961.0,105266,57220,0.12347,0.12545,162486,201755483.0,735,2023-11-07 11:45:00
437,FEES,810,788,192271978.0,216089755.0,155086,171535,0.12398,0.12597,326621,408361733.0,1598,722,653,176124551.0,208682026.0,142067,165570,0.12397,0.12604,307637,384806578.0,1375,2023-11-07 11:50:00
438,FEES,696,601,138735802.0,132485583.0,111289,105108,0.12466,0.12605,216397,271221386.0,1297,640,503,138902469.0,126470884.0,111693,100292,0.12436,0.1261,211985,265373354.0,1143,2023-11-07 11:55:00
439,FEES,1012,919,251130782.0,242292595.0,201481,191885,0.12464,0.12627,393366,493423377.0,1931,920,803,236391196.0,233829443.0,189891,185174,0.12449,0.12628,375065,470220639.0,1723,2023-11-07 12:00:00
440,FEES,618,727,161504751.0,133091925.0,129780,105470,0.12445,0.12619,235250,294596676.0,1345,573,632,161472825.0,129664744.0,129853,102765,0.12435,0.12618,232618,291137569.0,1205,2023-11-07 12:05:00
441,FEES,749,1235,169004270.0,235887324.0,135091,186595,0.1251,0.12642,321686,404891594.0,1984,674,1119,161815883.0,231423556.0,129768,182949,0.1247,0.1265,312717,393239440.0,1793,2023-11-07 12:10:00
442,FEES,1534,1611,423722958.0,419847597.0,340066,331161,0.1246,0.12678,671227,843570555.0,3145,1416,1500,412499255.0,408841257.0,331485,324217,0.12444,0.1261,655702,821340512.0,2916,2023-11-07 12:15:00
443,FEES,570,964,123102706.0,151760855.0,98795,121251,0.1246,0.12516,220046,274863561.0,1534,514,925,120605633.0,146019692.0,96812,116358,0.12458,0.12549,213170,266625325.0,1439,2023-11-07 12:20:00
444,FEES,266,411,39407821.0,44640035.0,31634,35636,0.12457,0.12527,67270,84047857.0,677,226,391,41997075.0,44622469.0,33758,35594,0.12441,0.12537,69352,86619545.0,617,2023-11-07 12:25:00
445,FEES,364,463,70654522.0,74598634.0,56773,59773,0.12445,0.1248,116546,145253157.0,827,335,400,68931156.0,72103206.0,55396,57522,0.12443,0.12535,112918,141034363.0,735,2023-11-07 12:30:00
446,FEES,326,377,70825374.0,69749097.0,57007,53042,0.12424,0.1315,110049,140574471.0,703,255,313,63514495.0,62909022.0,51122,50246,0.12424,0.1252,101368,126423517.0,568,2023-11-07 12:35:00
447,FEES,493,804,121246158.0,126219687.0,97389,100555,0.1245,0.12552,197944,247465845.0,1297,429,754,121507697.0,123318839.0,97727,98439,0.12433,0.12527,196166,244826536.0,1183,2023-11-07 12:40:00
448,FEES,321,373,91713692.0,103292246.0,73989,79416,0.12396,0.13006,153405,195005939.0,694,293,335,94552859.0,101772711.0,76235,78222,0.12403,0.13011,154457,196325571.0,628,2023-11-07 12:45:00
449,FEES,334,341,61269946.0,63746002.0,49277,48032,0.12434,0.13272,97309,125015948.0,675,304,310,58997911.0,62988722.0,47480,47388,0.12426,0.13292,94868,121986633.0,614,2023-11-07 12:50:00
450,FEES,751,875,196219076.0,233184895.0,158578,182660,0.12374,0.12766,341238,429403972.0,1626,603,814,190454720.0,217356964.0,154193,171517,0.12352,0.12673,325710,407811685.0,1417,2023-11-07 12:55:00
451,FEES,501,632,103414378.0,89265177.0,83730,71393,0.12351,0.12503,155123,192679556.0,1133,451,611,101134737.0,88112854.0,81914,70446,0.12346,0.12508,152360,189247592.0,1062,2023-11-07 13:00:00
452,FEES,194,262,29647974.0,46202090.0,23915,32178,0.12397,0.14358,56093,75850064.0,456,173,225,31799119.0,39192743.0,25780,31245,0.12335,0.12544,57025,70991862.0,398,2023-11-07 13:05:00
453,FEES,177,187,29751853.0,19321640.0,24045,15466,0.12373,0.12493,39511,49073493.0,364,139,168,27608744.0,18351512.0,22325,14666,0.12367,0.12513,36991,45960257.0,307,2023-11-07 13:10:00
454,FEES,234,212,29145855.0,31015645.0,23360,24733,0.12477,0.1254,48093,60161501.0,446,209,200,28513764.0,30736610.0,23032,24508,0.1238,0.12541,47540,59250374.0,409,2023-11-07 13:15:00
455,FEES,321,223,61234474.0,49468194.0,49193,39424,0.12448,0.12548,88617,110702668.0,544,288,198,57700978.0,49012738.0,46635,39060,0.12373,0.12548,85695,106713717.0,486,2023-11-07 13:20:00
456,FEES,720,705,92712900.0,120462637.0,74655,96049,0.12419,0.12542,170704,213175538.0,1425,660,688,90782840.0,119794618.0,73176,95555,0.12406,0.12537,168731,210577459.0,1348,2023-11-07 13:25:00
457,FEES,285,419,57920365.0,65475801.0,46625,49445,0.12423,0.13242,96070,123396167.0,704,276,373,58012951.0,64271057.0,46788,48486,0.12399,0.13256,95274,122284008.0,649,2023-11-07 13:30:00
458,FEES,185,277,29108285.0,31870535.0,23402,25491,0.12438,0.12503,48893,60978820.0,462,151,248,26441090.0,30500986.0,21274,24321,0.12429,0.12541,45595,56942077.0,399,2023-11-07 13:35:00
459,FEES,565,413,92050693.0,75196779.0,74210,53565,0.12404,0.14038,127775,167247472.0,978,539,394,89915293.0,74247500.0,72519,52777,0.12399,0.14068,125296,164162794.0,933,2023-11-07 13:40:00
460,FEES,183,235,48096159.0,25722950.0,38842,20526,0.12383,0.12532,59368,73819110.0,418,155,209,46950356.0,24705962.0,37923,19709,0.1238,0.12535,57632,71656318.0,364,2023-11-07 13:45:00
461,FEES,291,275,43912188.0,27202407.0,35359,21685,0.12419,0.12544,57044,71114596.0,566,271,254,41303225.0,26259350.0,33272,20943,0.12414,0.12538,54215,67562576.0,525,2023-11-07 13:50:00
462,FEES,743,830,200855785.0,201006555.0,161640,160054,0.12426,0.12559,321694,401862341.0,1573,693,790,198601160.0,202038656.0,159868,160882,0.12423,0.12558,320750,400639816.0,1483,2023-11-07 13:55:00
463,FEES,580,1065,163492444.0,190304007.0,131734,150237,0.12411,0.12667,281971,353796451.0,1645,544,1033,163720029.0,190825868.0,131953,149264,0.12407,0.12784,281217,354545898.0,1577,2023-11-07 14:00:00
464,FEES,146,163,40736090.0,21917544.0,32925,14667,0.12372,0.14943,47592,62653634.0,309,132,147,37930067.0,21455495.0,30667,14266,0.12368,0.1504,44933,59385562.0,279,2023-11-07 14:05:00
465,FEES,276,644,51350252.0,62865950.0,41258,50251,0.12446,0.1251,91509,114216202.0,920,225,611,47270512.0,64489116.0,38106,51468,0.12405,0.1253,89574,111759628.0,836,2023-11-07 14:10:00
466,FEES,336,166,34801654.0,24982472.0,27942,19345,0.12455,0.12914,47287,59784126.0,502,310,148,33252471.0,24717168.0,26823,19631,0.12397,0.12591,46454,57969639.0,458,2023-11-07 14:15:00
467,FEES,303,462,118670132.0,103775366.0,95514,82787,0.12424,0.12535,178301,222445498.0,765,277,432,110249243.0,103231004.0,88810,82328,0.12414,0.12539,171138,213480247.0,709,2023-11-07 14:20:00
468,FEES,191,186,49789042.0,27825773.0,40089,22176,0.1242,0.12548,62265,77614815.0,377,178,169,47666735.0,27069109.0,38482,21543,0.12387,0.12565,60025,74735844.0,347,2023-11-07 14:25:00
469,FEES,992,518,122962428.0,121058665.0,98796,96269,0.12446,0.12575,195065,244021094.0,1510,955,470,120404670.0,119051962.0,96962,94650,0.12418,0.12578,191612,239456632.0,1425,2023-11-07 14:30:00
470,FEES,148,139,19111876.0,17545957.0,15300,14037,0.12491,0.125,29337,36657834.0,287,122,115,17288163.0,16945518.0,13898,13497,0.12439,0.12555,27395,34233682.0,237,2023-11-07 14:35:00
471,FEES,202,211,24266354.0,26957030.0,19517,21482,0.12433,0.12549,40999,51223384.0,413,192,168,24105932.0,24969156.0,19382,19858,0.12437,0.12574,39240,49075089.0,360,2023-11-07 14:40:00
472,FEES,332,485,61160638.0,105627879.0,49313,84214,0.12403,0.12543,133527,166788517.0,817,294,469,59099610.0,101796798.0,47689,80890,0.12393,0.12585,128579,160896408.0,763,2023-11-07 14:45:00
473,FEES,878,1080,193806031.0,252216634.0,155837,201430,0.12436,0.12521,357267,446022665.0,1958,833,1037,191577433.0,250673433.0,154079,200178,0.12434,0.12523,354257,442250866.0,1870,2023-11-07 14:50:00
474,FEES,546,450,71909123.0,114497389.0,57857,91490,0.12429,0.12515,149347,186406512.0,996,520,442,71103869.0,115812183.0,57229,92490,0.12424,0.12522,149719,186916052.0,962,2023-11-07 14:55:00
475,FEES,960,791,190179436.0,189498518.0,153535,150828,0.12387,0.12564,304363,379677955.0,1751,912,757,185041739.0,183827200.0,149388,146276,0.12387,0.12567,295664,368868940.0,1669,2023-11-07 15:00:00
476,FEES,146,400,18702484.0,47077030.0,15060,37512,0.12419,0.1255,52572,65779515.0,546,119,378,17340632.0,46668310.0,13979,37186,0.12405,0.1255,51165,64008942.0,497,2023-11-07 15:05:00
477,FEES,255,171,20116513.0,25995438.0,16183,20677,0.12431,0.12572,36860,46111951.0,426,247,162,20036661.0,26112270.0,16122,20754,0.12428,0.12582,36876,46148931.0,409,2023-11-07 15:10:00
478,FEES,76,151,12985583.0,27671037.0,10457,21984,0.12418,0.12587,32441,40656621.0,227,64,141,8483961.0,26315600.0,6821,20926,0.12438,0.12576,27747,34799561.0,205,2023-11-07 15:15:00
479,FEES,421,583,53766239.0,95521365.0,43194,75748,0.12448,0.1261,118942,149287604.0,1004,375,556,51810654.0,96864652.0,41713,76904,0.12421,0.12596,118617,148675306.0,931,2023-11-07 15:20:00
480,FEES,226,339,40066624.0,81553564.0,32263,64591,0.12419,0.12626,96854,121620189.0,565,184,313,39009097.0,80722699.0,31473,63941,0.12394,0.12625,95414,119731796.0,497,2023-11-07 15:25:00
481,FEES,534,263,66177351.0,47735410.0,53110,37915,0.1246,0.1259,91025,113912761.0,797,486,235,63179984.0,43954383.0,50897,34898,0.12413,0.12595,85795,107134368.0,721,2023-11-07 15:30:00
482,FEES,905,862,261856759.0,165592652.0,211173,132004,0.124,0.12545,343177,427449411.0,1767,818,830,256052746.0,164498938.0,206623,130798,0.12392,0.12577,337421,420551684.0,1648,2023-11-07 15:35:00
483,FEES,279,280,32085367.0,23409969.0,25897,18659,0.1239,0.12546,44556,55495337.0,559,246,257,30172151.0,22286849.0,24217,17765,0.12459,0.12545,41982,52459000.0,503,2023-11-07 15:40:00
484,FEES,308,307,53646269.0,53730288.0,42979,42761,0.12482,0.12565,85740,107376557.0,615,265,278,48544999.0,54369065.0,38925,43279,0.12471,0.12562,82204,102914064.0,543,2023-11-07 15:45:00
485,FEES,168,314,28941425.0,38948329.0,23259,30936,0.12443,0.1259,54195,67889754.0,482,148,289,28024139.0,43380471.0,22504,34138,0.12453,0.12707,56642,71404610.0,437,2023-11-07 15:50:00
486,FEES,247,276,19402050.0,27779351.0,15599,19825,0.12438,0.14012,35424,47181402.0,523,220,257,18416330.0,24422186.0,14821,19391,0.12426,0.12595,34212,42838517.0,477,2023-11-07 15:55:00
487,FEES,126,181,15275554.0,22944393.0,12232,18251,0.12488,0.12572,30483,38219947.0,307,92,152,13974613.0,20647300.0,11206,16424,0.12471,0.12571,27630,34621913.0,244,2023-11-07 16:00:00
488,FEES,389,414,68625517.0,53056593.0,54985,41831,0.12481,0.12684,96816,121682110.0,803,321,379,62275544.0,50165476.0,49972,39806,0.12462,0.12602,89778,112441021.0,700,2023-11-07 16:05:00
489,FEES,528,303,72791772.0,67531621.0,58267,53236,0.12493,0.12685,111503,140323394.0,831,484,254,77377527.0,68076334.0,62063,54007,0.12468,0.12605,116070,145453862.0,738,2023-11-07 16:10:00
490,FEES,600,509,85541138.0,95460745.0,68858,75313,0.12423,0.12675,144171,181001884.0,1109,543,427,77456493.0,79778607.0,62414,63109,0.1241,0.12641,125523,157235100.0,970,2023-11-07 16:15:00
491,FEES,260,290,36955599.0,40603993.0,29597,32098,0.12486,0.1265,61695,77559592.0,550,235,250,35103636.0,38544514.0,28288,30464,0.12409,0.12652,58752,73648150.0,485,2023-11-07 16:20:00
492,FEES,558,288,71306314.0,37180704.0,57184,29541,0.1247,0.12586,86725,108487018.0,846,526,252,69723447.0,34996069.0,55993,27735,0.12452,0.12618,83728,104719516.0,778,2023-11-07 16:25:00
493,FEES,124,151,18016562.0,19127047.0,14392,15173,0.12518,0.12606,29565,37143609.0,275,103,117,17533419.0,16326724.0,14013,12946,0.12512,0.12611,26959,33860143.0,220,2023-11-07 16:30:00
494,FEES,420,640,45016479.0,54394599.0,36057,43142,0.12485,0.12608,79199,99411079.0,1060,387,614,44070147.0,53146232.0,35342,42164,0.1247,0.12605,77506,97216379.0,1001,2023-11-07 16:35:00
495,FEES,601,210,72595475.0,48072590.0,57906,37977,0.12537,0.12658,95883,120668065.0,811,567,178,70028379.0,47653357.0,56016,37579,0.12501,0.12681,93595,117681737.0,745,2023-11-07 16:40:00
496,FEES,776,597,102436670.0,93998410.0,81897,74517,0.12508,0.12614,156414,196435080.0,1373,731,557,100404713.0,92604296.0,80307,73360,0.12503,0.12623,153667,193009009.0,1288,2023-11-07 16:45:00
497,FEES,324,248,40537744.0,36667000.0,32406,28979,0.12509,0.12653,61385,77204744.0,572,298,216,40726460.0,35926517.0,32588,28392,0.12497,0.12654,60980,76652977.0,514,2023-11-07 16:50:00
498,FEES,276,191,38553161.0,29795785.0,30742,23606,0.12541,0.12622,54348,68348947.0,467,251,171,35386761.0,30130322.0,28298,23469,0.12505,0.12838,51767,65517083.0,422,2023-11-07 16:55:00
499,FEES,309,258,38635925.0,36746776.0,30793,29072,0.12547,0.1264,59865,75382701.0,567,268,226,35883080.0,34485316.0,28668,27262,0.12517,0.1265,55930,70368397.0,494,2023-11-07 17:00:00
500,FEES,271,322,30797201.0,25155514.0,24560,19530,0.1254,0.1288,44090,55952715.0,593,219,274,27570916.0,24097977.0,22023,19089,0.12519,0.12624,41112,51668893.0,493,2023-11-07 17:05:00
501,FEES,390,490,54673727.0,74407207.0,43217,58558,0.12651,0.12707,101775,129080935.0,880,307,426,48880879.0,72242850.0,39059,56894,0.12515,0.12698,95953,121123730.0,733,2023-11-07 17:10:00
502,FEES,652,490,80383345.0,77808154.0,64131,61430,0.12534,0.12666,125561,158191500.0,1142,622,404,79491607.0,71035708.0,63428,55971,0.12533,0.12692,119399,150527315.0,1026,2023-11-07 17:15:00
503,FEES,285,251,26891356.0,22313606.0,21462,17650,0.1253,0.12642,39112,49204962.0,536,250,226,26484343.0,23803279.0,21145,18698,0.12525,0.1273,39843,50287623.0,476,2023-11-07 17:20:00
504,FEES,315,288,24648689.0,46850957.0,19601,36949,0.12575,0.1268,56550,71499647.0,603,257,267,30105417.0,47608263.0,24234,37539,0.12423,0.12682,61773,77713681.0,524,2023-11-07 17:25:00
505,FEES,313,473,34071156.0,47740132.0,27197,37758,0.12528,0.12644,64955,81811289.0,786,288,439,32885305.0,44086445.0,26256,34819,0.12525,0.12662,61075,76971750.0,727,2023-11-07 17:30:00
506,FEES,402,403,36727964.0,61193587.0,29338,48590,0.12519,0.12594,77928,97921552.0,805,313,349,33466288.0,57630002.0,26759,45562,0.12507,0.12649,72321,91096290.0,662,2023-11-07 17:35:00
507,FEES,274,463,36263055.0,51727453.0,28984,41203,0.12511,0.12554,70187,87990508.0,737,196,420,34920283.0,48950622.0,28044,38916,0.12452,0.12579,66960,83870905.0,616,2023-11-07 17:40:00
508,FEES,185,162,19962501.0,22641633.0,15971,17919,0.12499,0.12636,33890,42604134.0,347,145,131,17672242.0,19168192.0,14154,14782,0.12486,0.12967,28936,36840434.0,276,2023-11-07 17:45:00
509,FEES,335,284,38274210.0,36912391.0,30714,29294,0.12461,0.12601,60008,75186601.0,619,299,264,39009653.0,35661305.0,31296,28201,0.12465,0.12645,59497,74670958.0,563,2023-11-07 17:50:00
510,FEES,281,293,50992482.0,44826860.0,41268,35539,0.12356,0.12613,76807,95819342.0,574,214,278,35108002.0,43667531.0,28181,34566,0.12458,0.12633,62747,78775534.0,492,2023-11-07 17:55:00
511,FEES,232,244,25541870.0,27472385.0,20447,21798,0.12492,0.12603,42245,53014255.0,476,198,231,24357408.0,26129823.0,19538,20730,0.12467,0.12605,40268,50487231.0,429,2023-11-07 18:00:00
512,FEES,218,261,25309155.0,22144222.0,20236,17550,0.12507,0.12618,37786,47453378.0,479,183,227,23147078.0,20695963.0,18587,16401,0.12453,0.12619,34988,43843041.0,410,2023-11-07 18:05:00
513,FEES,157,210,22586899.0,35982593.0,18146,28435,0.12447,0.12654,46581,58569492.0,367,130,188,23237452.0,34938109.0,18673,27600,0.12444,0.12659,46273,58175562.0,318,2023-11-07 18:10:00
514,FEES,342,581,47255242.0,78000142.0,37707,61829,0.12532,0.12615,99536,125255385.0,923,291,545,41191816.0,73145057.0,33044,57931,0.12466,0.12626,90975,114336873.0,836,2023-11-07 18:15:00
515,FEES,196,771,40500057.0,132252466.0,32586,105200,0.12429,0.12572,137786,172752524.0,967,151,747,39063401.0,128985514.0,31427,102488,0.1243,0.12585,133915,168048916.0,898,2023-11-07 18:20:00
516,FEES,177,229,19452868.0,24181011.0,15612,19478,0.1246,0.12415,35090,43633880.0,406,144,211,16675929.0,20940072.0,13390,16629,0.12454,0.12593,30019,37616001.0,355,2023-11-07 18:25:00
517,FEES,1162,627,138912790.0,105065995.0,111261,83509,0.12485,0.12581,194770,243978785.0,1789,1112,598,135948983.0,101250154.0,109170,80448,0.12453,0.12586,189618,237199138.0,1710,2023-11-07 18:30:00
518,FEES,633,240,54122888.0,47074855.0,43221,37283,0.12522,0.12626,80504,101197744.0,873,593,214,50992833.0,45938439.0,40756,36284,0.12512,0.12661,77040,96931272.0,807,2023-11-07 18:35:00
519,FEES,404,301,30473096.0,26133397.0,24362,20877,0.12508,0.12518,45239,56606493.0,705,376,278,33990020.0,29845314.0,27240,23729,0.12478,0.12578,50969,63835334.0,654,2023-11-07 18:40:00
520,FEES,1453,2453,166833153.0,354133022.0,136077,279951,0.1226,0.1265,416028,520966175.0,3906,1209,2085,130633290.0,315481880.0,104401,251236,0.12513,0.12557,355637,446115171.0,3294,2023-11-08 10:05:00
521,FEES,770,862,100705009.0,128926869.0,80912,101874,0.12446,0.12656,182786,229631878.0,1632,687,801,91245434.0,118252336.0,73422,94005,0.12428,0.12579,167427,209497771.0,1488,2023-11-08 10:10:00
522,FEES,463,864,42534587.0,139151667.0,34155,110674,0.12453,0.12573,144829,181686254.0,1327,358,789,38125154.0,132420328.0,30597,105415,0.1246,0.12562,136012,170545482.0,1147,2023-11-08 10:15:00
523,FEES,970,1405,83068315.0,236846310.0,66737,188927,0.12447,0.12536,255664,319914626.0,2375,877,1351,79086699.0,234670938.0,63647,187006,0.12426,0.12549,250653,313757638.0,2228,2023-11-08 10:20:00
524,FEES,566,586,75358967.0,114494814.0,60643,91023,0.12427,0.12579,151666,189853782.0,1152,501,541,68818614.0,107209477.0,55425,85324,0.12417,0.12565,140749,176028092.0,1042,2023-11-08 10:25:00
525,FEES,930,1435,73934714.0,247353815.0,59189,197093,0.12491,0.1255,256282,321288529.0,2365,861,1334,75236347.0,245202796.0,60299,195335,0.12477,0.12553,255634,320439144.0,2195,2023-11-08 10:30:00
526,FEES,1033,1176,88479592.0,174106242.0,70925,138564,0.12475,0.12565,209489,262585834.0,2209,957,1133,85254632.0,170310982.0,68433,135697,0.12458,0.12551,204130,255565615.0,2090,2023-11-08 10:35:00
527,FEES,967,763,162849289.0,127684350.0,130162,101291,0.12511,0.12606,231453,290533640.0,1730,901,679,156231605.0,120962669.0,125197,95982,0.12479,0.12603,221179,277194275.0,1580,2023-11-08 10:40:00
528,FEES,946,472,117813768.0,51867434.0,94101,41203,0.1252,0.12588,135304,169681202.0,1418,894,438,113372233.0,50786818.0,90625,40339,0.1251,0.1259,130964,164159051.0,1332,2023-11-08 10:45:00
529,FEES,1413,868,233552624.0,101691188.0,186298,80556,0.12537,0.12624,266854,335243813.0,2281,1340,774,229302974.0,95381533.0,183133,75636,0.12521,0.12611,258769,324684507.0,2114,2023-11-08 10:50:00
530,FEES,1098,545,146774311.0,94171472.0,116871,74479,0.12559,0.12644,191350,240945783.0,1643,1047,464,145270505.0,92161241.0,115851,72904,0.12539,0.12641,188755,237431746.0,1511,2023-11-08 10:55:00
531,FEES,458,368,58753030.0,47416913.0,46807,37541,0.12552,0.12631,84348,106169943.0,826,416,284,62388122.0,43085590.0,49794,34096,0.12529,0.12637,83890,105473712.0,700,2023-11-08 11:00:00
532,FEES,596,257,65401915.0,57692366.0,52043,45581,0.12567,0.12657,97624,123094281.0,853,551,190,61613845.0,53136971.0,49086,42010,0.12552,0.12649,91096,114750817.0,741,2023-11-08 11:05:00
533,FEES,351,324,57958398.0,47703692.0,46295,37924,0.12519,0.12579,84219,105662090.0,675,312,275,54547358.0,44805849.0,43520,35460,0.12534,0.12636,78980,99353208.0,587,2023-11-08 11:10:00
534,FEES,817,350,119849552.0,73890387.0,95518,58556,0.12547,0.12619,154074,193739939.0,1167,754,292,116972307.0,70591881.0,93269,55887,0.12541,0.12631,149156,187564188.0,1046,2023-11-08 11:15:00
535,FEES,794,551,125830660.0,107775037.0,100000,85132,0.12583,0.1266,185132,233605698.0,1345,746,488,121820176.0,100256218.0,97033,79216,0.12555,0.12656,176249,222076395.0,1234,2023-11-08 11:20:00
536,FEES,485,316,72930120.0,50277376.0,57901,39804,0.12596,0.12631,97705,123207497.0,801,437,266,69470537.0,49530089.0,55397,39138,0.1254,0.12655,94535,119000626.0,703,2023-11-08 11:25:00
537,FEES,833,1098,152939389.0,158323014.0,121720,125297,0.12565,0.12636,247017,311262403.0,1931,740,1040,140041592.0,159581607.0,111601,126266,0.12548,0.12639,237867,299623200.0,1780,2023-11-08 11:30:00
538,FEES,987,822,127765374.0,117636568.0,101532,92975,0.12584,0.12652,194507,245401942.0,1809,843,730,123338249.0,105793776.0,98181,83607,0.12562,0.12654,181788,229132025.0,1573,2023-11-08 11:35:00
539,FEES,488,329,62089304.0,43416640.0,49324,34248,0.12588,0.12677,83572,105505944.0,817,428,257,59278947.0,37887930.0,47129,29905,0.12578,0.12669,77034,97166878.0,685,2023-11-08 11:40:00
540,FEES,1093,707,168474843.0,116649903.0,133450,92008,0.12625,0.12678,225458,285124747.0,1800,1000,533,159364872.0,108518640.0,126507,85465,0.12597,0.12697,211972,267883513.0,1533,2023-11-08 11:45:00
541,FEES,554,517,75752377.0,83015062.0,60126,65383,0.12599,0.12697,125509,158767440.0,1071,439,432,73479167.0,79734147.0,58327,62790,0.12598,0.12699,121117,153213315.0,871,2023-11-08 11:50:00
542,FEES,768,625,130157104.0,82382494.0,103331,64917,0.12596,0.1269,168248,212539598.0,1393,675,524,127029809.0,73255421.0,100855,57753,0.12595,0.12684,158608,200285230.0,1199,2023-11-08 11:55:00
543,FEES,385,443,68089794.0,61466850.0,53946,48565,0.12622,0.12657,102511,129556645.0,828,328,399,64851440.0,57678327.0,51544,45538,0.12582,0.12666,97082,122529768.0,727,2023-11-08 12:00:00
544,FEES,1162,914,134990107.0,101780661.0,107301,80689,0.12581,0.12614,187990,236770768.0,2076,1065,863,132268009.0,99354147.0,105209,78506,0.12572,0.12656,183715,231622156.0,1928,2023-11-08 12:05:00
545,FEES,506,431,89218930.0,67413125.0,71038,53372,0.12559,0.12631,124410,156632055.0,937,459,363,84950863.0,58223647.0,67639,46022,0.12559,0.12651,113661,143174510.0,822,2023-11-08 12:10:00
546,FEES,190,142,35232899.0,30648575.0,28086,24261,0.12545,0.12633,52347,65881474.0,332,141,124,31056468.0,25974840.0,24755,20529,0.12546,0.12653,45284,57031308.0,265,2023-11-08 12:15:00
547,FEES,232,195,36278620.0,36282357.0,28929,28666,0.12541,0.12657,57595,72560977.0,427,182,173,35467598.0,35175157.0,28283,27819,0.1254,0.12644,56102,70642756.0,355,2023-11-08 12:20:00
548,FEES,445,297,54913288.0,43286716.0,43373,34221,0.12661,0.12649,77594,98200004.0,742,419,264,50536670.0,40562886.0,40251,32051,0.12555,0.12656,72302,91099556.0,683,2023-11-08 12:25:00
549,FEES,244,142,40131588.0,22168058.0,32021,17550,0.12533,0.12631,49571,62299647.0,386,222,109,38441742.0,18856297.0,30661,14924,0.12538,0.12635,45585,57298040.0,331,2023-11-08 12:30:00
550,FEES,485,238,66719445.0,40096967.0,53262,31776,0.12527,0.12619,85038,106816412.0,723,459,203,66276314.0,39380177.0,52894,31097,0.1253,0.12664,83991,105656492.0,662,2023-11-08 12:35:00
551,FEES,394,627,46296461.0,58266629.0,36921,46278,0.12539,0.12591,83199,104563090.0,1021,366,606,45743595.0,57974818.0,36492,46034,0.12535,0.12594,82526,103718413.0,972,2023-11-08 12:40:00
552,FEES,253,294,27163653.0,34372384.0,21636,27161,0.12555,0.12655,48797,61536038.0,547,224,276,26691766.0,28694561.0,21269,22755,0.1255,0.1261,44024,55386328.0,500,2023-11-08 12:45:00
553,FEES,236,447,40613982.0,53763602.0,32414,42483,0.1253,0.12655,74897,94377584.0,683,211,405,39978717.0,52858007.0,31923,41767,0.12523,0.12655,73690,92836724.0,616,2023-11-08 12:50:00
554,FEES,516,272,70118528.0,37962414.0,55935,30039,0.12536,0.12638,85974,108080943.0,788,477,253,68315938.0,37080686.0,54508,29304,0.12533,0.12654,83812,105396624.0,730,2023-11-08 12:55:00
555,FEES,143,177,20694023.0,16377972.0,16493,12969,0.12547,0.12629,29462,37071995.0,320,117,158,19685735.0,15789119.0,15693,12495,0.12544,0.12636,28188,35474854.0,275,2023-11-08 13:00:00
556,FEES,969,569,154354615.0,71072113.0,122916,56102,0.12558,0.12668,179018,225426728.0,1538,923,525,135532159.0,71626347.0,108146,56492,0.12532,0.12679,164638,207158506.0,1448,2023-11-08 13:05:00
557,FEES,195,335,26227515.0,28265830.0,20906,22362,0.12545,0.1264,43268,54493346.0,530,174,321,25742088.0,27842274.0,20530,22028,0.12539,0.12639,42558,53584362.0,495,2023-11-08 13:10:00
558,FEES,435,407,66282480.0,63043049.0,52770,49735,0.12561,0.12676,102505,129325529.0,842,400,376,67314296.0,59411993.0,53611,46830,0.12556,0.12687,100441,126726290.0,776,2023-11-08 13:15:00
559,FEES,371,314,52928887.0,35432610.0,42229,28019,0.12534,0.12646,70248,88361498.0,685,330,287,49567733.0,34786471.0,39521,27497,0.12542,0.12651,67018,84354205.0,617,2023-11-08 13:20:00
560,FEES,331,227,64712072.0,41544786.0,51635,32747,0.12533,0.12687,84382,106256858.0,558,298,214,61309372.0,40523973.0,48952,31963,0.12524,0.12678,80915,101833346.0,512,2023-11-08 13:25:00
561,FEES,262,220,38389599.0,37406187.0,30526,29669,0.12576,0.12608,60195,75795786.0,482,242,188,38230146.0,36966133.0,30439,29208,0.1256,0.12656,59647,75196280.0,430,2023-11-08 13:30:00
562,FEES,547,787,79119927.0,150780383.0,63162,118715,0.12527,0.12701,181877,229900311.0,1334,517,747,77993179.0,148153182.0,62252,116402,0.12529,0.12728,178654,226146361.0,1264,2023-11-08 13:35:00
563,FEES,567,1101,77396555.0,101037780.0,61664,79746,0.12551,0.1267,141410,178434335.0,1668,529,1059,75539708.0,100082270.0,60289,78990,0.1253,0.1267,139279,175621979.0,1588,2023-11-08 13:40:00
564,FEES,299,230,43333529.0,36361926.0,34568,28773,0.12536,0.12638,63341,79695456.0,529,275,204,43015350.0,35047510.0,34345,27639,0.12524,0.1268,61984,78062861.0,479,2023-11-08 13:45:00
565,FEES,480,367,56723038.0,46256840.0,45203,37178,0.12549,0.12442,82381,102979879.0,847,436,348,54996004.0,41763971.0,43840,33060,0.12545,0.12633,76900,96759975.0,784,2023-11-08 13:50:00
566,FEES,523,920,63003267.0,118093370.0,50234,93908,0.12542,0.12575,144142,181096637.0,1443,458,870,78950458.0,113960876.0,62978,90234,0.12536,0.12629,153212,192911335.0,1328,2023-11-08 13:55:00
567,FEES,763,583,131456072.0,90035597.0,104846,71411,0.12538,0.12608,176257,221491669.0,1346,717,556,119088189.0,89141799.0,95003,70627,0.12535,0.12621,165630,208229988.0,1273,2023-11-08 14:00:00
568,FEES,808,191,92817879.0,36263691.0,74115,28551,0.12523,0.12701,102666,129081570.0,999,784,176,91696048.0,33915924.0,73200,26760,0.12527,0.12674,99960,125611973.0,960,2023-11-08 14:05:00
569,FEES,512,257,63742801.0,39059516.0,50718,30882,0.12568,0.12648,81600,102802317.0,769,478,231,61062833.0,36966700.0,48665,29228,0.12548,0.12648,77893,98029533.0,709,2023-11-08 14:10:00
570,FEES,904,431,112702983.0,64118094.0,89809,50670,0.12549,0.12654,140479,176821077.0,1335,847,381,108791698.0,62081056.0,86775,49014,0.12537,0.12666,135789,170872754.0,1228,2023-11-08 14:15:00
571,FEES,573,303,82561751.0,57204201.0,65741,45074,0.12559,0.12691,110815,139765952.0,876,539,263,81114889.0,56131451.0,64632,44214,0.1255,0.12695,108846,137246341.0,802,2023-11-08 14:20:00
572,FEES,354,112,45951228.0,21025547.0,36483,16495,0.12595,0.12747,52978,66976775.0,466,333,94,45093790.0,19215156.0,35852,15168,0.12578,0.12668,51020,64308946.0,427,2023-11-08 14:25:00
573,FEES,1111,664,234115694.0,156458185.0,186116,123020,0.12579,0.12718,309136,390573879.0,1775,1005,559,223421348.0,154868096.0,177877,121656,0.1256,0.1273,299533,378289444.0,1564,2023-11-08 14:30:00
574,FEES,498,476,89862780.0,85771532.0,71330,67356,0.12598,0.12734,138686,175634312.0,974,448,388,98631303.0,81470715.0,78358,63956,0.12587,0.12739,142314,180102018.0,836,2023-11-08 14:35:00
575,FEES,1064,580,212666737.0,112805090.0,168961,88883,0.12587,0.12691,257844,325471827.0,1644,1017,536,211598085.0,107621926.0,168110,84735,0.12587,0.12701,252845,319220012.0,1553,2023-11-08 14:40:00
576,FEES,1003,657,192495552.0,129214425.0,152931,101468,0.12587,0.12735,254399,321709977.0,1660,919,606,186993650.0,124953980.0,148722,98167,0.12573,0.12729,246889,311947630.0,1525,2023-11-08 14:45:00
577,FEES,360,287,55189276.0,62312882.0,43800,48983,0.126,0.12721,92783,117502158.0,647,324,272,50785254.0,61543366.0,40337,48335,0.1259,0.12733,88672,112328620.0,596,2023-11-08 14:50:00
578,FEES,583,469,116359749.0,86948155.0,92340,68250,0.12601,0.1274,160590,203307904.0,1052,544,371,109916805.0,80880729.0,87319,63474,0.12588,0.12742,150793,190797535.0,915,2023-11-08 14:55:00
579,FEES,1661,907,332251742.0,239163053.0,261250,186699,0.12718,0.1281,447949,571414795.0,2568,1449,717,313323877.0,226604348.0,247737,176827,0.12647,0.12815,424564,539928225.0,2166,2023-11-08 15:00:00
580,FEES,2129,1443,407903461.0,336420070.0,322268,263901,0.12657,0.12748,586169,744323532.0,3572,1977,1301,398354981.0,326212858.0,315634,255290,0.12621,0.12778,570924,724567839.0,3278,2023-11-08 15:05:00
581,FEES,1176,1322,254032756.0,258757613.0,201064,202927,0.12634,0.12751,403991,512790369.0,2498,1102,1239,245149558.0,250783362.0,194541,196562,0.12601,0.12758,391103,495932921.0,2341,2023-11-08 15:10:00
582,FEES,1300,994,248344914.0,166063215.0,195936,129937,0.12675,0.1278,325873,414408129.0,2294,1227,866,236208670.0,158070752.0,186589,123458,0.12659,0.12804,310047,394279423.0,2093,2023-11-08 15:15:00
583,FEES,863,910,158031540.0,102585278.0,124691,80776,0.12674,0.127,205467,260616818.0,1773,816,836,157677184.0,98070807.0,124476,76942,0.12667,0.12746,201418,255747992.0,1652,2023-11-08 15:20:00
584,FEES,1252,651,194324195.0,75979016.0,153352,59933,0.12672,0.12677,213285,270303211.0,1903,1170,605,192358121.0,67929997.0,151843,53346,0.12668,0.12734,205189,260288119.0,1775,2023-11-08 15:25:00
585,FEES,861,915,147589850.0,118532060.0,116716,93293,0.12645,0.12705,210009,266121911.0,1776,810,894,147155691.0,116212563.0,116383,91261,0.12644,0.12734,207644,263368254.0,1704,2023-11-08 15:30:00
586,FEES,273,231,39983258.0,26975852.0,31624,21193,0.12643,0.12729,52817,66959110.0,504,246,219,41133517.0,27390873.0,32570,21488,0.12629,0.12747,54058,68524390.0,465,2023-11-08 15:35:00
587,FEES,858,734,156236071.0,114614815.0,123093,90007,0.12693,0.12734,213100,270850887.0,1592,838,699,150734826.0,111478079.0,119096,87510,0.12657,0.12739,206606,262212905.0,1537,2023-11-08 15:40:00
588,FEES,440,434,59224910.0,71866966.0,46405,56302,0.12763,0.12765,102707,131091876.0,874,403,378,55164159.0,71118320.0,43523,55686,0.12675,0.12771,99209,126282480.0,781,2023-11-08 15:45:00
589,FEES,759,326,142081831.0,53038075.0,112021,41533,0.12683,0.1277,153554,195119906.0,1085,731,271,142265797.0,48031124.0,112132,37594,0.12687,0.12776,149726,190296921.0,1002,2023-11-08 15:50:00
590,FEES,1199,742,187097840.0,141658904.0,147893,110755,0.12651,0.1279,258648,328756744.0,1941,1071,664,181397074.0,139762749.0,143491,109131,0.12642,0.12807,252622,321159823.0,1735,2023-11-08 15:55:00
591,FEES,679,486,124100901.0,108294824.0,98019,84820,0.12661,0.12768,182839,232395726.0,1165,638,434,120998388.0,99553066.0,95600,78009,0.12657,0.12762,173609,220551455.0,1072,2023-11-08 16:00:00
592,FEES,794,535,162297750.0,110330792.0,128593,86489,0.12621,0.12757,215082,272628542.0,1329,724,518,161215839.0,110056027.0,127750,86220,0.1262,0.12765,213970,271271867.0,1242,2023-11-08 16:05:00
593,FEES,524,446,108515944.0,61092417.0,86119,48121,0.12601,0.12696,134240,169608361.0,970,482,424,106945839.0,59217827.0,84900,46479,0.12597,0.12741,131379,166163667.0,906,2023-11-08 16:10:00
594,FEES,838,751,133866134.0,133185572.0,105963,104374,0.12633,0.1276,210337,267051707.0,1589,783,721,131591988.0,130678538.0,104272,102444,0.1262,0.12756,206716,262270527.0,1504,2023-11-08 16:15:00
595,FEES,494,330,48445596.0,83737610.0,38245,65351,0.12667,0.12814,103596,132183207.0,824,458,304,47136230.0,82593775.0,37280,64427,0.12644,0.1282,101707,129730006.0,762,2023-11-08 16:20:00
596,FEES,915,724,134784864.0,101348688.0,106763,79541,0.12625,0.12742,186304,236133552.0,1639,883,684,133840514.0,98734029.0,106018,77405,0.12624,0.12756,183423,232574543.0,1567,2023-11-08 16:25:00
597,FEES,417,329,62911507.0,43533054.0,49929,34227,0.126,0.12719,84156,106444561.0,746,379,303,56663778.0,44336621.0,45004,34836,0.12591,0.12727,79840,101000400.0,682,2023-11-08 16:30:00
598,FEES,390,481,59997153.0,85484021.0,47649,66987,0.12591,0.12761,114636,145481174.0,871,352,441,60492279.0,84922053.0,48061,66550,0.12587,0.12761,114611,145414333.0,793,2023-11-08 16:35:00
599,FEES,1094,728,137005765.0,215317136.0,108506,168076,0.12627,0.12811,276582,352322901.0,1822,1071,658,135223162.0,213596729.0,107153,166725,0.1262,0.12811,273878,348819891.0,1729,2023-11-08 16:40:00
600,FEES,328,339,55712411.0,60976951.0,44220,46159,0.12599,0.1321,90379,116689362.0,667,287,279,54617589.0,57878408.0,43346,45441,0.126,0.12737,88787,112495997.0,566,2023-11-08 16:45:00
601,FEES,846,839,121583999.0,268211971.0,96328,209544,0.12622,0.128,305872,389795970.0,1685,760,780,119108665.0,267475420.0,94395,208963,0.12618,0.128,303358,386584086.0,1540,2023-11-08 16:50:00
602,FEES,615,666,92534962.0,272964007.0,73272,213229,0.12629,0.12801,286501,365498970.0,1281,593,621,92387185.0,272112289.0,73168,212597,0.12627,0.12799,285765,364499475.0,1214,2023-11-08 16:55:00
603,FEES,745,869,137445461.0,148058446.0,109069,116355,0.12602,0.12725,225424,285503907.0,1614,696,804,135699362.0,143779559.0,107681,112847,0.12602,0.12741,220528,279478921.0,1500,2023-11-08 17:00:00
604,FEES,318,233,42825160.0,18248894.0,34035,14417,0.12583,0.12658,48452,61074054.0,551,288,194,41318006.0,18654341.0,32836,14681,0.12583,0.12706,47517,59972347.0,482,2023-11-08 17:05:00
605,FEES,234,335,49502676.0,62139007.0,39460,48896,0.12545,0.12708,88356,111641684.0,569,198,295,48525826.0,60184684.0,38699,47299,0.12539,0.12724,85998,108710511.0,493,2023-11-08 17:10:00
606,FEES,676,438,124897195.0,73953397.0,99005,58064,0.12615,0.12737,157069,198850592.0,1114,643,389,116884897.0,71404849.0,92699,56117,0.12609,0.12724,148816,188289746.0,1032,2023-11-08 17:15:00
607,FEES,305,461,41819421.0,38309323.0,32570,30132,0.1284,0.12714,62702,80128744.0,766,278,432,41947242.0,38584567.0,33285,30339,0.12602,0.12718,63624,80531810.0,710,2023-11-08 17:20:00
608,FEES,281,239,33593977.0,24233011.0,26676,18816,0.12593,0.12879,45492,57826988.0,520,251,218,32981048.0,22830869.0,26206,17753,0.12585,0.1286,43959,55811918.0,469,2023-11-08 17:25:00
609,FEES,93,130,13736305.0,19314206.0,10897,15158,0.12606,0.12742,26055,33050511.0,223,96,123,14094774.0,19210294.0,11224,15034,0.12558,0.12778,26258,33305068.0,219,2023-11-08 17:30:00
610,FEES,344,409,48966730.0,44070792.0,38767,34686,0.12631,0.12706,73453,93037522.0,753,309,394,48194307.0,43451383.0,38200,34162,0.12616,0.12719,72362,91645690.0,703,2023-11-08 17:35:00
611,FEES,147,101,29853238.0,11956695.0,23656,9413,0.1262,0.12702,33069,41809934.0,248,142,83,30120034.0,11433056.0,23890,8953,0.12608,0.1277,32843,41553090.0,225,2023-11-08 17:40:00
612,FEES,101,56,12239936.0,7461405.0,9677,5889,0.12648,0.1267,15566,19701342.0,157,88,50,11678677.0,7314683.0,9256,5754,0.12617,0.12712,15010,18993361.0,138,2023-11-08 17:45:00
613,FEES,144,79,31695768.0,3867470.0,25085,3054,0.12635,0.12664,28139,35563238.0,223,131,63,31469290.0,4088456.0,24910,3222,0.12633,0.12689,28132,35557746.0,194,2023-11-08 17:50:00
614,FEES,112,71,20086746.0,13883643.0,15898,10942,0.12635,0.12688,26840,33970389.0,183,90,65,19895412.0,11389277.0,15749,8970,0.12633,0.12697,24719,31284689.0,155,2023-11-08 17:55:00
615,FEES,616,531,104012143.0,36847720.0,82277,29084,0.12642,0.12669,111361,140859864.0,1147,594,529,108258675.0,40699840.0,85716,32086,0.1263,0.12685,117802,148958515.0,1123,2023-11-08 18:00:00
616,FEES,424,215,38090970.0,17287366.0,30097,13645,0.12656,0.12669,43742,55378337.0,639,415,197,36399683.0,17320032.0,28812,13637,0.12634,0.12701,42449,53719716.0,612,2023-11-08 18:05:00
617,FEES,399,177,36458771.0,22270494.0,28723,17569,0.12693,0.12676,46292,58729265.0,576,319,151,31892904.0,21424213.0,25226,16855,0.12643,0.12711,42081,53317117.0,470,2023-11-08 18:10:00
618,FEES,817,1172,80891350.0,133213697.0,63959,105332,0.12647,0.12647,169291,214105047.0,1989,736,1143,78047532.0,128390545.0,61728,101133,0.12644,0.12695,162861,206438077.0,1879,2023-11-08 18:15:00
619,FEES,370,262,38072546.0,33430199.0,30120,26270,0.1264,0.12726,56390,71502745.0,632,345,247,37884989.0,31640902.0,29986,24935,0.12634,0.12689,54921,69525891.0,592,2023-11-08 18:20:00
620,FEES,227,523,13316652.0,61435440.0,10519,48433,0.1266,0.12685,58952,74752093.0,750,193,514,12825156.0,60926025.0,10154,48028,0.12631,0.12686,58182,73751182.0,707,2023-11-08 18:25:00
621,FEES,272,185,19566006.0,61437939.0,15472,14917,0.12646,0.41187,30389,81003946.0,457,233,173,20203517.0,17378580.0,15982,13700,0.12641,0.12685,29682,37582097.0,406,2023-11-08 18:30:00
622,FEES,451,320,29536294.0,30323798.0,23360,23865,0.12644,0.12706,47225,59860093.0,771,400,308,24831941.0,30856432.0,19640,24245,0.12644,0.12727,43885,55688373.0,708,2023-11-08 18:35:00
623,FEES,208,448,18458811.0,32846019.0,14568,25944,0.12671,0.1266,40512,51304830.0,656,182,425,17734220.0,31180482.0,14017,24573,0.12652,0.12689,38590,48914702.0,607,2023-11-08 18:40:00
624,FEES,932,1665,115872635.0,227936118.0,94633,177018,0.12244,0.12876,271651,343808753.0,2597,699,1261,71881685.0,184082924.0,56990,145122,0.12613,0.12685,202112,255964610.0,1960,2023-11-09 10:05:00
625,FEES,1442,4525,186064617.0,776004028.0,147767,612495,0.12592,0.1267,760262,962068645.0,5967,1312,4411,178531879.0,763631001.0,141802,602689,0.1259,0.1267,744491,942162880.0,5723,2023-11-09 10:10:00
626,FEES,691,1408,80774655.0,149462614.0,64411,118134,0.12541,0.12652,182545,230237270.0,2099,577,1263,73301897.0,143370389.0,58432,113202,0.12545,0.12665,171634,216672287.0,1840,2023-11-09 10:15:00
627,FEES,1226,3348,154659792.0,608729222.0,123371,482549,0.12536,0.12615,605920,763389015.0,4574,1029,3230,150762433.0,601504027.0,120613,476186,0.125,0.12632,596799,752266460.0,4259,2023-11-09 10:20:00
628,FEES,1077,3490,132892858.0,707115616.0,107063,561244,0.12413,0.12599,668307,840008475.0,4567,958,3423,121556101.0,701571343.0,97419,556894,0.12478,0.12598,654313,823127444.0,4381,2023-11-09 10:25:00
629,FEES,499,370,53486753.0,70775075.0,42606,55946,0.12554,0.12651,98552,124261828.0,869,433,341,52663435.0,70251816.0,42063,55550,0.1252,0.12647,97613,122915251.0,774,2023-11-09 10:30:00
630,FEES,1024,629,85475019.0,82588370.0,68014,65203,0.12567,0.12666,133217,168063389.0,1653,923,541,80652780.0,78965076.0,64299,62413,0.12543,0.12652,126712,159617857.0,1464,2023-11-09 10:35:00
631,FEES,542,359,41284323.0,47620223.0,32800,37484,0.12587,0.12704,70284,88904546.0,901,495,323,39515450.0,44934203.0,31420,35463,0.12577,0.12671,66883,84449654.0,818,2023-11-09 10:40:00
632,FEES,630,856,56809848.0,119952016.0,45242,94977,0.12557,0.1263,140219,176761865.0,1486,584,811,54553159.0,117977322.0,43447,93251,0.12556,0.12652,136698,172530481.0,1395,2023-11-09 10:45:00
633,FEES,278,416,27002154.0,39594394.0,21532,31329,0.1254,0.12638,52861,66596548.0,694,237,387,25883711.0,39028274.0,20660,30836,0.12528,0.12657,51496,64911986.0,624,2023-11-09 10:50:00
634,FEES,561,2370,44819907.0,378475582.0,35686,300030,0.1256,0.12615,335716,423295489.0,2931,523,2356,42634356.0,377863941.0,33965,299520,0.12552,0.12616,333485,420498297.0,2879,2023-11-09 10:55:00
635,FEES,614,1061,84781565.0,162123958.0,67628,128482,0.12536,0.12618,196110,246905523.0,1675,558,1019,81280988.0,159469849.0,64827,126309,0.12538,0.12625,191136,240750837.0,1577,2023-11-09 11:00:00
636,FEES,585,697,75688292.0,96228241.0,60481,76202,0.12514,0.12628,136683,171916533.0,1282,528,658,68757470.0,93273080.0,54869,73870,0.12531,0.12627,128739,162030550.0,1186,2023-11-09 11:05:00
637,FEES,501,768,71415182.0,105003585.0,57072,83415,0.12513,0.12588,140487,176418767.0,1269,418,727,68279276.0,104748883.0,54560,83012,0.12515,0.12619,137572,173028160.0,1145,2023-11-09 11:10:00
638,FEES,771,1666,116127358.0,228263223.0,92705,181353,0.12527,0.12587,274058,344390581.0,2437,699,1589,118503690.0,223854268.0,94625,177704,0.12524,0.12597,272329,342357959.0,2288,2023-11-09 11:15:00
639,FEES,743,1015,105716694.0,141797130.0,85385,112329,0.12381,0.12623,197714,247513825.0,1758,658,954,99969300.0,133912046.0,80555,106060,0.1241,0.12626,186615,233881347.0,1612,2023-11-09 11:20:00
640,FEES,444,343,53107729.0,42669802.0,42618,33849,0.12461,0.12606,76467,95777531.0,787,413,298,52598184.0,41794287.0,42284,33147,0.12439,0.12609,75431,94392471.0,711,2023-11-09 11:25:00
641,FEES,717,951,128857574.0,181307303.0,104578,143406,0.12322,0.12643,247984,310164878.0,1668,646,886,125684611.0,179539626.0,102065,141799,0.12314,0.12662,243864,305224237.0,1532,2023-11-09 11:30:00
642,FEES,885,1042,118812032.0,163038749.0,97632,129634,0.12169,0.12577,227266,281850781.0,1927,825,965,116085003.0,160132079.0,95493,127111,0.12156,0.12598,222604,276217082.0,1790,2023-11-09 11:35:00
643,FEES,937,989,122227077.0,129375911.0,97622,102606,0.1252,0.12609,200228,251602989.0,1926,855,941,120152365.0,126974961.0,96003,100674,0.12515,0.12612,196677,247127327.0,1796,2023-11-09 11:40:00
644,FEES,283,157,36785823.0,25932307.0,29414,20578,0.12506,0.12602,49992,62718130.0,440,251,134,36239661.0,25772756.0,28990,20431,0.12501,0.12615,49421,62012417.0,385,2023-11-09 11:45:00
645,FEES,740,273,70835230.0,48498634.0,56717,38457,0.12489,0.12611,95174,119333865.0,1013,702,250,73626662.0,47459463.0,59023,37560,0.12474,0.12636,96583,121086125.0,952,2023-11-09 11:50:00
646,FEES,316,432,29373794.0,50825878.0,23615,40111,0.12439,0.12671,63726,80199673.0,748,268,423,25759540.0,50212625.0,20573,39881,0.12521,0.12591,60454,75972165.0,691,2023-11-09 11:55:00
647,FEES,705,650,182206515.0,103547253.0,146434,82384,0.12443,0.12569,228818,285753769.0,1355,661,633,180300814.0,99422479.0,144912,78905,0.12442,0.126,223817,279723293.0,1294,2023-11-09 12:00:00
648,FEES,197,224,35221776.0,38841173.0,28152,30787,0.12511,0.12616,58939,74062950.0,421,172,206,33410714.0,37021930.0,26762,29337,0.12484,0.1262,56099,70432644.0,378,2023-11-09 12:05:00
649,FEES,897,813,185244923.0,184393140.0,147801,146198,0.12533,0.12613,293999,369638063.0,1710,820,735,175361785.0,182238678.0,139991,144455,0.12527,0.12616,284446,357600463.0,1555,2023-11-09 12:10:00
650,FEES,1636,674,328862170.0,75398067.0,261442,59745,0.12579,0.1262,321187,404260237.0,2310,1581,627,327686890.0,68694207.0,260519,54313,0.12578,0.12648,314832,396381097.0,2208,2023-11-09 12:15:00
651,FEES,721,513,90103507.0,66872309.0,71900,52922,0.12532,0.12636,124822,156975817.0,1234,662,486,88551961.0,65644860.0,70657,51982,0.12533,0.12628,122639,154196822.0,1148,2023-11-09 12:20:00
652,FEES,344,361,23040840.0,23567418.0,18382,18659,0.12534,0.12631,37041,46608259.0,705,308,349,25617319.0,24621702.0,20625,19483,0.12421,0.12638,40108,50239021.0,657,2023-11-09 12:25:00
653,FEES,177,306,20242485.0,20115059.0,16123,15893,0.12555,0.12657,32016,40357544.0,483,152,291,19888678.0,18492600.0,15854,14619,0.12545,0.1265,30473,38381279.0,443,2023-11-09 12:30:00
654,FEES,284,261,33921644.0,38224766.0,27014,30137,0.12557,0.12684,57151,72146411.0,545,264,241,34780323.0,37437181.0,27731,29529,0.12542,0.12678,57260,72217505.0,505,2023-11-09 12:35:00
655,FEES,648,345,74877403.0,37656308.0,60040,29743,0.12471,0.12661,89783,112533711.0,993,597,330,69394769.0,37513901.0,55445,29614,0.12516,0.12668,85059,106908670.0,927,2023-11-09 12:40:00
656,FEES,413,359,46276924.0,24519288.0,37001,19437,0.12507,0.12615,56438,70796212.0,772,378,337,46145035.0,24749377.0,36907,19618,0.12503,0.12616,56525,70894413.0,715,2023-11-09 12:45:00
657,FEES,640,459,62142182.0,46085247.0,49622,36461,0.12523,0.1264,86083,108227429.0,1099,595,436,61885399.0,45662848.0,49442,36116,0.12517,0.12643,85558,107548247.0,1031,2023-11-09 12:50:00
658,FEES,787,513,115536526.0,53120262.0,92100,41931,0.12545,0.12668,134031,168656789.0,1300,752,477,115106395.0,52689085.0,91774,41535,0.12542,0.12685,133309,167795480.0,1229,2023-11-09 12:55:00
659,FEES,596,341,115804358.0,49656842.0,99634,39174,0.11623,0.12676,138808,165461201.0,937,571,317,109923801.0,47178132.0,94293,37256,0.11658,0.12663,131549,157101933.0,888,2023-11-09 13:00:00
660,FEES,663,610,68111419.0,72602686.0,54320,57567,0.12539,0.12612,111887,140714106.0,1273,637,596,67680884.0,72035811.0,54009,57090,0.12531,0.12618,111099,139716696.0,1233,2023-11-09 13:05:00
661,FEES,703,499,102481903.0,84871452.0,82058,67519,0.12489,0.1257,149577,187353356.0,1202,653,473,98452863.0,81663547.0,78923,64709,0.12475,0.1262,143632,180116411.0,1126,2023-11-09 13:10:00
662,FEES,583,384,63780501.0,62037638.0,51039,49094,0.12496,0.12637,100133,125818139.0,967,532,357,62399075.0,61420793.0,49956,48617,0.12491,0.12634,98573,123819868.0,889,2023-11-09 13:15:00
663,FEES,146,97,23389059.0,15897234.0,18691,12553,0.12514,0.12664,31244,39286294.0,243,131,81,23058880.0,15316790.0,18456,12086,0.12494,0.12673,30542,38375670.0,212,2023-11-09 13:20:00
664,FEES,289,224,26421516.0,15182128.0,21099,12038,0.12523,0.12612,33137,41603644.0,513,273,217,25955659.0,15270455.0,20702,12109,0.12538,0.12611,32811,41226114.0,490,2023-11-09 13:25:00
665,FEES,519,248,49070574.0,48248534.0,39236,38205,0.12507,0.12629,77441,97319109.0,767,487,229,47796120.0,47094302.0,38224,37174,0.12504,0.12669,75398,94890422.0,716,2023-11-09 13:30:00
666,FEES,612,527,62200034.0,36636367.0,49667,29107,0.12523,0.12587,78774,98836401.0,1139,590,514,60870333.0,36062829.0,48678,28617,0.12505,0.12602,77295,96933162.0,1104,2023-11-09 13:35:00
667,FEES,404,414,49525464.0,53548890.0,39611,42428,0.12503,0.12621,82039,103074355.0,818,379,390,48012726.0,52520451.0,38456,41546,0.12485,0.12642,80002,100533177.0,769,2023-11-09 13:40:00
668,FEES,161,245,26361155.0,31601702.0,20992,25003,0.12558,0.12639,45995,57962858.0,406,145,230,25486937.0,31427390.0,20392,24867,0.12498,0.12638,45259,56914327.0,375,2023-11-09 13:45:00
669,FEES,530,459,45173084.0,65467194.0,36144,51907,0.12498,0.12612,88051,110640279.0,989,512,440,45445393.0,63761933.0,36357,50539,0.125,0.12616,86896,109207326.0,952,2023-11-09 13:50:00
670,FEES,350,242,38632070.0,26718070.0,30890,21126,0.12506,0.12647,52016,65350141.0,592,327,229,38165264.0,26731858.0,30513,21141,0.12508,0.12645,51654,64897123.0,556,2023-11-09 13:55:00
671,FEES,268,213,34829931.0,31124815.0,27728,24590,0.12561,0.12658,52318,65954746.0,481,272,212,41196832.0,37391819.0,32903,29577,0.12521,0.12642,62480,78588652.0,484,2023-11-09 14:00:00
672,FEES,2780,1103,629246986.0,77071606.0,501620,61156,0.12544,0.12602,562776,706318593.0,3883,2752,1029,628323621.0,76501142.0,500962,60671,0.12542,0.12609,561633,704824764.0,3781,2023-11-09 14:05:00
673,FEES,582,546,58946502.0,43797929.0,47028,34757,0.12534,0.12601,81785,102744431.0,1128,556,522,58641527.0,41565045.0,46791,32971,0.12533,0.12607,79762,100206573.0,1078,2023-11-09 14:10:00
674,FEES,464,626,88473308.0,89055275.0,70916,70532,0.12476,0.12626,141448,177528583.0,1090,429,592,80711420.0,81996219.0,64736,64953,0.12468,0.12624,129689,162707640.0,1021,2023-11-09 14:15:00
675,FEES,173,243,14916933.0,19480822.0,11893,15453,0.12543,0.12606,27346,34397755.0,416,143,231,14545489.0,19289717.0,11614,15302,0.12524,0.12606,26916,33835206.0,374,2023-11-09 14:20:00
676,FEES,373,377,41688467.0,57372529.0,33272,45457,0.1253,0.12621,78729,99060996.0,750,340,358,41038836.0,56740842.0,32792,44892,0.12515,0.12639,77684,97779679.0,698,2023-11-09 14:25:00
677,FEES,310,135,20625310.0,20314483.0,16443,16061,0.12544,0.12648,32504,40939794.0,445,290,121,19820419.0,19919000.0,15841,15768,0.12512,0.12633,31609,39739420.0,411,2023-11-09 14:30:00
678,FEES,822,333,60527059.0,22762456.0,48255,18039,0.12543,0.12618,66294,83289515.0,1155,791,328,58786224.0,23920314.0,46887,18945,0.12538,0.12626,65832,82706538.0,1119,2023-11-09 14:35:00
679,FEES,331,462,37598682.0,36669311.0,30007,29112,0.1253,0.12596,59119,74267993.0,793,312,448,37613763.0,36194729.0,30017,28696,0.12531,0.12613,58713,73808492.0,760,2023-11-09 14:40:00
680,FEES,288,489,59771157.0,52640581.0,46391,41809,0.12884,0.12591,88200,112411738.0,777,262,462,56261029.0,49970101.0,44996,39586,0.12504,0.12623,84582,106231131.0,724,2023-11-09 14:45:00
681,FEES,340,310,40198189.0,54261605.0,32045,42873,0.12544,0.12656,74918,94459794.0,650,289,291,38725423.0,52427847.0,30921,41448,0.12524,0.12649,72369,91153270.0,580,2023-11-09 14:50:00
682,FEES,304,371,56147590.0,74403128.0,44536,58740,0.12607,0.12667,103276,130550718.0,675,275,330,54725079.0,72701818.0,43692,57389,0.12525,0.12668,101081,127426897.0,605,2023-11-09 14:55:00
683,FEES,390,227,37018232.0,28273014.0,29450,22307,0.1257,0.12675,51757,65291246.0,617,374,207,37381273.0,27140370.0,29773,21430,0.12555,0.12665,51203,64521643.0,581,2023-11-09 15:00:00
684,FEES,514,455,57791518.0,40390063.0,46008,31908,0.12561,0.12658,77916,98181581.0,969,468,428,57525032.0,39463172.0,45394,31157,0.12672,0.12666,76551,96988204.0,896,2023-11-09 15:05:00
685,FEES,252,160,28991740.0,29410746.0,23071,23239,0.12566,0.12656,46310,58402486.0,412,219,151,27821157.0,28682700.0,22170,22670,0.12549,0.12652,44840,56503857.0,370,2023-11-09 15:10:00
686,FEES,179,246,17266806.0,14323764.0,13705,11296,0.12599,0.1268,25001,31590570.0,425,162,223,16611513.0,13829177.0,13233,10937,0.12553,0.12644,24170,30440691.0,385,2023-11-09 15:15:00
687,FEES,647,344,66073237.0,55542602.0,52638,43953,0.12552,0.12637,96591,121615839.0,991,615,328,65081239.0,54545498.0,51856,43115,0.1255,0.12651,94971,119626738.0,943,2023-11-09 15:20:00
688,FEES,96,124,11389123.0,12130062.0,9070,9598,0.12557,0.12638,18668,23519186.0,220,73,111,10407621.0,11566659.0,8295,9150,0.12547,0.12641,17445,21974280.0,184,2023-11-09 15:25:00
689,FEES,363,389,62319750.0,28922853.0,49618,22896,0.1256,0.12632,72514,91242604.0,752,336,376,57992019.0,27903836.0,46160,22088,0.12563,0.12633,68248,85895855.0,712,2023-11-09 15:30:00
690,FEES,189,165,42823649.0,13968865.0,34168,11048,0.12533,0.12644,45216,56792515.0,354,171,127,46599500.0,13345192.0,37200,10553,0.12527,0.12646,47753,59944692.0,298,2023-11-09 15:35:00
691,FEES,300,213,49387049.0,22509455.0,39391,17827,0.12538,0.12627,57218,71896504.0,513,276,190,48402084.0,21208834.0,38616,16787,0.12534,0.12634,55403,69610918.0,466,2023-11-09 15:40:00
692,FEES,63,69,6646671.0,6603084.0,5299,5215,0.12543,0.12662,10514,13249755.0,132,46,83,5131597.0,6303381.0,4089,4977,0.1255,0.12665,9066,11434979.0,129,2023-11-09 15:45:00
693,FEES,322,450,51021625.0,54901447.0,40692,43784,0.12538,0.12539,84476,105923073.0,772,278,422,49224668.0,52028555.0,39253,41209,0.1254,0.12626,80462,101253224.0,700,2023-11-09 15:50:00
694,FEES,420,483,50642837.0,65684554.0,40377,52115,0.12542,0.12604,92492,116327391.0,903,347,469,49822727.0,64884092.0,39752,51457,0.12533,0.12609,91209,114706819.0,816,2023-11-09 15:55:00
695,FEES,326,415,37544891.0,40954291.0,29907,32443,0.12554,0.12623,62350,78499183.0,741,308,389,36670471.0,40257894.0,29259,31864,0.12533,0.12634,61123,76928365.0,697,2023-11-09 16:00:00
696,FEES,491,528,62698186.0,79723896.0,50073,63418,0.12521,0.12571,113491,142422083.0,1019,438,494,61807133.0,76677997.0,49363,60778,0.12521,0.12616,110141,138485131.0,932,2023-11-09 16:05:00
697,FEES,327,348,50092915.0,38774923.0,40006,30764,0.12521,0.12604,70770,88867838.0,675,280,324,51431814.0,38421771.0,41089,30452,0.12517,0.12617,71541,89853585.0,604,2023-11-09 16:10:00
698,FEES,764,1456,130105478.0,247959817.0,103625,197049,0.12555,0.12584,300674,378065295.0,2220,659,1396,124751023.0,243797992.0,99830,193659,0.12496,0.12589,293489,368549015.0,2055,2023-11-09 16:15:00
699,FEES,94,160,21431389.0,30120487.0,17100,23909,0.12533,0.12598,41009,51551877.0,254,72,145,19930881.0,29288082.0,15959,23236,0.12489,0.12605,39195,49218963.0,217,2023-11-09 16:20:00
700,FEES,326,213,33803385.0,31339040.0,26420,24840,0.12795,0.12616,51260,65142425.0,539,281,189,26486611.0,29908200.0,20697,23707,0.12797,0.12616,44404,56394811.0,470,2023-11-09 16:25:00
701,FEES,593,373,50832721.0,53794317.0,40453,42605,0.12566,0.12626,83058,104627038.0,966,540,354,49515906.0,54330191.0,39517,43030,0.1253,0.12626,82547,103846097.0,894,2023-11-09 16:30:00
702,FEES,348,333,36814307.0,40995523.0,29371,32421,0.12534,0.12645,61792,77809830.0,681,323,315,36253322.0,39395209.0,28934,31151,0.1253,0.12647,60085,75648531.0,638,2023-11-09 16:35:00
703,FEES,341,275,39438445.0,44831832.0,31423,35658,0.12551,0.12573,67081,84270277.0,616,258,259,38144576.0,43896093.0,30437,34747,0.12532,0.12633,65184,82040670.0,517,2023-11-09 16:40:00
704,FEES,446,495,38308169.0,42393106.0,30572,33584,0.1253,0.12623,64156,80701275.0,941,411,466,35855031.0,42112824.0,28655,33361,0.12513,0.12623,62016,77967855.0,877,2023-11-09 16:45:00
705,FEES,125,140,19773751.0,20241566.0,15604,16038,0.12672,0.12621,31642,40015317.0,265,94,121,19740266.0,19729015.0,15387,15620,0.12829,0.12631,31007,39469281.0,215,2023-11-09 16:50:00
706,FEES,236,469,36460559.0,59093241.0,29113,46908,0.12524,0.12598,76021,95553800.0,705,199,441,40880960.0,61118463.0,32671,48452,0.12513,0.12614,81123,101999423.0,640,2023-11-09 16:55:00
707,FEES,268,597,44365228.0,63967576.0,35443,50829,0.12517,0.12585,86272,108332805.0,865,232,576,41950944.0,61562103.0,33509,48897,0.12519,0.1259,82406,103513047.0,808,2023-11-09 17:00:00
708,FEES,174,110,3334455.0,8210370.0,2665,6523,0.12512,0.12587,9188,11544825.0,284,172,100,3998861.0,8505139.0,3196,6755,0.12512,0.12591,9951,12504000.0,272,2023-11-09 17:05:00
709,FEES,112,155,11403019.0,16612324.0,9106,13192,0.12523,0.12593,22298,28015344.0,267,104,151,11509138.0,15542249.0,9190,12333,0.12524,0.12602,21523,27051387.0,255,2023-11-09 17:10:00
710,FEES,67,148,5073894.0,20247130.0,4025,16065,0.12606,0.12603,20090,25321025.0,215,45,141,5479554.0,18594117.0,4383,14762,0.12502,0.12596,19145,24073671.0,186,2023-11-09 17:15:00
711,FEES,84,148,3992178.0,11192435.0,3179,8910,0.12558,0.12562,12089,15184613.0,232,60,143,3135037.0,11260524.0,2517,8951,0.12455,0.1258,11468,14395561.0,203,2023-11-09 17:20:00
712,FEES,95,297,6255915.0,23973879.0,4982,19064,0.12557,0.12575,24046,30229795.0,392,83,290,5059441.0,23858801.0,4044,18962,0.12511,0.12582,23006,28918243.0,373,2023-11-09 17:25:00
713,FEES,139,289,7032058.0,31371227.0,5610,24934,0.12535,0.12582,30544,38403286.0,428,122,288,6927924.0,31475399.0,5528,25017,0.12532,0.12582,30545,38403324.0,410,2023-11-09 17:30:00
714,FEES,174,370,13693706.0,33667591.0,10920,26766,0.1254,0.12578,37686,47361298.0,544,165,361,14281967.0,33653179.0,11402,26749,0.12526,0.12581,38151,47935146.0,526,2023-11-09 17:35:00
715,FEES,350,316,17519793.0,29457429.0,13560,23532,0.1292,0.12518,37092,46977222.0,666,330,293,18114263.0,28309126.0,14452,22495,0.12534,0.12585,36947,46423389.0,623,2023-11-09 17:40:00
716,FEES,240,376,11692263.0,59349621.0,9336,47204,0.12524,0.12573,56540,71041884.0,616,224,365,10383691.0,54192776.0,8290,43086,0.12526,0.12578,51376,64576467.0,589,2023-11-09 17:45:00
717,FEES,321,501,29257246.0,51919706.0,23377,41380,0.12515,0.12547,64757,81176953.0,822,292,477,28240714.0,51197549.0,22562,40737,0.12517,0.12568,63299,79438263.0,769,2023-11-09 17:50:00
718,FEES,265,607,21577588.0,53706820.0,17263,42748,0.12499,0.12564,60011,75284409.0,872,236,590,19351835.0,53115427.0,15457,42278,0.1252,0.12563,57735,72467263.0,826,2023-11-09 17:55:00
719,FEES,259,232,15603836.0,17204138.0,12466,13708,0.12517,0.1255,26174,32807975.0,491,227,221,12671544.0,15711016.0,10112,12483,0.12531,0.12586,22595,28382560.0,448,2023-11-09 18:00:00
720,FEES,498,948,36869766.0,89026835.0,29381,70767,0.12549,0.1258,100148,125896602.0,1446,464,934,35336199.0,88804431.0,28190,70592,0.12535,0.1258,98782,124140630.0,1398,2023-11-09 18:05:00
721,FEES,395,482,37945861.0,41559450.0,30246,33052,0.12546,0.12574,63298,79505311.0,877,372,462,37379368.0,40835601.0,29815,32460,0.12537,0.1258,62275,78214970.0,834,2023-11-09 18:10:00
722,FEES,301,981,25463222.0,120900399.0,20291,96112,0.12549,0.12579,116403,146363621.0,1282,277,968,25616021.0,120648547.0,20439,95909,0.12533,0.12579,116348,146264569.0,1245,2023-11-09 18:15:00
723,FEES,193,614,15222405.0,66551044.0,12079,52902,0.12602,0.1258,64981,81773450.0,807,182,598,14507859.0,66326165.0,11574,52704,0.12535,0.12585,64278,80834024.0,780,2023-11-09 18:20:00
724,FEES,341,598,22524978.0,62977513.0,17942,50163,0.12554,0.12555,68105,85502491.0,939,317,584,21906518.0,62479221.0,17470,49661,0.1254,0.12581,67131,84385739.0,901,2023-11-09 18:25:00
725,FEES,974,2194,88486391.0,389795568.0,70529,310287,0.12546,0.12562,380816,478281960.0,3168,934,2173,86354905.0,385935019.0,68881,306882,0.12537,0.12576,375763,472289925.0,3107,2023-11-09 18:30:00
726,FEES,864,2657,56451905.0,562952213.0,45022,447535,0.12539,0.12579,492557,619404118.0,3521,827,2641,53703585.0,561012477.0,42834,445961,0.12538,0.1258,488795,614716062.0,3468,2023-11-09 18:35:00
727,FEES,634,1585,42558359.0,284279504.0,33915,226212,0.12549,0.12567,260127,326837864.0,2219,615,1573,42978830.0,280959591.0,34318,223528,0.12524,0.12569,257846,323938421.0,2188,2023-11-09 18:40:00
728,FEES,2003,2781,295150728.0,335075532.0,240049,264400,0.12295,0.12673,504449,630226260.0,4784,1782,2386,254672251.0,293670256.0,203886,234208,0.12491,0.12539,438094,548342507.0,4168,2023-11-10 10:05:00
729,FEES,651,1304,42263232.0,121754065.0,33897,97442,0.12468,0.12495,131339,164017297.0,1955,557,1235,37385920.0,116644806.0,29957,93048,0.1248,0.12536,123005,154030726.0,1792,2023-11-10 10:10:00
730,FEES,478,2761,43083406.0,516437306.0,34631,412555,0.12441,0.12518,447186,559520713.0,3239,407,2679,36018431.0,513384500.0,28908,410036,0.1246,0.1252,438944,549402932.0,3086,2023-11-10 10:15:00
731,FEES,303,2924,18931419.0,478066575.0,15225,381686,0.12434,0.12525,396911,496997995.0,3227,256,2897,20706744.0,484226258.0,16702,386484,0.12398,0.12529,403186,504933003.0,3153,2023-11-10 10:20:00
732,FEES,561,1318,45947111.0,159059468.0,36827,126839,0.12476,0.1254,163666,205006579.0,1879,505,1272,45370834.0,157281981.0,36393,125423,0.12467,0.1254,161816,202652815.0,1777,2023-11-10 10:25:00
733,FEES,825,773,77950741.0,102707078.0,62155,81727,0.12541,0.12567,143882,180657819.0,1598,773,686,73146890.0,96016164.0,58600,76434,0.12482,0.12562,135034,169163055.0,1459,2023-11-10 10:30:00
734,FEES,738,696,73970359.0,94047641.0,59093,74889,0.12518,0.12558,133982,168018000.0,1434,657,582,73458086.0,89909843.0,58779,71523,0.12497,0.12571,130302,163367929.0,1239,2023-11-10 10:35:00
735,FEES,1974,1957,423809741.0,416886809.0,338023,329942,0.12538,0.12635,667965,840696551.0,3931,1640,1658,387939110.0,386725578.0,310559,306338,0.12492,0.12624,616897,774664689.0,3298,2023-11-10 10:40:00
736,FEES,832,870,145546275.0,139495335.0,115972,110283,0.1255,0.12649,226255,285041610.0,1702,760,780,142813396.0,128427238.0,114087,101637,0.12518,0.12636,215724,271240634.0,1540,2023-11-10 10:45:00
737,FEES,792,910,128836029.0,155961650.0,102517,122593,0.12567,0.12722,225110,284797679.0,1702,690,824,123667832.0,150604707.0,98610,119090,0.12541,0.12646,217700,274272540.0,1514,2023-11-10 10:50:00
738,FEES,573,1044,102307629.0,112422919.0,81738,89159,0.12517,0.12609,170897,214730549.0,1617,525,991,101716155.0,109385610.0,81273,86695,0.12515,0.12617,167968,211101766.0,1516,2023-11-10 10:55:00
739,FEES,319,278,40818110.0,27925716.0,32591,22179,0.12524,0.12591,54770,68743826.0,597,277,259,39498398.0,26722555.0,31591,21212,0.12503,0.12598,52803,66220953.0,536,2023-11-10 11:00:00
740,FEES,151,251,17196993.0,14558265.0,13711,11576,0.12542,0.12576,25287,31755258.0,402,130,218,16635676.0,13879487.0,13273,11021,0.12533,0.12594,24294,30515164.0,348,2023-11-10 11:05:00
741,FEES,466,545,77759627.0,82384593.0,62157,65520,0.1251,0.12574,127677,160144220.0,1011,430,487,74258797.0,75751176.0,59392,60111,0.12503,0.12602,119503,150009974.0,917,2023-11-10 11:10:00
742,FEES,284,376,41480795.0,32326424.0,33181,25782,0.12501,0.12538,58963,73807220.0,660,258,347,41917132.0,31332165.0,33543,24894,0.12497,0.12586,58437,73249297.0,605,2023-11-10 11:15:00
743,FEES,778,1010,141572063.0,176832090.0,113606,140700,0.12462,0.12568,254306,318404153.0,1788,651,941,135944084.0,165141211.0,109087,131300,0.12462,0.12577,240387,301085295.0,1592,2023-11-10 11:20:00
744,FEES,611,622,65551245.0,96815663.0,52497,77106,0.12487,0.12556,129603,162366909.0,1233,564,580,63926885.0,96841934.0,51218,77112,0.12481,0.12559,128330,160768820.0,1144,2023-11-10 11:25:00
745,FEES,302,446,41991696.0,80523515.0,33587,64070,0.12502,0.12568,97657,122515212.0,748,274,414,40732066.0,80170911.0,32646,63781,0.12477,0.1257,96427,120902978.0,688,2023-11-10 11:30:00
746,FEES,257,789,28260219.0,120452895.0,22621,95954,0.12493,0.12553,118575,148713115.0,1046,243,768,26798291.0,119113669.0,21461,94852,0.12487,0.12558,116313,145911960.0,1011,2023-11-10 11:35:00
747,FEES,323,488,51531338.0,63940682.0,41288,51040,0.12481,0.12528,92328,115472021.0,811,294,453,49668293.0,62239831.0,39814,49519,0.12475,0.12569,89333,111908125.0,747,2023-11-10 11:40:00
748,FEES,290,369,28130884.0,52649634.0,22539,42020,0.12481,0.1253,64559,80780519.0,659,277,352,27177831.0,51141323.0,21779,40692,0.12479,0.12568,62471,78319154.0,629,2023-11-10 11:45:00
749,FEES,492,307,43723319.0,49791165.0,35021,39692,0.12485,0.12544,74713,93514485.0,799,467,273,42370463.0,47634152.0,33938,37867,0.12485,0.12579,71805,90004615.0,740,2023-11-10 11:50:00
750,FEES,447,621,63519463.0,106376931.0,50973,62110,0.12461,0.17127,113083,169896394.0,1068,369,582,60310556.0,75016730.0,48404,59719,0.1246,0.12562,108123,135327286.0,951,2023-11-10 11:55:00
751,FEES,362,619,55780724.0,104379279.0,44802,59432,0.1245,0.17563,104234,160160004.0,981,289,606,53256918.0,104125615.0,42797,60214,0.12444,0.17293,103011,157382534.0,895,2023-11-10 12:00:00
752,FEES,460,1607,94884496.0,283744539.0,76270,226823,0.12441,0.1251,303093,378629035.0,2067,387,1578,90381543.0,278556340.0,72650,222172,0.12441,0.12538,294822,368937883.0,1965,2023-11-10 12:05:00
753,FEES,199,447,45451484.0,72372296.0,36545,57778,0.12437,0.12526,94323,117823780.0,646,158,425,45201135.0,71439455.0,36364,57024,0.1243,0.12528,93388,116640590.0,583,2023-11-10 12:10:00
754,FEES,103,165,24262938.0,33348760.0,19494,26576,0.12446,0.12548,46070,57611699.0,268,70,157,21995197.0,38264463.0,17689,30300,0.12434,0.12629,47989,60259660.0,227,2023-11-10 12:15:00
755,FEES,140,167,20941499.0,40601250.0,16809,32409,0.12459,0.12528,49218,61542749.0,307,99,134,18909792.0,39236533.0,15182,31255,0.12455,0.12554,46437,58146326.0,233,2023-11-10 12:20:00
756,FEES,640,597,139552675.0,186362105.0,111316,148222,0.12537,0.12573,259538,325914781.0,1237,594,555,134054537.0,184934795.0,107352,147080,0.12487,0.12574,254432,318989332.0,1149,2023-11-10 12:25:00
757,FEES,585,448,117380712.0,99807250.0,93930,79514,0.12497,0.12552,173444,217187963.0,1033,595,405,117616293.0,97840720.0,94115,77865,0.12497,0.12565,171980,215457014.0,1000,2023-11-10 12:30:00
758,FEES,356,588,41432595.0,69051596.0,33211,55054,0.12476,0.12543,88265,110484191.0,944,323,524,40100511.0,68325222.0,32177,54469,0.12462,0.12544,86646,108425734.0,847,2023-11-10 12:35:00
759,FEES,255,329,28189878.0,43435958.0,22591,34690,0.12478,0.12521,57281,71625836.0,584,229,316,27322524.0,42445357.0,21912,33860,0.12469,0.12536,55772,69767881.0,545,2023-11-10 12:40:00
760,FEES,192,279,25680508.0,29571991.0,21264,23637,0.12077,0.12511,44901,55252500.0,471,170,261,19917228.0,27629009.0,15974,22044,0.12469,0.12534,38018,47546237.0,431,2023-11-10 12:45:00
761,FEES,566,518,97057029.0,110917299.0,78045,88666,0.12436,0.1251,166711,207974328.0,1084,506,464,92501882.0,108060548.0,74371,86218,0.12438,0.12533,160589,200562431.0,970,2023-11-10 12:50:00
762,FEES,702,922,127779539.0,178638176.0,102798,142766,0.1243,0.12513,245564,306417715.0,1624,572,852,120756929.0,165090010.0,97271,131839,0.12414,0.12522,229110,285846939.0,1424,2023-11-10 12:55:00
763,FEES,704,1090,104097838.0,211872992.0,83922,169976,0.12404,0.12465,253898,315970831.0,1794,592,1036,100453790.0,216252723.0,81034,173242,0.12396,0.12483,254276,316706513.0,1628,2023-11-10 13:00:00
764,FEES,570,1466,77358461.0,271832069.0,62467,218047,0.12384,0.12467,280514,349190530.0,2036,473,1421,73479615.0,269873646.0,59400,216253,0.1237,0.1248,275653,343353261.0,1894,2023-11-10 13:05:00
765,FEES,310,630,47137985.0,93529971.0,38005,74925,0.12403,0.12483,112930,140667956.0,940,287,607,46858631.0,92546642.0,37816,74141,0.12391,0.12483,111957,139405273.0,894,2023-11-10 13:10:00
766,FEES,202,261,26747959.0,38598489.0,21592,30898,0.12388,0.12492,52490,65346449.0,463,203,239,26328083.0,37328249.0,21260,29867,0.12384,0.12498,51127,63656332.0,442,2023-11-10 13:15:00
767,FEES,394,876,90141714.0,132482494.0,76612,106259,0.11766,0.12468,182871,222624209.0,1270,359,839,90059722.0,128447850.0,76558,102926,0.11764,0.1248,179484,218507573.0,1198,2023-11-10 13:20:00
768,FEES,588,761,85400168.0,159814268.0,69033,128264,0.12371,0.1246,197297,245214436.0,1349,463,718,80761589.0,155172580.0,65326,124409,0.12363,0.12473,189735,235934170.0,1181,2023-11-10 13:25:00
769,FEES,650,727,83744359.0,125304884.0,67796,100891,0.12352,0.1242,168687,209049243.0,1377,481,648,80240923.0,121231955.0,64971,97386,0.1235,0.12449,162357,201472879.0,1129,2023-11-10 13:30:00
770,FEES,449,782,47629824.0,129885434.0,38517,104481,0.12366,0.12431,142998,177515258.0,1231,336,746,42366450.0,123290443.0,34290,99140,0.12355,0.12436,133430,165656893.0,1082,2023-11-10 13:35:00
771,FEES,270,334,24047399.0,62754445.0,19469,50560,0.12352,0.12412,70029,86801845.0,604,221,316,21183947.0,60346727.0,17143,48531,0.12357,0.12435,65674,81530674.0,537,2023-11-10 13:40:00
772,FEES,885,1409,163540875.0,304426424.0,132622,245452,0.12331,0.12403,378074,467967299.0,2294,711,1297,158656099.0,298923938.0,128730,240744,0.12325,0.12417,369474,457580038.0,2008,2023-11-10 13:45:00
773,FEES,509,828,69339789.0,153902300.0,56152,123983,0.12349,0.12413,180135,223242089.0,1337,464,804,66673843.0,152759131.0,54017,123012,0.12343,0.12418,177029,219432975.0,1268,2023-11-10 13:50:00
774,FEES,405,743,46678944.0,111696925.0,37623,89707,0.12407,0.12451,127330,158375869.0,1148,331,704,43066925.0,112114218.0,34850,89883,0.12358,0.12473,124733,155181144.0,1035,2023-11-10 13:55:00
775,FEES,309,483,45070756.0,90643573.0,36408,72828,0.12379,0.12446,109236,135714330.0,792,277,458,45536199.0,91747365.0,36841,73712,0.1236,0.12447,110553,137283564.0,735,2023-11-10 14:00:00
776,FEES,173,439,21184505.0,67854938.0,17044,54478,0.12429,0.12455,71522,89039444.0,612,151,405,20939521.0,67410056.0,16929,54127,0.12369,0.12454,71056,88349577.0,556,2023-11-10 14:05:00
777,FEES,705,2898,103917066.0,703438288.0,84108,565739,0.12355,0.12434,649847,807355355.0,3603,650,2857,92515382.0,696285640.0,74914,560047,0.1235,0.12433,634961,788801022.0,3507,2023-11-10 14:10:00
778,FEES,238,701,21322175.0,131516509.0,17221,105695,0.12381,0.12443,122916,152838684.0,939,212,677,19785156.0,131242286.0,16013,105477,0.12356,0.12443,121490,151027443.0,889,2023-11-10 14:15:00
779,FEES,181,708,12248631.0,111809802.0,9896,89866,0.12377,0.12442,99762,124058434.0,889,155,697,11891294.0,110556500.0,9619,88848,0.12362,0.12443,98467,122447795.0,852,2023-11-10 14:20:00
780,FEES,158,793,15618393.0,201165463.0,12630,161532,0.12366,0.12454,174162,216783857.0,951,152,788,15460518.0,200616853.0,12505,161074,0.12363,0.12455,173579,216077372.0,940,2023-11-10 14:25:00
781,FEES,774,988,101385475.0,222374536.0,81772,178661,0.12399,0.12447,260433,323760011.0,1762,744,962,100429089.0,221349940.0,81159,177770,0.12374,0.12451,258929,321779029.0,1706,2023-11-10 14:30:00
782,FEES,628,1016,108370590.0,165812371.0,87757,133373,0.12349,0.12432,221130,274182962.0,1644,586,1008,107636062.0,164971274.0,87165,132538,0.12349,0.12447,219703,272607337.0,1594,2023-11-10 14:35:00
783,FEES,368,403,42792668.0,71649101.0,34592,57552,0.12371,0.12449,92144,114441769.0,771,344,381,42004689.0,70133951.0,33964,56315,0.12367,0.12454,90279,112138641.0,725,2023-11-10 14:40:00
784,FEES,238,225,27764873.0,48210624.0,22449,38690,0.12368,0.12461,61139,75975497.0,463,202,206,26634599.0,43367900.0,21546,34816,0.12362,0.12456,56362,70002499.0,408,2023-11-10 14:45:00
785,FEES,198,132,17522758.0,13000654.0,14166,10451,0.1237,0.1244,24617,30523413.0,330,179,115,18391676.0,14120526.0,14873,11323,0.12366,0.12471,26196,32512202.0,294,2023-11-10 14:50:00
786,FEES,131,169,22043659.0,30199568.0,17857,24235,0.12345,0.12461,42092,52243227.0,300,106,158,20893889.0,29616633.0,16921,23752,0.12348,0.12469,40673,50510523.0,264,2023-11-10 14:55:00
787,FEES,179,209,11390391.0,27879747.0,9225,22436,0.12347,0.12426,31661,39270138.0,388,154,187,10604467.0,26839939.0,8589,21594,0.12347,0.12429,30183,37444406.0,341,2023-11-10 15:00:00
788,FEES,202,184,16775238.0,30412459.0,13569,24450,0.12363,0.12439,38019,47187698.0,386,170,167,16239608.0,30194924.0,13145,24273,0.12354,0.1244,37418,46434532.0,337,2023-11-10 15:05:00
789,FEES,285,372,36130816.0,38069283.0,29235,30643,0.12359,0.12423,59878,74200099.0,657,241,347,34550320.0,36921337.0,27993,29682,0.12342,0.12439,57675,71471658.0,588,2023-11-10 15:10:00
790,FEES,243,287,25146415.0,29376990.0,20353,23624,0.12355,0.12435,43977,54523405.0,530,204,253,23752100.0,28882077.0,19254,23216,0.12336,0.12441,42470,52634178.0,457,2023-11-10 15:15:00
791,FEES,339,445,75975123.0,73598469.0,61613,59282,0.12331,0.12415,120895,149573592.0,784,293,418,75004713.0,71360819.0,60833,57368,0.1233,0.12439,118201,146365533.0,711,2023-11-10 15:20:00
792,FEES,375,734,53893206.0,107859478.0,43705,86980,0.12331,0.124,130685,161752684.0,1109,316,680,50984626.0,100482746.0,41355,80905,0.12329,0.1242,122260,151467372.0,996,2023-11-10 15:25:00
793,FEES,448,1493,102522086.0,335410333.0,83286,246349,0.1231,0.13615,329635,437932419.0,1941,334,1442,100398252.0,297690773.0,81565,240038,0.12309,0.12402,321603,398089026.0,1776,2023-11-10 15:30:00
794,FEES,536,1155,94776884.0,252683818.0,76988,203845,0.12311,0.12396,280833,347460702.0,1691,434,1111,86379817.0,249128392.0,70204,200883,0.12304,0.12402,271087,335508210.0,1545,2023-11-10 15:35:00
795,FEES,1090,2038,164905712.0,410959012.0,134266,332223,0.12282,0.1237,466489,575864724.0,3128,873,1894,157545914.0,405299653.0,128333,327117,0.12276,0.1239,455450,562845567.0,2767,2023-11-10 15:40:00
796,FEES,1363,1860,243249697.0,335260283.0,197451,271633,0.12319,0.12342,469084,578509980.0,3223,1153,1771,234851805.0,326671316.0,190945,264116,0.12299,0.12368,455061,561523122.0,2924,2023-11-10 15:45:00
797,FEES,592,277,75072090.0,40020132.0,60881,32286,0.12331,0.12396,93167,115092222.0,869,450,250,73727168.0,38414323.0,59883,30968,0.12312,0.12405,90851,112141492.0,700,2023-11-10 15:50:00
798,FEES,1300,561,212487484.0,78135151.0,172380,63016,0.12327,0.12399,235396,290622635.0,1861,1040,520,209681713.0,77089305.0,170119,62164,0.12326,0.12401,232283,286771019.0,1560,2023-11-10 15:55:00
799,FEES,450,109,73908014.0,30611098.0,59972,24653,0.12324,0.12417,84625,104519112.0,559,409,90,72867456.0,27439262.0,59123,22100,0.12325,0.12416,81223,100306718.0,499,2023-11-10 16:00:00
800,FEES,294,294,49975787.0,40146943.0,40631,26470,0.123,0.15167,67101,90122731.0,588,270,274,45755471.0,31117301.0,37167,25107,0.12311,0.12394,62274,76872772.0,544,2023-11-10 16:05:00
801,FEES,161,156,18852102.0,21228060.0,15286,17162,0.12333,0.12369,32448,40080163.0,317,136,147,18039479.0,21676738.0,14661,17503,0.12304,0.12385,32164,39716217.0,283,2023-11-10 16:10:00
802,FEES,1083,1281,288792000.0,352024861.0,235995,285527,0.12237,0.12329,521522,640816862.0,2364,849,1129,280337778.0,332719000.0,229144,269272,0.12234,0.12356,498416,613056779.0,1978,2023-11-10 16:15:00
803,FEES,1236,1358,243528776.0,301700895.0,199049,244803,0.12235,0.12324,443852,545229671.0,2594,976,1247,216292091.0,295404760.0,176814,239426,0.12233,0.12338,416240,511696851.0,2223,2023-11-10 16:20:00
804,FEES,377,521,61679729.0,110609165.0,50201,89485,0.12287,0.12361,139686,172288894.0,898,319,473,58734996.0,107705832.0,47961,87121,0.12246,0.12363,135082,166440828.0,792,2023-11-10 16:25:00
805,FEES,328,302,62624853.0,49655609.0,51059,40169,0.12265,0.12362,91228,112280463.0,630,275,267,60797951.0,47070110.0,49658,38088,0.12243,0.12358,87746,107868062.0,542,2023-11-10 16:30:00
806,FEES,269,247,43175722.0,42874531.0,35165,34792,0.12278,0.12323,69957,86050254.0,516,210,216,42184452.0,42279343.0,34403,34189,0.12262,0.12366,68592,84463795.0,426,2023-11-10 16:35:00
807,FEES,192,247,39309609.0,48559610.0,32076,39470,0.12255,0.12303,71546,87869219.0,439,156,230,38353219.0,46445689.0,31308,37585,0.1225,0.12358,68893,84798909.0,386,2023-11-10 16:40:00
808,FEES,209,344,27165729.0,36759748.0,22089,29755,0.12298,0.12354,51844,63925478.0,553,161,330,28837829.0,36511659.0,23549,29550,0.12246,0.12356,53099,65349488.0,491,2023-11-10 16:45:00
809,FEES,182,140,25360587.0,19999402.0,20687,16205,0.12259,0.12342,36892,45359990.0,322,133,131,24582001.0,19111539.0,20064,15470,0.12252,0.12354,35534,43693540.0,264,2023-11-10 16:50:00
810,FEES,373,249,44640052.0,38300950.0,36416,31110,0.12258,0.12311,67526,82941003.0,622,337,237,43658709.0,37170919.0,35613,30096,0.12259,0.12351,65709,80829629.0,574,2023-11-10 16:55:00
811,FEES,189,350,27514858.0,51921937.0,22434,42122,0.12265,0.12327,64556,79436795.0,539,151,323,24714190.0,50456950.0,20176,40826,0.12249,0.12359,61002,75171140.0,474,2023-11-10 17:00:00
812,FEES,143,189,7591119.0,27922255.0,6172,22621,0.12299,0.12344,28793,35513374.0,332,115,174,8532227.0,26670056.0,6952,21602,0.12273,0.12346,28554,35202284.0,289,2023-11-10 17:05:00
813,FEES,267,245,35372595.0,66792181.0,28763,53961,0.12298,0.12378,82724,102164776.0,512,209,219,33353475.0,66391707.0,27170,53649,0.12276,0.12375,80819,99745182.0,428,2023-11-10 17:10:00
814,FEES,149,176,15559499.0,32458083.0,12562,26248,0.12386,0.12366,38810,48017583.0,325,114,144,13659673.0,31374217.0,11134,25358,0.12268,0.12373,36492,45033891.0,258,2023-11-10 17:15:00
815,FEES,232,190,14995385.0,21170164.0,12145,17123,0.12347,0.12364,29268,36165550.0,422,205,169,13751126.0,20059653.0,11165,16217,0.12316,0.1237,27382,33810779.0,374,2023-11-10 17:20:00
816,FEES,138,111,8590672.0,7965697.0,6961,6450,0.12341,0.1235,13411,16556369.0,249,118,103,8745068.0,8391065.0,7104,6786,0.1231,0.12365,13890,17136133.0,221,2023-11-10 17:25:00
817,FEES,192,193,29990149.0,19682155.0,24411,15982,0.12286,0.12315,40393,49672305.0,385,164,162,27624603.0,17812061.0,22480,14386,0.12289,0.12382,36866,45436665.0,326,2023-11-10 17:30:00
818,FEES,284,369,46883579.0,24663562.0,38052,19943,0.12321,0.12367,57995,71547141.0,653,247,351,41307315.0,23837382.0,33581,19269,0.12301,0.12371,52850,65144698.0,598,2023-11-10 17:35:00
819,FEES,512,245,61974969.0,24341684.0,50376,19799,0.12302,0.12294,70175,86316654.0,757,487,221,62941084.0,22678129.0,51195,18334,0.12294,0.12369,69529,85619213.0,708,2023-11-10 17:40:00
820,FEES,326,314,46714133.0,40086239.0,37993,32401,0.12295,0.12372,70394,86800372.0,640,301,302,46041843.0,41818579.0,37473,33778,0.12287,0.1238,71251,87860422.0,603,2023-11-10 17:45:00
821,FEES,404,273,47654910.0,45837092.0,38650,36985,0.1233,0.12393,75635,93492002.0,677,364,247,45115072.0,43540268.0,36639,35132,0.12313,0.12393,71771,88655340.0,611,2023-11-10 17:50:00
822,FEES,409,420,34375144.0,55634404.0,27834,44880,0.1235,0.12396,72714,90009548.0,829,387,388,33045286.0,54859383.0,26782,44257,0.12339,0.12396,71039,87904670.0,775,2023-11-10 17:55:00
823,FEES,585,294,45300441.0,41533902.0,36713,33666,0.12339,0.12337,70379,86834344.0,879,566,269,44826544.0,39796615.0,36359,32114,0.12329,0.12392,68473,84623160.0,835,2023-11-10 18:00:00
824,FEES,543,447,72319804.0,55572666.0,58796,44943,0.123,0.12365,103739,127892470.0,990,509,433,71575990.0,54604998.0,58201,44087,0.12298,0.12386,102288,126180988.0,942,2023-11-10 18:05:00
825,FEES,264,209,25525601.0,37114884.0,20697,29962,0.12333,0.12387,50659,62640486.0,473,248,195,25325447.0,36485863.0,20543,29448,0.12328,0.1239,49991,61811311.0,443,2023-11-10 18:10:00
826,FEES,289,309,26168165.0,49006928.0,21232,39528,0.12325,0.12398,60760,75175093.0,598,252,299,25302529.0,49236141.0,20542,39716,0.12317,0.12397,60258,74538671.0,551,2023-11-10 18:15:00
827,FEES,280,245,21668057.0,19066507.0,17476,15391,0.12399,0.12388,32867,40734565.0,525,263,220,20999541.0,18476060.0,17023,14914,0.12336,0.12388,31937,39475601.0,483,2023-11-10 18:20:00
828,FEES,132,162,16269475.0,30426293.0,13174,24561,0.1235,0.12388,37735,46695769.0,294,115,162,19664765.0,37238534.0,15976,30022,0.12309,0.12404,45998,56903300.0,277,2023-11-10 18:25:00
829,FEES,169,317,9189955.0,58487544.0,7409,47207,0.12404,0.1239,54616,67677499.0,486,153,292,8895078.0,54219731.0,7204,43771,0.12347,0.12387,50975,63114810.0,445,2023-11-10 18:30:00
830,FEES,155,189,10196212.0,33885276.0,8581,27344,0.11882,0.12392,35925,44081488.0,344,120,179,5230736.0,92943247.0,4247,26606,0.12316,0.34933,30853,98173983.0,299,2023-11-10 18:35:00
831,FEES,260,119,19616188.0,16964818.0,15796,13674,0.12418,0.12407,29470,36581006.0,379,229,107,18455648.0,16761805.0,14936,13514,0.12356,0.12403,28450,35217453.0,336,2023-11-10 18:40:00
832,FEES,1597,8391,206331206.0,1711317905.0,175536,1386836,0.11754,0.1234,1562372,1917649111.0,9988,1271,7883,148486243.0,1673042645.0,123449,1357310,0.12028,0.12326,1480759,1821528888.0,9154,2023-11-13 10:05:00
833,FEES,1411,14243,137880283.0,3237162268.0,112664,2626901,0.12238,0.12323,2739565,3375042551.0,15654,1566,14079,131211705.0,3231381697.0,107376,2622885,0.1222,0.1232,2730261,3362593403.0,15645,2023-11-13 10:10:00
834,FEES,1558,7037,131325760.0,1670849787.0,107074,1357188,0.12265,0.12311,1464262,1802175548.0,8595,1404,6911,123139775.0,1663610915.0,100444,1351234,0.1226,0.12312,1451678,1786750690.0,8315,2023-11-13 10:15:00
835,FEES,1615,3574,172201567.0,546966015.0,140534,443012,0.12253,0.12347,583546,719167582.0,5189,1491,3444,168441003.0,540262068.0,137470,438509,0.12253,0.1232,575979,708703072.0,4935,2023-11-13 10:20:00
836,FEES,2696,4553,423599266.0,850732302.0,345403,690990,0.12264,0.12312,1036393,1274331568.0,7249,2300,4230,389263720.0,827460970.0,318271,671676,0.12231,0.12319,989947,1216724691.0,6530,2023-11-13 10:25:00
837,FEES,3187,2769,566262268.0,491770195.0,457394,395135,0.1238,0.12446,852529,1058032463.0,5956,2701,2380,532424422.0,465391979.0,431395,373582,0.12342,0.12458,804977,997816401.0,5081,2023-11-13 10:30:00
838,FEES,1201,1617,210795675.0,269382549.0,170201,216179,0.12385,0.12461,386380,480178224.0,2818,1153,1422,202335620.0,263393383.0,163660,211146,0.12363,0.12474,374806,465729003.0,2575,2023-11-13 10:35:00
839,FEES,2089,1618,407779422.0,342387588.0,329200,274369,0.12387,0.12479,603569,750167010.0,3707,1875,1402,393355759.0,333597759.0,318002,267177,0.1237,0.12486,585179,726953518.0,3277,2023-11-13 10:40:00
840,FEES,1728,1772,406743097.0,356707032.0,327854,285535,0.12406,0.12493,613389,763450129.0,3500,1646,1608,400076862.0,342335843.0,322756,273910,0.12396,0.12498,596666,742412706.0,3254,2023-11-13 10:45:00
841,FEES,1473,1727,260677276.0,372048762.0,210439,298158,0.12387,0.12478,508597,632726038.0,3200,1397,1620,254903647.0,369690682.0,205858,296188,0.12382,0.12482,502046,624594329.0,3017,2023-11-13 10:50:00
842,FEES,601,746,91836942.0,129351788.0,74148,103634,0.12386,0.12482,177782,221188731.0,1347,570,688,91569826.0,127256212.0,73963,101946,0.1238,0.12483,175909,218826038.0,1258,2023-11-13 10:55:00
843,FEES,368,276,59035419.0,49564547.0,47643,39713,0.12391,0.12481,87356,108599966.0,644,319,231,49443708.0,45418240.0,39943,36362,0.12379,0.12491,76305,94861948.0,550,2023-11-13 11:00:00
844,FEES,487,502,73953842.0,81517321.0,59532,65238,0.12423,0.12495,124770,155471164.0,989,402,446,71949417.0,80490914.0,58043,64369,0.12396,0.12505,122412,152440331.0,848,2023-11-13 11:05:00
845,FEES,381,440,54090186.0,60301702.0,43588,48321,0.12409,0.12479,91909,114391888.0,821,339,362,51766364.0,58477558.0,41737,46789,0.12403,0.12498,88526,110243922.0,701,2023-11-13 11:10:00
846,FEES,298,665,44872036.0,57329061.0,36084,45871,0.12435,0.12498,81955,102201097.0,963,254,610,37825386.0,57951895.0,30486,46403,0.12407,0.12489,76889,95777281.0,864,2023-11-13 11:15:00
847,FEES,716,686,104180894.0,86740115.0,83818,69411,0.12429,0.12497,153229,190921009.0,1402,686,613,103901279.0,83030383.0,83698,66416,0.12414,0.12502,150114,186931663.0,1299,2023-11-13 11:20:00
848,FEES,571,370,100065883.0,78132049.0,80161,62122,0.12483,0.12577,142283,178197932.0,941,543,279,92853551.0,74207893.0,74803,59066,0.12413,0.12564,133869,167061445.0,822,2023-11-13 11:25:00
849,FEES,460,333,61991836.0,50076590.0,49905,40101,0.12422,0.12488,90006,112068426.0,793,418,256,70106128.0,48390013.0,57908,38621,0.12106,0.12529,96529,118496141.0,674,2023-11-13 11:30:00
850,FEES,431,601,50046667.0,74307894.0,40276,59491,0.12426,0.12491,99767,124354561.0,1032,385,578,49256386.0,73237347.0,39670,58621,0.12417,0.12493,98291,122493733.0,963,2023-11-13 11:35:00
851,FEES,522,932,80359720.0,101623613.0,64739,81401,0.12413,0.12484,146140,181983333.0,1454,499,880,80373215.0,100856574.0,64760,80740,0.12411,0.12492,145500,181229789.0,1379,2023-11-13 11:40:00
852,FEES,668,799,70360154.0,105518033.0,56722,84634,0.12404,0.12468,141356,175878187.0,1467,615,756,68746392.0,103097803.0,55429,82576,0.12403,0.12485,138005,171844196.0,1371,2023-11-13 11:45:00
853,FEES,1713,1282,321268444.0,194848563.0,259464,156005,0.12382,0.1249,415469,516117007.0,2995,1649,1210,303409933.0,189511419.0,244062,151669,0.12432,0.12495,395731,492921353.0,2859,2023-11-13 11:50:00
854,FEES,913,862,112982826.0,68379285.0,90803,54739,0.12443,0.12492,145542,181362112.0,1775,808,829,108260162.0,67014313.0,87074,53645,0.12433,0.12492,140719,175274475.0,1637,2023-11-13 11:55:00
855,FEES,811,756,92338127.0,96307963.0,74175,76923,0.12449,0.1252,151098,188646090.0,1567,762,716,91420025.0,94046324.0,73109,75062,0.12505,0.12529,148171,185466349.0,1478,2023-11-13 12:00:00
856,FEES,1611,746,281414325.0,145593904.0,225922,116055,0.12456,0.12545,341977,427008229.0,2357,1547,702,284391951.0,147154712.0,228385,117296,0.12452,0.12546,345681,431546663.0,2249,2023-11-13 12:05:00
857,FEES,712,565,140130037.0,59822388.0,112587,47759,0.12446,0.12526,160346,199952426.0,1277,659,524,138033972.0,59034726.0,110929,47105,0.12443,0.12533,158034,197068699.0,1183,2023-11-13 12:10:00
858,FEES,569,416,103256126.0,66222913.0,82997,52886,0.12441,0.12522,135883,169479039.0,985,519,353,102093700.0,64573599.0,82086,51460,0.12437,0.12548,133546,166667299.0,872,2023-11-13 12:15:00
859,FEES,7104,3477,1680142566.0,1029579592.0,1340072,815683,0.12538,0.12622,2155755,2709722158.0,10581,6015,2797,1620446342.0,984793774.0,1294838,779766,0.12515,0.12629,2074604,2605240116.0,8812,2023-11-13 12:20:00
860,FEES,2117,2161,537597726.0,546234197.0,427112,430367,0.12587,0.12692,857479,1083831923.0,4278,1906,1841,518335702.0,509576270.0,412576,401691,0.12563,0.12686,814267,1027911972.0,3747,2023-11-13 12:25:00
861,FEES,745,952,171366235.0,162589801.0,136278,128461,0.12575,0.12657,264739,333956037.0,1697,641,769,167281974.0,154152316.0,133137,121511,0.12565,0.12686,254648,321434291.0,1410,2023-11-13 12:30:00
862,FEES,2556,2138,573984801.0,548356929.0,457974,436409,0.12533,0.12565,894383,1122341730.0,4694,2309,1972,566738068.0,538364848.0,452357,426569,0.12529,0.12621,878926,1105102916.0,4281,2023-11-13 12:35:00
863,FEES,1362,1051,273997856.0,146873695.0,218789,116626,0.12523,0.12594,335415,420871552.0,2413,1311,905,270486363.0,141644563.0,216007,112428,0.12522,0.12599,328435,412130926.0,2216,2023-11-13 12:40:00
864,FEES,1038,1152,156787860.0,197417924.0,124933,156851,0.1255,0.12586,281784,354205785.0,2190,947,1043,152325013.0,194080354.0,121799,154181,0.12506,0.12588,275980,346405367.0,1990,2023-11-13 12:45:00
865,FEES,1111,1562,192475866.0,387708568.0,153615,306354,0.1253,0.12656,459969,580184435.0,2673,1045,1496,191318461.0,379709729.0,152716,301345,0.12528,0.126,454061,571028190.0,2541,2023-11-13 12:50:00
866,FEES,596,314,136222362.0,61033062.0,108980,48478,0.125,0.1259,157458,197255425.0,910,541,274,132557007.0,58098444.0,106099,46140,0.12494,0.12592,152239,190655451.0,815,2023-11-13 12:55:00
867,FEES,817,713,220133787.0,156165249.0,175632,123806,0.12534,0.12614,299438,376299036.0,1530,775,676,216764499.0,155534783.0,173116,123312,0.12521,0.12613,296428,372299282.0,1451,2023-11-13 13:00:00
868,FEES,469,359,120973642.0,86810726.0,96738,68976,0.12505,0.12586,165714,207784368.0,828,433,334,119842423.0,86677840.0,95822,68703,0.12507,0.12616,164525,206520264.0,767,2023-11-13 13:05:00
869,FEES,432,327,119252683.0,75262686.0,95276,59644,0.12517,0.12619,154920,194515370.0,759,398,301,117012274.0,73844566.0,93545,58523,0.12509,0.12618,152068,190856841.0,699,2023-11-13 13:10:00
870,FEES,452,447,108749277.0,73468151.0,86833,58284,0.12524,0.12605,145117,182217429.0,899,429,427,108196672.0,73898802.0,86396,58615,0.12523,0.12607,145011,182095475.0,856,2023-11-13 13:15:00
871,FEES,728,343,169279455.0,67054830.0,135159,53320,0.12524,0.12576,188479,236334285.0,1071,698,312,164914842.0,65390534.0,131673,51841,0.12525,0.12614,183514,230305377.0,1010,2023-11-13 13:20:00
872,FEES,1420,568,278591753.0,75872317.0,222298,60169,0.12532,0.1261,282467,354464070.0,1988,1377,522,278729498.0,73737830.0,222434,58458,0.12531,0.12614,280892,352467328.0,1899,2023-11-13 13:25:00
873,FEES,1102,496,229284554.0,98058641.0,183029,78034,0.12527,0.12566,261063,327343196.0,1598,1047,444,225610954.0,93512701.0,180144,74142,0.12524,0.12613,254286,319123655.0,1491,2023-11-13 13:30:00
874,FEES,494,302,112700625.0,77738512.0,90287,61865,0.12482,0.12566,152152,190439137.0,796,453,271,100331366.0,76055980.0,80341,60367,0.12488,0.12599,140708,176387347.0,724,2023-11-13 13:35:00
875,FEES,628,643,112733610.0,147770360.0,89994,117406,0.12527,0.12586,207400,260503970.0,1271,568,605,113252738.0,145488265.0,90487,115425,0.12516,0.12605,205912,258741003.0,1173,2023-11-13 13:40:00
876,FEES,939,465,198495340.0,118930200.0,159923,94118,0.12412,0.12636,254041,317425540.0,1404,880,415,193861138.0,115585425.0,156246,91517,0.12407,0.1263,247763,309446563.0,1295,2023-11-13 13:45:00
877,FEES,1256,773,323998228.0,212936526.0,257856,168511,0.12565,0.12636,426367,536934755.0,2029,1199,668,317152148.0,202266115.0,252787,159948,0.12546,0.12646,412735,519418264.0,1867,2023-11-13 13:50:00
878,FEES,283,180,50860341.0,28045061.0,40571,22243,0.12536,0.12608,62814,78905402.0,463,260,148,50864307.0,32351327.0,40587,25473,0.12532,0.127,66060,83215634.0,408,2023-11-13 13:55:00
879,FEES,570,429,118965489.0,88031346.0,95026,70014,0.12519,0.12573,165040,206996836.0,999,534,396,120530399.0,85938732.0,96272,68150,0.1252,0.1261,164422,206469131.0,930,2023-11-13 14:00:00
880,FEES,501,363,108414178.0,92207399.0,86799,73223,0.1249,0.12593,160022,200621578.0,864,440,327,105701527.0,84828721.0,84622,67329,0.12491,0.12599,151951,190530248.0,767,2023-11-13 14:05:00
881,FEES,499,424,135687284.0,115220073.0,108630,91516,0.12491,0.1259,200146,250907358.0,923,430,381,132625846.0,114287988.0,106203,90751,0.12488,0.12594,196954,246913835.0,811,2023-11-13 14:10:00
882,FEES,626,564,137880860.0,150277750.0,110072,119326,0.12526,0.12594,229398,288158610.0,1190,562,523,131127431.0,148314020.0,104854,117723,0.12506,0.12599,222577,279441452.0,1085,2023-11-13 14:15:00
883,FEES,475,297,81714331.0,74372963.0,65199,58976,0.12533,0.12611,124175,156087295.0,772,429,270,79017115.0,72218172.0,63095,57258,0.12524,0.12613,120353,151235287.0,699,2023-11-13 14:20:00
884,FEES,123,133,26307286.0,28756244.0,20984,22776,0.12537,0.12626,43760,55063531.0,256,104,113,31329362.0,27700799.0,25079,21945,0.12492,0.12623,47024,59030161.0,217,2023-11-13 14:25:00
885,FEES,371,189,91736548.0,42674348.0,73175,33887,0.12537,0.12593,107062,134410896.0,560,365,153,91851794.0,40763300.0,73271,32310,0.12536,0.12616,105581,132615095.0,518,2023-11-13 14:30:00
886,FEES,669,213,177133672.0,62927621.0,141227,49441,0.12542,0.12728,190668,240061293.0,882,632,184,173585906.0,61787360.0,138468,48524,0.12536,0.12733,186992,235373266.0,816,2023-11-13 14:35:00
887,FEES,808,423,224260006.0,116448636.0,178740,91320,0.12547,0.12752,270060,340708642.0,1231,776,387,223142030.0,115684015.0,177873,90714,0.12545,0.12753,268587,338826046.0,1163,2023-11-13 14:40:00
888,FEES,360,329,72182899.0,70764219.0,57540,56108,0.12545,0.12612,113648,142947118.0,689,331,287,69262644.0,67120204.0,55215,53152,0.12544,0.12628,108367,136382849.0,618,2023-11-13 14:45:00
889,FEES,567,547,166725975.0,150474607.0,133086,118603,0.12528,0.12687,251689,317200583.0,1114,513,515,161786952.0,148463822.0,129252,116767,0.12517,0.12715,246019,310250774.0,1028,2023-11-13 14:50:00
890,FEES,893,419,208231110.0,150109917.0,165692,118512,0.12567,0.12666,284204,358341027.0,1312,770,348,192414796.0,143696450.0,152822,113441,0.12591,0.12667,266263,336111246.0,1118,2023-11-13 14:55:00
891,FEES,863,485,225252127.0,150699327.0,179267,119141,0.12565,0.12649,298408,375951455.0,1348,841,413,225012834.0,147235054.0,179097,116214,0.12564,0.12669,295311,372247889.0,1254,2023-11-13 15:00:00
892,FEES,516,532,181910209.0,178830930.0,144915,141368,0.12553,0.1265,286283,360741140.0,1048,476,498,181096552.0,178116736.0,144289,140763,0.12551,0.12654,285052,359213288.0,974,2023-11-13 15:05:00
893,FEES,282,263,79770946.0,78039202.0,63326,61611,0.12597,0.12666,124937,157810148.0,545,254,214,76876000.0,76125305.0,61215,60064,0.12558,0.12674,121279,153001305.0,468,2023-11-13 15:10:00
894,FEES,809,928,309543864.0,336001075.0,246372,265407,0.12564,0.1266,511779,645544939.0,1737,746,876,304550893.0,332951908.0,242406,262786,0.12564,0.1267,505192,637502801.0,1622,2023-11-13 15:15:00
895,FEES,1347,789,373783057.0,249483916.0,297001,196774,0.12585,0.12679,493775,623266973.0,2136,1285,675,370229808.0,244166418.0,294221,192409,0.12583,0.1269,486630,614396227.0,1960,2023-11-13 15:20:00
896,FEES,297,247,75658748.0,69705731.0,60190,55004,0.1257,0.12673,115194,145364480.0,544,275,195,74576283.0,64737890.0,59331,51006,0.1257,0.12692,110337,139314173.0,470,2023-11-13 15:25:00
897,FEES,64,54,15210954.0,12290045.0,12095,9722,0.12576,0.12641,21817,27500999.0,118,58,37,14476989.0,10488001.0,11536,8277,0.12549,0.12671,19813,24964990.0,95,2023-11-13 15:30:00
898,FEES,135,139,32640365.0,27208741.0,26006,21517,0.12551,0.12645,47523,59849107.0,274,120,113,32528382.0,32520847.0,25919,25459,0.1255,0.12774,51378,65049230.0,233,2023-11-13 15:35:00
899,FEES,338,151,55561373.0,35771169.0,44204,28185,0.12569,0.12692,72389,91332542.0,489,315,112,52825898.0,32712520.0,42064,25821,0.12558,0.12669,67885,85538419.0,427,2023-11-13 15:40:00
900,FEES,240,131,47044058.0,30000521.0,37407,23690,0.12576,0.12664,61097,77044579.0,371,215,99,43375006.0,28980056.0,34525,22874,0.12563,0.12669,57399,72355062.0,314,2023-11-13 15:45:00
901,FEES,132,94,33712789.0,19410464.0,26876,15434,0.12544,0.12576,42310,53123254.0,226,127,80,32155797.0,18192024.0,25628,14360,0.12547,0.12669,39988,50347821.0,207,2023-11-13 15:50:00
902,FEES,306,246,78450823.0,65690683.0,62385,52018,0.12575,0.12628,114403,144141506.0,552,276,207,71970011.0,62633454.0,57312,49443,0.12558,0.12668,106755,134603465.0,483,2023-11-13 15:55:00
903,FEES,375,140,71608471.0,24038199.0,56954,19015,0.12573,0.12642,75969,95646670.0,515,363,132,75695837.0,23529577.0,60216,18618,0.12571,0.12638,78834,99225414.0,495,2023-11-13 16:00:00
904,FEES,280,259,44194033.0,46783028.0,35191,37099,0.12558,0.1261,72290,90977061.0,539,248,229,43330875.0,44754989.0,34508,35428,0.12557,0.12633,69936,88085865.0,477,2023-11-13 16:05:00
905,FEES,417,437,86284874.0,105734052.0,68814,83989,0.12539,0.12589,152803,192018926.0,854,372,390,81381507.0,92881152.0,64916,73598,0.12536,0.1262,138514,174262659.0,762,2023-11-13 16:10:00
906,FEES,197,262,34409276.0,65933942.0,27455,52441,0.12533,0.12573,79896,100343219.0,459,168,253,32947697.0,64193703.0,26311,50851,0.12522,0.12624,77162,97141401.0,421,2023-11-13 16:15:00
907,FEES,326,320,67739633.0,75862751.0,54128,60353,0.12515,0.1257,114481,143602385.0,646,281,279,66655701.0,71492666.0,53257,56717,0.12516,0.12605,109974,138148368.0,560,2023-11-13 16:20:00
908,FEES,164,197,36634663.0,42802933.0,29312,33871,0.12498,0.12637,63183,79437596.0,361,134,187,35042891.0,38319695.0,28045,30424,0.12495,0.12595,58469,73362587.0,321,2023-11-13 16:25:00
909,FEES,250,580,61163983.0,142434772.0,48914,113085,0.12504,0.12595,161999,203598756.0,830,226,556,60248994.0,140761072.0,48199,111745,0.125,0.12597,159944,201010067.0,782,2023-11-13 16:30:00
910,FEES,378,347,78458576.0,84808097.0,62597,67333,0.12534,0.12595,129930,163266674.0,725,351,316,76689392.0,84270676.0,61285,66753,0.12514,0.12624,128038,160960068.0,667,2023-11-13 16:35:00
911,FEES,197,143,33126043.0,45619303.0,26394,36176,0.12551,0.1261,62570,78745346.0,340,178,118,32430365.0,44296018.0,25890,35143,0.12526,0.12605,61033,76726383.0,296,2023-11-13 16:40:00
912,FEES,384,450,64725608.0,99003834.0,51604,78406,0.12543,0.12627,130010,163729442.0,834,342,429,71900083.0,96773419.0,57454,76742,0.12514,0.1261,134196,168673503.0,771,2023-11-13 16:45:00
913,FEES,188,264,41299526.0,55822681.0,33021,44300,0.12507,0.12601,77321,97122208.0,452,164,244,40707278.0,56827830.0,32560,44932,0.12502,0.12648,77492,97535108.0,408,2023-11-13 16:50:00
914,FEES,164,94,25970691.0,19745807.0,20718,15681,0.12535,0.12592,36399,45716498.0,258,150,83,25481776.0,18155519.0,20340,14402,0.12528,0.12606,34742,43637296.0,233,2023-11-13 16:55:00
915,FEES,386,260,77154951.0,44946705.0,61640,35723,0.12517,0.12582,97363,122101657.0,646,363,240,76707834.0,43755306.0,61274,34697,0.12519,0.12611,95971,120463140.0,603,2023-11-13 17:00:00
916,FEES,300,152,52031493.0,23467981.0,41546,18638,0.12524,0.12591,60184,75499475.0,452,290,146,51958407.0,23170601.0,41498,18405,0.12521,0.12589,59903,75129009.0,436,2023-11-13 17:05:00
917,FEES,179,239,38501650.0,46567927.0,30802,36982,0.125,0.12592,67784,85069577.0,418,148,220,38222120.0,46643844.0,30587,37015,0.12496,0.12601,67602,84865964.0,368,2023-11-13 17:10:00
918,FEES,485,365,134777150.0,130459573.0,107837,103602,0.12498,0.12592,211439,265236723.0,850,464,337,133562854.0,126466702.0,106878,100374,0.12497,0.126,207252,260029557.0,801,2023-11-13 17:15:00
919,FEES,579,678,135002589.0,183427570.0,108170,146341,0.12481,0.12534,254511,318430160.0,1257,538,630,134472179.0,186809760.0,107742,148454,0.12481,0.12584,256196,321281939.0,1168,2023-11-13 17:20:00
920,FEES,665,1704,146116983.0,426419774.0,117286,340434,0.12458,0.12526,457720,572536757.0,2369,584,1667,147048693.0,430111003.0,118056,343244,0.12456,0.12531,461300,577159697.0,2251,2023-11-13 17:25:00
921,FEES,235,731,40257347.0,175589597.0,32270,140281,0.12475,0.12517,172551,215846945.0,966,179,711,38155193.0,176036700.0,30672,140620,0.1244,0.12519,171292,214191894.0,890,2023-11-13 17:30:00
922,FEES,555,1307,97291509.0,340194633.0,78388,272509,0.12412,0.12484,350897,437486142.0,1862,455,1241,94828707.0,331552677.0,76401,264772,0.12412,0.12522,341173,426381385.0,1696,2023-11-13 17:35:00
923,FEES,515,1266,81834714.0,310817498.0,66064,249510,0.12387,0.12457,315574,392652213.0,1781,438,1229,77890333.0,308220738.0,62889,247210,0.12385,0.12468,310099,386111071.0,1667,2023-11-13 17:40:00
924,FEES,652,2066,125117360.0,567872297.0,97521,455966,0.1283,0.12454,553487,692989657.0,2718,540,2026,118405742.0,563865059.0,95734,452335,0.12368,0.12466,548069,682270802.0,2566,2023-11-13 17:45:00
925,FEES,251,472,41942311.0,103974049.0,33705,83289,0.12444,0.12484,116994,145916361.0,723,189,438,39544519.0,102346916.0,31893,81980,0.12399,0.12484,113873,141891435.0,627,2023-11-13 17:50:00
926,FEES,249,349,45611046.0,68078366.0,36733,54545,0.12417,0.12481,91278,113689413.0,598,207,323,45850936.0,66128477.0,36950,52909,0.12409,0.12499,89859,111979414.0,530,2023-11-13 17:55:00
927,FEES,197,162,49936045.0,25339868.0,40186,20303,0.12426,0.12481,60489,75275913.0,359,169,135,51168853.0,23384180.0,37758,18719,0.13552,0.12492,56477,74553033.0,304,2023-11-13 18:00:00
928,FEES,312,329,59255885.0,65903886.0,47648,52733,0.12436,0.12498,100381,125159771.0,641,278,309,57207000.0,64990171.0,46035,51980,0.12427,0.12503,98015,122197171.0,587,2023-11-13 18:05:00
929,FEES,385,617,57924281.0,119891425.0,43547,95819,0.13302,0.12512,139366,177815706.0,1002,348,586,51648794.0,119224168.0,41500,95339,0.12445,0.12505,136839,170872963.0,934,2023-11-13 18:10:00
930,FEES,579,706,95402615.0,140580355.0,76411,112309,0.12485,0.12517,188720,235982971.0,1285,524,649,91709344.0,137811590.0,73675,109983,0.12448,0.1253,183658,229520935.0,1173,2023-11-13 18:15:00
931,FEES,323,392,40493576.0,52284679.0,32511,41877,0.12455,0.12485,74388,92778255.0,715,289,360,40076562.0,50918575.0,32182,40676,0.12453,0.12518,72858,90995137.0,649,2023-11-13 18:20:00
932,FEES,219,437,39967834.0,67193592.0,32144,53764,0.12434,0.12498,85908,107161426.0,656,201,418,45101916.0,65060491.0,33312,51994,0.13539,0.12513,85306,110162407.0,619,2023-11-13 18:25:00
933,FEES,204,156,32951813.0,43614417.0,26481,34979,0.12444,0.12469,61460,76566230.0,360,177,142,31133431.0,41896809.0,25083,33439,0.12412,0.12529,58522,73030240.0,319,2023-11-13 18:30:00
934,FEES,281,73,21457581.0,9856023.0,17233,7908,0.12451,0.12463,25141,31313604.0,354,248,54,20880811.0,9419556.0,16774,7540,0.12448,0.12493,24314,30300367.0,302,2023-11-13 18:35:00
935,FEES,152,186,21291740.0,40029850.0,17114,32084,0.12441,0.12477,49198,61321591.0,338,132,168,25778401.0,44406035.0,20747,35555,0.12425,0.12489,56302,70184436.0,300,2023-11-13 18:40:00
936,FEES,2027,7116,416174230.0,1995095845.0,341435,1594474,0.12189,0.12513,1935909,2411270075.0,9143,1449,6556,357352262.0,1937744762.0,291161,1549553,0.12273,0.12505,1840714,2295097024.0,8005,2023-11-14 10:05:00
937,FEES,933,5611,140242194.0,1490795938.0,113620,1198472,0.12343,0.12439,1312092,1631038133.0,6544,591,5356,119533104.0,1477879913.0,97045,1187583,0.12317,0.12444,1284628,1597413017.0,5947,2023-11-14 10:10:00
938,FEES,2967,3479,451240602.0,730798253.0,363425,587405,0.12416,0.12441,950830,1182038856.0,6446,2733,3261,442576420.0,720910075.0,356655,579341,0.12409,0.12444,935996,1163486496.0,5994,2023-11-14 10:15:00
939,FEES,1697,1406,291670093.0,182404873.0,235324,144443,0.12394,0.12628,379767,474074966.0,3103,1547,1180,284649633.0,173066922.0,229758,138608,0.12389,0.12486,368366,457716556.0,2727,2023-11-14 10:20:00
940,FEES,1723,1851,328296678.0,399376520.0,265667,319150,0.12357,0.12514,584817,727673198.0,3574,1537,1749,318864126.0,391965327.0,258250,312842,0.12347,0.12529,571092,710829454.0,3286,2023-11-14 10:25:00
941,FEES,1658,966,353857733.0,181196805.0,284688,144754,0.1243,0.12518,429442,535054538.0,2624,1514,855,343524218.0,173133852.0,276504,138214,0.12424,0.12527,414718,516658071.0,2369,2023-11-14 10:30:00
942,FEES,1497,1100,371257336.0,196442823.0,298525,157146,0.12436,0.12501,455671,567700160.0,2597,1404,1002,361896907.0,186011195.0,291002,148429,0.12436,0.12532,439431,547908103.0,2406,2023-11-14 10:35:00
943,FEES,273,394,49282366.0,86991256.0,39667,69474,0.12424,0.12521,109141,136273623.0,667,227,355,47943486.0,86427045.0,38610,68998,0.12417,0.12526,107608,134370531.0,582,2023-11-14 10:40:00
944,FEES,903,2407,197874427.0,513073602.0,159598,411601,0.12398,0.12465,571199,710948030.0,3310,797,2318,196380508.0,507698188.0,158349,406889,0.12402,0.12478,565238,704078696.0,3115,2023-11-14 10:45:00
945,FEES,1049,1015,219741808.0,280889830.0,177633,225396,0.12371,0.12462,403029,500631638.0,2064,926,966,212618314.0,279059892.0,171946,223804,0.12365,0.12469,395750,491678206.0,1892,2023-11-14 10:50:00
946,FEES,624,739,114735513.0,163184634.0,92647,130749,0.12384,0.12481,223396,277920147.0,1363,531,685,110997181.0,159600469.0,89685,127849,0.12376,0.12484,217534,270597651.0,1216,2023-11-14 10:55:00
947,FEES,1763,1039,312592991.0,211875494.0,251354,169469,0.12436,0.12502,420823,524468485.0,2802,1692,999,310129916.0,210270479.0,249529,168193,0.12429,0.12502,417722,520400396.0,2691,2023-11-14 11:00:00
948,FEES,764,1895,139028813.0,525535130.0,111819,420968,0.12433,0.12484,532787,664563943.0,2659,713,1841,133005931.0,517796164.0,107086,414709,0.1242,0.12486,521795,650802096.0,2554,2023-11-14 11:05:00
949,FEES,972,4873,210045517.0,1123420578.0,178244,901566,0.11784,0.12461,1079810,1333466095.0,5845,904,4818,207818575.0,1120549801.0,175841,899120,0.11819,0.12463,1074961,1328368376.0,5722,2023-11-14 11:10:00
950,FEES,568,3041,145556633.0,740279757.0,120769,595054,0.12052,0.12441,715823,885836391.0,3609,497,2998,153872313.0,737859961.0,128938,593026,0.11934,0.12442,721964,891732274.0,3495,2023-11-14 11:15:00
951,FEES,499,690,103531188.0,171468637.0,83724,138007,0.12366,0.12425,221731,274999826.0,1189,436,632,99152988.0,163843696.0,80314,131573,0.12346,0.12453,211887,262996684.0,1068,2023-11-14 11:20:00
952,FEES,562,2599,85258723.0,546168716.0,68984,439975,0.12359,0.12414,508959,631427439.0,3161,471,2562,81427670.0,545417107.0,65962,439273,0.12345,0.12416,505235,626844778.0,3033,2023-11-14 11:25:00
953,FEES,786,485,126048808.0,69295003.0,102011,55804,0.12356,0.12418,157815,195343811.0,1271,737,441,123657163.0,67806091.0,100053,54533,0.12359,0.12434,154586,191463254.0,1178,2023-11-14 11:30:00
954,FEES,247,310,52396384.0,56547122.0,42426,45478,0.1235,0.12434,87904,108943507.0,557,205,287,50068407.0,55456438.0,40572,44522,0.12341,0.12456,85094,105524845.0,492,2023-11-14 11:35:00
955,FEES,1864,3233,341713701.0,794179642.0,275495,637257,0.12404,0.12462,912752,1135893344.0,5097,1801,3162,339251777.0,795765196.0,273613,638529,0.12399,0.12462,912142,1135016973.0,4963,2023-11-14 11:40:00
956,FEES,934,1503,188648685.0,359153881.0,151742,287829,0.12432,0.12478,439571,547802566.0,2437,895,1450,184099868.0,353786059.0,148477,283605,0.12399,0.12475,432082,537885928.0,2345,2023-11-14 11:45:00
957,FEES,821,650,178520147.0,109857231.0,143835,88157,0.12411,0.12462,231992,288377379.0,1471,777,612,176292919.0,107207526.0,142105,85848,0.12406,0.12488,227953,283500445.0,1389,2023-11-14 11:50:00
958,FEES,502,788,104259903.0,162096288.0,84093,129919,0.12398,0.12477,214012,266356191.0,1290,448,764,102015274.0,161183802.0,82351,129128,0.12388,0.12482,211479,263199077.0,1212,2023-11-14 11:55:00
959,FEES,404,673,75626721.0,126789697.0,61024,101567,0.12393,0.12483,162591,202416419.0,1077,364,641,70766314.0,126086848.0,57089,100992,0.12396,0.12485,158081,196853162.0,1005,2023-11-14 12:00:00
960,FEES,309,517,57490351.0,108629548.0,46400,87209,0.1239,0.12456,133609,166119899.0,826,261,485,56155040.0,106389633.0,45324,85283,0.1239,0.12475,130607,162544673.0,746,2023-11-14 12:05:00
961,FEES,137,232,30971414.0,41245081.0,25029,33094,0.12374,0.12463,58123,72216496.0,369,116,213,29804420.0,40541340.0,24101,32518,0.12366,0.12467,56619,70345760.0,329,2023-11-14 12:10:00
962,FEES,152,385,32181172.0,71849648.0,26018,57630,0.12369,0.12467,83648,104030821.0,537,128,363,31477198.0,69675111.0,25443,55866,0.12372,0.12472,81309,101152310.0,491,2023-11-14 12:15:00
963,FEES,279,573,59695162.0,93586903.0,48290,75186,0.12362,0.12447,123476,153282065.0,852,256,555,57780485.0,92010470.0,46746,73926,0.12361,0.12446,120672,149790955.0,811,2023-11-14 12:20:00
964,FEES,379,537,78964216.0,118747960.0,63879,95258,0.12362,0.12466,159137,197712177.0,916,325,493,78055832.0,116316155.0,63160,93270,0.12358,0.12471,156430,194371988.0,818,2023-11-14 12:25:00
965,FEES,194,298,30397286.0,54567641.0,24599,43871,0.12357,0.12438,68470,84964928.0,492,168,277,28991711.0,53444988.0,23462,42911,0.12357,0.12455,66373,82436700.0,445,2023-11-14 12:30:00
966,FEES,414,668,109982511.0,138173328.0,90603,111195,0.12139,0.12426,201798,248155840.0,1082,346,592,97980541.0,129046921.0,79439,103768,0.12334,0.12436,183207,227027463.0,938,2023-11-14 12:35:00
967,FEES,819,643,170992604.0,159973989.0,138833,129153,0.12316,0.12386,267986,330966594.0,1462,667,538,186249135.0,155778398.0,154099,125448,0.12086,0.12418,279547,342027533.0,1205,2023-11-14 12:40:00
968,FEES,508,370,77327243.0,76589795.0,62714,61757,0.1233,0.12402,124471,153917038.0,878,437,335,74637718.0,75196486.0,60617,60620,0.12313,0.12405,121237,149834205.0,772,2023-11-14 12:45:00
969,FEES,290,185,36710430.0,33732862.0,29762,27108,0.12335,0.12444,56870,70443293.0,475,245,162,36392057.0,29369871.0,29544,23652,0.12318,0.12418,53196,65761929.0,407,2023-11-14 12:50:00
970,FEES,384,423,73689385.0,103060662.0,59877,83281,0.12307,0.12375,143158,176750048.0,807,341,388,71397917.0,102722302.0,58018,82741,0.12306,0.12415,140759,174120219.0,729,2023-11-14 12:55:00
971,FEES,253,250,39157885.0,60814097.0,31835,49179,0.123,0.12366,81014,99971982.0,503,162,227,37019711.0,58247207.0,30116,46987,0.12292,0.12396,77103,95266919.0,389,2023-11-14 13:00:00
972,FEES,971,584,205474296.0,115116417.0,166429,92802,0.12346,0.12405,259231,320590714.0,1555,930,541,202366775.0,115000146.0,164134,92724,0.12329,0.12402,256858,317366921.0,1471,2023-11-14 13:05:00
973,FEES,207,259,34053615.0,30999056.0,27630,25001,0.12325,0.12399,52631,65052671.0,466,185,243,32561554.0,30532071.0,26441,24613,0.12315,0.12405,51054,63093625.0,428,2023-11-14 13:10:00
974,FEES,218,260,45720950.0,47006611.0,37085,37863,0.12329,0.12415,74948,92727562.0,478,194,241,44501002.0,44631635.0,36119,35979,0.12321,0.12405,72098,89132638.0,435,2023-11-14 13:15:00
975,FEES,488,697,118259575.0,133981921.0,95766,107776,0.12349,0.12432,203542,252241496.0,1185,452,673,113867543.0,130819959.0,92271,105247,0.12341,0.1243,197518,244687503.0,1125,2023-11-14 13:20:00
976,FEES,257,436,56754223.0,74944424.0,45856,60230,0.12377,0.12443,106086,131698647.0,693,222,411,56136270.0,72111309.0,45443,57937,0.12353,0.12447,103380,128247579.0,633,2023-11-14 13:25:00
977,FEES,104,146,13233847.0,19063565.0,10699,15259,0.12369,0.12493,25958,32297413.0,250,71,123,11967408.0,17234921.0,9693,13857,0.12346,0.12438,23550,29202330.0,194,2023-11-14 13:30:00
978,FEES,123,152,28184300.0,22444024.0,22830,18092,0.12345,0.12405,40922,50628324.0,275,111,135,28205336.0,21815892.0,22855,17542,0.12341,0.12436,40397,50021229.0,246,2023-11-14 13:35:00
979,FEES,109,127,28077759.0,19851135.0,22757,15959,0.12338,0.12439,38716,47928895.0,236,86,113,27294354.0,19818412.0,22131,15933,0.12333,0.12439,38064,47112766.0,199,2023-11-14 13:40:00
980,FEES,212,358,51110586.0,58755477.0,41468,47306,0.12325,0.1242,88774,109866063.0,570,197,333,61101804.0,57231576.0,50983,46038,0.11985,0.12431,97021,118333381.0,530,2023-11-14 13:45:00
981,FEES,93,181,16289934.0,26173317.0,13212,21122,0.1233,0.12391,34334,42463251.0,274,71,163,15539262.0,25693832.0,12606,20708,0.12327,0.12408,33314,41233095.0,234,2023-11-14 13:50:00
982,FEES,107,114,20967134.0,25940256.0,17003,20901,0.12331,0.12411,37904,46907390.0,221,84,103,18914691.0,25403424.0,15347,20461,0.12325,0.12416,35808,44318115.0,187,2023-11-14 13:55:00
983,FEES,505,738,109992882.0,168359929.0,89102,135689,0.12345,0.12408,224791,278352812.0,1243,442,700,109272185.0,167423744.0,88571,134494,0.12337,0.12448,223065,276695929.0,1142,2023-11-14 14:00:00
984,FEES,153,4311,23122320.0,725802377.0,18745,585500,0.12335,0.12396,604245,748924697.0,4464,142,4295,23226362.0,722272505.0,18848,582712,0.12323,0.12395,601560,745498868.0,4437,2023-11-14 14:05:00
985,FEES,388,1469,66459710.0,236792863.0,54014,191296,0.12304,0.12378,245310,303252573.0,1857,327,1423,62716636.0,233942170.0,50983,188852,0.12301,0.12388,239835,296658807.0,1750,2023-11-14 14:10:00
986,FEES,572,1265,125876319.0,186778135.0,102433,151089,0.12289,0.12362,253522,312654454.0,1837,505,1199,122985328.0,184875005.0,100133,149420,0.12282,0.12373,249553,307860333.0,1704,2023-11-14 14:15:00
987,FEES,445,430,101044318.0,100895093.0,82160,81410,0.12298,0.12393,163570,201939411.0,875,415,368,100232015.0,99530339.0,81572,80253,0.12288,0.12402,161825,199762354.0,783,2023-11-14 14:20:00
988,FEES,373,622,74289899.0,107675655.0,60755,87321,0.12228,0.12331,148076,181965554.0,995,305,564,68900612.0,104514505.0,56289,84611,0.12241,0.12352,140900,173415117.0,869,2023-11-14 14:25:00
989,FEES,1043,1506,360613338.0,418219531.0,295696,340117,0.12195,0.12296,635813,778832870.0,2549,833,1279,329492377.0,383369794.0,270149,311081,0.12197,0.12324,581230,712862171.0,2112,2023-11-14 14:30:00
990,FEES,1368,1820,370710056.0,416751741.0,303914,340992,0.12198,0.12222,644906,787461797.0,3188,1091,1536,339644350.0,385935718.0,278754,313929,0.12184,0.12294,592683,725580068.0,2627,2023-11-14 14:35:00
991,FEES,617,865,151075840.0,215964729.0,123920,175998,0.12191,0.12271,299918,367040570.0,1482,546,757,145299916.0,204736922.0,119158,166365,0.12194,0.12306,285523,350036838.0,1303,2023-11-14 14:40:00
992,FEES,971,1245,207231729.0,297382253.0,169763,241961,0.12207,0.12291,411724,504613983.0,2216,880,1164,204655140.0,301549134.0,167714,245306,0.12203,0.12293,413020,506204275.0,2044,2023-11-14 14:45:00
993,FEES,973,628,192117695.0,159987608.0,156825,129687,0.1225,0.12336,286512,352105303.0,1601,878,558,190031220.0,162269380.0,155193,131457,0.12245,0.12344,286650,352300600.0,1436,2023-11-14 14:50:00
994,FEES,1416,1593,360042549.0,355912428.0,294638,289689,0.1222,0.12286,584327,715954978.0,3009,1273,1462,357691376.0,332121018.0,292770,269989,0.12217,0.12301,562759,689812394.0,2735,2023-11-14 14:55:00
995,FEES,1234,1482,279758859.0,391064551.0,228742,318398,0.1223,0.12282,547140,670823410.0,2716,1052,1247,251366781.0,385227893.0,206223,313550,0.12189,0.12286,519773,636594674.0,2299,2023-11-14 15:00:00
996,FEES,333,610,63678421.0,99948059.0,52113,81366,0.12219,0.12284,133479,163626480.0,943,283,541,62470284.0,98610520.0,51146,80237,0.12214,0.1229,131383,161080805.0,824,2023-11-14 15:05:00
997,FEES,382,749,96956094.0,112336366.0,79386,91462,0.12213,0.12282,170848,209292460.0,1131,344,714,94228239.0,111132472.0,77182,90419,0.12209,0.12291,167601,205360711.0,1058,2023-11-14 15:10:00
998,FEES,415,1958,66958774.0,369616408.0,54825,301106,0.12213,0.12275,355931,436575183.0,2373,360,1923,64737536.0,365411479.0,53024,297422,0.12209,0.12286,350446,430149015.0,2283,2023-11-14 15:15:00
999,FEES,1141,3985,264429752.0,964087004.0,221038,793676,0.11963,0.12147,1014714,1228516757.0,5126,718,3610,243033543.0,945153214.0,203392,775337,0.11949,0.1219,978729,1188186757.0,4328,2023-11-14 15:20:00
1000,FEES,551,529,119715435.0,161007440.0,97845,130693,0.12235,0.1232,228538,280722875.0,1080,410,412,105923215.0,150022288.0,87416,122502,0.12117,0.12247,209918,255945503.0,822,2023-11-14 15:25:00
1001,FEES,911,888,138873143.0,259513285.0,113820,211818,0.12201,0.12252,325638,398386429.0,1799,761,827,135119093.0,250858278.0,110993,204823,0.12174,0.12248,315816,385977371.0,1588,2023-11-14 15:30:00
1002,FEES,1586,337,300780706.0,77297858.0,246400,62896,0.12207,0.1229,309296,378078564.0,1923,1540,294,299387833.0,73326978.0,245308,59663,0.12205,0.1229,304971,372714811.0,1834,2023-11-14 15:35:00
1003,FEES,1177,718,236505088.0,143274055.0,193948,116629,0.12194,0.12285,310577,379779143.0,1895,1092,639,232888128.0,140425660.0,191060,114198,0.12189,0.12297,305258,373313789.0,1731,2023-11-14 15:40:00
1004,FEES,170,175,26997317.0,25694702.0,22137,20884,0.12196,0.12304,43021,52692020.0,345,148,162,26031214.0,24649233.0,21371,20025,0.12181,0.12309,41396,50680448.0,310,2023-11-14 15:45:00
1005,FEES,328,198,61122560.0,38036742.0,49920,30911,0.12244,0.12305,80831,99159302.0,526,294,157,58609124.0,37103157.0,48084,30155,0.12189,0.12304,78239,95712282.0,451,2023-11-14 15:50:00
1006,FEES,628,1275,115710590.0,212651870.0,94642,173116,0.12226,0.12284,267758,328362460.0,1903,595,1249,113121260.0,212257016.0,92611,172714,0.12215,0.1229,265325,325378276.0,1844,2023-11-14 15:55:00
1007,FEES,298,548,60407383.0,91487308.0,49520,74494,0.12199,0.12281,124014,151894691.0,846,262,529,58576802.0,86720567.0,48029,70557,0.12196,0.12291,118586,145297370.0,791,2023-11-14 16:00:00
1008,FEES,1342,1132,337526348.0,234718625.0,276536,191095,0.12206,0.12283,467631,572244973.0,2474,1274,1078,331032595.0,231517489.0,271440,188272,0.12195,0.12297,459712,562550084.0,2352,2023-11-14 16:05:00
1009,FEES,910,766,117237233.0,128432866.0,96022,104664,0.12209,0.12271,200686,245670099.0,1676,887,736,117077990.0,127695916.0,95912,104040,0.12207,0.12274,199952,244773907.0,1623,2023-11-14 16:10:00
1010,FEES,492,1015,91975843.0,192120838.0,75646,156876,0.12159,0.12247,232522,284096681.0,1507,421,951,90980353.0,182928900.0,74810,149313,0.12162,0.12251,224123,273909253.0,1372,2023-11-14 16:15:00
1011,FEES,636,1061,124590243.0,178133982.0,102515,145629,0.12153,0.12232,248144,302724225.0,1697,559,1054,121379680.0,182453648.0,99943,149135,0.12145,0.12234,249078,303833329.0,1613,2023-11-14 16:20:00
1012,FEES,278,569,56581009.0,104723099.0,46447,85425,0.12182,0.12259,131872,161304109.0,847,207,538,54457184.0,103974188.0,44746,84823,0.1217,0.12258,129569,158431372.0,745,2023-11-14 16:25:00
1013,FEES,480,621,121763913.0,137494770.0,99642,111920,0.1222,0.12285,211562,259258684.0,1101,442,570,119803250.0,135137966.0,98255,109972,0.12193,0.12288,208227,254941217.0,1012,2023-11-14 16:30:00
1014,FEES,527,883,98653530.0,185069330.0,80869,150846,0.12199,0.12269,231715,283722861.0,1410,491,863,97007712.0,183864271.0,79566,149801,0.12192,0.12274,229367,280871984.0,1354,2023-11-14 16:35:00
1015,FEES,500,555,107940735.0,114685024.0,88433,93316,0.12206,0.1229,181749,222625759.0,1055,451,515,105907249.0,114163479.0,86853,92888,0.12194,0.1229,179741,220070729.0,966,2023-11-14 16:40:00
1016,FEES,666,470,151450861.0,90604147.0,123894,73647,0.12224,0.12302,197541,242055009.0,1136,639,440,149133968.0,89931956.0,122116,73066,0.12212,0.12308,195182,239065925.0,1079,2023-11-14 16:45:00
1017,FEES,576,298,88954572.0,48015181.0,72649,39011,0.12244,0.12308,111660,136969753.0,874,533,265,88960001.0,48656152.0,72673,39515,0.12241,0.12313,112188,137616154.0,798,2023-11-14 16:50:00
1018,FEES,3380,1996,554505960.0,486265404.0,451800,393394,0.12273,0.12361,845194,1040771364.0,5376,2309,1873,545669071.0,479405198.0,444737,387965,0.12269,0.12357,832702,1025074269.0,4182,2023-11-14 16:55:00
1019,FEES,897,435,213428876.0,77265049.0,177264,62510,0.1204,0.1236,239774,290693925.0,1332,835,373,184348965.0,75053005.0,150228,60686,0.12271,0.12367,210914,259401970.0,1208,2023-11-14 17:00:00
1020,FEES,985,778,208586649.0,159904240.0,169505,129359,0.12306,0.12361,298864,368490890.0,1763,951,721,203778646.0,156304426.0,165981,126439,0.12277,0.12362,292420,360083072.0,1672,2023-11-14 17:05:00
1021,FEES,335,428,65385976.0,72145769.0,53245,58399,0.1228,0.12354,111644,137531746.0,763,307,396,63834642.0,69654055.0,52019,56282,0.12271,0.12376,108301,133488698.0,703,2023-11-14 17:10:00
1022,FEES,963,2546,185063418.0,538964424.0,150927,437172,0.12262,0.12328,588099,724027843.0,3509,928,2493,210571730.0,536346632.0,175104,434992,0.12026,0.1233,610096,746918363.0,3421,2023-11-14 17:15:00
1023,FEES,1824,7947,299344966.0,1815184121.0,247533,1474533,0.12093,0.1231,1722066,2114529087.0,9771,1783,7923,272391055.0,1813897369.0,222169,1473453,0.12261,0.12311,1695622,2086288424.0,9706,2023-11-14 17:20:00
1024,FEES,869,6847,144261779.0,1585068361.0,117764,1287039,0.1225,0.12316,1404803,1729330141.0,7716,827,6816,141727961.0,1584657362.0,115812,1286709,0.12238,0.12316,1402521,1726385323.0,7643,2023-11-14 17:25:00
1025,FEES,679,3301,90674948.0,539049404.0,74067,437570,0.12242,0.12319,511637,629724352.0,3980,644,3280,88761095.0,538693625.0,72512,437274,0.12241,0.12319,509786,627454720.0,3924,2023-11-14 17:30:00
1026,FEES,367,3293,52518741.0,552872736.0,42861,449038,0.12253,0.12312,491899,605391478.0,3660,355,3284,54443384.0,550724627.0,44461,447251,0.12245,0.12314,491712,605168012.0,3639,2023-11-14 17:35:00
1027,FEES,1215,1640,211982140.0,286235494.0,173371,232833,0.12227,0.12294,406204,498217635.0,2855,1146,1554,209923656.0,283342289.0,171702,230436,0.12226,0.12296,402138,493265946.0,2700,2023-11-14 17:40:00
1028,FEES,317,375,40751339.0,78769228.0,33395,64084,0.12203,0.12292,97479,119520568.0,692,289,332,38528473.0,79242383.0,31568,64431,0.12205,0.12299,95999,117770857.0,621,2023-11-14 17:45:00
1029,FEES,908,3323,136673326.0,716019847.0,111738,581980,0.12232,0.12303,693718,852693174.0,4231,844,3257,133427063.0,715279899.0,109140,581385,0.12225,0.12303,690525,848706963.0,4101,2023-11-14 17:50:00
1030,FEES,460,1486,72212207.0,256512882.0,58978,208330,0.12244,0.12313,267308,328725090.0,1946,445,1403,71455013.0,258077056.0,58385,209451,0.12239,0.12322,267836,329532069.0,1848,2023-11-14 17:55:00
1031,FEES,302,637,8175878.0,70229928.0,6663,57125,0.12271,0.12294,63788,78405806.0,939,73,569,8029098.0,69661220.0,6549,56642,0.1226,0.12299,63191,77690318.0,642,2023-11-14 18:00:00
1032,FEES,291,325,43690384.0,39374998.0,35694,32043,0.1224,0.12288,67737,83065383.0,616,273,298,43526436.0,36982715.0,35560,30057,0.1224,0.12304,65617,80509151.0,571,2023-11-14 18:05:00
1033,FEES,260,466,40282374.0,54228564.0,32935,44114,0.12231,0.12293,77049,94510938.0,726,245,422,40700272.0,54297540.0,33279,44150,0.1223,0.12298,77429,94997812.0,667,2023-11-14 18:10:00
1034,FEES,342,769,33176010.0,86576213.0,27112,70596,0.12237,0.12264,97708,119752223.0,1111,309,708,31916049.0,86577171.0,26098,70479,0.12229,0.12284,96577,118493221.0,1017,2023-11-14 18:15:00
1035,FEES,288,474,39509340.0,73941620.0,32344,60329,0.12215,0.12256,92673,113450960.0,762,267,447,39409064.0,71584927.0,32269,58284,0.12213,0.12282,90553,110993992.0,714,2023-11-14 18:20:00
1036,FEES,893,792,183871645.0,114647886.0,150959,93844,0.1218,0.12217,244803,298519531.0,1685,790,767,178685979.0,110518557.0,146699,90119,0.1218,0.12264,236818,289204536.0,1557,2023-11-14 18:25:00
1037,FEES,915,1536,143370946.0,331709068.0,117965,271244,0.12154,0.12229,389209,475080015.0,2451,778,1486,137993923.0,326881587.0,113577,266975,0.1215,0.12244,380552,464875510.0,2264,2023-11-14 18:30:00
1038,FEES,677,956,76935762.0,219619750.0,63135,179320,0.12186,0.12247,242455,296555512.0,1633,602,927,74751541.0,220561250.0,61446,179843,0.12165,0.12264,241289,295312792.0,1529,2023-11-14 18:35:00
1039,FEES,2168,1763,395963504.0,375104082.0,324407,306607,0.12206,0.12234,631014,771067586.0,3931,2119,1721,400099428.0,378199393.0,327819,309068,0.12205,0.12237,636887,778298821.0,3840,2023-11-14 18:40:00
1040,FEES,1680,2773,32861.0,32861.0,279889,329324,1e-05,1e-05,609213,71900.0,4453,1461,2312,30918.0,30918.0,262930,305924,1e-05,1e-05,568854,67177.0,3773,2023-11-29 10:05:00
1041,FEES,1187,872,19495.0,19495.0,166218,120397,1e-05,1e-05,286615,33883.0,2059,1071,729,19629.0,19629.0,166714,104614,1e-05,1e-05,271328,32062.0,1800,2023-11-29 10:10:00
1042,FEES,1573,881,19674.0,19674.0,171260,108950,1e-05,1e-05,280210,32587.0,2454,1283,706,18820.0,18820.0,159195,99972,1e-05,1e-05,259167,30761.0,1989,2023-11-29 10:15:00
1043,FEES,548,633,9170.0,9170.0,80001,76297,1e-05,1e-05,156298,18217.0,1181,465,504,7936.0,7936.0,67092,67779,1e-05,1e-05,134871,16030.0,969,2023-11-29 10:20:00
1044,FEES,486,512,9394.0,9394.0,80654,70356,1e-05,1e-05,151010,17647.0,998,374,360,8404.0,8404.0,71092,60273,1e-05,1e-05,131365,15596.0,734,2023-11-29 10:25:00
1045,FEES,715,491,13599.0,13599.0,116409,95350,1e-05,1e-05,211759,24985.0,1206,580,380,13299.0,13299.0,112391,92688,1e-05,1e-05,205079,24379.0,960,2023-11-29 10:30:00
1046,FEES,1210,1125,32624.0,32624.0,278228,262559,1e-05,1e-05,540787,64040.0,2335,1041,935,32159.0,32159.0,271101,257145,1e-05,1e-05,528246,62988.0,1976,2023-11-29 10:35:00
1047,FEES,1073,1039,33007.0,33007.0,284035,245940,1e-05,1e-05,529975,62296.0,2112,925,819,32352.0,32352.0,272644,234220,1e-05,1e-05,506864,60414.0,1744,2023-11-29 10:40:00
1048,FEES,1294,959,35529.0,35529.0,300176,254920,1e-05,1e-05,555096,65964.0,2253,1193,805,34524.0,34524.0,290938,247108,1e-05,1e-05,538046,64120.0,1998,2023-11-29 10:45:00
1049,FEES,907,581,27659.0,27659.0,235646,159707,1e-05,1e-05,395353,46802.0,1488,835,484,27425.0,27425.0,230979,158053,1e-05,1e-05,389032,46399.0,1319,2023-11-29 10:50:00
1050,FEES,736,472,18169.0,18169.0,154341,103949,1e-05,1e-05,258290,30445.0,1208,690,397,18086.0,18086.0,152219,91613,1e-05,1e-05,243832,29069.0,1087,2023-11-29 10:55:00
1051,FEES,763,883,16442.0,16442.0,139083,179967,1e-05,1e-05,319050,37653.0,1646,641,775,15945.0,15945.0,134752,167379,1e-05,1e-05,302131,35942.0,1416,2023-11-29 11:00:00
1052,FEES,499,301,8917.0,8917.0,76151,58151,1e-05,1e-05,134302,15852.0,800,415,254,8349.0,8349.0,70569,54009,1e-05,1e-05,124578,14793.0,669,2023-11-29 11:05:00
1053,FEES,348,322,6449.0,6449.0,54716,65194,1e-05,1e-05,119910,14190.0,670,332,290,6433.0,6433.0,54287,63480,1e-05,1e-05,117767,14017.0,622,2023-11-29 11:10:00
1054,FEES,303,291,6430.0,6430.0,54581,58804,1e-05,1e-05,113385,13443.0,594,275,265,6405.0,6405.0,54095,58244,1e-05,1e-05,112339,13364.0,540,2023-11-29 11:15:00
1055,FEES,558,1186,14204.0,14204.0,120307,252641,1e-05,1e-05,372948,44095.0,1744,500,1159,14117.0,14117.0,119555,250629,1e-05,1e-05,370184,44009.0,1659,2023-11-29 11:20:00
1056,FEES,250,376,5659.0,5659.0,48049,79579,1e-05,1e-05,127628,15122.0,626,227,354,5025.0,5025.0,42536,79317,1e-05,1e-05,121853,14486.0,581,2023-11-29 11:25:00
1057,FEES,327,930,5496.0,5496.0,46573,192773,1e-05,1e-05,239346,28422.0,1257,285,891,5415.0,5415.0,45852,190474,1e-05,1e-05,236326,28074.0,1176,2023-11-29 11:30:00
1058,FEES,344,869,8273.0,8273.0,70194,165998,1e-05,1e-05,236192,27979.0,1213,314,836,8084.0,8084.0,68500,165530,1e-05,1e-05,234030,27774.0,1150,2023-11-29 11:35:00
1059,FEES,299,757,5135.0,5135.0,43490,144011,1e-05,1e-05,187501,22277.0,1056,289,734,5002.0,5002.0,42307,142900,1e-05,1e-05,185207,22019.0,1023,2023-11-29 11:40:00
1060,FEES,258,450,4296.0,4296.0,36399,73537,1e-05,1e-05,109936,13022.0,708,221,433,4234.0,4234.0,35871,72951,1e-05,1e-05,108822,12916.0,654,2023-11-29 11:45:00
1061,FEES,535,887,15888.0,15888.0,135162,185942,1e-05,1e-05,321104,37922.0,1422,481,763,15683.0,15683.0,133172,182156,1e-05,1e-05,315328,37336.0,1244,2023-11-29 11:50:00
1062,FEES,1488,2944,30971.0,30971.0,267616,750706,1e-05,1e-05,1018322,118752.0,4432,1310,2768,28239.0,28239.0,240999,737121,1e-05,1e-05,978120,115304.0,4078,2023-11-29 11:55:00
1063,FEES,602,682,11166.0,11166.0,95611,140492,1e-05,1e-05,236103,27650.0,1284,532,639,10560.0,10560.0,90134,140966,1e-05,1e-05,231100,27209.0,1171,2023-11-29 12:00:00
1064,FEES,509,1747,14529.0,14529.0,124198,313756,1e-05,1e-05,437954,51440.0,2256,452,1699,14055.0,14055.0,119992,311367,1e-05,1e-05,431359,50791.0,2151,2023-11-29 12:05:00
1065,FEES,342,1076,8559.0,8559.0,73118,198300,1e-05,1e-05,271418,31955.0,1418,321,1054,8528.0,8528.0,72829,197751,1e-05,1e-05,270580,31868.0,1375,2023-11-29 12:10:00
1066,FEES,433,578,11744.0,11744.0,101019,130324,1e-05,1e-05,231343,26956.0,1011,371,540,11404.0,11404.0,97664,126135,1e-05,1e-05,223799,26273.0,911,2023-11-29 12:15:00
1067,FEES,567,1160,14206.0,14206.0,122107,217608,1e-05,1e-05,339715,39775.0,1727,519,1128,13929.0,13929.0,119287,220338,1e-05,1e-05,339625,39869.0,1647,2023-11-29 12:20:00
1068,FEES,1207,1959,24080.0,24080.0,206082,412597,1e-05,1e-05,618679,72735.0,3166,1172,1924,23841.0,23841.0,203501,411264,1e-05,1e-05,614765,72343.0,3096,2023-11-29 12:25:00
1069,FEES,369,306,8120.0,8120.0,69369,64836,1e-05,1e-05,134205,15764.0,675,348,284,7994.0,7994.0,68252,64362,1e-05,1e-05,132614,15594.0,632,2023-11-29 12:30:00
1070,FEES,271,255,5807.0,5807.0,49677,48512,1e-05,1e-05,98189,11525.0,526,245,237,5809.0,5809.0,49697,43237,1e-05,1e-05,92934,10927.0,482,2023-11-29 12:35:00
1071,FEES,219,345,3624.0,3624.0,30985,55737,1e-05,1e-05,86722,10192.0,564,203,330,4040.0,4040.0,34549,57556,1e-05,1e-05,92105,10826.0,533,2023-11-29 12:40:00
1072,FEES,252,328,5760.0,5760.0,49302,66423,1e-05,1e-05,115725,13594.0,580,228,306,5236.0,5236.0,44781,62007,1e-05,1e-05,106788,12548.0,534,2023-11-29 12:45:00
1073,FEES,677,885,18425.0,18425.0,158160,180698,1e-05,1e-05,338858,39715.0,1562,627,867,18354.0,18354.0,156949,181151,1e-05,1e-05,338100,39712.0,1494,2023-11-29 12:50:00
1074,FEES,482,442,9000.0,9000.0,76987,69780,1e-05,1e-05,146767,17235.0,924,431,417,8983.0,8983.0,76695,68540,1e-05,1e-05,145235,17073.0,848,2023-11-29 12:55:00
1075,FEES,272,364,3907.0,3907.0,33302,56258,1e-05,1e-05,89560,10557.0,636,265,352,3832.0,3832.0,32665,56048,1e-05,1e-05,88713,10457.0,617,2023-11-29 13:00:00
1076,FEES,577,946,9374.0,9374.0,80008,199020,1e-05,1e-05,279028,32909.0,1523,550,937,9287.0,9287.0,79205,197400,1e-05,1e-05,276605,32632.0,1487,2023-11-29 13:05:00
1077,FEES,255,304,4269.0,4269.0,36410,42991,1e-05,1e-05,79401,9371.0,559,241,290,4313.0,4313.0,36752,42987,1e-05,1e-05,79739,9401.0,531,2023-11-29 13:10:00
1078,FEES,210,202,4487.0,4487.0,38279,23039,1e-05,1e-05,61318,7218.0,412,194,188,4545.0,4545.0,38736,22825,1e-05,1e-05,61561,7262.0,382,2023-11-29 13:15:00
1079,FEES,736,321,12501.0,12501.0,106975,39064,1e-05,1e-05,146039,17104.0,1057,714,298,12499.0,12499.0,106250,39020,1e-05,1e-05,145270,17117.0,1012,2023-11-29 13:20:00
1080,FEES,639,552,14661.0,14661.0,125240,101316,1e-05,1e-05,226556,26616.0,1191,617,519,14569.0,14569.0,123989,98757,1e-05,1e-05,222746,26274.0,1136,2023-11-29 13:25:00
1081,FEES,471,540,11409.0,11409.0,97359,100671,1e-05,1e-05,198030,23299.0,1011,452,521,11340.0,11340.0,96762,99591,1e-05,1e-05,196353,23107.0,973,2023-11-29 13:30:00
1082,FEES,561,520,11405.0,11405.0,97824,104234,1e-05,1e-05,202058,23734.0,1081,548,504,11422.0,11422.0,97291,103598,1e-05,1e-05,200889,23678.0,1052,2023-11-29 13:35:00
1083,FEES,235,405,3356.0,3356.0,28614,74687,1e-05,1e-05,103301,12172.0,640,209,387,3249.0,3249.0,27681,73609,1e-05,1e-05,101290,11939.0,596,2023-11-29 13:40:00
1084,FEES,245,300,5122.0,5122.0,43740,47779,1e-05,1e-05,91519,10764.0,545,227,289,5053.0,5053.0,43145,47365,1e-05,1e-05,90510,10651.0,516,2023-11-29 13:45:00
1085,FEES,357,439,8453.0,8453.0,72278,79253,1e-05,1e-05,151531,17786.0,796,301,410,8161.0,8161.0,69738,78159,1e-05,1e-05,147897,17389.0,711,2023-11-29 13:50:00
1086,FEES,195,292,4424.0,4424.0,37845,36800,1e-05,1e-05,74645,8731.0,487,170,271,4287.0,4287.0,36675,36209,1e-05,1e-05,72884,8556.0,441,2023-11-29 13:55:00
1087,FEES,315,406,6398.0,6398.0,55596,70445,1e-05,1e-05,126041,14718.0,721,303,391,6532.0,6532.0,55749,71324,1e-05,1e-05,127073,14954.0,694,2023-11-29 14:00:00
1088,FEES,873,1061,29123.0,29123.0,248614,161432,1e-05,1e-05,410046,48171.0,1934,867,1057,28585.0,28585.0,244026,161482,1e-05,1e-05,405508,47640.0,1924,2023-11-29 14:05:00
1089,FEES,433,1465,8391.0,8391.0,71512,227850,1e-05,1e-05,299362,35294.0,1898,400,1445,8007.0,8007.0,68253,225614,1e-05,1e-05,293867,34646.0,1845,2023-11-29 14:10:00
1090,FEES,374,539,7627.0,7627.0,65037,98197,1e-05,1e-05,163234,19297.0,913,366,513,8255.0,8255.0,70284,97586,1e-05,1e-05,167870,19816.0,879,2023-11-29 14:15:00
1091,FEES,373,679,7512.0,7512.0,64389,96152,1e-05,1e-05,160541,18880.0,1052,363,668,7484.0,7484.0,63752,96053,1e-05,1e-05,159805,18841.0,1031,2023-11-29 14:20:00
1092,FEES,495,722,15011.0,15011.0,128282,176778,1e-05,1e-05,305060,35817.0,1217,469,681,14900.0,14900.0,127273,166578,1e-05,1e-05,293851,34587.0,1150,2023-11-29 14:25:00
1093,FEES,989,842,27141.0,27141.0,231123,154344,1e-05,1e-05,385467,45376.0,1831,965,810,26383.0,26383.0,224609,163183,1e-05,1e-05,387792,45659.0,1775,2023-11-29 14:30:00
1094,FEES,734,1685,19113.0,19113.0,162990,308662,1e-05,1e-05,471652,55625.0,2419,716,1651,19439.0,19439.0,165322,307497,1e-05,1e-05,472819,55825.0,2367,2023-11-29 14:35:00
1095,FEES,350,508,8549.0,8549.0,73451,95101,1e-05,1e-05,168552,19805.0,858,318,484,7660.0,7660.0,65085,92880,1e-05,1e-05,157965,18667.0,802,2023-11-29 14:40:00
1096,FEES,487,554,11305.0,11305.0,96239,124190,1e-05,1e-05,220429,26020.0,1041,485,526,12478.0,12478.0,106069,122482,1e-05,1e-05,228551,26998.0,1011,2023-11-29 14:45:00
1097,FEES,1244,1056,31715.0,31715.0,270415,229564,1e-05,1e-05,499979,58846.0,2300,1178,1022,31460.0,31460.0,268192,220299,1e-05,1e-05,488491,57513.0,2200,2023-11-29 14:50:00
1098,FEES,1947,1402,43709.0,43709.0,372009,256105,1e-05,1e-05,628114,73980.0,3349,1917,1389,43530.0,43530.0,370476,264522,1e-05,1e-05,634998,74790.0,3306,2023-11-29 14:55:00
1099,FEES,549,1041,12223.0,12223.0,104202,149958,1e-05,1e-05,254160,29957.0,1590,530,1020,12263.0,12263.0,104315,149202,1e-05,1e-05,253517,29908.0,1550,2023-11-29 15:00:00
1100,FEES,301,784,7592.0,7592.0,64847,95043,1e-05,1e-05,159890,18832.0,1085,289,785,7578.0,7578.0,64548,94314,1e-05,1e-05,158862,18734.0,1074,2023-11-29 15:05:00
1101,FEES,384,208,7993.0,7993.0,67954,19398,1e-05,1e-05,87352,10285.0,592,362,196,7926.0,7926.0,67386,19628,1e-05,1e-05,87014,10248.0,558,2023-11-29 15:10:00
1102,FEES,360,364,5513.0,5513.0,46889,49061,1e-05,1e-05,95950,11316.0,724,350,356,5528.0,5528.0,47005,48961,1e-05,1e-05,95966,11318.0,706,2023-11-29 15:15:00
1103,FEES,237,93,4079.0,4079.0,34722,14570,1e-05,1e-05,49292,5808.0,330,226,84,4034.0,4034.0,34336,14888,1e-05,1e-05,49224,5802.0,310,2023-11-29 15:20:00
1104,FEES,461,315,11749.0,11749.0,100231,80540,1e-05,1e-05,180771,21247.0,776,449,298,11787.0,11787.0,100538,79920,1e-05,1e-05,180458,21238.0,747,2023-11-29 15:25:00
1105,FEES,298,125,5090.0,5090.0,43410,19316,1e-05,1e-05,62726,7373.0,423,278,124,5041.0,5041.0,42952,19168,1e-05,1e-05,62120,7307.0,402,2023-11-29 15:30:00
1106,FEES,972,344,18937.0,18937.0,161402,45859,1e-05,1e-05,207261,24364.0,1316,923,331,18929.0,18929.0,161047,45926,1e-05,1e-05,206973,24365.0,1254,2023-11-29 15:35:00
1107,FEES,378,549,10469.0,10469.0,89075,91483,1e-05,1e-05,180558,21326.0,927,340,518,10296.0,10296.0,87590,90757,1e-05,1e-05,178347,21065.0,858,2023-11-29 15:40:00
1108,FEES,416,252,8101.0,8101.0,68885,41856,1e-05,1e-05,110741,13057.0,668,405,235,8063.0,8063.0,68551,40109,1e-05,1e-05,108660,12821.0,640,2023-11-29 15:45:00
1109,FEES,1750,327,37786.0,37786.0,321125,37325,1e-05,1e-05,358450,42208.0,2077,1730,318,37746.0,37746.0,320752,37200,1e-05,1e-05,357952,42154.0,2048,2023-11-29 15:50:00
1110,FEES,2249,335,50118.0,50118.0,425982,28306,1e-05,1e-05,454288,53470.0,2584,2243,332,50124.0,50124.0,426022,28231,1e-05,1e-05,454253,53466.0,2575,2023-11-29 15:55:00
1111,FEES,403,326,8898.0,8898.0,75756,37710,1e-05,1e-05,113466,13350.0,729,381,299,8863.0,8863.0,75423,36773,1e-05,1e-05,112196,13219.0,680,2023-11-29 16:00:00
1112,FEES,364,304,7948.0,7948.0,67760,25342,1e-05,1e-05,93102,10943.0,668,349,293,7878.0,7878.0,67167,25038,1e-05,1e-05,92205,10838.0,642,2023-11-29 16:05:00
1113,FEES,609,422,14634.0,14634.0,124659,62540,1e-05,1e-05,187199,21986.0,1031,597,407,14378.0,14378.0,122499,60757,1e-05,1e-05,183256,21565.0,1004,2023-11-29 16:10:00
1114,FEES,506,530,12712.0,12712.0,108347,96743,1e-05,1e-05,205090,24154.0,1036,496,506,12467.0,12467.0,106211,92897,1e-05,1e-05,199108,23458.0,1002,2023-11-29 16:15:00
1115,FEES,535,662,10061.0,10061.0,86490,117392,1e-05,1e-05,203882,23926.0,1197,511,632,9974.0,9974.0,84998,116586,1e-05,1e-05,201584,23752.0,1143,2023-11-29 16:20:00
1116,FEES,238,803,4773.0,4773.0,40692,112846,1e-05,1e-05,153538,18087.0,1041,233,797,4775.0,4775.0,40713,113525,1e-05,1e-05,154238,18178.0,1030,2023-11-29 16:25:00
1117,FEES,175,478,2042.0,2042.0,17396,49647,1e-05,1e-05,67043,7901.0,653,167,472,2537.0,2537.0,21621,53529,1e-05,1e-05,75150,8863.0,639,2023-11-29 16:30:00
1118,FEES,203,382,5777.0,5777.0,49361,64421,1e-05,1e-05,113782,13390.0,585,189,362,5211.0,5211.0,44476,60536,1e-05,1e-05,105012,12366.0,551,2023-11-29 16:35:00
1119,FEES,271,436,5417.0,5417.0,46882,84644,1e-05,1e-05,131526,15407.0,707,240,410,5355.0,5355.0,45699,83887,1e-05,1e-05,129586,15273.0,650,2023-11-29 16:40:00
1120,FEES,581,924,15593.0,15593.0,133206,164709,1e-05,1e-05,297915,35028.0,1505,559,916,15627.0,15627.0,133478,163889,1e-05,1e-05,297367,34966.0,1475,2023-11-29 16:45:00
1121,FEES,359,892,9222.0,9222.0,78749,163347,1e-05,1e-05,242096,28491.0,1251,345,891,9156.0,9156.0,78188,163214,1e-05,1e-05,241402,28409.0,1236,2023-11-29 16:50:00
1122,FEES,154,386,2076.0,2076.0,17745,43671,1e-05,1e-05,61416,7230.0,540,139,373,2061.0,2061.0,17569,42447,1e-05,1e-05,60016,7073.0,512,2023-11-29 16:55:00
1123,FEES,124,98,2732.0,2732.0,23369,17116,1e-05,1e-05,40485,4753.0,222,113,95,2740.0,2740.0,23410,17612,1e-05,1e-05,41022,4821.0,208,2023-11-29 17:00:00
1124,FEES,252,196,4363.0,4363.0,37455,22468,1e-05,1e-05,59923,7011.0,448,222,184,4027.0,4027.0,34385,22721,1e-05,1e-05,57106,6709.0,406,2023-11-29 17:05:00
1125,FEES,391,754,8452.0,8452.0,72308,86337,1e-05,1e-05,158645,18377.0,1145,357,639,8302.0,8302.0,71007,83930,1e-05,1e-05,154937,18190.0,996,2023-11-29 17:10:00
1126,FEES,230,455,3713.0,3713.0,31727,63048,1e-05,1e-05,94775,11128.0,685,213,448,3656.0,3656.0,31240,62497,1e-05,1e-05,93737,11007.0,661,2023-11-29 17:15:00
1127,FEES,323,738,6036.0,6036.0,51594,119899,1e-05,1e-05,171493,20135.0,1061,305,727,6062.0,6062.0,51804,120140,1e-05,1e-05,171944,20198.0,1032,2023-11-29 17:20:00
1128,FEES,244,578,3798.0,3798.0,32496,107082,1e-05,1e-05,139578,16265.0,822,221,570,3735.0,3735.0,31949,108096,1e-05,1e-05,140045,16466.0,791,2023-11-29 17:25:00
1129,FEES,232,553,3714.0,3714.0,31830,96459,1e-05,1e-05,128289,15041.0,785,202,533,3599.0,3599.0,30822,95700,1e-05,1e-05,126522,14840.0,735,2023-11-29 17:30:00
1130,FEES,201,531,4047.0,4047.0,34710,83726,1e-05,1e-05,118436,13880.0,732,176,513,4011.0,4011.0,34370,82495,1e-05,1e-05,116865,13700.0,689,2023-11-29 17:35:00
1131,FEES,117,543,1596.0,1596.0,13632,94000,1e-05,1e-05,107632,12635.0,660,108,540,1596.0,1596.0,13628,93800,1e-05,1e-05,107428,12617.0,648,2023-11-29 17:40:00
1132,FEES,110,386,1549.0,1549.0,13315,55274,1e-05,1e-05,68589,8043.0,496,93,370,1522.0,1522.0,13036,55989,1e-05,1e-05,69025,8103.0,463,2023-11-29 17:45:00
1133,FEES,227,1549,2856.0,2856.0,24436,264414,1e-05,1e-05,288850,33934.0,1776,219,1530,2868.0,2868.0,24494,263951,1e-05,1e-05,288445,33897.0,1749,2023-11-29 17:50:00
1134,FEES,199,1397,3687.0,3687.0,31552,246733,1e-05,1e-05,278285,32683.0,1596,189,1383,3694.0,3694.0,31584,247495,1e-05,1e-05,279079,32788.0,1572,2023-11-29 17:55:00
1135,FEES,286,1700,5281.0,5281.0,45244,326756,1e-05,1e-05,372000,43644.0,1986,264,1690,4925.0,4925.0,42149,325567,1e-05,1e-05,367716,43166.0,1954,2023-11-29 18:00:00
1136,FEES,227,813,3804.0,3804.0,32564,163289,1e-05,1e-05,195853,22982.0,1040,220,810,3822.0,3822.0,32704,163502,1e-05,1e-05,196206,23027.0,1030,2023-11-29 18:05:00
1137,FEES,110,196,1730.0,1730.0,14823,25141,1e-05,1e-05,39964,4681.0,306,91,182,1717.0,1717.0,14710,25087,1e-05,1e-05,39797,4667.0,273,2023-11-29 18:10:00
1138,FEES,416,958,6064.0,6064.0,51819,151417,1e-05,1e-05,203236,23872.0,1374,415,943,6092.0,6092.0,52063,149821,1e-05,1e-05,201884,23710.0,1358,2023-11-29 18:15:00
1139,FEES,222,435,3846.0,3846.0,32991,50677,1e-05,1e-05,83668,9793.0,657,204,414,3821.0,3821.0,32705,50134,1e-05,1e-05,82839,9718.0,618,2023-11-29 18:20:00
1140,FEES,65,73,1355.0,1355.0,11625,13076,1e-05,1e-05,24701,2890.0,138,71,77,1398.0,1398.0,11989,11040,1e-05,1e-05,23029,2699.0,148,2023-11-29 18:25:00
1141,FEES,359,707,6726.0,6726.0,57779,110372,1e-05,1e-05,168151,19261.0,1066,297,653,6601.0,6601.0,56660,106664,1e-05,1e-05,163324,19123.0,950,2023-11-29 18:30:00
1142,FEES,432,1144,11837.0,11837.0,102115,147023,1e-05,1e-05,249138,28829.0,1576,352,1116,11438.0,11438.0,98623,144948,1e-05,1e-05,243571,28390.0,1468,2023-11-29 18:35:00
1143,FEES,519,897,5845.0,5845.0,50699,98039,1e-05,1e-05,148738,17304.0,1416,492,878,6265.0,6265.0,53796,107143,1e-05,1e-05,160939,18871.0,1370,2023-11-29 18:40:00
1144,FEES,24862,11070,419042.0,419042.0,3584418,1238697,1e-05,1e-05,4823115,564748.0,35932,24640,10732,416392.0,416392.0,3559399,1222421,1e-05,1e-05,4781820,560094.0,35372,2023-11-30 10:05:00
1145,FEES,1363,796,20516.0,20516.0,175971,69882,1e-05,1e-05,245853,28719.0,2159,1295,750,20384.0,20384.0,174777,64663,1e-05,1e-05,239440,27970.0,2045,2023-11-30 10:10:00
1146,FEES,4568,6890,65127.0,65127.0,557849,930849,1e-05,1e-05,1488698,174231.0,11458,4466,6823,64491.0,64491.0,552334,927004,1e-05,1e-05,1479338,173261.0,11289,2023-11-30 10:15:00
1147,FEES,984,2118,11358.0,11358.0,97926,290683,1e-05,1e-05,388609,45188.0,3102,903,2038,11175.0,11175.0,96275,288142,1e-05,1e-05,384417,44844.0,2941,2023-11-30 10:20:00
1148,FEES,704,969,8425.0,8425.0,72733,167183,1e-05,1e-05,239916,27947.0,1673,621,939,7819.0,7819.0,67343,163679,1e-05,1e-05,231022,26954.0,1560,2023-11-30 10:25:00
1149,FEES,445,487,5925.0,5925.0,51340,77513,1e-05,1e-05,128853,14959.0,932,361,436,5798.0,5798.0,49996,76676,1e-05,1e-05,126672,14759.0,797,2023-11-30 10:30:00
1150,FEES,435,1075,7820.0,7820.0,67656,162162,1e-05,1e-05,229818,26718.0,1510,347,1045,7523.0,7523.0,64905,161617,1e-05,1e-05,226522,26375.0,1392,2023-11-30 10:35:00
1151,FEES,490,948,15001.0,15001.0,129405,180820,1e-05,1e-05,310225,36147.0,1438,444,925,14772.0,14772.0,127376,178383,1e-05,1e-05,305759,35613.0,1369,2023-11-30 10:40:00
1152,FEES,285,1127,6240.0,6240.0,53844,205639,1e-05,1e-05,259483,30231.0,1412,259,1099,6279.0,6279.0,54147,204257,1e-05,1e-05,258404,30130.0,1358,2023-11-30 10:45:00
1153,FEES,550,6301,8176.0,8176.0,70514,1058933,1e-05,1e-05,1129447,131561.0,6851,548,6269,8100.0,8100.0,69838,1057357,1e-05,1e-05,1127195,131301.0,6817,2023-11-30 10:50:00
1154,FEES,201,194,4004.0,4004.0,34610,30085,1e-05,1e-05,64695,7454.0,395,167,159,4054.0,4054.0,35014,27445,1e-05,1e-05,62459,7260.0,326,2023-11-30 10:55:00
1155,FEES,213,392,5751.0,5751.0,49741,68606,1e-05,1e-05,118347,13632.0,605,200,341,5909.0,5909.0,51079,66751,1e-05,1e-05,117830,13701.0,541,2023-11-30 11:00:00
1156,FEES,1218,4190,31917.0,31917.0,277606,875821,1e-05,1e-05,1153427,132964.0,5408,1064,4088,30776.0,30776.0,267524,867501,1e-05,1e-05,1135025,131320.0,5152,2023-11-30 11:05:00
1157,FEES,1180,7220,31610.0,31610.0,276437,1586887,1e-05,1e-05,1863324,214640.0,8400,996,7147,30572.0,30572.0,266687,1581190,1e-05,1e-05,1847877,213364.0,8143,2023-11-30 11:10:00
1158,FEES,596,1337,14721.0,14721.0,129012,267169,1e-05,1e-05,396181,44683.0,1933,476,1248,14705.0,14705.0,128631,257243,1e-05,1e-05,385874,44360.0,1724,2023-11-30 11:15:00
1159,FEES,869,1033,18927.0,18927.0,166862,250252,1e-05,1e-05,417114,47686.0,1902,710,974,17839.0,17839.0,156090,245030,1e-05,1e-05,401120,46087.0,1684,2023-11-30 11:20:00
1160,FEES,499,507,6869.0,6869.0,60029,93094,1e-05,1e-05,153123,17633.0,1006,418,481,6684.0,6684.0,58331,91792,1e-05,1e-05,150123,17299.0,899,2023-11-30 11:25:00
1161,FEES,288,225,3349.0,3349.0,29333,40001,1e-05,1e-05,69334,7979.0,513,205,199,3114.0,3114.0,27145,39807,1e-05,1e-05,66952,7724.0,404,2023-11-30 11:30:00
1162,FEES,773,675,10604.0,10604.0,94142,128373,1e-05,1e-05,222515,25468.0,1448,553,596,10489.0,10489.0,91273,126000,1e-05,1e-05,217273,25087.0,1149,2023-11-30 11:35:00
1163,FEES,773,878,15394.0,15394.0,135610,191455,1e-05,1e-05,327065,37590.0,1651,698,819,15218.0,15218.0,132287,189160,1e-05,1e-05,321447,37154.0,1517,2023-11-30 11:40:00
1164,FEES,651,557,10213.0,10213.0,88943,117030,1e-05,1e-05,205973,23798.0,1208,592,523,10069.0,10069.0,87368,115530,1e-05,1e-05,202898,23487.0,1115,2023-11-30 11:45:00
1165,FEES,656,506,10729.0,10729.0,93179,103060,1e-05,1e-05,196239,22630.0,1162,595,459,10443.0,10443.0,90654,100391,1e-05,1e-05,191045,22104.0,1054,2023-11-30 11:50:00
1166,FEES,472,276,6700.0,6700.0,58127,43990,1e-05,1e-05,102117,11787.0,748,417,248,6645.0,6645.0,57663,41133,1e-05,1e-05,98796,11429.0,665,2023-11-30 11:55:00
1167,FEES,713,391,9844.0,9844.0,85605,72501,1e-05,1e-05,158106,18281.0,1104,628,345,9576.0,9576.0,82895,72324,1e-05,1e-05,155219,18000.0,973,2023-11-30 12:00:00
1168,FEES,843,808,12974.0,12974.0,112897,165967,1e-05,1e-05,278864,32337.0,1651,775,744,12788.0,12788.0,110476,164258,1e-05,1e-05,274734,31955.0,1519,2023-11-30 12:05:00
1169,FEES,501,601,7595.0,7595.0,65871,115771,1e-05,1e-05,181642,21114.0,1102,439,558,7457.0,7457.0,64297,115643,1e-05,1e-05,179940,20968.0,997,2023-11-30 12:10:00
1170,FEES,7451,3299,297367.0,297367.0,2564946,806839,1e-05,1e-05,3371785,391721.0,10750,7292,3134,295702.0,295702.0,2550665,794314,1e-05,1e-05,3344979,388602.0,10426,2023-11-30 12:15:00
1171,FEES,2414,3290,61817.0,61817.0,531836,667671,1e-05,1e-05,1199507,140002.0,5704,2325,3194,61257.0,61257.0,526046,662028,1e-05,1e-05,1188074,138800.0,5519,2023-11-30 12:20:00
1172,FEES,1688,1881,42365.0,42365.0,364941,410262,1e-05,1e-05,775203,90302.0,3569,1552,1771,41315.0,41315.0,355851,402536,1e-05,1e-05,758387,88358.0,3323,2023-11-30 12:25:00
1173,FEES,435,509,5377.0,5377.0,46358,63065,1e-05,1e-05,109423,12740.0,944,390,479,5250.0,5250.0,45261,62014,1e-05,1e-05,107275,12497.0,869,2023-11-30 12:30:00
1174,FEES,412,498,7197.0,7197.0,62196,74766,1e-05,1e-05,136962,15914.0,910,360,450,7147.0,7147.0,61750,73868,1e-05,1e-05,135618,15771.0,810,2023-11-30 12:35:00
1175,FEES,1711,1821,44267.0,44267.0,381560,405872,1e-05,1e-05,787432,91679.0,3532,1591,1708,43692.0,43692.0,376592,400013,1e-05,1e-05,776605,90420.0,3299,2023-11-30 12:40:00
1176,FEES,1225,2662,22381.0,22381.0,192769,422477,1e-05,1e-05,615246,71757.0,3887,1168,2630,22259.0,22259.0,191495,422222,1e-05,1e-05,613717,71608.0,3798,2023-11-30 12:45:00
1177,FEES,2568,514,55223.0,55223.0,477635,94046,1e-05,1e-05,571681,66222.0,3082,2510,461,55212.0,55212.0,473726,91344,1e-05,1e-05,565070,65925.0,2971,2023-11-30 12:50:00
1178,FEES,1023,447,20949.0,20949.0,179626,85070,1e-05,1e-05,264696,30917.0,1470,949,410,20554.0,20554.0,176230,82656,1e-05,1e-05,258886,30238.0,1359,2023-11-30 12:55:00
1179,FEES,705,352,15699.0,15699.0,134924,63971,1e-05,1e-05,198895,23182.0,1057,683,321,15724.0,15724.0,135008,64017,1e-05,1e-05,199025,23248.0,1004,2023-11-30 13:00:00
1180,FEES,677,391,15546.0,15546.0,133541,83393,1e-05,1e-05,216934,25423.0,1068,658,369,15527.0,15527.0,133260,69056,1e-05,1e-05,202316,23630.0,1027,2023-11-30 13:05:00
1181,FEES,1617,618,34205.0,34205.0,293263,118333,1e-05,1e-05,411596,48094.0,2235,1607,590,34286.0,34286.0,293942,117033,1e-05,1e-05,410975,48023.0,2197,2023-11-30 13:10:00
1182,FEES,1194,354,22863.0,22863.0,196145,54245,1e-05,1e-05,250390,29224.0,1548,1173,342,22860.0,22860.0,195940,54527,1e-05,1e-05,250467,29258.0,1515,2023-11-30 13:15:00
1183,FEES,806,303,15710.0,15710.0,134734,64820,1e-05,1e-05,199554,23322.0,1109,786,279,15693.0,15693.0,134468,62400,1e-05,1e-05,196868,23026.0,1065,2023-11-30 13:20:00
1184,FEES,951,285,21018.0,21018.0,180127,52101,1e-05,1e-05,232228,27140.0,1236,905,259,20941.0,20941.0,179481,51954,1e-05,1e-05,231435,27050.0,1164,2023-11-30 13:25:00
1185,FEES,288,141,3307.0,3307.0,28379,17668,1e-05,1e-05,46047,5391.0,429,255,116,3148.0,3148.0,27003,16931,1e-05,1e-05,43934,5143.0,371,2023-11-30 13:30:00
1186,FEES,4124,509,73069.0,73069.0,623653,98527,1e-05,1e-05,722180,84638.0,4633,4069,460,72837.0,72837.0,621628,94867,1e-05,1e-05,716495,83999.0,4529,2023-11-30 13:35:00
1187,FEES,1029,433,20611.0,20611.0,176506,71479,1e-05,1e-05,247985,29044.0,1462,997,400,20693.0,20693.0,176983,70575,1e-05,1e-05,247558,29016.0,1397,2023-11-30 13:40:00
1188,FEES,1202,505,22363.0,22363.0,190914,79915,1e-05,1e-05,270829,31774.0,1707,1122,431,22099.0,22099.0,188607,78829,1e-05,1e-05,267436,31407.0,1553,2023-11-30 13:45:00
1189,FEES,1432,288,24163.0,24163.0,206143,56819,1e-05,1e-05,262962,30889.0,1720,1388,254,24127.0,24127.0,205506,55790,1e-05,1e-05,261296,30730.0,1642,2023-11-30 13:50:00
1190,FEES,1896,528,34798.0,34798.0,296581,100359,1e-05,1e-05,396940,46680.0,2424,1831,444,34644.0,34644.0,294690,98569,1e-05,1e-05,393259,46330.0,2275,2023-11-30 13:55:00
1191,FEES,1139,446,23560.0,23560.0,200277,84691,1e-05,1e-05,284968,33585.0,1585,1075,398,23628.0,23628.0,200852,85740,1e-05,1e-05,286592,33794.0,1473,2023-11-30 14:00:00
1192,FEES,2153,358,42866.0,42866.0,363865,59440,1e-05,1e-05,423305,49913.0,2511,2100,291,42706.0,42706.0,362485,58580,1e-05,1e-05,421065,49659.0,2391,2023-11-30 14:05:00
1193,FEES,771,418,16272.0,16272.0,138460,72150,1e-05,1e-05,210610,24787.0,1189,708,365,15901.0,15901.0,135264,71433,1e-05,1e-05,206697,24360.0,1073,2023-11-30 14:10:00
1194,FEES,343,265,7392.0,7392.0,63136,45379,1e-05,1e-05,108515,12742.0,608,280,212,7280.0,7280.0,62096,44403,1e-05,1e-05,106499,12535.0,492,2023-11-30 14:15:00
1195,FEES,569,380,12548.0,12548.0,107178,80289,1e-05,1e-05,187467,22025.0,949,527,323,12360.0,12360.0,105428,76296,1e-05,1e-05,181724,21388.0,850,2023-11-30 14:20:00
1196,FEES,206,100,3238.0,3238.0,27611,17908,1e-05,1e-05,45519,5351.0,306,168,84,3106.0,3106.0,26499,18206,1e-05,1e-05,44705,5260.0,252,2023-11-30 14:25:00
1197,FEES,775,283,14874.0,14874.0,126903,71917,1e-05,1e-05,198820,23386.0,1058,715,253,14637.0,14637.0,124575,71203,1e-05,1e-05,195778,23072.0,968,2023-11-30 14:30:00
1198,FEES,455,312,7752.0,7752.0,66175,53284,1e-05,1e-05,119459,14046.0,767,408,254,7494.0,7494.0,63665,52059,1e-05,1e-05,115724,13670.0,662,2023-11-30 14:35:00
1199,FEES,1048,552,19849.0,19849.0,168770,116536,1e-05,1e-05,285306,33672.0,1600,970,454,19691.0,19691.0,167306,111985,1e-05,1e-05,279291,32986.0,1424,2023-11-30 14:40:00
1200,FEES,406,193,6646.0,6646.0,56452,38932,1e-05,1e-05,95384,11258.0,599,352,163,6415.0,6415.0,54511,38518,1e-05,1e-05,93029,10990.0,515,2023-11-30 14:45:00
1201,FEES,818,446,15847.0,15847.0,134672,104256,1e-05,1e-05,238928,28253.0,1264,717,372,15415.0,15415.0,130765,101218,1e-05,1e-05,231983,27462.0,1089,2023-11-30 14:50:00
1202,FEES,203,163,3057.0,3057.0,25965,26664,1e-05,1e-05,52629,6227.0,366,176,110,2952.0,2952.0,25056,24681,1e-05,1e-05,49737,5889.0,286,2023-11-30 14:55:00
1203,FEES,711,285,13181.0,13181.0,111768,52137,1e-05,1e-05,163905,19403.0,996,645,227,12980.0,12980.0,109942,46236,1e-05,1e-05,156178,18496.0,872,2023-11-30 15:00:00
1204,FEES,420,233,7086.0,7086.0,60307,42686,1e-05,1e-05,102993,12163.0,653,353,160,6803.0,6803.0,57633,41190,1e-05,1e-05,98823,11712.0,513,2023-11-30 15:05:00
1205,FEES,715,478,13181.0,13181.0,113509,84910,1e-05,1e-05,198419,23261.0,1193,591,347,12884.0,12884.0,109001,79813,1e-05,1e-05,188814,22409.0,938,2023-11-30 15:10:00
1206,FEES,679,356,12173.0,12173.0,104229,73846,1e-05,1e-05,178075,21036.0,1035,591,289,11984.0,11984.0,101334,71278,1e-05,1e-05,172612,20584.0,880,2023-11-30 15:15:00
1207,FEES,725,485,12510.0,12510.0,106348,86626,1e-05,1e-05,192974,22842.0,1210,668,369,12252.0,12252.0,103477,82343,1e-05,1e-05,185820,22097.0,1037,2023-11-30 15:20:00
1208,FEES,390,236,6276.0,6276.0,53227,35273,1e-05,1e-05,88500,10472.0,626,342,182,5988.0,5988.0,50557,34520,1e-05,1e-05,85077,10115.0,524,2023-11-30 15:25:00
1209,FEES,313,250,5207.0,5207.0,44028,40349,1e-05,1e-05,84377,9980.0,563,241,181,5090.0,5090.0,43033,38816,1e-05,1e-05,81849,9724.0,422,2023-11-30 15:30:00
1210,FEES,370,200,6591.0,6591.0,55708,32059,1e-05,1e-05,87767,10396.0,570,326,162,6522.0,6522.0,55125,30923,1e-05,1e-05,86048,10214.0,488,2023-11-30 15:35:00
1211,FEES,840,346,14073.0,14073.0,118857,63746,1e-05,1e-05,182603,21672.0,1186,810,288,13735.0,13735.0,115813,62238,1e-05,1e-05,178051,21181.0,1098,2023-11-30 15:40:00
1212,FEES,694,361,11226.0,11226.0,94673,54109,1e-05,1e-05,148782,17679.0,1055,661,319,11194.0,11194.0,94362,54982,1e-05,1e-05,149344,17763.0,980,2023-11-30 15:45:00
1213,FEES,812,632,18780.0,18780.0,158600,118411,1e-05,1e-05,277011,32900.0,1444,755,481,18557.0,18557.0,156660,114672,1e-05,1e-05,271332,32251.0,1236,2023-11-30 15:50:00
1214,FEES,298,248,4926.0,4926.0,41637,33772,1e-05,1e-05,75409,8930.0,546,248,208,4749.0,4749.0,40107,31762,1e-05,1e-05,71869,8544.0,456,2023-11-30 15:55:00
1215,FEES,807,707,15605.0,15605.0,131979,105838,1e-05,1e-05,237817,28045.0,1514,718,633,15276.0,15276.0,129140,102864,1e-05,1e-05,232004,27529.0,1351,2023-11-30 16:00:00
1216,FEES,770,666,15824.0,15824.0,134518,115737,1e-05,1e-05,250255,29424.0,1436,669,596,15731.0,15731.0,133227,112690,1e-05,1e-05,245917,29150.0,1265,2023-11-30 16:05:00
1217,FEES,901,897,21070.0,21070.0,178736,179229,1e-05,1e-05,357965,42336.0,1798,793,824,20300.0,20300.0,172173,174329,1e-05,1e-05,346502,41024.0,1617,2023-11-30 16:10:00
1218,FEES,486,525,9199.0,9199.0,78037,93677,1e-05,1e-05,171714,20346.0,1011,414,473,9070.0,9070.0,76960,86626,1e-05,1e-05,163586,19370.0,887,2023-11-30 16:15:00
1219,FEES,564,549,10616.0,10616.0,89967,95415,1e-05,1e-05,185382,22043.0,1113,494,476,10236.0,10236.0,86771,87073,1e-05,1e-05,173844,20594.0,970,2023-11-30 16:20:00
1220,FEES,827,738,13878.0,13878.0,117253,110938,1e-05,1e-05,228191,27049.0,1565,778,688,13818.0,13818.0,116743,108618,1e-05,1e-05,225361,26759.0,1466,2023-11-30 16:25:00
1221,FEES,411,729,8435.0,8435.0,71387,101868,1e-05,1e-05,173255,20523.0,1140,356,676,8162.0,8162.0,69103,98958,1e-05,1e-05,168061,19950.0,1032,2023-11-30 16:30:00
1222,FEES,597,659,10790.0,10790.0,91418,115194,1e-05,1e-05,206612,24462.0,1256,533,627,10635.0,10635.0,90064,116146,1e-05,1e-05,206210,24451.0,1160,2023-11-30 16:35:00
1223,FEES,823,1126,19722.0,19722.0,167353,196618,1e-05,1e-05,363971,42668.0,1949,745,1064,19452.0,19452.0,165035,191432,1e-05,1e-05,356467,42170.0,1809,2023-11-30 16:40:00
1224,FEES,914,1387,19394.0,19394.0,164912,317536,1e-05,1e-05,482448,56966.0,2301,837,1320,19048.0,19048.0,161981,315683,1e-05,1e-05,477664,56489.0,2157,2023-11-30 16:45:00
1225,FEES,1185,3945,16761.0,16761.0,142375,951211,1e-05,1e-05,1093586,129446.0,5130,1128,3913,16652.0,16652.0,141435,949532,1e-05,1e-05,1090967,129207.0,5041,2023-11-30 16:50:00
1226,FEES,647,1367,10463.0,10463.0,89016,359729,1e-05,1e-05,448745,53104.0,2014,594,1332,10278.0,10278.0,87339,358507,1e-05,1e-05,445846,52800.0,1926,2023-11-30 16:55:00
1227,FEES,391,241,6566.0,6566.0,56208,56931,1e-05,1e-05,113139,13275.0,632,353,201,6614.0,6614.0,56230,54444,1e-05,1e-05,110674,13085.0,554,2023-11-30 17:00:00
1228,FEES,398,2535,5669.0,5669.0,48176,610948,1e-05,1e-05,659124,77965.0,2933,342,2487,5617.0,5617.0,47766,610454,1e-05,1e-05,658220,77881.0,2829,2023-11-30 17:05:00
1229,FEES,732,1208,16197.0,16197.0,138001,321749,1e-05,1e-05,459750,54134.0,1940,621,1161,15553.0,15553.0,132425,317990,1e-05,1e-05,450415,53240.0,1782,2023-11-30 17:10:00
1230,FEES,322,334,3151.0,3151.0,26906,51607,1e-05,1e-05,78513,9268.0,656,279,300,3040.0,3040.0,25855,51518,1e-05,1e-05,77373,9151.0,579,2023-11-30 17:15:00
1231,FEES,223,191,2950.0,2950.0,25481,27370,1e-05,1e-05,52851,6196.0,414,188,166,2721.0,2721.0,23106,26745,1e-05,1e-05,49851,5897.0,354,2023-11-30 17:20:00
1232,FEES,274,291,4137.0,4137.0,35093,45366,1e-05,1e-05,80459,9533.0,565,223,261,3717.0,3717.0,31559,45630,1e-05,1e-05,77189,9143.0,484,2023-11-30 17:25:00
1233,FEES,371,579,5350.0,5350.0,45453,88740,1e-05,1e-05,134193,15910.0,950,344,532,5099.0,5099.0,43176,87970,1e-05,1e-05,131146,15566.0,876,2023-11-30 17:30:00
1234,FEES,771,430,7903.0,7903.0,66976,84751,1e-05,1e-05,151727,18018.0,1201,455,368,7355.0,7355.0,62185,81653,1e-05,1e-05,143838,17100.0,823,2023-11-30 17:35:00
1235,FEES,710,556,14853.0,14853.0,127199,138029,1e-05,1e-05,265228,31483.0,1266,624,469,14582.0,14582.0,123040,123540,1e-05,1e-05,246580,29379.0,1093,2023-11-30 17:40:00
1236,FEES,593,471,11560.0,11560.0,97479,70133,1e-05,1e-05,167612,19902.0,1064,508,359,11388.0,11388.0,95781,85651,1e-05,1e-05,181432,21866.0,867,2023-11-30 17:45:00
1237,FEES,1879,1145,40026.0,40026.0,337282,205578,1e-05,1e-05,542860,64713.0,3024,1724,790,38410.0,38410.0,321251,199709,1e-05,1e-05,520960,62582.0,2514,2023-11-30 17:50:00
1238,FEES,914,958,16255.0,16255.0,136494,168891,1e-05,1e-05,305385,36401.0,1872,737,764,15879.0,15879.0,132977,162649,1e-05,1e-05,295626,35459.0,1501,2023-11-30 17:55:00
1239,FEES,580,329,8934.0,8934.0,78174,50565,1e-05,1e-05,128739,15012.0,909,478,265,8391.0,8391.0,70317,47847,1e-05,1e-05,118164,14158.0,743,2023-11-30 18:00:00
1240,FEES,748,597,13186.0,13186.0,112049,103217,1e-05,1e-05,215266,25573.0,1345,651,515,12479.0,12479.0,104353,99224,1e-05,1e-05,203577,24445.0,1166,2023-11-30 18:05:00
1241,FEES,467,217,8615.0,8615.0,72750,26691,1e-05,1e-05,99441,11816.0,684,364,156,9694.0,9694.0,81714,24304,1e-05,1e-05,106018,12627.0,520,2023-11-30 18:10:00
1242,FEES,1883,1683,49438.0,49438.0,416778,344152,1e-05,1e-05,760930,90911.0,3566,1652,1341,48664.0,48664.0,404866,329186,1e-05,1e-05,734052,88592.0,2993,2023-11-30 18:15:00
1243,FEES,1434,1139,33544.0,33544.0,281982,216880,1e-05,1e-05,498862,59775.0,2573,1294,1015,33075.0,33075.0,275332,213231,1e-05,1e-05,488563,58921.0,2309,2023-11-30 18:20:00
1244,FEES,630,487,13443.0,13443.0,112047,67832,1e-05,1e-05,179879,21567.0,1117,554,330,13160.0,13160.0,109436,63264,1e-05,1e-05,172700,20836.0,884,2023-11-30 18:25:00
1245,FEES,712,406,10145.0,10145.0,87577,85787,1e-05,1e-05,173364,20555.0,1118,635,310,10376.0,10376.0,86260,85440,1e-05,1e-05,171700,20752.0,945,2023-11-30 18:30:00
1246,FEES,851,411,20254.0,20254.0,168512,92333,1e-05,1e-05,260845,31371.0,1262,754,307,19400.0,19400.0,161201,83107,1e-05,1e-05,244308,29492.0,1061,2023-11-30 18:35:00
1247,FEES,599,203,6780.0,6780.0,58259,21217,1e-05,1e-05,79476,9301.0,802,553,154,7318.0,7318.0,60852,23496,1e-05,1e-05,84348,10165.0,707,2023-11-30 18:40:00
0,GAZP,4252,3090,836481720.0,784218662.0,497368,459752,168.18,170.57,957120,1620700382.0,7342,3441,2532,734467864.0,650728636.0,437674,386553,167.81,168.34,824227,1385196501.0,5973,2023-11-01 10:05:00
1,GAZP,2810,2086,574803269.0,476965740.0,341896,280306,168.12,170.16,622202,1051769010.0,4896,2213,1636,509223300.0,353965060.0,303144,208065,167.98,170.12,511209,863188361.0,3849,2023-11-01 10:10:00
2,GAZP,4319,3254,1082824428.0,758984468.0,644218,446688,168.08,169.91,1090906,1841808896.0,7573,3784,2928,1037589438.0,689767747.0,617616,407201,168.0,169.39,1024817,1727357185.0,6712,2023-11-01 10:15:00
3,GAZP,4724,3710,1282230472.0,1077030165.0,764206,638883,167.79,168.58,1403089,2359260637.0,8434,4115,3432,1237909913.0,1005889408.0,736852,593484,168.0,169.49,1330336,2243799322.0,7547,2023-11-01 10:20:00
4,GAZP,3721,4172,1026236949.0,1435297579.0,611623,850657,167.79,168.73,1462280,2461534529.0,7893,3098,3958,985246934.0,1410347580.0,587696,837643,167.65,168.37,1425339,2395594515.0,7056,2023-11-01 10:25:00
5,GAZP,2164,3280,688634495.0,999851375.0,410142,577211,167.9,173.22,987353,1688485870.0,5444,1663,2456,669452521.0,930200805.0,398962,552200,167.8,168.45,951162,1599653326.0,4119,2023-11-01 10:30:00
6,GAZP,2183,1230,595860619.0,545385828.0,354891,320645,167.9,170.09,675536,1141246447.0,3413,1657,1063,569135024.0,571345242.0,339222,337191,167.78,169.44,676413,1140480266.0,2720,2023-11-01 10:35:00
7,GAZP,1702,929,534305128.0,541815927.0,302735,320475,176.49,169.07,623210,1076121056.0,2631,1266,752,486362414.0,525823453.0,289710,311820,167.88,168.63,601530,1012185868.0,2018,2023-11-01 10:40:00
8,GAZP,1503,1209,433941043.0,572980000.0,258148,339840,168.1,168.6,597988,1006921043.0,2712,1113,1061,421099805.0,555792072.0,250904,329806,167.83,168.52,580710,976891878.0,2174,2023-11-01 10:45:00
9,GAZP,1744,852,540148661.0,405075643.0,321402,240262,168.06,168.6,561664,945224305.0,2596,1247,730,515921957.0,389290060.0,307271,230518,167.9,168.88,537789,905212017.0,1977,2023-11-01 10:50:00
10,GAZP,2108,2547,724638603.0,797332201.0,426250,472252,170.0,168.84,898502,1521970804.0,4655,1583,2372,676166203.0,754146754.0,402892,447720,167.83,168.44,850612,1430312957.0,3955,2023-11-01 10:55:00
11,GAZP,2059,2947,579225032.0,1249601683.0,340109,741974,170.31,168.42,1082083,1828826716.0,5006,1603,2768,561447509.0,1250699518.0,329613,727093,170.34,172.01,1056706,1812147027.0,4371,2023-11-01 11:00:00
12,GAZP,2234,4092,666963187.0,1770551420.0,384038,1052346,173.67,168.25,1436384,2437514607.0,6326,1768,3932,656162774.0,1696864326.0,376187,1008103,174.42,168.32,1384290,2353027101.0,5700,2023-11-01 11:05:00
13,GAZP,2780,5699,764607554.0,1864655850.0,455077,1108190,168.02,168.26,1563267,2629263405.0,8479,2281,5589,754281920.0,1862563825.0,442587,1106637,170.43,168.31,1549224,2616845745.0,7870,2023-11-01 11:10:00
14,GAZP,1787,774,537170844.0,384802860.0,319700,228066,168.02,168.72,547766,921973704.0,2561,1404,643,534296389.0,370882300.0,318293,220043,167.86,168.55,538336,905178689.0,2047,2023-11-01 11:15:00
15,GAZP,1454,2635,436929481.0,1312596769.0,257022,780216,170.0,168.24,1037238,1749526251.0,4089,1051,2511,411711272.0,1278021623.0,245257,759354,167.87,168.3,1004611,1689732895.0,3562,2023-11-01 11:20:00
16,GAZP,2294,1659,484988443.0,486621465.0,288589,288996,168.06,168.38,577585,971609908.0,3953,1707,1550,462292107.0,468528610.0,275305,278189,167.92,168.42,553494,930820717.0,3257,2023-11-01 11:25:00
17,GAZP,2123,1091,558960942.0,426884652.0,330163,253502,169.3,168.39,583665,985845594.0,3214,1711,1011,549787107.0,413320444.0,324621,245248,169.36,168.53,569869,963107551.0,2722,2023-11-01 11:30:00
18,GAZP,2578,1939,893894628.0,776206021.0,530847,460840,168.39,168.43,991687,1670100650.0,4517,2066,1790,846652357.0,757041723.0,504134,449230,167.94,168.52,953364,1603694080.0,3856,2023-11-01 11:35:00
19,GAZP,3625,2785,1232869448.0,1154737344.0,724673,683302,170.13,168.99,1407975,2387606792.0,6410,2516,2361,1098710218.0,1111387094.0,650331,657389,168.95,169.06,1307720,2210097312.0,4877,2023-11-01 11:40:00
20,GAZP,5268,4037,1988100447.0,1846577323.0,1176987,1091614,168.91,169.16,2268601,3834677770.0,9305,4169,3334,1920957814.0,1756778400.0,1138928,1037195,168.66,169.38,2176123,3677736214.0,7503,2023-11-01 11:45:00
21,GAZP,4939,5876,1704216545.0,2326824597.0,1009759,1370571,168.77,169.77,2380330,4031041142.0,10815,4216,5447,1610433509.0,2229007925.0,954763,1312456,168.67,169.83,2267219,3839441434.0,9663,2023-11-01 11:50:00
22,GAZP,3072,2532,1257533770.0,1124353354.0,743484,641772,169.14,175.2,1385256,2381887125.0,5604,2466,2171,1175751377.0,1057163618.0,696512,603412,168.81,175.2,1299924,2232914995.0,4637,2023-11-01 11:55:00
23,GAZP,6090,5243,2313603984.0,2617911528.0,1369767,1520568,168.9,172.17,2890335,4931515512.0,11333,5412,4754,2187069003.0,2545141110.0,1295976,1478264,168.76,172.17,2774240,4732210113.0,10166,2023-11-01 12:00:00
24,GAZP,5415,3849,1811837421.0,1730223148.0,1071704,1007376,169.06,171.76,2079080,3542060570.0,9264,4288,3387,1688031062.0,1628735703.0,999679,946145,168.86,172.14,1945824,3316766765.0,7675,2023-11-01 12:05:00
25,GAZP,4408,4431,1104117032.0,1466131284.0,653516,856960,168.95,171.09,1510476,2570248316.0,8839,3781,4203,1057034643.0,1436095984.0,625910,836013,168.88,171.78,1461923,2493130628.0,7984,2023-11-01 12:10:00
26,GAZP,3145,3331,649736973.0,948279743.0,384066,559509,169.17,169.48,943575,1598016717.0,6476,2662,3172,614665778.0,896927890.0,363818,529798,168.95,169.3,893616,1511593668.0,5834,2023-11-01 12:15:00
27,GAZP,4548,4673,1528629778.0,1829831956.0,905564,1079217,168.8,169.55,1984781,3358461734.0,9221,4127,4439,1570454574.0,1806242510.0,931010,1065200,168.68,169.57,1996210,3376697084.0,8566,2023-11-01 12:20:00
28,GAZP,3698,2221,1245526789.0,1121314379.0,737227,659242,168.95,170.09,1396469,2366841169.0,5919,3269,1981,1224431983.0,1086878618.0,725101,638260,168.86,170.29,1363361,2311310601.0,5250,2023-11-01 12:25:00
29,GAZP,4067,3523,1103913157.0,1624445300.0,653511,959794,168.92,169.25,1613305,2728358457.0,7590,3639,3336,1077815068.0,1597662602.0,638923,943645,168.69,169.31,1582568,2675477671.0,6975,2023-11-01 12:30:00
30,GAZP,3890,6233,1060701145.0,2933442528.0,628553,1734049,168.75,169.17,2362602,3994143673.0,10123,3455,6048,1023800860.0,2898515437.0,607284,1712784,168.59,169.23,2320068,3922316298.0,9503,2023-11-01 12:35:00
31,GAZP,3792,4180,1138679318.0,1700975843.0,672816,993656,169.24,171.18,1666472,2839655162.0,7972,3325,3882,1075935988.0,1669792495.0,637471,975080,168.78,171.25,1612551,2745728483.0,7207,2023-11-01 12:40:00
32,GAZP,4216,2602,1586717384.0,1018495514.0,938270,600815,169.11,169.52,1539085,2605212899.0,6818,3688,2363,1566778307.0,987036825.0,926963,582023,169.02,169.59,1508986,2553815132.0,6051,2023-11-01 12:45:00
33,GAZP,3984,2333,1900897693.0,943020485.0,1124205,555015,169.09,169.91,1679220,2843918179.0,6317,3494,2120,1882000672.0,918294067.0,1113406,540274,169.03,169.97,1653680,2800294740.0,5614,2023-11-01 12:50:00
34,GAZP,2467,2470,666818593.0,1105200832.0,395010,649716,168.81,170.11,1044726,1772019426.0,4937,1967,2318,658750710.0,1083858639.0,390493,636999,168.7,170.15,1027492,1742609349.0,4285,2023-11-01 12:55:00
35,GAZP,2754,6432,860943472.0,2926258016.0,509994,1727196,168.81,169.42,2237190,3787201489.0,9186,2271,6128,842055267.0,2890593346.0,499006,1707076,168.75,169.33,2206082,3732648613.0,8399,2023-11-01 13:00:00
36,GAZP,2661,6825,569289209.0,3487351252.0,337656,2044396,168.6,170.58,2382052,4056640461.0,9486,1833,6578,506508893.0,3440027920.0,300750,2013160,168.42,170.88,2313910,3946536813.0,8411,2023-11-01 13:05:00
37,GAZP,2697,4760,730025014.0,2685377212.0,433579,1588341,168.37,169.07,2021920,3415402227.0,7457,2196,4588,709672383.0,2663023651.0,421649,1575136,168.31,169.07,1996785,3372696034.0,6784,2023-11-01 13:10:00
38,GAZP,5448,5950,1352579500.0,3017542870.0,802999,1784081,168.44,169.14,2587080,4370122370.0,11398,4974,5793,1346590645.0,3003299733.0,799761,1775701,168.37,169.13,2575462,4349890378.0,10767,2023-11-01 13:15:00
39,GAZP,4220,5443,1236888596.0,2625561485.0,734247,1547977,168.46,169.61,2282224,3862450081.0,9663,3760,5325,1193070422.0,2605497042.0,708762,1536693,168.33,169.55,2245455,3798567465.0,9085,2023-11-01 13:20:00
40,GAZP,3365,4281,925551312.0,2045492969.0,548647,1208660,168.7,169.24,1757307,2971044282.0,7646,2946,4126,908313132.0,2034147317.0,538848,1201871,168.57,169.25,1740719,2942460450.0,7072,2023-11-01 13:25:00
41,GAZP,3930,7603,1023574558.0,2642799069.0,607414,1561697,168.51,169.23,2169111,3666373628.0,11533,3431,7395,1032614760.0,2627620978.0,613005,1552330,168.45,169.27,2165335,3660235739.0,10826,2023-11-01 13:30:00
42,GAZP,3794,5155,1019539717.0,2177888551.0,605141,1278957,168.48,170.29,1884098,3197428269.0,8949,3354,5033,970931779.0,2002768740.0,576575,1183876,168.4,169.17,1760451,2973700519.0,8387,2023-11-01 13:35:00
43,GAZP,2978,3920,791212675.0,1495589889.0,468820,883593,168.77,169.26,1352413,2286802565.0,6898,2529,3686,807720648.0,1476277624.0,479010,871853,168.62,169.33,1350863,2283998273.0,6215,2023-11-01 13:40:00
44,GAZP,3488,3489,1081139632.0,1425303713.0,641234,842217,168.6,169.23,1483451,2506443345.0,6977,3054,3361,1066443510.0,1413906029.0,632800,835235,168.53,169.28,1468035,2480349540.0,6415,2023-11-01 13:45:00
45,GAZP,3165,2472,849449226.0,992670246.0,503362,586082,168.76,169.37,1089444,1842119473.0,5637,2776,2310,839976059.0,979448993.0,498131,578239,168.63,169.38,1076370,1819425052.0,5086,2023-11-01 13:50:00
46,GAZP,1723,1892,528290896.0,736759529.0,312884,434891,168.85,169.41,747775,1265050425.0,3615,1322,1762,519324810.0,729083226.0,307861,430336,168.69,169.42,738197,1248408036.0,3084,2023-11-01 13:55:00
47,GAZP,834,632,285129007.0,312817009.0,168791,184585,168.92,169.47,353376,597946016.0,1466,712,565,270042746.0,321213864.0,160004,188984,168.77,169.97,348988,591256610.0,1277,2023-11-01 14:00:00
48,GAZP,772,604,277759650.0,289817031.0,164268,171073,169.09,169.41,335341,567576681.0,1376,551,498,263854663.0,287225946.0,156375,169352,168.73,169.6,325727,551080610.0,1049,2023-11-01 14:05:00
49,GAZP,1292,974,433965785.0,488290702.0,256903,288347,168.92,169.34,545250,922256487.0,2266,1086,819,414920287.0,467763149.0,245876,276030,168.75,169.46,521906,882683436.0,1905,2023-11-01 14:10:00
50,GAZP,1479,1230,590793909.0,619211473.0,349957,365256,168.82,169.53,715213,1210005383.0,2709,1280,1112,571703317.0,608316918.0,338739,358843,168.77,169.52,697582,1180020235.0,2392,2023-11-01 14:15:00
51,GAZP,1024,1113,454555017.0,490784067.0,269042,289484,168.95,169.54,558526,945339084.0,2137,826,958,444594719.0,464985916.0,263298,274264,168.86,169.54,537562,909580635.0,1784,2023-11-01 14:20:00
52,GAZP,802,1007,382856310.0,366725291.0,226585,216445,168.97,169.43,443030,749581601.0,1809,655,885,358885203.0,342745960.0,212572,202188,168.83,169.52,414760,701631163.0,1540,2023-11-01 14:25:00
53,GAZP,1729,2186,993541661.0,1041925495.0,588139,615275,168.93,169.34,1203414,2035467157.0,3915,1463,2023,964657220.0,1000550978.0,571253,590648,168.87,169.4,1161901,1965208198.0,3486,2023-11-01 14:30:00
54,GAZP,1254,742,510966993.0,308220235.0,302397,181164,168.97,170.13,483561,819187228.0,1996,1121,617,499894395.0,302409796.0,296060,177391,168.85,170.48,473451,802304192.0,1738,2023-11-01 14:35:00
55,GAZP,1196,1523,453942553.0,588629023.0,268584,347448,169.01,169.41,616032,1042571577.0,2719,1042,1005,441273595.0,562074180.0,261395,331738,168.81,169.43,593133,1003347775.0,2047,2023-11-01 14:40:00
56,GAZP,1132,1013,357222859.0,473686100.0,211792,279874,168.67,169.25,491666,830908960.0,2145,953,903,344024740.0,447699389.0,204006,264445,168.63,169.3,468451,791724130.0,1856,2023-11-01 14:45:00
57,GAZP,1354,1227,463072271.0,576064651.0,274616,340545,168.63,169.16,615161,1039136922.0,2581,1172,1125,449396435.0,566830702.0,266577,334798,168.58,169.31,601375,1016227138.0,2297,2023-11-01 14:50:00
58,GAZP,1061,711,208088855.0,216996463.0,123520,128289,168.47,169.15,251809,425085318.0,1772,523,630,189749252.0,209913721.0,112537,123974,168.61,169.32,236511,399662974.0,1153,2023-11-01 14:55:00
59,GAZP,2055,2106,540405362.0,990037038.0,320224,585009,168.76,169.23,905233,1530442401.0,4161,2306,1984,528753497.0,973764606.0,313664,575378,168.57,169.24,889042,1502518104.0,4290,2023-11-01 15:00:00
60,GAZP,663,649,197090184.0,223482397.0,116772,131979,168.78,169.33,248751,420572581.0,1312,532,559,186662588.0,220491727.0,110657,130180,168.69,169.37,240837,407154315.0,1091,2023-11-01 15:05:00
61,GAZP,864,927,322889448.0,410972971.0,191336,242785,168.76,169.27,434121,733862420.0,1791,739,832,321516050.0,408983282.0,190614,241540,168.67,169.32,432154,730499333.0,1571,2023-11-01 15:10:00
62,GAZP,930,912,263162547.0,329449804.0,155963,194725,168.73,169.19,350688,592612351.0,1842,819,819,275950783.0,313355626.0,163776,185049,168.49,169.34,348825,589306410.0,1638,2023-11-01 15:15:00
63,GAZP,741,1559,281583519.0,364776058.0,166902,215473,168.71,169.29,382375,646359577.0,2300,621,1415,259563049.0,346727980.0,153919,204751,168.64,169.34,358670,606291030.0,2036,2023-11-01 15:20:00
64,GAZP,1235,1542,539573223.0,396617162.0,319414,234004,168.93,169.49,553418,936190385.0,2777,1094,1312,504480599.0,377976267.0,298820,222977,168.82,169.51,521797,882456867.0,2406,2023-11-01 15:25:00
65,GAZP,2174,1527,744706169.0,506839436.0,440706,299274,168.98,169.36,739980,1251545605.0,3701,1937,1352,722388577.0,488076959.0,427545,287959,168.96,169.5,715504,1210465536.0,3289,2023-11-01 15:30:00
66,GAZP,889,1856,321217548.0,437960141.0,190254,258519,168.84,169.41,448773,759177689.0,2745,792,1736,314715903.0,427199181.0,186510,252056,168.74,169.49,438566,741915085.0,2528,2023-11-01 15:35:00
67,GAZP,924,1323,360663575.0,345409254.0,213769,203898,168.72,169.4,417667,706072830.0,2247,803,1236,357198310.0,331399321.0,211796,195581,168.65,169.44,407377,688597631.0,2039,2023-11-01 15:40:00
68,GAZP,698,1207,219131327.0,331803424.0,129959,196085,168.62,169.21,326044,550934752.0,1905,595,1129,210637852.0,324439067.0,124941,191535,168.59,169.39,316476,535076919.0,1724,2023-11-01 15:45:00
69,GAZP,1343,1694,525718939.0,636377551.0,311370,375638,168.84,169.41,687008,1162096491.0,3037,1168,1526,508523353.0,627373385.0,301392,370158,168.72,169.49,671550,1135896739.0,2694,2023-11-01 15:50:00
70,GAZP,2160,2368,725029422.0,747747946.0,429659,441320,168.75,169.43,870979,1472777368.0,4528,2018,2275,716883661.0,741191868.0,424930,437344,168.71,169.48,862274,1458075529.0,4293,2023-11-01 15:55:00
71,GAZP,2895,4214,692853322.0,926096326.0,410833,547056,168.65,169.29,957889,1618949649.0,7109,2776,4089,686248868.0,915675555.0,406939,540573,168.64,169.39,947512,1601924423.0,6865,2023-11-01 16:00:00
72,GAZP,2029,2941,721819717.0,855373916.0,428032,505723,168.64,169.14,933755,1577193633.0,4970,1883,2745,710802592.0,822575433.0,421541,486087,168.62,169.22,907628,1533378025.0,4628,2023-11-01 16:05:00
73,GAZP,1462,1867,509040223.0,539784749.0,301795,319071,168.67,169.17,620866,1048824972.0,3329,1305,1734,488423458.0,526375181.0,289632,311044,168.64,169.23,600676,1014798639.0,3039,2023-11-01 16:10:00
74,GAZP,904,996,312730884.0,322145160.0,185545,190253,168.55,169.32,375798,634876045.0,1900,786,913,306453834.0,317305689.0,181844,187387,168.53,169.33,369231,623759524.0,1699,2023-11-01 16:15:00
75,GAZP,2849,1914,834706511.0,731349529.0,494967,432206,168.64,169.21,927173,1566056041.0,4763,2669,1769,819036292.0,712891552.0,485829,420976,168.59,169.34,906805,1531927844.0,4438,2023-11-01 16:20:00
76,GAZP,1442,1865,485871765.0,669924611.0,288249,396196,168.56,169.09,684445,1155796376.0,3307,1298,1759,475645215.0,662090451.0,282277,391378,168.5,169.17,673655,1137735666.0,3057,2023-11-01 16:25:00
77,GAZP,1218,1260,434605737.0,453308888.0,257885,268118,168.53,169.07,526003,887914625.0,2478,1057,1152,421310284.0,449341070.0,250035,265541,168.5,169.22,515576,870651355.0,2209,2023-11-01 16:30:00
78,GAZP,1639,2831,527559735.0,1739213447.0,313031,1028492,168.53,169.1,1341523,2266773182.0,4470,1536,2755,526217444.0,1739892640.0,312340,1028806,168.48,169.12,1341146,2266110084.0,4291,2023-11-01 16:35:00
79,GAZP,1305,1380,486154320.0,868849038.0,288479,513655,168.52,169.15,802134,1355003358.0,2685,1151,1277,460780495.0,861743176.0,273424,509353,168.52,169.18,782777,1322523671.0,2428,2023-11-01 16:40:00
80,GAZP,855,892,258342671.0,393538993.0,153261,232605,168.56,169.19,385866,651881664.0,1747,746,843,254855900.0,396535261.0,151270,234321,168.48,169.23,385591,651391161.0,1589,2023-11-01 16:45:00
81,GAZP,931,1445,345838144.0,567598006.0,205208,335477,168.53,169.19,540685,913436151.0,2376,815,1382,344178870.0,555418067.0,204277,328245,168.49,169.21,532522,899596937.0,2197,2023-11-01 16:50:00
82,GAZP,2142,2983,703206658.0,914659613.0,417170,540328,168.57,169.28,957498,1617866271.0,5125,2018,2826,688473224.0,902710135.0,408501,533223,168.54,169.29,941724,1591183359.0,4844,2023-11-01 16:55:00
83,GAZP,1585,1366,416229472.0,395817175.0,246716,233733,168.71,169.35,480449,812046647.0,2951,1476,1271,403054304.0,386082240.0,238962,227960,168.67,169.36,466922,789136544.0,2747,2023-11-01 17:00:00
84,GAZP,3539,3018,1161763625.0,1578128348.0,688558,932649,168.72,169.21,1621207,2739891974.0,6557,3373,2844,1140623763.0,1569297294.0,676299,926758,168.66,169.33,1603057,2709921058.0,6217,2023-11-01 17:05:00
85,GAZP,3296,2170,1020610289.0,1002994099.0,604322,591807,168.89,169.48,1196129,2023604388.0,5466,3116,2030,981559029.0,993702710.0,581403,585885,168.83,169.61,1167288,1975261740.0,5146,2023-11-01 17:10:00
86,GAZP,6072,5579,2012203781.0,1791721358.0,1186224,1055160,169.63,169.81,2241384,3803925139.0,11651,4905,4709,1853575331.0,1704848978.0,1094699,1003224,169.32,169.94,2097923,3558424309.0,9614,2023-11-01 17:15:00
87,GAZP,6718,5418,2204814845.0,2056745533.0,1298612,1195494,169.78,172.04,2494106,4261560379.0,12136,4914,4820,2114988578.0,1962406765.0,1247806,1154231,169.5,170.02,2402037,4077395344.0,9734,2023-11-01 17:20:00
88,GAZP,2502,2216,808855631.0,847913422.0,477621,497106,169.35,170.57,974727,1656769053.0,4718,2071,1936,748925586.0,715679608.0,442371,421019,169.3,169.99,863390,1464605194.0,4007,2023-11-01 17:25:00
89,GAZP,1947,1984,646628700.0,698252815.0,381917,410119,169.31,170.26,792036,1344881516.0,3931,1699,1723,619277984.0,666189191.0,365906,392053,169.25,169.92,757959,1285467175.0,3422,2023-11-01 17:30:00
90,GAZP,2054,1230,624227089.0,474781058.0,368298,279539,169.49,169.84,647837,1099008147.0,3284,1849,1010,585113594.0,440918606.0,345407,259160,169.4,170.13,604567,1026032200.0,2859,2023-11-01 17:35:00
91,GAZP,2110,2008,532777901.0,724534320.0,314313,426212,169.51,169.99,740525,1257312221.0,4118,1906,1826,509308911.0,713011635.0,300700,419325,169.37,170.04,720025,1222320546.0,3732,2023-11-01 17:40:00
92,GAZP,2390,1458,717635690.0,576988783.0,423575,339243,169.42,170.08,762818,1294624473.0,3848,2169,1307,695213126.0,540275527.0,410522,317510,169.35,170.16,728032,1235488653.0,3476,2023-11-01 17:45:00
93,GAZP,2389,2571,718645093.0,660942320.0,424221,389081,169.4,169.87,813302,1379587413.0,4960,2165,2398,702629177.0,641954420.0,414856,377584,169.37,170.02,792440,1344583597.0,4563,2023-11-01 17:50:00
94,GAZP,945,846,233166830.0,175344057.0,137618,103104,169.43,170.07,240722,408510888.0,1791,749,736,201719941.0,153884544.0,119183,90353,169.25,170.31,209536,355604486.0,1485,2023-11-01 17:55:00
95,GAZP,620,737,119396597.0,162299517.0,70442,94572,169.5,171.61,165014,281696114.0,1357,490,629,138014549.0,163857267.0,81651,95282,169.03,171.97,176933,301871816.0,1119,2023-11-01 18:00:00
96,GAZP,899,3262,226363789.0,688165559.0,133459,405265,169.61,169.81,538724,914529349.0,4161,784,3124,222780045.0,674464536.0,131639,397008,169.24,169.89,528647,897244581.0,3908,2023-11-01 18:05:00
97,GAZP,1115,890,278560153.0,229076527.0,163984,134805,169.87,169.93,298789,507636681.0,2005,1003,748,260478475.0,215263787.0,153819,126484,169.34,170.19,280303,475742263.0,1751,2023-11-01 18:10:00
98,GAZP,1406,857,346941490.0,234587909.0,204724,138049,169.47,169.93,342773,581529399.0,2263,1235,760,326059605.0,221577904.0,192577,130187,169.31,170.2,322764,547637509.0,1995,2023-11-01 18:15:00
99,GAZP,971,1221,242336293.0,295962784.0,142539,174182,170.01,169.92,316721,538299077.0,2192,777,1063,199759054.0,283956599.0,118106,166949,169.14,170.09,285055,483715654.0,1840,2023-11-01 18:20:00
100,GAZP,1197,749,309417008.0,209987551.0,182059,123477,169.95,170.06,305536,519404559.0,1946,975,538,268438118.0,186648663.0,158433,109610,169.43,170.28,268043,455086781.0,1513,2023-11-01 18:25:00
101,GAZP,2324,999,396575779.0,343163233.0,232059,201486,170.89,170.32,433545,739739012.0,3323,1196,733,323616479.0,266711395.0,191024,156510,169.41,170.41,347534,590327875.0,1929,2023-11-01 18:30:00
102,GAZP,3050,1310,1752970534.0,366165831.0,1030344,214723,170.13,170.53,1245067,2119136365.0,4360,2294,730,1654780645.0,302320993.0,974686,177080,169.78,170.73,1151766,1957101638.0,3024,2023-11-01 18:35:00
103,GAZP,4065,2242,2341292162.0,672868526.0,1378978,396058,169.78,169.89,1775036,3014160689.0,6307,3570,1922,2289952294.0,606867400.0,1349503,356189,169.69,170.38,1705692,2896819695.0,5492,2023-11-01 18:40:00
104,GAZP,4090,4564,1385525339.0,1139735395.0,808686,667773,171.33,170.68,1476459,2525260735.0,8654,2884,3302,1226430768.0,956731454.0,720103,560935,170.31,170.56,1281038,2183162222.0,6186,2023-11-02 10:05:00
105,GAZP,1936,1893,505460391.0,438201690.0,285263,258083,177.19,169.79,543346,943662082.0,3829,1294,1290,423776869.0,322359166.0,241476,188884,175.49,170.67,430360,746136035.0,2584,2023-11-02 10:10:00
106,GAZP,2136,1743,510413305.0,411838839.0,292881,242206,174.27,170.04,535087,922252145.0,3879,1598,1357,445017620.0,354724794.0,261065,208158,170.46,170.41,469223,799742414.0,2955,2023-11-02 10:15:00
107,GAZP,2876,2688,782570300.0,605714187.0,439538,354544,178.04,170.84,794082,1388284488.0,5564,2219,1806,678041448.0,504695047.0,385143,295437,176.05,170.83,680580,1182736495.0,4025,2023-11-02 10:20:00
108,GAZP,2723,2285,994165205.0,760580797.0,582968,445444,170.54,170.75,1028412,1754746002.0,5008,2215,1603,941706355.0,667829127.0,550389,390023,171.1,171.23,940412,1609535482.0,3818,2023-11-02 10:25:00
109,GAZP,1188,1174,397877329.0,371133256.0,217955,217131,182.55,170.93,435086,769010585.0,2362,950,877,366380317.0,330887717.0,202955,193185,180.52,171.28,396140,697268034.0,1827,2023-11-02 10:30:00
110,GAZP,1837,1917,786430790.0,668545950.0,447062,391154,175.91,170.92,838216,1454976741.0,3754,1499,1419,730387870.0,621130967.0,416195,363167,175.49,171.03,779362,1351518838.0,2918,2023-11-02 10:35:00
111,GAZP,2311,2177,889589517.0,972370298.0,505817,567209,175.87,171.43,1073026,1861959815.0,4488,1940,1441,831033071.0,806070089.0,471769,470761,176.15,171.23,942530,1637103160.0,3381,2023-11-02 10:40:00
112,GAZP,3845,3216,1421581172.0,1412634530.0,828140,819060,171.66,172.47,1647200,2834215702.0,7061,2876,2329,1195926506.0,1356144999.0,700629,787700,170.69,172.17,1488329,2552071506.0,5205,2023-11-02 10:45:00
113,GAZP,4130,4453,1499265836.0,1475026714.0,875090,859068,171.33,171.7,1734158,2974292551.0,8583,3454,3575,1379228274.0,1350980306.0,807578,785531,170.79,171.98,1593109,2730208580.0,7029,2023-11-02 10:50:00
114,GAZP,3489,4579,1205954863.0,1505061580.0,703317,877665,171.47,171.48,1580982,2711016444.0,8068,3051,3860,1128459635.0,1412527595.0,658086,823058,171.48,171.62,1481144,2540987230.0,6911,2023-11-02 10:55:00
115,GAZP,4568,3415,1526973489.0,1566427432.0,893895,870119,170.82,180.02,1764014,3093400922.0,7983,4059,2870,1469239332.0,1457434984.0,860387,807166,170.76,180.56,1667553,2926674316.0,6929,2023-11-02 11:00:00
116,GAZP,4864,5151,1841162212.0,2073048395.0,1080031,1153828,170.47,179.67,2233859,3914210608.0,10015,4184,4757,1776386510.0,2030410055.0,1042351,1125712,170.42,180.37,2168063,3806796566.0,8941,2023-11-02 11:05:00
117,GAZP,5312,5790,2102812732.0,2189168373.0,1234249,1280489,170.37,170.96,2514738,4291981105.0,11102,4791,5449,2033271361.0,2133558332.0,1194808,1248303,170.18,170.92,2443111,4166829694.0,10240,2023-11-02 11:10:00
118,GAZP,3659,4095,1912933229.0,1557913849.0,1123418,911852,170.28,170.85,2035270,3470847079.0,7754,3299,3759,1872016276.0,1496311828.0,1100153,876232,170.16,170.77,1976385,3368328105.0,7058,2023-11-02 11:15:00
119,GAZP,2902,2700,826255874.0,949812032.0,485866,555626,170.06,170.94,1041492,1776067907.0,5602,2248,2418,790185213.0,922785853.0,464649,540334,170.06,170.78,1004983,1712971066.0,4666,2023-11-02 11:20:00
120,GAZP,1756,3174,594636472.0,928197961.0,349753,543289,170.02,170.85,893042,1522834434.0,4930,1514,2976,568017309.0,918835781.0,334159,537503,169.98,170.95,871662,1486853090.0,4490,2023-11-02 11:25:00
121,GAZP,2235,2309,641841095.0,709624217.0,376794,415448,170.34,170.81,792242,1351465313.0,4544,1753,2088,596929375.0,667194635.0,350736,390351,170.19,170.92,741087,1264124010.0,3841,2023-11-02 11:30:00
122,GAZP,1451,4080,543284851.0,780548080.0,319047,456742,170.28,170.89,775789,1323832931.0,5531,1239,3886,474347814.0,759546788.0,279241,444930,169.87,170.71,724171,1233894602.0,5125,2023-11-02 11:35:00
123,GAZP,1805,2192,1118954259.0,681529514.0,657676,397460,170.14,171.47,1055136,1800483773.0,3997,1607,2012,1093311025.0,658999034.0,642873,386531,170.07,170.49,1029404,1752310059.0,3619,2023-11-02 11:40:00
124,GAZP,2905,2825,1534827156.0,742076144.0,902573,432883,170.05,171.43,1335456,2276903301.0,5730,2681,2529,1501088293.0,708374113.0,882846,415206,170.03,170.61,1298052,2209462407.0,5210,2023-11-02 11:45:00
125,GAZP,4647,3916,1583679610.0,1317433800.0,932060,768114,169.91,171.52,1700174,2901113410.0,8563,4253,3611,1533359946.0,1265036836.0,902629,738474,169.88,171.3,1641103,2798396783.0,7864,2023-11-02 11:50:00
126,GAZP,3484,3848,1296577594.0,1240583113.0,763956,726938,169.72,170.66,1490894,2537160707.0,7332,3000,3429,1217166234.0,1164409538.0,717319,681201,169.68,170.93,1398520,2381575773.0,6429,2023-11-02 11:55:00
127,GAZP,2342,2828,769997403.0,957957727.0,453356,561837,169.84,170.5,1015193,1727955130.0,5170,2047,2578,772071446.0,935317569.0,454846,548594,169.74,170.49,1003440,1707389016.0,4625,2023-11-02 12:00:00
128,GAZP,1425,2600,439751725.0,565367482.0,258964,331411,169.81,170.59,590375,1005119208.0,4025,1228,2328,429094801.0,522079002.0,252852,306059,169.7,170.58,558911,951173803.0,3556,2023-11-02 12:05:00
129,GAZP,1949,2926,885164219.0,995772018.0,521773,584114,169.65,170.48,1105887,1880936238.0,4875,1592,2284,835571768.0,958203477.0,492686,562396,169.6,170.38,1055082,1793775246.0,3876,2023-11-02 12:10:00
130,GAZP,7912,8046,3061623473.0,3629632677.0,1804503,2136342,169.67,169.9,3940845,6691256151.0,15958,7299,7394,2957949164.0,3517777314.0,1744375,2067819,169.57,170.12,3812194,6475726479.0,14693,2023-11-02 12:15:00
131,GAZP,3241,3965,1173799570.0,1610750843.0,691476,945713,169.75,170.32,1637189,2784550414.0,7206,2863,3612,1134038658.0,1563889784.0,668685,918629,169.59,170.24,1587314,2697928443.0,6475,2023-11-02 12:20:00
132,GAZP,1101,1563,407448981.0,530964827.0,240047,312066,169.74,170.15,552113,938413808.0,2664,838,1389,391042521.0,510969333.0,230737,300381,169.48,170.11,531118,902011854.0,2227,2023-11-02 12:25:00
133,GAZP,3060,3864,1213509405.0,1518628629.0,714951,891855,169.73,170.28,1606806,2732138034.0,6924,2775,3467,1166548198.0,1477786391.0,687756,867998,169.62,170.25,1555754,2644334590.0,6242,2023-11-02 12:30:00
134,GAZP,2209,4087,614793418.0,1200127383.0,362288,704839,169.7,170.27,1067127,1814920801.0,6296,2025,3894,598816164.0,1173300256.0,353019,688988,169.63,170.29,1042007,1772116420.0,5919,2023-11-02 12:35:00
135,GAZP,2311,2197,989627988.0,728923679.0,582537,427457,169.88,170.53,1009994,1718551668.0,4508,2150,1825,972168672.0,684286573.0,572435,401319,169.83,170.51,973754,1656455246.0,3975,2023-11-02 12:40:00
136,GAZP,1861,1653,882124480.0,630648263.0,519214,362126,169.9,174.15,881340,1512772743.0,3514,1697,1432,858157053.0,601002645.0,505283,344766,169.84,174.32,850049,1459159699.0,3129,2023-11-02 12:45:00
137,GAZP,1557,1447,755185512.0,469205233.0,444573,275208,169.87,170.49,719781,1224390745.0,3004,1406,1277,730174064.0,444234569.0,429919,260563,169.84,170.49,690482,1174408633.0,2683,2023-11-02 12:50:00
138,GAZP,2423,2364,746725676.0,644318698.0,431466,378410,173.07,170.27,809876,1391044375.0,4787,2204,2143,703506604.0,625510379.0,415112,367107,169.47,170.39,782219,1329016983.0,4347,2023-11-02 12:55:00
139,GAZP,2480,2532,607952554.0,527674335.0,358405,309858,169.63,170.3,668263,1135626890.0,5012,2288,2323,593543293.0,507484869.0,349975,297941,169.6,170.33,647916,1101028163.0,4611,2023-11-02 13:00:00
140,GAZP,2582,2556,666511995.0,776043672.0,392944,455361,169.62,170.42,848305,1442555668.0,5138,2050,2360,647660043.0,763023585.0,381978,447773,169.55,170.4,829751,1410683629.0,4410,2023-11-02 13:05:00
141,GAZP,11177,19642,1118591102.0,3939302477.0,658653,2314580,169.83,170.2,2973233,5057893580.0,30819,11060,19475,1105241395.0,3922321067.0,650874,2304918,169.81,170.17,2955792,5027562462.0,30535,2023-11-02 13:10:00
142,GAZP,2358,2803,832483798.0,867562564.0,490652,509289,169.67,170.35,999941,1700046362.0,5161,2198,2645,799249409.0,853197400.0,471301,500897,169.58,170.33,972198,1652446810.0,4843,2023-11-02 13:15:00
143,GAZP,927,1252,399237959.0,466528114.0,235214,273834,169.73,170.37,509048,865766074.0,2179,805,1100,394346972.0,449873071.0,232381,263954,169.7,170.44,496335,844220044.0,1905,2023-11-02 13:20:00
144,GAZP,587,805,219480610.0,263538317.0,129371,154670,169.65,170.39,284041,483018928.0,1392,466,691,213376827.0,255153689.0,125739,149744,169.7,170.39,275483,468530516.0,1157,2023-11-02 13:25:00
145,GAZP,2471,2363,958965534.0,1143560351.0,563140,672337,170.29,170.09,1235477,2102525886.0,4834,2189,1972,935897655.0,1099919433.0,550635,646424,169.97,170.15,1197059,2035817089.0,4161,2023-11-02 13:30:00
146,GAZP,2710,4072,953324150.0,1301555583.0,562310,765624,169.54,170.0,1327934,2254879733.0,6782,2438,3861,932000021.0,1263154235.0,549619,742607,169.57,170.1,1292226,2195154257.0,6299,2023-11-02 13:35:00
147,GAZP,1679,1851,663684397.0,698164892.0,391669,410881,169.45,169.92,802550,1361849289.0,3530,1483,1705,638235622.0,680237800.0,376738,399790,169.41,170.15,776528,1318473422.0,3188,2023-11-02 13:40:00
148,GAZP,1881,2652,789134228.0,986194041.0,464618,579096,169.85,170.3,1043714,1775328269.0,4533,1740,2347,765583267.0,958849146.0,451238,563041,169.66,170.3,1014279,1724432414.0,4087,2023-11-02 13:45:00
149,GAZP,832,1192,352414462.0,392681386.0,204040,230325,172.72,170.49,434365,745095849.0,2024,708,960,328826294.0,372532386.0,193580,218450,169.87,170.53,412030,701358680.0,1668,2023-11-02 13:50:00
150,GAZP,1339,1088,407409676.0,570615194.0,239854,333823,169.86,170.93,573677,978024871.0,2427,1239,950,408229619.0,538213760.0,237137,315718,172.15,170.47,552855,946443379.0,2189,2023-11-02 13:55:00
151,GAZP,1659,2028,526557739.0,677916514.0,310401,397935,169.64,170.36,708336,1204474253.0,3687,1570,1955,504084919.0,678045812.0,296957,397943,169.75,170.39,694900,1182130731.0,3525,2023-11-02 14:00:00
152,GAZP,621,1166,297114381.0,1028925187.0,175121,604290,169.66,170.27,779411,1326039569.0,1787,523,1085,288776334.0,1024097890.0,170239,601369,169.63,170.29,771608,1312874224.0,1608,2023-11-02 14:05:00
153,GAZP,946,1467,425243326.0,452078122.0,248481,265555,171.14,170.24,514036,877321448.0,2413,784,1309,410868398.0,432889630.0,240327,254107,170.96,170.36,494434,843758028.0,2093,2023-11-02 14:10:00
154,GAZP,791,846,292476443.0,255794776.0,169604,150157,172.45,170.35,319761,548271219.0,1637,682,720,279112269.0,248039531.0,162708,145514,171.54,170.46,308222,527151800.0,1402,2023-11-02 14:15:00
155,GAZP,659,941,242269785.0,464049297.0,142714,263679,169.76,175.99,406393,706319082.0,1600,520,833,233302359.0,280562023.0,137486,164709,169.69,170.34,302195,513864382.0,1353,2023-11-02 14:20:00
156,GAZP,2186,2415,788705061.0,941561150.0,464786,553425,169.69,170.13,1018211,1730266211.0,4601,1895,2216,744863959.0,900608568.0,439527,529251,169.47,170.17,968778,1645472527.0,4111,2023-11-02 14:25:00
157,GAZP,994,2732,312589113.0,467138263.0,184548,274610,169.38,170.11,459158,779727376.0,3726,828,2560,293962670.0,461725690.0,173639,271356,169.3,170.15,444995,755688360.0,3388,2023-11-02 14:30:00
158,GAZP,1028,2255,436473647.0,618476610.0,257319,363469,169.62,170.16,620788,1054950258.0,3283,861,2132,429844911.0,613338580.0,253608,360222,169.49,170.27,613830,1043183491.0,2993,2023-11-02 14:35:00
159,GAZP,1891,1890,689941384.0,569662582.0,406480,334753,169.74,170.17,741233,1259603966.0,3781,1743,1730,663166672.0,552042777.0,390851,324233,169.67,170.26,715084,1215209449.0,3473,2023-11-02 14:40:00
160,GAZP,1215,1402,520071095.0,638012619.0,306291,374463,169.8,170.38,680754,1158083714.0,2617,1075,1262,492997392.0,597829028.0,290617,350782,169.64,170.43,641399,1090826421.0,2337,2023-11-02 14:45:00
161,GAZP,1090,1033,430696375.0,414240555.0,253584,243056,169.84,170.43,496640,844936931.0,2123,983,925,425939804.0,396944941.0,251098,232853,169.63,170.47,483951,822884745.0,1908,2023-11-02 14:50:00
162,GAZP,676,734,253092918.0,284975647.0,149098,167303,169.75,170.34,316401,538068566.0,1410,579,626,250333312.0,260848886.0,147554,153091,169.66,170.39,300645,511182198.0,1205,2023-11-02 14:55:00
163,GAZP,578,669,207927761.0,242982587.0,122566,142658,169.65,170.33,265224,450910348.0,1247,456,542,206483626.0,235967509.0,121755,138445,169.59,170.44,260200,442451135.0,998,2023-11-02 15:00:00
164,GAZP,1022,5107,321903069.0,1316821627.0,189734,774323,169.66,170.06,964057,1638724697.0,6129,894,5000,310287587.0,1297701395.0,182967,762918,169.59,170.1,945885,1607988982.0,5894,2023-11-02 15:05:00
165,GAZP,938,1573,335370238.0,525703655.0,197758,308986,169.59,170.14,506744,861073893.0,2511,832,1490,337206405.0,522727478.0,198889,307154,169.55,170.18,506043,859933884.0,2322,2023-11-02 15:10:00
166,GAZP,906,1725,362101497.0,567526775.0,213595,333588,169.53,170.13,547183,929628272.0,2631,765,1648,353567565.0,565145071.0,208627,332044,169.47,170.2,540671,918712636.0,2413,2023-11-02 15:15:00
167,GAZP,1001,1145,360920518.0,396720991.0,212871,233027,169.55,170.25,445898,757641509.0,2146,873,1060,352089495.0,391137625.0,207765,229699,169.47,170.28,437464,743227121.0,1933,2023-11-02 15:20:00
168,GAZP,1365,2521,565892493.0,865686217.0,333962,509192,169.45,170.01,843154,1431578711.0,3886,1181,2382,546470325.0,847328447.0,322567,498062,169.41,170.13,820629,1393798772.0,3563,2023-11-02 15:25:00
169,GAZP,953,931,357275136.0,348023484.0,210593,204476,169.65,170.2,415069,705298621.0,1884,838,822,345464294.0,340542458.0,203929,199996,169.4,170.27,403925,686006753.0,1660,2023-11-02 15:30:00
170,GAZP,641,1104,302410515.0,304545996.0,178334,178940,169.58,170.19,357274,606956511.0,1745,544,1027,289830718.0,303996973.0,170981,178542,169.51,170.27,349523,593827691.0,1571,2023-11-02 15:35:00
171,GAZP,745,980,285657715.0,300354662.0,168436,176467,169.59,170.2,344903,586012377.0,1725,632,889,279468635.0,294605700.0,164845,173046,169.53,170.25,337891,574074335.0,1521,2023-11-02 15:40:00
172,GAZP,960,1351,457437429.0,480768327.0,269717,282638,169.6,170.1,552355,938205757.0,2311,837,1244,440486942.0,472871438.0,259769,277749,169.57,170.25,537518,913358381.0,2081,2023-11-02 15:45:00
173,GAZP,1881,1767,774102416.0,652409606.0,456713,381659,169.49,170.94,838372,1426512023.0,3648,1669,1561,753440590.0,628894769.0,444705,369673,169.42,170.12,814378,1382335359.0,3230,2023-11-02 15:50:00
174,GAZP,1683,2942,650600174.0,800371661.0,383275,470078,169.75,170.26,853353,1450971835.0,4625,1569,2797,620887659.0,781383866.0,366048,458970,169.62,170.25,825018,1402271525.0,4366,2023-11-02 15:55:00
175,GAZP,982,1014,360469387.0,385314680.0,212419,225266,169.7,171.05,437685,745784068.0,1996,869,898,354736692.0,376823152.0,209120,219216,169.63,171.9,428336,731559845.0,1767,2023-11-02 16:00:00
176,GAZP,1139,1356,508493248.0,451515513.0,299827,263240,169.6,171.52,563067,960008761.0,2495,991,1219,482582079.0,439414733.0,284548,256967,169.6,171.0,541515,921996812.0,2210,2023-11-02 16:05:00
177,GAZP,1138,3245,321254864.0,615889441.0,189269,361692,169.73,170.28,550961,937144306.0,4383,1012,3121,311480106.0,604352703.0,183584,354927,169.67,170.28,538511,915832810.0,4133,2023-11-02 16:10:00
178,GAZP,808,1604,362823363.0,386291105.0,213872,226981,169.65,170.19,440853,749114468.0,2412,682,1508,359771214.0,367310236.0,212093,215669,169.63,170.31,427762,727081450.0,2190,2023-11-02 16:15:00
179,GAZP,522,431,174884092.0,163126591.0,103080,95794,169.66,170.29,198874,338010683.0,953,419,352,179408544.0,152863601.0,105860,89770,169.48,170.28,195630,332272145.0,771,2023-11-02 16:20:00
180,GAZP,1149,1125,459188276.0,434389465.0,270630,255110,169.67,170.28,525740,893577741.0,2274,988,1043,431906028.0,410389013.0,254789,240595,169.52,170.57,495384,842295042.0,2031,2023-11-02 16:25:00
181,GAZP,1782,2324,703773825.0,760488613.0,414775,447698,169.68,169.87,862473,1464262438.0,4106,1563,2165,681030549.0,737234623.0,401439,433354,169.65,170.12,834793,1418265173.0,3728,2023-11-02 16:30:00
182,GAZP,1031,2454,470236734.0,572506707.0,277548,334662,169.43,171.07,612210,1042743441.0,3485,937,2359,467655123.0,561173606.0,275183,329663,169.94,170.23,604846,1028828730.0,3296,2023-11-02 16:35:00
183,GAZP,839,956,352556381.0,282861298.0,208001,166435,169.5,169.95,374436,635417679.0,1795,739,875,340561403.0,272216738.0,201042,159981,169.4,170.16,361023,612778141.0,1614,2023-11-02 16:40:00
184,GAZP,794,1130,363931441.0,351276705.0,214710,203859,169.5,172.31,418569,715208147.0,1924,640,1063,354696110.0,344067473.0,209486,200484,169.32,171.62,409970,698763583.0,1703,2023-11-02 16:45:00
185,GAZP,823,1543,349987949.0,395194704.0,206595,226626,169.41,174.38,433221,745182654.0,2366,721,1457,343629061.0,389413583.0,202916,223050,169.35,174.59,425966,733042645.0,2178,2023-11-02 16:50:00
186,GAZP,903,950,368499367.0,328052033.0,217410,192846,169.5,170.11,410256,696551401.0,1853,718,853,357152439.0,320387649.0,210756,188276,169.46,170.17,399032,677540088.0,1571,2023-11-02 16:55:00
187,GAZP,1205,2826,458535399.0,819824655.0,270467,482009,169.53,170.08,752476,1278360055.0,4031,1095,2691,455523084.0,807345551.0,268765,474740,169.49,170.06,743505,1262868635.0,3786,2023-11-02 17:00:00
188,GAZP,971,979,314403398.0,303063038.0,184535,178196,170.38,170.07,362731,617466437.0,1950,831,906,298911814.0,297339923.0,176368,174700,169.48,170.2,351068,596251738.0,1737,2023-11-02 17:05:00
189,GAZP,1406,4361,346248693.0,1080910668.0,204067,636015,169.67,169.95,840082,1427159361.0,5767,1241,4234,341348087.0,1059047310.0,200385,623056,170.35,169.98,823441,1400395398.0,5475,2023-11-02 17:10:00
190,GAZP,2029,2085,777423402.0,875694088.0,459279,517257,169.27,169.3,976536,1653117491.0,4114,1953,1916,771354077.0,807344437.0,455916,475102,169.19,169.93,931018,1578698515.0,3869,2023-11-02 17:15:00
191,GAZP,3212,6029,727915778.0,1356751480.0,429947,799811,169.3,169.63,1229758,2084667258.0,9241,2911,5830,705186021.0,1336191986.0,416753,786973,169.21,169.79,1203726,2041378007.0,8741,2023-11-02 17:20:00
192,GAZP,1483,1890,462680818.0,618469119.0,267158,363975,173.19,169.92,631133,1081149938.0,3373,1325,1779,444493706.0,593520096.0,262596,349113,169.27,170.01,611709,1038013802.0,3104,2023-11-02 17:25:00
193,GAZP,1411,1584,440676425.0,481725496.0,260308,284365,169.29,169.4,544673,922401922.0,2995,1250,1453,409011823.0,462356137.0,241627,272174,169.27,169.88,513801,871367960.0,2703,2023-11-02 17:30:00
194,GAZP,5036,6302,1785000394.0,1963874358.0,1054581,1163284,169.26,168.82,2217865,3748874752.0,11338,4118,4890,1679236945.0,1826247930.0,993963,1078005,168.94,169.41,2071968,3505484876.0,9008,2023-11-02 17:35:00
195,GAZP,3140,3124,936328740.0,912784359.0,552992,539608,169.32,169.16,1092600,1849113099.0,6264,2714,2765,926939160.0,863838296.0,548007,509765,169.15,169.46,1057772,1790777457.0,5479,2023-11-02 17:40:00
196,GAZP,9337,13786,2403319605.0,3761652101.0,1426350,2239145,168.49,168.0,3665495,6164971706.0,23123,7629,10861,2158273226.0,3460372312.0,1282880,2052009,168.24,168.63,3334889,5618645538.0,18490,2023-11-02 17:45:00
197,GAZP,4900,6062,1450022216.0,1586139471.0,853526,941657,169.89,168.44,1795183,3036161688.0,10962,4002,5303,1331198082.0,1481823366.0,791548,878598,168.18,168.66,1670146,2813021448.0,9305,2023-11-02 17:50:00
198,GAZP,4224,5092,1106292807.0,2164291422.0,656363,1282746,168.55,168.72,1939109,3270584229.0,9316,3741,4702,1038279005.0,2104733310.0,616550,1246711,168.4,168.82,1863261,3143012316.0,8443,2023-11-02 17:55:00
199,GAZP,2938,5672,998723222.0,1913959010.0,592205,1119531,168.64,170.96,1711736,2912682232.0,8610,2616,5483,976113350.0,1871592123.0,578991,1108165,168.59,168.89,1687156,2847705474.0,8099,2023-11-02 18:00:00
200,GAZP,2464,2471,527889107.0,787564952.0,308015,467755,171.38,168.37,775770,1315454060.0,4935,2070,2274,488450237.0,766837120.0,290185,454100,168.32,168.87,744285,1255287357.0,4344,2023-11-02 18:05:00
201,GAZP,3233,4015,591291881.0,1316421217.0,350255,781141,168.82,168.53,1131396,1907713098.0,7248,2620,3683,523751697.0,1250877623.0,311405,741277,168.19,168.75,1052682,1774629320.0,6303,2023-11-02 18:10:00
202,GAZP,5486,3946,1232314073.0,792706059.0,730447,469272,168.71,168.92,1199719,2025020132.0,9432,4998,3634,1184131523.0,753232442.0,703361,445958,168.35,168.9,1149319,1937363965.0,8632,2023-11-02 18:15:00
203,GAZP,2086,1894,382401804.0,369152343.0,224665,208649,170.21,176.93,433314,751554147.0,3980,1687,1635,344378202.0,324129293.0,204354,181352,168.52,178.73,385706,668507495.0,3322,2023-11-02 18:20:00
204,GAZP,2548,2419,450424050.0,718257403.0,266705,427374,168.88,168.06,694079,1168681453.0,4967,1927,2180,400508359.0,655595243.0,238123,388585,168.19,168.71,626708,1056103602.0,4107,2023-11-02 18:25:00
205,GAZP,1780,2018,278306095.0,351492493.0,165220,208733,168.45,168.39,373953,629798589.0,3798,1346,1794,227466892.0,328004835.0,135347,194472,168.06,168.66,329819,555471727.0,3140,2023-11-02 18:30:00
206,GAZP,1181,1043,197254051.0,189209575.0,117201,108169,168.3,174.92,225370,386463626.0,2224,859,872,183460215.0,164739745.0,109405,92485,167.69,178.13,201890,348199961.0,1731,2023-11-02 18:35:00
207,GAZP,2973,6168,439919034.0,4620088960.0,260809,2724740,168.67,169.56,2985549,5060007994.0,9141,2015,5686,366244252.0,4455391963.0,218345,2645567,167.74,168.41,2863912,4821636216.0,7701,2023-11-02 18:40:00
208,GAZP,4995,2637,3495136176.0,500586881.0,2069513,268148,168.89,186.68,2337661,3995723058.0,7632,3929,1841,3386803917.0,330393740.0,2013717,194789,168.19,169.62,2208506,3717197657.0,5770,2023-11-03 10:05:00
209,GAZP,3869,3933,980590530.0,799532801.0,585275,475752,167.54,168.06,1061027,1780123331.0,7802,2645,3135,812742633.0,622421722.0,485206,369066,167.5,168.65,854272,1435164356.0,5780,2023-11-03 10:10:00
210,GAZP,2468,3678,560868828.0,676609692.0,334179,401023,167.83,168.72,735202,1237478521.0,6146,1468,3101,467454988.0,612316356.0,278930,363333,167.59,168.53,642263,1079771344.0,4569,2023-11-03 10:15:00
211,GAZP,2528,3031,504082842.0,645424730.0,300651,382693,167.66,168.65,683344,1149507573.0,5559,1789,2670,444377314.0,609561592.0,265191,361732,167.57,168.51,626923,1053938906.0,4459,2023-11-03 10:20:00
212,GAZP,2133,2162,636916025.0,709436519.0,367784,420484,173.18,168.72,788268,1346352545.0,4295,1578,1830,566518091.0,653649070.0,328872,388531,172.26,168.24,717403,1220167161.0,3408,2023-11-03 10:25:00
213,GAZP,2334,3064,685750355.0,954500069.0,407731,566338,168.19,168.54,974069,1640250424.0,5398,1962,2721,653093240.0,887496673.0,389070,527182,167.86,168.35,916252,1540589913.0,4683,2023-11-03 10:30:00
214,GAZP,2413,2877,834076607.0,871520770.0,490271,516342,170.13,168.79,1006613,1705597377.0,5290,2036,2417,798135968.0,821158512.0,475971,487308,167.69,168.51,963279,1619294481.0,4453,2023-11-03 10:35:00
215,GAZP,2074,3008,700702447.0,950344489.0,408780,564193,171.41,168.44,972973,1651046937.0,5082,1664,2777,664681664.0,914309659.0,387606,542892,171.48,168.41,930498,1578991323.0,4441,2023-11-03 10:40:00
216,GAZP,1303,2833,548444083.0,988612484.0,327740,587531,167.34,168.27,915271,1537056567.0,4136,918,2652,511236930.0,966382046.0,305259,574458,167.48,168.23,879717,1477618976.0,3570,2023-11-03 10:45:00
217,GAZP,934,1338,358792943.0,508771720.0,213769,302583,167.84,168.14,516352,867564664.0,2272,586,1066,341585540.0,483743178.0,203829,287528,167.58,168.24,491357,825328718.0,1652,2023-11-03 10:50:00
218,GAZP,1724,2726,768387885.0,1066624412.0,440904,634272,174.28,168.17,1075176,1835012297.0,4450,1319,2558,736616288.0,1048803550.0,422098,623528,174.51,168.2,1045626,1785419838.0,3877,2023-11-03 10:55:00
219,GAZP,1232,1048,471298069.0,507877273.0,272246,301850,173.11,168.25,574096,979175342.0,2280,958,866,452411101.0,488970873.0,261098,290438,173.27,168.36,551536,941381974.0,1824,2023-11-03 11:00:00
220,GAZP,1970,2362,840132128.0,1035695285.0,501868,600934,167.4,172.35,1102802,1875827413.0,4332,1646,2164,822628448.0,1008959536.0,491434,586560,167.39,172.01,1077994,1831587984.0,3810,2023-11-03 11:05:00
221,GAZP,1884,1973,680963923.0,976136898.0,397904,580671,171.14,168.1,978575,1657100821.0,3857,1580,1859,654726968.0,940775369.0,382262,559338,171.28,168.19,941600,1595502337.0,3439,2023-11-03 11:10:00
222,GAZP,1596,2044,653891412.0,727599167.0,381786,433413,171.27,167.88,815199,1381490580.0,3640,1321,1581,629429202.0,699730616.0,367171,416129,171.43,168.15,783300,1329159819.0,2902,2023-11-03 11:15:00
223,GAZP,1460,1089,634194003.0,600386995.0,369217,356762,171.77,168.29,725979,1234580998.0,2549,1180,998,612096717.0,592065580.0,356497,351749,171.7,168.32,708246,1204162297.0,2178,2023-11-03 11:20:00
224,GAZP,1395,2506,633486265.0,815625011.0,378306,484869,167.45,168.22,863175,1449111276.0,3901,1227,2377,605999917.0,807310323.0,361884,479866,167.46,168.24,841750,1413310240.0,3604,2023-11-03 11:25:00
225,GAZP,673,1038,295260462.0,354649593.0,176380,211189,167.4,167.93,387569,649910056.0,1711,475,853,284843365.0,334406396.0,170062,198924,167.49,168.11,368986,619249762.0,1328,2023-11-03 11:30:00
226,GAZP,1415,1794,606716647.0,657886398.0,362322,391744,167.45,167.94,754066,1264603045.0,3209,1114,1513,578241966.0,615245812.0,345454,365287,167.39,168.43,710741,1193487778.0,2627,2023-11-03 11:35:00
227,GAZP,3154,3757,1139540083.0,1422825065.0,671905,848387,169.6,167.71,1520292,2562365149.0,6911,2638,3555,1095810235.0,1375311843.0,646062,818991,169.61,167.93,1465053,2471122079.0,6193,2023-11-03 11:40:00
228,GAZP,2461,2480,861088701.0,877313546.0,514523,522042,167.36,168.05,1036565,1738402247.0,4941,2207,2340,845741677.0,858581373.0,505421,510770,167.33,168.1,1016191,1704323050.0,4547,2023-11-03 11:45:00
229,GAZP,3860,3982,1473500144.0,1248623507.0,879259,743078,167.58,168.03,1622337,2722123651.0,7842,3540,3717,1428998784.0,1207863628.0,853203,718311,167.49,168.15,1571514,2636862413.0,7257,2023-11-03 11:50:00
230,GAZP,1901,2067,733275125.0,654464355.0,437626,389776,167.56,167.91,827402,1387739481.0,3968,1644,1902,712338942.0,638169564.0,425360,379518,167.47,168.15,804878,1350508506.0,3546,2023-11-03 11:55:00
231,GAZP,1397,1803,490898080.0,515370793.0,293038,306962,167.52,167.89,600000,1006268873.0,3200,1141,1589,478878847.0,484165415.0,285960,288005,167.46,168.11,573965,963044263.0,2730,2023-11-03 12:00:00
232,GAZP,3475,3152,1772191831.0,1112509272.0,1058087,663112,167.49,167.77,1721199,2884701104.0,6627,3072,2957,1723137369.0,1084302002.0,1029018,645596,167.45,167.95,1674614,2807439371.0,6029,2023-11-03 12:05:00
233,GAZP,1715,1486,696908214.0,274720589.0,415920,163599,167.56,167.92,579519,971628804.0,3201,1459,1372,686756737.0,267794787.0,409971,159372,167.51,168.03,569343,954551524.0,2831,2023-11-03 12:10:00
234,GAZP,2518,2738,1038532410.0,613130165.0,619238,365154,167.71,167.91,984392,1651662575.0,5256,2249,2510,1010962007.0,589569852.0,603132,350852,167.62,168.04,953984,1600531860.0,4759,2023-11-03 12:15:00
235,GAZP,2434,2331,1166422888.0,382450395.0,695826,227790,167.63,167.9,923616,1548873283.0,4765,2243,2255,1157895015.0,370297732.0,690783,220345,167.62,168.05,911128,1528192748.0,4498,2023-11-03 12:20:00
236,GAZP,1769,1669,628449415.0,328511337.0,375056,196208,167.56,167.43,571264,956960752.0,3438,1581,1582,618975361.0,310065223.0,369424,184586,167.55,167.98,554010,929040585.0,3163,2023-11-03 12:25:00
237,GAZP,1582,1502,561197239.0,453835214.0,334604,270069,167.72,168.04,604673,1015032453.0,3084,1362,1400,543342732.0,442056301.0,324097,262980,167.65,168.1,587077,985399034.0,2762,2023-11-03 12:30:00
238,GAZP,1610,1474,473390382.0,416735338.0,282381,247862,167.64,168.13,530243,890125720.0,3084,1467,1366,476906984.0,401142752.0,284539,238455,167.61,168.23,522994,878049736.0,2833,2023-11-03 12:35:00
239,GAZP,5283,12457,827564750.0,1375005346.0,491866,818452,168.25,168.0,1310318,2202570096.0,17740,5063,12330,801725230.0,1351343731.0,476601,804361,168.22,168.0,1280962,2153068961.0,17393,2023-11-03 12:40:00
240,GAZP,1152,2562,379605139.0,690055713.0,226338,410322,167.72,168.17,636660,1069660852.0,3714,997,2452,372013489.0,680394876.0,221916,404504,167.64,168.2,626420,1052408365.0,3449,2023-11-03 12:45:00
241,GAZP,2743,5735,531608238.0,1854426693.0,316697,1102957,167.86,168.13,1419654,2386034932.0,8478,2550,5557,516115783.0,1835580438.0,307685,1091439,167.74,168.18,1399124,2351696222.0,8107,2023-11-03 12:50:00
242,GAZP,1064,1694,256987152.0,857462133.0,153073,509910,167.89,168.16,662983,1114449286.0,2758,909,1617,248359911.0,859106964.0,148050,510751,167.75,168.2,658801,1107466876.0,2526,2023-11-03 12:55:00
243,GAZP,1272,1650,286871668.0,399252125.0,170989,237260,167.77,168.28,408249,686123794.0,2922,1106,1529,277805457.0,374044454.0,165556,222242,167.8,168.31,387798,651849912.0,2635,2023-11-03 13:00:00
244,GAZP,1089,3104,321617220.0,794903226.0,191690,472755,167.78,168.14,664445,1116520446.0,4193,932,2990,309358324.0,783468515.0,184445,465831,167.72,168.19,650276,1092826840.0,3922,2023-11-03 13:05:00
245,GAZP,748,577,206384342.0,162774803.0,123036,96655,167.74,168.41,219691,369159146.0,1325,582,484,200415946.0,151652377.0,119452,90036,167.78,168.44,209488,352068323.0,1066,2023-11-03 13:10:00
246,GAZP,1026,646,350231226.0,262685024.0,208489,156051,167.99,168.33,364540,612916250.0,1672,775,545,325849160.0,247010732.0,194146,146611,167.84,168.48,340757,572859892.0,1320,2023-11-03 13:15:00
247,GAZP,1282,1444,459212682.0,744850891.0,273562,443718,167.86,167.87,717280,1204063573.0,2726,1073,1307,429221885.0,705713337.0,255916,419106,167.72,168.39,675022,1134935223.0,2380,2023-11-03 13:20:00
248,GAZP,1067,1782,309960924.0,794129226.0,182082,472045,170.23,168.23,654127,1104090150.0,2849,855,1672,288335598.0,781741724.0,172043,464658,167.6,168.24,636701,1070077322.0,2527,2023-11-03 13:25:00
249,GAZP,1440,1995,406103066.0,687880896.0,239477,408919,169.58,168.22,648396,1093983962.0,3435,1224,1710,384997152.0,659742689.0,229792,392112,167.54,168.25,621904,1044739841.0,2934,2023-11-03 13:30:00
250,GAZP,1636,1915,362966319.0,675563341.0,216510,401692,167.64,168.18,618202,1038529661.0,3551,1485,1821,354268013.0,663132239.0,211436,394214,167.55,168.22,605650,1017400252.0,3306,2023-11-03 13:35:00
251,GAZP,2567,3374,697758924.0,1432486579.0,415878,851788,167.78,168.17,1267666,2130245504.0,5941,2359,3265,679135578.0,1425012443.0,405241,847243,167.59,168.19,1252484,2104148021.0,5624,2023-11-03 13:40:00
252,GAZP,1405,2189,362071689.0,939833552.0,216093,559286,167.55,168.04,775379,1301905242.0,3594,1242,2145,354197527.0,933095828.0,211527,554943,167.45,168.14,766470,1287293355.0,3387,2023-11-03 13:45:00
253,GAZP,1482,2038,386185681.0,643683185.0,230030,382163,167.88,168.43,612193,1029868866.0,3520,1272,1909,369115582.0,643706684.0,220109,382175,167.7,168.43,602284,1012822266.0,3181,2023-11-03 13:50:00
254,GAZP,1692,2379,458170358.0,1158547649.0,273371,689294,167.6,168.08,962665,1616718008.0,4071,1446,2257,438032036.0,1122805442.0,261431,667165,167.55,168.3,928596,1560837478.0,3703,2023-11-03 13:55:00
255,GAZP,4272,6298,757428286.0,2705154114.0,452073,1610490,167.55,167.97,2062563,3462582400.0,10570,4040,6220,749209562.0,2690922567.0,447328,1601039,167.49,168.07,2048367,3440132129.0,10260,2023-11-03 14:00:00
256,GAZP,1470,12809,570715072.0,16068187765.0,338144,9557741,168.78,168.12,9895885,16638902838.0,14279,1218,12739,545856407.0,16057923724.0,326154,9551427,167.36,168.12,9877581,16603780131.0,13957,2023-11-03 14:05:00
257,GAZP,3957,7689,764101548.0,3866665855.0,455970,2299064,167.58,168.18,2755034,4630767404.0,11646,3651,7494,734066586.0,3837862470.0,437999,2281857,167.6,168.19,2719856,4571929056.0,11145,2023-11-03 14:10:00
258,GAZP,4542,7772,744955391.0,3098766519.0,444787,1843867,167.49,168.06,2288654,3843721910.0,12314,4288,7712,732028233.0,3083607673.0,437164,1835010,167.45,168.04,2272174,3815635906.0,12000,2023-11-03 14:15:00
259,GAZP,2990,5787,497481547.0,2476118157.0,296843,1472388,167.59,168.17,1769231,2973599705.0,8777,2767,5722,493094190.0,2468813498.0,294395,1468025,167.49,168.17,1762420,2961907689.0,8489,2023-11-03 14:20:00
260,GAZP,1451,1656,310406590.0,698013838.0,185033,415017,167.76,168.19,600050,1008420429.0,3107,1263,1559,301429603.0,688036312.0,179944,408966,167.51,168.24,588910,989465916.0,2822,2023-11-03 14:25:00
261,GAZP,1351,941,403311863.0,421931004.0,240485,250500,167.71,168.44,490985,825242867.0,2292,1134,886,392423523.0,428915386.0,234311,254056,167.48,168.83,488367,821338909.0,2020,2023-11-03 14:30:00
262,GAZP,2388,1278,886023443.0,887425400.0,528222,526754,167.74,168.47,1054976,1773448843.0,3666,2245,1190,871477092.0,880286913.0,519613,522450,167.72,168.49,1042063,1751764005.0,3435,2023-11-03 14:35:00
263,GAZP,532,366,179724061.0,230173004.0,107031,136318,167.92,168.85,243349,409897065.0,898,375,307,170238837.0,227578697.0,101524,132019,167.68,172.38,233543,397817534.0,682,2023-11-03 14:40:00
264,GAZP,2595,3811,756894541.0,4045764587.0,450409,2401984,168.05,168.43,2852393,4802659128.0,6406,2092,3701,734105624.0,4029218574.0,437147,2391928,167.93,168.45,2829075,4763324199.0,5793,2023-11-03 14:45:00
265,GAZP,1879,1686,594299342.0,1169425619.0,351316,694118,169.16,168.48,1045434,1763724961.0,3565,1693,1599,574689553.0,1166593627.0,342363,692385,167.86,168.49,1034748,1741283181.0,3292,2023-11-03 14:50:00
266,GAZP,2095,1599,839937428.0,715052817.0,494224,423941,169.95,168.67,918165,1554990246.0,3694,1874,1392,799513892.0,681318655.0,476005,403901,167.96,168.68,879906,1480832547.0,3266,2023-11-03 14:55:00
267,GAZP,412,375,52743326.0,55313509.0,31375,32685,168.11,169.23,64060,108056835.0,787,264,252,48281093.0,53929919.0,28784,31803,167.74,169.57,60587,102211012.0,516,2023-11-03 15:00:00
268,GAZP,816,685,189965039.0,228745928.0,112965,135581,168.16,168.72,248546,418710967.0,1501,688,580,190739956.0,220017970.0,113582,130345,167.93,168.8,243927,410757927.0,1268,2023-11-03 15:05:00
269,GAZP,1102,604,245118322.0,155188628.0,145904,92004,168.0,168.68,237908,400306951.0,1706,1002,544,241424863.0,150910885.0,143744,89412,167.95,168.78,233156,392335748.0,1546,2023-11-03 15:10:00
270,GAZP,1434,835,333892277.0,347027545.0,198739,205781,168.01,168.64,404520,680919822.0,2269,1333,776,329816354.0,338784035.0,196326,200787,167.99,168.73,397113,668600390.0,2109,2023-11-03 15:15:00
271,GAZP,1851,1010,483236229.0,341950835.0,287230,202554,168.24,168.82,489784,825187064.0,2861,1696,896,461030914.0,333474606.0,274471,197471,167.97,168.87,471942,794505520.0,2592,2023-11-03 15:20:00
272,GAZP,1129,928,317790199.0,358758000.0,188773,212419,168.35,168.89,401192,676548199.0,2057,967,763,300904053.0,337846507.0,179047,199963,168.06,168.95,379010,638750560.0,1730,2023-11-03 15:25:00
273,GAZP,624,575,158828950.0,177342893.0,94420,105062,168.22,168.8,199482,336171843.0,1199,457,489,149883136.0,168185459.0,89196,99593,168.04,168.87,188789,318068595.0,946,2023-11-03 15:30:00
274,GAZP,1658,1094,464618519.0,347587663.0,272692,205713,170.38,168.97,478405,812206182.0,2752,1431,927,426133423.0,331300698.0,253292,195972,168.24,169.06,449264,757434121.0,2358,2023-11-03 15:35:00
275,GAZP,1302,4016,299542018.0,1039383192.0,177981,615904,168.3,168.76,793885,1338925211.0,5318,1152,3896,299260706.0,1041211624.0,177956,616722,168.17,168.83,794678,1340472331.0,5048,2023-11-03 15:40:00
276,GAZP,1100,795,279200021.0,264188360.0,165808,156319,168.39,169.01,322127,543388381.0,1895,951,680,270076615.0,249600369.0,160574,147563,168.19,169.15,308137,519676984.0,1631,2023-11-03 15:45:00
277,GAZP,1341,5431,286570241.0,1947061102.0,170157,1153902,168.42,168.74,1324059,2233631344.0,6772,1123,5211,281008223.0,1920550221.0,167278,1137989,167.99,168.77,1305267,2201558444.0,6334,2023-11-03 15:50:00
278,GAZP,1959,2539,533902592.0,1112180181.0,316983,659087,168.43,168.75,976070,1646082773.0,4498,1790,2406,518656218.0,1100734075.0,308228,652196,168.27,168.77,960424,1619390294.0,4196,2023-11-03 15:55:00
279,GAZP,1931,1289,524169900.0,518737265.0,311085,306918,168.5,169.01,618003,1042907166.0,3220,1591,1141,494755248.0,509543351.0,293934,301374,168.32,169.07,595308,1004298599.0,2732,2023-11-03 16:00:00
280,GAZP,3339,1406,564504535.0,489755885.0,332301,289311,169.88,169.28,621612,1054260420.0,4745,1512,1075,463166905.0,458285614.0,274879,270556,168.5,169.39,545435,921452519.0,2587,2023-11-03 16:05:00
281,GAZP,1975,2164,709433458.0,806751437.0,420457,477637,168.73,168.9,898094,1516184895.0,4139,1685,1916,678326507.0,772197398.0,402320,456226,168.6,169.26,858546,1450523906.0,3601,2023-11-03 16:10:00
282,GAZP,999,862,288170571.0,293389913.0,170955,173655,168.57,168.95,344610,581560484.0,1861,831,695,287600571.0,278534378.0,170696,159651,168.49,174.46,330347,566134949.0,1526,2023-11-03 16:15:00
283,GAZP,1449,1254,416214424.0,464558107.0,244498,269790,170.23,172.19,514288,880772532.0,2703,1276,1144,390507733.0,443973945.0,231806,262271,168.46,169.28,494077,834481679.0,2420,2023-11-03 16:20:00
284,GAZP,804,1801,185480044.0,308235475.0,110101,182510,168.46,168.89,292611,493715519.0,2605,667,1671,186126702.0,293465771.0,110501,173549,168.44,169.1,284050,479592473.0,2338,2023-11-03 16:25:00
285,GAZP,925,750,252069983.0,280968142.0,149578,165227,168.52,170.05,314805,533038126.0,1675,761,662,235113193.0,246469592.0,139625,144597,168.39,170.45,284222,481582786.0,1423,2023-11-03 16:30:00
286,GAZP,877,702,273211486.0,231339775.0,162106,127982,168.54,180.76,290088,504551261.0,1579,717,592,263568280.0,234497490.0,156508,138485,168.41,169.33,294993,498065770.0,1309,2023-11-03 16:35:00
287,GAZP,1781,1452,560603647.0,433850330.0,332382,256824,168.66,168.93,589206,994453977.0,3233,1597,1322,565359451.0,418670929.0,330806,247407,170.9,169.22,578213,984030380.0,2919,2023-11-03 16:40:00
288,GAZP,1606,937,512207108.0,331049727.0,304057,195707,168.46,169.16,499764,843256836.0,2543,1500,864,500515085.0,323776493.0,297153,191243,168.44,169.3,488396,824291579.0,2364,2023-11-03 16:45:00
289,GAZP,956,725,326093779.0,272914890.0,193498,161229,168.53,169.27,354727,599008670.0,1681,780,609,317483030.0,259560181.0,188549,153269,168.38,169.35,341818,577043212.0,1389,2023-11-03 16:50:00
290,GAZP,1440,1856,378151572.0,563744558.0,224528,333440,168.42,169.07,557968,941896130.0,3296,1267,1796,370125068.0,556143654.0,219811,328830,168.38,169.13,548641,926268723.0,3063,2023-11-03 16:55:00
291,GAZP,1037,1153,234987536.0,374067309.0,139459,220237,168.5,169.85,359696,609054846.0,2190,864,1078,224746552.0,351777825.0,133539,207922,168.3,169.19,341461,576524378.0,1942,2023-11-03 17:00:00
292,GAZP,1418,1281,387059335.0,456233597.0,229222,269611,168.86,169.22,498833,843292933.0,2699,1189,1180,361494659.0,446817051.0,214493,263910,168.53,169.31,478403,808311710.0,2369,2023-11-03 17:05:00
293,GAZP,1197,1094,332521704.0,313309366.0,197307,185026,168.53,169.33,382333,645831070.0,2291,1105,1028,334810511.0,306468795.0,198757,180963,168.45,169.35,379720,641279306.0,2133,2023-11-03 17:10:00
294,GAZP,2275,3232,476652029.0,916360159.0,282819,542032,168.54,169.06,824851,1393012188.0,5507,2135,3108,471074832.0,906798539.0,279561,536285,168.51,169.09,815846,1377873371.0,5243,2023-11-03 17:15:00
295,GAZP,1093,955,261903127.0,233684404.0,155386,137883,168.55,169.48,293269,495587531.0,2048,973,893,249558850.0,225519433.0,148141,133060,168.46,169.49,281201,475078283.0,1866,2023-11-03 17:20:00
296,GAZP,1007,847,304414279.0,215129814.0,180662,127227,168.5,169.09,307889,519544094.0,1854,863,739,296956114.0,204724195.0,176403,120862,168.34,169.39,297265,501680310.0,1602,2023-11-03 17:25:00
297,GAZP,1469,772,371096559.0,450221977.0,219870,257303,168.78,174.98,477173,821318537.0,2241,1228,683,357769086.0,273864564.0,212355,161622,168.48,169.45,373977,631633651.0,1911,2023-11-03 17:30:00
298,GAZP,3603,2291,879692041.0,882770953.0,519977,520931,169.18,169.46,1040908,1762462994.0,5894,3215,2069,827897408.0,857116640.0,490850,505626,168.67,169.52,996476,1685014049.0,5284,2023-11-03 17:35:00
299,GAZP,1655,1798,429181331.0,613707642.0,253764,362183,169.13,169.45,615947,1042888974.0,3453,1505,1648,410191464.0,594674683.0,243226,350926,168.65,169.46,594152,1004866147.0,3153,2023-11-03 17:40:00
300,GAZP,1206,1360,314344208.0,332926228.0,186020,196342,168.98,169.56,382362,647270437.0,2566,1081,1251,303238474.0,320529960.0,179803,189020,168.65,169.57,368823,623768435.0,2332,2023-11-03 17:45:00
301,GAZP,6038,3318,1513887015.0,1331578575.0,893568,784926,169.42,169.64,1678494,2845465591.0,9356,4652,2868,1420415317.0,1270794196.0,840652,748465,168.97,169.79,1589117,2691209513.0,7520,2023-11-03 17:50:00
302,GAZP,2181,1380,420428470.0,344304046.0,248272,202667,169.34,169.89,450939,764732516.0,3561,1970,1119,400632528.0,379343858.0,237001,223079,169.04,170.05,460080,779976387.0,3089,2023-11-03 17:55:00
303,GAZP,1438,1178,337670157.0,323803074.0,199764,190756,169.03,169.75,390520,661473232.0,2616,1218,997,328460938.0,301285252.0,194443,177362,168.92,169.87,371805,629746190.0,2215,2023-11-03 18:00:00
304,GAZP,2097,2416,444261250.0,633939600.0,262604,373609,169.18,169.68,636213,1078200850.0,4513,1803,2255,422628253.0,613328401.0,250071,361244,169.0,169.78,611315,1035956655.0,4058,2023-11-03 18:05:00
305,GAZP,1122,715,268866164.0,189619371.0,158857,111729,169.25,169.71,270586,458485536.0,1837,925,593,234889345.0,181597518.0,139007,106883,168.98,169.9,245890,416486863.0,1518,2023-11-03 18:10:00
306,GAZP,2380,2590,601245765.0,775528063.0,354898,455786,169.41,170.15,810684,1376773828.0,4970,1965,2321,571385396.0,662295675.0,337885,389992,169.11,169.82,727877,1233681071.0,4286,2023-11-03 18:15:00
307,GAZP,4363,2657,1097599509.0,993350029.0,647133,584821,169.61,169.86,1231954,2090949538.0,7020,3374,2388,1045492294.0,953306147.0,618222,560931,169.11,169.95,1179153,1998798441.0,5762,2023-11-03 18:20:00
308,GAZP,850,1006,229410283.0,224945041.0,135520,132432,169.28,169.86,267952,454355325.0,1856,712,860,216176069.0,218256209.0,127832,128367,169.11,170.03,256199,434432278.0,1572,2023-11-03 18:25:00
309,GAZP,1400,1099,357527411.0,255422025.0,211237,150442,169.25,169.78,361679,612949436.0,2499,1267,922,351509222.0,236275172.0,207864,138962,169.11,170.03,346826,587784395.0,2189,2023-11-03 18:30:00
310,GAZP,1999,1445,579259474.0,442249559.0,342413,261325,169.17,169.23,603738,1021509033.0,3444,1699,1027,564264074.0,383809767.0,333741,225864,169.07,169.93,559605,948073842.0,2726,2023-11-03 18:35:00
311,GAZP,1537,936,337666520.0,336271341.0,199066,198260,169.63,169.61,397326,673937861.0,2473,1307,782,305071457.0,320136047.0,180379,188594,169.13,169.75,368973,625207504.0,2089,2023-11-03 18:40:00
312,GAZP,2479,2571,470717306.0,700262425.0,278137,413236,169.24,169.46,691373,1170979732.0,5050,1689,1971,348432801.0,586159838.0,206012,345628,169.13,169.59,551640,934592640.0,3660,2023-11-06 10:05:00
313,GAZP,2848,3063,592372741.0,783168702.0,349965,460813,169.27,169.95,810778,1375541443.0,5911,2442,2670,534092587.0,696008471.0,315694,410133,169.18,169.7,725827,1230101059.0,5112,2023-11-06 10:10:00
314,GAZP,3663,5992,495213633.0,1419355666.0,292284,834485,169.43,170.09,1126769,1914569299.0,9655,3380,5638,461393154.0,1306412568.0,272349,769741,169.41,169.72,1042090,1767805722.0,9018,2023-11-06 10:15:00
315,GAZP,3744,3360,569860690.0,648923180.0,336539,382134,169.33,169.82,718673,1218783870.0,7104,3477,3108,564548212.0,611107125.0,333461,360170,169.3,169.67,693631,1175655337.0,6585,2023-11-06 10:20:00
316,GAZP,2358,2948,512276175.0,1126543617.0,302661,664408,169.26,169.56,967069,1638819792.0,5306,2104,2776,509031166.0,1101520180.0,300766,649537,169.24,169.59,950303,1610551347.0,4880,2023-11-06 10:25:00
317,GAZP,1496,4478,449133934.0,1130082225.0,265690,666694,169.04,169.51,932384,1579216159.0,5974,1274,4319,402529082.0,1109147771.0,237864,654372,169.23,169.5,892236,1511676854.0,5593,2023-11-06 10:30:00
318,GAZP,1393,2781,494829486.0,864531576.0,292455,510067,169.2,169.49,802522,1359361063.0,4174,1194,2661,480734776.0,851605521.0,284116,502402,169.2,169.51,786518,1332340297.0,3855,2023-11-06 10:35:00
319,GAZP,3681,7977,687634042.0,1908427614.0,406767,1126053,169.05,169.48,1532820,2596061657.0,11658,3482,7792,686365523.0,1884868720.0,406030,1112490,169.04,169.43,1518520,2571234243.0,11274,2023-11-06 10:40:00
320,GAZP,2046,2896,642166318.0,1105803792.0,380204,653418,168.9,169.23,1033622,1747970110.0,4942,1775,2768,620679588.0,1079022485.0,367566,636765,168.86,169.45,1004331,1699702073.0,4543,2023-11-06 10:45:00
321,GAZP,1187,1309,466404966.0,724429827.0,275754,427036,169.14,169.64,702790,1190834793.0,2496,1035,1169,439555912.0,703615372.0,260021,414770,169.05,169.64,674791,1143171285.0,2204,2023-11-06 10:50:00
322,GAZP,738,3378,261949960.0,665539676.0,154695,392425,169.33,169.6,547120,927489637.0,4116,563,3208,252956471.0,643687176.0,149492,379445,169.21,169.64,528937,896643648.0,3771,2023-11-06 10:55:00
323,GAZP,522,1481,199232796.0,369156650.0,117572,217622,169.46,169.63,335194,568389447.0,2003,412,1368,203391903.0,362561147.0,120252,213717,169.14,169.65,333969,565953050.0,1780,2023-11-06 11:00:00
324,GAZP,1145,565,357946632.0,253807642.0,210483,149442,170.06,169.84,359925,611754275.0,1710,1022,386,341729802.0,241805874.0,201709,142376,169.42,169.84,344085,583535676.0,1408,2023-11-06 11:05:00
325,GAZP,606,1013,214436299.0,287838611.0,126570,169546,169.42,169.77,296116,502274911.0,1619,499,886,209270488.0,276923527.0,123528,163113,169.41,169.77,286641,486194016.0,1385,2023-11-06 11:10:00
326,GAZP,1017,1019,342738684.0,370356447.0,202239,218207,169.47,169.73,420446,713095131.0,2036,899,912,346893983.0,360083979.0,204780,212057,169.4,169.81,416837,706977962.0,1811,2023-11-06 11:15:00
327,GAZP,1073,1523,512724598.0,584861495.0,301860,344435,169.86,169.8,646295,1097586093.0,2596,888,1358,468353615.0,563622191.0,276353,331842,169.48,169.85,608195,1031975806.0,2246,2023-11-06 11:20:00
328,GAZP,1811,2150,826281037.0,579506132.0,486993,340863,169.67,170.01,827856,1405787170.0,3961,1632,1965,805914251.0,549469594.0,475371,323361,169.53,169.92,798732,1355383846.0,3597,2023-11-06 11:25:00
329,GAZP,983,1807,420751604.0,224739743.0,246987,131886,170.35,170.4,378873,645491348.0,2790,807,1600,386395902.0,210824284.0,227841,123744,169.59,170.37,351585,597220187.0,2407,2023-11-06 11:30:00
330,GAZP,2638,1305,1275860925.0,385107582.0,749340,225727,170.26,170.61,975067,1660968508.0,3943,2236,855,1216715400.0,318688493.0,716470,186883,169.82,170.53,903353,1535403893.0,3091,2023-11-06 11:35:00
331,GAZP,4423,1732,1895950978.0,539832133.0,1114894,316795,170.06,170.4,1431689,2435783112.0,6155,4030,1364,1812292739.0,490082480.0,1066432,287188,169.94,170.65,1353620,2302375219.0,5394,2023-11-06 11:40:00
332,GAZP,1573,2610,838486142.0,757817353.0,493130,444978,170.03,170.3,938108,1596303495.0,4183,1408,2373,817355183.0,729695753.0,480589,428553,170.07,170.27,909142,1547050936.0,3781,2023-11-06 11:45:00
333,GAZP,711,806,305823288.0,257747336.0,179743,151646,170.14,169.97,331389,563570624.0,1517,545,576,301536042.0,232802797.0,177422,136551,169.95,170.49,313973,534338839.0,1121,2023-11-06 11:50:00
334,GAZP,1643,1811,591229498.0,633968048.0,347123,373584,170.32,169.7,720707,1225197547.0,3454,1433,1472,574305958.0,521718367.0,337531,306134,170.15,170.42,643665,1096024326.0,2905,2023-11-06 11:55:00
335,GAZP,1530,1137,454022109.0,366033708.0,267287,215089,169.86,170.18,482376,820055817.0,2667,1314,974,434239769.0,351150814.0,255833,206291,169.74,170.22,462124,785390584.0,2288,2023-11-06 12:00:00
336,GAZP,1497,1168,603178309.0,400104143.0,355106,235221,169.86,170.1,590327,1003282452.0,2665,1339,985,587329191.0,392427381.0,345859,230322,169.82,170.38,576181,979756573.0,2324,2023-11-06 12:05:00
337,GAZP,1011,1464,305858040.0,307449425.0,179584,180768,170.31,170.08,360352,613307465.0,2475,882,1259,305221753.0,288553622.0,179302,169531,170.23,170.21,348833,593775375.0,2141,2023-11-06 12:10:00
338,GAZP,1581,1248,662624358.0,350484093.0,390115,206164,169.85,170.0,596279,1013108451.0,2829,1417,1081,651058250.0,335018994.0,383374,196782,169.82,170.25,580156,986077245.0,2498,2023-11-06 12:15:00
339,GAZP,783,642,275363296.0,214300296.0,162121,125965,169.85,170.13,288086,489663592.0,1425,660,505,258879637.0,199254293.0,152432,116996,169.83,170.31,269428,458133931.0,1165,2023-11-06 12:20:00
340,GAZP,2036,4840,412163593.0,1039405999.0,242922,611700,169.67,169.92,854622,1451569592.0,6876,1860,4660,412012866.0,1006513397.0,242860,592294,169.65,169.93,835154,1418526264.0,6520,2023-11-06 12:25:00
341,GAZP,1329,2546,402319894.0,591040078.0,236616,347741,170.03,169.97,584357,993359972.0,3875,1175,2398,382558153.0,577557108.0,225446,339797,169.69,169.97,565243,960115261.0,3573,2023-11-06 12:30:00
342,GAZP,892,678,309436163.0,213951884.0,182188,125609,169.84,170.33,307797,523388048.0,1570,804,561,286336837.0,208001587.0,168649,122125,169.78,170.32,290774,494338424.0,1365,2023-11-06 12:35:00
343,GAZP,820,579,230711638.0,197497497.0,135864,116139,169.81,170.05,252003,428209136.0,1399,757,491,234754463.0,180980495.0,138318,106316,169.72,170.23,244634,415734958.0,1248,2023-11-06 12:40:00
344,GAZP,1289,1699,406929247.0,457579408.0,240004,269337,169.55,169.89,509341,864508655.0,2988,1102,1570,391867494.0,450942539.0,231159,265379,169.52,169.92,496538,842810033.0,2672,2023-11-06 12:45:00
345,GAZP,1668,1225,503370396.0,345436479.0,296028,203230,170.04,169.97,499258,848806875.0,2893,1545,1079,474955409.0,336724612.0,280015,197976,169.62,170.08,477991,811680021.0,2624,2023-11-06 12:50:00
346,GAZP,921,756,341062603.0,232886422.0,201072,136948,169.62,170.05,338020,573949025.0,1677,847,602,330659557.0,219893310.0,194997,129338,169.57,170.01,324335,550552868.0,1449,2023-11-06 12:55:00
347,GAZP,971,828,332435412.0,253677646.0,195671,149139,169.9,170.09,344810,586113059.0,1799,820,724,316318770.0,239299453.0,186472,140736,169.63,170.03,327208,555618223.0,1544,2023-11-06 13:00:00
348,GAZP,658,823,215906240.0,263649896.0,127312,155251,169.59,169.82,282563,479556137.0,1481,542,719,182852982.0,227020154.0,107820,133521,169.59,170.03,241341,409873136.0,1261,2023-11-06 13:05:00
349,GAZP,745,636,244713289.0,242370718.0,144423,142802,169.44,169.73,287225,487084008.0,1381,661,526,240997971.0,230547608.0,142225,135685,169.45,169.91,277910,471545579.0,1187,2023-11-06 13:10:00
350,GAZP,935,697,357825968.0,233873186.0,211036,137768,169.56,169.76,348804,591699155.0,1632,772,623,338164207.0,229855090.0,199674,135330,169.36,169.85,335004,568019298.0,1395,2023-11-06 13:15:00
351,GAZP,456,392,150373287.0,106859003.0,88724,62783,169.48,170.2,151507,257232290.0,848,375,333,147194433.0,102710391.0,86861,60387,169.46,170.09,147248,249904824.0,708,2023-11-06 13:20:00
352,GAZP,496,429,173885845.0,116997227.0,102584,68924,169.51,169.75,171508,290883073.0,925,415,368,170445150.0,115750699.0,100590,68141,169.45,169.87,168731,286195849.0,783,2023-11-06 13:25:00
353,GAZP,340,347,112044675.0,97280269.0,66099,57424,169.51,169.41,123523,209324945.0,687,255,296,120730883.0,94950672.0,71420,55904,169.04,169.85,127324,215681555.0,551,2023-11-06 13:30:00
354,GAZP,729,608,231760168.0,143856997.0,136918,84799,169.27,169.64,221717,375617166.0,1337,644,549,228077735.0,140708491.0,134733,82848,169.28,169.84,217581,368786226.0,1193,2023-11-06 13:35:00
355,GAZP,416,319,137557321.0,112941119.0,81200,66478,169.41,169.89,147678,250498440.0,735,294,265,133524692.0,109960643.0,78836,64742,169.37,169.84,143578,243485336.0,559,2023-11-06 13:40:00
356,GAZP,325,401,103113076.0,97650607.0,60854,57527,169.44,169.75,118381,200763684.0,726,254,349,101871715.0,98241656.0,60150,57828,169.36,169.89,117978,200113372.0,603,2023-11-06 13:45:00
357,GAZP,1387,1671,493487437.0,534221774.0,291701,316108,169.18,169.0,607809,1027709211.0,3058,1161,1478,476631676.0,491911311.0,281815,289944,169.13,169.66,571759,968542987.0,2639,2023-11-06 13:50:00
358,GAZP,686,627,206570591.0,192465214.0,122084,113426,169.2,169.68,235510,399035806.0,1313,549,539,187723022.0,182228361.0,111058,107419,169.03,169.64,218477,369951383.0,1088,2023-11-06 13:55:00
359,GAZP,612,662,187752987.0,193948914.0,110545,114413,169.84,169.52,224958,381701901.0,1274,560,618,185793609.0,195856478.0,109832,115443,169.16,169.66,225275,381650087.0,1178,2023-11-06 14:00:00
360,GAZP,304,1044,154946551.0,446677602.0,91312,263442,169.69,169.55,354754,601624153.0,1348,235,983,142395901.0,432671168.0,84121,255010,169.28,169.67,339131,575067070.0,1218,2023-11-06 14:05:00
361,GAZP,1078,1873,370284704.0,1183284129.0,219004,698022,169.08,169.52,917026,1553568833.0,2951,872,1665,384699081.0,1128996841.0,227910,666069,168.79,169.5,893979,1513695923.0,2537,2023-11-06 14:10:00
362,GAZP,986,1193,375527628.0,411677814.0,222437,242739,168.82,169.6,465176,787205443.0,2179,735,1023,308921644.0,372064065.0,182899,219686,168.9,169.36,402585,680985709.0,1758,2023-11-06 14:15:00
363,GAZP,647,913,187491497.0,252674194.0,110637,149108,169.47,169.46,259745,440165691.0,1560,469,826,171887373.0,233876640.0,101771,138050,168.9,169.41,239821,405764013.0,1295,2023-11-06 14:20:00
364,GAZP,535,616,152947711.0,158237720.0,90489,93216,169.02,169.75,183705,311185431.0,1151,411,542,149186489.0,147221323.0,88301,86851,168.95,169.51,175152,296407812.0,953,2023-11-06 14:25:00
365,GAZP,842,835,205801712.0,258388825.0,121663,152452,169.16,169.49,274115,464190537.0,1677,676,779,197491558.0,262434479.0,116821,154787,169.05,169.55,271608,459926037.0,1455,2023-11-06 14:30:00
366,GAZP,966,870,263400428.0,285140187.0,155776,168356,169.09,169.37,324132,548540615.0,1836,811,804,250004716.0,273810135.0,147924,161468,169.01,169.58,309392,523814852.0,1615,2023-11-06 14:35:00
367,GAZP,547,706,183327492.0,244920554.0,108100,144434,169.59,169.57,252534,428248047.0,1253,445,583,184177752.0,229102227.0,108869,135065,169.17,169.62,243934,413279979.0,1028,2023-11-06 14:40:00
368,GAZP,685,755,213378043.0,218363123.0,126142,128796,169.16,169.54,254938,431741167.0,1440,609,668,208683144.0,208253431.0,123425,122754,169.08,169.65,246179,416936576.0,1277,2023-11-06 14:45:00
369,GAZP,481,440,133182249.0,108936766.0,78895,64268,168.81,169.5,143163,242119015.0,921,403,389,123387921.0,112528759.0,73047,66339,168.92,169.63,139386,235916680.0,792,2023-11-06 14:50:00
370,GAZP,465,501,198281430.0,155857887.0,117452,91949,168.82,169.5,209401,354139318.0,966,367,431,192705246.0,151099196.0,114299,89108,168.6,169.57,203407,343804442.0,798,2023-11-06 14:55:00
371,GAZP,480,566,150162779.0,165997495.0,88797,97873,169.11,169.6,186670,316160275.0,1046,390,473,148329262.0,161852914.0,87705,95389,169.12,169.68,183094,310182176.0,863,2023-11-06 15:00:00
372,GAZP,772,895,216828368.0,279012593.0,128165,164457,169.18,169.66,292622,495840962.0,1667,695,793,214210478.0,274333073.0,126672,161690,169.11,169.67,288362,488543551.0,1488,2023-11-06 15:05:00
373,GAZP,727,906,222628567.0,270935888.0,131573,159958,169.21,169.38,291531,493564456.0,1633,644,834,234120110.0,263903795.0,138570,155582,168.95,169.62,294152,498023905.0,1478,2023-11-06 15:10:00
374,GAZP,607,682,183201964.0,170157687.0,108291,100321,169.18,169.61,208612,353359651.0,1289,523,625,166600438.0,166508230.0,98469,98161,169.19,169.63,196630,333108669.0,1148,2023-11-06 15:15:00
375,GAZP,457,504,146852027.0,155855755.0,86803,91820,169.18,169.74,178623,302707782.0,961,377,438,140109301.0,151166216.0,82806,89044,169.2,169.77,171850,291275517.0,815,2023-11-06 15:20:00
376,GAZP,330,396,113820532.0,138042888.0,67223,81386,169.32,169.62,148609,251863421.0,726,222,344,110891624.0,135883464.0,65519,80080,169.25,169.68,145599,246775089.0,566,2023-11-06 15:25:00
377,GAZP,347,432,134031263.0,144423318.0,79177,85128,169.28,169.65,164305,278454581.0,779,259,372,130903030.0,144259905.0,77365,84994,169.2,169.73,162359,275162936.0,631,2023-11-06 15:30:00
378,GAZP,688,917,216868067.0,236791605.0,128164,139575,169.21,169.65,267739,453659673.0,1605,609,821,215301279.0,227578072.0,127315,134114,169.11,169.69,261429,442879351.0,1430,2023-11-06 15:35:00
379,GAZP,424,696,161713642.0,203790007.0,95640,120508,169.09,169.11,216148,365503650.0,1120,352,520,162867479.0,186033296.0,96315,109702,169.1,169.58,206017,348900775.0,872,2023-11-06 15:40:00
380,GAZP,628,748,193798343.0,237803688.0,114715,140400,168.94,169.38,255115,431602032.0,1376,484,655,185523532.0,210451666.0,109853,124221,168.88,169.42,234074,395975199.0,1139,2023-11-06 15:45:00
381,GAZP,779,481,268668389.0,165509776.0,159332,97435,168.62,169.87,256767,434178165.0,1260,674,446,259469127.0,184066176.0,153843,108487,168.66,169.67,262330,443535303.0,1120,2023-11-06 15:50:00
382,GAZP,651,560,269215559.0,211820291.0,159748,125099,168.53,169.32,284847,481035851.0,1211,513,464,231353508.0,199334159.0,137160,117662,168.67,169.41,254822,430687667.0,977,2023-11-06 15:55:00
383,GAZP,647,691,260365664.0,251409481.0,154394,148554,168.64,169.24,302948,511775145.0,1338,511,576,240892371.0,241631589.0,142799,142681,168.69,169.35,285480,482523960.0,1087,2023-11-06 16:00:00
384,GAZP,375,368,143687943.0,146578236.0,85072,86569,168.9,169.32,171641,290266179.0,743,245,284,137505653.0,149312892.0,81479,88165,168.76,169.36,169644,286818546.0,529,2023-11-06 16:05:00
385,GAZP,288,385,97396084.0,117867689.0,57685,69582,168.84,169.39,127267,215263773.0,673,209,334,92475083.0,117620593.0,54784,69441,168.8,169.38,124225,210095677.0,543,2023-11-06 16:10:00
386,GAZP,275,458,91214582.0,114899109.0,53966,67841,169.02,169.37,121807,206113692.0,733,193,384,88112084.0,110663698.0,52144,65330,168.98,169.39,117474,198775783.0,577,2023-11-06 16:15:00
387,GAZP,253,374,86119079.0,89792201.0,50847,53033,169.37,169.31,103880,175911281.0,627,176,286,82515436.0,83582509.0,48850,49343,168.92,169.39,98193,166097945.0,462,2023-11-06 16:20:00
388,GAZP,228,235,66336945.0,67389187.0,39214,39814,169.17,169.26,79028,133726133.0,463,156,178,66461593.0,65446249.0,39323,38640,169.01,169.37,77963,131907843.0,334,2023-11-06 16:25:00
389,GAZP,442,713,150969646.0,196859464.0,89346,116270,168.97,169.31,205616,347829111.0,1155,394,621,147490746.0,177693956.0,87284,104933,168.98,169.34,192217,325184702.0,1015,2023-11-06 16:30:00
390,GAZP,685,704,208627428.0,254769285.0,122680,151002,170.06,168.72,273682,463396714.0,1389,463,523,184989058.0,223294224.0,108858,131957,169.94,169.22,240815,408283283.0,986,2023-11-06 16:35:00
391,GAZP,1683,1447,437126305.0,384579284.0,258947,227679,168.81,168.91,486626,821705590.0,3130,1363,1138,415737122.0,362817620.0,246418,214446,168.71,169.19,460864,778554742.0,2501,2023-11-06 16:40:00
392,GAZP,619,686,169388793.0,189555163.0,100190,111359,169.07,170.22,211549,358943956.0,1305,528,616,162364409.0,187865872.0,96108,110610,168.94,169.85,206718,350230281.0,1144,2023-11-06 16:45:00
393,GAZP,649,632,178909258.0,160004244.0,105815,94456,169.08,169.4,200271,338913503.0,1281,568,532,173462112.0,157368106.0,102677,92868,168.94,169.45,195545,330830219.0,1100,2023-11-06 16:50:00
394,GAZP,894,763,226512129.0,212800613.0,133823,125521,169.26,169.53,259344,439312742.0,1657,823,691,225268569.0,207544620.0,133212,122424,169.11,169.53,255636,432813190.0,1514,2023-11-06 16:55:00
395,GAZP,428,590,160550795.0,173580388.0,94445,102379,169.99,169.55,196824,334131184.0,1018,365,431,147873809.0,165619879.0,87394,97649,169.2,169.61,185043,313493688.0,796,2023-11-06 17:00:00
396,GAZP,1428,1600,403917822.0,465858049.0,237929,274476,169.76,169.73,512405,869775871.0,3028,1323,1388,388450265.0,450364359.0,229446,265249,169.3,169.79,494695,838814624.0,2711,2023-11-06 17:05:00
397,GAZP,600,723,157450126.0,162540036.0,93003,95768,169.3,169.72,188771,319990162.0,1323,527,553,149403230.0,144459707.0,88235,85087,169.32,169.78,173322,293862937.0,1080,2023-11-06 17:10:00
398,GAZP,9457,2972,863427855.0,276382707.0,509462,162943,169.48,169.62,672405,1139810562.0,12429,9389,2931,860099201.0,273154117.0,507494,161021,169.48,169.64,668515,1133253318.0,12320,2023-11-06 17:15:00
399,GAZP,803,712,185927017.0,160120069.0,109894,94547,169.19,169.35,204441,346047087.0,1515,718,622,176267252.0,150189409.0,104159,88495,169.23,169.72,192654,326456661.0,1340,2023-11-06 17:20:00
400,GAZP,1248,887,214766582.0,149835186.0,126958,88362,169.16,169.57,215320,364601768.0,2135,1173,856,211692668.0,149334476.0,125167,88034,169.13,169.63,213201,361027144.0,2029,2023-11-06 17:25:00
401,GAZP,405,338,73407365.0,60899742.0,43370,35875,169.26,169.76,79245,134307108.0,743,330,275,67373366.0,58334291.0,39829,34335,169.16,169.9,74164,125707658.0,605,2023-11-06 17:30:00
402,GAZP,348,398,48557145.0,58319734.0,28703,34353,169.17,169.77,63056,106876879.0,746,294,340,58250625.0,61665803.0,34448,36280,169.1,169.97,70728,119916429.0,634,2023-11-06 17:35:00
403,GAZP,5105,3249,463961067.0,266040851.0,273960,156992,169.35,169.46,430952,730001918.0,8354,4967,3180,460145081.0,260943765.0,271702,153890,169.36,169.57,425592,721088847.0,8147,2023-11-06 17:40:00
404,GAZP,891,732,166081420.0,131374540.0,97995,77491,169.48,169.54,175486,297455960.0,1623,772,653,158097326.0,127624638.0,93483,75232,169.12,169.64,168715,285721964.0,1425,2023-11-06 17:45:00
405,GAZP,354,352,60851634.0,77727632.0,35946,45804,169.29,169.7,81750,138579266.0,706,274,285,48737020.0,73575320.0,28812,43310,169.16,169.88,72122,122312340.0,559,2023-11-06 17:50:00
406,GAZP,352,365,48914384.0,78218559.0,28845,46381,169.58,168.64,75226,127132943.0,717,264,253,45945510.0,60018992.0,27165,35331,169.13,169.88,62496,105964503.0,517,2023-11-06 17:55:00
407,GAZP,378,386,69652463.0,62416694.0,41103,36843,169.46,169.41,77946,132069157.0,764,285,308,66635422.0,58884125.0,39401,34668,169.12,169.85,74069,125519547.0,593,2023-11-06 18:00:00
408,GAZP,954,1061,300674274.0,240572326.0,176887,141258,169.98,170.31,318145,541246601.0,2015,822,813,283294993.0,216196036.0,167113,127148,169.52,170.03,294261,499491029.0,1635,2023-11-06 18:05:00
409,GAZP,725,561,138585593.0,120449898.0,81629,70796,169.77,170.14,152425,259035491.0,1286,642,478,129632154.0,109723952.0,76468,64498,169.52,170.12,140966,239356106.0,1120,2023-11-06 18:10:00
410,GAZP,666,343,98739082.0,65382916.0,58250,38303,169.51,170.7,96553,164121998.0,1009,499,284,88149719.0,60991637.0,52023,35687,169.44,170.91,87710,149141356.0,783,2023-11-06 18:15:00
411,GAZP,371,349,127458581.0,81518743.0,75109,47925,169.7,170.1,123034,208977324.0,720,277,276,98431727.0,63562525.0,58089,37385,169.45,170.02,95474,161994252.0,553,2023-11-06 18:20:00
412,GAZP,579,495,117359783.0,104192292.0,69236,61422,169.51,169.63,130658,221552076.0,1074,489,407,111016960.0,89233561.0,65526,52518,169.42,169.91,118044,200250522.0,896,2023-11-06 18:25:00
413,GAZP,498,427,97582325.0,96735439.0,57556,57349,169.54,168.68,114905,194317764.0,925,374,344,88941534.0,90651780.0,52519,53345,169.35,169.93,105864,179593315.0,718,2023-11-06 18:30:00
414,GAZP,214,306,39659460.0,78864833.0,23380,46406,169.63,169.95,69786,118524294.0,520,138,240,41130063.0,73566870.0,24294,43260,169.3,170.06,67554,114696934.0,378,2023-11-06 18:35:00
415,GAZP,461,481,199396027.0,109461996.0,117340,64353,169.93,170.1,181693,308858023.0,942,419,405,187845326.0,93217807.0,110762,54810,169.59,170.07,165572,281063134.0,824,2023-11-06 18:40:00
416,GAZP,3422,4110,624290614.0,1683908700.0,366329,983591,170.42,171.2,1349920,2308199314.0,7532,2610,3291,510623612.0,1591853677.0,299655,939301,170.4,169.47,1238956,2102477290.0,5901,2023-11-07 10:05:00
417,GAZP,1747,1406,422828467.0,388616533.0,251172,219334,168.34,177.18,470506,811445000.0,3153,1320,1116,376570723.0,330429223.0,223312,194709,168.63,169.7,418021,706999947.0,2436,2023-11-07 10:10:00
418,GAZP,2224,2874,511941950.0,755862876.0,302936,446485,168.99,169.29,749421,1267804826.0,5098,1740,2576,465317823.0,695747373.0,276048,410590,168.56,169.45,686638,1161065196.0,4316,2023-11-07 10:15:00
419,GAZP,2994,2409,915465042.0,848011629.0,542473,499852,168.76,169.65,1042325,1763476671.0,5403,2271,1815,792134492.0,784847120.0,470002,452639,168.54,173.39,922641,1576981612.0,4086,2023-11-07 10:20:00
420,GAZP,2523,2558,1047144760.0,1109363209.0,617098,654554,169.69,169.48,1271652,2156507970.0,5081,2048,2142,997797379.0,1064872438.0,591469,628519,168.7,169.43,1219988,2062669817.0,4190,2023-11-07 10:25:00
421,GAZP,2422,2832,808656281.0,972479899.0,479315,561406,168.71,173.22,1040721,1781136180.0,5254,2005,2538,760713286.0,919355324.0,451382,543039,168.53,169.3,994421,1680068611.0,4543,2023-11-07 10:30:00
422,GAZP,2997,3171,1036644198.0,1114042421.0,614914,658913,168.58,169.07,1273827,2150686619.0,6168,2179,2720,966040768.0,1049783281.0,573137,620417,168.55,169.21,1193554,2015824050.0,4899,2023-11-07 10:35:00
423,GAZP,3048,4003,886437818.0,1424068494.0,525829,841979,168.58,169.13,1367808,2310506312.0,7051,2476,3702,859562245.0,1358439664.0,510275,803094,168.45,169.15,1313369,2218001909.0,6178,2023-11-07 10:40:00
424,GAZP,2526,3248,640096477.0,1103086631.0,375437,652408,170.49,169.08,1027845,1743183108.0,5774,2155,3069,593218907.0,1089253396.0,351103,644246,168.96,169.07,995349,1682472304.0,5224,2023-11-07 10:45:00
425,GAZP,1961,1934,572330189.0,670759436.0,339562,395810,168.55,169.47,735372,1243089626.0,3895,1596,1778,567070235.0,648123331.0,336690,382870,168.43,169.28,719560,1215193567.0,3374,2023-11-07 10:50:00
426,GAZP,727,596,211363630.0,252081035.0,125286,148881,168.7,169.32,274167,463444666.0,1323,507,460,184703031.0,253346241.0,109481,136760,168.71,185.25,246241,438049272.0,967,2023-11-07 10:55:00
427,GAZP,2340,3519,583290660.0,1733669061.0,345995,1024620,168.58,169.2,1370615,2316959722.0,5859,2158,3365,583322215.0,1716251444.0,346001,1014366,168.59,169.19,1360367,2299573659.0,5523,2023-11-07 11:00:00
428,GAZP,1716,2612,636995476.0,1663576241.0,378082,983414,168.48,169.16,1361496,2300571717.0,4328,1483,2461,614362731.0,1657076058.0,364649,979451,168.48,169.18,1344100,2271438789.0,3944,2023-11-07 11:05:00
429,GAZP,1331,3634,515252680.0,3063484160.0,302523,1808654,170.32,169.38,2111177,3578736841.0,4965,1036,3435,493409906.0,3047389286.0,292601,1799358,168.63,169.36,2091959,3540799193.0,4471,2023-11-07 11:10:00
430,GAZP,1106,1149,403707443.0,665983031.0,239115,393029,168.83,169.45,632144,1069690474.0,2255,943,954,394358503.0,651888288.0,233635,384728,168.79,169.44,618363,1046246791.0,1897,2023-11-07 11:15:00
431,GAZP,1286,1132,440932547.0,461855841.0,261159,272221,168.84,169.66,533380,902788388.0,2418,1088,960,430222252.0,436857310.0,254863,257601,168.81,169.59,512464,867079563.0,2048,2023-11-07 11:20:00
432,GAZP,1216,1195,323961426.0,453688156.0,192479,268949,168.31,168.69,461428,777649582.0,2411,995,1016,313235752.0,427078162.0,186132,252194,168.29,169.35,438326,740313915.0,2011,2023-11-07 11:25:00
433,GAZP,886,1626,260204146.0,923868414.0,154402,545934,168.52,169.23,700336,1184072561.0,2512,700,1524,233585526.0,909978059.0,138662,537764,168.46,169.22,676426,1143563585.0,2224,2023-11-07 11:30:00
434,GAZP,856,1124,192857454.0,441447632.0,114362,260736,168.64,169.31,375098,634305087.0,1980,673,983,177952683.0,424997716.0,105631,250923,168.47,169.37,356554,602950399.0,1656,2023-11-07 11:35:00
435,GAZP,4139,5134,861180498.0,2594941715.0,511708,1538926,168.3,168.62,2050634,3456122213.0,9273,3694,4981,808074684.0,2492253984.0,480261,1474980,168.26,168.97,1955241,3300328668.0,8675,2023-11-07 11:40:00
436,GAZP,3653,4523,437208059.0,2631979195.0,259427,1557731,168.53,168.96,1817158,3069187254.0,8176,3431,4368,424125989.0,2614927595.0,251670,1547575,168.52,168.97,1799245,3039053585.0,7799,2023-11-07 11:45:00
437,GAZP,560,917,134689370.0,522155459.0,80056,308548,168.24,169.23,388604,656844830.0,1477,371,806,115417650.0,512515664.0,68648,303022,168.13,169.13,371670,627933315.0,1177,2023-11-07 11:50:00
438,GAZP,1060,1308,276804527.0,443253913.0,164209,262105,168.57,169.11,426314,720058441.0,2368,851,1180,270928578.0,437244420.0,160851,258371,168.43,169.23,419222,708172999.0,2031,2023-11-07 11:55:00
439,GAZP,722,768,209544831.0,262375462.0,124378,155094,168.47,169.17,279472,471920293.0,1490,560,708,198160466.0,259560702.0,117646,153274,168.44,169.34,270920,457721168.0,1268,2023-11-07 12:00:00
440,GAZP,1295,1979,311917527.0,886291338.0,185144,524142,168.47,169.09,709286,1198208865.0,3274,1130,1865,301911139.0,872891676.0,179244,516096,168.44,169.13,695340,1174802816.0,2995,2023-11-07 12:05:00
441,GAZP,974,1142,260918139.0,421974636.0,154891,249525,168.45,169.11,404416,682892775.0,2116,836,993,258062796.0,408129465.0,153233,241203,168.41,169.21,394436,666192261.0,1829,2023-11-07 12:10:00
442,GAZP,1669,2879,368681948.0,1243911607.0,219052,738049,168.31,168.54,957101,1612593556.0,4548,1254,2681,322394227.0,1171836739.0,191660,694037,168.21,168.84,885697,1494230967.0,3935,2023-11-07 12:15:00
443,GAZP,1858,4274,489845021.0,2673574470.0,291241,1582749,168.19,168.92,1873990,3163419492.0,6132,1562,4156,433383998.0,2652898483.0,257724,1570524,168.16,168.92,1828248,3086282481.0,5718,2023-11-07 12:20:00
444,GAZP,3615,4344,1179197591.0,1856455060.0,698990,1098609,168.7,168.98,1797599,3035652651.0,7959,3480,4080,1138353626.0,1836918698.0,675268,1086941,168.58,169.0,1762209,2975272325.0,7560,2023-11-07 12:25:00
445,GAZP,1626,1266,877918892.0,172443219.0,520258,101870,168.75,169.28,622128,1050362112.0,2892,1499,1113,847847705.0,155819865.0,502502,91939,168.73,169.48,594441,1003667571.0,2612,2023-11-07 12:30:00
446,GAZP,2693,1746,1310393530.0,396475944.0,776418,234070,168.77,169.38,1010488,1706869475.0,4439,2542,1546,1273844407.0,365805473.0,754891,215872,168.75,169.45,970763,1639649881.0,4088,2023-11-07 12:35:00
447,GAZP,1225,772,540319251.0,203208955.0,320288,119882,168.7,169.51,440170,743528206.0,1997,1082,709,534193970.0,202362809.0,316654,119364,168.7,169.53,436018,736556779.0,1791,2023-11-07 12:40:00
448,GAZP,1423,1102,534028299.0,285039004.0,316491,168340,168.73,169.32,484831,819067304.0,2525,1290,956,510098412.0,270889701.0,302435,159895,168.66,169.42,462330,780988114.0,2246,2023-11-07 12:45:00
449,GAZP,1155,1009,377567239.0,236903506.0,223718,139540,168.77,169.77,363258,614470745.0,2164,1021,844,371229724.0,225724028.0,220057,132885,168.7,169.86,352942,596953753.0,1865,2023-11-07 12:50:00
450,GAZP,487,593,176303320.0,155221560.0,104457,91816,168.78,169.06,196273,331524881.0,1080,364,495,167390483.0,138208264.0,99268,81536,168.62,169.51,180804,305598748.0,859,2023-11-07 12:55:00
451,GAZP,356,538,145881820.0,164583676.0,83881,97404,173.92,168.97,181285,310465497.0,894,257,421,141193046.0,157243940.0,83714,92806,168.66,169.43,176520,298436987.0,678,2023-11-07 13:00:00
452,GAZP,1075,1201,385560053.0,372133532.0,228554,219534,168.7,169.51,448088,757693585.0,2276,974,1091,380511515.0,361093676.0,225591,213019,168.67,169.51,438610,741605192.0,2065,2023-11-07 13:05:00
453,GAZP,333,370,131592014.0,133752805.0,78015,74065,168.68,180.59,152080,265344819.0,703,249,285,128434745.0,119891810.0,76161,70714,168.64,169.54,146875,248326555.0,534,2023-11-07 13:10:00
454,GAZP,563,631,267621199.0,234702567.0,158674,138772,168.66,169.13,297446,502323767.0,1194,466,528,243025310.0,225828914.0,144093,133334,168.66,169.37,277427,468854225.0,994,2023-11-07 13:15:00
455,GAZP,739,631,308629723.0,226202818.0,182857,133223,168.78,169.79,316080,534832541.0,1370,564,548,292925473.0,224705313.0,173571,132581,168.76,169.49,306152,517630787.0,1112,2023-11-07 13:20:00
456,GAZP,731,731,257242999.0,241514611.0,152490,142799,168.69,169.13,295289,498757611.0,1462,637,622,278779288.0,232629742.0,165272,137388,168.68,169.32,302660,511409030.0,1259,2023-11-07 13:25:00
457,GAZP,709,590,283777105.0,252413901.0,168265,149111,168.65,169.28,317376,536191006.0,1299,602,525,275537211.0,243952540.0,163428,144027,168.6,169.38,307455,519489752.0,1127,2023-11-07 13:30:00
458,GAZP,2188,2262,802563046.0,803793013.0,475927,471184,168.63,170.59,947111,1606356059.0,4450,2032,2154,782342307.0,793368594.0,464176,468790,168.54,169.24,932966,1575710902.0,4186,2023-11-07 13:35:00
459,GAZP,2302,2300,873722992.0,688546673.0,515506,407243,169.49,169.08,922749,1562269665.0,4602,2176,2191,857264466.0,673005292.0,508461,397624,168.6,169.26,906085,1530269758.0,4367,2023-11-07 13:40:00
460,GAZP,1331,1183,576647745.0,394767592.0,342088,233233,168.57,169.26,575321,971415337.0,2514,1226,1111,576509560.0,391926225.0,342028,231474,168.56,169.32,573502,968435785.0,2337,2023-11-07 13:45:00
461,GAZP,980,847,330295034.0,298858470.0,193440,176601,170.75,169.23,370041,629153505.0,1827,828,803,317717645.0,283973674.0,188547,167714,168.51,169.32,356261,601691319.0,1631,2023-11-07 13:50:00
462,GAZP,1794,1179,1040388609.0,452062323.0,615975,265954,168.9,169.98,881929,1492450932.0,2973,1639,1102,1026623330.0,433233505.0,608557,255779,168.7,169.38,864336,1459856836.0,2741,2023-11-07 13:55:00
463,GAZP,2013,1241,1066969073.0,383556343.0,629360,226528,169.53,169.32,855888,1450525416.0,3254,1943,1220,1066993666.0,387870009.0,632303,229045,168.75,169.34,861348,1454863676.0,3163,2023-11-07 14:00:00
464,GAZP,6674,1613,7974493048.0,770467958.0,4714337,453325,169.15,169.96,5167662,8744961007.0,8287,6294,1114,7883256409.0,708357716.0,4661539,416517,169.11,170.07,5078056,8591614126.0,7408,2023-11-07 14:05:00
465,GAZP,5817,3484,3161774052.0,860940642.0,1870398,508195,169.04,169.41,2378593,4022714694.0,9301,5475,3151,3118984063.0,823452370.0,1845814,485525,168.98,169.6,2331339,3942436433.0,8626,2023-11-07 14:10:00
466,GAZP,3004,2177,1299591578.0,698690987.0,768258,412860,169.16,169.23,1181118,1998282565.0,5181,2770,1952,1225853001.0,660433337.0,725224,389656,169.03,169.49,1114880,1886286339.0,4722,2023-11-07 14:15:00
467,GAZP,2378,1473,921471827.0,447161713.0,545471,263649,168.93,169.6,809120,1368633541.0,3851,2177,1353,945389085.0,434950262.0,560047,256391,168.81,169.64,816438,1380339347.0,3530,2023-11-07 14:20:00
468,GAZP,2417,2504,793458579.0,1107199683.0,469103,643368,169.14,172.09,1112471,1900658263.0,4921,2248,2411,783492073.0,912375726.0,463688,537852,168.97,169.63,1001540,1695867799.0,4659,2023-11-07 14:25:00
469,GAZP,2373,1546,1169677205.0,528770403.0,692147,311244,168.99,169.89,1003391,1698447609.0,3919,2260,1432,1164656283.0,496651495.0,689382,292553,168.94,169.76,981935,1661307778.0,3692,2023-11-07 14:30:00
470,GAZP,4468,3044,1589020248.0,1083462644.0,940520,638546,168.95,169.68,1579066,2672482893.0,7512,4332,2946,1581160758.0,1067858482.0,935983,629267,168.93,169.7,1565250,2649019240.0,7278,2023-11-07 14:35:00
471,GAZP,1667,1484,561737716.0,566425071.0,332814,333980,168.78,169.6,666794,1128162787.0,3151,1557,1418,544983154.0,564056156.0,322886,332405,168.79,169.69,655291,1109039310.0,2975,2023-11-07 14:40:00
472,GAZP,1204,876,672094240.0,277005517.0,398045,163413,168.85,169.51,561458,949099758.0,2080,1063,793,661763832.0,269443663.0,392054,158911,168.79,169.56,550965,931207495.0,1856,2023-11-07 14:45:00
473,GAZP,2401,1938,1057485421.0,733544954.0,626196,432907,168.87,169.45,1059103,1791030375.0,4339,2255,1825,1039870559.0,713926789.0,615886,420932,168.84,169.61,1036818,1753797349.0,4080,2023-11-07 14:50:00
474,GAZP,1473,1024,567545246.0,407930756.0,336378,240595,168.72,169.55,576973,975476002.0,2497,1356,950,559421644.0,395708727.0,331603,233480,168.7,169.48,565083,955130371.0,2306,2023-11-07 14:55:00
475,GAZP,903,532,295395088.0,195001111.0,174988,115016,168.81,169.54,290004,490396200.0,1435,771,475,288668138.0,191508373.0,171067,112904,168.75,169.62,283971,480176512.0,1246,2023-11-07 15:00:00
476,GAZP,1227,934,421420471.0,308549066.0,249606,181988,168.83,169.54,431594,729969538.0,2161,1147,844,421084211.0,299440451.0,249420,176564,168.83,169.59,425984,720524663.0,1991,2023-11-07 15:05:00
477,GAZP,1228,1067,336790086.0,622626455.0,199588,368057,168.74,169.17,567645,959416541.0,2295,1101,1011,327107836.0,604017468.0,193882,356819,168.71,169.28,550701,931125304.0,2112,2023-11-07 15:10:00
478,GAZP,944,1068,294080093.0,314066029.0,174324,185571,168.7,169.24,359895,608146123.0,2012,831,999,286417332.0,315619457.0,169820,186388,168.66,169.33,356208,602036789.0,1830,2023-11-07 15:15:00
479,GAZP,1265,987,475262679.0,429281667.0,281805,253420,168.65,169.4,535225,904544346.0,2252,1145,891,470637698.0,409029420.0,279181,241379,168.58,169.46,520560,879667118.0,2036,2023-11-07 15:20:00
480,GAZP,1076,838,452143704.0,303877009.0,267747,179970,168.87,168.85,447717,756020713.0,1914,1046,745,450267332.0,286667905.0,267071,169213,168.59,169.41,436284,736935238.0,1791,2023-11-07 15:25:00
481,GAZP,1287,982,569710572.0,394550268.0,337673,232903,168.72,169.41,570576,964260840.0,2269,1123,907,524754732.0,386444984.0,311133,227838,168.66,169.61,538971,911199716.0,2030,2023-11-07 15:30:00
482,GAZP,3329,3067,1303547941.0,851477145.0,772109,502382,168.83,169.49,1274491,2155025087.0,6396,3247,2984,1307644148.0,834443680.0,774549,492383,168.83,169.47,1266932,2142087828.0,6231,2023-11-07 15:35:00
483,GAZP,2660,2220,816109336.0,639753895.0,483709,377330,168.72,169.55,861039,1455863232.0,4880,2567,2169,814263748.0,622041336.0,482644,367290,168.71,169.36,849934,1436305084.0,4736,2023-11-07 15:40:00
484,GAZP,1027,661,391036036.0,202716499.0,231672,119639,168.79,169.44,351311,593752536.0,1688,942,604,389013750.0,203327960.0,230564,119759,168.72,169.78,350323,592341711.0,1546,2023-11-07 15:45:00
485,GAZP,1157,524,629037052.0,198785068.0,372655,117031,168.8,169.86,489686,827822121.0,1681,1060,465,631216225.0,187197259.0,374213,110322,168.68,169.68,484535,818413485.0,1525,2023-11-07 15:50:00
486,GAZP,1123,714,462969241.0,214260148.0,275780,126563,167.88,169.29,402343,677229390.0,1837,1034,673,326595635.0,212997122.0,193706,125734,168.6,169.4,319440,539592757.0,1707,2023-11-07 15:55:00
487,GAZP,1097,725,369694302.0,272738452.0,219072,161061,168.75,169.34,380133,642432754.0,1822,1012,678,498660549.0,267303779.0,296915,157717,167.95,169.48,454632,765964329.0,1690,2023-11-07 16:00:00
488,GAZP,11397,13083,3196553368.0,4414611303.0,1893487,2608652,168.82,169.23,4502139,7611164672.0,24480,11280,13026,3182725689.0,4402217401.0,1885676,2601297,168.78,169.23,4486973,7584943091.0,24306,2023-11-07 16:05:00
489,GAZP,1905,2306,598568970.0,955419312.0,354680,564124,168.76,169.36,918804,1553988283.0,4211,1813,2258,595737422.0,944795370.0,353116,557880,168.71,169.35,910996,1540532792.0,4071,2023-11-07 16:10:00
490,GAZP,2047,2368,795315661.0,809777992.0,468805,478074,169.65,169.38,946879,1605093653.0,4415,1965,2298,771195052.0,807540068.0,457126,476535,168.71,169.46,933661,1578735121.0,4263,2023-11-07 16:15:00
491,GAZP,4563,4294,1563390581.0,1367404937.0,925727,807076,168.88,169.43,1732803,2930795519.0,8857,4453,4251,1547902671.0,1366616295.0,917127,806661,168.78,169.42,1723788,2914518966.0,8704,2023-11-07 16:20:00
492,GAZP,3497,2978,1245402871.0,1094810794.0,734878,645188,169.47,169.69,1380066,2340213665.0,6475,3360,2727,1208004188.0,1073173456.0,714534,632405,169.06,169.7,1346939,2281177645.0,6087,2023-11-07 16:25:00
493,GAZP,3308,2373,1190664695.0,662936975.0,703789,384746,169.18,172.31,1088535,1853601670.0,5681,3133,2223,1176877599.0,628155664.0,695818,369685,169.14,169.92,1065503,1805033263.0,5356,2023-11-07 16:30:00
494,GAZP,5138,6711,1094630976.0,2178479600.0,647041,1283720,169.17,169.7,1930761,3273110576.0,11849,5012,6666,1094441120.0,2179656393.0,647183,1284240,169.11,169.72,1931423,3274097513.0,11678,2023-11-07 16:35:00
495,GAZP,654,633,279013861.0,259584802.0,164909,152902,169.19,169.77,317811,538598664.0,1287,538,515,268398601.0,249892231.0,158680,147049,169.14,169.94,305729,518290832.0,1053,2023-11-07 16:40:00
496,GAZP,588,525,201772599.0,194530968.0,119133,107522,169.37,180.92,226655,396303568.0,1113,439,387,193655763.0,160202267.0,114513,94316,169.11,169.86,208829,353858030.0,826,2023-11-07 16:45:00
497,GAZP,1657,1346,670097871.0,511826720.0,396517,297804,169.0,171.87,694321,1181924591.0,3003,1441,1267,660099123.0,509046916.0,390593,290338,169.0,175.33,680931,1169146039.0,2708,2023-11-07 16:50:00
498,GAZP,2227,1784,766931917.0,635800571.0,453573,373712,169.09,170.13,827285,1402732489.0,4011,2023,1694,751038591.0,627917761.0,444392,368408,169.0,170.44,812800,1378956352.0,3717,2023-11-07 16:55:00
499,GAZP,1852,1419,611518395.0,497387767.0,360938,292903,169.42,169.81,653841,1108906163.0,3271,1629,1262,597549277.0,483745616.0,353195,284696,169.18,169.92,637891,1081294893.0,2891,2023-11-07 17:00:00
500,GAZP,2108,1421,795098719.0,552480379.0,468614,324974,169.67,170.01,793588,1347579098.0,3529,1845,1301,756448501.0,533224700.0,447062,313556,169.2,170.06,760618,1289673201.0,3146,2023-11-07 17:05:00
501,GAZP,733,493,272487302.0,212644407.0,160771,114577,169.49,185.59,275348,485131709.0,1226,587,381,255330120.0,183411662.0,150789,107890,169.33,170.0,258679,438741783.0,968,2023-11-07 17:10:00
502,GAZP,1942,1300,640075982.0,474639321.0,377733,279708,169.45,169.69,657441,1114715304.0,3242,1697,1138,625036076.0,454437905.0,366903,267333,170.35,169.99,634236,1079473982.0,2835,2023-11-07 17:15:00
503,GAZP,3468,1985,1199402519.0,1041104082.0,703287,612634,170.54,169.94,1315921,2240506601.0,5453,2595,1727,1108101332.0,1002122831.0,651030,589059,170.21,170.12,1240089,2110224164.0,4322,2023-11-07 17:20:00
504,GAZP,3733,3825,973631563.0,2190715624.0,573834,1289045,169.67,169.95,1862879,3164347188.0,7558,3464,3479,942663101.0,2136725657.0,555957,1256444,169.56,170.06,1812401,3079388758.0,6943,2023-11-07 17:25:00
505,GAZP,1179,812,391107627.0,432792365.0,230750,254763,169.49,169.88,485513,823899993.0,1991,814,643,388109804.0,426673504.0,229064,249750,169.43,170.84,478814,814783308.0,1457,2023-11-07 17:30:00
506,GAZP,897,801,337107049.0,338464509.0,198782,198924,169.59,170.15,397706,675571558.0,1698,763,725,310268176.0,315374451.0,183113,185217,169.44,170.27,368330,625642627.0,1488,2023-11-07 17:35:00
507,GAZP,7348,7420,1838740739.0,3332604761.0,1086899,1968243,169.17,169.32,3055142,5171345500.0,14768,6296,6914,1673596422.0,3147630921.0,991062,1857975,168.87,169.41,2849037,4821227344.0,13210,2023-11-07 17:40:00
508,GAZP,3773,4142,1333724770.0,1804045178.0,731559,1054682,182.31,171.05,1786241,3137769949.0,7915,3270,3684,1218238132.0,1658622194.0,690878,968113,176.33,171.33,1658991,2876860326.0,6954,2023-11-07 17:45:00
509,GAZP,1660,1613,539204818.0,768191860.0,294664,454156,182.99,169.15,748820,1307396678.0,3273,1260,1325,527330231.0,688232629.0,282883,406106,186.41,169.47,688989,1215562861.0,2585,2023-11-07 17:50:00
510,GAZP,1420,1062,575063803.0,723726365.0,315155,427165,182.47,169.43,742320,1298790169.0,2482,1205,877,534294270.0,748244767.0,286859,441480,186.26,169.49,728339,1282539038.0,2082,2023-11-07 17:55:00
511,GAZP,5794,4118,2922692926.0,1538423813.0,1681345,895378,173.83,171.82,2576723,4461116740.0,9912,5406,3734,2873702594.0,1553336980.0,1648631,904064,174.31,171.82,2552695,4427039575.0,9140,2023-11-07 18:00:00
512,GAZP,1745,1514,722312789.0,1459474071.0,427116,854772,169.11,170.74,1281888,2181786861.0,3259,1575,1305,707632166.0,1404773750.0,418578,827942,169.06,169.67,1246520,2112405917.0,2880,2023-11-07 18:05:00
513,GAZP,1362,1199,567334768.0,534194622.0,320696,317094,176.91,168.47,637790,1101529391.0,2561,1212,1103,552815811.0,534660975.0,312168,304520,177.09,175.57,616688,1087476786.0,2315,2023-11-07 18:10:00
514,GAZP,5850,8953,1214603185.0,3784754987.0,707293,2239043,171.73,169.03,2946336,4999358173.0,14803,5343,8763,1131737588.0,3708985536.0,655844,2190033,172.56,169.36,2845877,4840723124.0,14106,2023-11-07 18:15:00
515,GAZP,2297,2704,568550688.0,1120942866.0,337032,662619,168.69,169.17,999651,1689493554.0,5001,1979,2582,526015011.0,1076292770.0,311923,635287,168.64,169.42,947210,1602307782.0,4561,2023-11-07 18:20:00
516,GAZP,1181,1423,235972690.0,448271402.0,139821,264868,168.77,169.24,404689,684244092.0,2604,955,1324,211205983.0,439814929.0,125266,259755,168.61,169.32,385021,651020912.0,2279,2023-11-07 18:25:00
517,GAZP,1224,2068,305328063.0,1392137472.0,180923,821933,168.76,169.37,1002856,1697465535.0,3292,1050,1931,292925746.0,1378201028.0,173793,813618,168.55,169.39,987411,1671126775.0,2981,2023-11-07 18:30:00
518,GAZP,977,3652,134751390.0,3787599873.0,79862,2226673,168.73,170.1,2306535,3922351263.0,4629,807,3512,127521729.0,3759174182.0,75678,2220134,168.51,169.32,2295812,3886695911.0,4319,2023-11-07 18:35:00
519,GAZP,1407,2949,197066367.0,2925752351.0,116051,1717355,169.81,170.36,1833406,3122818718.0,4356,1242,2859,190192334.0,2908170647.0,112674,1706813,168.8,170.39,1819487,3098362981.0,4101,2023-11-07 18:40:00
520,GAZP,6067,6487,1598853999.0,1809712428.0,947577,1069888,168.73,169.15,2017465,3408566428.0,12554,4988,5520,1456425385.0,1672366048.0,864296,990056,168.51,168.92,1854352,3128791434.0,10508,2023-11-08 10:05:00
521,GAZP,3084,3252,921263650.0,891394570.0,516104,526426,178.5,169.33,1042530,1812658220.0,6336,2590,2562,795386566.0,758885961.0,443356,448405,179.4,169.24,891761,1554272528.0,5152,2023-11-08 10:10:00
522,GAZP,2958,2840,863708764.0,656772820.0,512588,385801,168.5,170.24,898389,1520481584.0,5798,2499,2230,806087452.0,560583798.0,476982,330449,169.0,169.64,807431,1366671250.0,4729,2023-11-08 10:15:00
523,GAZP,3063,1858,1389201975.0,467881014.0,820795,274706,169.25,170.32,1095501,1857082990.0,4921,2701,1515,1335188820.0,414587296.0,791686,243778,168.65,170.07,1035464,1749776116.0,4216,2023-11-08 10:20:00
524,GAZP,2846,2109,1332623369.0,898412801.0,689573,532203,193.25,168.81,1221776,2231036171.0,4955,2377,1816,1283315267.0,831498352.0,663639,492158,193.38,168.95,1155797,2114813619.0,4193,2023-11-08 10:25:00
525,GAZP,4637,4186,1713781349.0,1281504560.0,1006175,756679,170.33,169.36,1762854,2995285909.0,8823,4227,3393,1656041439.0,1220869013.0,969557,722058,170.8,169.08,1691615,2876910452.0,7620,2023-11-08 10:30:00
526,GAZP,3149,2653,1207024299.0,905568486.0,715816,533668,168.62,169.69,1249484,2112592786.0,5802,2778,2326,1187437084.0,854432275.0,704399,504494,168.57,169.36,1208893,2041869360.0,5104,2023-11-08 10:35:00
527,GAZP,2433,2654,920487891.0,744967470.0,543575,438120,169.34,170.04,981695,1665455361.0,5087,2111,2159,880104929.0,725949460.0,522470,427238,168.45,169.92,949708,1606054390.0,4270,2023-11-08 10:40:00
528,GAZP,2074,1893,767622057.0,665069222.0,455877,392301,168.38,169.53,848178,1432691280.0,3967,1753,1610,743394868.0,637692692.0,441542,376475,168.36,169.39,818017,1381087560.0,3363,2023-11-08 10:45:00
529,GAZP,2995,4894,1229627855.0,2011708443.0,716338,1193186,171.65,168.6,1909524,3241336299.0,7889,2673,4612,1173818401.0,1959949938.0,698025,1160419,168.16,168.9,1858444,3133768339.0,7285,2023-11-08 10:50:00
530,GAZP,2326,2016,828213671.0,885515275.0,470624,524223,175.98,168.92,994847,1713728947.0,4342,1985,1847,788043017.0,848479700.0,439341,502198,179.37,168.95,941539,1636522717.0,3832,2023-11-08 10:55:00
531,GAZP,2604,2839,813958558.0,1257226760.0,473963,744368,171.73,168.9,1218331,2071185318.0,5443,2340,2708,772331995.0,1243666826.0,459231,736350,168.18,168.9,1195581,2015998821.0,5048,2023-11-08 11:00:00
532,GAZP,2979,2871,1029065564.0,1128884232.0,610424,668230,168.58,168.94,1278654,2157949797.0,5850,2741,2700,995467460.0,1105181215.0,591751,654021,168.22,168.98,1245772,2100648675.0,5441,2023-11-08 11:05:00
533,GAZP,3926,3627,1510137065.0,1319824606.0,893814,780584,168.95,169.08,1674398,2829961672.0,7553,3708,3448,1478416301.0,1285615183.0,877642,760535,168.45,169.04,1638177,2764031485.0,7156,2023-11-08 11:10:00
534,GAZP,1688,1598,748022702.0,553199219.0,443314,327395,168.73,168.97,770709,1301221922.0,3286,1460,1419,761070502.0,526757056.0,451714,311284,168.49,169.22,762998,1287827558.0,2879,2023-11-08 11:15:00
535,GAZP,3018,2284,1343452307.0,795447595.0,796907,469961,168.58,169.26,1266868,2138899902.0,5302,2765,2099,1313815570.0,751827448.0,779915,444314,168.46,169.21,1224229,2065643018.0,4864,2023-11-08 11:20:00
536,GAZP,3147,2401,1613198147.0,814445605.0,956933,481626,168.58,169.1,1438559,2427643752.0,5548,2967,2245,1583110558.0,792922961.0,939529,468774,168.5,169.15,1408303,2376033520.0,5212,2023-11-08 11:25:00
537,GAZP,1250,1236,450473282.0,388535936.0,267107,229875,168.65,169.02,496982,839009218.0,2486,1062,1095,434156342.0,372395907.0,257727,220247,168.46,169.08,477974,806552249.0,2157,2023-11-08 11:30:00
538,GAZP,1223,1015,490328619.0,384445707.0,290957,227339,168.52,169.11,518296,874774327.0,2238,1035,909,479160894.0,376499139.0,284576,222538,168.38,169.18,507114,855660034.0,1944,2023-11-08 11:35:00
539,GAZP,753,726,279491069.0,253176015.0,163143,149730,171.32,169.09,312873,532667085.0,1479,603,610,277074952.0,251078588.0,164535,148412,168.4,169.18,312947,528153540.0,1213,2023-11-08 11:40:00
540,GAZP,940,903,369314659.0,375138042.0,218755,221629,168.83,169.26,440384,744452701.0,1843,730,786,350767041.0,359309807.0,208082,212366,168.57,169.19,420448,710076849.0,1516,2023-11-08 11:45:00
541,GAZP,2367,1678,1198426923.0,610573941.0,709269,360638,168.97,169.3,1069907,1809000865.0,4045,2011,1455,1162220000.0,592507729.0,688545,349857,168.79,169.36,1038402,1754727730.0,3466,2023-11-08 11:50:00
542,GAZP,1926,1550,821221567.0,557926507.0,486338,329664,168.86,169.24,816002,1379148074.0,3476,1700,1333,803633744.0,544905821.0,476217,321667,168.75,169.4,797884,1348539566.0,3033,2023-11-08 11:55:00
543,GAZP,2659,2678,1236879684.0,1003284653.0,729224,591968,169.62,169.48,1321192,2240164337.0,5337,2461,2365,1217180887.0,971911486.0,720952,573507,168.83,169.47,1294459,2189092373.0,4826,2023-11-08 12:00:00
544,GAZP,2716,2165,1288490777.0,767566587.0,762851,452615,168.9,169.58,1215466,2056057364.0,4881,2521,1936,1259883007.0,723847401.0,746504,426914,168.77,169.55,1173418,1983730408.0,4457,2023-11-08 12:05:00
545,GAZP,2398,1697,847294632.0,644532490.0,502426,380747,168.64,169.28,883173,1491827122.0,4095,2189,1501,828917555.0,613623485.0,491755,362349,168.56,169.35,854104,1442541040.0,3690,2023-11-08 12:10:00
546,GAZP,1882,1446,788032974.0,504156057.0,467051,297899,168.73,169.24,764950,1292189031.0,3328,1685,1310,763628826.0,496358940.0,452676,293084,168.69,169.36,745760,1259987766.0,2995,2023-11-08 12:15:00
547,GAZP,977,969,433518111.0,403399578.0,256925,221818,168.73,181.86,478743,836917689.0,1946,784,800,406636882.0,360555190.0,241053,212879,168.69,169.37,453932,767192072.0,1584,2023-11-08 12:20:00
548,GAZP,2618,4862,810521708.0,2524761115.0,480943,1492800,168.53,169.13,1973743,3335282824.0,7480,2381,4763,791056103.0,2482069861.0,469483,1467342,168.5,169.15,1936825,3273125965.0,7144,2023-11-08 12:25:00
549,GAZP,1153,2153,326792306.0,1187462438.0,193797,693956,168.63,171.11,887753,1514254744.0,3306,981,2016,324968710.0,1109776884.0,192807,656241,168.55,169.11,849048,1434745595.0,2997,2023-11-08 12:30:00
550,GAZP,1028,1222,436646889.0,543801628.0,259039,321509,168.56,169.14,580548,980448517.0,2250,761,1076,422264102.0,510369546.0,250636,301632,168.48,169.2,552268,932633649.0,1837,2023-11-08 12:35:00
551,GAZP,1344,1524,527087892.0,586818288.0,312922,339056,168.44,173.07,651978,1113906180.0,2868,1107,1338,512370566.0,546715762.0,304237,323282,168.41,169.11,627519,1059086329.0,2445,2023-11-08 12:40:00
552,GAZP,873,823,364908281.0,330800205.0,214246,195729,170.32,169.01,409975,695708487.0,1696,640,693,333000469.0,329997870.0,195495,195092,170.34,169.15,390587,662998339.0,1333,2023-11-08 12:45:00
553,GAZP,883,896,344985331.0,360267528.0,204711,212955,168.52,169.18,417666,705252859.0,1779,731,765,336762932.0,351841439.0,199824,207879,168.53,169.25,407703,688604371.0,1496,2023-11-08 12:50:00
554,GAZP,1204,1265,476479839.0,489364277.0,282421,289317,168.71,169.14,571738,965844117.0,2469,1030,1121,469288525.0,482893555.0,278479,285424,168.52,169.18,563903,952182080.0,2151,2023-11-08 12:55:00
555,GAZP,1299,1089,499331215.0,427705995.0,296192,252902,168.58,169.12,549094,927037210.0,2388,1173,901,483010655.0,412529806.0,286769,243827,168.43,169.19,530596,895540462.0,2074,2023-11-08 13:00:00
556,GAZP,3305,3353,1410549322.0,1310187732.0,834824,775543,168.96,168.94,1610367,2720737055.0,6658,3094,3082,1363485481.0,1268778136.0,807050,749931,168.95,169.19,1556981,2632263618.0,6176,2023-11-08 13:05:00
557,GAZP,1762,1755,741535562.0,752908328.0,440050,437096,168.51,172.25,877146,1494443891.0,3517,1613,1608,716720617.0,720631647.0,425454,417848,168.46,172.46,843302,1437352264.0,3221,2023-11-08 13:10:00
558,GAZP,1965,2358,695247808.0,853456447.0,412832,505026,168.41,168.99,917858,1548704256.0,4323,1812,2170,668005021.0,818793194.0,396624,484318,168.42,169.06,880942,1486798215.0,3982,2023-11-08 13:15:00
559,GAZP,1473,1444,510744832.0,640727111.0,303226,379097,168.44,169.01,682323,1151471943.0,2917,1257,1260,495741914.0,614108198.0,294383,363279,168.4,169.05,657662,1109850112.0,2517,2023-11-08 13:20:00
560,GAZP,1759,1757,677595879.0,708588479.0,402134,419194,168.5,169.04,821328,1386184358.0,3516,1588,1588,689850544.0,697765792.0,409730,412597,168.37,169.12,822327,1387616336.0,3176,2023-11-08 13:25:00
561,GAZP,861,963,335189873.0,407529122.0,199045,241139,168.4,169.0,440184,742718995.0,1824,737,844,326137590.0,409616232.0,193697,242193,168.38,169.13,435890,735753823.0,1581,2023-11-08 13:30:00
562,GAZP,742,1062,335673296.0,486772892.0,199214,288478,168.5,168.74,487692,822446189.0,1804,548,901,328274100.0,461054122.0,194983,272837,168.36,168.99,467820,789328223.0,1449,2023-11-08 13:35:00
563,GAZP,706,1137,331901035.0,499951572.0,197288,290303,168.23,172.22,487591,831852607.0,1843,579,1008,310080445.0,489440438.0,184250,281463,168.29,173.89,465713,799520884.0,1587,2023-11-08 13:40:00
564,GAZP,592,941,252128423.0,540151263.0,149673,320401,168.45,168.59,470074,792279686.0,1533,421,805,243357238.0,525682001.0,144522,311262,168.39,168.89,455784,769039240.0,1226,2023-11-08 13:45:00
565,GAZP,1088,2199,485102386.0,953346106.0,288232,558812,168.3,170.6,847044,1438448493.0,3287,937,2092,478244315.0,931842673.0,284243,545672,168.25,170.77,829915,1410086988.0,3029,2023-11-08 13:50:00
566,GAZP,1282,2514,524216231.0,1697760882.0,311395,1006549,168.34,168.67,1317944,2221977113.0,3796,1044,2387,508046655.0,1665126527.0,302049,986390,168.2,168.81,1288439,2173173182.0,3431,2023-11-08 13:55:00
567,GAZP,668,731,283370422.0,376540734.0,168270,223075,168.4,168.8,391345,659911156.0,1399,584,688,280673724.0,378444935.0,166728,224036,168.34,168.92,390764,659118660.0,1272,2023-11-08 14:00:00
568,GAZP,362,477,198054902.0,376758248.0,117633,223050,168.37,168.91,340683,574813150.0,839,232,405,167866826.0,367985468.0,99732,217763,168.32,168.98,317495,535852294.0,637,2023-11-08 14:05:00
569,GAZP,1923,2569,672313686.0,1151662920.0,398819,681799,168.58,168.92,1080618,1823976606.0,4492,1697,2438,643359040.0,1130340564.0,382053,669026,168.4,168.95,1051079,1773699604.0,4135,2023-11-08 14:10:00
570,GAZP,2315,2420,922621719.0,1031272372.0,546994,609932,168.67,169.08,1156926,1953894092.0,4735,2185,2267,912799784.0,993959977.0,541811,587550,168.47,169.17,1129361,1906759762.0,4452,2023-11-08 14:15:00
571,GAZP,1031,1081,505314383.0,477485068.0,299638,282180,168.64,169.21,581818,982799452.0,2112,900,967,498286675.0,474909040.0,295721,280616,168.5,169.24,576337,973195716.0,1867,2023-11-08 14:20:00
572,GAZP,1717,1651,754476565.0,675993537.0,444720,399428,169.65,169.24,844148,1430470102.0,3368,1614,1554,736843983.0,669176745.0,437114,395382,168.57,169.25,832496,1406020728.0,3168,2023-11-08 14:25:00
573,GAZP,1156,1400,392560190.0,544467880.0,232819,321872,168.61,169.16,554691,937028070.0,2556,1047,1243,390088133.0,526675850.0,231528,311300,168.48,169.19,542828,916763983.0,2290,2023-11-08 14:30:00
574,GAZP,1070,990,352419770.0,393128460.0,208917,232202,168.69,169.3,441119,745548231.0,2060,967,890,344008644.0,380766106.0,204071,225025,168.57,169.21,429096,724774750.0,1857,2023-11-08 14:35:00
575,GAZP,1232,1151,431365577.0,403932074.0,255805,239147,168.63,168.91,494952,835297651.0,2383,1124,1013,421261742.0,391916552.0,249840,231605,168.61,169.22,481445,813178294.0,2137,2023-11-08 14:40:00
576,GAZP,1400,1070,505557257.0,399443147.0,299553,236086,168.77,169.19,535639,905000404.0,2470,1235,975,489774244.0,404340046.0,290465,238831,168.62,169.3,529296,894114290.0,2210,2023-11-08 14:45:00
577,GAZP,1530,1766,481884720.0,723633998.0,285404,427675,168.84,169.2,713079,1205518718.0,3296,1392,1618,447128125.0,701079508.0,265105,414295,168.66,169.22,679400,1148207633.0,3010,2023-11-08 14:50:00
578,GAZP,2327,3104,510382004.0,1304560337.0,302479,771156,168.73,169.17,1073635,1814942341.0,5431,2212,2952,506245530.0,1294308464.0,300153,765012,168.66,169.19,1065165,1800553995.0,5164,2023-11-08 14:55:00
579,GAZP,2295,2712,731952726.0,1067261111.0,431808,630705,169.51,169.22,1062513,1799213837.0,5007,2160,2587,709971882.0,1061876302.0,421136,627409,168.58,169.25,1048545,1771848184.0,4747,2023-11-08 15:00:00
580,GAZP,1433,1207,684635249.0,426599335.0,405709,251958,168.75,169.31,657667,1111234584.0,2640,1277,1107,672704249.0,405456484.0,398750,239367,168.7,169.39,638117,1078160733.0,2384,2023-11-08 15:05:00
581,GAZP,1609,1200,815361017.0,396239979.0,483394,234120,168.67,169.25,717514,1211600996.0,2809,1497,1114,814143000.0,385660929.0,482715,227862,168.66,169.25,710577,1199803930.0,2611,2023-11-08 15:10:00
582,GAZP,1362,1377,422671931.0,528858220.0,250645,313211,168.63,168.85,563856,951530151.0,2739,1131,1277,395480325.0,513187211.0,234811,303545,168.42,169.06,538356,908667537.0,2408,2023-11-08 15:15:00
583,GAZP,759,822,246250554.0,273845697.0,143524,161945,171.57,169.1,305469,520096251.0,1581,655,788,236585927.0,272608364.0,140482,161068,168.41,169.25,301550,509194291.0,1443,2023-11-08 15:20:00
584,GAZP,529,768,188002089.0,302178676.0,111607,178740,168.45,169.06,290347,490180766.0,1297,437,705,207632313.0,297712859.0,108616,175985,191.16,169.17,284601,505345172.0,1142,2023-11-08 15:25:00
585,GAZP,919,1147,342692808.0,472182464.0,198468,279227,172.67,169.1,477695,814875273.0,2066,706,1084,317600341.0,465389263.0,188547,275133,168.45,169.15,463680,782989604.0,1790,2023-11-08 15:30:00
586,GAZP,1137,1216,248660351.0,434615995.0,144952,256998,171.55,169.11,401950,683276347.0,2353,1135,1179,244024717.0,432973061.0,144847,255980,168.47,169.14,400827,676997778.0,2314,2023-11-08 15:35:00
587,GAZP,700,837,218449466.0,306159133.0,128970,180767,169.38,169.37,309737,524608599.0,1537,602,718,201831040.0,293820282.0,119743,173557,168.55,169.29,293300,495651323.0,1320,2023-11-08 15:40:00
588,GAZP,1018,1502,285139112.0,461257682.0,169244,272667,168.48,169.17,441911,746396795.0,2520,924,1436,282627136.0,456359466.0,167788,269648,168.44,169.24,437436,738986602.0,2360,2023-11-08 15:45:00
589,GAZP,1631,2392,342698283.0,778434277.0,203333,460285,168.54,169.12,663618,1121132561.0,4023,1543,2329,335661424.0,769783104.0,199163,455081,168.54,169.15,654244,1105444529.0,3872,2023-11-08 15:50:00
590,GAZP,767,783,224811814.0,205826206.0,118460,121556,189.78,169.33,240016,430638020.0,1550,633,704,200814034.0,198301247.0,114278,117079,175.72,169.37,231357,399115281.0,1337,2023-11-08 15:55:00
591,GAZP,832,1075,265957158.0,355361391.0,157704,209997,168.64,169.22,367701,621318550.0,1907,757,999,262277919.0,343492683.0,155652,202956,168.5,169.24,358608,605770602.0,1756,2023-11-08 16:00:00
592,GAZP,858,1273,292898124.0,390738501.0,173636,231076,168.69,169.1,404712,683636626.0,2131,732,1200,291599028.0,383977403.0,173072,226913,168.48,169.22,399985,675576431.0,1932,2023-11-08 16:05:00
593,GAZP,844,1064,310485830.0,401558586.0,184137,237252,168.62,169.25,421389,712044416.0,1908,738,1005,304058164.0,398038417.0,180380,234840,168.57,169.49,415220,702096582.0,1743,2023-11-08 16:10:00
594,GAZP,993,876,398317872.0,380772291.0,236015,223902,168.77,170.06,459917,779090163.0,1869,826,753,346929693.0,366560432.0,205602,216492,168.74,169.32,422094,713490125.0,1579,2023-11-08 16:15:00
595,GAZP,2822,3715,827095236.0,2101975087.0,485291,1233670,170.43,170.38,1718961,2929070324.0,6537,2672,3500,793739138.0,1908191646.0,470448,1127142,168.72,169.29,1597590,2701930785.0,6172,2023-11-08 16:20:00
596,GAZP,715,646,248792705.0,241813978.0,147290,142934,168.91,169.18,290224,490606684.0,1361,573,546,272518759.0,230044390.0,161921,135832,168.3,169.36,297753,502563150.0,1119,2023-11-08 16:25:00
597,GAZP,1430,1360,465926554.0,536978712.0,276002,317266,168.81,169.25,593268,1002905266.0,2790,1329,1254,456859300.0,516250566.0,270802,304968,168.71,169.28,575770,973109867.0,2583,2023-11-08 16:30:00
598,GAZP,3772,3578,936515076.0,913315558.0,555295,540447,168.65,168.99,1095742,1849830634.0,7350,3578,3409,902233895.0,890738157.0,535026,526344,168.63,169.23,1061370,1792972053.0,6987,2023-11-08 16:35:00
599,GAZP,2033,2308,652649953.0,890152260.0,387124,526495,168.59,169.07,913619,1542802214.0,4341,1868,2117,641149904.0,864716629.0,380419,511260,168.54,169.13,891679,1505866533.0,3985,2023-11-08 16:40:00
600,GAZP,701,887,249658187.0,317560601.0,148124,185139,168.55,171.53,333263,567218789.0,1588,572,733,240814289.0,310660634.0,142899,183693,168.52,169.12,326592,551474923.0,1305,2023-11-08 16:45:00
601,GAZP,7772,6887,2929378199.0,2727565082.0,1732976,1609246,169.04,169.49,3342222,5656943282.0,14659,7120,6428,2740311426.0,2579098242.0,1623112,1523763,168.83,169.26,3146875,5319409669.0,13548,2023-11-08 16:50:00
602,GAZP,1601,2562,563954029.0,1140398477.0,334811,608955,168.44,187.27,943766,1704352506.0,4163,1350,2329,523088754.0,1116249822.0,310539,594424,168.45,187.79,904963,1639338576.0,3679,2023-11-08 16:55:00
603,GAZP,1076,1579,542097581.0,674247320.0,322429,397019,168.13,169.83,719448,1216344901.0,2655,762,1424,505549365.0,650225404.0,300854,384123,168.04,169.28,684977,1155774769.0,2186,2023-11-08 17:00:00
604,GAZP,1986,2106,568952153.0,779415373.0,337916,461868,168.37,168.75,799784,1348367527.0,4092,1731,1922,545282447.0,738430972.0,324034,437070,168.28,168.95,761104,1283713419.0,3653,2023-11-08 17:05:00
605,GAZP,1168,2574,471082344.0,2421875639.0,279609,1430761,168.48,169.27,1710370,2892957984.0,3742,1008,2417,455678717.0,2390244798.0,270492,1414810,168.46,168.94,1685302,2845923515.0,3425,2023-11-08 17:10:00
606,GAZP,1791,3338,397881707.0,2763922795.0,234560,1634864,169.63,169.06,1869424,3161804502.0,5129,1620,3183,386779149.0,2719160143.0,229585,1609945,168.47,168.9,1839530,3105939292.0,4803,2023-11-08 17:15:00
607,GAZP,1174,1360,356134151.0,587179071.0,211452,347018,168.42,169.21,558470,943313223.0,2534,1026,1226,352145063.0,564464683.0,209204,332379,168.33,169.83,541583,916609746.0,2252,2023-11-08 17:20:00
608,GAZP,905,819,325712189.0,461941021.0,193460,253752,168.36,182.04,447212,787653210.0,1724,766,697,345052626.0,435857258.0,205269,257513,168.1,169.26,462782,780909885.0,1463,2023-11-08 17:25:00
609,GAZP,756,1213,239964825.0,513262188.0,142620,303970,168.25,168.85,446590,753227013.0,1969,609,1133,204516869.0,505875795.0,121552,299529,168.25,168.89,421081,710392665.0,1742,2023-11-08 17:30:00
610,GAZP,654,379,123812528.0,80586571.0,73483,47580,168.49,169.37,121063,204399099.0,1033,436,296,100987116.0,86095730.0,60010,50761,168.28,169.61,110771,187082847.0,732,2023-11-08 17:35:00
611,GAZP,674,478,470527263.0,142783143.0,280180,84640,167.94,168.69,364820,613310406.0,1152,518,395,490923883.0,134726676.0,292756,79594,167.69,169.27,372350,625650559.0,913,2023-11-08 17:40:00
612,GAZP,669,587,172940888.0,232662421.0,102693,137272,168.41,169.49,239965,405603309.0,1256,464,499,158438113.0,223158888.0,94195,131236,168.2,170.04,225431,381597001.0,963,2023-11-08 17:45:00
613,GAZP,1305,1554,357133345.0,432260496.0,211058,255299,169.21,169.32,466357,789393842.0,2859,1169,1456,324918500.0,414094924.0,192994,244948,168.36,169.05,437942,739013425.0,2625,2023-11-08 17:50:00
614,GAZP,878,789,236163482.0,340539313.0,140120,201529,168.54,168.98,341649,576702796.0,1667,743,710,222372665.0,339993114.0,132109,201133,168.33,169.04,333242,562365779.0,1453,2023-11-08 17:55:00
615,GAZP,698,1184,232005756.0,585007129.0,137450,346405,168.79,168.88,483855,817012886.0,1882,596,1143,244582752.0,591968501.0,130395,350461,187.57,168.91,480856,836551253.0,1739,2023-11-08 18:00:00
616,GAZP,1770,2484,496970583.0,914923981.0,294658,541148,168.66,169.07,835806,1411894564.0,4254,1632,2351,478900442.0,896104396.0,283936,529997,168.66,169.08,813933,1375004839.0,3983,2023-11-08 18:05:00
617,GAZP,3111,3200,786101601.0,1194163328.0,466217,706518,168.61,169.02,1172735,1980264930.0,6311,2988,3043,785897209.0,1178981135.0,466248,697252,168.56,169.09,1163500,1964878345.0,6031,2023-11-08 18:10:00
618,GAZP,3712,3052,1192225172.0,815583310.0,706461,481818,168.76,169.27,1188279,2007808482.0,6764,3591,2921,1176165346.0,796547440.0,697416,470619,168.65,169.26,1168035,1972712787.0,6512,2023-11-08 18:15:00
619,GAZP,1190,581,790530948.0,131747347.0,468527,77775,168.73,169.4,546302,922278295.0,1771,1050,457,775526525.0,121085449.0,459762,71407,168.68,169.57,531169,896611975.0,1507,2023-11-08 18:20:00
620,GAZP,1592,1021,434046687.0,251279838.0,257294,148486,168.7,169.23,405780,685326525.0,2613,1423,895,424113294.0,216259323.0,251446,127650,168.67,169.42,379096,640372617.0,2318,2023-11-08 18:25:00
621,GAZP,997,485,495526474.0,85422021.0,293585,50497,168.78,169.16,344082,580948496.0,1482,864,357,485852694.0,74331986.0,287952,43873,168.73,169.43,331825,560184680.0,1221,2023-11-08 18:30:00
622,GAZP,777,574,155918037.0,129456491.0,92158,76530,169.19,169.16,168688,285374529.0,1351,564,427,137930119.0,94153506.0,81786,55554,168.65,169.48,137340,232083626.0,991,2023-11-08 18:35:00
623,GAZP,806,767,209586804.0,165506374.0,124181,97942,168.78,168.98,222123,375093179.0,1573,729,609,192214251.0,136674711.0,114022,80638,168.58,169.49,194660,328888963.0,1338,2023-11-08 18:40:00
624,GAZP,2227,2172,487606277.0,498551339.0,288991,294890,168.73,169.06,583881,986157616.0,4399,1519,1652,349641532.0,404012939.0,208056,239344,168.05,168.8,447400,753654471.0,3171,2023-11-09 10:05:00
625,GAZP,2665,2860,775159554.0,1375001714.0,461849,815946,167.84,168.52,1277795,2150161269.0,5525,1715,2398,668861577.0,1260568535.0,398842,748214,167.7,168.48,1147056,1929430113.0,4113,2023-11-09 10:10:00
626,GAZP,2325,3403,987247098.0,1960628982.0,588661,1165746,167.71,168.19,1754407,2947876080.0,5728,1550,2980,898448655.0,1877385752.0,536121,1115005,167.58,168.37,1651126,2775834407.0,4530,2023-11-09 10:15:00
627,GAZP,3468,2784,741147424.0,1203286503.0,441136,714722,168.01,168.36,1155858,1944433927.0,6252,2888,2478,700010553.0,1162213251.0,416906,690259,167.91,168.37,1107165,1862223804.0,5366,2023-11-09 10:20:00
628,GAZP,1677,2348,719682102.0,1043694656.0,429008,620796,167.75,168.12,1049804,1763376758.0,4025,1088,2044,680977953.0,1002531621.0,406073,595599,167.7,168.32,1001672,1683509575.0,3132,2023-11-09 10:25:00
629,GAZP,1435,2295,527016382.0,1532667752.0,314218,910572,167.72,168.32,1224790,2059684135.0,3730,991,2037,483599160.0,1489709704.0,288284,885222,167.75,168.29,1173506,1973308864.0,3028,2023-11-09 10:30:00
630,GAZP,1048,1199,411685603.0,597633956.0,245322,354676,167.81,168.5,599998,1009319559.0,2247,642,899,376014391.0,574480457.0,224214,340936,167.7,168.5,565150,950494849.0,1541,2023-11-09 10:35:00
631,GAZP,957,984,380464310.0,486820151.0,224034,288980,169.82,168.46,513014,867284462.0,1941,498,680,329173905.0,447483456.0,196207,265898,167.77,168.29,462105,776657362.0,1178,2023-11-09 10:40:00
632,GAZP,813,1322,300138422.0,614993191.0,178779,365384,167.88,168.31,544163,915131613.0,2135,489,1168,284837103.0,596857258.0,169808,354555,167.74,168.34,524363,881694361.0,1657,2023-11-09 10:45:00
633,GAZP,611,593,239845084.0,292280602.0,140092,173709,171.21,168.26,313801,532125687.0,1204,341,458,217715159.0,285547147.0,129773,169560,167.77,168.4,299333,503262306.0,799,2023-11-09 10:50:00
634,GAZP,943,1727,490108523.0,781604614.0,292010,464038,167.84,168.44,756048,1271713137.0,2670,711,1536,471942261.0,770038046.0,281348,457153,167.74,168.44,738501,1241980308.0,2247,2023-11-09 10:55:00
635,GAZP,2536,4185,982729634.0,2188876329.0,585478,1299645,167.85,168.42,1885123,3171605964.0,6721,2258,3986,958160817.0,2167116601.0,571067,1287160,167.78,168.36,1858227,3125277418.0,6244,2023-11-09 11:00:00
636,GAZP,1390,2244,482426649.0,840123333.0,284703,499082,169.45,168.33,783785,1322549982.0,3634,1205,1937,461856711.0,788977397.0,275224,468580,167.81,168.38,743804,1250834108.0,3142,2023-11-09 11:05:00
637,GAZP,1320,1419,508402022.0,574170960.0,303013,341235,167.78,168.26,644248,1082572982.0,2739,1072,1270,486765137.0,558559150.0,290213,331692,167.73,168.4,621905,1045324287.0,2342,2023-11-09 11:10:00
638,GAZP,1134,904,366547582.0,349568283.0,215924,207459,169.76,168.5,423383,716115865.0,2038,927,743,356810026.0,337774768.0,212799,200506,167.67,168.46,413305,694584794.0,1670,2023-11-09 11:15:00
639,GAZP,1135,1073,456745410.0,486878130.0,272422,289389,167.66,168.24,561811,943623541.0,2208,878,947,439635136.0,443700457.0,262340,263442,167.58,168.42,525782,883335594.0,1825,2023-11-09 11:20:00
640,GAZP,3016,3909,1101172982.0,1483492315.0,656873,854509,167.64,173.61,1511382,2584665298.0,6925,2531,3323,1055222367.0,1385006578.0,629701,824002,167.58,168.08,1453703,2440228946.0,5854,2023-11-09 11:25:00
641,GAZP,5556,6581,2591011098.0,2204912572.0,1543342,1314756,167.88,167.71,2858098,4795923670.0,12137,4784,5706,2465002294.0,2104810255.0,1471610,1252950,167.5,167.99,2724560,4569812549.0,10490,2023-11-09 11:30:00
642,GAZP,2818,3080,1002532734.0,1111233172.0,593295,640920,168.98,173.38,1234215,2113765906.0,5898,2428,2807,937384440.0,1072213645.0,559551,616207,167.52,174.0,1175758,2009598086.0,5235,2023-11-09 11:35:00
643,GAZP,1281,778,442237770.0,329472667.0,263880,196269,167.59,167.87,460149,771710438.0,2059,881,659,445587090.0,317959629.0,265923,189075,167.56,168.17,454998,763546720.0,1540,2023-11-09 11:40:00
644,GAZP,971,811,313206844.0,304825545.0,184195,181642,170.04,167.82,365837,618032389.0,1782,703,687,275504466.0,289968475.0,164449,172493,167.53,168.1,336942,565472942.0,1390,2023-11-09 11:45:00
645,GAZP,4664,7006,1069535984.0,2941207237.0,638293,1750233,167.56,168.05,2388526,4010743222.0,11670,4415,6860,1062660413.0,2962761756.0,634402,1741971,167.51,170.08,2376373,4025422169.0,11275,2023-11-09 11:50:00
646,GAZP,1508,1820,606226521.0,866113066.0,361557,514626,167.67,168.3,876183,1472339587.0,3328,1351,1675,587669339.0,852044570.0,350518,506348,167.66,168.27,856866,1439713910.0,3026,2023-11-09 11:55:00
647,GAZP,1812,2080,584187885.0,1169818831.0,345854,695894,168.91,168.1,1041748,1754006717.0,3892,1576,1974,562027603.0,1148429819.0,335350,683001,167.59,168.14,1018351,1710457423.0,3550,2023-11-09 12:00:00
648,GAZP,1441,1405,422267767.0,542379343.0,251844,322451,167.67,168.21,574295,964647110.0,2846,1120,1300,401649005.0,532244967.0,239748,316406,167.53,168.22,556154,933893972.0,2420,2023-11-09 12:05:00
649,GAZP,2817,2760,1073091187.0,1097710335.0,637654,652800,168.29,168.15,1290454,2170801523.0,5577,2423,2552,948138032.0,1031358497.0,565573,613321,167.64,168.16,1178894,1979496529.0,4975,2023-11-09 12:10:00
650,GAZP,3465,2800,1712115347.0,876550256.0,1017234,519831,168.31,168.62,1537065,2588665604.0,6265,3239,2414,1690885923.0,787206397.0,1005966,466595,168.09,168.71,1472561,2478092321.0,5653,2023-11-09 12:15:00
651,GAZP,5769,7044,1513150105.0,2789020130.0,901131,1655657,167.92,168.45,2556788,4302170236.0,12813,5547,6843,1485582143.0,2770316420.0,884847,1644313,167.89,168.48,2529160,4255898564.0,12390,2023-11-09 12:20:00
652,GAZP,9933,18252,1873540371.0,7751139579.0,1116534,4607666,167.8,168.22,5724200,9624679951.0,28185,9560,18064,1831969753.0,7691582472.0,1091949,4570979,167.77,168.27,5662928,9523552226.0,27624,2023-11-09 12:25:00
653,GAZP,3003,3913,695729886.0,1761831268.0,414586,1045573,167.81,168.5,1460159,2457561154.0,6916,2780,3716,662976710.0,1712871800.0,395253,1017349,167.73,168.37,1412602,2375848511.0,6496,2023-11-09 12:30:00
654,GAZP,2446,3739,574778533.0,1850705350.0,342681,978845,167.73,189.07,1321526,2425483883.0,6185,2265,3542,551993584.0,1634676138.0,329248,971420,167.65,168.28,1300668,2186669722.0,5807,2023-11-09 12:35:00
655,GAZP,983,1073,257986337.0,509162272.0,153214,302952,168.38,168.07,456166,767148609.0,2056,736,965,191464437.0,494523971.0,114240,294007,167.6,168.2,408247,685988408.0,1701,2023-11-09 12:40:00
656,GAZP,961,892,248998430.0,427173278.0,148463,254026,167.72,168.16,402489,676171709.0,1853,745,797,240573568.0,417647659.0,143654,248198,167.47,168.27,391852,658221227.0,1542,2023-11-09 12:45:00
657,GAZP,852,844,167342902.0,232843532.0,99706,138344,167.84,168.31,238050,400186434.0,1696,687,742,165906051.0,223059556.0,99032,132452,167.53,168.41,231484,388965608.0,1429,2023-11-09 12:50:00
658,GAZP,1089,1152,305187881.0,623553571.0,181560,285485,168.09,218.42,467045,928741453.0,2241,835,1083,274326409.0,677328022.0,163687,280566,167.59,241.41,444253,951654432.0,1918,2023-11-09 12:55:00
659,GAZP,1307,2092,330419943.0,644080760.0,196902,382062,167.81,168.58,578964,974500703.0,3399,1150,1973,317960552.0,638050764.0,189824,378178,167.5,168.72,568002,956011316.0,3123,2023-11-09 13:00:00
660,GAZP,1446,1581,445159742.0,659888532.0,265448,392629,167.7,168.07,658077,1105048275.0,3027,1263,1447,437994474.0,637524881.0,261360,379164,167.58,168.14,640524,1075519356.0,2710,2023-11-09 13:05:00
661,GAZP,1667,2315,481666366.0,1308706986.0,284754,779438,169.15,167.9,1064192,1790373353.0,3982,1461,2197,453317320.0,1300265412.0,270661,774066,167.49,167.98,1044727,1753582732.0,3658,2023-11-09 13:10:00
662,GAZP,2491,1894,702616963.0,706361978.0,418993,420059,167.69,168.16,839052,1408978941.0,4385,2321,1806,699015511.0,693666534.0,417168,412368,167.56,168.22,829536,1392682046.0,4127,2023-11-09 13:15:00
663,GAZP,948,708,331799713.0,244667377.0,198113,145328,167.48,168.36,343441,576467090.0,1656,791,638,323489267.0,241114696.0,193039,143162,167.58,168.42,336201,564603964.0,1429,2023-11-09 13:20:00
664,GAZP,813,682,285578706.0,242441405.0,170350,144017,167.64,168.34,314367,528020112.0,1495,672,597,281641138.0,233468684.0,168072,138693,167.57,168.33,306765,515109822.0,1269,2023-11-09 13:25:00
665,GAZP,757,416,217214808.0,153078125.0,129516,90897,167.71,168.41,220413,370292933.0,1173,578,348,211239623.0,147365045.0,126006,87500,167.64,168.42,213506,358604668.0,926,2023-11-09 13:30:00
666,GAZP,656,407,218287416.0,155375915.0,130173,92316,167.69,168.31,222489,373663332.0,1063,516,332,229035916.0,147535397.0,136680,87590,167.57,168.44,224270,376571314.0,848,2023-11-09 13:35:00
667,GAZP,764,550,250712976.0,188932849.0,149473,112476,167.73,167.98,261949,439645825.0,1314,606,448,242426976.0,180851507.0,144600,107437,167.65,168.33,252037,423278483.0,1054,2023-11-09 13:40:00
668,GAZP,717,461,242283286.0,183987635.0,144544,109548,167.62,167.95,254092,426270922.0,1178,557,382,237425758.0,180636760.0,141694,107329,167.56,168.3,249023,418062518.0,939,2023-11-09 13:45:00
669,GAZP,1106,1057,362110774.0,450745651.0,216177,268272,167.51,168.02,484449,812856425.0,2163,912,943,352190269.0,432987418.0,210219,257466,167.53,168.17,467685,785177687.0,1855,2023-11-09 13:50:00
670,GAZP,1419,1672,504180778.0,870724911.0,301250,518418,167.36,167.96,819668,1374905690.0,3091,1196,1542,480921646.0,844988165.0,287178,502770,167.46,168.07,789948,1325909811.0,2738,2023-11-09 13:55:00
671,GAZP,2744,3685,696445264.0,1555488989.0,415477,927055,167.63,167.79,1342532,2251934254.0,6429,2378,3611,669497287.0,1520568963.0,400004,905494,167.37,167.93,1305498,2190066250.0,5989,2023-11-09 14:00:00
672,GAZP,647,831,250224993.0,802506951.0,149546,478416,167.32,167.74,627962,1052731944.0,1478,294,706,228603987.0,781675375.0,136655,465466,167.29,167.93,602121,1010279362.0,1000,2023-11-09 14:05:00
673,GAZP,653,672,231513329.0,258345031.0,138316,153933,167.38,167.83,292249,489858360.0,1325,376,533,201075733.0,237482453.0,120431,141458,166.96,167.88,261889,438558186.0,909,2023-11-09 14:10:00
674,GAZP,814,834,276984261.0,483007008.0,165269,217458,167.6,222.12,382727,759991270.0,1648,539,726,266635495.0,494315154.0,159315,210087,167.36,235.29,369402,760950650.0,1265,2023-11-09 14:15:00
675,GAZP,768,580,244609271.0,256423183.0,146224,152683,167.28,167.94,298907,501032455.0,1348,470,450,213643459.0,238025932.0,127702,141753,167.3,167.92,269455,451669391.0,920,2023-11-09 14:20:00
676,GAZP,693,498,207660148.0,222142798.0,114216,132171,181.81,168.07,246387,429802946.0,1191,400,403,185262719.0,209648848.0,101178,124419,183.11,168.5,225597,394911568.0,803,2023-11-09 14:25:00
677,GAZP,586,527,233013197.0,176593169.0,93731,105188,248.6,167.88,198919,409606366.0,1113,320,457,169070970.0,164062037.0,73542,97684,229.9,167.95,171226,333133007.0,777,2023-11-09 14:30:00
678,GAZP,700,471,212662022.0,207523899.0,126861,122966,167.63,168.77,249827,420185921.0,1171,430,395,150490653.0,228153674.0,89916,134866,167.37,169.17,224782,378644328.0,825,2023-11-09 14:35:00
679,GAZP,498,433,190492344.0,244794609.0,109425,127134,174.08,192.55,236559,435286954.0,931,264,343,158611396.0,187265274.0,94827,111524,167.26,167.91,206351,345876670.0,607,2023-11-09 14:40:00
680,GAZP,822,891,234578449.0,381367153.0,139990,207901,167.57,183.44,347891,615945602.0,1713,574,794,210525700.0,362059446.0,125835,196058,167.3,184.67,321893,572585147.0,1368,2023-11-09 14:45:00
681,GAZP,1727,2713,534474339.0,1128480293.0,318073,671667,168.04,168.01,989740,1662954633.0,4440,1537,2478,536592554.0,1139560645.0,302504,658637,177.38,173.02,961141,1676153200.0,4015,2023-11-09 14:50:00
682,GAZP,1915,1167,532400168.0,1036464370.0,317772,598829,167.54,173.08,916601,1568864539.0,3082,1779,1084,544626403.0,1026399461.0,325367,592799,167.39,173.14,918166,1571025864.0,2863,2023-11-09 14:55:00
683,GAZP,897,927,264250251.0,510110797.0,154859,285576,170.64,178.63,440435,774361048.0,1824,764,863,250732459.0,504449642.0,149715,282102,167.47,178.82,431817,755182101.0,1627,2023-11-09 15:00:00
684,GAZP,1106,913,425181750.0,405986150.0,252924,241240,168.11,168.29,494164,831167900.0,2019,970,810,413568590.0,398790682.0,246745,236956,167.61,168.3,483701,812359273.0,1780,2023-11-09 15:05:00
685,GAZP,1047,895,359720009.0,396980177.0,214237,236028,167.91,168.19,450265,756700186.0,1942,881,794,334357976.0,382643420.0,199555,227339,167.55,168.31,426894,717001397.0,1675,2023-11-09 15:10:00
686,GAZP,1846,1797,713248050.0,684527652.0,422069,405917,168.99,168.64,827986,1397775702.0,3643,1674,1544,692768864.0,645755801.0,412770,382735,167.83,168.72,795505,1338524665.0,3218,2023-11-09 15:15:00
687,GAZP,1313,1071,447180597.0,428940445.0,266668,254784,167.69,168.35,521452,876121042.0,2384,1195,972,440355140.0,411578948.0,262739,244402,167.6,168.4,507141,851934089.0,2167,2023-11-09 15:20:00
688,GAZP,1594,1378,626608648.0,477540167.0,373192,283531,167.91,168.43,656723,1104148816.0,2972,1447,1238,606520818.0,460317976.0,361430,273179,167.81,168.5,634609,1066838794.0,2685,2023-11-09 15:25:00
689,GAZP,1497,844,702695259.0,270307144.0,418837,160527,167.77,168.39,579364,973002403.0,2341,1389,751,705057822.0,278756502.0,420740,165470,167.58,168.46,586210,983814324.0,2140,2023-11-09 15:30:00
690,GAZP,2062,2373,643325617.0,1179481803.0,382913,699970,168.01,168.5,1082883,1822807420.0,4435,1930,2289,634665767.0,1166222298.0,378081,692039,167.87,168.52,1070120,1800888066.0,4219,2023-11-09 15:35:00
691,GAZP,2286,2674,751042975.0,1108103210.0,448207,659033,167.57,168.14,1107240,1859146185.0,4960,2110,2603,725150302.0,1105192394.0,432769,657194,167.56,168.17,1089963,1830342696.0,4713,2023-11-09 15:40:00
692,GAZP,982,815,328461695.0,289266363.0,195910,171845,167.66,168.33,367755,617728058.0,1797,881,735,332583142.0,272368139.0,198391,161798,167.64,168.34,360189,604951281.0,1616,2023-11-09 15:45:00
693,GAZP,608,444,187722422.0,173356818.0,111979,102881,167.64,168.5,214860,361079241.0,1052,507,392,181855997.0,161453839.0,108501,95738,167.61,168.64,204239,343309836.0,899,2023-11-09 15:50:00
694,GAZP,1290,1405,436751422.0,550875244.0,260211,326956,167.85,168.49,587167,987626666.0,2695,1162,1303,431174028.0,542294021.0,257041,321813,167.75,168.51,578854,973468050.0,2465,2023-11-09 15:55:00
695,GAZP,798,745,282578872.0,271777531.0,168464,161479,167.74,168.31,329943,554356404.0,1543,702,647,280221259.0,265866781.0,167085,157760,167.71,168.53,324845,546088041.0,1349,2023-11-09 16:00:00
696,GAZP,858,887,295788121.0,295860247.0,176340,175752,167.74,168.34,352092,591648369.0,1745,769,830,295986645.0,292071893.0,176602,173431,167.6,168.41,350033,588058539.0,1599,2023-11-09 16:05:00
697,GAZP,871,841,300977897.0,359056119.0,179356,213335,167.81,168.31,392691,660034016.0,1712,755,772,296990667.0,350066188.0,177170,207929,167.63,168.36,385099,647056855.0,1527,2023-11-09 16:10:00
698,GAZP,567,570,210364586.0,214077004.0,124066,127191,169.56,168.31,251257,424441591.0,1137,458,501,202175592.0,207795210.0,120637,123409,167.59,168.38,244046,409970802.0,959,2023-11-09 16:15:00
699,GAZP,1093,1268,375234914.0,589746106.0,223832,351229,167.64,167.91,575061,964981020.0,2361,886,1160,360182038.0,568686961.0,214965,338264,167.55,168.12,553229,928868999.0,2046,2023-11-09 16:20:00
700,GAZP,1302,1428,371333557.0,554050319.0,221797,329647,167.42,168.07,551444,925383876.0,2730,1133,1373,354242144.0,557374779.0,211542,331584,167.46,168.09,543126,911616924.0,2506,2023-11-09 16:25:00
701,GAZP,2199,1826,740799809.0,562464623.0,440984,334230,167.99,168.29,775214,1303264433.0,4025,2006,1662,739206411.0,563561857.0,441203,334865,167.54,168.3,776068,1302768268.0,3668,2023-11-09 16:30:00
702,GAZP,1326,1234,489936613.0,448249367.0,291845,265422,167.88,168.88,557267,938185981.0,2560,1210,1115,483335414.0,426470328.0,288093,252960,167.77,168.59,541053,909805742.0,2325,2023-11-09 16:35:00
703,GAZP,1382,1000,465426762.0,416745127.0,276757,247521,168.17,168.37,524278,882171890.0,2382,1180,938,437681339.0,410562231.0,260915,243784,167.75,168.41,504699,848243571.0,2118,2023-11-09 16:40:00
704,GAZP,1807,2066,557613969.0,778793019.0,325303,462371,171.41,168.43,787674,1336406988.0,3873,1685,1889,537833823.0,746696220.0,320390,443465,167.87,168.38,763855,1284530044.0,3574,2023-11-09 16:45:00
705,GAZP,750,590,297055591.0,261722483.0,176716,154550,168.1,169.34,331266,558778074.0,1340,650,474,279333186.0,230053049.0,161839,135673,172.6,169.56,297512,509386235.0,1124,2023-11-09 16:50:00
706,GAZP,1150,874,391670607.0,332429585.0,233239,197396,167.93,168.41,430635,724100193.0,2024,1010,825,379992127.0,325386685.0,226523,193143,167.75,168.47,419666,705378812.0,1835,2023-11-09 16:55:00
707,GAZP,444,408,179205310.0,164641587.0,106382,97569,168.45,168.74,203951,343846898.0,852,349,322,176762517.0,155112448.0,105344,92029,167.8,168.55,197373,331874966.0,671,2023-11-09 17:00:00
708,GAZP,782,589,223365566.0,183971905.0,132511,109232,168.56,168.42,241743,407337472.0,1371,705,509,225981158.0,175217257.0,134640,103927,167.84,168.6,238567,401198416.0,1214,2023-11-09 17:05:00
709,GAZP,889,628,282022305.0,230186634.0,167891,136662,167.98,168.43,304553,512208940.0,1517,766,535,267614305.0,234547937.0,159533,139111,167.75,168.6,298644,502162243.0,1301,2023-11-09 17:10:00
710,GAZP,1038,954,359506942.0,327549717.0,213173,194511,168.65,168.4,407684,687056660.0,1992,908,868,351760323.0,322945192.0,208916,191721,168.37,168.45,400637,674705515.0,1776,2023-11-09 17:15:00
711,GAZP,2171,2567,594044240.0,821332621.0,353831,487993,167.89,168.31,841824,1415376862.0,4738,2016,2474,579232447.0,794973495.0,345314,472259,167.74,168.33,817573,1374205942.0,4490,2023-11-09 17:20:00
712,GAZP,904,887,282334005.0,309867382.0,167835,184001,168.22,168.41,351836,592201388.0,1791,794,813,278252999.0,302775158.0,165810,179732,167.81,168.46,345542,581028158.0,1607,2023-11-09 17:25:00
713,GAZP,491,332,132711664.0,128462149.0,78751,76314,168.52,168.33,155065,261173813.0,823,367,266,131344557.0,124353101.0,78271,73793,167.81,168.52,152064,255697658.0,633,2023-11-09 17:30:00
714,GAZP,974,833,278158596.0,276393888.0,165590,164032,167.98,168.5,329622,554552484.0,1807,867,770,270248715.0,271752744.0,161147,161218,167.7,168.56,322365,542001460.0,1637,2023-11-09 17:35:00
715,GAZP,1079,1195,337129615.0,433961275.0,199524,258058,168.97,168.16,457582,771090890.0,2274,960,1101,332001753.0,422878181.0,197955,251301,167.72,168.28,449256,754879934.0,2061,2023-11-09 17:40:00
716,GAZP,1801,1951,565452388.0,669822256.0,336850,397968,167.86,168.31,734818,1235274644.0,3752,1640,1863,539076536.0,658882192.0,321427,391538,167.71,168.28,712965,1197958728.0,3503,2023-11-09 17:45:00
717,GAZP,1865,1332,618818255.0,372269239.0,368621,221226,167.87,168.28,589847,991087494.0,3197,1756,1193,600293818.0,339977408.0,358180,201777,167.6,168.49,559957,940271227.0,2949,2023-11-09 17:50:00
718,GAZP,1218,632,584022497.0,151768806.0,347914,88244,167.86,171.99,436158,735791303.0,1850,1050,564,575081486.0,149706860.0,342751,88811,167.78,168.57,431562,724788346.0,1614,2023-11-09 17:55:00
719,GAZP,1875,1582,473401493.0,817199309.0,281986,485050,167.88,168.48,767036,1290600803.0,3457,1707,1518,474782817.0,810028650.0,283060,479850,167.73,168.81,762910,1284811468.0,3225,2023-11-09 18:00:00
720,GAZP,12484,9898,4427347669.0,2637580122.0,2614310,1559245,169.35,169.16,4173555,7064927791.0,22382,10724,8231,4006423645.0,2343284279.0,2376927,1383667,168.55,169.35,3760594,6349707924.0,18955,2023-11-09 18:05:00
721,GAZP,4768,3660,1979598240.0,1032680747.0,1169427,607562,169.28,169.97,1776989,3012278987.0,8428,3907,2986,1858277712.0,891429533.0,1100302,525618,168.89,169.6,1625920,2749707246.0,6893,2023-11-09 18:10:00
722,GAZP,4079,3265,1383770133.0,1254017246.0,819027,741580,168.95,169.1,1560607,2637787379.0,7344,3597,2917,1324332254.0,1142402326.0,784795,674447,168.75,169.38,1459242,2466734581.0,6514,2023-11-09 18:15:00
723,GAZP,3040,2402,735991429.0,653639759.0,435027,378147,169.18,172.85,813174,1389631189.0,5442,2475,2006,687210837.0,603176745.0,407176,347810,168.77,173.42,754986,1290387582.0,4481,2023-11-09 18:20:00
724,GAZP,4003,2467,1200677278.0,658340955.0,710166,388810,169.07,169.32,1098976,1859018233.0,6470,3616,2193,1168023751.0,618369224.0,691700,365010,168.86,169.41,1056710,1786392975.0,5809,2023-11-09 18:25:00
725,GAZP,3441,2096,1078379602.0,652262330.0,632789,383770,170.42,169.96,1016559,1730641932.0,5537,3023,1771,1009168585.0,585406504.0,594258,345324,169.82,169.52,939582,1594575090.0,4794,2023-11-09 18:30:00
726,GAZP,2131,1227,618814570.0,394000136.0,365613,232519,169.25,169.45,598132,1012814707.0,3358,1696,928,586747346.0,344574586.0,347511,203122,168.84,169.64,550633,931321932.0,2624,2023-11-09 18:35:00
727,GAZP,1767,1014,627554832.0,383297719.0,371871,205559,168.76,186.47,577430,1010852551.0,2781,1431,872,585526011.0,301389048.0,346227,177914,169.12,169.4,524141,886915060.0,2303,2023-11-09 18:40:00
728,GAZP,6874,6533,1483088249.0,1585827911.0,882485,936789,168.06,169.28,1819274,3068916160.0,13407,6059,5828,1390793990.0,1482686550.0,827090,879063,168.16,168.67,1706153,2873480541.0,11887,2023-11-10 10:05:00
729,GAZP,1482,1291,470444001.0,438027646.0,280131,203315,167.94,215.44,483446,908471647.0,2773,985,983,372932569.0,299679726.0,222082,173564,167.93,172.66,395646,672612296.0,1968,2023-11-10 10:10:00
730,GAZP,2291,3824,621451403.0,2369024792.0,369928,1398306,167.99,169.42,1768234,2990476196.0,6115,1924,3565,624125331.0,2323122986.0,371504,1373134,168.0,169.18,1744638,2947248317.0,5489,2023-11-10 10:15:00
731,GAZP,1169,579,258366199.0,223183392.0,153973,107230,167.8,208.14,261203,481549591.0,1748,625,396,224690433.0,202912018.0,134005,96573,167.67,210.11,230578,427602452.0,1021,2023-11-10 10:20:00
732,GAZP,1201,733,408105867.0,411807504.0,243182,215279,167.82,191.29,458461,819913372.0,1934,704,515,330447490.0,354781597.0,196893,194620,167.83,182.29,391513,685229088.0,1219,2023-11-10 10:25:00
733,GAZP,2264,1499,885959490.0,914592419.0,527878,537153,167.83,170.27,1065031,1800551909.0,3763,1816,1304,852336502.0,857282737.0,508217,502745,167.71,170.52,1010962,1709619240.0,3120,2023-11-10 10:30:00
734,GAZP,2650,2803,869614493.0,1180573649.0,518330,689043,167.77,171.34,1207373,2050188142.0,5453,2088,2409,789141984.0,1150374508.0,470727,668549,167.64,172.07,1139276,1939516492.0,4497,2023-11-10 10:35:00
735,GAZP,2078,1708,659289291.0,801851466.0,393226,466534,167.66,171.87,859760,1461140758.0,3786,1577,1475,628124378.0,770782012.0,374600,446918,167.68,172.47,821518,1398906391.0,3052,2023-11-10 10:40:00
736,GAZP,1714,1746,601926430.0,679385629.0,358828,351473,167.75,193.3,710301,1281312060.0,3460,1303,1603,584982461.0,661059694.0,348925,342221,167.65,193.17,691146,1246042156.0,2906,2023-11-10 10:45:00
737,GAZP,2855,3262,972772753.0,1081347282.0,578691,641523,168.1,168.56,1220214,2054120036.0,6117,2482,2933,931984614.0,1050058110.0,555292,622955,167.84,168.56,1178247,1982042724.0,5415,2023-11-10 10:50:00
738,GAZP,3631,3973,1215340321.0,1314447577.0,723941,779813,167.88,168.56,1503754,2529787899.0,7604,3367,3676,1199215050.0,1268612102.0,714461,752710,167.85,168.54,1467171,2467827153.0,7043,2023-11-10 10:55:00
739,GAZP,1290,937,437254591.0,374196589.0,260031,222070,168.15,168.5,482101,811451180.0,2227,1075,788,418001027.0,359341982.0,249161,213222,167.76,168.53,462383,777343009.0,1863,2023-11-10 11:00:00
740,GAZP,1813,1631,601008452.0,563325050.0,355014,334301,169.29,168.51,689315,1164333502.0,3444,1596,1500,581057151.0,553044306.0,345984,328080,167.94,168.57,674064,1134101457.0,3096,2023-11-10 11:05:00
741,GAZP,1546,1659,532501283.0,581453480.0,316986,344967,167.99,168.55,661953,1113954763.0,3205,1378,1481,541067587.0,566171594.0,322209,335876,167.92,168.57,658085,1107239182.0,2859,2023-11-10 11:10:00
742,GAZP,924,865,321131545.0,398314680.0,191345,236265,167.83,168.59,427610,719446226.0,1789,743,694,318872612.0,376368987.0,189958,223324,167.86,168.53,413282,695241599.0,1437,2023-11-10 11:15:00
743,GAZP,667,501,228180677.0,304271427.0,133074,126310,171.47,240.89,259384,532452105.0,1168,446,395,221767377.0,204833958.0,132154,121479,167.81,168.62,253633,426601335.0,841,2023-11-10 11:20:00
744,GAZP,784,646,291141298.0,263542447.0,173475,156503,167.83,168.39,329978,554683746.0,1430,563,511,273777496.0,257830355.0,163112,153062,167.85,168.45,316174,531607852.0,1074,2023-11-10 11:25:00
745,GAZP,762,505,276824368.0,220614399.0,164885,131033,167.89,168.37,295918,497438768.0,1267,573,388,252945336.0,201614694.0,150676,119634,167.87,168.53,270310,454560030.0,961,2023-11-10 11:30:00
746,GAZP,6033,2695,1036473398.0,467126563.0,614283,277527,168.73,168.32,891810,1503599962.0,8728,5854,2524,1020999634.0,459209473.0,607830,272707,167.97,168.39,880537,1480209108.0,8378,2023-11-10 11:35:00
747,GAZP,1302,928,441823221.0,403809643.0,263166,240267,167.89,168.07,503433,845632865.0,2230,1091,838,426722416.0,369531009.0,254398,219364,167.74,168.46,473762,796253425.0,1929,2023-11-10 11:40:00
748,GAZP,1286,1203,464596264.0,497454894.0,274201,296114,169.44,167.99,570315,962051158.0,2489,1012,1081,447902115.0,491099950.0,267098,291658,167.69,168.38,558756,939002066.0,2093,2023-11-10 11:45:00
749,GAZP,2555,2258,1318963167.0,831446911.0,785631,493962,167.89,168.32,1279593,2150410078.0,4813,2186,2050,1274527436.0,805021827.0,759732,478102,167.76,168.38,1237834,2079549263.0,4236,2023-11-10 11:50:00
750,GAZP,1452,1264,494872721.0,445604087.0,291743,264657,169.63,168.37,556400,940476808.0,2716,1238,1140,473108251.0,434092692.0,281870,257756,167.85,168.41,539626,907200943.0,2378,2023-11-10 11:55:00
751,GAZP,1642,2176,581260366.0,835204293.0,343798,496152,169.07,168.34,839950,1416464660.0,3818,1424,2036,558309889.0,799821827.0,332895,475063,167.71,168.36,807958,1358131717.0,3460,2023-11-10 12:00:00
752,GAZP,1309,1317,453925422.0,625013108.0,270043,370388,168.09,168.75,640431,1078938531.0,2626,1104,1199,426320470.0,612375790.0,254105,363467,167.77,168.48,617572,1038696260.0,2303,2023-11-10 12:05:00
753,GAZP,830,745,326029332.0,304830487.0,193839,180737,168.2,168.66,374576,630859820.0,1575,612,617,306017000.0,290114052.0,182563,172073,167.62,168.6,354636,596131053.0,1229,2023-11-10 12:10:00
754,GAZP,605,512,203602086.0,231786894.0,121341,134375,167.79,172.49,255716,435388980.0,1117,432,419,204627290.0,214392414.0,121978,127305,167.76,168.41,249283,419019704.0,851,2023-11-10 12:15:00
755,GAZP,1784,2687,568920165.0,1331672744.0,339237,791583,167.71,168.23,1130820,1900592910.0,4471,1587,2569,578763274.0,1303523647.0,345291,774551,167.62,168.29,1119842,1882286921.0,4156,2023-11-10 12:20:00
756,GAZP,1405,2470,433954909.0,1090835423.0,258659,648906,167.77,168.1,907565,1524790332.0,3875,1190,2311,416697028.0,1038964215.0,248492,617793,167.69,168.17,866285,1455661244.0,3501,2023-11-10 12:25:00
757,GAZP,1040,1234,331787571.0,511846266.0,197782,304635,167.75,168.02,502417,843633837.0,2274,819,1069,328555925.0,499464205.0,195899,297075,167.72,168.13,492974,828020131.0,1888,2023-11-10 12:30:00
758,GAZP,2109,2031,809050982.0,858227334.0,482457,510543,167.69,168.1,993000,1667278317.0,4140,1809,1777,778375872.0,880162888.0,464292,472739,167.65,186.18,937031,1658538760.0,3586,2023-11-10 12:35:00
759,GAZP,2695,2082,689722729.0,565604064.0,410306,336520,168.1,168.07,746826,1255326793.0,4777,2464,1975,663674452.0,571862163.0,395328,339844,167.88,168.27,735172,1235536615.0,4439,2023-11-10 12:40:00
760,GAZP,1128,876,358871432.0,355885433.0,213771,209116,167.88,170.19,422887,714756866.0,2004,929,756,345922160.0,346298809.0,206211,205632,167.75,168.41,411843,692220970.0,1685,2023-11-10 12:45:00
761,GAZP,940,831,303026501.0,293688889.0,180664,174536,167.73,168.27,355200,596715390.0,1771,753,727,289387497.0,283368969.0,172540,168364,167.72,168.31,340904,572756466.0,1480,2023-11-10 12:50:00
762,GAZP,1613,1566,609128543.0,625141296.0,363411,371870,167.61,168.11,735281,1234269839.0,3179,1421,1450,611999924.0,615808440.0,365178,365982,167.59,168.26,731160,1227808364.0,2871,2023-11-10 12:55:00
763,GAZP,4086,5302,1214131319.0,1756169654.0,721692,1044265,168.23,168.17,1765957,2970300973.0,9388,3842,5193,1178236897.0,1749876566.0,703087,1040363,167.58,168.2,1743450,2928113464.0,9035,2023-11-10 13:00:00
764,GAZP,2210,2128,765992023.0,817566103.0,456843,486384,167.67,168.09,943227,1583558127.0,4338,2003,1999,757809022.0,815888469.0,452040,484780,167.64,168.3,936820,1573697492.0,4002,2023-11-10 13:05:00
765,GAZP,713,614,233248459.0,232010706.0,138891,137909,167.94,168.23,276800,465259166.0,1327,501,511,218673692.0,226390422.0,130394,134517,167.7,168.3,264911,445064115.0,1012,2023-11-10 13:10:00
766,GAZP,1179,1445,435802649.0,480884479.0,259671,285693,167.83,168.32,545364,916687129.0,2624,1005,1342,442845605.0,475747223.0,264069,282588,167.7,168.35,546657,918592828.0,2347,2023-11-10 13:15:00
767,GAZP,3875,3745,1703471310.0,1268972987.0,1014670,749085,167.88,169.4,1763755,2972444298.0,7620,3705,3627,1686851459.0,1248324174.0,1005360,741478,167.79,168.36,1746838,2935175633.0,7332,2023-11-10 13:20:00
768,GAZP,2150,2640,760265530.0,1208538384.0,453162,718520,167.77,168.2,1171682,1968803915.0,4790,1975,2538,751070377.0,1202581558.0,447876,714939,167.7,168.21,1162815,1953651935.0,4513,2023-11-10 13:25:00
769,GAZP,2013,1966,732529747.0,680411574.0,436605,404345,167.78,168.28,840950,1412941322.0,3979,1783,1833,722217608.0,655223228.0,430506,389182,167.76,168.36,819688,1377440836.0,3616,2023-11-10 13:30:00
770,GAZP,1564,1916,510995845.0,904535932.0,304580,532944,167.77,169.72,837524,1415531777.0,3480,1386,1832,501496366.0,848754358.0,299043,501861,167.7,169.12,800904,1350250725.0,3218,2023-11-10 13:35:00
771,GAZP,1023,1118,330813616.0,486964188.0,197231,289557,167.73,168.18,486788,817777804.0,2141,851,1003,332492345.0,468917456.0,198324,278685,167.65,168.26,477009,801409802.0,1854,2023-11-10 13:40:00
772,GAZP,3057,5519,1207995535.0,2985959471.0,721285,1778412,167.48,167.9,2499697,4193955006.0,8576,2619,5297,1155320790.0,2918851215.0,689979,1737730,167.44,167.97,2427709,4074172006.0,7916,2023-11-10 13:45:00
773,GAZP,2347,3978,835786190.0,1749576716.0,494055,1037646,169.17,168.61,1531701,2585362906.0,6325,2033,3778,807655580.0,1721859814.0,482499,1020621,167.39,168.71,1503120,2529515394.0,5811,2023-11-10 13:50:00
774,GAZP,2310,3585,603219232.0,1367988494.0,360240,807781,167.45,169.35,1168021,1971207727.0,5895,2014,3501,584264982.0,1362730277.0,349052,804279,167.39,169.44,1153331,1946995259.0,5515,2023-11-10 13:55:00
775,GAZP,5849,10072,1134208116.0,3917857889.0,676917,2333212,167.55,167.92,3010129,5052066005.0,15921,5698,9998,1122677653.0,3919622064.0,670087,2334154,167.54,167.92,3004241,5042299718.0,15696,2023-11-10 14:00:00
776,GAZP,943,1635,473243936.0,1346242139.0,282369,801061,167.6,168.06,1083430,1819486075.0,2578,730,1550,465094463.0,1325817026.0,277594,788795,167.54,168.08,1066389,1790911490.0,2280,2023-11-10 14:05:00
777,GAZP,1215,3786,652412120.0,2647336280.0,382310,1573313,170.65,168.27,1955623,3299748400.0,5001,1020,3701,618449146.0,2622365242.0,369451,1559539,167.4,168.15,1928990,3240814389.0,4721,2023-11-10 14:10:00
778,GAZP,1318,3085,629897702.0,1798397815.0,376390,1070539,167.35,167.99,1446929,2428295517.0,4403,1132,3008,624206643.0,1794294128.0,373122,1068066,167.29,167.99,1441188,2418500772.0,4140,2023-11-10 14:15:00
779,GAZP,2156,3690,1525616814.0,2499323613.0,910100,1486751,167.63,168.11,2396851,4024940427.0,5846,1950,3574,1500289404.0,2477855550.0,895720,1473563,167.5,168.15,2369283,3978144954.0,5524,2023-11-10 14:20:00
780,GAZP,1005,838,553789341.0,574157566.0,330423,332455,167.6,172.7,662878,1127946907.0,1843,807,748,545539346.0,407871451.0,325566,242448,167.57,168.23,568014,953410797.0,1555,2023-11-10 14:25:00
781,GAZP,1402,2689,1136013280.0,1810682546.0,677248,1026605,167.74,176.38,1703853,2946695826.0,4091,1208,2585,1118409394.0,1717304619.0,667295,1021639,167.6,168.09,1688934,2835714014.0,3793,2023-11-10 14:30:00
782,GAZP,2261,3187,1833583348.0,1950610170.0,1092489,1159973,167.84,168.16,2252462,3784193518.0,5448,2071,3019,1801897199.0,1916999092.0,1073992,1139891,167.78,168.17,2213883,3718896292.0,5090,2023-11-10 14:35:00
783,GAZP,1619,3418,1228984930.0,1367286494.0,732652,813230,167.74,168.13,1545882,2596271424.0,5037,1384,3277,1223502561.0,1348197134.0,729519,801837,167.71,168.14,1531356,2571699696.0,4661,2023-11-10 14:40:00
784,GAZP,1423,1589,586816700.0,797931491.0,350136,474447,167.6,168.18,824583,1384748192.0,3012,1275,1513,587847055.0,786304287.0,350782,467309,167.58,168.26,818091,1374151342.0,2788,2023-11-10 14:45:00
785,GAZP,1918,2511,447238293.0,975064078.0,266629,579831,167.74,168.16,846460,1422302371.0,4429,1749,2427,435197155.0,965235268.0,259640,574026,167.62,168.15,833666,1400432423.0,4176,2023-11-10 14:50:00
786,GAZP,4641,5089,1435062173.0,1779055849.0,856002,1057516,167.65,168.23,1913518,3214118022.0,9730,4459,4994,1428616202.0,1757937860.0,852189,1044868,167.64,168.24,1897057,3186554062.0,9453,2023-11-10 14:55:00
787,GAZP,2539,2955,811624041.0,1383504533.0,484086,823025,167.66,168.1,1307111,2195128575.0,5494,2249,2881,769525312.0,1374617741.0,459244,817662,167.56,168.12,1276906,2144143053.0,5130,2023-11-10 15:00:00
788,GAZP,1332,1314,417274696.0,608828139.0,246799,361784,169.07,168.28,608583,1026102836.0,2646,1151,1207,414565370.0,577232003.0,247144,343037,167.74,168.27,590181,991797373.0,2358,2023-11-10 15:05:00
789,GAZP,1103,888,425063478.0,408651102.0,251859,242695,168.77,168.38,494554,833714580.0,1991,930,778,366447360.0,392450848.0,218443,233033,167.75,168.41,451476,758898209.0,1708,2023-11-10 15:10:00
790,GAZP,1265,1294,486129455.0,566760400.0,286839,336857,169.48,168.25,623696,1052889855.0,2559,1061,1196,460870631.0,535043311.0,274790,317717,167.72,168.4,592507,995913942.0,2257,2023-11-10 15:15:00
791,GAZP,1618,2423,452928795.0,1048504862.0,269811,623120,167.87,168.27,892931,1501433658.0,4041,1454,2340,439780420.0,1039188959.0,262228,617536,167.71,168.28,879764,1478969379.0,3794,2023-11-10 15:20:00
792,GAZP,1031,1167,349009585.0,555099804.0,208179,329081,167.65,168.68,537260,904109390.0,2198,810,1071,338025725.0,526455433.0,201659,312826,167.62,168.29,514485,864481158.0,1881,2023-11-10 15:25:00
793,GAZP,1397,1225,468499800.0,571777108.0,279336,339555,167.72,168.39,618891,1040276909.0,2622,1151,1124,452589583.0,544336962.0,269939,323492,167.66,168.27,593431,996926546.0,2275,2023-11-10 15:30:00
794,GAZP,4838,11342,1569453937.0,9165237026.0,936716,5452833,167.55,168.08,6389549,10734690963.0,16180,4587,11275,1566382347.0,9166366853.0,934990,5453227,167.53,168.09,6388217,10732749201.0,15862,2023-11-10 15:35:00
795,GAZP,1486,1632,667317138.0,1139724970.0,397535,677229,167.86,168.29,1074764,1807042109.0,3118,1308,1534,653971978.0,1124711162.0,390079,668334,167.65,168.29,1058413,1778683141.0,2842,2023-11-10 15:40:00
796,GAZP,1516,1083,799026226.0,733764449.0,476247,435746,167.78,168.39,911993,1532790675.0,2599,1337,960,789391771.0,738434741.0,470721,438450,167.7,168.42,909171,1527826513.0,2297,2023-11-10 15:45:00
797,GAZP,2222,1579,876337020.0,1052942448.0,522449,625648,167.74,168.3,1148097,1929279468.0,3801,2027,1468,868474298.0,1042179105.0,517833,619161,167.71,168.32,1136994,1910653403.0,3495,2023-11-10 15:50:00
798,GAZP,3725,2318,1888875924.0,1772140652.0,1124917,1049590,167.91,168.84,2174507,3661016576.0,6043,3546,2150,1857621073.0,1702579553.0,1106651,1010906,167.86,168.42,2117557,3560200626.0,5696,2023-11-10 15:55:00
799,GAZP,1902,1621,946383064.0,980763930.0,563858,582728,167.84,168.31,1146586,1927146994.0,3523,1688,1483,924487739.0,951538795.0,550918,565267,167.81,168.33,1116185,1876026534.0,3171,2023-11-10 16:00:00
800,GAZP,5638,4073,6083413714.0,3218618086.0,3621911,1912918,167.96,168.26,5534829,9302031800.0,9711,5446,3957,6063559060.0,3206467529.0,3610098,1905412,167.96,168.28,5515510,9270026589.0,9403,2023-11-10 16:05:00
801,GAZP,2291,5277,599514591.0,3726581463.0,358041,2217300,167.44,168.07,2575341,4326096054.0,7568,1981,5156,593769860.0,3713238336.0,354666,2209107,167.42,168.09,2563773,4307008196.0,7137,2023-11-10 16:10:00
802,GAZP,1053,1059,218055811.0,555161977.0,129980,326770,167.76,169.89,456750,773217788.0,2112,803,989,209688472.0,542850493.0,125142,322707,167.56,168.22,447849,752538965.0,1792,2023-11-10 16:15:00
803,GAZP,3446,4428,686916398.0,2487170891.0,409800,1479403,167.62,168.12,1889203,3174087289.0,7874,3279,4320,681303913.0,2469226349.0,406662,1468537,167.54,168.14,1875199,3150530262.0,7599,2023-11-10 16:20:00
804,GAZP,1729,1983,357789166.0,1477601824.0,213389,878546,167.67,168.19,1091935,1835390991.0,3712,1560,1941,344259971.0,1478979958.0,205430,878985,167.58,168.26,1084415,1823239930.0,3501,2023-11-10 16:25:00
805,GAZP,4071,4480,853442565.0,3316214890.0,509287,1973128,167.58,168.07,2482415,4169657455.0,8551,3932,4405,841895518.0,3306105458.0,502453,1966913,167.56,168.09,2469366,4148000976.0,8337,2023-11-10 16:30:00
806,GAZP,6921,7780,1420921265.0,7578851862.0,847919,4508967,167.58,168.08,5356886,8999773127.0,14701,6726,7696,1406225528.0,7576291033.0,839307,4507263,167.55,168.09,5346570,8982516561.0,14422,2023-11-10 16:35:00
807,GAZP,1982,2145,557558484.0,1288252420.0,332605,766553,167.63,168.06,1099158,1845810904.0,4127,1683,2064,539362922.0,1279025149.0,322034,760782,167.49,168.12,1082816,1818388071.0,3747,2023-11-10 16:40:00
808,GAZP,741,521,157984982.0,247955409.0,94085,146838,167.92,168.86,240923,405940392.0,1262,531,438,150305139.0,187685156.0,89740,111262,167.49,168.69,201002,337990295.0,969,2023-11-10 16:45:00
809,GAZP,1494,693,500223329.0,356773020.0,297896,211647,167.92,168.57,509543,856996349.0,2187,1321,602,495549611.0,379945528.0,287922,225277,172.11,168.66,513199,875495139.0,1923,2023-11-10 16:50:00
810,GAZP,2519,1243,642052206.0,668441640.0,382308,397130,167.94,168.32,779438,1310493846.0,3762,2330,1122,621533841.0,658183042.0,370357,390911,167.82,168.37,761268,1279716884.0,3452,2023-11-10 16:55:00
811,GAZP,1045,914,384854596.0,434990797.0,229004,258399,168.06,168.34,487403,819845393.0,1959,806,772,365291588.0,395389004.0,217798,234755,167.72,168.43,452553,760680592.0,1578,2023-11-10 17:00:00
812,GAZP,1240,1037,301596355.0,405171969.0,179651,240737,167.88,168.3,420388,706768324.0,2277,1056,975,287310842.0,403170692.0,171436,239442,167.59,168.38,410878,690481534.0,2031,2023-11-10 17:05:00
813,GAZP,2123,1743,281209000.0,445829512.0,167303,264875,168.08,168.32,432178,727038512.0,3866,1967,1652,275212487.0,432200047.0,163926,256769,167.89,168.32,420695,707412534.0,3619,2023-11-10 17:10:00
814,GAZP,510,309,109928087.0,72042288.0,65377,42771,168.14,168.44,108148,181970376.0,819,320,221,79640293.0,53834727.0,47475,31926,167.75,168.62,79401,133475020.0,541,2023-11-10 17:15:00
815,GAZP,372,251,61871068.0,85881031.0,36706,50897,168.56,168.73,87603,147752099.0,623,217,155,54327596.0,58241380.0,32456,34429,167.39,169.16,66885,112568976.0,372,2023-11-10 17:20:00
816,GAZP,723,430,153253220.0,160486470.0,91075,95509,168.27,168.03,186584,313739691.0,1153,545,349,135764482.0,153632173.0,81013,91197,167.58,168.46,172210,289396655.0,894,2023-11-10 17:25:00
817,GAZP,562,294,121317675.0,109029627.0,72391,61437,167.59,177.47,133828,230347302.0,856,429,235,118521146.0,103357105.0,70708,61301,167.62,168.61,132009,221878251.0,664,2023-11-10 17:30:00
818,GAZP,764,394,151234762.0,98607346.0,89937,58452,168.16,168.7,148389,249842108.0,1158,597,347,143718444.0,95935004.0,85618,56779,167.86,168.96,142397,239653448.0,944,2023-11-10 17:35:00
819,GAZP,534,286,91073036.0,88373821.0,54129,52425,168.25,168.57,106554,179446857.0,820,390,234,74262938.0,76072541.0,44272,45087,167.74,168.72,89359,150335480.0,624,2023-11-10 17:40:00
820,GAZP,1511,777,507986453.0,362156636.0,302168,214886,168.11,168.53,517054,870143089.0,2288,1299,696,486221938.0,354181032.0,289446,210093,167.98,168.58,499539,840402970.0,1995,2023-11-10 17:45:00
821,GAZP,5632,6789,1127493066.0,5447025476.0,670808,3235607,168.08,168.35,3906415,6574518543.0,12421,5354,6627,1092367572.0,5399115005.0,650571,3206970,167.91,168.36,3857541,6491482578.0,11981,2023-11-10 17:50:00
822,GAZP,1319,827,361501744.0,436773528.0,215279,259128,167.92,168.56,474407,798275272.0,2146,1160,738,347406930.0,429081814.0,206904,254507,167.91,168.59,461411,776488745.0,1898,2023-11-10 17:55:00
823,GAZP,1069,405,247226005.0,177089570.0,147074,104955,168.1,168.73,252029,424315576.0,1474,930,326,240293637.0,166536465.0,143068,98697,167.96,168.74,241765,406830102.0,1256,2023-11-10 18:00:00
824,GAZP,1100,773,264429805.0,337330626.0,157311,200054,168.09,168.62,357365,601760431.0,1873,897,655,250186434.0,328719189.0,148945,194819,167.97,168.73,343764,578905624.0,1552,2023-11-10 18:05:00
825,GAZP,727,407,172925956.0,157964354.0,102699,93577,168.38,168.81,196276,330890310.0,1134,544,313,162451659.0,161250157.0,96715,95544,167.97,168.77,192259,323701816.0,857,2023-11-10 18:10:00
826,GAZP,1316,1216,408825187.0,482527266.0,243268,286322,168.06,168.53,529590,891352453.0,2532,1115,1109,398601089.0,468003687.0,237388,277545,167.91,168.62,514933,866604776.0,2224,2023-11-10 18:15:00
827,GAZP,2876,2592,744697185.0,1036922702.0,443345,615227,167.97,168.54,1058572,1781619888.0,5468,2703,2466,739214652.0,1024563479.0,440190,607836,167.93,168.56,1048026,1763778131.0,5169,2023-11-10 18:20:00
828,GAZP,1789,1801,514531249.0,633609081.0,306329,376140,167.97,168.45,682469,1148140331.0,3590,1663,1723,515750832.0,632906088.0,307150,375477,167.91,168.56,682627,1148656920.0,3386,2023-11-10 18:25:00
829,GAZP,1817,1876,158561114.0,325154951.0,93813,192886,169.02,168.57,286699,483716066.0,3693,1644,1756,147341752.0,304834478.0,87559,180781,168.28,168.62,268340,452176231.0,3400,2023-11-10 18:30:00
830,GAZP,536,292,93956918.0,67357401.0,55969,40010,167.87,168.35,95979,161314319.0,828,356,174,71427473.0,60190195.0,42468,35595,168.19,169.1,78063,131617668.0,530,2023-11-10 18:35:00
831,GAZP,916,1486,148733187.0,183516966.0,88291,109711,168.46,167.27,198002,332250154.0,2402,735,559,140995705.0,164818317.0,83809,97814,168.23,168.5,181623,305814022.0,1294,2023-11-10 18:40:00
832,GAZP,3710,4822,713418297.0,1688895141.0,422948,1001409,168.68,168.65,1424357,2402313438.0,8532,2402,3992,576803036.0,1506648888.0,343570,894741,167.89,168.39,1238311,2083451924.0,6394,2023-11-13 10:05:00
833,GAZP,5440,6290,3297181301.0,3489719270.0,1960280,2075816,168.2,168.11,4036096,6786900571.0,11730,4889,5887,3219577180.0,3441792250.0,1916132,2047073,168.02,168.13,3963205,6661369431.0,10776,2023-11-13 10:10:00
834,GAZP,2394,4624,741897551.0,1479288430.0,438809,868580,169.07,170.31,1307389,2221185982.0,7018,1852,4236,677370123.0,1409081401.0,402657,837674,168.23,168.21,1240331,2086451524.0,6088,2023-11-13 10:15:00
835,GAZP,1889,1898,506507787.0,738865197.0,296826,438766,170.64,168.4,735592,1245372985.0,3787,1454,1482,450460329.0,668887679.0,267977,397454,168.1,168.29,665431,1119348008.0,2936,2023-11-13 10:20:00
836,GAZP,5044,5881,1125811128.0,2128772113.0,668958,1267636,168.29,167.93,1936594,3254583241.0,10925,4501,5489,1076339654.0,2076605834.0,641139,1235445,167.88,168.09,1876584,3152945488.0,9990,2023-11-13 10:25:00
837,GAZP,1616,1626,615747448.0,696064476.0,364596,413517,168.88,168.33,778113,1311811925.0,3242,1206,1354,567876461.0,659053316.0,337740,391641,168.14,168.28,729381,1226929777.0,2560,2023-11-13 10:30:00
838,GAZP,1292,1540,454232656.0,631081075.0,268264,375252,169.32,168.18,643516,1085313731.0,2832,928,1209,438191263.0,591480499.0,260735,351576,168.06,168.24,612311,1029671763.0,2137,2023-11-13 10:35:00
839,GAZP,2832,2260,1154276860.0,844602418.0,684197,503986,168.71,167.58,1188183,1998879278.0,5092,2403,1985,1115124620.0,803807769.0,664815,477897,167.73,168.2,1142712,1918932390.0,4388,2023-11-13 10:40:00
840,GAZP,2446,1648,795575944.0,619304975.0,474570,368668,167.64,167.98,843238,1414880919.0,4094,1523,1437,716843844.0,594909662.0,427167,353699,167.81,168.2,780866,1311753507.0,2960,2023-11-13 10:45:00
841,GAZP,860,809,308984628.0,339594724.0,181324,202199,170.4,167.95,383523,648579353.0,1669,494,667,285952441.0,309578147.0,170509,184172,167.71,168.09,354681,595530588.0,1161,2023-11-13 10:50:00
842,GAZP,2105,2011,463144198.0,473051469.0,275962,281439,167.83,168.08,557401,936195667.0,4116,1739,1839,445421496.0,466950940.0,265526,277451,167.75,168.3,542977,912372436.0,3578,2023-11-13 10:55:00
843,GAZP,1794,1798,717415585.0,716665997.0,427607,425457,167.77,168.45,853064,1434081583.0,3592,1484,1626,689579021.0,686136512.0,411199,407830,167.7,168.24,819029,1375715534.0,3110,2023-11-13 11:00:00
844,GAZP,1255,1168,433448706.0,394499825.0,257927,234491,168.05,168.24,492418,827948532.0,2423,1007,972,416983947.0,379083062.0,248549,225254,167.77,168.29,473803,796067009.0,1979,2023-11-13 11:05:00
845,GAZP,1470,1416,526453958.0,604102619.0,310318,359401,169.65,168.09,669719,1130556577.0,2886,1226,1209,510047357.0,578984931.0,303573,343970,168.01,168.32,647543,1089032289.0,2435,2023-11-13 11:10:00
846,GAZP,1373,1602,462094525.0,657551594.0,273611,390769,168.89,168.27,664380,1119646119.0,2975,1118,1394,454482989.0,640825133.0,271042,380770,167.68,168.3,651812,1095308122.0,2512,2023-11-13 11:15:00
847,GAZP,1629,1478,551443079.0,653656192.0,328700,388462,167.76,168.27,717162,1205099271.0,3107,1273,1302,524023871.0,627191100.0,312511,372733,167.68,168.27,685244,1151214971.0,2575,2023-11-13 11:20:00
848,GAZP,1493,931,525043716.0,411488486.0,312716,244397,167.9,168.37,557113,936532202.0,2424,1161,807,512465877.0,396341700.0,305516,235500,167.74,168.3,541016,908807578.0,1968,2023-11-13 11:25:00
849,GAZP,2356,2644,815657481.0,1299206518.0,484672,771772,168.29,168.34,1256444,2114863999.0,5000,2579,2437,830168150.0,1276487690.0,495851,758184,167.42,168.36,1254035,2106655840.0,5016,2023-11-13 11:30:00
850,GAZP,1314,823,468400389.0,369628724.0,279051,219692,167.85,168.25,498743,838029114.0,2137,1072,719,451491160.0,359007247.0,269145,213234,167.75,168.36,482379,810498407.0,1791,2023-11-13 11:35:00
851,GAZP,1477,1487,427542167.0,700159912.0,254551,415952,167.96,168.33,670503,1127702079.0,2964,1267,1336,414794810.0,687893826.0,247130,408706,167.84,168.31,655836,1102688637.0,2603,2023-11-13 11:40:00
852,GAZP,1518,1219,592599495.0,559149396.0,348980,331435,169.81,168.71,680415,1151748891.0,2737,1315,1038,582584767.0,515300673.0,346246,305843,168.26,168.49,652089,1097885441.0,2353,2023-11-13 11:45:00
853,GAZP,2025,2043,697872238.0,909153475.0,415286,540195,168.05,168.3,955481,1607025714.0,4068,1789,1878,669190172.0,894769032.0,398504,531539,167.93,168.34,930043,1563959205.0,3667,2023-11-13 11:50:00
854,GAZP,1952,1300,753337123.0,683069272.0,447539,405246,168.33,168.56,852785,1436406395.0,3252,1578,1107,717088734.0,644268663.0,426755,382120,168.03,168.6,808875,1361357398.0,2685,2023-11-13 11:55:00
855,GAZP,4830,4344,1832062769.0,1792608515.0,1083830,1061813,169.04,168.83,2145643,3624671285.0,9174,4440,3859,1751130151.0,1716847743.0,1039764,1016249,168.42,168.94,2056013,3467977894.0,8299,2023-11-13 12:00:00
856,GAZP,4357,2546,1830986923.0,1025434368.0,1085027,606185,168.75,169.16,1691212,2856421291.0,6903,4101,2260,1797186552.0,970302376.0,1066151,574034,168.57,169.03,1640185,2767488929.0,6361,2023-11-13 12:05:00
857,GAZP,1748,1407,747875749.0,655404484.0,443842,387724,168.5,169.04,831566,1403280234.0,3155,1426,1181,705181351.0,621879794.0,418909,368107,168.34,168.94,787016,1327061145.0,2607,2023-11-13 12:10:00
858,GAZP,968,945,387964505.0,442372478.0,230462,261675,168.34,169.05,492137,830336984.0,1913,711,793,360678191.0,423536390.0,214405,250685,168.22,168.95,465090,784214581.0,1504,2023-11-13 12:15:00
859,GAZP,1797,1832,659864889.0,867175909.0,392007,513997,168.33,168.71,906004,1527040798.0,3629,1574,1698,642878057.0,860858570.0,382218,510263,168.2,168.71,892481,1503736628.0,3272,2023-11-13 12:20:00
860,GAZP,3396,2427,1272744532.0,824896662.0,755541,488624,168.45,168.82,1244165,2097641195.0,5823,3168,2247,1247570640.0,800917372.0,741286,474214,168.3,168.89,1215500,2048488013.0,5415,2023-11-13 12:25:00
861,GAZP,1585,1816,676239699.0,672065322.0,401834,398680,168.29,168.57,800514,1348305021.0,3401,1398,1609,666870313.0,646962172.0,396482,383372,168.2,168.76,779854,1313832485.0,3007,2023-11-13 12:30:00
862,GAZP,2194,2645,815122468.0,958537492.0,484708,568050,168.17,168.74,1052758,1773659961.0,4839,2004,2506,806590065.0,946567327.0,478956,561012,168.41,168.72,1039968,1753157393.0,4510,2023-11-13 12:35:00
863,GAZP,1496,1774,542533267.0,836239447.0,322720,496065,168.11,168.57,818785,1378772714.0,3270,1305,1629,525530743.0,821306387.0,312763,487154,168.03,168.59,799917,1346837131.0,2934,2023-11-13 12:40:00
864,GAZP,1028,955,391491550.0,395466037.0,232899,232885,168.09,169.81,465784,786957588.0,1983,859,874,378282500.0,379003058.0,225149,223637,168.01,169.47,448786,757285558.0,1733,2023-11-13 12:45:00
865,GAZP,1094,1395,348385119.0,624483867.0,207346,370258,168.02,168.66,577604,972868986.0,2489,934,1284,344750310.0,601780442.0,205245,356806,167.97,168.66,562051,946530752.0,2218,2023-11-13 12:50:00
866,GAZP,1969,1857,742545630.0,614495630.0,441839,364365,168.06,168.65,806204,1357041260.0,3826,1828,1646,701037778.0,588050497.0,417169,348744,168.05,168.62,765913,1289088276.0,3474,2023-11-13 12:55:00
867,GAZP,691,773,279599537.0,291520215.0,163477,172832,171.03,168.67,336309,571119753.0,1464,575,674,267913578.0,277190316.0,159440,164403,168.03,168.6,323843,545103895.0,1249,2023-11-13 13:00:00
868,GAZP,1159,1026,449169992.0,396959712.0,267093,235311,168.17,168.7,502404,846129704.0,2185,989,869,436483640.0,382190066.0,259675,226615,168.09,168.65,486290,818673706.0,1858,2023-11-13 13:05:00
869,GAZP,956,1520,341023448.0,805005093.0,202711,468370,168.23,171.87,671081,1146028541.0,2476,784,1358,338887814.0,620455405.0,201628,367882,168.08,168.66,569510,959343220.0,2142,2023-11-13 13:10:00
870,GAZP,1687,2046,538445212.0,804621486.0,320270,477866,168.12,168.38,798136,1343066699.0,3733,1539,1931,518791458.0,791375506.0,308699,469623,168.06,168.51,778322,1310166964.0,3470,2023-11-13 13:15:00
871,GAZP,782,698,296653120.0,299461773.0,176467,177560,168.11,168.65,354027,596114894.0,1480,659,606,292280432.0,290855371.0,173959,172501,168.02,168.61,346460,583135803.0,1265,2023-11-13 13:20:00
872,GAZP,836,1152,319862093.0,558934759.0,187706,331722,170.41,168.49,519428,878796853.0,1988,633,1014,309339356.0,540981164.0,184194,320879,167.94,168.59,505073,850320521.0,1647,2023-11-13 13:25:00
873,GAZP,1169,1363,336244864.0,417668485.0,200238,248176,167.92,168.3,448414,753913350.0,2532,962,1271,329986793.0,407742684.0,196527,242189,167.91,168.36,438716,737729478.0,2233,2023-11-13 13:30:00
874,GAZP,728,719,240930528.0,293235450.0,143445,174399,167.96,168.14,317844,534165979.0,1447,566,600,229608704.0,282018664.0,136780,167500,167.87,168.37,304280,511627369.0,1166,2023-11-13 13:35:00
875,GAZP,818,890,293896550.0,396428271.0,174918,236002,168.02,167.98,410920,690324821.0,1708,607,746,273080377.0,346250673.0,162686,205788,167.86,168.26,368474,619331051.0,1353,2023-11-13 13:40:00
876,GAZP,1196,1222,414301786.0,479012841.0,243656,284521,170.04,168.36,528177,893314628.0,2418,977,1101,401813348.0,469449006.0,239426,278793,167.82,168.39,518219,871262354.0,2078,2023-11-13 13:45:00
877,GAZP,2444,2786,748206210.0,1232323527.0,445427,731929,167.98,168.37,1177356,1980529737.0,5230,2277,2656,729761711.0,1214089106.0,434659,721005,167.89,168.39,1155664,1943850817.0,4933,2023-11-13 13:50:00
878,GAZP,1384,1162,508455696.0,461743732.0,302728,274179,167.96,168.41,576907,970199428.0,2546,1244,1050,475538501.0,463836348.0,283249,275367,167.89,168.44,558616,939374849.0,2294,2023-11-13 13:55:00
879,GAZP,756,1017,243048925.0,311687179.0,141928,185242,171.25,168.26,327170,554736105.0,1773,685,957,266947437.0,316750867.0,158896,188206,168.0,168.3,347102,583698305.0,1642,2023-11-13 14:00:00
880,GAZP,315,217,135569906.0,130428168.0,80625,77560,168.15,168.16,158185,265998074.0,532,154,131,126187873.0,129134479.0,75113,76705,168.0,168.35,151818,255322352.0,285,2023-11-13 14:05:00
881,GAZP,1838,1589,502780345.0,392692993.0,299063,233235,168.12,168.37,532298,895473338.0,3427,1676,1444,488869446.0,372114510.0,291070,220892,167.96,168.46,511962,860983957.0,3120,2023-11-13 14:10:00
882,GAZP,671,699,246909473.0,263678804.0,140104,156708,176.23,168.26,296812,510588277.0,1370,542,604,229563452.0,257058196.0,136688,152628,167.95,168.42,289316,486621648.0,1146,2023-11-13 14:15:00
883,GAZP,596,548,223999027.0,197956326.0,132488,117550,169.07,168.4,250038,421955353.0,1144,410,443,189459012.0,197407468.0,112752,117220,168.03,168.41,229972,386866481.0,853,2023-11-13 14:20:00
884,GAZP,651,624,262576951.0,230910241.0,156281,137257,168.02,168.23,293538,493487193.0,1275,562,536,262477769.0,221203315.0,156257,131274,167.98,168.51,287531,483681085.0,1098,2023-11-13 14:25:00
885,GAZP,1061,1032,483842064.0,398953470.0,288054,237249,167.97,168.16,525303,882795534.0,2093,904,951,475321708.0,378218750.0,283008,224580,167.95,168.41,507588,853540458.0,1855,2023-11-13 14:30:00
886,GAZP,1570,2109,628557167.0,760417408.0,374177,452095,167.98,168.2,826272,1388974575.0,3679,1350,1985,608404480.0,713317435.0,362285,423899,167.94,168.28,786184,1321721916.0,3335,2023-11-13 14:35:00
887,GAZP,1285,1934,478357276.0,545903967.0,285196,324441,167.73,168.26,609637,1024261243.0,3219,1113,1868,468806443.0,536523837.0,279481,318723,167.74,168.34,598204,1005330280.0,2981,2023-11-13 14:40:00
888,GAZP,2378,3326,697206979.0,1089152772.0,415334,647728,167.87,168.15,1063062,1786359751.0,5704,2199,3247,695032510.0,1084640347.0,414123,644977,167.83,168.17,1059100,1779672857.0,5446,2023-11-13 14:45:00
889,GAZP,927,1227,250690076.0,418025277.0,149192,248455,168.03,168.25,397647,668715354.0,2154,787,1171,243474154.0,408257680.0,145008,242642,167.9,168.26,387650,651731834.0,1958,2023-11-13 14:50:00
890,GAZP,361,457,145821847.0,167484656.0,86799,99556,168.0,168.23,186355,313306503.0,818,253,346,143724109.0,161489289.0,85588,95957,167.93,168.29,181545,305213398.0,599,2023-11-13 14:55:00
891,GAZP,952,1756,346419605.0,356011602.0,206263,211570,167.95,168.27,417833,702431207.0,2708,809,1687,355703429.0,355497079.0,211917,211255,167.85,168.28,423172,711200508.0,2496,2023-11-13 15:00:00
892,GAZP,1766,2500,654005710.0,847805106.0,389832,504228,167.77,168.14,894060,1501810816.0,4266,1574,2411,642793568.0,833342488.0,383212,495030,167.74,168.34,878242,1476136056.0,3985,2023-11-13 15:05:00
893,GAZP,1377,1838,428550845.0,517244729.0,255236,307558,167.9,168.18,562794,945795575.0,3215,1250,1752,421493684.0,517472371.0,251185,307548,167.8,168.26,558733,938966055.0,3002,2023-11-13 15:10:00
894,GAZP,960,951,379432724.0,338396400.0,225832,201210,168.02,168.18,427042,717829125.0,1911,795,863,366380353.0,326919336.0,218361,194266,167.79,168.28,412627,693299689.0,1658,2023-11-13 15:15:00
895,GAZP,1294,953,447965687.0,346037054.0,264158,205531,169.58,168.36,469689,794002742.0,2247,1154,877,434660280.0,333764141.0,258968,198170,167.84,168.42,457138,768424422.0,2031,2023-11-13 15:20:00
896,GAZP,1001,1356,328375450.0,334402847.0,195591,198712,167.89,168.29,394303,662778298.0,2357,895,1281,323304902.0,331363613.0,192585,196919,167.88,168.27,389504,654668515.0,2176,2023-11-13 15:25:00
897,GAZP,901,1079,247104138.0,268601248.0,147155,159745,167.92,168.14,306900,515705386.0,1980,780,1004,253666016.0,247516527.0,151210,147080,167.76,168.29,298290,501182543.0,1784,2023-11-13 15:30:00
898,GAZP,713,572,291031785.0,181601993.0,173306,107878,167.93,168.34,281184,472633778.0,1285,582,514,286733109.0,186693631.0,170785,110851,167.89,168.42,281636,473426741.0,1096,2023-11-13 15:35:00
899,GAZP,714,765,303982121.0,277086742.0,180985,164739,167.96,168.2,345724,581068863.0,1479,584,668,301816856.0,267771852.0,177018,159046,170.5,168.36,336064,569588709.0,1252,2023-11-13 15:40:00
900,GAZP,904,982,341662055.0,284904107.0,203445,169262,167.94,168.32,372707,626566163.0,1886,783,898,339742931.0,275628810.0,202339,163680,167.91,168.39,366019,615371741.0,1681,2023-11-13 15:45:00
901,GAZP,4634,9292,1095444824.0,4742100408.0,631048,2824151,173.59,167.91,3455199,5837545233.0,13926,4432,9224,1074349250.0,4694812680.0,620068,2793062,173.26,168.09,3413130,5769161931.0,13656,2023-11-13 15:50:00
902,GAZP,7716,17731,953093536.0,10862074326.0,567889,6450974,167.83,168.38,7018863,11815167862.0,25447,7575,17637,934851018.0,10838513823.0,557117,6447304,167.8,168.11,7004421,11773364841.0,25212,2023-11-13 15:55:00
903,GAZP,772,838,218882564.0,314335753.0,127798,186933,171.27,168.15,314731,533218317.0,1610,622,776,217439975.0,306779075.0,129769,182416,167.56,168.18,312185,524219051.0,1398,2023-11-13 16:00:00
904,GAZP,429,408,98771062.0,289735235.0,58841,164444,167.86,176.19,223285,388506297.0,837,306,313,84894253.0,72709981.0,50627,43217,167.69,168.24,93844,157604235.0,619,2023-11-13 16:05:00
905,GAZP,2540,2701,782020931.0,1014272758.0,466187,603817,167.75,167.98,1070004,1796293690.0,5241,2303,2597,771717373.0,997001336.0,460378,592767,167.63,168.19,1053145,1768718710.0,4900,2023-11-13 16:10:00
906,GAZP,928,850,330710982.0,345738475.0,188681,205476,175.28,168.26,394157,676449457.0,1778,789,793,290219678.0,345771457.0,173109,205427,167.65,168.32,378536,635991135.0,1582,2023-11-13 16:15:00
907,GAZP,1425,1659,434352099.0,585072397.0,258998,347726,167.7,168.26,606724,1019424497.0,3084,1291,1574,432546749.0,570766322.0,257968,339203,167.67,168.27,597171,1003313071.0,2865,2023-11-13 16:20:00
908,GAZP,1008,1351,296378700.0,515740590.0,175831,306740,168.56,168.14,482571,812119291.0,2359,853,1267,287951979.0,511464495.0,171740,304142,167.67,168.17,475882,799416475.0,2120,2023-11-13 16:25:00
909,GAZP,428,628,94033663.0,305501045.0,55801,181885,168.52,167.96,237686,399534708.0,1056,300,549,85016184.0,298263936.0,50492,177510,168.38,168.03,228002,383280120.0,849,2023-11-13 16:30:00
910,GAZP,506,1135,91669976.0,299362044.0,54562,178130,168.01,168.06,232692,391032020.0,1641,372,1068,81891888.0,295343805.0,48641,175665,168.36,168.13,224306,377235693.0,1440,2023-11-13 16:35:00
911,GAZP,1303,2062,215089996.0,521386353.0,128158,309996,167.83,168.19,438154,736476349.0,3365,1188,1989,212595865.0,516659300.0,126718,307191,167.77,168.19,433909,729255166.0,3177,2023-11-13 16:40:00
912,GAZP,1528,2479,368600420.0,903767152.0,219670,537327,167.8,168.2,756997,1272367573.0,4007,1411,2403,368133747.0,900462657.0,215236,535313,171.04,168.21,750549,1268596404.0,3814,2023-11-13 16:45:00
913,GAZP,1363,1434,415043931.0,458830531.0,243107,272380,170.72,168.45,515487,873874463.0,2797,1268,1338,393801341.0,453977734.0,234818,269467,167.7,168.47,504285,847779075.0,2606,2023-11-13 16:50:00
914,GAZP,1048,1210,345399428.0,386441993.0,205436,229473,168.13,168.4,434909,731841421.0,2258,943,1072,333817092.0,374391777.0,198659,222228,168.04,168.47,420887,708208870.0,2015,2023-11-13 16:55:00
915,GAZP,1267,1242,316982412.0,587850837.0,188753,349026,167.94,168.43,537779,904833249.0,2509,1141,1158,303124901.0,561375691.0,180561,333366,167.88,168.4,513927,864500592.0,2299,2023-11-13 17:00:00
916,GAZP,1304,1353,543563849.0,601100235.0,323341,357360,168.11,168.21,680701,1144664084.0,2657,1158,1260,491968746.0,589351448.0,290267,349781,169.49,168.49,640048,1081320194.0,2418,2023-11-13 17:05:00
917,GAZP,1054,841,382317186.0,336198816.0,227227,199619,168.25,168.42,426846,718516003.0,1895,914,727,386677452.0,329525040.0,230002,195542,168.12,168.52,425544,716202492.0,1641,2023-11-13 17:10:00
918,GAZP,478,585,190855831.0,272300520.0,113384,161666,168.33,168.43,275050,463156351.0,1063,373,494,187770364.0,260439106.0,111745,154527,168.03,168.54,266272,448209470.0,867,2023-11-13 17:15:00
919,GAZP,2106,1878,813200478.0,883040966.0,482853,523969,168.42,168.53,1006822,1696241445.0,3984,1936,1704,785789508.0,862327709.0,467271,511490,168.17,168.59,978761,1648117218.0,3640,2023-11-13 17:20:00
920,GAZP,2728,1804,1110535754.0,756942819.0,660555,449199,168.12,168.51,1109754,1867478573.0,4532,2612,1679,1103262319.0,739199050.0,656406,438389,168.08,168.62,1094795,1842461370.0,4291,2023-11-13 17:25:00
921,GAZP,2639,2285,875819355.0,801795668.0,521049,475499,168.09,168.62,996548,1677615023.0,4924,2532,2197,869570166.0,800544960.0,517552,474709,168.02,168.64,992261,1670115126.0,4729,2023-11-13 17:30:00
922,GAZP,3844,4305,1419179307.0,1335100605.0,844226,792422,168.1,168.48,1636648,2754279912.0,8149,3700,4201,1391922370.0,1321871882.0,828264,784209,168.05,168.56,1612473,2713794252.0,7901,2023-11-13 17:35:00
923,GAZP,1364,1454,455040087.0,456005864.0,270790,270560,168.04,168.54,541350,911045952.0,2818,1270,1374,472051100.0,450401145.0,280996,267189,167.99,168.57,548185,922452246.0,2644,2023-11-13 17:40:00
924,GAZP,1402,908,577067992.0,489312567.0,342935,290167,168.27,168.63,633102,1066380560.0,2310,1275,775,541564621.0,463475376.0,322179,274716,168.09,168.71,596895,1005039997.0,2050,2023-11-13 17:45:00
925,GAZP,1061,767,358950284.0,336905293.0,212852,199860,168.64,168.57,412712,695855577.0,1828,918,652,343994185.0,321395950.0,204503,190561,168.21,168.66,395064,665390135.0,1570,2023-11-13 17:50:00
926,GAZP,1945,1396,604198250.0,529627500.0,358566,314283,168.5,168.52,672849,1133825750.0,3341,1799,1297,590141976.0,523931274.0,350627,310706,168.31,168.63,661333,1114073251.0,3096,2023-11-13 17:55:00
927,GAZP,4236,5494,1197649999.0,2859764021.0,712769,1698489,168.03,168.37,2411258,4057414020.0,9730,4031,5371,1162377895.0,2828177382.0,692001,1678815,167.97,168.46,2370816,3990555277.0,9402,2023-11-13 18:00:00
928,GAZP,1605,1872,560848819.0,976386015.0,334039,579623,167.9,168.45,913662,1537234835.0,3477,1486,1769,542782708.0,964531114.0,323322,572413,167.88,168.5,895735,1507313823.0,3255,2023-11-13 18:05:00
929,GAZP,1107,1550,378960517.0,759309437.0,225585,451050,167.99,168.34,676635,1138269955.0,2657,974,1437,365562627.0,744540334.0,217725,442058,167.9,168.43,659783,1110102962.0,2411,2023-11-13 18:10:00
930,GAZP,2733,4401,441060973.0,1469744004.0,262426,873077,168.07,168.34,1135503,1910804977.0,7134,2590,4299,441276939.0,1461170534.0,262802,867923,167.91,168.35,1130725,1902447473.0,6889,2023-11-13 18:15:00
931,GAZP,2537,3480,561728031.0,1802185343.0,334481,1070280,167.94,168.38,1404761,2363913374.0,6017,2412,3387,564923919.0,1804097450.0,335612,1071261,168.33,168.41,1406873,2369021370.0,5799,2023-11-13 18:20:00
932,GAZP,524,490,125356024.0,145821857.0,74306,86668,168.7,168.25,160974,271177882.0,1014,390,442,107773177.0,140820784.0,64235,83582,167.78,168.48,147817,248593962.0,832,2023-11-13 18:25:00
933,GAZP,1126,1606,332147064.0,660924855.0,197638,392500,168.06,168.39,590138,993071920.0,2732,945,1514,303131234.0,647743887.0,180667,384598,167.78,168.42,565265,950875122.0,2459,2023-11-13 18:30:00
934,GAZP,877,1152,292206747.0,717640675.0,173839,425407,168.09,168.7,599246,1009847423.0,2029,758,1011,278394534.0,690935818.0,165795,410087,167.91,168.49,575882,969330352.0,1769,2023-11-13 18:35:00
935,GAZP,449,700,93600423.0,527273568.0,55702,313101,168.04,168.4,368803,620873992.0,1149,376,666,89384179.0,529060016.0,53232,314104,167.91,168.43,367336,618444195.0,1042,2023-11-13 18:40:00
936,GAZP,5015,10965,1678635965.0,9778379067.0,974009,5856398,172.34,166.97,6830407,11457015033.0,15980,2228,8912,1317463265.0,9415581368.0,790783,5634904,166.6,167.09,6425687,10733044633.0,11140,2023-11-14 10:05:00
937,GAZP,3237,3513,1171856334.0,1980993455.0,699341,1190518,167.57,166.4,1889859,3152849790.0,6750,1716,2617,1049800822.0,1784662218.0,628320,1069400,167.08,166.88,1697720,2834463041.0,4333,2023-11-14 10:10:00
938,GAZP,2870,5225,842196758.0,6032257652.0,501124,3612177,168.06,167.0,4113301,6874454411.0,8095,1310,4593,649280325.0,5909826778.0,390404,3539702,166.31,166.96,3930106,6559107103.0,5903,2023-11-14 10:15:00
939,GAZP,3183,3199,689619747.0,966895613.0,411276,576063,167.68,167.85,987339,1656515361.0,6382,1473,2170,615917598.0,830671089.0,370830,495666,166.09,167.59,866496,1446588687.0,3643,2023-11-14 10:20:00
940,GAZP,6425,5187,2544778132.0,2460668973.0,1511740,1483099,168.33,165.91,2994839,5005447106.0,11612,3644,3482,2261925453.0,2194942123.0,1357138,1318768,166.67,166.44,2675906,4456867577.0,7126,2023-11-14 10:25:00
941,GAZP,5923,4237,2254761251.0,1317474616.0,1344379,789271,167.72,166.92,2133650,3572235868.0,10160,4616,3562,2173904790.0,1228884831.0,1302635,736921,166.89,166.76,2039556,3402789622.0,8178,2023-11-14 10:30:00
942,GAZP,6171,4197,1423499345.0,773503735.0,855983,450507,166.3,171.7,1306490,2197003081.0,10368,4869,3785,1388805794.0,686275713.0,836145,403942,166.1,169.89,1240087,2075081508.0,8654,2023-11-14 10:35:00
943,GAZP,3269,1955,750286174.0,867775755.0,440437,515634,170.35,168.29,956071,1618061930.0,5224,1913,1602,661137884.0,811185802.0,384785,482420,171.82,168.15,867205,1472323687.0,3515,2023-11-14 10:40:00
944,GAZP,3605,5392,813439334.0,4145751405.0,490149,2492195,165.96,166.35,2982344,4959190740.0,8997,1668,3813,664249361.0,3959871926.0,400930,2377969,165.68,166.52,2778899,4624121288.0,5481,2023-11-14 10:45:00
945,GAZP,2426,1987,448319245.0,888188698.0,266769,534178,168.06,166.27,800947,1336507944.0,4413,1035,1566,373012385.0,829761728.0,224992,498890,165.79,166.32,723882,1202774114.0,2601,2023-11-14 10:50:00
946,GAZP,2713,2720,796895269.0,968008195.0,446357,581697,178.53,166.41,1028054,1764903465.0,5433,1715,2342,740366074.0,928618898.0,420252,554359,176.17,167.51,974611,1668984972.0,4057,2023-11-14 10:55:00
947,GAZP,1718,1544,382507852.0,541049545.0,227481,321583,168.15,168.25,549064,923557397.0,3262,939,1225,339512393.0,453128063.0,202137,271873,167.96,166.67,474010,792640457.0,2164,2023-11-14 11:00:00
948,GAZP,2021,2288,659804889.0,896133851.0,397497,538504,165.99,166.41,936001,1555938740.0,4309,1283,1883,645467983.0,856375856.0,389304,514140,165.8,166.56,903444,1501843840.0,3166,2023-11-14 11:05:00
949,GAZP,2137,1612,927545669.0,819450228.0,557542,491820,166.36,166.62,1049362,1746995897.0,3749,1462,1345,913826699.0,785393280.0,550371,471454,166.04,166.59,1021825,1699219980.0,2807,2023-11-14 11:10:00
950,GAZP,3732,4424,1866000031.0,2053615311.0,1123887,1235097,166.03,166.27,2358984,3919615343.0,8156,2888,3661,1801298127.0,1986616220.0,1086052,1193494,165.86,166.45,2279546,3787914348.0,6549,2023-11-14 11:15:00
951,GAZP,2504,4384,1276999994.0,1728347599.0,769727,1039857,165.9,166.21,1809584,3005347593.0,6888,1799,4061,1236424611.0,1688725142.0,745464,1015731,165.86,166.26,1761195,2925149753.0,5860,2023-11-14 11:20:00
952,GAZP,1657,1986,860514415.0,996802809.0,509333,599672,168.95,166.22,1109005,1857317224.0,3643,1068,1652,789531464.0,942669700.0,469589,566848,168.13,166.3,1036437,1732201165.0,2720,2023-11-14 11:25:00
953,GAZP,1602,2077,743915475.0,996859105.0,448335,600412,165.93,166.03,1048747,1740774580.0,3679,952,1659,697495990.0,947174595.0,421010,569773,165.67,166.24,990783,1644670586.0,2611,2023-11-14 11:30:00
954,GAZP,2767,3997,1306174640.0,1861894760.0,770056,1120412,169.62,166.18,1890468,3168069400.0,6764,2090,3553,1248880364.0,1815125593.0,737834,1091973,169.26,166.22,1829807,3064005957.0,5643,2023-11-14 11:35:00
955,GAZP,2606,3188,1015760005.0,1109544979.0,597114,667603,170.11,166.2,1264717,2125304984.0,5794,1954,2842,965558155.0,1073068607.0,570643,645651,169.21,166.2,1216294,2038626762.0,4796,2023-11-14 11:40:00
956,GAZP,2451,2250,994791371.0,881250260.0,579636,529918,171.62,166.3,1109554,1876041631.0,4701,1843,1900,947657722.0,841360637.0,551551,505846,171.82,166.33,1057397,1789018359.0,3743,2023-11-14 11:45:00
957,GAZP,1735,1809,669644036.0,651556127.0,403363,391287,166.02,166.52,794650,1321200164.0,3544,1396,1593,646053087.0,627536430.0,389602,376809,165.82,166.54,766411,1273589517.0,2989,2023-11-14 11:50:00
958,GAZP,1744,1993,716726655.0,710740735.0,431217,426786,166.21,166.53,858003,1427467391.0,3737,1380,1756,687232922.0,688548778.0,413993,413366,166.0,166.57,827359,1375781700.0,3136,2023-11-14 11:55:00
959,GAZP,2140,1799,895069083.0,734621116.0,538700,440902,166.15,166.62,979602,1629690199.0,3939,1780,1618,876561900.0,703875038.0,526849,422374,166.38,166.65,949223,1580436938.0,3398,2023-11-14 12:00:00
960,GAZP,3122,3295,1396935119.0,1587817635.0,813517,953021,171.72,166.61,1766538,2984752755.0,6417,2719,2983,1288146177.0,1531561598.0,748845,919184,172.02,166.62,1668029,2819707776.0,5702,2023-11-14 12:05:00
961,GAZP,2396,2905,884336444.0,1084780722.0,532256,651297,166.15,166.56,1183553,1969117166.0,5301,2050,2649,849360819.0,1073405974.0,511725,644361,165.98,166.58,1156086,1922766793.0,4699,2023-11-14 12:10:00
962,GAZP,2989,3113,1129248635.0,1138877242.0,677556,682727,166.66,166.81,1360283,2268125877.0,6102,2670,2845,1094046313.0,1107621814.0,657704,663865,166.34,166.84,1321569,2201668127.0,5515,2023-11-14 12:15:00
963,GAZP,1457,1437,609978466.0,554937692.0,366618,332692,166.38,166.8,699310,1164916158.0,2894,1153,1232,593870130.0,535415573.0,357197,320781,166.26,166.91,677978,1129285704.0,2385,2023-11-14 12:20:00
964,GAZP,1443,1327,552375564.0,479261372.0,332279,287308,166.24,166.81,619587,1031636937.0,2770,1123,1153,540355415.0,473706333.0,325169,283942,166.18,166.83,609111,1014061748.0,2276,2023-11-14 12:25:00
965,GAZP,2153,4422,766133617.0,1537394901.0,461278,923151,166.09,166.54,1384429,2303528519.0,6575,1773,4282,752432443.0,1449693947.0,453121,870174,166.06,166.6,1323295,2202126390.0,6055,2023-11-14 12:30:00
966,GAZP,2080,2389,756895695.0,896141280.0,456109,538397,165.95,166.45,994506,1653036975.0,4469,1725,2141,742449397.0,883791208.0,447572,530764,165.88,166.51,978336,1626240606.0,3866,2023-11-14 12:35:00
967,GAZP,1650,1650,653995362.0,571584662.0,393822,343045,166.06,166.62,736867,1225580025.0,3300,1377,1478,636753248.0,563514060.0,383752,338159,165.93,166.64,721911,1200267309.0,2855,2023-11-14 12:40:00
968,GAZP,2085,2735,713973191.0,1038776302.0,425976,624503,167.61,166.34,1050479,1752749494.0,4820,1581,2495,676438252.0,894020051.0,404872,537205,167.07,166.42,942077,1570458304.0,4076,2023-11-14 12:45:00
969,GAZP,2226,2168,772269894.0,923417632.0,426777,555118,180.95,166.35,981895,1695687526.0,4394,1690,1962,721024136.0,894496772.0,398408,537689,180.98,166.36,936097,1615520909.0,3652,2023-11-14 12:50:00
970,GAZP,1655,1553,535065504.0,415606771.0,316533,249623,169.04,166.49,566156,950672276.0,3208,1250,1395,456530473.0,385724321.0,268925,231582,169.76,166.56,500507,842254795.0,2645,2023-11-14 12:55:00
971,GAZP,1210,1028,501025799.0,430439791.0,280598,258273,178.56,166.66,538871,931465591.0,2238,844,905,484679605.0,400016780.0,271600,240025,178.45,166.66,511625,884696386.0,1749,2023-11-14 13:00:00
972,GAZP,1217,1396,538241646.0,615554499.0,313992,369234,171.42,166.71,683226,1153796146.0,2613,907,1205,516921167.0,595117744.0,301021,356908,171.72,166.74,657929,1112038911.0,2112,2023-11-14 13:05:00
973,GAZP,1395,1605,613184943.0,555624719.0,369320,333185,166.03,166.76,702505,1168809663.0,3000,1174,1504,603209390.0,558989182.0,363370,335144,166.0,166.79,698514,1162198573.0,2678,2023-11-14 13:10:00
974,GAZP,752,684,265846937.0,215105534.0,159894,129171,166.26,166.53,289065,480952472.0,1436,477,570,257834679.0,206575896.0,155161,123997,166.17,166.6,279158,464410575.0,1047,2023-11-14 13:15:00
975,GAZP,1005,1166,403702166.0,378336843.0,242904,227041,166.2,166.64,469945,782039009.0,2171,829,1074,397822400.0,368482126.0,239453,220990,166.14,166.74,460443,766304526.0,1903,2023-11-14 13:20:00
976,GAZP,630,659,196101410.0,204315918.0,117833,122691,166.42,166.53,240524,400417329.0,1289,396,538,185829708.0,193223895.0,111784,115931,166.24,166.67,227715,379053603.0,934,2023-11-14 13:25:00
977,GAZP,858,1028,343090444.0,327556793.0,206354,196503,166.26,166.69,402857,670647237.0,1886,610,877,333464698.0,320949627.0,200655,192462,166.19,166.76,393117,654414325.0,1487,2023-11-14 13:30:00
978,GAZP,1086,1252,416447198.0,385466224.0,250600,231252,166.18,166.69,481852,801913422.0,2338,855,1155,414339518.0,366256273.0,249378,219697,166.15,166.71,469075,780595791.0,2010,2023-11-14 13:35:00
979,GAZP,1353,1494,535767556.0,514696824.0,322485,309065,166.14,166.53,631550,1050464381.0,2847,1083,1366,534635531.0,497199380.0,321945,298430,166.06,166.61,620375,1031834912.0,2449,2023-11-14 13:40:00
980,GAZP,3109,3939,1225495342.0,1273354457.0,738500,765385,165.94,166.37,1503885,2498849799.0,7048,2642,3728,1196420977.0,1239071621.0,721272,744538,165.88,166.42,1465810,2435492598.0,6370,2023-11-14 13:45:00
981,GAZP,1207,1028,538926879.0,413877574.0,324454,248838,166.1,166.32,573292,952804454.0,2235,876,872,511074864.0,400045390.0,308143,240397,165.86,166.41,548540,911120255.0,1748,2023-11-14 13:50:00
982,GAZP,1719,1506,621325916.0,515750810.0,374329,309953,165.98,166.4,684282,1137076726.0,3225,1442,1392,599836404.0,506971711.0,361528,304672,165.92,166.4,666200,1106808116.0,2834,2023-11-14 13:55:00
983,GAZP,2100,1792,788725783.0,700989002.0,475074,420990,166.02,166.51,896064,1489714785.0,3892,1808,1698,779197732.0,694595230.0,469547,416936,165.95,166.6,886483,1473792962.0,3506,2023-11-14 14:00:00
984,GAZP,1182,1191,656814358.0,849321447.0,396054,510500,165.84,166.37,906554,1506135805.0,2373,1013,1063,658458154.0,817621812.0,397234,491237,165.76,166.44,888471,1476079966.0,2076,2023-11-14 14:05:00
985,GAZP,1948,2256,962151795.0,1141364017.0,579698,687058,165.97,166.12,1266756,2103515813.0,4204,1495,2004,900717893.0,1050770475.0,543056,631885,165.86,166.29,1174941,1951488368.0,3499,2023-11-14 14:10:00
986,GAZP,3020,4301,1164085612.0,3036869498.0,701806,1827533,165.87,166.17,2529339,4200955111.0,7321,2603,4143,1118132438.0,3023065980.0,674289,1819037,165.82,166.19,2493326,4141198419.0,6746,2023-11-14 14:15:00
987,GAZP,3153,3794,1127509132.0,2288952885.0,679861,1377076,165.84,166.22,2056937,3416462017.0,6947,2833,3670,1116963422.0,2273458185.0,673726,1367406,165.79,166.26,2041132,3390421608.0,6503,2023-11-14 14:20:00
988,GAZP,4678,5902,1213905472.0,1951611977.0,732042,1175870,165.82,165.97,1907912,3165517449.0,10580,4197,5662,1202845458.0,1885391133.0,726032,1134995,165.67,166.11,1861027,3088236591.0,9859,2023-11-14 14:25:00
989,GAZP,4210,5341,1281421380.0,1817196588.0,773457,1095060,165.67,165.94,1868517,3098617968.0,9551,3728,5107,1248144926.0,1791247316.0,753969,1076005,165.54,166.47,1829974,3039392243.0,8835,2023-11-14 14:30:00
990,GAZP,4516,5684,1034904696.0,2115688942.0,624455,1274986,165.73,165.94,1899441,3150593639.0,10200,3735,5354,988611936.0,2041309481.0,596707,1229709,165.68,166.0,1826416,3029921417.0,9089,2023-11-14 14:35:00
991,GAZP,4610,7398,913434233.0,2120510466.0,548385,1279027,166.57,165.79,1827412,3033944699.0,12008,3923,7205,863288432.0,2072663078.0,521439,1249386,165.56,165.89,1770825,2935951511.0,11128,2023-11-14 14:40:00
992,GAZP,2553,3215,709749474.0,1014778913.0,425405,611399,166.84,165.98,1036804,1724528388.0,5768,2110,3047,675936306.0,987886263.0,407920,595052,165.7,166.02,1002972,1663822570.0,5157,2023-11-14 14:45:00
993,GAZP,3197,4208,850754643.0,1442480993.0,505839,866831,168.19,166.41,1372670,2293235637.0,7405,2744,4070,812651477.0,1451220963.0,482879,871045,168.29,166.61,1353924,2263872441.0,6814,2023-11-14 14:50:00
994,GAZP,1856,2469,576775615.0,1001049524.0,347227,601070,166.11,166.54,948297,1577825140.0,4325,1554,2267,554453091.0,943469852.0,334087,567491,165.96,166.25,901578,1497922943.0,3821,2023-11-14 14:55:00
995,GAZP,1083,820,374418109.0,286330212.0,225536,172320,166.01,166.16,397856,660748321.0,1903,756,695,361734550.0,272882024.0,218007,164026,165.93,166.37,382033,634616575.0,1451,2023-11-14 15:00:00
996,GAZP,1121,1051,341821728.0,323191541.0,205928,194389,165.99,166.26,400317,665013269.0,2172,868,944,332165815.0,316071527.0,200216,189996,165.9,166.36,390212,648237342.0,1812,2023-11-14 15:05:00
997,GAZP,1170,861,401772975.0,316707350.0,241728,190518,166.21,166.23,432246,718480325.0,2031,859,714,386340223.0,301027324.0,232807,180642,165.95,166.64,413449,687367547.0,1573,2023-11-14 15:10:00
998,GAZP,2536,1453,1235075618.0,473896059.0,744357,285975,165.93,165.71,1030332,1708971677.0,3989,2134,1338,1218630432.0,456665937.0,734546,274629,165.9,166.28,1009175,1675296369.0,3472,2023-11-14 15:15:00
999,GAZP,2184,1095,1202354315.0,309398326.0,724567,186441,165.94,165.95,911008,1511752641.0,3279,1919,978,1190417011.0,301934677.0,717443,177982,165.92,169.64,895425,1492351688.0,2897,2023-11-14 15:20:00
1000,GAZP,1863,945,971777104.0,267048509.0,586369,160383,165.73,166.51,746752,1238825613.0,2808,1570,837,942308592.0,264547150.0,567860,158796,165.94,166.6,726656,1206855743.0,2407,2023-11-14 15:25:00
1001,GAZP,2635,439,2388522617.0,116244196.0,1439268,69944,165.95,166.2,1509212,2504766814.0,3074,2389,375,2379521846.0,105389821.0,1434010,63334,165.93,166.4,1497344,2484911668.0,2764,2023-11-14 15:30:00
1002,GAZP,1142,362,204693818.0,85137779.0,123192,51131,166.16,166.51,174323,289831598.0,1504,737,255,184564198.0,85013638.0,111126,51022,166.09,166.62,162148,269577836.0,992,2023-11-14 15:35:00
1003,GAZP,1285,1156,648202645.0,558532287.0,390018,335614,166.2,166.42,725632,1206734933.0,2441,1042,999,616235218.0,538485421.0,371072,323511,166.07,166.45,694583,1154720639.0,2041,2023-11-14 15:40:00
1004,GAZP,1273,469,751225396.0,200044358.0,452375,120196,166.06,166.43,572571,951269754.0,1742,1060,383,745100978.0,189492538.0,448751,113835,166.04,166.46,562586,934593516.0,1443,2023-11-14 15:45:00
1005,GAZP,1235,504,580633705.0,205398868.0,349642,123450,166.07,166.38,473092,786032574.0,1739,1050,433,570826149.0,198602462.0,343766,119265,166.05,166.52,463031,769428611.0,1483,2023-11-14 15:50:00
1006,GAZP,841,340,514882302.0,167026812.0,309860,100392,166.17,166.37,410252,681909114.0,1181,634,245,506226255.0,167039180.0,304818,100369,166.07,166.43,405187,673265435.0,879,2023-11-14 15:55:00
1007,GAZP,1171,869,440176403.0,393399577.0,261907,236265,168.07,166.51,498172,833575981.0,2040,800,721,366874858.0,381625133.0,220567,228950,166.33,166.68,449517,748499992.0,1521,2023-11-14 16:00:00
1008,GAZP,1244,1511,393946703.0,596225870.0,236934,358135,166.27,166.48,595069,990172574.0,2755,989,1348,376774904.0,572748700.0,226675,343918,166.22,166.54,570593,949523605.0,2337,2023-11-14 16:05:00
1009,GAZP,1964,1769,683987485.0,929037590.0,411329,558236,166.29,166.42,969565,1613025075.0,3733,1712,1646,671679973.0,917445774.0,404028,551162,166.25,166.46,955190,1589125747.0,3358,2023-11-14 16:10:00
1010,GAZP,1612,779,608278823.0,285516628.0,365900,171559,166.24,166.42,537459,893795451.0,2391,1461,706,601227412.0,277840797.0,361686,166871,166.23,166.5,528557,879068209.0,2167,2023-11-14 16:15:00
1011,GAZP,3201,2736,1216785562.0,1152751982.0,731992,692514,166.23,166.46,1424506,2369537545.0,5937,2895,2664,1206332641.0,1140168359.0,725670,684729,166.24,166.51,1410399,2346501000.0,5559,2023-11-14 16:20:00
1012,GAZP,1071,1739,321237458.0,981470634.0,193041,589636,166.41,166.45,782677,1302708092.0,2810,766,1668,312565671.0,985021259.0,188002,591642,166.26,166.49,779644,1297586931.0,2434,2023-11-14 16:25:00
1013,GAZP,1569,1010,433396646.0,462405603.0,260569,277829,166.33,166.44,538398,895802249.0,2579,1240,928,424156943.0,451409450.0,255130,271050,166.25,166.54,526180,875566393.0,2168,2023-11-14 16:30:00
1014,GAZP,1862,3155,819678150.0,2075722370.0,493118,1247481,166.22,166.39,1740599,2895400520.0,5017,1581,3040,807001759.0,2052474299.0,485615,1233239,166.18,166.43,1718854,2859476059.0,4621,2023-11-14 16:35:00
1015,GAZP,1846,1249,601910149.0,916837034.0,361830,549269,166.35,166.92,911099,1518747184.0,3095,1510,1166,588920919.0,899508727.0,354305,540516,166.22,166.42,894821,1488429646.0,2676,2023-11-14 16:40:00
1016,GAZP,1078,540,318833802.0,244890093.0,191379,147137,166.6,166.44,338516,563723895.0,1618,770,440,307688015.0,238289626.0,185122,143118,166.21,166.5,328240,545977641.0,1210,2023-11-14 16:45:00
1017,GAZP,1273,582,451177567.0,256080866.0,270657,153864,166.7,166.43,424521,707258433.0,1855,1004,489,410551279.0,250547716.0,246691,150327,166.42,166.67,397018,661098996.0,1493,2023-11-14 16:50:00
1018,GAZP,983,1020,392404979.0,455646459.0,235438,273065,166.67,166.86,508503,848051438.0,2003,724,915,365247980.0,438675155.0,219488,263332,166.41,166.59,482820,803923135.0,1639,2023-11-14 16:55:00
1019,GAZP,1174,2217,414584938.0,1036506467.0,246526,622715,168.17,166.45,869241,1451091405.0,3391,1012,2114,403964712.0,1027000626.0,242973,616899,166.26,166.48,859872,1430965339.0,3126,2023-11-14 17:00:00
1020,GAZP,1021,1208,366581882.0,624109147.0,220253,374971,166.44,166.44,595224,990691029.0,2229,805,1105,355693808.0,605987321.0,214276,363987,166.0,166.49,578263,961681129.0,1910,2023-11-14 17:05:00
1021,GAZP,1789,1413,672006357.0,634508731.0,404136,381150,166.28,166.47,785286,1306515088.0,3202,1598,1348,653094066.0,618541252.0,392930,371467,166.21,166.51,764397,1271635318.0,2946,2023-11-14 17:10:00
1022,GAZP,652,335,265074138.0,201388145.0,156544,120993,169.33,166.45,277537,466462284.0,987,449,324,240443824.0,209910103.0,144690,126057,166.18,166.52,270747,450353928.0,773,2023-11-14 17:15:00
1023,GAZP,2066,1169,867833473.0,515897447.0,520170,309705,166.84,166.58,829875,1383730920.0,3235,1805,1036,851028442.0,508349147.0,510932,305126,166.56,166.6,816058,1359377590.0,2841,2023-11-14 17:20:00
1024,GAZP,2162,3311,1059863560.0,1701685090.0,635287,1020946,166.83,166.68,1656233,2761548651.0,5473,1872,3097,1032765521.0,1649934899.0,619948,989514,166.59,166.74,1609462,2682700420.0,4969,2023-11-14 17:25:00
1025,GAZP,1765,3557,491477812.0,1869150200.0,294993,1121944,166.61,166.6,1416937,2360628012.0,5322,1602,3448,484458758.0,1872766353.0,291055,1123925,166.45,166.63,1414980,2357225111.0,5050,2023-11-14 17:30:00
1026,GAZP,1083,727,475134078.0,373631686.0,284945,213319,166.75,175.15,498264,848765765.0,1810,948,610,454611977.0,340050638.0,272985,203945,166.53,166.74,476930,794662615.0,1558,2023-11-14 17:35:00
1027,GAZP,1634,1597,632022608.0,718663295.0,379701,431733,166.45,166.46,811434,1350685903.0,3231,1463,1441,622585958.0,698844411.0,374335,419535,166.32,166.58,793870,1321430370.0,2904,2023-11-14 17:40:00
1028,GAZP,1287,584,457523914.0,1572281661.0,274952,171261,166.4,918.06,446213,2029805576.0,1871,1099,504,444323556.0,1531421018.0,267087,148832,166.36,1028.96,415919,1975744574.0,1603,2023-11-14 17:45:00
1029,GAZP,1110,770,459096170.0,330942953.0,275536,197444,166.62,167.61,472980,790039123.0,1880,925,605,454756419.0,335345661.0,265366,198927,171.37,168.58,464293,790102081.0,1530,2023-11-14 17:50:00
1030,GAZP,2404,2482,878189065.0,1198217954.0,527883,704879,166.36,169.99,1232762,2076407020.0,4886,2162,2363,866958520.0,1034836144.0,521197,620068,166.34,166.89,1141265,1901794664.0,4525,2023-11-14 17:55:00
1031,GAZP,975,1381,305825952.0,753330755.0,183886,446131,166.31,168.86,630017,1059156707.0,2356,823,1305,295757356.0,735374768.0,177888,436111,166.26,168.62,613999,1031132124.0,2128,2023-11-14 18:00:00
1032,GAZP,479,447,196527672.0,223018069.0,118023,128477,166.52,173.59,246500,419545742.0,926,321,363,176550266.0,214328876.0,106256,123116,166.16,174.09,229372,390879143.0,684,2023-11-14 18:05:00
1033,GAZP,2768,4339,779743296.0,1956745459.0,468768,1175760,166.34,166.42,1644528,2736488755.0,7107,2577,4249,759159868.0,1937342693.0,456689,1163742,166.23,166.48,1620431,2696502562.0,6826,2023-11-14 18:10:00
1034,GAZP,1482,2206,449980394.0,928343268.0,270608,554310,166.28,167.48,824918,1378323663.0,3688,1252,2129,437321502.0,920762539.0,263049,553087,166.25,166.48,816136,1358084041.0,3381,2023-11-14 18:15:00
1035,GAZP,754,541,235553630.0,147386269.0,141734,88493,166.19,166.55,230227,382939900.0,1295,567,455,222871640.0,134199991.0,134142,80508,166.15,166.69,214650,357071631.0,1022,2023-11-14 18:20:00
1036,GAZP,1652,1538,1028360417.0,558086405.0,618553,335676,166.25,166.26,954229,1586446822.0,3190,1448,1409,990888379.0,521495049.0,595967,313220,166.27,166.49,909187,1512383429.0,2857,2023-11-14 18:25:00
1037,GAZP,1076,1061,332933812.0,273243331.0,200330,164425,166.19,166.18,364755,606177144.0,2137,871,957,338052390.0,265221624.0,203557,159330,166.07,166.46,362887,603274014.0,1828,2023-11-14 18:30:00
1038,GAZP,912,485,450261457.0,113497882.0,270807,68234,166.27,166.34,339041,563759339.0,1397,738,388,428396349.0,96578141.0,257738,57911,166.21,166.77,315649,524974490.0,1126,2023-11-14 18:35:00
1039,GAZP,588,537,184667382.0,161492334.0,111108,97180,166.21,166.18,208288,346159717.0,1125,492,504,181194489.0,137945684.0,109051,82838,166.16,166.52,191889,319140173.0,996,2023-11-14 18:40:00
1040,GAZP,9492,13315,157226954.0,157226954.0,968058,2338992,16.24,16.38,3307050,540316796.0,22807,8622,12544,145655689.0,145655689.0,889154,2247328,16.38,16.41,3136482,514406779.0,21166,2023-11-29 10:05:00
1041,GAZP,4272,3944,65357178.0,65357178.0,401971,631508,16.26,16.28,1033479,168185809.0,8216,3878,3667,63075267.0,63075267.0,384781,600102,16.39,16.42,984883,161619044.0,7545,2023-11-29 10:10:00
1042,GAZP,4676,4234,123938792.0,123938792.0,763267,527895,16.24,16.34,1291162,210221721.0,8910,4230,3861,119575110.0,119575110.0,727198,490592,16.44,16.46,1217790,200351008.0,8091,2023-11-29 10:15:00
1043,GAZP,1963,1870,56427974.0,56427974.0,346155,338456,16.3,16.46,684611,112141511.0,3833,1713,1693,53201976.0,53201976.0,324132,322134,16.41,16.48,646266,106296010.0,3406,2023-11-29 10:20:00
1044,GAZP,3784,2764,114271626.0,114271626.0,703590,636182,16.24,16.46,1339772,218961628.0,6548,3114,2338,105099045.0,105099045.0,638126,598536,16.47,16.51,1236662,203909863.0,5452,2023-11-29 10:25:00
1045,GAZP,8330,6597,269581755.0,269581755.0,1660657,1608744,16.23,16.42,3269401,533761998.0,14927,7432,5705,261209226.0,261209226.0,1582812,1403732,16.5,16.56,2986544,493644076.0,13137,2023-11-29 10:30:00
1046,GAZP,4689,4418,159817197.0,159817197.0,981170,1359765,16.29,16.5,2340935,384187600.0,9107,4107,3955,150929885.0,150929885.0,913685,1410788,16.52,16.56,2324473,384579569.0,8062,2023-11-29 10:35:00
1047,GAZP,2819,4112,83531808.0,83531808.0,507888,1464777,16.45,16.53,1972665,325625027.0,6931,2474,3722,79811732.0,79811732.0,483159,1417938,16.52,16.56,1901097,314675260.0,6196,2023-11-29 10:40:00
1048,GAZP,1576,1348,52232784.0,52232784.0,318020,377153,16.42,16.04,695173,112741173.0,2924,1315,1084,49669689.0,49669689.0,301321,346886,16.48,16.53,648207,107019053.0,2399,2023-11-29 10:45:00
1049,GAZP,1584,655,63714482.0,63714482.0,392709,308519,16.22,16.23,701228,113796084.0,2239,1223,531,59435227.0,59435227.0,361045,217597,16.46,16.51,578642,95367943.0,1754,2023-11-29 10:50:00
1050,GAZP,4189,1517,127335833.0,127335833.0,777290,503596,16.38,16.39,1280886,209850321.0,5706,3816,1253,123173944.0,123173944.0,750007,551498,16.42,16.49,1301505,214143295.0,5069,2023-11-29 10:55:00
1051,GAZP,5911,7834,221267354.0,221267354.0,1365872,2280679,16.2,16.37,3646551,594564975.0,13745,5159,7402,216378737.0,216378737.0,1318876,2148520,16.41,16.44,3467396,569491841.0,12561,2023-11-29 11:00:00
1052,GAZP,5772,7033,144497769.0,144497769.0,895408,2176089,16.14,16.47,3071497,502894766.0,12805,5526,6746,141297869.0,141297869.0,859520,2141876,16.44,16.48,3001396,494301624.0,12272,2023-11-29 11:05:00
1053,GAZP,1483,1531,56604467.0,56604467.0,346313,570934,16.34,16.4,917247,150234144.0,3014,1307,1336,54812366.0,54812366.0,333372,550428,16.44,16.5,883800,145634080.0,2643,2023-11-29 11:10:00
1054,GAZP,2705,4269,76686221.0,76686221.0,468925,1078639,16.35,16.44,1547564,254058984.0,6974,2480,4192,75379383.0,75379383.0,459423,1068830,16.41,16.47,1528253,251437579.0,6672,2023-11-29 11:15:00
1055,GAZP,1410,1890,49862221.0,49862221.0,305089,473887,16.34,16.48,778976,127970700.0,3300,1258,1755,42092598.0,42092598.0,256372,460489,16.42,16.48,716861,117991770.0,3013,2023-11-29 11:20:00
1056,GAZP,2471,2480,77066884.0,77066884.0,470867,663411,16.37,16.44,1134278,186122128.0,4951,2306,2332,74339005.0,74339005.0,452972,658387,16.41,16.47,1111359,182804559.0,4638,2023-11-29 11:25:00
1057,GAZP,2601,2785,80448492.0,80448492.0,496611,629921,16.2,16.46,1126532,184131623.0,5386,2446,2616,78498787.0,78498787.0,478509,611627,16.4,16.48,1090136,179265049.0,5062,2023-11-29 11:30:00
1058,GAZP,2925,3649,87109397.0,87109397.0,536043,696067,16.25,16.48,1232110,201853889.0,6574,2768,3476,84992001.0,84992001.0,516868,681551,16.44,16.5,1198419,197445059.0,6244,2023-11-29 11:35:00
1059,GAZP,1599,1632,50094169.0,50094169.0,305131,347762,16.42,16.47,652893,107387927.0,3231,1502,1518,49946249.0,49946249.0,303942,339263,16.43,16.5,643205,105919941.0,3020,2023-11-29 11:40:00
1060,GAZP,1556,1333,68169903.0,68169903.0,423499,242788,16.1,16.41,666287,108003495.0,2889,1419,1161,66455035.0,66455035.0,404475,225941,16.43,16.49,630416,103722069.0,2580,2023-11-29 11:45:00
1061,GAZP,3786,3762,122154460.0,122154460.0,751001,694042,16.27,16.37,1445043,235795572.0,7548,3584,3371,120895456.0,120895456.0,737586,660828,16.39,16.45,1398414,229604035.0,6955,2023-11-29 11:50:00
1062,GAZP,6760,6413,268556207.0,268556207.0,1650306,1373412,16.27,16.39,3023718,493672728.0,13173,6473,5996,264844089.0,264844089.0,1615373,1331841,16.4,16.46,2947214,484050849.0,12469,2023-11-29 11:55:00
1063,GAZP,2546,1841,80514461.0,80514461.0,490658,322982,16.41,16.44,813640,133600753.0,4387,2444,1735,78535567.0,78535567.0,478393,315688,16.42,16.47,794081,130532147.0,4179,2023-11-29 12:00:00
1064,GAZP,1245,803,54540609.0,54540609.0,333289,113682,16.36,16.12,446971,72862228.0,2048,1138,666,53314662.0,53314662.0,324525,96220,16.43,16.49,420745,69177140.0,1804,2023-11-29 12:05:00
1065,GAZP,5197,2048,311500541.0,311500541.0,1897400,242043,16.42,16.46,2139443,351339576.0,7245,5039,1904,309824768.0,309824768.0,1884613,233043,16.44,16.49,2117656,348256187.0,6943,2023-11-29 12:10:00
1066,GAZP,2227,1842,82304281.0,82304281.0,501298,275591,16.42,16.4,776889,127491971.0,4069,2130,1743,82231742.0,82231742.0,500605,275601,16.43,16.49,776206,127684283.0,3873,2023-11-29 12:15:00
1067,GAZP,3312,2168,158490862.0,158490862.0,971831,443904,16.31,16.38,1415735,231209455.0,5480,3088,2059,157209598.0,157209598.0,958514,432810,16.4,16.45,1391324,228425035.0,5147,2023-11-29 12:20:00
1068,GAZP,2120,2657,76135599.0,76135599.0,467628,521557,16.28,16.39,989185,161613096.0,4777,1985,2546,75430623.0,75430623.0,459708,508070,16.41,16.47,967778,159087855.0,4531,2023-11-29 12:25:00
1069,GAZP,731,825,25023955.0,25023955.0,152857,161729,16.37,16.42,314586,51572399.0,1556,647,701,24567864.0,24567864.0,149794,155908,16.4,16.47,305702,50250158.0,1348,2023-11-29 12:30:00
1070,GAZP,946,1502,26724231.0,26724231.0,163110,499828,16.38,16.41,662938,108725851.0,2448,841,1420,25960095.0,25960095.0,158362,494746,16.39,16.44,653108,107281080.0,2261,2023-11-29 12:35:00
1071,GAZP,929,1048,29577629.0,29577629.0,185847,215131,15.92,16.39,400978,64844035.0,1977,808,960,27584744.0,27584744.0,168342,203081,16.39,16.45,371423,60987562.0,1768,2023-11-29 12:40:00
1072,GAZP,3858,6783,76098214.0,76098214.0,478911,1718165,15.89,16.45,2197076,358762000.0,10641,3752,6603,75144980.0,75144980.0,457741,1700525,16.42,16.46,2158266,354994054.0,10355,2023-11-29 12:45:00
1073,GAZP,1111,1509,33216168.0,33216168.0,202527,338462,16.4,16.45,540989,88890360.0,2620,966,1414,31206238.0,31206238.0,189958,337164,16.43,16.49,527122,86806148.0,2380,2023-11-29 12:50:00
1074,GAZP,1476,1772,35954202.0,35954202.0,226266,286154,15.89,16.43,512420,82963654.0,3248,1340,1617,35868145.0,35868145.0,218375,275222,16.43,16.5,493597,81272529.0,2957,2023-11-29 12:55:00
1075,GAZP,1124,1461,31267002.0,31267002.0,190889,270999,16.38,16.46,461888,75873254.0,2585,1026,1347,29856798.0,29856798.0,181865,265636,16.42,16.49,447501,73647254.0,2373,2023-11-29 13:00:00
1076,GAZP,662,749,23839350.0,23839350.0,145922,142930,16.34,16.14,288852,46903901.0,1411,532,671,22960769.0,22960769.0,139774,137344,16.43,16.49,277118,45609093.0,1203,2023-11-29 13:05:00
1077,GAZP,494,591,13479775.0,13479775.0,87192,90631,15.46,16.43,177823,28367292.0,1085,427,516,13678759.0,13678759.0,83224,85363,16.44,16.48,168587,27743038.0,943,2023-11-29 13:10:00
1078,GAZP,365,486,8346336.0,8346336.0,51079,77678,16.34,16.15,128757,20888399.0,851,296,408,7181105.0,7181105.0,43730,69741,16.42,16.48,113471,18676621.0,704,2023-11-29 13:15:00
1079,GAZP,337,536,7788676.0,7788676.0,49292,83662,15.8,16.4,132954,21508616.0,873,236,465,7830844.0,7830844.0,47730,81533,16.41,16.48,129263,21271237.0,701,2023-11-29 13:20:00
1080,GAZP,522,590,17539665.0,17539665.0,106963,104986,16.4,16.43,211949,34784617.0,1112,453,534,16551079.0,16551079.0,100813,101331,16.42,16.49,202144,33263578.0,987,2023-11-29 13:25:00
1081,GAZP,802,930,31521301.0,31521301.0,198044,173202,15.92,16.23,371246,59624827.0,1732,710,814,31144893.0,31144893.0,189747,159912,16.41,16.48,349659,57495603.0,1524,2023-11-29 13:30:00
1082,GAZP,917,848,41003870.0,41003870.0,250185,171647,16.39,16.36,421832,69081037.0,1765,829,800,40622410.0,40622410.0,247539,227817,16.41,16.52,475356,78248087.0,1629,2023-11-29 13:35:00
1083,GAZP,8338,512,541072921.0,541072921.0,3297996,76925,16.41,16.28,3374921,553599361.0,8850,8174,436,540603067.0,540603067.0,3294680,74201,16.41,16.45,3368881,552805558.0,8610,2023-11-29 13:40:00
1084,GAZP,1172,979,86617255.0,86617255.0,533379,176348,16.24,16.41,709727,115552279.0,2151,1065,848,85966851.0,85966851.0,523893,170121,16.41,16.47,694014,113978634.0,1913,2023-11-29 13:45:00
1085,GAZP,1319,1584,52406403.0,52406403.0,329954,289073,15.88,16.45,619027,99972267.0,2903,1197,1331,51346434.0,51346434.0,313143,225993,16.4,16.46,539136,88538430.0,2528,2023-11-29 13:50:00
1086,GAZP,1932,2161,59026263.0,59026263.0,361916,563956,16.31,16.36,925872,151264743.0,4093,1662,1980,55119826.0,55119826.0,336638,465330,16.37,16.44,801968,131618541.0,3642,2023-11-29 13:55:00
1087,GAZP,1049,2485,27198852.0,27198852.0,166980,1225834,16.29,16.46,1392814,228982419.0,3534,880,2422,25678975.0,25678975.0,157134,1190083,16.34,16.44,1347217,221269236.0,3302,2023-11-29 14:00:00
1088,GAZP,316,7934,8561801.0,8561801.0,52960,4886773,16.17,16.43,4939733,811537318.0,8250,175,7859,7857331.0,7857331.0,48037,4887994,16.36,16.43,4936031,811144947.0,8034,2023-11-29 14:05:00
1089,GAZP,890,3625,33844944.0,33844944.0,210080,1829170,16.11,16.43,2039250,334344778.0,4515,745,3494,32706675.0,32706675.0,199915,1814045,16.36,16.43,2013960,330713182.0,4239,2023-11-29 14:10:00
1090,GAZP,262,309,7748369.0,7748369.0,48103,60625,16.11,16.42,108728,17702152.0,571,165,240,7112751.0,7112751.0,43461,58008,16.37,16.44,101469,16651945.0,405,2023-11-29 14:15:00
1091,GAZP,930,2004,36932754.0,36932754.0,227158,625875,16.26,15.86,853033,136192578.0,2934,739,1776,35129280.0,35129280.0,214973,595441,16.34,16.41,810414,132853459.0,2515,2023-11-29 14:20:00
1092,GAZP,3459,6737,118865757.0,118865757.0,742083,2009088,16.02,15.95,2751171,439292534.0,10196,2512,5454,109842755.0,109842755.0,674160,1917238,16.29,16.36,2591398,423583341.0,7966,2023-11-29 14:25:00
1093,GAZP,4196,4574,137388975.0,137388975.0,855801,864368,16.05,16.34,1720169,278599121.0,8770,3970,4275,136281413.0,136281413.0,834704,848757,16.33,16.39,1683461,275385758.0,8245,2023-11-29 14:30:00
1094,GAZP,2372,3174,77240468.0,77240468.0,474772,607694,16.27,16.37,1082466,176711467.0,5546,2127,3065,74336686.0,74336686.0,455418,594684,16.32,16.4,1050102,171835671.0,5192,2023-11-29 14:35:00
1095,GAZP,3096,4779,64198583.0,64198583.0,397966,796854,16.13,16.37,1194820,194660649.0,7875,2953,4662,63064744.0,63064744.0,386166,796231,16.33,16.39,1182397,193559953.0,7615,2023-11-29 14:40:00
1096,GAZP,1121,1188,33643238.0,33643238.0,206414,195912,16.3,16.28,402326,65534837.0,2309,966,1106,33351459.0,33351459.0,204366,186854,16.32,16.39,391220,63970970.0,2072,2023-11-29 14:45:00
1097,GAZP,7173,7660,158599754.0,158599754.0,971110,1943091,16.33,16.38,2914201,476879620.0,14833,7045,7553,150331819.0,150331819.0,919638,1938867,16.35,16.38,2858505,467966551.0,14598,2023-11-29 14:50:00
1098,GAZP,3785,5298,269042204.0,269042204.0,1644209,975380,16.36,16.42,2619589,429167255.0,9083,3610,5191,276343908.0,276343908.0,1688601,974771,16.37,16.43,2663372,436460225.0,8801,2023-11-29 14:55:00
1099,GAZP,3416,2932,100799063.0,100799063.0,617209,528101,16.33,16.37,1145310,187258009.0,6348,3289,2840,98510494.0,98510494.0,602558,515798,16.35,16.42,1118356,183195543.0,6129,2023-11-29 15:00:00
1100,GAZP,509,453,12452393.0,12452393.0,76817,80728,16.21,16.33,157545,25635080.0,962,367,394,10700679.0,10700679.0,65546,79485,16.33,16.41,145031,23743586.0,761,2023-11-29 15:05:00
1101,GAZP,993,1247,25811788.0,25811788.0,158514,255625,16.28,16.38,414139,67694668.0,2240,877,1176,24821253.0,24821253.0,152083,254399,16.32,16.4,406482,66542841.0,2053,2023-11-29 15:10:00
1102,GAZP,585,718,12702380.0,12702380.0,77907,105767,16.3,16.39,183674,30042620.0,1303,489,653,12236868.0,12236868.0,74909,103653,16.34,16.4,178562,29235841.0,1142,2023-11-29 15:15:00
1103,GAZP,850,918,24736636.0,24736636.0,152192,176813,16.25,16.39,329005,53718350.0,1768,747,822,24507273.0,24507273.0,149986,171914,16.34,16.41,321900,52714349.0,1569,2023-11-29 15:20:00
1104,GAZP,1816,2755,52847211.0,52847211.0,324373,598650,16.29,16.38,923023,150905698.0,4571,1740,2695,52539599.0,52539599.0,321994,593368,16.32,16.39,915362,149820769.0,4435,2023-11-29 15:25:00
1105,GAZP,760,960,15787429.0,15787429.0,96847,132629,16.3,16.4,229476,37534792.0,1720,642,874,17029274.0,17029274.0,104291,132622,16.33,16.4,236913,38783912.0,1516,2023-11-29 15:30:00
1106,GAZP,1837,1108,34450094.0,34450094.0,210941,158976,16.33,16.39,369917,60510339.0,2945,1718,1040,33348403.0,33348403.0,204047,156236,16.34,16.43,360283,59010914.0,2758,2023-11-29 15:35:00
1107,GAZP,1306,2007,34169147.0,34169147.0,211642,460142,16.14,16.43,671784,109761240.0,3313,1175,1874,33418443.0,33418443.0,204179,456376,16.37,16.44,660555,108430481.0,3049,2023-11-29 15:40:00
1108,GAZP,1307,2035,34370646.0,34370646.0,210270,423774,16.35,16.42,634044,103955463.0,3342,1226,1927,34062808.0,34062808.0,208176,415327,16.36,16.44,623503,102339188.0,3153,2023-11-29 15:45:00
1109,GAZP,546,810,15913637.0,15913637.0,97357,158824,16.35,16.28,256181,41771087.0,1356,437,714,15314635.0,15314635.0,93530,151286,16.37,16.45,244816,40195789.0,1151,2023-11-29 15:50:00
1110,GAZP,750,965,18110845.0,18110845.0,110885,179694,16.33,16.34,290579,47481113.0,1715,677,930,18218983.0,18218983.0,111437,179044,16.35,16.44,290481,47658948.0,1607,2023-11-29 15:55:00
1111,GAZP,634,582,17097249.0,17097249.0,104605,108901,16.34,16.19,213506,34733304.0,1216,545,502,16816981.0,16816981.0,102791,105132,16.36,16.44,207923,34100295.0,1047,2023-11-29 16:00:00
1112,GAZP,307,278,2273940.0,2273940.0,14072,65789,16.16,16.39,79861,13058971.0,585,214,230,2289376.0,2289376.0,14018,61733,16.33,16.41,75751,12421209.0,444,2023-11-29 16:05:00
1113,GAZP,1020,1117,9293536.0,9293536.0,57110,226854,16.27,16.43,283964,46569684.0,2137,938,1038,9614432.0,9614432.0,58810,216694,16.35,16.4,275504,45153194.0,1976,2023-11-29 16:10:00
1114,GAZP,267,236,2830287.0,2830287.0,17387,19820,16.28,15.7,37207,5941804.0,503,194,168,2446578.0,2446578.0,14961,17169,16.35,16.55,32130,5288041.0,362,2023-11-29 16:15:00
1115,GAZP,982,1343,19631895.0,19631895.0,122317,271325,16.05,16.31,393642,63888593.0,2325,912,1249,19233480.0,19233480.0,117622,259288,16.35,16.41,376910,61791814.0,2161,2023-11-29 16:20:00
1116,GAZP,3207,3309,91481295.0,91481295.0,559408,601105,16.35,16.37,1160513,189911520.0,6516,3134,3239,91413148.0,91413148.0,558594,591650,16.36,16.42,1150244,188577407.0,6373,2023-11-29 16:25:00
1117,GAZP,1718,2886,28376927.0,28376927.0,173711,582841,16.34,16.6,756552,125140175.0,4604,1657,2811,28504684.0,28504684.0,174326,505508,16.35,16.41,679834,111461004.0,4468,2023-11-29 16:30:00
1118,GAZP,1730,2160,52144604.0,52144604.0,320323,488356,16.28,16.35,808679,131972231.0,3890,1474,2025,48387520.0,48387520.0,296358,459032,16.33,16.41,755390,123708128.0,3499,2023-11-29 16:35:00
1119,GAZP,986,1448,31772377.0,31772377.0,195134,331511,16.28,16.38,526645,86074258.0,2434,872,1361,30829061.0,30829061.0,188981,331622,16.31,16.4,520603,85205082.0,2233,2023-11-29 16:40:00
1120,GAZP,794,1149,20794546.0,20794546.0,128717,207124,16.16,16.31,335841,54566188.0,1943,643,1058,19995581.0,19995581.0,122737,201897,16.29,16.37,324634,53055472.0,1701,2023-11-29 16:45:00
1121,GAZP,1269,1957,33045885.0,33045885.0,210412,378084,15.71,16.33,588496,94769729.0,3226,1155,1815,32011237.0,32011237.0,196247,372524,16.31,16.4,568771,93088942.0,2970,2023-11-29 16:50:00
1122,GAZP,2948,7861,33277097.0,33277097.0,203901,1547276,16.32,16.39,1751177,286859759.0,10809,2873,7786,33028207.0,33028207.0,202183,1539413,16.34,16.38,1741596,285260060.0,10659,2023-11-29 16:55:00
1123,GAZP,857,1310,22726463.0,22726463.0,139545,255869,16.29,16.06,395414,63815330.0,2167,692,1237,21786312.0,21786312.0,133674,239994,16.3,16.39,373668,61125781.0,1929,2023-11-29 17:00:00
1124,GAZP,704,526,7588531.0,7588531.0,48046,57274,15.79,16.29,105320,16920550.0,1230,574,453,9513480.0,9513480.0,59022,50447,16.12,16.38,109469,17775970.0,1027,2023-11-29 17:05:00
1125,GAZP,612,480,11511440.0,11511440.0,73419,83698,15.68,16.32,157117,25174512.0,1092,352,401,7839965.0,7839965.0,48131,81116,16.29,16.38,129247,21123434.0,753,2023-11-29 17:10:00
1126,GAZP,717,700,14748074.0,14748074.0,93317,112141,15.8,16.38,205458,33114546.0,1417,474,626,15139769.0,15139769.0,92932,101549,16.29,16.37,194481,31766038.0,1100,2023-11-29 17:15:00
1127,GAZP,880,849,18583142.0,18583142.0,115751,160032,16.05,16.32,275783,44707782.0,1729,761,769,17995655.0,17995655.0,110477,154578,16.29,16.37,265055,43307411.0,1530,2023-11-29 17:20:00
1128,GAZP,814,886,19256121.0,19256121.0,118441,202068,16.26,16.37,320509,52340812.0,1700,731,798,18696329.0,18696329.0,114746,200797,16.29,16.39,315543,51600100.0,1529,2023-11-29 17:25:00
1129,GAZP,2524,3724,31435364.0,31435364.0,193379,667021,16.26,16.34,860400,140402729.0,6248,2415,3583,31124122.0,31124122.0,190838,662998,16.31,16.36,853836,139566648.0,5998,2023-11-29 17:30:00
1130,GAZP,1163,1312,26254558.0,26254558.0,162118,246878,16.19,15.96,408996,65648393.0,2475,1019,1242,24981153.0,24981153.0,153372,235810,16.29,16.37,389182,63583172.0,2261,2023-11-29 17:35:00
1131,GAZP,428,430,11872957.0,11872957.0,73355,81431,16.19,16.36,154786,25197163.0,858,306,392,11058513.0,11058513.0,67844,80405,16.3,16.38,148249,24229886.0,698,2023-11-29 17:40:00
1132,GAZP,608,706,18720667.0,18720667.0,115492,150686,16.21,16.36,266178,43373326.0,1314,514,646,17709189.0,17709189.0,108712,144370,16.29,16.39,253082,41367587.0,1160,2023-11-29 17:45:00
1133,GAZP,1233,2441,28410218.0,28410218.0,175407,511912,16.2,16.29,687319,111805625.0,3674,1138,2373,27034420.0,27034420.0,165928,506242,16.29,16.37,672170,109892583.0,3511,2023-11-29 17:50:00
1134,GAZP,511,626,14065947.0,14065947.0,86609,126428,16.24,16.3,213037,34672149.0,1137,413,587,12989755.0,12989755.0,79754,119317,16.29,16.37,199071,32527772.0,1000,2023-11-29 17:55:00
1135,GAZP,555,610,11908456.0,11908456.0,73387,121847,16.23,16.37,195234,31859299.0,1165,432,540,11124633.0,11124633.0,68288,111798,16.29,16.36,180086,29415665.0,972,2023-11-29 18:00:00
1136,GAZP,3741,3821,71771112.0,71771112.0,444566,1164488,16.14,16.31,1609054,261701366.0,7562,3433,3717,69143976.0,69143976.0,424592,1135326,16.28,16.33,1559918,254595609.0,7150,2023-11-29 18:05:00
1137,GAZP,2391,2576,50080770.0,50080770.0,312390,648733,16.03,16.33,961123,155999664.0,4967,2223,2491,49252576.0,49252576.0,302303,647081,16.29,16.35,949384,155055217.0,4714,2023-11-29 18:10:00
1138,GAZP,1773,2224,45814109.0,45814109.0,287136,839352,15.96,16.34,1126488,182983180.0,3997,1605,2162,44864271.0,44864271.0,275428,824216,16.29,16.34,1099644,179578747.0,3767,2023-11-29 18:15:00
1139,GAZP,1522,1446,41439704.0,41439704.0,254923,509420,16.26,16.33,764343,124635030.0,2968,1408,1396,40767605.0,40767605.0,250525,503916,16.27,16.35,754441,123173085.0,2804,2023-11-29 18:20:00
1140,GAZP,1204,1334,31341200.0,31341200.0,193423,327720,16.2,16.28,521143,84702793.0,2538,1018,1293,30378587.0,30378587.0,186702,328299,16.27,16.34,515001,84038493.0,2311,2023-11-29 18:25:00
1141,GAZP,1065,724,21250462.0,21250462.0,130884,289554,16.24,16.27,420438,68366499.0,1789,933,690,21286867.0,21286867.0,130873,291400,16.27,16.34,422273,68901433.0,1623,2023-11-29 18:30:00
1142,GAZP,1707,3078,29394828.0,29394828.0,182731,355673,16.09,14.86,538404,82257509.0,4785,1051,2035,25282587.0,25282587.0,155382,371989,16.27,16.68,527371,87337923.0,3086,2023-11-29 18:35:00
1143,GAZP,998,1315,19728049.0,19728049.0,130241,196292,15.15,16.3,326533,51730966.0,2313,822,1048,18799319.0,18799319.0,115437,182502,16.29,16.33,297939,48597951.0,1870,2023-11-29 18:40:00
1144,GAZP,5883,8937,120961383.0,120961383.0,750521,1330158,16.12,16.31,2080679,337879324.0,14820,5038,8107,110227109.0,110227109.0,675307,1242514,16.32,16.35,1917821,313378069.0,13145,2023-11-30 10:05:00
1145,GAZP,5664,6479,194256587.0,194256587.0,1190436,1123723,16.32,16.27,2314159,377128992.0,12143,5250,6078,188305422.0,188305422.0,1152900,1080625,16.33,16.35,2233525,364965025.0,11328,2023-11-30 10:10:00
1146,GAZP,4894,3290,172771307.0,172771307.0,1059733,559023,16.3,16.34,1618756,264110250.0,8184,4585,3077,170959537.0,170959537.0,1047919,538335,16.31,16.37,1586254,259067836.0,7662,2023-11-30 10:15:00
1147,GAZP,8048,5412,274121020.0,274121020.0,1683283,881304,16.28,16.27,2564587,417470116.0,13460,7651,4977,270675872.0,270675872.0,1661616,846488,16.29,16.35,2508104,409065257.0,12628,2023-11-30 10:20:00
1148,GAZP,8578,8168,288958967.0,288958967.0,1774135,1347198,16.29,16.32,3121333,508814476.0,16746,8258,7856,286214726.0,286214726.0,1755667,1325694,16.3,16.35,3081361,502899641.0,16114,2023-11-30 10:25:00
1149,GAZP,2013,2351,77340427.0,77340427.0,476217,479454,16.24,16.26,955671,155314400.0,4364,1709,2192,76293417.0,76293417.0,468885,464615,16.27,16.33,933500,152180134.0,3901,2023-11-30 10:30:00
1150,GAZP,3615,2633,115519771.0,115519771.0,719251,603385,16.06,16.15,1322636,212990561.0,6248,3108,2390,112217186.0,112217186.0,689717,580753,16.27,16.33,1270470,207032268.0,5498,2023-11-30 10:35:00
1151,GAZP,1640,1636,38507429.0,38507429.0,237049,438446,16.24,16.29,675495,109931412.0,3276,1402,1522,37577770.0,37577770.0,230809,431258,16.28,16.33,662067,107992789.0,2924,2023-11-30 10:40:00
1152,GAZP,6117,8490,181137968.0,181137968.0,1115864,1909796,16.23,16.23,3025660,491139557.0,14607,5637,8167,178655998.0,178655998.0,1099886,1888005,16.24,16.3,2987891,486309839.0,13804,2023-11-30 10:45:00
1153,GAZP,5535,6719,106043301.0,106043301.0,655828,1366983,16.17,16.27,2022811,328506595.0,12254,5122,6589,101807711.0,101807711.0,626643,1362386,16.25,16.29,1989029,323705670.0,11711,2023-11-30 10:50:00
1154,GAZP,2134,2805,62960802.0,62960802.0,390435,533231,16.13,16.27,923666,149707550.0,4939,1770,2651,61288585.0,61288585.0,377252,525335,16.25,16.3,902587,146916215.0,4421,2023-11-30 10:55:00
1155,GAZP,1759,2704,53225422.0,53225422.0,328646,476073,16.2,15.86,804719,128733259.0,4463,1417,2546,51673041.0,51673041.0,318356,460267,16.23,16.3,778623,126712881.0,3963,2023-11-30 11:00:00
1156,GAZP,7016,9004,167662017.0,167662017.0,1037182,2212844,16.17,16.18,3250026,525789125.0,16020,6385,8809,163220205.0,163220205.0,1007511,2185082,16.2,16.25,3192593,518214753.0,15194,2023-11-30 11:05:00
1157,GAZP,2762,3245,84581731.0,84581731.0,526702,696988,16.06,16.18,1223690,197335768.0,6007,2322,3039,82309291.0,82309291.0,507737,685442,16.21,16.28,1193179,193884060.0,5361,2023-11-30 11:10:00
1158,GAZP,4148,6580,96612874.0,96612874.0,599427,1404929,16.12,16.15,2004356,323452541.0,10728,3760,6347,92850760.0,92850760.0,573093,1373871,16.2,16.24,1946964,315954172.0,10107,2023-11-30 11:15:00
1159,GAZP,2352,1996,83378021.0,83378021.0,522642,500200,15.95,16.19,1022842,164370829.0,4348,1909,1825,80238002.0,80238002.0,494868,481201,16.21,16.28,976069,158560082.0,3734,2023-11-30 11:20:00
1160,GAZP,2490,12503,57458933.0,57458933.0,359538,1282815,15.98,16.29,1642353,266474607.0,14993,2213,12360,56462509.0,56462509.0,347846,1270781,16.23,16.3,1618627,263545528.0,14573,2023-11-30 11:25:00
1161,GAZP,1080,1301,38413954.0,38413954.0,240959,261678,15.94,16.23,502637,80871352.0,2381,821,1148,37299937.0,37299937.0,229922,247210,16.22,16.3,477132,77600088.0,1969,2023-11-30 11:30:00
1162,GAZP,1235,1815,33251315.0,33251315.0,205312,353350,16.2,16.27,558662,90733070.0,3050,1072,1741,33325443.0,33325443.0,205352,350549,16.23,16.3,555901,90468124.0,2813,2023-11-30 11:35:00
1163,GAZP,2233,3280,60592644.0,60592644.0,374543,667071,16.18,16.27,1041614,169145342.0,5513,2083,3209,60189442.0,60189442.0,370677,663478,16.24,16.3,1034155,168327784.0,5292,2023-11-30 11:40:00
1164,GAZP,1103,1146,37189089.0,37189089.0,234756,246243,15.84,16.29,480999,77309135.0,2249,922,1048,36324170.0,36324170.0,223424,235446,16.26,16.33,458870,74761940.0,1970,2023-11-30 11:45:00
1165,GAZP,1690,1495,37054299.0,37054299.0,228422,249972,16.22,16.08,478394,77238794.0,3185,1527,1386,36181291.0,36181291.0,222672,243048,16.25,16.33,465720,75859928.0,2913,2023-11-30 11:50:00
1166,GAZP,1146,753,25463188.0,25463188.0,156993,149900,16.22,16.07,306893,49547620.0,1899,1005,698,25079806.0,25079806.0,154343,163054,16.25,16.45,317397,51909775.0,1703,2023-11-30 11:55:00
1167,GAZP,1652,1106,33521500.0,33521500.0,210353,160621,15.94,16.34,370974,59769245.0,2758,1471,1034,33197148.0,33197148.0,203894,149633,16.28,16.31,353527,57608295.0,2505,2023-11-30 12:00:00
1168,GAZP,2371,3221,32524871.0,32524871.0,201259,620174,16.16,16.31,821433,133668218.0,5592,2253,3115,32502743.0,32502743.0,199502,614225,16.29,16.31,813727,132701626.0,5368,2023-11-30 12:05:00
1169,GAZP,1028,1151,20680086.0,20680086.0,127386,187333,16.23,16.22,314719,51059590.0,2179,929,1072,20097142.0,20097142.0,123430,184374,16.28,16.31,307804,50177117.0,2001,2023-11-30 12:10:00
1170,GAZP,1132,1186,25283741.0,25283741.0,155571,219343,16.25,16.49,374914,61457479.0,2318,1002,1107,24668770.0,24668770.0,151580,167978,16.27,16.31,319558,52066351.0,2109,2023-11-30 12:15:00
1171,GAZP,773,694,26550728.0,26550728.0,163488,123836,16.24,16.27,287324,46696879.0,1467,635,641,24586061.0,24586061.0,151065,117063,16.28,16.32,268128,43695742.0,1276,2023-11-30 12:20:00
1172,GAZP,458,411,13860878.0,13860878.0,86140,99384,16.09,16.2,185524,29958042.0,869,358,328,14218640.0,14218640.0,87343,83303,16.28,16.34,170646,27833576.0,686,2023-11-30 12:25:00
1173,GAZP,1189,1256,42874468.0,42874468.0,263893,290157,16.25,16.21,554050,89912001.0,2445,1064,1189,42366567.0,42366567.0,260621,287430,16.26,16.32,548051,89269495.0,2253,2023-11-30 12:30:00
1174,GAZP,2521,3150,78171850.0,78171850.0,481994,687843,16.22,16.26,1169837,190023621.0,5671,2334,3101,76779034.0,76779034.0,472882,678782,16.24,16.3,1151664,187412145.0,5435,2023-11-30 12:35:00
1175,GAZP,1575,2035,50390553.0,50390553.0,311521,471635,16.18,16.24,783156,126998771.0,3610,1347,1961,47570096.0,47570096.0,293112,478207,16.23,16.29,771319,125490353.0,3308,2023-11-30 12:40:00
1176,GAZP,1889,3283,49801444.0,49801444.0,307461,617608,16.2,16.27,925069,150307365.0,5172,1732,3238,48929080.0,48929080.0,301302,615014,16.24,16.29,916316,149138641.0,4970,2023-11-30 12:45:00
1177,GAZP,2188,2823,69000545.0,69000545.0,427107,652546,16.16,16.31,1079653,175402695.0,5011,2056,2741,68206405.0,68206405.0,419547,642270,16.26,16.32,1061817,173017967.0,4797,2023-11-30 12:50:00
1178,GAZP,923,843,30144301.0,30144301.0,185903,199048,16.22,16.32,384951,62638510.0,1766,838,779,30155833.0,30155833.0,185482,191498,16.26,16.34,376980,61440574.0,1617,2023-11-30 12:55:00
1179,GAZP,1847,1000,55949253.0,55949253.0,344417,192821,16.24,16.31,537238,87404812.0,2847,1720,967,54703213.0,54703213.0,335974,191645,16.28,16.33,527619,86001573.0,2687,2023-11-30 13:00:00
1180,GAZP,1606,1345,54598359.0,54598359.0,342882,313628,15.92,16.24,656510,105547021.0,2951,1412,1178,54131267.0,54131267.0,332347,306737,16.29,16.35,639084,104291427.0,2590,2023-11-30 13:05:00
1181,GAZP,2685,3194,88871225.0,88871225.0,546018,660575,16.28,16.33,1206593,196750886.0,5879,2567,3075,88319216.0,88319216.0,542388,655455,16.28,16.35,1197843,195475130.0,5642,2023-11-30 13:10:00
1182,GAZP,2781,2288,84942979.0,84942979.0,523234,509912,16.23,16.3,1033146,168078269.0,5069,2648,2219,84791312.0,84791312.0,520705,508168,16.28,16.35,1028873,167859813.0,4867,2023-11-30 13:15:00
1183,GAZP,1049,865,27705076.0,27705076.0,170692,208486,16.23,16.33,379178,61753208.0,1914,911,816,26395182.0,26395182.0,162058,200445,16.29,16.35,362503,59158026.0,1727,2023-11-30 13:20:00
1184,GAZP,997,701,33086658.0,33086658.0,203528,196672,16.26,16.33,400200,65202705.0,1698,874,651,32251811.0,32251811.0,198087,153301,16.28,16.34,351388,57308689.0,1525,2023-11-30 13:25:00
1185,GAZP,908,829,33398806.0,33398806.0,205690,207544,16.24,16.12,413234,66850977.0,1737,788,756,33324436.0,33324436.0,204646,204838,16.28,16.34,409484,66805034.0,1544,2023-11-30 13:30:00
1186,GAZP,1808,2069,42244886.0,42244886.0,259837,644961,16.26,16.31,904798,147432252.0,3877,1697,2036,42190207.0,42190207.0,259276,643700,16.27,16.32,902976,147264492.0,3733,2023-11-30 13:35:00
1187,GAZP,859,983,23458747.0,23458747.0,144269,208185,16.26,16.27,352454,57322931.0,1842,746,924,23289813.0,23289813.0,143151,206177,16.27,16.33,349328,56961453.0,1670,2023-11-30 13:40:00
1188,GAZP,709,743,24617689.0,24617689.0,151816,173628,16.22,16.18,325444,52706361.0,1452,578,703,23861865.0,23861865.0,146583,170412,16.28,16.34,316995,51700263.0,1281,2023-11-30 13:45:00
1189,GAZP,1332,995,41163515.0,41163515.0,255482,183973,16.11,16.33,439455,71207291.0,2327,1202,928,41115380.0,41115380.0,252180,179293,16.3,16.35,431473,70421474.0,2130,2023-11-30 13:50:00
1190,GAZP,1890,1125,55364940.0,55364940.0,340283,222798,16.27,16.3,563081,91690164.0,3015,1782,1035,54867802.0,54867802.0,336364,215216,16.31,16.34,551580,90035708.0,2817,2023-11-30 13:55:00
1191,GAZP,1715,754,43350916.0,43350916.0,266084,191775,16.29,16.25,457859,74522659.0,2469,1619,724,42573667.0,42573667.0,261014,194559,16.31,16.34,455573,74360550.0,2343,2023-11-30 14:00:00
1192,GAZP,2666,945,48082058.0,48082058.0,295165,569853,16.29,16.33,865018,141164725.0,3611,2547,864,46919970.0,46919970.0,287487,567335,16.32,16.34,854822,139620096.0,3411,2023-11-30 14:05:00
1193,GAZP,4135,5458,82618731.0,82618731.0,506795,1712866,16.3,16.33,2219661,362367376.0,9593,3976,5283,81211751.0,81211751.0,497721,1699477,16.32,16.34,2197198,358894356.0,9259,2023-11-30 14:10:00
1194,GAZP,963,710,25386551.0,25386551.0,156323,143586,16.24,16.33,299909,48827431.0,1673,864,613,25432176.0,25432176.0,155871,138882,16.32,16.34,294753,48129663.0,1477,2023-11-30 14:15:00
1195,GAZP,1630,1631,57697657.0,57697657.0,354062,391308,16.3,16.31,745370,121534176.0,3261,1511,1560,56911837.0,56911837.0,349155,387235,16.3,16.35,736390,120209408.0,3071,2023-11-30 14:20:00
1196,GAZP,1432,1092,54699286.0,54699286.0,336935,249273,16.23,16.3,586208,95323563.0,2524,1316,1013,53938294.0,53938294.0,330847,243908,16.3,16.37,574755,93869968.0,2329,2023-11-30 14:25:00
1197,GAZP,2260,1840,76297753.0,76297753.0,468340,431570,16.29,16.29,899910,146585364.0,4100,2152,1782,75942256.0,75942256.0,465874,427795,16.3,16.36,893669,145935853.0,3934,2023-11-30 14:30:00
1198,GAZP,1025,802,35586895.0,35586895.0,218588,234270,16.28,16.26,452858,73686456.0,1827,925,754,35160559.0,35160559.0,215781,229927,16.29,16.36,445708,72779925.0,1679,2023-11-30 14:35:00
1199,GAZP,1055,1172,33016916.0,33016916.0,204676,300657,16.13,16.33,505333,82125674.0,2227,973,1123,32563575.0,32563575.0,199893,298271,16.29,16.35,498164,81341582.0,2096,2023-11-30 14:40:00
1200,GAZP,1940,1429,82493807.0,82493807.0,508172,308553,16.23,16.34,816725,132921803.0,3369,1837,1374,82246463.0,82246463.0,504407,303795,16.31,16.37,808202,131964774.0,3211,2023-11-30 14:45:00
1201,GAZP,1170,972,43639360.0,43639360.0,270030,258182,16.16,16.37,528212,85903765.0,2142,1042,917,42797983.0,42797983.0,262505,250524,16.3,16.37,513029,83812649.0,1959,2023-11-30 14:50:00
1202,GAZP,374,439,13973258.0,13973258.0,85719,114102,16.3,16.35,199821,32631771.0,813,273,388,12990624.0,12990624.0,79638,111104,16.31,16.41,190742,31217320.0,661,2023-11-30 14:55:00
1203,GAZP,597,549,20130136.0,20130136.0,123579,133002,16.29,16.33,256581,41845235.0,1146,493,492,19778236.0,19778236.0,121220,123541,16.32,16.37,244761,39997999.0,985,2023-11-30 15:00:00
1204,GAZP,1175,1003,41561517.0,41561517.0,255066,248442,16.29,16.27,503508,81978692.0,2178,1064,919,41093055.0,41093055.0,251904,239146,16.31,16.37,491050,80247020.0,1983,2023-11-30 15:05:00
1205,GAZP,1009,742,35914301.0,35914301.0,221703,171759,16.2,16.36,393462,64008117.0,1751,900,695,35186101.0,35186101.0,215690,166925,16.31,16.37,382615,62517028.0,1595,2023-11-30 15:10:00
1206,GAZP,724,576,27534901.0,27534901.0,169935,142920,16.2,16.32,312855,50866153.0,1300,594,514,25540742.0,25540742.0,156521,133708,16.32,16.37,290229,47435045.0,1108,2023-11-30 15:15:00
1207,GAZP,589,365,18490237.0,18490237.0,113404,86571,16.3,16.36,199975,32656399.0,954,415,320,15919920.0,15919920.0,97511,82615,16.33,16.4,180126,29465392.0,735,2023-11-30 15:20:00
1208,GAZP,989,1825,36019639.0,36019639.0,221007,655601,16.3,16.35,876608,143242672.0,2814,879,1742,35695755.0,35695755.0,218887,651758,16.31,16.36,870645,142352776.0,2621,2023-11-30 15:25:00
1209,GAZP,707,958,25140991.0,25140991.0,154304,279574,16.29,16.37,433878,70894223.0,1665,598,891,24533674.0,24533674.0,150398,273809,16.31,16.38,424207,69373750.0,1489,2023-11-30 15:30:00
1210,GAZP,942,1062,33293135.0,33293135.0,205262,296479,16.22,16.35,501741,81766130.0,2004,808,991,32315499.0,32315499.0,198035,288905,16.32,16.37,486940,79612220.0,1799,2023-11-30 15:35:00
1211,GAZP,1382,1458,51108560.0,51108560.0,313464,373980,16.3,16.31,687444,112101616.0,2840,1264,1366,49870429.0,49870429.0,305526,368760,16.32,16.38,674286,110275227.0,2630,2023-11-30 15:40:00
1212,GAZP,1492,1215,58156686.0,58156686.0,357067,348682,16.29,16.35,705749,115182365.0,2707,1366,1119,57107742.0,57107742.0,349677,336820,16.33,16.39,686497,112305303.0,2485,2023-11-30 15:45:00
1213,GAZP,1055,1242,40412585.0,40412585.0,248425,405986,16.27,16.25,654411,106396354.0,2297,916,1155,38857821.0,38857821.0,237950,397096,16.33,16.39,635046,103928869.0,2071,2023-11-30 15:50:00
1214,GAZP,1729,2579,61881338.0,61881338.0,380031,852036,16.28,16.35,1232067,201217894.0,4308,1562,2497,60768362.0,60768362.0,372360,845904,16.32,16.38,1218264,199309422.0,4059,2023-11-30 15:55:00
1215,GAZP,2476,3230,69398690.0,69398690.0,426482,1199156,16.27,16.36,1625638,265553633.0,5706,2345,3174,69194935.0,69194935.0,424227,1195152,16.31,16.37,1619379,264797347.0,5519,2023-11-30 16:00:00
1216,GAZP,1339,1725,39410937.0,39410937.0,241757,595554,16.3,16.32,837311,136594375.0,3064,1186,1623,38736233.0,38736233.0,237389,596728,16.32,16.37,834117,136447136.0,2809,2023-11-30 16:05:00
1217,GAZP,951,1560,31742844.0,31742844.0,194812,346085,16.29,16.28,540897,88081240.0,2511,797,1496,30895527.0,30895527.0,189524,340310,16.3,16.38,529834,86644628.0,2293,2023-11-30 16:10:00
1218,GAZP,2519,1837,96367010.0,96367010.0,591233,447580,16.3,16.25,1038813,169087203.0,4356,2273,1720,94781478.0,94781478.0,581450,419545,16.3,16.35,1000995,163381208.0,3993,2023-11-30 16:15:00
1219,GAZP,2484,1559,98465940.0,98465940.0,607304,378655,16.21,16.35,985959,160369640.0,4043,2284,1397,97215947.0,97215947.0,596757,374025,16.29,16.36,970782,158390717.0,3681,2023-11-30 16:20:00
1220,GAZP,2509,542,211510193.0,211510193.0,1299535,156728,16.28,16.32,1456263,237087954.0,3051,2393,503,211128643.0,211128643.0,1294483,150516,16.31,16.37,1444999,235760839.0,2896,2023-11-30 16:25:00
1221,GAZP,980,512,29944790.0,29944790.0,186152,114274,16.09,16.29,300426,48558151.0,1492,905,441,29758424.0,29758424.0,182526,106891,16.3,16.37,289417,47259116.0,1346,2023-11-30 16:30:00
1222,GAZP,1591,1355,61621054.0,61621054.0,378948,298209,16.26,16.3,677157,110217519.0,2946,1505,1267,60957858.0,60957858.0,373945,294252,16.3,16.36,668197,109103767.0,2772,2023-11-30 16:35:00
1223,GAZP,1678,1396,52364542.0,52364542.0,321577,280661,16.28,16.23,602238,97926499.0,3074,1562,1297,51474696.0,51474696.0,315940,275347,16.29,16.36,591287,96522440.0,2859,2023-11-30 16:40:00
1224,GAZP,1147,922,38349095.0,38349095.0,236414,192790,16.22,16.31,429204,69786620.0,2069,1039,850,37684752.0,37684752.0,231273,179652,16.29,16.36,410925,67074209.0,1889,2023-11-30 16:45:00
1225,GAZP,2827,463,211605016.0,211605016.0,1298340,131232,16.3,16.25,1429572,232925812.0,3290,2708,397,211600720.0,211600720.0,1297572,130336,16.31,16.36,1427908,232918796.0,3105,2023-11-30 16:50:00
1226,GAZP,4977,777,212816538.0,212816538.0,1304966,201974,16.31,16.09,1506940,245305040.0,5754,4830,702,212251388.0,212251388.0,1301353,190866,16.31,16.34,1492219,243438119.0,5532,2023-11-30 16:55:00
1227,GAZP,1730,600,61566111.0,61566111.0,378775,192011,16.25,16.32,570786,92893863.0,2330,1645,542,59765272.0,59765272.0,366687,187081,16.3,16.36,553768,90374427.0,2187,2023-11-30 17:00:00
1228,GAZP,2369,607,104853877.0,104853877.0,644122,216214,16.28,16.29,860336,140080147.0,2976,2281,539,104844919.0,104844919.0,643311,207843,16.3,16.37,851154,138869320.0,2820,2023-11-30 17:05:00
1229,GAZP,766,312,18061153.0,18061153.0,111787,64760,16.16,16.3,176547,28615447.0,1078,616,257,16889743.0,16889743.0,103708,59228,16.29,16.37,162936,26583775.0,873,2023-11-30 17:10:00
1230,GAZP,793,415,13526542.0,13526542.0,83677,46381,16.17,16.29,130058,21081844.0,1208,692,357,13149066.0,13149066.0,80652,43797,16.3,16.36,124449,20316353.0,1049,2023-11-30 17:15:00
1231,GAZP,752,560,23445433.0,23445433.0,144111,109794,16.27,16.3,253905,41337639.0,1312,631,480,22952126.0,22952126.0,140815,106154,16.3,16.39,246969,40348019.0,1111,2023-11-30 17:20:00
1232,GAZP,679,845,20698535.0,20698535.0,127021,123392,16.3,16.35,250413,40878199.0,1524,592,762,19576208.0,19576208.0,120063,116154,16.3,16.38,236217,38598987.0,1354,2023-11-30 17:25:00
1233,GAZP,1073,813,32515777.0,32515777.0,199709,164446,16.28,15.84,364155,58558787.0,1886,942,715,31422868.0,31422868.0,192687,151308,16.31,16.37,343995,56188054.0,1657,2023-11-30 17:30:00
1234,GAZP,830,592,28591589.0,28591589.0,175815,99259,16.26,16.32,275074,44787308.0,1422,676,549,27077645.0,27077645.0,165978,94989,16.31,16.37,260967,42628695.0,1225,2023-11-30 17:35:00
1235,GAZP,851,703,26575240.0,26575240.0,163253,129289,16.28,16.29,292542,47631421.0,1554,723,610,25871386.0,25871386.0,158554,125549,16.32,16.39,284103,46446799.0,1333,2023-11-30 17:40:00
1236,GAZP,1759,1886,53225559.0,53225559.0,330324,463973,16.11,16.38,794297,129209908.0,3645,1574,1749,52222063.0,52222063.0,319925,455334,16.32,16.39,775259,126844219.0,3323,2023-11-30 17:45:00
1237,GAZP,2717,3187,77719228.0,77719228.0,481528,862368,16.14,16.33,1343896,218573089.0,5904,2461,3002,75943309.0,75943309.0,464637,852116,16.34,16.39,1316753,215638538.0,5463,2023-11-30 17:50:00
1238,GAZP,2207,2169,70265908.0,70265908.0,432868,574337,16.23,16.38,1007205,164368866.0,4376,1938,2074,68219757.0,68219757.0,417440,558766,16.34,16.4,976206,159852588.0,4012,2023-11-30 17:55:00
1239,GAZP,968,2279,27896542.0,27896542.0,171011,728355,16.31,16.38,899366,147199327.0,3247,809,2197,27160271.0,27160271.0,166234,725284,16.34,16.39,891518,145998641.0,3006,2023-11-30 18:00:00
1240,GAZP,1575,1157,50140656.0,50140656.0,306794,278907,16.34,16.39,585701,95856043.0,2732,1450,1086,49577595.0,49577595.0,303279,274369,16.35,16.41,577648,94593245.0,2536,2023-11-30 18:05:00
1241,GAZP,1127,1053,39867244.0,39867244.0,253870,353184,15.7,16.38,607054,97728427.0,2180,981,899,37029163.0,37029163.0,226550,346458,16.34,16.41,573008,93877461.0,1880,2023-11-30 18:10:00
1242,GAZP,2168,2506,60326198.0,60326198.0,375035,779717,16.09,16.37,1154752,187981317.0,4674,1872,2271,55353330.0,55353330.0,338182,759052,16.37,16.43,1097234,180031364.0,4143,2023-11-30 18:15:00
1243,GAZP,1112,875,25642690.0,25642690.0,170064,197932,15.08,16.39,367996,58084747.0,1987,833,740,25302696.0,25302696.0,154631,186536,16.36,16.45,341167,55982741.0,1573,2023-11-30 18:20:00
1244,GAZP,6486,3406,160771761.0,160771761.0,1000927,998837,16.06,16.38,1999764,324391838.0,9892,5241,2938,155619583.0,155619583.0,948480,966814,16.41,16.47,1915294,314809056.0,8179,2023-11-30 18:25:00
1245,GAZP,4208,3926,169407146.0,169407146.0,1034877,929260,16.37,16.41,1964137,321861249.0,8134,3926,3715,166698565.0,166698565.0,1015926,906306,16.41,16.45,1922232,315769861.0,7641,2023-11-30 18:30:00
1246,GAZP,1284,976,36334213.0,36334213.0,222329,245926,16.34,15.93,468255,75516710.0,2260,998,822,33237844.0,33237844.0,203005,219606,16.37,16.43,422611,69325846.0,1820,2023-11-30 18:35:00
1247,GAZP,1198,3247,40157647.0,40157647.0,248716,774651,16.15,16.38,1023367,167060978.0,4445,979,3204,37129857.0,37129857.0,228324,617345,16.26,16.39,845669,138303908.0,4183,2023-11-30 18:40:00
0,PHOR,359,668,53213095.0,185122580.0,8083,27784,6583.0,6663.0,35867,238335675.0,1027,160,544,35035613.0,165014411.0,5330,24750,6573.0,6667.0,30080,200050024.0,704,2023-11-01 10:05:00
1,PHOR,284,208,22195993.0,28109287.0,3339,4227,6647.0,6650.0,7566,50305280.0,492,182,148,18179491.0,24262210.0,2740,3642,6635.0,6662.0,6382,42441701.0,330,2023-11-01 10:10:00
2,PHOR,637,451,83863800.0,85239430.0,12603,12781,6654.0,6669.0,25384,169103230.0,1088,530,389,71311573.0,78299459.0,10750,11750,6634.0,6664.0,22500,149611032.0,919,2023-11-01 10:15:00
3,PHOR,845,1052,112237162.0,202312764.0,16871,26834,6653.0,7539.0,43705,314549926.0,1897,736,949,106923986.0,170288413.0,16110,25524,6637.0,6672.0,41634,277212399.0,1685,2023-11-01 10:20:00
4,PHOR,489,411,80806398.0,84670723.0,12167,12668,6641.0,6684.0,24835,165477121.0,900,381,340,74823173.0,79406222.0,11274,11881,6637.0,6683.0,23155,154229395.0,721,2023-11-01 10:25:00
5,PHOR,292,192,51904254.0,46015120.0,7795,6881,6659.0,6687.0,14676,97919374.0,484,214,145,48358925.0,40499216.0,7276,6063,6646.0,6680.0,13339,88858141.0,359,2023-11-01 10:30:00
6,PHOR,535,301,89690886.0,73929727.0,13495,11072,6646.0,6677.0,24567,163620613.0,836,440,240,86435515.0,69400208.0,13010,10388,6644.0,6681.0,23398,155835723.0,680,2023-11-01 10:35:00
7,PHOR,597,300,107089355.0,83310323.0,16057,12469,6669.0,6681.0,28526,190399678.0,897,528,227,93522450.0,81051954.0,14092,12127,6637.0,6684.0,26219,174574404.0,755,2023-11-01 10:40:00
8,PHOR,652,512,84500300.0,91468379.0,12722,13694,6642.0,6679.0,26416,175968679.0,1164,590,471,80528597.0,88798812.0,12115,13292,6647.0,6681.0,25407,169327409.0,1061,2023-11-01 10:45:00
9,PHOR,431,406,65437689.0,64297339.0,9853,9630,6641.0,6677.0,19483,129735028.0,837,374,372,63955049.0,62668691.0,9631,9379,6641.0,6682.0,19010,126623740.0,746,2023-11-01 10:50:00
10,PHOR,579,594,75433306.0,84424192.0,11351,12644,6646.0,6677.0,23995,159857498.0,1173,496,536,73692357.0,83666636.0,11091,12528,6644.0,6678.0,23619,157358993.0,1032,2023-11-01 10:55:00
11,PHOR,531,421,70100300.0,84380409.0,10567,11154,6634.0,7565.0,21721,154480709.0,952,454,353,67815003.0,69794146.0,10215,10444,6639.0,6683.0,20659,137609149.0,807,2023-11-01 11:00:00
12,PHOR,388,315,59155273.0,62651925.0,8911,9402,6638.0,6664.0,18313,121807198.0,703,335,277,57864781.0,59268435.0,8717,8881,6638.0,6674.0,17598,117133216.0,612,2023-11-01 11:05:00
13,PHOR,496,464,91517394.0,85933615.0,13805,12867,6629.0,6679.0,26672,177451009.0,960,424,406,83801980.0,85094907.0,12622,12742,6639.0,6678.0,25364,168896887.0,830,2023-11-01 11:10:00
14,PHOR,363,277,61721740.0,62588995.0,9298,9370,6638.0,6680.0,18668,124310735.0,640,320,248,66116302.0,59057729.0,9964,8837,6636.0,6683.0,18801,125174031.0,568,2023-11-01 11:15:00
15,PHOR,381,461,62510165.0,76647938.0,9421,11368,6635.0,6742.0,20789,139158103.0,842,314,422,55159613.0,70420976.0,8309,10470,6639.0,6726.0,18779,125580589.0,736,2023-11-01 11:20:00
16,PHOR,255,207,43960887.0,39884825.0,6619,5978,6642.0,6672.0,12597,83845712.0,462,187,168,42608864.0,38357562.0,6417,5748,6640.0,6673.0,12165,80966426.0,355,2023-11-01 11:25:00
17,PHOR,273,205,53506987.0,55419817.0,8065,8331,6634.0,6652.0,16396,108926804.0,478,205,163,51965879.0,50607804.0,7840,7545,6628.0,6707.0,15385,102573683.0,368,2023-11-01 11:30:00
18,PHOR,636,390,107886080.0,101525595.0,16280,15221,6627.0,6670.0,31501,209411675.0,1026,512,332,104501741.0,98003018.0,15769,14680,6627.0,6676.0,30449,202504759.0,844,2023-11-01 11:35:00
19,PHOR,452,262,59863434.0,57248842.0,9016,8584,6640.0,6669.0,17600,117112276.0,714,350,229,56652068.0,55033758.0,8535,8249,6638.0,6672.0,16784,111685826.0,579,2023-11-01 11:40:00
20,PHOR,750,384,123650268.0,108068239.0,18656,16233,6628.0,6657.0,34889,231718507.0,1134,653,330,119974909.0,101229516.0,18107,15154,6626.0,6680.0,33261,221204425.0,983,2023-11-01 11:45:00
21,PHOR,627,433,125170766.0,120639314.0,18892,18133,6626.0,6653.0,37025,245810080.0,1060,527,387,120778642.0,115389366.0,18229,17285,6626.0,6676.0,35514,236168008.0,914,2023-11-01 11:50:00
22,PHOR,592,531,65603139.0,64006148.0,9894,9605,6631.0,6664.0,19499,129609287.0,1123,493,480,62903864.0,61581182.0,9490,9239,6628.0,6665.0,18729,124485046.0,973,2023-11-01 11:55:00
23,PHOR,577,452,87298808.0,89645879.0,13164,13439,6632.0,6671.0,26603,176944687.0,1029,494,376,85063405.0,87570196.0,12833,13124,6628.0,6673.0,25957,172633601.0,870,2023-11-01 12:00:00
24,PHOR,468,348,62515080.0,69224927.0,9426,10381,6632.0,6668.0,19807,131740007.0,816,375,311,60937192.0,64229731.0,9196,9630,6626.0,6670.0,18826,125166923.0,686,2023-11-01 12:05:00
25,PHOR,469,205,48752946.0,40008761.0,7350,6003,6633.0,6665.0,13353,88761707.0,674,386,156,46478025.0,37647854.0,7011,5647,6629.0,6667.0,12658,84125879.0,542,2023-11-01 12:10:00
26,PHOR,325,235,44086228.0,47312000.0,6624,7098,6656.0,6666.0,13722,91398228.0,560,242,198,39382601.0,48409654.0,5937,5776,6633.0,8381.0,11713,87792255.0,440,2023-11-01 12:15:00
27,PHOR,274,172,37912625.0,36770900.0,5713,5515,6636.0,6667.0,11228,74683525.0,446,205,146,34684266.0,34696200.0,5230,5203,6632.0,6668.0,10433,69380466.0,351,2023-11-01 12:20:00
28,PHOR,464,181,52332487.0,46784845.0,7884,7004,6638.0,6680.0,14888,99117332.0,645,394,153,49677548.0,44475817.0,7489,6662,6633.0,6676.0,14151,94153365.0,547,2023-11-01 12:25:00
29,PHOR,252,168,32512441.0,33952232.0,4888,5094,6651.0,6665.0,9982,66464673.0,420,171,154,30007709.0,32156110.0,4521,4820,6637.0,6671.0,9341,62163819.0,325,2023-11-01 12:30:00
30,PHOR,328,171,42848192.0,36349253.0,6442,5448,6651.0,6672.0,11890,79197445.0,499,262,145,40700747.0,35666761.0,6131,5345,6639.0,6673.0,11476,76367508.0,407,2023-11-01 12:35:00
31,PHOR,396,278,59430549.0,53810813.0,8954,8063,6637.0,6674.0,17017,113241362.0,674,337,251,57520891.0,53117864.0,8670,7959,6634.0,6674.0,16629,110638755.0,588,2023-11-01 12:40:00
32,PHOR,357,156,48216466.0,36819399.0,7256,5515,6645.0,6676.0,12771,85035865.0,513,301,130,46005095.0,35852325.0,6925,5369,6643.0,6678.0,12294,81857420.0,431,2023-11-01 12:45:00
33,PHOR,582,190,66996090.0,41237841.0,10076,6180,6649.0,6673.0,16256,108233931.0,772,516,162,65881857.0,40457878.0,9911,6057,6647.0,6680.0,15968,106339735.0,678,2023-11-01 12:50:00
34,PHOR,830,433,157443710.0,85545714.0,23664,12840,6653.0,6662.0,36504,242989424.0,1263,732,396,154787717.0,84404919.0,23274,12661,6651.0,6667.0,35935,239192636.0,1128,2023-11-01 12:55:00
35,PHOR,1489,429,338724144.0,69855633.0,50926,10475,6651.0,6669.0,61401,408579777.0,1918,1402,358,336379619.0,68286362.0,50578,10233,6651.0,6673.0,60811,404665981.0,1760,2023-11-01 13:00:00
36,PHOR,658,443,127317825.0,91751490.0,19152,13766,6648.0,6665.0,32918,219069315.0,1101,551,377,121514212.0,89993764.0,18285,13496,6646.0,6668.0,31781,211507976.0,928,2023-11-01 13:05:00
37,PHOR,233,194,38310947.0,43636167.0,5767,6563,6643.0,6649.0,12330,81947114.0,427,166,163,36142965.0,41691394.0,5442,6248,6641.0,6673.0,11690,77834359.0,329,2023-11-01 13:10:00
38,PHOR,240,190,45051718.0,50578686.0,6784,7581,6641.0,6672.0,14365,95630404.0,430,180,147,42389499.0,47902508.0,6383,7174,6641.0,6677.0,13557,90292007.0,327,2023-11-01 13:15:00
39,PHOR,771,296,159458547.0,67909083.0,23975,10169,6651.0,6678.0,34144,227367630.0,1067,683,248,157439035.0,63367677.0,23674,9491,6650.0,6677.0,33165,220806712.0,931,2023-11-01 13:20:00
40,PHOR,681,366,107468570.0,86457692.0,16169,12949,6647.0,6677.0,29118,193926262.0,1047,589,321,104963397.0,84427384.0,15800,12643,6643.0,6678.0,28443,189390781.0,910,2023-11-01 13:25:00
41,PHOR,473,295,68794710.0,68033471.0,10341,10188,6653.0,6678.0,20529,136828181.0,768,403,244,66219661.0,66762049.0,9961,9994,6648.0,6680.0,19955,132981710.0,647,2023-11-01 13:30:00
42,PHOR,350,282,53981912.0,70206431.0,8115,10516,6652.0,6676.0,18631,124188343.0,632,273,251,51307280.0,70992000.0,7717,10634,6649.0,6676.0,18351,122299280.0,524,2023-11-01 13:35:00
43,PHOR,618,916,120127670.0,220262902.0,18075,33029,6646.0,6669.0,51104,340390572.0,1534,545,862,117868313.0,216982591.0,17739,32532,6645.0,6670.0,50271,334850904.0,1407,2023-11-01 13:40:00
44,PHOR,886,796,139046118.0,175452132.0,20919,26315,6647.0,6667.0,47234,314498250.0,1682,792,737,136817175.0,173067828.0,20585,25954,6646.0,6668.0,46539,309885003.0,1529,2023-11-01 13:45:00
45,PHOR,393,437,57529419.0,65940675.0,8656,9886,6646.0,6670.0,18542,123470094.0,830,334,394,55241744.0,64570697.0,8312,9678,6646.0,6672.0,17990,119812441.0,728,2023-11-01 13:50:00
46,PHOR,397,208,52767991.0,47362105.0,7935,7084,6650.0,6686.0,15019,100130096.0,605,328,174,49602259.0,46741705.0,7463,6992,6646.0,6685.0,14455,96343964.0,502,2023-11-01 13:55:00
47,PHOR,432,156,55115287.0,34124404.0,8275,5109,6660.0,6679.0,13384,89239691.0,588,383,135,54844843.0,33303263.0,8248,4984,6649.0,6682.0,13232,88148106.0,518,2023-11-01 14:00:00
48,PHOR,566,148,60877673.0,29678319.0,9160,4441,6646.0,6683.0,13601,90555992.0,714,502,127,57394745.0,28604245.0,8625,4280,6654.0,6683.0,12905,85998990.0,629,2023-11-01 14:05:00
49,PHOR,360,131,66252884.0,35962093.0,9959,5383,6653.0,6681.0,15342,102214977.0,491,294,108,63038320.0,33507995.0,9476,5014,6652.0,6683.0,14490,96546315.0,402,2023-11-01 14:10:00
50,PHOR,477,176,95456426.0,36470374.0,14337,5461,6658.0,6678.0,19798,131926800.0,653,426,149,93911070.0,29427181.0,14107,4403,6657.0,6683.0,18510,123338251.0,575,2023-11-01 14:15:00
51,PHOR,328,182,65615195.0,35058797.0,9857,5246,6657.0,6683.0,15103,100673992.0,510,270,158,64151505.0,34290567.0,9639,5131,6655.0,6683.0,14770,98442072.0,428,2023-11-01 14:20:00
52,PHOR,527,213,99459055.0,51549426.0,14947,7715,6654.0,6682.0,22662,151008481.0,740,453,181,97374206.0,54862399.0,14635,8211,6654.0,6682.0,22846,152236605.0,634,2023-11-01 14:25:00
53,PHOR,481,151,113084395.0,44546501.0,16991,6673,6656.0,6676.0,23664,157630896.0,632,402,124,110803359.0,41186836.0,16650,6166,6655.0,6680.0,22816,151990195.0,526,2023-11-01 14:30:00
54,PHOR,628,210,163808989.0,51162017.0,24608,7667,6657.0,6673.0,32275,214971006.0,838,569,179,161809412.0,49321896.0,24312,7383,6656.0,6680.0,31695,211131308.0,748,2023-11-01 14:35:00
55,PHOR,737,220,156425973.0,45054303.0,23502,6745,6656.0,6680.0,30247,201480276.0,957,687,183,155753246.0,43362547.0,23403,6491,6655.0,6680.0,29894,199115793.0,870,2023-11-01 14:40:00
56,PHOR,344,171,90485378.0,51317657.0,13600,7688,6653.0,6675.0,21288,141803035.0,515,297,128,88821488.0,45492853.0,13356,6812,6650.0,6678.0,20168,134314341.0,425,2023-11-01 14:45:00
57,PHOR,1399,263,340159454.0,48910942.0,51114,7329,6655.0,6674.0,58443,389070396.0,1662,1335,219,338723142.0,48404225.0,50899,7246,6655.0,6680.0,58145,387127367.0,1554,2023-11-01 14:50:00
58,PHOR,984,212,210288126.0,59440181.0,31617,8899,6651.0,6679.0,40516,269728307.0,1196,924,179,208989022.0,54950704.0,31423,8225,6651.0,6681.0,39648,263939726.0,1103,2023-11-01 14:55:00
59,PHOR,215,333,40562868.0,72558330.0,6111,10882,6638.0,6668.0,16993,113121198.0,548,172,308,38292489.0,74447018.0,5770,11162,6636.0,6670.0,16932,112739507.0,480,2023-11-01 15:00:00
60,PHOR,229,188,49473223.0,53344483.0,7460,8003,6632.0,6666.0,15463,102817706.0,417,168,162,47396378.0,50613346.0,7147,7590,6632.0,6668.0,14737,98009724.0,330,2023-11-01 15:05:00
61,PHOR,343,142,35799034.0,43418928.0,5396,6542,6634.0,6637.0,11938,79217962.0,485,294,119,34322546.0,42423528.0,5175,6360,6632.0,6670.0,11535,76746074.0,413,2023-11-01 15:10:00
62,PHOR,295,199,56490000.0,55820075.0,8505,8378,6642.0,6663.0,16883,112310075.0,494,224,174,52752083.0,55846003.0,7954,8376,6632.0,6667.0,16330,108598086.0,398,2023-11-01 15:15:00
63,PHOR,806,291,159788048.0,66667087.0,24052,9992,6643.0,6672.0,34044,226455135.0,1097,749,261,157857361.0,66008206.0,23757,9894,6645.0,6672.0,33651,223865567.0,1010,2023-11-01 15:20:00
64,PHOR,541,330,93021092.0,63600548.0,14001,9530,6644.0,6674.0,23531,156621640.0,871,497,295,91691969.0,62657478.0,13803,9389,6643.0,6673.0,23192,154349447.0,792,2023-11-01 15:25:00
65,PHOR,336,220,46971271.0,42905627.0,7070,6431,6644.0,6672.0,13501,89876898.0,556,265,185,44862882.0,40814459.0,6755,6116,6641.0,6673.0,12871,85677341.0,450,2023-11-01 15:30:00
66,PHOR,262,383,41206582.0,57728729.0,6204,8653,6642.0,6672.0,14857,98935311.0,645,211,349,39707244.0,57471831.0,5980,8615,6640.0,6671.0,14595,97179075.0,560,2023-11-01 15:35:00
67,PHOR,337,269,59847977.0,55265221.0,9010,8285,6642.0,6671.0,17295,115113198.0,606,277,236,58511370.0,53370038.0,8812,7995,6640.0,6675.0,16807,111881408.0,513,2023-11-01 15:40:00
68,PHOR,183,150,29437101.0,29792422.0,4428,4463,6648.0,6675.0,8891,59229523.0,333,142,134,28280947.0,29395819.0,4257,4403,6643.0,6676.0,8660,57676766.0,276,2023-11-01 15:45:00
69,PHOR,321,499,51747394.0,65475952.0,7788,9800,6645.0,6681.0,17588,117223346.0,820,270,450,50454365.0,63195791.0,7595,9471,6643.0,6673.0,17066,113650156.0,720,2023-11-01 15:50:00
70,PHOR,304,268,53416124.0,50844663.0,8029,7609,6653.0,6682.0,15638,104260787.0,572,266,228,50160122.0,49235966.0,7553,7368,6641.0,6682.0,14921,99396088.0,494,2023-11-01 15:55:00
71,PHOR,250,190,43829203.0,40901393.0,6579,6132,6662.0,6670.0,12711,84730596.0,440,203,150,41899340.0,39167278.0,6302,5862,6649.0,6682.0,12164,81066618.0,353,2023-11-01 16:00:00
72,PHOR,269,318,49633241.0,51827201.0,7471,7759,6643.0,6680.0,15230,101460442.0,587,219,281,47441773.0,50230082.0,7142,7519,6643.0,6680.0,14661,97671855.0,500,2023-11-01 16:05:00
73,PHOR,251,253,42063343.0,50755007.0,6331,7613,6644.0,6667.0,13944,92818350.0,504,193,214,41220453.0,48751670.0,6204,7295,6644.0,6683.0,13499,89972123.0,407,2023-11-01 16:10:00
74,PHOR,370,333,50175029.0,55239944.0,7546,8290,6649.0,6663.0,15836,105414973.0,703,310,293,48591412.0,53504599.0,7314,8014,6644.0,6676.0,15328,102096011.0,603,2023-11-01 16:15:00
75,PHOR,386,310,55422728.0,50136604.0,8340,7511,6645.0,6675.0,15851,105559332.0,696,323,268,52853557.0,49208931.0,7952,7369,6647.0,6678.0,15321,102062488.0,591,2023-11-01 16:20:00
76,PHOR,548,330,65080787.0,55346765.0,9785,8288,6651.0,6678.0,18073,120427552.0,878,490,283,62946966.0,54387300.0,9469,8143,6648.0,6679.0,17612,117334266.0,773,2023-11-01 16:25:00
77,PHOR,346,349,61061316.0,64877765.0,9188,9720,6646.0,6675.0,18908,125939081.0,695,302,290,60037442.0,61265758.0,9037,9172,6644.0,6680.0,18209,121303200.0,592,2023-11-01 16:30:00
78,PHOR,321,316,47684962.0,49137454.0,7173,7364,6648.0,6673.0,14537,96822416.0,637,264,276,46405400.0,48840815.0,6982,7308,6646.0,6683.0,14290,95246215.0,540,2023-11-01 16:35:00
79,PHOR,271,230,45610652.0,45326425.0,6862,6788,6647.0,6677.0,13650,90937077.0,501,213,178,44100246.0,39773788.0,6638,5954,6644.0,6680.0,12592,83874034.0,391,2023-11-01 16:40:00
80,PHOR,247,205,33833072.0,31306478.0,5089,4692,6648.0,6672.0,9781,65139550.0,452,186,170,32322128.0,30436600.0,4865,4557,6644.0,6679.0,9422,62758728.0,356,2023-11-01 16:45:00
81,PHOR,268,230,51896762.0,52250210.0,7819,6993,6637.0,7472.0,14812,104146972.0,498,217,201,48049420.0,52297840.0,7241,7413,6636.0,7055.0,14654,100347260.0,418,2023-11-01 16:50:00
82,PHOR,376,245,50144990.0,41589442.0,7547,6228,6644.0,6678.0,13775,91734432.0,621,317,213,48265147.0,41459244.0,7267,6208,6642.0,6678.0,13475,89724391.0,530,2023-11-01 16:55:00
83,PHOR,317,320,48231453.0,51041484.0,7249,7637,6654.0,6683.0,14886,99272937.0,637,274,296,46145764.0,50610904.0,6948,7574,6642.0,6682.0,14522,96756668.0,570,2023-11-01 17:00:00
84,PHOR,427,557,50710380.0,66707058.0,7630,9991,6646.0,6677.0,17621,117417438.0,984,379,478,50343919.0,65773336.0,7576,9842,6645.0,6683.0,17418,116117255.0,857,2023-11-01 17:05:00
85,PHOR,275,397,29745507.0,34780672.0,4471,5205,6653.0,6682.0,9676,64526179.0,672,214,361,27480558.0,33405396.0,4141,4999,6636.0,6682.0,9140,60885954.0,575,2023-11-01 17:10:00
86,PHOR,625,859,124232796.0,149996772.0,18741,22639,6629.0,6626.0,41380,274229568.0,1484,516,781,115815789.0,135836877.0,17475,20354,6628.0,6674.0,37829,251652666.0,1297,2023-11-01 17:15:00
87,PHOR,285,506,40705963.0,53933028.0,6144,8087,6625.0,6669.0,14231,94638991.0,791,221,468,42346540.0,52550765.0,6392,7873,6625.0,6675.0,14265,94897305.0,689,2023-11-01 17:20:00
88,PHOR,196,303,22707664.0,28660061.0,3431,4296,6618.0,6671.0,7727,51367725.0,499,125,259,21103281.0,27843069.0,3191,4172,6613.0,6674.0,7363,48946350.0,384,2023-11-01 17:25:00
89,PHOR,200,315,26836384.0,37101295.0,4043,5575,6638.0,6655.0,9618,63937679.0,515,149,250,24678840.0,36638346.0,3726,5493,6623.0,6670.0,9219,61317186.0,399,2023-11-01 17:30:00
90,PHOR,142,192,14917012.0,24689577.0,2248,3706,6636.0,6662.0,5954,39606589.0,334,92,161,12665651.0,23367082.0,1912,3500,6624.0,6676.0,5412,36032733.0,253,2023-11-01 17:35:00
91,PHOR,363,169,27737713.0,25495292.0,4177,3815,6641.0,6683.0,7992,53233005.0,532,309,132,26115754.0,23606837.0,3936,3532,6635.0,6684.0,7468,49722591.0,441,2023-11-01 17:40:00
92,PHOR,148,190,12896159.0,21475180.0,1941,3221,6644.0,6667.0,5162,34371339.0,338,107,150,11130463.0,19777156.0,1677,2962,6637.0,6677.0,4639,30907619.0,257,2023-11-01 17:45:00
93,PHOR,118,283,11126435.0,26870848.0,1674,4027,6647.0,6673.0,5701,37997283.0,401,80,259,9738967.0,26389254.0,1468,3954,6634.0,6674.0,5422,36128221.0,339,2023-11-01 17:50:00
94,PHOR,169,277,15013947.0,54400488.0,2259,8161,6646.0,6666.0,10420,69414435.0,446,119,247,13155639.0,53593704.0,1981,8031,6641.0,6673.0,10012,66749343.0,366,2023-11-01 17:55:00
95,PHOR,198,254,16536284.0,27918640.0,2488,4191,6646.0,6662.0,6679,44454924.0,452,141,208,14960808.0,25208764.0,2254,3777,6637.0,6674.0,6031,40169572.0,349,2023-11-01 18:00:00
96,PHOR,234,246,32232008.0,41630004.0,4864,6233,6627.0,6679.0,11097,73862012.0,480,185,214,30596025.0,40653083.0,4616,6084,6628.0,6682.0,10700,71249108.0,399,2023-11-01 18:05:00
97,PHOR,307,257,43925283.0,46132039.0,6606,6900,6649.0,6686.0,13506,90057322.0,564,249,221,39721715.0,44428232.0,5990,6646,6631.0,6685.0,12636,84149947.0,470,2023-11-01 18:10:00
98,PHOR,218,172,11825114.0,14816341.0,1776,2220,6658.0,6674.0,3996,26641455.0,390,166,137,11036220.0,14076205.0,1659,2108,6652.0,6678.0,3767,25112425.0,303,2023-11-01 18:15:00
99,PHOR,262,203,31893329.0,26586104.0,4797,3980,6649.0,6680.0,8777,58479433.0,465,210,159,30576762.0,23994632.0,4601,3591,6646.0,6682.0,8192,54571394.0,369,2023-11-01 18:20:00
100,PHOR,152,324,25453885.0,26704399.0,3833,4008,6641.0,6663.0,7841,52158284.0,476,150,301,25288538.0,25292043.0,3809,3788,6639.0,6677.0,7597,50580581.0,451,2023-11-01 18:25:00
101,PHOR,305,128,28915928.0,24180628.0,4354,3618,6641.0,6683.0,7972,53096556.0,433,294,118,33496081.0,28501582.0,5047,4258,6637.0,6694.0,9305,61997663.0,412,2023-11-01 18:30:00
102,PHOR,105,92,13509492.0,17694816.0,2037,2662,6632.0,6647.0,4699,31204308.0,197,85,81,12534443.0,16609133.0,1890,2486,6632.0,6681.0,4376,29143576.0,166,2023-11-01 18:35:00
103,PHOR,67,210,7196100.0,33438591.0,1081,5014,6657.0,6669.0,6095,40634691.0,277,56,214,8956713.0,37164354.0,1351,5567,6630.0,6676.0,6918,46121067.0,270,2023-11-01 18:40:00
104,PHOR,1342,2339,199838246.0,363610350.0,30116,54221,6636.0,6706.0,84337,563448596.0,3681,1246,2155,175705505.0,349476261.0,26410,52122,6653.0,6705.0,78532,525181766.0,3401,2023-11-02 10:05:00
105,PHOR,574,941,43408509.0,114867523.0,6507,17138,6671.0,6703.0,23645,158276032.0,1515,484,842,37482473.0,109606003.0,5626,16357,6662.0,6701.0,21983,147088476.0,1326,2023-11-02 10:10:00
106,PHOR,442,631,58133317.0,102410683.0,8688,15253,6691.0,6714.0,23941,160544000.0,1073,367,582,45617602.0,97386923.0,6843,14510,6666.0,6712.0,21353,143004525.0,949,2023-11-02 10:15:00
107,PHOR,581,938,85340999.0,132270176.0,12791,19706,6672.0,6712.0,32497,217611175.0,1519,501,859,82226445.0,126197714.0,12333,18779,6667.0,6720.0,31112,208424159.0,1360,2023-11-02 10:20:00
108,PHOR,305,635,46232888.0,69922904.0,6924,10417,6677.0,6712.0,17341,116155792.0,940,267,599,43852055.0,67116373.0,6568,9996,6677.0,6714.0,16564,110968428.0,866,2023-11-02 10:25:00
109,PHOR,179,221,29110550.0,30984348.0,4358,4620,6680.0,6707.0,8978,60094898.0,400,125,183,26234679.0,28103013.0,3930,4188,6675.0,6710.0,8118,54337692.0,308,2023-11-02 10:30:00
110,PHOR,257,278,33087854.0,36290551.0,4954,5414,6679.0,6703.0,10368,69378405.0,535,215,247,32173925.0,33926836.0,4817,5054,6679.0,6713.0,9871,66100761.0,462,2023-11-02 10:35:00
111,PHOR,141,120,19171644.0,15397138.0,2871,2294,6678.0,6712.0,5165,34568782.0,261,109,96,17490371.0,16667450.0,2619,2482,6678.0,6715.0,5101,34157821.0,205,2023-11-02 10:40:00
112,PHOR,185,282,31594833.0,29101936.0,4718,4326,6697.0,6727.0,9044,60696769.0,467,143,244,28100785.0,27767081.0,4215,4130,6667.0,6723.0,8345,55867866.0,387,2023-11-02 10:45:00
113,PHOR,228,275,36427445.0,51008376.0,5443,5792,6693.0,8807.0,11235,87435821.0,503,200,233,35918239.0,35334788.0,5375,5258,6682.0,6720.0,10633,71253027.0,433,2023-11-02 10:50:00
114,PHOR,206,208,42635525.0,54624051.0,6387,6334,6675.0,8624.0,12721,97259576.0,414,178,159,40986684.0,51452659.0,6138,5858,6678.0,8783.0,11996,92439343.0,337,2023-11-02 10:55:00
115,PHOR,205,205,43466466.0,45603536.0,6511,6845,6676.0,6662.0,13356,89070002.0,410,181,158,42992862.0,40248889.0,6441,5991,6675.0,6718.0,12432,83241751.0,339,2023-11-02 11:00:00
116,PHOR,291,613,85526393.0,125306083.0,12442,18694,6874.0,6703.0,31136,210832476.0,904,265,563,81937436.0,117609294.0,12299,17539,6662.0,6706.0,29838,199546730.0,828,2023-11-02 11:05:00
117,PHOR,347,356,57952689.0,51995850.0,8307,7764,6976.0,6697.0,16071,109948539.0,703,302,329,54054110.0,54368678.0,7717,8115,7005.0,6700.0,15832,108422788.0,631,2023-11-02 11:10:00
118,PHOR,304,424,66658552.0,80145563.0,10020,12040,6653.0,6657.0,22060,146804115.0,728,257,387,63134677.0,73389037.0,9490,10960,6653.0,6696.0,20450,136523714.0,644,2023-11-02 11:15:00
119,PHOR,464,396,57907321.0,51533362.0,8698,7695,6658.0,6697.0,16393,109440683.0,860,425,370,57269630.0,48286802.0,8602,7217,6658.0,6691.0,15819,105556432.0,795,2023-11-02 11:20:00
120,PHOR,486,472,67620876.0,68635394.0,10149,10265,6663.0,6686.0,20414,136256270.0,958,436,431,66052502.0,66144081.0,9926,9888,6654.0,6689.0,19814,132196583.0,867,2023-11-02 11:25:00
121,PHOR,253,318,36881195.0,44142806.0,5543,6598,6654.0,6690.0,12141,81024001.0,571,231,295,36980039.0,43940109.0,5559,6567,6652.0,6691.0,12126,80920148.0,526,2023-11-02 11:30:00
122,PHOR,863,1144,143742869.0,207009153.0,21622,30964,6648.0,6685.0,52586,350752022.0,2007,812,1102,139737029.0,204422409.0,21035,30565,6643.0,6688.0,51600,344159438.0,1914,2023-11-02 11:35:00
123,PHOR,660,428,71584925.0,79347140.0,10763,11854,6651.0,6694.0,22617,150932065.0,1088,631,406,70933914.0,78451894.0,10666,11719,6650.0,6694.0,22385,149385808.0,1037,2023-11-02 11:40:00
124,PHOR,436,299,55573215.0,43943010.0,8348,6564,6657.0,6695.0,14912,99516225.0,735,407,274,54439175.0,43322974.0,8183,6470,6653.0,6696.0,14653,97762149.0,681,2023-11-02 11:45:00
125,PHOR,1657,1028,309992381.0,225824555.0,46532,33641,6662.0,6713.0,80173,535816936.0,2685,1620,993,304889804.0,223330003.0,45782,33271,6660.0,6712.0,79053,528219807.0,2613,2023-11-02 11:50:00
126,PHOR,315,440,55546832.0,42929066.0,8336,6400,6663.0,6708.0,14736,98475898.0,755,299,413,55323860.0,41753772.0,8302,6223,6664.0,6710.0,14525,97077632.0,712,2023-11-02 11:55:00
127,PHOR,1180,797,247433778.0,102720687.0,37101,15294,6669.0,6716.0,52395,350154465.0,1977,1145,774,245690836.0,101787436.0,36838,15156,6669.0,6716.0,51994,347478272.0,1919,2023-11-02 12:00:00
128,PHOR,416,169,68071476.0,22777369.0,10234,3388,6652.0,6723.0,13622,90848845.0,585,385,143,63033499.0,22329297.0,9448,3320,6672.0,6726.0,12768,85362796.0,528,2023-11-02 12:05:00
129,PHOR,313,361,38991509.0,22439536.0,5844,3348,6672.0,6702.0,9192,61431045.0,674,290,326,37872534.0,21788149.0,5677,3248,6671.0,6708.0,8925,59660683.0,616,2023-11-02 12:10:00
130,PHOR,119,139,15766351.0,12882023.0,2370,1918,6652.0,6716.0,4288,28648374.0,258,89,114,14908074.0,10061371.0,2240,1499,6655.0,6712.0,3739,24969445.0,203,2023-11-02 12:15:00
131,PHOR,261,187,37150290.0,20331533.0,5574,3029,6665.0,6712.0,8603,57481823.0,448,228,151,35073006.0,19493817.0,5267,2904,6659.0,6713.0,8171,54566823.0,379,2023-11-02 12:20:00
132,PHOR,117,114,13941533.0,8329716.0,2092,1238,6664.0,6728.0,3330,22271249.0,231,99,90,15373572.0,7096323.0,2306,1056,6667.0,6720.0,3362,22469895.0,189,2023-11-02 12:25:00
133,PHOR,168,158,25466892.0,20942407.0,3820,3121,6667.0,6710.0,6941,46409299.0,326,146,136,24387508.0,20670837.0,3660,3080,6663.0,6711.0,6740,45058345.0,282,2023-11-02 12:30:00
134,PHOR,182,146,25075874.0,15783679.0,3760,2349,6669.0,6719.0,6109,40859553.0,328,160,116,22740031.0,14221979.0,3410,2118,6669.0,6715.0,5528,36962010.0,276,2023-11-02 12:35:00
135,PHOR,138,319,17330743.0,21321442.0,2599,3178,6668.0,6709.0,5777,38652185.0,457,116,298,16697794.0,19316510.0,2506,2879,6663.0,6709.0,5385,36014304.0,414,2023-11-02 12:40:00
136,PHOR,92,100,4961939.0,6434315.0,744,960,6669.0,6702.0,1704,11396254.0,192,75,75,4278301.0,6820860.0,643,1015,6654.0,6720.0,1658,11099161.0,150,2023-11-02 12:45:00
137,PHOR,427,310,53512529.0,45644925.0,8034,6832,6661.0,6681.0,14866,99157454.0,737,393,264,52320157.0,42861139.0,7857,6385,6659.0,6713.0,14242,95181296.0,657,2023-11-02 12:50:00
138,PHOR,203,152,22557513.0,17210162.0,3388,2570,6658.0,6697.0,5958,39767675.0,355,172,136,21963015.0,16528540.0,3298,2465,6659.0,6705.0,5763,38491555.0,308,2023-11-02 12:55:00
139,PHOR,155,207,18199883.0,23720415.0,2734,3542,6657.0,6697.0,6276,41920298.0,362,132,190,18888283.0,23443668.0,2841,3500,6648.0,6698.0,6341,42331951.0,322,2023-11-02 13:00:00
140,PHOR,149,121,15358516.0,22264851.0,2309,1977,6652.0,11262.0,4286,37623367.0,270,125,99,14912192.0,11631935.0,2242,1733,6651.0,6712.0,3975,26544127.0,224,2023-11-02 13:05:00
141,PHOR,111,120,18405619.0,18416352.0,2791,2747,6595.0,6704.0,5538,36821971.0,231,83,87,13694753.0,17167987.0,2059,2558,6651.0,6711.0,4617,30862740.0,170,2023-11-02 13:10:00
142,PHOR,307,197,64063636.0,46716494.0,9637,6984,6648.0,6689.0,16621,110780130.0,504,272,163,62827415.0,40729802.0,9451,6085,6648.0,6693.0,15536,103557217.0,435,2023-11-02 13:15:00
143,PHOR,171,258,25347715.0,19362573.0,3803,2897,6665.0,6684.0,6700,44710288.0,429,128,244,22976866.0,18896850.0,3454,2826,6652.0,6687.0,6280,41873716.0,372,2023-11-02 13:20:00
144,PHOR,81,50,3469945.0,2947385.0,522,439,6647.0,6714.0,961,6417330.0,131,53,30,2776316.0,2097750.0,418,311,6642.0,6745.0,729,4874066.0,83,2023-11-02 13:25:00
145,PHOR,286,84,20939291.0,7276346.0,3146,1088,6656.0,6688.0,4234,28215637.0,370,265,66,19383782.0,6824841.0,2913,1019,6654.0,6698.0,3932,26208623.0,331,2023-11-02 13:30:00
146,PHOR,77,60,7232982.0,8110749.0,1089,1216,6642.0,6670.0,2305,15343731.0,137,49,40,6587310.0,6976780.0,993,1041,6634.0,6702.0,2034,13564090.0,89,2023-11-02 13:35:00
147,PHOR,91,51,5372523.0,4489295.0,809,671,6641.0,6690.0,1480,9861818.0,142,60,30,4467097.0,3707548.0,674,551,6628.0,6729.0,1225,8174645.0,90,2023-11-02 13:40:00
148,PHOR,130,152,12437640.0,17661978.0,1871,2642,6648.0,6685.0,4513,30099618.0,282,91,132,11509312.0,17218316.0,1733,2575,6641.0,6687.0,4308,28727628.0,223,2023-11-02 13:45:00
149,PHOR,186,289,30257948.0,43681180.0,4552,6528,6647.0,6691.0,11080,73939128.0,475,147,255,27308977.0,42695400.0,4112,6381,6641.0,6691.0,10493,70004377.0,402,2023-11-02 13:50:00
150,PHOR,102,165,16377984.0,15615619.0,2461,2335,6655.0,6688.0,4796,31993603.0,267,83,133,15464677.0,14742149.0,2325,2203,6651.0,6692.0,4528,30206826.0,216,2023-11-02 13:55:00
151,PHOR,189,222,29541079.0,38295304.0,4440,5738,6653.0,6674.0,10178,67836383.0,411,160,207,30605125.0,38922561.0,4602,5819,6650.0,6689.0,10421,69527686.0,367,2023-11-02 14:00:00
152,PHOR,94,95,8035296.0,11376508.0,1209,1699,6646.0,6696.0,2908,19411804.0,189,80,79,8179965.0,11035523.0,1232,1647,6640.0,6700.0,2879,19215488.0,159,2023-11-02 14:05:00
153,PHOR,80,102,8636373.0,13110257.0,1300,1959,6643.0,6692.0,3259,21746630.0,182,54,78,5792926.0,10701148.0,873,1598,6636.0,6697.0,2471,16494074.0,132,2023-11-02 14:10:00
154,PHOR,96,114,14422672.0,24361290.0,2170,3651,6646.0,6672.0,5821,38783962.0,210,75,89,13154236.0,19272350.0,1980,2876,6644.0,6701.0,4856,32426586.0,164,2023-11-02 14:15:00
155,PHOR,173,155,14206135.0,16149952.0,2135,2418,6654.0,6679.0,4553,30356087.0,328,123,116,12302835.0,13671366.0,1851,2043,6647.0,6692.0,3894,25974201.0,239,2023-11-02 14:20:00
156,PHOR,366,344,70819534.0,69969325.0,10655,10463,6647.0,6687.0,21118,140788859.0,710,289,300,62318559.0,58133786.0,9383,8692,6642.0,6688.0,18075,120452345.0,589,2023-11-02 14:25:00
157,PHOR,361,491,49021819.0,72024771.0,7369,10765,6652.0,6691.0,18134,121046590.0,852,320,454,47500339.0,75497468.0,7143,11280,6650.0,6693.0,18423,122997807.0,774,2023-11-02 14:30:00
158,PHOR,434,394,73927337.0,64038084.0,11104,9550,6658.0,6706.0,20654,137965421.0,828,383,362,70453656.0,58687996.0,10592,8757,6652.0,6702.0,19349,129141652.0,745,2023-11-02 14:35:00
159,PHOR,412,522,66968443.0,48003909.0,10065,7194,6654.0,6673.0,17259,114972352.0,934,325,484,60765021.0,44606065.0,9137,6662,6650.0,6696.0,15799,105371086.0,809,2023-11-02 14:40:00
160,PHOR,204,140,11517890.0,10043340.0,1724,1500,6681.0,6696.0,3224,21561230.0,344,166,110,10347543.0,7464028.0,1552,1114,6667.0,6700.0,2666,17811571.0,276,2023-11-02 14:45:00
161,PHOR,205,331,19962682.0,29026108.0,3000,4335,6654.0,6696.0,7335,48988790.0,536,153,308,15969129.0,29351048.0,2400,4384,6654.0,6695.0,6784,45320177.0,461,2023-11-02 14:50:00
162,PHOR,252,322,36409008.0,44382108.0,5473,6657,6652.0,6667.0,12130,80791116.0,574,195,273,33687624.0,37453485.0,5066,5595,6650.0,6694.0,10661,71141109.0,468,2023-11-02 14:55:00
163,PHOR,408,323,65610641.0,59936085.0,9853,8952,6659.0,6695.0,18805,125546726.0,731,359,280,61993441.0,50839201.0,9318,7589,6653.0,6699.0,16907,112832642.0,639,2023-11-02 15:00:00
164,PHOR,430,323,61119334.0,56728309.0,9174,8095,6662.0,7008.0,17269,117847643.0,753,389,293,58905252.0,51908585.0,8856,7751,6651.0,6697.0,16607,110813837.0,682,2023-11-02 15:05:00
165,PHOR,492,269,73007495.0,30565543.0,10961,4569,6661.0,6690.0,15530,103573038.0,761,440,239,70992294.0,28168967.0,10661,4210,6659.0,6691.0,14871,99161261.0,679,2023-11-02 15:10:00
166,PHOR,256,129,35984972.0,17236785.0,5401,2577,6663.0,6689.0,7978,53221757.0,385,199,96,28548395.0,20278207.0,4289,3013,6656.0,6730.0,7302,48826602.0,295,2023-11-02 15:15:00
167,PHOR,209,86,46861642.0,15522729.0,7034,2322,6662.0,6685.0,9356,62384371.0,295,179,65,48009448.0,16971937.0,7208,2536,6661.0,6692.0,9744,64981385.0,244,2023-11-02 15:20:00
168,PHOR,128,270,15286156.0,30792422.0,2294,4609,6664.0,6681.0,6903,46078578.0,398,90,249,13408934.0,29310695.0,2015,4386,6655.0,6683.0,6401,42719629.0,339,2023-11-02 15:25:00
169,PHOR,246,182,33912353.0,31921828.0,5095,4765,6656.0,6699.0,9860,65834181.0,428,181,154,31075575.0,32195722.0,4674,4806,6649.0,6699.0,9480,63271297.0,335,2023-11-02 15:30:00
170,PHOR,167,100,12029825.0,11573922.0,1804,1732,6668.0,6682.0,3536,23603747.0,267,114,73,9734723.0,9680921.0,1463,1444,6654.0,6704.0,2907,19415644.0,187,2023-11-02 15:35:00
171,PHOR,191,320,21286985.0,33346941.0,3195,4987,6663.0,6687.0,8182,54633926.0,511,153,287,19793634.0,32406952.0,2978,4846,6647.0,6687.0,7824,52200586.0,440,2023-11-02 15:40:00
172,PHOR,184,298,21045990.0,25775101.0,3156,3854,6669.0,6688.0,7010,46821091.0,482,130,260,16213717.0,24720386.0,2434,3694,6661.0,6692.0,6128,40934103.0,390,2023-11-02 15:45:00
173,PHOR,108,171,8946021.0,20552522.0,1341,3072,6671.0,6690.0,4413,29498543.0,279,63,154,6575589.0,19841997.0,988,2965,6655.0,6692.0,3953,26417586.0,217,2023-11-02 15:50:00
174,PHOR,175,473,19418764.0,51280032.0,2917,7674,6657.0,6682.0,10591,70698796.0,648,125,440,16611520.0,49657536.0,2501,7430,6642.0,6683.0,9931,66269056.0,565,2023-11-02 15:55:00
175,PHOR,109,484,6841259.0,56669979.0,1024,8478,6681.0,6684.0,9502,63511238.0,593,81,469,5071668.0,56136447.0,762,8398,6656.0,6685.0,9160,61208115.0,550,2023-11-02 16:00:00
176,PHOR,134,99,15744249.0,13929179.0,2363,2079,6663.0,6700.0,4442,29673428.0,233,101,96,13949361.0,14226009.0,2094,2123,6662.0,6701.0,4217,28175370.0,197,2023-11-02 16:05:00
177,PHOR,293,314,53293401.0,56394440.0,7982,8416,6677.0,6701.0,16398,109687841.0,607,247,291,49202855.0,54884581.0,7389,8189,6659.0,6702.0,15578,104087436.0,538,2023-11-02 16:10:00
178,PHOR,321,298,32247343.0,35012499.0,4826,5238,6682.0,6684.0,10064,67259842.0,619,265,239,29050844.0,33218099.0,4355,4963,6671.0,6693.0,9318,62268943.0,504,2023-11-02 16:15:00
179,PHOR,375,522,37522151.0,79925986.0,5621,11943,6675.0,6692.0,17564,117448137.0,897,325,487,35679636.0,78796111.0,5348,11774,6672.0,6692.0,17122,114475747.0,812,2023-11-02 16:20:00
180,PHOR,596,371,79637896.0,59810256.0,11927,8924,6677.0,6702.0,20851,139448152.0,967,563,340,78223574.0,59638550.0,11719,8898,6675.0,6702.0,20617,137862124.0,903,2023-11-02 16:25:00
181,PHOR,582,342,78483414.0,44124843.0,11737,6583,6687.0,6703.0,18320,122608257.0,924,535,297,74833674.0,42632085.0,11205,6359,6679.0,6704.0,17564,117465759.0,832,2023-11-02 16:30:00
182,PHOR,433,454,63652399.0,61058222.0,9525,9101,6683.0,6709.0,18626,124710621.0,887,392,408,61360082.0,57756687.0,9194,8608,6674.0,6710.0,17802,119116769.0,800,2023-11-02 16:35:00
183,PHOR,348,303,42467231.0,27577629.0,6343,4117,6695.0,6698.0,10460,70044860.0,651,302,246,39649621.0,25732039.0,5932,3839,6684.0,6703.0,9771,65381660.0,548,2023-11-02 16:40:00
184,PHOR,396,233,35174677.0,34896450.0,5262,3404,6685.0,10252.0,8666,70071127.0,629,338,179,32685668.0,32197575.0,4892,2999,6681.0,10736.0,7891,64883243.0,517,2023-11-02 16:45:00
185,PHOR,284,161,28152771.0,17597106.0,4212,2623,6684.0,6709.0,6835,45749877.0,445,236,124,25470610.0,16647992.0,3813,2479,6680.0,6716.0,6292,42118602.0,360,2023-11-02 16:50:00
186,PHOR,261,177,27932714.0,19699134.0,4180,2931,6682.0,6721.0,7111,47631848.0,438,220,149,25258489.0,18889516.0,3783,2810,6677.0,6722.0,6593,44148005.0,369,2023-11-02 16:55:00
187,PHOR,320,218,29514074.0,22935270.0,4403,3416,6703.0,6714.0,7819,52449344.0,538,266,167,27144730.0,20374752.0,4061,3034,6684.0,6715.0,7095,47519482.0,433,2023-11-02 17:00:00
188,PHOR,278,189,29132488.0,18221189.0,4355,2724,6689.0,6689.0,7079,47353677.0,467,225,139,27381661.0,14414455.0,4096,2146,6685.0,6717.0,6242,41796116.0,364,2023-11-02 17:05:00
189,PHOR,281,210,30305751.0,18229257.0,4529,2714,6691.0,6717.0,7243,48535008.0,491,228,166,27906500.0,18051682.0,4176,2687,6683.0,6718.0,6863,45958182.0,394,2023-11-02 17:10:00
190,PHOR,532,442,95380153.0,81859623.0,14295,12186,6672.0,6718.0,26481,177239776.0,974,484,392,93245071.0,80058685.0,13977,11914,6671.0,6720.0,25891,173303756.0,876,2023-11-02 17:15:00
191,PHOR,763,492,100124279.0,63535396.0,14983,9469,6683.0,6710.0,24452,163659675.0,1255,715,447,99272470.0,63346420.0,14867,9439,6677.0,6711.0,24306,162618890.0,1162,2023-11-02 17:20:00
192,PHOR,275,226,29924900.0,21035664.0,4476,3133,6686.0,6714.0,7609,50960564.0,501,219,168,27597287.0,17591852.0,4131,2619,6681.0,6717.0,6750,45189139.0,387,2023-11-02 17:25:00
193,PHOR,544,283,91784292.0,43705588.0,13713,6503,6693.0,6721.0,20216,135489880.0,827,500,235,81172626.0,43856368.0,12149,6522,6681.0,6724.0,18671,125028994.0,735,2023-11-02 17:30:00
194,PHOR,426,200,41094299.0,31379507.0,6142,4674,6691.0,6714.0,10816,72473806.0,626,381,128,38492202.0,16826623.0,5756,2504,6687.0,6720.0,8260,55318825.0,509,2023-11-02 17:35:00
195,PHOR,461,240,58323569.0,39752573.0,8721,5944,6688.0,6688.0,14665,98076142.0,701,411,191,55902383.0,38356031.0,8367,5708,6681.0,6720.0,14075,94258414.0,602,2023-11-02 17:40:00
196,PHOR,422,452,50507843.0,53212287.0,7561,7955,6680.0,6689.0,15516,103720130.0,874,378,366,48631703.0,50313577.0,7283,7502,6677.0,6707.0,14785,98945280.0,744,2023-11-02 17:45:00
197,PHOR,481,535,60886799.0,71791950.0,9117,10710,6678.0,6703.0,19827,132678749.0,1016,414,431,55996271.0,69174720.0,8388,10309,6676.0,6710.0,18697,125170991.0,845,2023-11-02 17:50:00
198,PHOR,902,553,105036224.0,59128827.0,15708,8812,6687.0,6710.0,24520,164165051.0,1455,835,419,100316128.0,54803127.0,15020,8155,6679.0,6720.0,23175,155119255.0,1254,2023-11-02 17:55:00
199,PHOR,412,208,48313490.0,20912982.0,7225,3114,6687.0,6716.0,10339,69226472.0,620,361,157,45254874.0,18654530.0,6773,2775,6682.0,6722.0,9548,63909404.0,518,2023-11-02 18:00:00
200,PHOR,426,276,43683270.0,19826212.0,6535,2957,6685.0,6705.0,9492,63509482.0,702,369,211,39670230.0,16897295.0,5937,2517,6682.0,6713.0,8454,56567525.0,580,2023-11-02 18:05:00
201,PHOR,212,200,21966541.0,21772177.0,3285,3251,6687.0,6697.0,6536,43738718.0,412,161,134,19268708.0,16947278.0,2886,2526,6677.0,6709.0,5412,36215986.0,295,2023-11-02 18:10:00
202,PHOR,433,321,66657434.0,37366043.0,9981,5591,6678.0,6683.0,15572,104023477.0,754,383,284,64170401.0,34512900.0,9611,5142,6677.0,6712.0,14753,98683301.0,667,2023-11-02 18:15:00
203,PHOR,363,430,37118756.0,26279747.0,5543,3923,6697.0,6699.0,9466,63398503.0,793,319,368,38050516.0,26058995.0,5698,3881,6678.0,6715.0,9579,64109511.0,687,2023-11-02 18:20:00
204,PHOR,331,199,45897758.0,17828614.0,6867,2662,6684.0,6697.0,9529,63726372.0,530,325,170,45505170.0,18334019.0,6809,2735,6683.0,6703.0,9544,63839189.0,495,2023-11-02 18:25:00
205,PHOR,149,174,16652353.0,21985716.0,2493,3283,6680.0,6697.0,5776,38638069.0,323,130,141,15908626.0,19452027.0,2382,2901,6679.0,6705.0,5283,35360653.0,271,2023-11-02 18:30:00
206,PHOR,446,227,66711918.0,40786528.0,9954,6034,6702.0,6759.0,15988,107498446.0,673,415,172,41939174.0,28243096.0,6271,4204,6688.0,6718.0,10475,70182270.0,587,2023-11-02 18:35:00
207,PHOR,148,292,22782996.0,36933426.0,3403,5521,6695.0,6690.0,8924,59716422.0,440,129,226,21289873.0,32456682.0,3182,4836,6691.0,6711.0,8018,53746555.0,355,2023-11-02 18:40:00
208,PHOR,1150,18803,164556910.0,4394694729.0,24590,654285,6692.0,6717.0,678875,4559251639.0,19953,1060,18702,153541936.0,4382901116.0,22936,652551,6694.0,6717.0,675487,4536443052.0,19762,2023-11-03 10:05:00
209,PHOR,628,704,43110385.0,54618676.0,6441,8117,6693.0,6729.0,14558,97729061.0,1332,572,662,40184882.0,51697270.0,6001,7688,6696.0,6724.0,13689,91882152.0,1234,2023-11-03 10:10:00
210,PHOR,233,332,13335229.0,31770827.0,1992,4711,6694.0,6744.0,6703,45106056.0,565,180,272,11885401.0,26192235.0,1776,3887,6692.0,6738.0,5663,38077636.0,452,2023-11-03 10:15:00
211,PHOR,174,113,21180065.0,12834693.0,3173,1897,6675.0,6766.0,5070,34014758.0,287,140,76,19828081.0,10280073.0,2971,1526,6674.0,6737.0,4497,30108154.0,216,2023-11-03 10:20:00
212,PHOR,112,70,16862397.0,12696843.0,2524,1895,6681.0,6700.0,4419,29559240.0,182,77,54,15609734.0,11249034.0,2335,1672,6685.0,6728.0,4007,26858768.0,131,2023-11-03 10:25:00
213,PHOR,174,90,23372134.0,15556406.0,3494,2308,6689.0,6740.0,5802,38928540.0,264,121,76,20796671.0,13802930.0,3115,2050,6676.0,6733.0,5165,34599601.0,197,2023-11-03 10:30:00
214,PHOR,180,103,20698759.0,18662568.0,3095,2770,6688.0,6737.0,5865,39361327.0,283,138,71,19297347.0,14729493.0,2888,2187,6682.0,6735.0,5075,34026840.0,209,2023-11-03 10:35:00
215,PHOR,228,232,44916846.0,40107847.0,6726,5973,6678.0,6715.0,12699,85024693.0,460,197,151,43194128.0,33942413.0,6468,5044,6678.0,6729.0,11512,77136541.0,348,2023-11-03 10:40:00
216,PHOR,226,344,40982974.0,50053189.0,6144,7448,6670.0,6720.0,13592,91036163.0,570,198,321,40983584.0,49346209.0,6142,7339,6673.0,6724.0,13481,90329793.0,519,2023-11-03 10:45:00
217,PHOR,618,799,85471205.0,113953457.0,12812,16965,6671.0,6717.0,29777,199424662.0,1417,592,772,84930891.0,113222112.0,12733,16852,6670.0,6719.0,29585,198153003.0,1364,2023-11-03 10:50:00
218,PHOR,696,1161,109387010.0,171106000.0,16413,25491,6665.0,6712.0,41904,280493010.0,1857,646,1135,108256673.0,169854250.0,16243,25298,6665.0,6714.0,41541,278110923.0,1781,2023-11-03 10:55:00
219,PHOR,227,1063,37591789.0,114760923.0,5640,17118,6665.0,6704.0,22758,152352712.0,1290,205,1048,35708651.0,115053099.0,5356,17161,6667.0,6704.0,22517,150761750.0,1253,2023-11-03 11:00:00
220,PHOR,385,807,53913729.0,130005180.0,8086,19383,6668.0,6707.0,27469,183918909.0,1192,345,748,52594290.0,127701848.0,7888,19034,6668.0,6709.0,26922,180296138.0,1093,2023-11-03 11:05:00
221,PHOR,446,1307,46880370.0,162675634.0,7030,24270,6669.0,6703.0,31300,209556004.0,1753,406,1264,44334392.0,161858611.0,6649,24146,6668.0,6703.0,30795,206193003.0,1670,2023-11-03 11:10:00
222,PHOR,395,662,78426816.0,134473399.0,11784,20085,6655.0,6695.0,31869,212900215.0,1057,341,627,77281520.0,120172785.0,11613,17918,6655.0,6707.0,29531,197454305.0,968,2023-11-03 11:15:00
223,PHOR,647,1031,95883422.0,108494862.0,14410,16212,6654.0,6692.0,30622,204378284.0,1678,598,993,94292610.0,105733205.0,14169,15794,6655.0,6695.0,29963,200025815.0,1591,2023-11-03 11:20:00
224,PHOR,654,579,125878975.0,82564568.0,19000,12339,6625.0,6691.0,31339,208443543.0,1233,602,549,122161820.0,78162912.0,18425,11678,6630.0,6693.0,30103,200324732.0,1151,2023-11-03 11:25:00
225,PHOR,227,198,43809404.0,44403305.0,6595,6639,6643.0,6688.0,13234,88212709.0,425,182,169,42049343.0,42793307.0,6332,6396,6641.0,6691.0,12728,84842650.0,351,2023-11-03 11:30:00
226,PHOR,443,635,88686529.0,101318824.0,13371,15187,6633.0,6671.0,28558,190005353.0,1078,377,562,85494369.0,97296449.0,12892,14572,6632.0,6677.0,27464,182790818.0,939,2023-11-03 11:35:00
227,PHOR,440,615,74396592.0,94592069.0,11219,14202,6631.0,6660.0,25421,168988661.0,1055,355,571,70788507.0,101585555.0,10679,15224,6629.0,6673.0,25903,172374062.0,926,2023-11-03 11:40:00
228,PHOR,429,746,80680307.0,117903955.0,12159,17675,6635.0,6671.0,29834,198584262.0,1175,348,697,76442998.0,116037985.0,11528,17397,6631.0,6670.0,28925,192480983.0,1045,2023-11-03 11:45:00
229,PHOR,1364,853,237957552.0,141166144.0,35818,21165,6644.0,6670.0,56983,379123696.0,2217,1283,723,234922923.0,134722748.0,35360,20181,6644.0,6676.0,55541,369645671.0,2006,2023-11-03 11:50:00
230,PHOR,703,390,91892608.0,69613803.0,13840,10445,6640.0,6665.0,24285,161506411.0,1093,648,334,92582798.0,70033970.0,13953,10492,6635.0,6675.0,24445,162616768.0,982,2023-11-03 11:55:00
231,PHOR,254,224,40405661.0,38069824.0,6093,5715,6631.0,6661.0,11808,78475485.0,478,202,167,34138889.0,32606852.0,5147,4887,6633.0,6672.0,10034,66745741.0,369,2023-11-03 12:00:00
232,PHOR,222,248,34331995.0,39933583.0,5177,5986,6632.0,6671.0,11163,74265578.0,470,182,209,34577198.0,40299058.0,5215,6039,6630.0,6673.0,11254,74876256.0,391,2023-11-03 12:05:00
233,PHOR,1097,1111,352282359.0,360053910.0,53387,54281,6599.0,6633.0,107668,712336269.0,2208,794,894,318435132.0,320547450.0,48252,48180,6599.0,6653.0,96432,638982582.0,1688,2023-11-03 12:10:00
234,PHOR,2845,3195,821881048.0,938155415.0,122558,141749,6706.0,6618.0,264307,1760036463.0,6040,2216,2766,760444520.0,884464870.0,114582,133384,6637.0,6631.0,247966,1644909390.0,4982,2023-11-03 12:15:00
235,PHOR,967,1375,211445589.0,320413213.0,32135,48484,6580.0,6609.0,80619,531858802.0,2342,710,1236,185217713.0,295482968.0,28145,44596,6581.0,6626.0,72741,480700681.0,1946,2023-11-03 12:20:00
236,PHOR,966,1226,193451565.0,236090845.0,29368,35706,6587.0,6612.0,65074,429542410.0,2192,710,1098,186375790.0,229303984.0,28337,34651,6577.0,6618.0,62988,415679774.0,1808,2023-11-03 12:25:00
237,PHOR,713,1109,152051599.0,225532094.0,23045,34072,6598.0,6619.0,57117,377583693.0,1822,533,1007,144698213.0,217254800.0,21979,32807,6583.0,6622.0,54786,361953013.0,1540,2023-11-03 12:30:00
238,PHOR,637,946,130663637.0,167111963.0,19828,25292,6590.0,6607.0,45120,297775600.0,1583,488,861,124324816.0,157493623.0,18896,23793,6579.0,6619.0,42689,281818439.0,1349,2023-11-03 12:35:00
239,PHOR,572,536,137657970.0,140131215.0,20796,21139,6619.0,6629.0,41935,277789185.0,1108,429,456,121678169.0,134113137.0,18461,20229,6591.0,6630.0,38690,255791306.0,885,2023-11-03 12:40:00
240,PHOR,1029,586,168884580.0,124872780.0,25550,18846,6610.0,6626.0,44396,293757360.0,1615,918,506,147271891.0,119956420.0,22319,18084,6598.0,6633.0,40403,267228311.0,1424,2023-11-03 12:45:00
241,PHOR,455,380,81093972.0,75317165.0,12278,11352,6605.0,6635.0,23630,156411137.0,835,386,326,77373122.0,73969107.0,11725,11145,6599.0,6637.0,22870,151342229.0,712,2023-11-03 12:50:00
242,PHOR,410,370,66915454.0,73419748.0,10133,11114,6604.0,6606.0,21247,140335202.0,780,354,298,66385158.0,65218676.0,10060,9822,6599.0,6640.0,19882,131603834.0,652,2023-11-03 12:55:00
243,PHOR,343,535,71976698.0,100274962.0,10919,15143,6592.0,6622.0,26062,172251660.0,878,248,487,61141846.0,97707296.0,9273,14739,6594.0,6629.0,24012,158849142.0,735,2023-11-03 13:00:00
244,PHOR,512,448,84177350.0,103612464.0,12742,15608,6606.0,6638.0,28350,187789814.0,960,422,405,80544933.0,101722907.0,12202,15324,6601.0,6638.0,27526,182267840.0,827,2023-11-03 13:05:00
245,PHOR,588,439,147756392.0,125203030.0,22366,18841,6606.0,6645.0,41207,272959422.0,1027,504,364,134710381.0,120142519.0,20405,18073,6602.0,6648.0,38478,254852900.0,868,2023-11-03 13:10:00
246,PHOR,511,373,112222071.0,98937447.0,16969,14885,6613.0,6647.0,31854,211159518.0,884,447,324,105464335.0,95782426.0,15958,14408,6609.0,6648.0,30366,201246761.0,771,2023-11-03 13:15:00
247,PHOR,1273,891,278561930.0,221100953.0,42056,33191,6624.0,6661.0,75247,499662883.0,2164,1241,808,276663435.0,211548349.0,41791,31755,6620.0,6662.0,73546,488211784.0,2049,2023-11-03 13:20:00
248,PHOR,886,677,174781592.0,145468620.0,26395,21851,6622.0,6657.0,48246,320250212.0,1563,837,609,170838970.0,144075687.0,25828,21633,6614.0,6660.0,47461,314914657.0,1446,2023-11-03 13:25:00
249,PHOR,709,524,153388023.0,111281066.0,23194,16755,6613.0,6642.0,39949,264669089.0,1233,661,466,151981566.0,107789186.0,22992,16206,6610.0,6651.0,39198,259770752.0,1127,2023-11-03 13:30:00
250,PHOR,468,312,77880547.0,73287336.0,11797,11038,6602.0,6640.0,22835,151167883.0,780,414,272,75861229.0,69898089.0,11491,10515,6602.0,6647.0,22006,145759318.0,686,2023-11-03 13:35:00
251,PHOR,727,736,191091342.0,196622631.0,28999,29715,6590.0,6617.0,58714,387713973.0,1463,604,681,186563100.0,188459877.0,28328,28397,6586.0,6637.0,56725,375022977.0,1285,2023-11-03 13:40:00
252,PHOR,510,505,118414281.0,110304692.0,17978,16657,6587.0,6622.0,34635,228718973.0,1015,436,457,116747753.0,105062908.0,17731,15840,6584.0,6633.0,33571,221810661.0,893,2023-11-03 13:45:00
253,PHOR,298,213,52511102.0,56397534.0,7968,8522,6590.0,6618.0,16490,108908636.0,511,193,170,48675061.0,51845567.0,7389,7818,6588.0,6632.0,15207,100520628.0,363,2023-11-03 13:50:00
254,PHOR,287,190,60903068.0,40468474.0,7414,6116,8215.0,6617.0,13530,101371542.0,477,213,157,44450729.0,39285205.0,6750,5933,6585.0,6621.0,12683,83735934.0,370,2023-11-03 13:55:00
255,PHOR,336,589,76668996.0,110491028.0,11654,16707,6579.0,6613.0,28361,187160024.0,925,267,545,72313482.0,110569483.0,10989,16712,6581.0,6616.0,27701,182882965.0,812,2023-11-03 14:00:00
256,PHOR,201,215,34302013.0,38067068.0,5213,5748,6580.0,6623.0,10961,72369081.0,416,134,170,31811046.0,37243987.0,4835,5619,6579.0,6628.0,10454,69055033.0,304,2023-11-03 14:05:00
257,PHOR,347,348,83175361.0,84034214.0,12612,12683,6595.0,6626.0,25295,167209575.0,695,287,316,76021153.0,79324609.0,11543,11964,6586.0,6630.0,23507,155345762.0,603,2023-11-03 14:10:00
258,PHOR,298,297,66342089.0,71337389.0,10070,10768,6588.0,6625.0,20838,137679478.0,595,255,267,63762039.0,70383607.0,9681,10615,6586.0,6631.0,20296,134145646.0,522,2023-11-03 14:15:00
259,PHOR,857,590,172483654.0,130529992.0,26075,19656,6615.0,6641.0,45731,303013646.0,1447,815,547,166554776.0,126783489.0,25256,19091,6595.0,6641.0,44347,293338265.0,1362,2023-11-03 14:20:00
260,PHOR,629,436,100368834.0,73996250.0,15194,11140,6606.0,6642.0,26334,174365084.0,1065,578,414,98333899.0,72627365.0,14904,10933,6598.0,6643.0,25837,170961264.0,992,2023-11-03 14:25:00
261,PHOR,446,327,80644119.0,48913208.0,12199,7365,6611.0,6641.0,19564,129557327.0,773,405,308,81801360.0,45504190.0,12380,6850,6608.0,6643.0,19230,127305550.0,713,2023-11-03 14:30:00
262,PHOR,487,341,89656020.0,68459702.0,13582,10310,6601.0,6640.0,23892,158115722.0,828,444,301,88635258.0,66435240.0,13434,10002,6598.0,6642.0,23436,155070498.0,745,2023-11-03 14:35:00
263,PHOR,663,294,102940490.0,59858386.0,15597,9027,6600.0,6631.0,24624,162798876.0,957,615,279,98954331.0,58987420.0,14994,8878,6600.0,6644.0,23872,157941751.0,894,2023-11-03 14:40:00
264,PHOR,566,442,112551875.0,86131798.0,17041,12979,6605.0,6636.0,30020,198683673.0,1008,484,388,107831556.0,84903127.0,16350,12790,6595.0,6638.0,29140,192734683.0,872,2023-11-03 14:45:00
265,PHOR,370,320,48861476.0,45986733.0,7404,6929,6599.0,6637.0,14333,94848209.0,690,328,299,50554393.0,45577583.0,7660,6863,6600.0,6641.0,14523,96131976.0,627,2023-11-03 14:50:00
266,PHOR,482,296,79370191.0,65526467.0,11995,9870,6617.0,6639.0,21865,144896658.0,778,447,254,78894086.0,63476794.0,11950,9560,6602.0,6640.0,21510,142370880.0,701,2023-11-03 14:55:00
267,PHOR,166,99,30543277.0,24151055.0,4630,3632,6597.0,6650.0,8262,54694332.0,265,130,84,29641796.0,25562651.0,4494,3845,6596.0,6648.0,8339,55204447.0,214,2023-11-03 15:00:00
268,PHOR,192,161,35139786.0,39683963.0,5319,5976,6606.0,6641.0,11295,74823749.0,353,152,140,34078731.0,37939501.0,5164,5712,6599.0,6642.0,10876,72018232.0,292,2023-11-03 15:05:00
269,PHOR,234,208,52401620.0,58951369.0,7935,8834,6604.0,6673.0,16769,111352989.0,442,196,179,50041778.0,57760037.0,7581,8664,6601.0,6667.0,16245,107801815.0,375,2023-11-03 15:10:00
270,PHOR,227,195,49508027.0,47484216.0,7508,7167,6594.0,6625.0,14675,96992243.0,422,185,174,47430967.0,45815627.0,7194,6898,6593.0,6642.0,14092,93246594.0,359,2023-11-03 15:15:00
271,PHOR,307,322,43706729.0,55650593.0,6618,8367,6604.0,6651.0,14985,99357322.0,629,269,301,41914283.0,54850841.0,6350,8241,6601.0,6656.0,14591,96765124.0,570,2023-11-03 15:20:00
272,PHOR,311,313,62005153.0,63186672.0,9389,9516,6604.0,6640.0,18905,125191825.0,624,262,287,57922559.0,63007574.0,8782,9489,6596.0,6640.0,18271,120930133.0,549,2023-11-03 15:25:00
273,PHOR,317,299,58526691.0,58329378.0,8857,8783,6608.0,6641.0,17640,116856069.0,616,268,269,56488128.0,57645887.0,8552,8678,6605.0,6643.0,17230,114134015.0,537,2023-11-03 15:30:00
274,PHOR,745,784,222112756.0,205787088.0,33418,30931,6647.0,6653.0,64349,427899844.0,1529,657,692,203798025.0,194371636.0,30852,29150,6606.0,6668.0,60002,398169661.0,1349,2023-11-03 15:35:00
275,PHOR,799,454,207128699.0,109561498.0,31290,16460,6620.0,6656.0,47750,316690197.0,1253,752,413,203711707.0,105291344.0,30795,15811,6615.0,6659.0,46606,309003051.0,1165,2023-11-03 15:40:00
276,PHOR,308,275,50812774.0,47384330.0,7672,7120,6623.0,6655.0,14792,98197104.0,583,275,245,47145801.0,45602960.0,7128,6851,6614.0,6656.0,13979,92748761.0,520,2023-11-03 15:45:00
277,PHOR,368,599,76908378.0,105774281.0,11646,15974,6604.0,6622.0,27620,182682659.0,967,339,557,75641360.0,98716578.0,11454,14851,6604.0,6647.0,26305,174357938.0,896,2023-11-03 15:50:00
278,PHOR,362,361,73212974.0,73303786.0,11059,11026,6620.0,6648.0,22085,146516760.0,723,316,337,69172630.0,72149166.0,10474,10855,6604.0,6647.0,21329,141321796.0,653,2023-11-03 15:55:00
279,PHOR,409,394,59797812.0,58773962.0,9042,8844,6613.0,6646.0,17886,118571774.0,803,368,352,59806669.0,56983384.0,9045,8570,6612.0,6649.0,17615,116790053.0,720,2023-11-03 16:00:00
280,PHOR,369,282,58740948.0,48037834.0,8877,7225,6617.0,6649.0,16102,106778782.0,651,336,254,59029485.0,47292254.0,8937,7110,6605.0,6652.0,16047,106321739.0,590,2023-11-03 16:05:00
281,PHOR,390,243,61789966.0,58691420.0,9344,8825,6613.0,6651.0,18169,120481386.0,633,353,211,60430235.0,57325010.0,9143,8619,6609.0,6651.0,17762,117755245.0,564,2023-11-03 16:10:00
282,PHOR,371,160,44735199.0,32752198.0,6769,4928,6609.0,6646.0,11697,77487397.0,531,345,143,42979310.0,31934187.0,6506,4803,6606.0,6649.0,11309,74913497.0,488,2023-11-03 16:15:00
283,PHOR,135,107,26062963.0,31717890.0,3944,4767,6608.0,6654.0,8711,57780853.0,242,88,87,25014627.0,31150085.0,3789,4678,6602.0,6659.0,8467,56164712.0,175,2023-11-03 16:20:00
284,PHOR,408,402,82677274.0,90006969.0,12502,13533,6613.0,6651.0,26035,172684243.0,810,374,365,73844680.0,84668425.0,11175,12729,6608.0,6652.0,23904,158513105.0,739,2023-11-03 16:25:00
285,PHOR,253,286,35309083.0,39547312.0,5340,5953,6612.0,6643.0,11293,74856395.0,539,220,262,34063246.0,38553882.0,5153,5802,6610.0,6645.0,10955,72617128.0,482,2023-11-03 16:30:00
286,PHOR,159,161,38453068.0,39884451.0,5820,5995,6607.0,6653.0,11815,78337519.0,320,139,133,34445798.0,38556321.0,5217,5792,6603.0,6657.0,11009,73002119.0,272,2023-11-03 16:35:00
287,PHOR,124,136,25229486.0,29187165.0,3813,4386,6617.0,6655.0,8199,54416651.0,260,112,108,25478231.0,25117795.0,3855,3774,6609.0,6655.0,7629,50596026.0,220,2023-11-03 16:40:00
288,PHOR,158,134,27930855.0,26492591.0,4222,3983,6616.0,6651.0,8205,54423446.0,292,137,121,28119455.0,25897629.0,4251,3893,6615.0,6652.0,8144,54017084.0,258,2023-11-03 16:45:00
289,PHOR,237,285,54259973.0,86253359.0,8216,12979,6604.0,6646.0,21195,140513332.0,522,209,253,53874178.0,70335936.0,8158,10574,6604.0,6652.0,18732,124210114.0,462,2023-11-03 16:50:00
290,PHOR,373,266,66917910.0,67302226.0,10131,10129,6605.0,6645.0,20260,134220136.0,639,318,233,65677342.0,66068314.0,9946,9940,6603.0,6647.0,19886,131745656.0,551,2023-11-03 16:55:00
291,PHOR,216,128,32202756.0,30097832.0,4840,4533,6653.0,6640.0,9373,62300588.0,344,185,109,29308204.0,29229005.0,4438,4398,6604.0,6646.0,8836,58537209.0,294,2023-11-03 17:00:00
292,PHOR,575,468,98855426.0,73662494.0,14934,11097,6619.0,6638.0,26031,172517920.0,1043,519,438,96143933.0,72268396.0,14552,10884,6607.0,6640.0,25436,168412329.0,957,2023-11-03 17:05:00
293,PHOR,235,190,39127686.0,36491334.0,5919,5494,6611.0,6642.0,11413,75619020.0,425,206,166,38483623.0,35823072.0,5824,5391,6608.0,6645.0,11215,74306695.0,372,2023-11-03 17:10:00
294,PHOR,369,205,50091788.0,39652893.0,7580,5971,6608.0,6641.0,13551,89744681.0,574,343,181,50473607.0,40403832.0,7638,6081,6608.0,6644.0,13719,90877439.0,524,2023-11-03 17:15:00
295,PHOR,179,122,20818389.0,16926708.0,3150,2545,6609.0,6651.0,5695,37745097.0,301,155,107,20437170.0,16455278.0,3094,2474,6605.0,6651.0,5568,36892448.0,262,2023-11-03 17:20:00
296,PHOR,187,225,29401023.0,30665655.0,4454,4620,6601.0,6638.0,9074,60066678.0,412,153,195,28557861.0,29903463.0,4328,4503,6598.0,6641.0,8831,58461324.0,348,2023-11-03 17:25:00
297,PHOR,150,147,18026789.0,19868940.0,2728,2989,6608.0,6647.0,5717,37895729.0,297,108,126,17045312.0,19373207.0,2582,2914,6602.0,6648.0,5496,36418519.0,234,2023-11-03 17:30:00
298,PHOR,294,189,44741123.0,35942057.0,6764,5406,6615.0,6649.0,12170,80683180.0,483,249,162,43960537.0,35433188.0,6658,5329,6603.0,6649.0,11987,79393725.0,411,2023-11-03 17:35:00
299,PHOR,272,171,40925014.0,33612032.0,6193,5049,6608.0,6657.0,11242,74537046.0,443,225,134,35820664.0,32266509.0,5427,4847,6600.0,6657.0,10274,68087173.0,359,2023-11-03 17:40:00
300,PHOR,239,192,36374142.0,28859325.0,5508,4339,6604.0,6651.0,9847,65233467.0,431,208,169,34260480.0,27385146.0,5189,4116,6603.0,6653.0,9305,61645626.0,377,2023-11-03 17:45:00
301,PHOR,140,119,18019199.0,19322687.0,2724,2904,6615.0,6654.0,5628,37341886.0,259,114,98,17516520.0,18462545.0,2649,2774,6613.0,6656.0,5423,35979065.0,212,2023-11-03 17:50:00
302,PHOR,192,210,29347953.0,12246903.0,4432,1843,6622.0,6645.0,6275,41594856.0,402,131,189,14733616.0,12268483.0,2228,1846,6613.0,6646.0,4074,27002099.0,320,2023-11-03 17:55:00
303,PHOR,146,286,32911270.0,27097692.0,4976,4081,6614.0,6640.0,9057,60008962.0,432,91,257,31414875.0,25807125.0,4758,3884,6603.0,6644.0,8642,57222000.0,348,2023-11-03 18:00:00
304,PHOR,172,131,15739430.0,19177853.0,2374,2883,6630.0,6652.0,5257,34917283.0,303,114,111,13056622.0,18014253.0,1976,2707,6608.0,6655.0,4683,31070875.0,225,2023-11-03 18:05:00
305,PHOR,464,565,95613602.0,90871696.0,14384,13665,6647.0,6650.0,28049,186485298.0,1029,319,536,65971225.0,89434593.0,9969,13449,6618.0,6650.0,23418,155405818.0,855,2023-11-03 18:10:00
306,PHOR,271,251,48520266.0,38161955.0,7300,5734,6647.0,6655.0,13034,86682221.0,522,211,221,41959277.0,36037005.0,6332,5411,6627.0,6660.0,11743,77996282.0,432,2023-11-03 18:15:00
307,PHOR,149,147,22224688.0,23274612.0,3348,3499,6638.0,6652.0,6847,45499300.0,296,131,114,21261232.0,22505545.0,3204,3380,6636.0,6658.0,6584,43766777.0,245,2023-11-03 18:20:00
308,PHOR,96,134,14064520.0,19796136.0,2120,2854,6634.0,6936.0,4974,33860656.0,230,93,109,17802934.0,20896115.0,2688,3136,6623.0,6663.0,5824,38699049.0,202,2023-11-03 18:25:00
309,PHOR,310,68,29117832.0,15198120.0,4387,2284,6637.0,6654.0,6671,44315952.0,378,292,47,26920070.0,14583797.0,4058,2190,6634.0,6659.0,6248,41503867.0,339,2023-11-03 18:30:00
310,PHOR,118,128,22085445.0,24010481.0,3310,3609,6672.0,6653.0,6919,46095926.0,246,102,108,19927245.0,23548882.0,3005,3535,6631.0,6662.0,6540,43476127.0,210,2023-11-03 18:35:00
311,PHOR,147,116,15429097.0,14918306.0,2322,2246,6645.0,6642.0,4568,30347403.0,263,138,108,17083940.0,17657162.0,2574,2654,6637.0,6653.0,5228,34741102.0,246,2023-11-03 18:40:00
312,PHOR,3754,1990,1074148699.0,465545133.0,159649,69166,6728.0,6731.0,228815,1539693832.0,5744,3598,1873,1028669507.0,449219782.0,154545,66728,6656.0,6732.0,221273,1477889289.0,5471,2023-11-06 10:05:00
313,PHOR,1442,931,197940695.0,109178322.0,29769,16373,6649.0,6668.0,46142,307119017.0,2373,1393,892,194929448.0,106108995.0,29312,15899,6650.0,6674.0,45211,301038443.0,2285,2023-11-06 10:10:00
314,PHOR,656,487,129539539.0,95053319.0,19498,14211,6644.0,6689.0,33709,224592858.0,1143,620,438,126982047.0,92254391.0,19113,13789,6644.0,6690.0,32902,219236438.0,1058,2023-11-06 10:15:00
315,PHOR,604,538,93102771.0,60604125.0,13994,9077,6653.0,6677.0,23071,153706896.0,1142,559,497,91720385.0,58744106.0,13796,8798,6648.0,6677.0,22594,150464491.0,1056,2023-11-06 10:20:00
316,PHOR,399,360,52942539.0,46140987.0,7957,6900,6654.0,6687.0,14857,99083526.0,759,365,325,48295474.0,44557039.0,7261,6665,6651.0,6685.0,13926,92852513.0,690,2023-11-06 10:25:00
317,PHOR,262,443,60906757.0,69666411.0,9145,10409,6660.0,6693.0,19554,130573168.0,705,225,418,58392482.0,68494311.0,8775,10233,6654.0,6693.0,19008,126886793.0,643,2023-11-06 10:30:00
318,PHOR,178,248,39439270.0,47532727.0,5923,7106,6659.0,6689.0,13029,86971997.0,426,150,230,38342101.0,46564385.0,5761,6961,6655.0,6689.0,12722,84906486.0,380,2023-11-06 10:35:00
319,PHOR,151,124,21723578.0,24003149.0,3262,3593,6660.0,6681.0,6855,45726727.0,275,115,99,21271125.0,23425472.0,3195,3503,6658.0,6687.0,6698,44696597.0,214,2023-11-06 10:40:00
320,PHOR,104,121,16257850.0,16809680.0,2438,2513,6669.0,6689.0,4951,33067530.0,225,81,102,15696638.0,16159519.0,2358,2416,6657.0,6689.0,4774,31856157.0,183,2023-11-06 10:45:00
321,PHOR,573,631,123875455.0,103064928.0,18547,15363,6679.0,6709.0,33910,226940383.0,1204,535,598,119842817.0,100365031.0,17988,14969,6662.0,6705.0,32957,220207848.0,1133,2023-11-06 10:50:00
322,PHOR,596,358,105411203.0,69552882.0,15802,10383,6671.0,6699.0,26185,174964085.0,954,560,316,104639959.0,67564723.0,15688,10078,6670.0,6704.0,25766,172204682.0,876,2023-11-06 10:55:00
323,PHOR,133,105,24061402.0,20906763.0,3605,3122,6674.0,6697.0,6727,44968165.0,238,109,94,23119087.0,20674892.0,3471,3087,6661.0,6697.0,6558,43793979.0,203,2023-11-06 11:00:00
324,PHOR,624,735,145063619.0,185517083.0,21799,27718,6655.0,6693.0,49517,330580702.0,1359,541,651,138731175.0,171455901.0,20845,25601,6655.0,6697.0,46446,310187076.0,1192,2023-11-06 11:05:00
325,PHOR,321,481,52565378.0,70524971.0,7909,10565,6646.0,6675.0,18474,123090349.0,802,293,462,50673718.0,71172376.0,7623,10659,6647.0,6677.0,18282,121846094.0,755,2023-11-06 11:10:00
326,PHOR,418,776,58366287.0,97435719.0,8784,14580,6645.0,6683.0,23364,155802006.0,1194,388,761,57225078.0,97008735.0,8611,14522,6646.0,6680.0,23133,154233813.0,1149,2023-11-06 11:15:00
327,PHOR,211,307,36304958.0,44900058.0,5455,6711,6655.0,6691.0,12166,81205016.0,518,189,286,33968321.0,43509119.0,5105,6503,6654.0,6691.0,11608,77477440.0,475,2023-11-06 11:20:00
328,PHOR,864,1332,183725239.0,214723388.0,27550,32101,6669.0,6689.0,59651,398448627.0,2196,832,1304,182387952.0,211114439.0,27373,31543,6663.0,6693.0,58916,393502391.0,2136,2023-11-06 11:25:00
329,PHOR,68,79,11116855.0,16520643.0,1669,2470,6661.0,6689.0,4139,27637498.0,147,51,58,10415531.0,15223280.0,1565,2276,6655.0,6689.0,3841,25638811.0,109,2023-11-06 11:30:00
330,PHOR,182,63,16316076.0,15025026.0,2448,2243,6665.0,6699.0,4691,31341102.0,245,161,55,15362349.0,14601161.0,2306,2180,6662.0,6698.0,4486,29963510.0,216,2023-11-06 11:35:00
331,PHOR,656,773,134309132.0,157233663.0,20131,23489,6672.0,6694.0,43620,291542795.0,1429,616,736,121302738.0,154417663.0,18214,23065,6660.0,6695.0,41279,275720401.0,1352,2023-11-06 11:40:00
332,PHOR,385,487,51743122.0,79030950.0,7768,11813,6661.0,6690.0,19581,130774072.0,872,355,463,50530967.0,76534754.0,7577,11433,6669.0,6694.0,19010,127065721.0,818,2023-11-06 11:45:00
333,PHOR,158,126,23796262.0,26027736.0,3567,3887,6671.0,6696.0,7454,49823998.0,284,133,102,22265641.0,25134007.0,3338,3751,6670.0,6701.0,7089,47399648.0,235,2023-11-06 11:50:00
334,PHOR,321,267,68861766.0,63070673.0,10354,9425,6651.0,6692.0,19779,131932439.0,588,289,227,67380806.0,59310878.0,10121,8857,6658.0,6696.0,18978,126691684.0,516,2023-11-06 11:55:00
335,PHOR,204,217,47551999.0,44834549.0,7141,6706,6659.0,6686.0,13847,92386548.0,421,175,199,44637932.0,44550665.0,6707,6658,6655.0,6691.0,13365,89188597.0,374,2023-11-06 12:00:00
336,PHOR,114,144,13017950.0,30588727.0,1952,4565,6669.0,6701.0,6517,43606677.0,258,97,120,12718458.0,28991282.0,1908,4324,6666.0,6705.0,6232,41709740.0,217,2023-11-06 12:05:00
337,PHOR,100,114,14252349.0,20018004.0,2134,2992,6679.0,6691.0,5126,34270353.0,214,74,91,13064187.0,18616447.0,1960,2781,6665.0,6694.0,4741,31680634.0,165,2023-11-06 12:10:00
338,PHOR,103,105,19840121.0,24076054.0,2963,3588,6696.0,6710.0,6551,43916175.0,208,78,87,15178918.0,19661755.0,2277,2937,6666.0,6695.0,5214,34840673.0,165,2023-11-06 12:15:00
339,PHOR,148,195,36044961.0,41188272.0,5404,6139,6670.0,6709.0,11543,77233233.0,343,125,166,31139033.0,40699809.0,4673,6068,6664.0,6707.0,10741,71838842.0,291,2023-11-06 12:20:00
340,PHOR,67,100,9969820.0,20119175.0,1494,3002,6673.0,6702.0,4496,30088995.0,167,44,80,11756809.0,18984105.0,1762,2834,6672.0,6699.0,4596,30740914.0,124,2023-11-06 12:25:00
341,PHOR,48,41,7702132.0,9161752.0,1154,1367,6674.0,6702.0,2521,16863884.0,89,33,32,7752021.0,9069993.0,1162,1353,6671.0,6704.0,2515,16822014.0,65,2023-11-06 12:30:00
342,PHOR,64,64,9147799.0,15704737.0,1371,2341,6672.0,6709.0,3712,24852536.0,128,43,52,8738803.0,15234874.0,1310,2270,6671.0,6711.0,3580,23973677.0,95,2023-11-06 12:35:00
343,PHOR,52,39,8823570.0,7299564.0,1326,1090,6654.0,6697.0,2416,16123134.0,91,32,34,6925674.0,7400126.0,1038,1104,6672.0,6703.0,2142,14325800.0,66,2023-11-06 12:40:00
344,PHOR,96,105,25455180.0,21687343.0,3814,3235,6674.0,6704.0,7049,47142523.0,201,82,91,24564365.0,20507251.0,3684,3059,6668.0,6704.0,6743,45071616.0,173,2023-11-06 12:45:00
345,PHOR,111,141,25412541.0,33764879.0,3803,5029,6682.0,6714.0,8832,59177420.0,252,89,129,22654289.0,35018101.0,3393,5211,6677.0,6720.0,8604,57672390.0,218,2023-11-06 12:50:00
346,PHOR,91,103,19406328.0,18657072.0,2906,2781,6678.0,6709.0,5687,38063400.0,194,76,74,20059493.0,16602536.0,3003,2474,6680.0,6711.0,5477,36662029.0,150,2023-11-06 12:55:00
347,PHOR,458,731,124088878.0,139699830.0,18546,20800,6691.0,6716.0,39346,263788708.0,1189,378,695,93891418.0,137423449.0,14047,20460,6684.0,6717.0,34507,231314867.0,1073,2023-11-06 13:00:00
348,PHOR,267,619,37730154.0,99406754.0,5636,14797,6694.0,6718.0,20433,137136908.0,886,235,571,36576437.0,97401906.0,5467,14500,6690.0,6717.0,19967,133978343.0,806,2023-11-06 13:05:00
349,PHOR,344,272,52319185.0,56313763.0,7763,8375,6740.0,6724.0,16138,108632948.0,616,321,225,47719364.0,52006150.0,7123,7729,6699.0,6729.0,14852,99725514.0,546,2023-11-06 13:10:00
350,PHOR,126,136,22094212.0,24396440.0,3300,3631,6695.0,6719.0,6931,46490652.0,262,118,115,20696799.0,23213395.0,3092,3453,6694.0,6723.0,6545,43910194.0,233,2023-11-06 13:15:00
351,PHOR,280,232,52676133.0,45045328.0,7862,6700,6700.0,6723.0,14562,97721461.0,512,243,207,48695246.0,44208584.0,7273,6572,6695.0,6727.0,13845,92903830.0,450,2023-11-06 13:20:00
352,PHOR,286,451,67054069.0,81950410.0,9977,12181,6721.0,6728.0,22158,149004479.0,737,257,407,65365659.0,77841800.0,9760,11558,6697.0,6735.0,21318,143207459.0,664,2023-11-06 13:25:00
353,PHOR,106,99,17720490.0,19661124.0,2643,2921,6705.0,6731.0,5564,37381614.0,205,94,84,17205870.0,17624230.0,2568,2618,6700.0,6732.0,5186,34830100.0,178,2023-11-06 13:30:00
354,PHOR,96,73,12137238.0,19246397.0,1811,2855,6702.0,6741.0,4666,31383635.0,169,70,61,11296334.0,18768745.0,1686,2785,6700.0,6739.0,4471,30065079.0,131,2023-11-06 13:35:00
355,PHOR,135,104,30347242.0,27816471.0,4528,4125,6702.0,6743.0,8653,58163713.0,239,109,86,27250782.0,27372746.0,4069,4060,6697.0,6742.0,8129,54623528.0,195,2023-11-06 13:40:00
356,PHOR,524,703,137913513.0,125764273.0,20510,18630,6724.0,6751.0,39140,263677786.0,1227,442,641,122750905.0,121856881.0,18297,18050,6709.0,6751.0,36347,244607786.0,1083,2023-11-06 13:45:00
357,PHOR,710,552,88065649.0,101264922.0,13090,14994,6728.0,6754.0,28084,189330571.0,1262,680,491,94046817.0,98638581.0,13979,14605,6728.0,6754.0,28584,192685398.0,1171,2023-11-06 13:50:00
358,PHOR,151,107,16249925.0,19215622.0,2427,2846,6695.0,6752.0,5273,35465547.0,258,130,89,15094360.0,17896269.0,2245,2650,6724.0,6753.0,4895,32990629.0,219,2023-11-06 13:55:00
359,PHOR,132,101,29166232.0,23646109.0,4339,3504,6722.0,6748.0,7843,52812341.0,233,119,87,30784816.0,24950801.0,4586,3696,6713.0,6751.0,8282,55735617.0,206,2023-11-06 14:00:00
360,PHOR,88,90,15077699.0,20038096.0,2241,2966,6728.0,6756.0,5207,35115795.0,178,66,67,14333200.0,17661718.0,2133,2612,6720.0,6762.0,4745,31994918.0,133,2023-11-06 14:05:00
361,PHOR,123,92,26762273.0,23225934.0,3973,3441,6736.0,6750.0,7414,49988207.0,215,95,73,23289206.0,21301631.0,3464,3155,6723.0,6752.0,6619,44590837.0,168,2023-11-06 14:10:00
362,PHOR,131,118,27288087.0,20592747.0,4062,3056,6718.0,6738.0,7118,47880834.0,249,125,98,27601277.0,19281070.0,4108,2855,6719.0,6753.0,6963,46882347.0,223,2023-11-06 14:15:00
363,PHOR,116,110,17830437.0,23324672.0,2653,3450,6721.0,6761.0,6103,41155109.0,226,107,84,16785594.0,22159771.0,2498,3276,6720.0,6764.0,5774,38945365.0,191,2023-11-06 14:20:00
364,PHOR,165,115,26860589.0,20607555.0,3995,3050,6724.0,6757.0,7045,47468144.0,280,146,99,28290314.0,20987115.0,4209,3108,6721.0,6753.0,7317,49277429.0,245,2023-11-06 14:25:00
365,PHOR,846,904,201992451.0,188724644.0,29975,27865,6739.0,6773.0,57840,390717095.0,1750,775,818,193678849.0,186266526.0,28779,27500,6730.0,6773.0,56279,379945375.0,1593,2023-11-06 14:30:00
366,PHOR,981,964,224701683.0,199191408.0,33235,29307,6761.0,6797.0,62542,423893091.0,1945,909,862,193931036.0,191592783.0,28703,28193,6756.0,6796.0,56896,385523819.0,1771,2023-11-06 14:35:00
367,PHOR,900,1129,258929521.0,300482051.0,38393,44286,6744.0,6785.0,82679,559411572.0,2029,845,1028,278512770.0,287646603.0,41271,42355,6748.0,6791.0,83626,566159373.0,1873,2023-11-06 14:40:00
368,PHOR,299,383,83824945.0,89004044.0,12431,13139,6743.0,6774.0,25570,172828989.0,682,273,337,82372287.0,86146086.0,12216,12696,6743.0,6785.0,24912,168518373.0,610,2023-11-06 14:45:00
369,PHOR,109,185,11877830.0,23721867.0,1762,3504,6741.0,6770.0,5266,35599697.0,294,88,162,10964135.0,24404903.0,1627,3601,6739.0,6777.0,5228,35369038.0,250,2023-11-06 14:50:00
370,PHOR,177,407,50876731.0,50457866.0,7556,7451,6733.0,6772.0,15007,101334597.0,584,155,367,42209234.0,49231245.0,6274,7270,6728.0,6772.0,13544,91440479.0,522,2023-11-06 14:55:00
371,PHOR,1055,1188,236734585.0,226525039.0,35038,33396,6757.0,6783.0,68434,463259624.0,2243,1017,1126,240863523.0,223338523.0,35671,32928,6752.0,6783.0,68599,464202046.0,2143,2023-11-06 15:00:00
372,PHOR,370,374,89635482.0,79434958.0,13284,11695,6748.0,6792.0,24979,169070440.0,744,344,338,82216191.0,76729807.0,12191,11296,6744.0,6793.0,23487,158945998.0,682,2023-11-06 15:05:00
373,PHOR,61,117,15176270.0,19728127.0,2250,2909,6745.0,6782.0,5159,34904397.0,178,53,90,14917649.0,18166103.0,2211,2673,6747.0,6796.0,4884,33083752.0,143,2023-11-06 15:10:00
374,PHOR,200,145,34568555.0,30503539.0,5114,4496,6760.0,6785.0,9610,65072094.0,345,190,122,40581620.0,29013085.0,6004,4270,6759.0,6795.0,10274,69594705.0,312,2023-11-06 15:15:00
375,PHOR,285,225,72388511.0,66919817.0,10695,9840,6768.0,6801.0,20535,139308328.0,510,258,194,68439339.0,65563198.0,10128,9643,6757.0,6799.0,19771,134002537.0,452,2023-11-06 15:20:00
376,PHOR,201,184,42872824.0,38259011.0,6346,5634,6756.0,6791.0,11980,81131835.0,385,188,150,43217205.0,36852603.0,6397,5421,6756.0,6798.0,11818,80069808.0,338,2023-11-06 15:25:00
377,PHOR,911,396,167187967.0,64864075.0,24741,9577,6758.0,6773.0,34318,232052042.0,1307,892,376,164888330.0,60991657.0,24408,8985,6756.0,6788.0,33393,225879987.0,1268,2023-11-06 15:30:00
378,PHOR,221,139,38370031.0,26075139.0,5681,3844,6754.0,6783.0,9525,64445170.0,360,212,128,37536527.0,24070695.0,5559,3546,6752.0,6788.0,9105,61607222.0,340,2023-11-06 15:35:00
379,PHOR,543,193,91629620.0,46770311.0,13589,6907,6743.0,6771.0,20496,138399931.0,736,524,157,91041386.0,45436475.0,13502,6702,6743.0,6780.0,20204,136477861.0,681,2023-11-06 15:40:00
380,PHOR,224,166,38406152.0,25947676.0,5694,3834,6745.0,6768.0,9528,64353828.0,390,204,149,36909557.0,25384973.0,5475,3750,6741.0,6769.0,9225,62294530.0,353,2023-11-06 15:45:00
381,PHOR,217,359,42699326.0,55316827.0,6335,8157,6740.0,6782.0,14492,98016153.0,576,184,350,41827606.0,55536656.0,6206,8190,6740.0,6781.0,14396,97364262.0,534,2023-11-06 15:50:00
382,PHOR,224,337,34933948.0,40354936.0,5178,5961,6747.0,6770.0,11139,75288884.0,561,212,325,34734143.0,40247026.0,5148,5940,6747.0,6776.0,11088,74981169.0,537,2023-11-06 15:55:00
383,PHOR,409,302,88392776.0,76384919.0,13095,11261,6750.0,6783.0,24356,164777695.0,711,379,285,85717809.0,74767398.0,12704,11020,6747.0,6785.0,23724,160485207.0,664,2023-11-06 16:00:00
384,PHOR,100,133,24345465.0,31332347.0,3610,4614,6744.0,6791.0,8224,55677812.0,233,87,113,23007681.0,30290142.0,3414,4460,6739.0,6792.0,7874,53297823.0,200,2023-11-06 16:05:00
385,PHOR,249,347,52436716.0,41500740.0,7774,6130,6745.0,6770.0,13904,93937456.0,596,209,333,44955978.0,40881371.0,6668,6033,6742.0,6776.0,12701,85837349.0,542,2023-11-06 16:10:00
386,PHOR,235,271,36927127.0,49103737.0,5467,7230,6755.0,6792.0,12697,86030864.0,506,214,255,36232298.0,47537116.0,5368,7001,6750.0,6790.0,12369,83769414.0,469,2023-11-06 16:15:00
387,PHOR,94,111,14706468.0,26940836.0,2177,3966,6755.0,6793.0,6143,41647304.0,205,84,95,14137215.0,24671663.0,2093,3629,6755.0,6798.0,5722,38808878.0,179,2023-11-06 16:20:00
388,PHOR,105,192,18482131.0,27274640.0,2735,4021,6758.0,6783.0,6756,45756771.0,297,91,168,25654160.0,26627421.0,3823,3922,6710.0,6789.0,7745,52281581.0,259,2023-11-06 16:25:00
389,PHOR,87,111,15135832.0,22747203.0,2239,3361,6760.0,6768.0,5600,37883035.0,198,73,95,14737806.0,22369362.0,2182,3298,6754.0,6783.0,5480,37107168.0,168,2023-11-06 16:30:00
390,PHOR,293,138,20401585.0,25334520.0,3018,3735,6760.0,6783.0,6753,45736105.0,431,285,128,21604389.0,23749345.0,3197,3499,6758.0,6787.0,6696,45353734.0,413,2023-11-06 16:35:00
391,PHOR,103,125,17205258.0,28720833.0,2548,4233,6752.0,6785.0,6781,45926091.0,228,97,112,23095271.0,27597843.0,3418,4065,6757.0,6789.0,7483,50693114.0,209,2023-11-06 16:40:00
392,PHOR,287,208,67351969.0,54314957.0,9979,8004,6749.0,6786.0,17983,121666926.0,495,269,193,65677359.0,55026120.0,9731,8107,6749.0,6787.0,17838,120703479.0,462,2023-11-06 16:45:00
393,PHOR,155,142,29020153.0,34809110.0,4301,5125,6747.0,6792.0,9426,63829263.0,297,144,130,29275155.0,33521804.0,4338,4934,6749.0,6794.0,9272,62796959.0,274,2023-11-06 16:50:00
394,PHOR,149,261,16784673.0,13383807.0,2483,1976,6760.0,6773.0,4459,30168480.0,410,139,255,16615520.0,13174069.0,2460,1945,6754.0,6773.0,4405,29789589.0,394,2023-11-06 16:55:00
395,PHOR,577,97,44846149.0,7671473.0,6632,1132,6762.0,6777.0,7764,52517622.0,674,572,94,45407545.0,7155501.0,6715,1056,6762.0,6776.0,7771,52563046.0,666,2023-11-06 17:00:00
396,PHOR,143,164,15623662.0,19542822.0,2313,2881,6755.0,6783.0,5194,35166484.0,307,125,153,15529290.0,19951913.0,2300,2939,6752.0,6789.0,5239,35481203.0,278,2023-11-06 17:05:00
397,PHOR,128,80,14812437.0,11310089.0,2194,1669,6751.0,6777.0,3863,26122526.0,208,119,68,18725105.0,15116355.0,2778,2226,6740.0,6791.0,5004,33841460.0,187,2023-11-06 17:10:00
398,PHOR,157,118,16475884.0,18466471.0,2440,2733,6752.0,6757.0,5173,34942355.0,275,145,94,15801895.0,16813658.0,2341,2481,6750.0,6777.0,4822,32615553.0,239,2023-11-06 17:15:00
399,PHOR,141,298,16676352.0,28915235.0,2471,4270,6749.0,6772.0,6741,45591587.0,439,122,291,15693895.0,28278724.0,2325,4172,6750.0,6778.0,6497,43972619.0,413,2023-11-06 17:20:00
400,PHOR,120,84,17463992.0,13585901.0,2582,2003,6764.0,6783.0,4585,31049893.0,204,104,74,16463497.0,12987591.0,2438,1915,6753.0,6782.0,4353,29451088.0,178,2023-11-06 17:25:00
401,PHOR,70,46,9260586.0,5773849.0,1370,852,6760.0,6777.0,2222,15034435.0,116,60,42,9597788.0,6368164.0,1421,939,6754.0,6782.0,2360,15965952.0,102,2023-11-06 17:30:00
402,PHOR,50,52,4619298.0,9303127.0,684,1366,6753.0,6810.0,2050,13922425.0,102,40,44,4766195.0,8368863.0,706,1231,6751.0,6798.0,1937,13135058.0,84,2023-11-06 17:35:00
403,PHOR,78,328,11289260.0,22382593.0,1669,3308,6764.0,6766.0,4977,33671853.0,406,57,310,9647689.0,20917428.0,1428,3086,6756.0,6778.0,4514,30565117.0,367,2023-11-06 17:40:00
404,PHOR,92,263,11624484.0,16850498.0,1719,2487,6762.0,6775.0,4206,28474982.0,355,79,247,10425383.0,15576835.0,1542,2298,6761.0,6778.0,3840,26002218.0,326,2023-11-06 17:45:00
405,PHOR,124,130,19977646.0,22845355.0,2950,3358,6772.0,6803.0,6308,42823001.0,254,111,108,18366271.0,18754311.0,2718,2760,6757.0,6795.0,5478,37120582.0,219,2023-11-06 17:50:00
406,PHOR,98,103,18606068.0,16298412.0,2750,2400,6766.0,6791.0,5150,34904480.0,201,89,84,17054469.0,14477731.0,2522,2132,6762.0,6791.0,4654,31532200.0,173,2023-11-06 17:55:00
407,PHOR,127,75,14522375.0,11222910.0,2141,1658,6783.0,6769.0,3799,25745285.0,202,108,65,13220511.0,10111885.0,1955,1489,6762.0,6791.0,3444,23332396.0,173,2023-11-06 18:00:00
408,PHOR,244,172,28080502.0,22840842.0,4149,3369,6768.0,6780.0,7518,50921344.0,416,205,139,27304887.0,18965012.0,4035,2791,6767.0,6795.0,6826,46269899.0,344,2023-11-06 18:05:00
409,PHOR,189,89,18675122.0,8979349.0,2759,1332,6769.0,6741.0,4091,27654471.0,278,182,71,17982176.0,9337910.0,2658,1376,6765.0,6786.0,4034,27320086.0,253,2023-11-06 18:10:00
410,PHOR,86,94,9164736.0,14129419.0,1355,2083,6764.0,6783.0,3438,23294155.0,180,64,67,8568233.0,9241916.0,1268,1361,6757.0,6791.0,2629,17810149.0,131,2023-11-06 18:15:00
411,PHOR,82,48,8506055.0,7615177.0,1246,1117,6827.0,6818.0,2363,16121232.0,130,70,36,6433924.0,7589884.0,952,1113,6758.0,6819.0,2065,14023808.0,106,2023-11-06 18:20:00
412,PHOR,77,68,14841476.0,11120000.0,2189,1639,6780.0,6785.0,3828,25961476.0,145,52,44,7039853.0,6925957.0,1041,1020,6763.0,6790.0,2061,13965810.0,96,2023-11-06 18:25:00
413,PHOR,74,53,7862486.0,3628399.0,1159,536,6784.0,6769.0,1695,11490885.0,127,57,50,7077315.0,4970632.0,1047,732,6760.0,6790.0,1779,12047947.0,107,2023-11-06 18:30:00
414,PHOR,266,272,64268583.0,43822689.0,9477,6442,6782.0,6803.0,15919,108091272.0,538,221,230,60352273.0,37654516.0,8907,5535,6776.0,6803.0,14442,98006789.0,451,2023-11-06 18:35:00
415,PHOR,188,135,16014249.0,17929772.0,2363,2640,6777.0,6792.0,5003,33944021.0,323,172,126,24489625.0,19370187.0,3617,2851,6771.0,6794.0,6468,43859812.0,298,2023-11-06 18:40:00
416,PHOR,621,856,85724048.0,149961512.0,10847,21950,7903.0,6832.0,32797,235685560.0,1477,487,639,61888893.0,130912473.0,9123,19183,6784.0,6824.0,28306,192801366.0,1126,2023-11-07 10:05:00
417,PHOR,433,426,86256765.0,81376806.0,12806,11943,6736.0,6814.0,24749,167633571.0,859,359,321,56749756.0,70714923.0,8366,10358,6783.0,6827.0,18724,127464679.0,680,2023-11-07 10:10:00
418,PHOR,695,860,113153043.0,149171305.0,16643,21842,6799.0,6830.0,38485,262324348.0,1555,604,760,102686727.0,141948567.0,15146,20781,6780.0,6831.0,35927,244635294.0,1364,2023-11-07 10:15:00
419,PHOR,341,527,68140559.0,79264526.0,10046,11602,6783.0,6832.0,21648,147405085.0,868,270,456,59920260.0,75810720.0,8843,11097,6776.0,6832.0,19940,135730980.0,726,2023-11-07 10:20:00
420,PHOR,315,505,64590313.0,101964228.0,9505,14937,6795.0,6826.0,24442,166554541.0,820,267,431,58222145.0,96425502.0,8577,14123,6788.0,6828.0,22700,154647647.0,698,2023-11-07 10:25:00
421,PHOR,364,240,49050964.0,44103030.0,7216,6456,6798.0,6831.0,13672,93153994.0,604,327,160,47797207.0,41231544.0,7034,6034,6795.0,6833.0,13068,89028751.0,487,2023-11-07 10:30:00
422,PHOR,195,231,43636175.0,54460815.0,6418,7980,6799.0,6825.0,14398,98096990.0,426,131,173,36937430.0,49438409.0,5438,7235,6792.0,6833.0,12673,86375839.0,304,2023-11-07 10:35:00
423,PHOR,472,483,89056784.0,90915314.0,13061,13296,6819.0,6838.0,26357,179972098.0,955,409,424,82245796.0,85446284.0,12100,12499,6797.0,6836.0,24599,167692080.0,833,2023-11-07 10:40:00
424,PHOR,323,503,67810174.0,99195237.0,9969,14518,6802.0,6833.0,24487,167005411.0,826,286,425,65741136.0,82734732.0,9671,12101,6798.0,6837.0,21772,148475868.0,711,2023-11-07 10:45:00
425,PHOR,229,364,37057410.0,53595821.0,5446,7843,6805.0,6834.0,13289,90653231.0,593,192,320,34447163.0,51336334.0,5065,7514,6801.0,6832.0,12579,85783497.0,512,2023-11-07 10:50:00
426,PHOR,441,446,102402924.0,99404085.0,15074,14549,6793.0,6832.0,29623,201807009.0,887,414,394,104136894.0,96053996.0,15337,14053,6790.0,6835.0,29390,200190890.0,808,2023-11-07 10:55:00
427,PHOR,179,232,34554062.0,35618683.0,5095,5221,6782.0,6822.0,10316,70172745.0,411,158,198,33887543.0,34825633.0,5000,5099,6778.0,6830.0,10099,68713176.0,356,2023-11-07 11:00:00
428,PHOR,137,209,32141672.0,35643729.0,4733,5227,6791.0,6819.0,9960,67785401.0,346,103,170,29697324.0,32113678.0,4381,4702,6779.0,6830.0,9083,61811002.0,273,2023-11-07 11:05:00
429,PHOR,139,139,30469220.0,34006992.0,4492,4978,6783.0,6831.0,9470,64476212.0,278,113,127,30197049.0,39316003.0,4454,5758,6780.0,6828.0,10212,69513052.0,240,2023-11-07 11:10:00
430,PHOR,193,99,33687878.0,26878866.0,4961,3956,6791.0,6794.0,8917,60566744.0,292,160,78,32870605.0,26465987.0,4844,3874,6786.0,6832.0,8718,59336592.0,238,2023-11-07 11:15:00
431,PHOR,218,128,35436348.0,33374185.0,5264,4837,6732.0,6900.0,10101,68810533.0,346,191,83,35505168.0,30038191.0,5247,4365,6767.0,6882.0,9612,65543359.0,274,2023-11-07 11:20:00
432,PHOR,1056,1472,275055711.0,335329172.0,40681,49295,6761.0,6802.0,89976,610384883.0,2528,976,1390,269848355.0,324969236.0,39938,47671,6757.0,6817.0,87609,594817591.0,2366,2023-11-07 11:25:00
433,PHOR,586,788,127068919.0,166631860.0,18792,24495,6762.0,6803.0,43287,293700779.0,1374,530,757,123705235.0,160214120.0,18300,23552,6760.0,6803.0,41852,283919355.0,1287,2023-11-07 11:30:00
434,PHOR,146,186,25929627.0,44562579.0,3835,5641,6761.0,7900.0,9476,70492206.0,332,133,163,25449736.0,36965765.0,3765,5417,6760.0,6824.0,9182,62415501.0,296,2023-11-07 11:35:00
435,PHOR,214,186,43930624.0,34211738.0,6507,5029,6751.0,6803.0,11536,78142362.0,400,187,157,36252816.0,32728809.0,5364,4805,6759.0,6811.0,10169,68981625.0,344,2023-11-07 11:40:00
436,PHOR,147,139,37067190.0,35730569.0,5490,5264,6752.0,6788.0,10754,72797759.0,286,123,117,35496914.0,33495449.0,5258,4917,6751.0,6812.0,10175,68992363.0,240,2023-11-07 11:45:00
437,PHOR,370,356,72624150.0,70947459.0,10749,10430,6756.0,6802.0,21179,143571609.0,726,338,343,65525832.0,70921124.0,9703,10417,6753.0,6808.0,20120,136446956.0,681,2023-11-07 11:50:00
438,PHOR,156,153,27560531.0,29577017.0,4068,4339,6775.0,6817.0,8407,57137548.0,309,137,138,27013761.0,28888116.0,3996,4241,6760.0,6812.0,8237,55901877.0,275,2023-11-07 11:55:00
439,PHOR,294,482,65323144.0,96818711.0,9673,14255,6753.0,6792.0,23928,162141855.0,776,264,459,63753097.0,94244873.0,9437,13854,6756.0,6803.0,23291,157997970.0,723,2023-11-07 12:00:00
440,PHOR,196,189,34078710.0,44093788.0,5044,6479,6756.0,6806.0,11523,78172498.0,385,169,170,33468969.0,42435763.0,4956,6237,6753.0,6804.0,11193,75904732.0,339,2023-11-07 12:05:00
441,PHOR,295,442,48457898.0,73939018.0,7170,10870,6758.0,6802.0,18040,122396916.0,737,273,424,47608914.0,74235938.0,7044,10913,6759.0,6803.0,17957,121844852.0,697,2023-11-07 12:10:00
442,PHOR,122,142,20956755.0,26617987.0,3102,3914,6756.0,6801.0,7016,47574742.0,264,107,133,20643129.0,25936841.0,3056,3813,6755.0,6802.0,6869,46579970.0,240,2023-11-07 12:15:00
443,PHOR,93,116,18447122.0,22970183.0,2730,3377,6757.0,6802.0,6107,41417305.0,209,67,107,17997829.0,22992422.0,2664,3379,6756.0,6805.0,6043,40990251.0,174,2023-11-07 12:20:00
444,PHOR,416,444,82209961.0,90970561.0,12099,13368,6795.0,6805.0,25467,173180522.0,860,388,427,76751454.0,89077022.0,11350,13091,6762.0,6804.0,24441,165828476.0,815,2023-11-07 12:25:00
445,PHOR,211,150,34780590.0,25955763.0,5143,3812,6763.0,6809.0,8955,60736353.0,361,191,132,33959971.0,25583382.0,5021,3756,6764.0,6811.0,8777,59543353.0,323,2023-11-07 12:30:00
446,PHOR,362,417,70628448.0,88043776.0,10430,12938,6772.0,6805.0,23368,158672224.0,779,346,404,69933234.0,87149049.0,10336,12807,6766.0,6805.0,23143,157082283.0,750,2023-11-07 12:35:00
447,PHOR,223,302,24638978.0,28516743.0,3639,4191,6771.0,6804.0,7830,53155721.0,525,206,287,23907003.0,27929597.0,3529,4105,6774.0,6804.0,7634,51836600.0,493,2023-11-07 12:40:00
448,PHOR,251,146,45020685.0,28532821.0,6644,4190,6776.0,6810.0,10834,73553506.0,397,234,127,44219680.0,27848230.0,6530,4088,6772.0,6812.0,10618,72067910.0,361,2023-11-07 12:45:00
449,PHOR,133,118,27811232.0,25262007.0,4098,3708,6787.0,6813.0,7806,53073239.0,251,121,105,25663368.0,25825191.0,3791,3788,6770.0,6818.0,7579,51488559.0,226,2023-11-07 12:50:00
450,PHOR,107,114,27955325.0,30114318.0,4131,4423,6767.0,6809.0,8554,58069643.0,221,80,93,27206049.0,25958706.0,4020,3809,6768.0,6815.0,7829,53164755.0,173,2023-11-07 12:55:00
451,PHOR,244,403,58993472.0,87740830.0,8746,12980,6745.0,6760.0,21726,146734302.0,647,201,377,52365814.0,80244308.0,7762,11788,6746.0,6807.0,19550,132610122.0,578,2023-11-07 13:00:00
452,PHOR,255,324,39926337.0,53166926.0,5905,7819,6761.0,6800.0,13724,93093263.0,579,230,313,37866334.0,51474028.0,5609,7570,6751.0,6800.0,13179,89340362.0,543,2023-11-07 13:05:00
453,PHOR,68,96,8470520.0,15183872.0,1253,2227,6760.0,6818.0,3480,23654392.0,164,59,90,8137758.0,15217527.0,1205,2232,6753.0,6818.0,3437,23355285.0,149,2023-11-07 13:10:00
454,PHOR,251,210,63895502.0,56748955.0,9394,8340,6802.0,6804.0,17734,120644457.0,461,225,183,56902122.0,54154290.0,8414,7954,6763.0,6808.0,16368,111056412.0,408,2023-11-07 13:15:00
455,PHOR,65,93,13989686.0,24245426.0,2054,3558,6811.0,6814.0,5612,38235112.0,158,55,66,14727733.0,19577417.0,2179,2872,6759.0,6817.0,5051,34305150.0,121,2023-11-07 13:20:00
456,PHOR,250,54,20471226.0,11850338.0,3020,1740,6779.0,6811.0,4760,32321564.0,304,242,51,20294072.0,11108690.0,2994,1630,6778.0,6815.0,4624,31402762.0,293,2023-11-07 13:25:00
457,PHOR,71,62,11725459.0,11049539.0,1730,1623,6778.0,6808.0,3353,22774998.0,133,56,48,11242114.0,10479809.0,1661,1536,6768.0,6823.0,3197,21721923.0,104,2023-11-07 13:30:00
458,PHOR,107,104,22879322.0,22881332.0,3378,3360,6773.0,6810.0,6738,45760654.0,211,94,93,21945044.0,22578822.0,3242,3313,6769.0,6815.0,6555,44523866.0,187,2023-11-07 13:35:00
459,PHOR,180,125,41879212.0,29013444.0,6186,4258,6770.0,6814.0,10444,70892656.0,305,149,117,38209760.0,28754718.0,5647,4219,6766.0,6816.0,9866,66964478.0,266,2023-11-07 13:40:00
460,PHOR,140,151,38178168.0,32953815.0,5571,4831,6853.0,6821.0,10402,71131983.0,291,132,131,33019712.0,32075228.0,4877,4702,6770.0,6822.0,9579,65094940.0,263,2023-11-07 13:45:00
461,PHOR,210,204,35137804.0,41828984.0,5184,6132,6778.0,6821.0,11316,76966788.0,414,194,192,33031336.0,41223906.0,4876,6043,6774.0,6822.0,10919,74255242.0,386,2023-11-07 13:50:00
462,PHOR,248,336,52084357.0,63687249.0,7662,9333,6798.0,6824.0,16995,115771606.0,584,230,314,49755182.0,62127376.0,7343,9103,6776.0,6825.0,16446,111882558.0,544,2023-11-07 13:55:00
463,PHOR,356,368,66129380.0,85234810.0,9752,12479,6781.0,6830.0,22231,151364190.0,724,326,350,66715522.0,80964908.0,9840,11869,6780.0,6822.0,21709,147680430.0,676,2023-11-07 14:00:00
464,PHOR,163,287,37482769.0,56058576.0,5543,8222,6762.0,6818.0,13765,93541345.0,450,148,284,36115699.0,55545554.0,5339,8149,6765.0,6816.0,13488,91661253.0,432,2023-11-07 14:05:00
465,PHOR,256,239,43903743.0,57628941.0,6472,7937,6784.0,7261.0,14409,101532684.0,495,221,230,41620454.0,51006369.0,6140,7481,6779.0,6818.0,13621,92626823.0,451,2023-11-07 14:10:00
466,PHOR,91,121,22337604.0,27988901.0,3305,4107,6759.0,6815.0,7412,50326505.0,212,69,106,22217295.0,23872815.0,3286,3496,6761.0,6829.0,6782,46090110.0,175,2023-11-07 14:15:00
467,PHOR,131,207,31908374.0,37155881.0,4720,4945,6760.0,7514.0,9665,69064255.0,338,104,194,30695577.0,36607408.0,4541,4854,6760.0,7542.0,9395,67302985.0,298,2023-11-07 14:20:00
468,PHOR,57,36,10468117.0,8596375.0,1547,1263,6767.0,6806.0,2810,19064492.0,93,31,23,9369296.0,8417893.0,1386,1236,6760.0,6811.0,2622,17787189.0,54,2023-11-07 14:25:00
469,PHOR,64,67,9370383.0,11617395.0,1384,1706,6771.0,6810.0,3090,20987778.0,131,52,55,9051584.0,11234506.0,1339,1648,6760.0,6817.0,2987,20286090.0,107,2023-11-07 14:30:00
470,PHOR,151,230,42205541.0,60214513.0,6246,8628,6757.0,6979.0,14874,102420054.0,381,126,215,40524511.0,59912992.0,6000,8289,6754.0,7228.0,14289,100437503.0,341,2023-11-07 14:35:00
471,PHOR,522,439,98459670.0,89873774.0,14591,13239,6748.0,6789.0,27830,188333444.0,961,486,407,96364074.0,87837853.0,14278,12927,6749.0,6795.0,27205,184201927.0,893,2023-11-07 14:40:00
472,PHOR,263,291,47801627.0,55987998.0,7079,8238,6753.0,6796.0,15317,103789625.0,554,238,280,45622941.0,55850843.0,6760,8220,6749.0,6795.0,14980,101473784.0,518,2023-11-07 14:45:00
473,PHOR,161,204,44588191.0,46275764.0,6607,6807,6749.0,6798.0,13414,90863955.0,365,138,195,44534018.0,46342928.0,6601,6810,6747.0,6805.0,13411,90876946.0,333,2023-11-07 14:50:00
474,PHOR,242,542,63582375.0,98022665.0,9434,14442,6740.0,6787.0,23876,161605040.0,784,210,527,60566133.0,95829528.0,8982,14113,6743.0,6790.0,23095,156395661.0,737,2023-11-07 14:55:00
475,PHOR,263,544,50237281.0,81697519.0,7442,12030,6751.0,6791.0,19472,131934800.0,807,249,536,50071042.0,81318947.0,7422,11973,6746.0,6792.0,19395,131389989.0,785,2023-11-07 15:00:00
476,PHOR,179,278,19444798.0,34840058.0,2872,5129,6770.0,6793.0,8001,54284856.0,457,160,266,19126552.0,34502855.0,2830,5078,6758.0,6795.0,7908,53629407.0,426,2023-11-07 15:05:00
477,PHOR,312,355,53386264.0,63924825.0,7898,9406,6759.0,6796.0,17304,117311089.0,667,293,343,50749076.0,63074589.0,7513,9281,6755.0,6796.0,16794,113823665.0,636,2023-11-07 15:10:00
478,PHOR,98,155,18621521.0,34269072.0,2776,5044,6708.0,6794.0,7820,52890593.0,253,87,144,14330955.0,33306011.0,2120,4902,6760.0,6794.0,7022,47636966.0,231,2023-11-07 15:15:00
479,PHOR,131,185,31867880.0,42554964.0,4714,6258,6760.0,6800.0,10972,74422844.0,316,121,172,28233170.0,42424891.0,4179,6238,6756.0,6801.0,10417,70658061.0,293,2023-11-07 15:20:00
480,PHOR,62,99,11352829.0,18893141.0,1680,2776,6758.0,6806.0,4456,30245970.0,161,50,94,11354137.0,20751831.0,1682,3034,6750.0,6840.0,4716,32105968.0,144,2023-11-07 15:25:00
481,PHOR,95,113,12047640.0,17934018.0,1781,2634,6765.0,6809.0,4415,29981658.0,208,85,103,12025750.0,16304915.0,1780,2393,6756.0,6814.0,4173,28330665.0,188,2023-11-07 15:30:00
482,PHOR,108,97,18918138.0,20010082.0,2797,2936,6764.0,6815.0,5733,38928220.0,205,95,86,18596680.0,19802191.0,2751,2906,6760.0,6814.0,5657,38398871.0,181,2023-11-07 15:35:00
483,PHOR,341,128,37556735.0,22651556.0,5537,3329,6783.0,6804.0,8866,60208291.0,469,310,111,34361559.0,21693504.0,5078,3188,6767.0,6805.0,8266,56055063.0,421,2023-11-07 15:40:00
484,PHOR,75,69,16012066.0,15706457.0,2359,2304,6788.0,6817.0,4663,31718523.0,144,65,60,15712848.0,15375700.0,2327,2256,6752.0,6815.0,4583,31088548.0,125,2023-11-07 15:45:00
485,PHOR,116,114,19333849.0,21749469.0,2859,3199,6762.0,6799.0,6058,41083318.0,230,105,100,18180635.0,21081263.0,2688,3094,6764.0,6814.0,5782,39261898.0,205,2023-11-07 15:50:00
486,PHOR,182,247,51157980.0,58174913.0,7612,8553,6721.0,6802.0,16165,109332893.0,429,161,230,46849317.0,56032505.0,6938,8234,6753.0,6805.0,15172,102881822.0,391,2023-11-07 15:55:00
487,PHOR,93,96,19423275.0,25634271.0,2879,3794,6747.0,6757.0,6673,45057546.0,189,74,87,20621129.0,22003274.0,3093,3231,6667.0,6810.0,6324,42624403.0,161,2023-11-07 16:00:00
488,PHOR,147,235,42011822.0,53359427.0,6224,7850,6750.0,6797.0,14074,95371249.0,382,134,219,40613780.0,50804114.0,6018,7469,6749.0,6802.0,13487,91417894.0,353,2023-11-07 16:05:00
489,PHOR,178,266,53107595.0,71071760.0,7878,10466,6741.0,6791.0,18344,124179355.0,444,159,253,52410119.0,69234776.0,7774,10191,6742.0,6794.0,17965,121644895.0,412,2023-11-07 16:10:00
490,PHOR,565,909,138343378.0,205450199.0,20507,30313,6746.0,6778.0,50820,343793577.0,1474,474,867,129108910.0,197375322.0,19176,29096,6733.0,6784.0,48272,326484232.0,1341,2023-11-07 16:15:00
491,PHOR,148,335,27181012.0,71142998.0,4032,10480,6741.0,6788.0,14512,98324010.0,483,122,325,26433217.0,70960500.0,3922,10452,6740.0,6789.0,14374,97393717.0,447,2023-11-07 16:20:00
492,PHOR,140,202,32970105.0,41784916.0,4891,6166,6741.0,6777.0,11057,74755021.0,342,119,183,32625290.0,36814521.0,4840,5421,6741.0,6791.0,10261,69439811.0,302,2023-11-07 16:25:00
493,PHOR,76,77,11325869.0,13709156.0,1680,2020,6742.0,6787.0,3700,25035025.0,153,58,65,10167820.0,12087551.0,1511,1779,6729.0,6795.0,3290,22255371.0,123,2023-11-07 16:30:00
494,PHOR,115,83,11423015.0,17451526.0,1695,2568,6739.0,6796.0,4263,28874541.0,198,91,77,10363167.0,16000564.0,1538,2352,6738.0,6803.0,3890,26363731.0,168,2023-11-07 16:35:00
495,PHOR,253,367,20791853.0,30430438.0,3083,4498,6744.0,6765.0,7581,51222291.0,620,231,360,20768174.0,29966452.0,3080,4425,6743.0,6772.0,7505,50734626.0,591,2023-11-07 16:40:00
496,PHOR,82,67,9824131.0,10307397.0,1457,1520,6743.0,6781.0,2977,20131528.0,149,68,55,9071810.0,9894989.0,1346,1456,6740.0,6796.0,2802,18966799.0,123,2023-11-07 16:45:00
497,PHOR,77,46,9574776.0,10417842.0,1421,1535,6738.0,6787.0,2956,19992618.0,123,68,42,9837400.0,10755513.0,1460,1583,6738.0,6794.0,3043,20592913.0,110,2023-11-07 16:50:00
498,PHOR,185,95,20832356.0,17636110.0,3088,2603,6746.0,6775.0,5691,38468466.0,280,150,85,20013219.0,16874947.0,2969,2488,6741.0,6783.0,5457,36888166.0,235,2023-11-07 16:55:00
499,PHOR,286,272,58396822.0,63298496.0,8655,9324,6747.0,6789.0,17979,121695318.0,558,257,256,56010870.0,61374602.0,8311,9042,6739.0,6788.0,17353,117385472.0,513,2023-11-07 17:00:00
500,PHOR,189,132,29334226.0,33252455.0,4345,4900,6751.0,6786.0,9245,62586681.0,321,166,121,27874129.0,32906353.0,4130,4849,6749.0,6786.0,8979,60780482.0,287,2023-11-07 17:05:00
501,PHOR,141,63,17095667.0,15584250.0,2531,2293,6755.0,6796.0,4824,32679917.0,204,121,56,17050908.0,15541998.0,2526,2287,6750.0,6796.0,4813,32592906.0,177,2023-11-07 17:10:00
502,PHOR,82,53,12937362.0,10763647.0,1916,1585,6752.0,6791.0,3501,23701009.0,135,68,44,12867890.0,10697279.0,1907,1574,6748.0,6796.0,3481,23565169.0,112,2023-11-07 17:15:00
503,PHOR,131,84,13349688.0,19008662.0,1976,2798,6756.0,6794.0,4774,32358350.0,215,115,80,11617315.0,19633584.0,1721,2890,6750.0,6794.0,4611,31250899.0,195,2023-11-07 17:20:00
504,PHOR,267,173,38646479.0,39082801.0,5720,5757,6756.0,6789.0,11477,77729280.0,440,203,164,34921358.0,36504128.0,5173,5375,6751.0,6791.0,10548,71425486.0,367,2023-11-07 17:25:00
505,PHOR,288,402,76621449.0,76488308.0,11321,11269,6768.0,6787.0,22590,153109757.0,690,235,379,69670960.0,73090771.0,10339,10751,6739.0,6799.0,21090,142761731.0,614,2023-11-07 17:30:00
506,PHOR,220,305,39666216.0,49693159.0,5859,7315,6770.0,6793.0,13174,89359375.0,525,177,273,31989895.0,47747450.0,4735,7026,6756.0,6796.0,11761,79737345.0,450,2023-11-07 17:35:00
507,PHOR,239,269,28648174.0,38163206.0,4229,5634,6774.0,6774.0,9863,66811380.0,508,209,242,26892019.0,35362599.0,3975,5199,6765.0,6802.0,9174,62254618.0,451,2023-11-07 17:40:00
508,PHOR,100,121,10494234.0,12308712.0,1550,1810,6770.0,6800.0,3360,22802946.0,221,81,109,9277517.0,11373933.0,1371,1672,6767.0,6803.0,3043,20651450.0,190,2023-11-07 17:45:00
509,PHOR,205,142,17490133.0,19896518.0,2579,2926,6782.0,6800.0,5505,37386651.0,347,197,128,17394567.0,19156187.0,2568,2815,6774.0,6805.0,5383,36550754.0,325,2023-11-07 17:50:00
510,PHOR,62,105,7373492.0,12981678.0,1086,1911,6790.0,6793.0,2997,20355170.0,167,43,92,7096802.0,12668986.0,1049,1863,6765.0,6800.0,2912,19765788.0,135,2023-11-07 17:55:00
511,PHOR,262,281,43081651.0,42030644.0,6360,6175,6774.0,6807.0,12535,85112295.0,543,239,268,47306627.0,41578076.0,6985,6108,6773.0,6807.0,13093,88884703.0,507,2023-11-07 18:00:00
512,PHOR,350,284,50388151.0,37049135.0,7436,5442,6776.0,6808.0,12878,87437286.0,634,332,274,50146127.0,36815698.0,7403,5406,6774.0,6810.0,12809,86961825.0,606,2023-11-07 18:05:00
513,PHOR,198,169,25919277.0,16501922.0,3824,2425,6778.0,6805.0,6249,42421199.0,367,191,159,24561030.0,16277731.0,3625,2392,6775.0,6805.0,6017,40838761.0,350,2023-11-07 18:10:00
514,PHOR,176,230,33866500.0,31028110.0,4995,4561,6780.0,6803.0,9556,64894610.0,406,160,228,34278564.0,31112859.0,5059,4572,6776.0,6805.0,9631,65391423.0,388,2023-11-07 18:15:00
515,PHOR,59,90,10099588.0,13025043.0,1491,1912,6774.0,6812.0,3403,23124631.0,149,51,88,9543936.0,12697836.0,1410,1866,6769.0,6805.0,3276,22241772.0,139,2023-11-07 18:20:00
516,PHOR,101,85,16183578.0,12127709.0,2390,1782,6771.0,6806.0,4172,28311287.0,186,87,76,15195619.0,10698280.0,2248,1571,6760.0,6810.0,3819,25893899.0,163,2023-11-07 18:25:00
517,PHOR,49,122,8429405.0,10761376.0,1244,1582,6776.0,6802.0,2826,19190781.0,171,47,112,13942809.0,14909313.0,2063,2187,6759.0,6817.0,4250,28852122.0,159,2023-11-07 18:30:00
518,PHOR,160,112,18218958.0,18204831.0,2650,2679,6875.0,6795.0,5329,36423789.0,272,158,104,16437386.0,17158462.0,2425,2521,6778.0,6806.0,4946,33595848.0,262,2023-11-07 18:35:00
519,PHOR,182,352,29931304.0,33779815.0,4411,4967,6786.0,6801.0,9378,63711119.0,534,179,346,31167198.0,34401107.0,4597,5058,6780.0,6801.0,9655,65568305.0,525,2023-11-07 18:40:00
520,PHOR,956,2526,134836200.0,490440981.0,18176,72319,7418.0,6782.0,90495,625277181.0,3482,863,2430,107495587.0,476301357.0,15901,70266,6760.0,6779.0,86167,583796944.0,3293,2023-11-08 10:05:00
521,PHOR,591,439,60731182.0,40232365.0,8987,5912,6758.0,6805.0,14899,100963547.0,1030,528,370,59083550.0,36628757.0,8741,5384,6759.0,6803.0,14125,95712307.0,898,2023-11-08 10:10:00
522,PHOR,677,1074,104517052.0,186909705.0,15489,27536,6748.0,6788.0,43025,291426757.0,1751,600,1007,99272125.0,183198190.0,14721,26992,6744.0,6787.0,41713,282470315.0,1607,2023-11-08 10:15:00
523,PHOR,125,351,15372017.0,54624293.0,2281,8040,6739.0,6794.0,10321,69996310.0,476,83,325,13733425.0,53547771.0,2036,7878,6745.0,6797.0,9914,67281196.0,408,2023-11-08 10:20:00
524,PHOR,341,645,65439540.0,126349330.0,9679,18617,6761.0,6787.0,28296,191788870.0,986,300,610,59789517.0,122699386.0,8855,18067,6752.0,6791.0,26922,182488903.0,910,2023-11-08 10:25:00
525,PHOR,235,294,37213073.0,47897774.0,5506,7048,6759.0,6796.0,12554,85110847.0,529,188,259,36186746.0,46804140.0,5357,6883,6755.0,6800.0,12240,82990886.0,447,2023-11-08 10:30:00
526,PHOR,196,266,37431638.0,50526331.0,5542,7426,6754.0,6804.0,12968,87957969.0,462,153,231,34331236.0,47994066.0,5084,7050,6753.0,6808.0,12134,82325302.0,384,2023-11-08 10:35:00
527,PHOR,135,202,22191340.0,37015897.0,3286,5443,6753.0,6801.0,8729,59207237.0,337,95,173,21529020.0,34929015.0,3188,5131,6753.0,6807.0,8319,56458035.0,268,2023-11-08 10:40:00
528,PHOR,483,362,116138865.0,113140854.0,17210,15779,6748.0,7170.0,32989,229279719.0,845,413,324,96023603.0,92152541.0,14233,13571,6747.0,6790.0,27804,188176144.0,737,2023-11-08 10:45:00
529,PHOR,315,358,47771292.0,87517924.0,7077,12916,6750.0,6776.0,19993,135289216.0,673,254,306,44466058.0,82354128.0,6597,12152,6740.0,6777.0,18749,126820186.0,560,2023-11-08 10:50:00
530,PHOR,319,367,65643409.0,87743020.0,9727,12934,6749.0,6784.0,22661,153386429.0,686,273,333,61008814.0,85464286.0,9054,12598,6738.0,6784.0,21652,146473100.0,606,2023-11-08 10:55:00
531,PHOR,172,183,28655985.0,36433292.0,4244,5367,6752.0,6788.0,9611,65089277.0,355,130,166,26982432.0,36467050.0,4005,5372,6737.0,6788.0,9377,63449482.0,296,2023-11-08 11:00:00
532,PHOR,195,296,37525791.0,57046066.0,5571,8412,6736.0,6782.0,13983,94571857.0,491,165,269,33991424.0,56033567.0,5047,8260,6735.0,6784.0,13307,90024991.0,434,2023-11-08 11:05:00
533,PHOR,335,270,33351168.0,77477386.0,4930,10589,6765.0,7317.0,15519,110828554.0,605,299,237,31607112.0,76287964.0,4683,10354,6749.0,7368.0,15037,107895076.0,536,2023-11-08 11:10:00
534,PHOR,127,85,13836337.0,18490220.0,2050,2724,6749.0,6788.0,4774,32326557.0,212,102,78,13015027.0,18215757.0,1928,2683,6751.0,6789.0,4611,31230784.0,180,2023-11-08 11:15:00
535,PHOR,163,117,15766156.0,21113957.0,2332,3106,6761.0,6798.0,5438,36880113.0,280,127,109,14426704.0,20230622.0,2137,2979,6751.0,6791.0,5116,34657326.0,236,2023-11-08 11:20:00
536,PHOR,185,138,17819868.0,25822299.0,2634,3805,6765.0,6786.0,6439,43642167.0,323,156,119,15510287.0,24906063.0,2297,3669,6752.0,6788.0,5966,40416350.0,275,2023-11-08 11:25:00
537,PHOR,201,99,14883029.0,10639170.0,2195,1568,6780.0,6785.0,3763,25522199.0,300,181,92,14043688.0,10401190.0,2078,1532,6758.0,6789.0,3610,24444878.0,273,2023-11-08 11:30:00
538,PHOR,183,118,23694684.0,13732310.0,3498,2022,6774.0,6791.0,5520,37426994.0,301,154,105,16125208.0,13309488.0,2387,1958,6755.0,6797.0,4345,29434696.0,259,2023-11-08 11:35:00
539,PHOR,109,104,11735297.0,14618449.0,1735,2154,6764.0,6787.0,3889,26353746.0,213,81,90,11074576.0,12659464.0,1641,1863,6749.0,6795.0,3504,23734040.0,171,2023-11-08 11:40:00
540,PHOR,217,183,28945806.0,29328599.0,4274,4325,6773.0,6781.0,8599,58274405.0,400,195,174,23917184.0,29410313.0,3542,4334,6752.0,6786.0,7876,53327497.0,369,2023-11-08 11:45:00
541,PHOR,266,229,35808785.0,41750225.0,5307,6152,6747.0,6786.0,11459,77559010.0,495,221,210,40707898.0,38103483.0,6031,5611,6750.0,6791.0,11642,78811381.0,431,2023-11-08 11:50:00
542,PHOR,227,227,25521435.0,56778864.0,3787,8376,6739.0,6779.0,12163,82300299.0,454,176,215,16671331.0,57311831.0,2471,8445,6747.0,6786.0,10916,73983162.0,391,2023-11-08 11:55:00
543,PHOR,300,282,36748191.0,85040950.0,5448,12544,6745.0,6779.0,17992,121789141.0,582,239,261,33541913.0,82054943.0,4972,12098,6746.0,6783.0,17070,115596856.0,500,2023-11-08 12:00:00
544,PHOR,131,96,18006927.0,27598824.0,2666,4071,6754.0,6779.0,6737,45605751.0,227,91,83,15203742.0,27403411.0,2255,4035,6742.0,6791.0,6290,42607153.0,174,2023-11-08 12:05:00
545,PHOR,78,398,6877582.0,34221985.0,1016,5051,6769.0,6775.0,6067,41099567.0,476,54,368,6450837.0,31905079.0,956,4706,6748.0,6780.0,5662,38355916.0,422,2023-11-08 12:10:00
546,PHOR,82,121,10394506.0,14899650.0,1538,2197,6758.0,6782.0,3735,25294156.0,203,77,108,9513874.0,13575769.0,1410,2000,6747.0,6788.0,3410,23089643.0,185,2023-11-08 12:15:00
547,PHOR,161,195,20919385.0,35640061.0,3096,5256,6757.0,6781.0,8352,56559446.0,356,126,182,19398943.0,35869284.0,2886,5289,6722.0,6782.0,8175,55268227.0,308,2023-11-08 12:20:00
548,PHOR,259,320,61598045.0,83278517.0,9114,12267,6759.0,6789.0,21381,144876562.0,579,235,306,56095348.0,80862600.0,8312,11913,6749.0,6788.0,20225,136957948.0,541,2023-11-08 12:25:00
549,PHOR,99,236,20902997.0,48611507.0,3089,7166,6767.0,6784.0,10255,69514504.0,335,88,216,19952288.0,48040596.0,2955,7081,6752.0,6784.0,10036,67992884.0,304,2023-11-08 12:30:00
550,PHOR,239,301,39364600.0,56866009.0,5826,8376,6757.0,6789.0,14202,96230609.0,540,219,276,38779717.0,49534144.0,5740,7299,6756.0,6786.0,13039,88313861.0,495,2023-11-08 12:35:00
551,PHOR,264,260,49622192.0,54636429.0,7352,7604,6749.0,7185.0,14956,104258621.0,524,237,240,48595188.0,47750178.0,7203,7032,6747.0,6790.0,14235,96345366.0,477,2023-11-08 12:40:00
552,PHOR,183,201,34747696.0,46233925.0,5155,6724,6741.0,6876.0,11879,80981621.0,384,151,173,33357675.0,46671668.0,4950,6427,6739.0,7262.0,11377,80029343.0,324,2023-11-08 12:45:00
553,PHOR,136,143,23550467.0,28425114.0,3494,4190,6740.0,6784.0,7684,51975581.0,279,122,130,22963280.0,27728081.0,3407,4085,6740.0,6788.0,7492,50691361.0,252,2023-11-08 12:50:00
554,PHOR,239,348,56734644.0,80112297.0,8417,11826,6740.0,6774.0,20243,136846941.0,587,185,317,53916313.0,66946008.0,8005,9872,6735.0,6781.0,17877,120862321.0,502,2023-11-08 12:55:00
555,PHOR,330,148,45627318.0,35666274.0,6767,5273,6743.0,6764.0,12040,81293592.0,478,285,120,43663498.0,32741765.0,6480,4827,6738.0,6783.0,11307,76405263.0,405,2023-11-08 13:00:00
556,PHOR,176,145,33078990.0,32226503.0,4877,4755,6783.0,6777.0,9632,65305493.0,321,149,133,31070587.0,32096051.0,4612,4734,6737.0,6780.0,9346,63166638.0,282,2023-11-08 13:05:00
557,PHOR,487,92,33926009.0,14643907.0,5025,2158,6751.0,6786.0,7183,48569916.0,579,467,84,32569160.0,14053084.0,4827,2070,6747.0,6789.0,6897,46622244.0,551,2023-11-08 13:10:00
558,PHOR,315,97,39068603.0,14291380.0,5809,2105,6726.0,6789.0,7914,53359983.0,412,298,84,35446900.0,13938318.0,5253,2053,6748.0,6789.0,7306,49385218.0,382,2023-11-08 13:15:00
559,PHOR,148,99,17047397.0,21618739.0,2524,3187,6754.0,6783.0,5711,38666136.0,247,126,92,16116237.0,28990137.0,2392,4278,6738.0,6777.0,6670,45106374.0,218,2023-11-08 13:20:00
560,PHOR,206,318,49897167.0,67349766.0,7410,9953,6734.0,6767.0,17363,117246933.0,524,159,268,46062326.0,63200206.0,6842,9237,6732.0,6842.0,16079,109262532.0,427,2023-11-08 13:25:00
561,PHOR,264,722,48386597.0,115753868.0,7170,17100,6748.0,6769.0,24270,164140465.0,986,237,684,45448799.0,114390611.0,6747,16892,6736.0,6772.0,23639,159839410.0,921,2023-11-08 13:30:00
562,PHOR,307,460,77041688.0,99337996.0,11384,14636,6768.0,6787.0,26020,176379684.0,767,269,415,72132854.0,95225897.0,10706,14031,6738.0,6787.0,24737,167358751.0,684,2023-11-08 13:35:00
563,PHOR,127,261,28100254.0,48381198.0,4170,7135,6739.0,6781.0,11305,76481452.0,388,112,245,27933485.0,47547810.0,4145,7010,6739.0,6783.0,11155,75481295.0,357,2023-11-08 13:40:00
564,PHOR,225,388,41150641.0,70943713.0,6097,10481,6749.0,6769.0,16578,112094354.0,613,199,377,39876604.0,69354592.0,5918,10243,6738.0,6771.0,16161,109231196.0,576,2023-11-08 13:45:00
565,PHOR,159,123,22860748.0,25770799.0,3386,3803,6752.0,6776.0,7189,48631547.0,282,140,114,21549023.0,24878996.0,3196,3670,6742.0,6779.0,6866,46428019.0,254,2023-11-08 13:50:00
566,PHOR,144,166,24519478.0,26951270.0,3634,3974,6747.0,6782.0,7608,51470748.0,310,122,161,24187809.0,27100106.0,3588,3996,6741.0,6782.0,7584,51287915.0,283,2023-11-08 13:55:00
567,PHOR,156,164,33953772.0,38246501.0,5032,5654,6748.0,6765.0,10686,72200273.0,320,144,146,34538947.0,38032883.0,5124,5606,6741.0,6784.0,10730,72571830.0,290,2023-11-08 14:00:00
568,PHOR,121,149,26707296.0,42019565.0,3962,6197,6741.0,6781.0,10159,68726861.0,270,94,132,23152554.0,40959490.0,3439,6031,6732.0,6791.0,9470,64112044.0,226,2023-11-08 14:05:00
569,PHOR,166,597,27727144.0,112898786.0,4113,16692,6741.0,6764.0,20805,140625930.0,763,133,573,25419904.0,110218654.0,3773,16290,6737.0,6766.0,20063,135638558.0,706,2023-11-08 14:10:00
570,PHOR,78,103,13173719.0,19899250.0,1955,2935,6738.0,6780.0,4890,33072969.0,181,67,93,13039643.0,19751430.0,1936,2912,6735.0,6783.0,4848,32791073.0,160,2023-11-08 14:15:00
571,PHOR,165,110,20563674.0,24458118.0,3051,3605,6740.0,6784.0,6656,45021792.0,275,155,98,23058100.0,22726888.0,3424,3347,6734.0,6790.0,6771,45784988.0,253,2023-11-08 14:20:00
572,PHOR,100,97,22342465.0,27915312.0,3316,4118,6738.0,6779.0,7434,50257777.0,197,80,84,21208852.0,28510087.0,3149,4200,6735.0,6788.0,7349,49718939.0,164,2023-11-08 14:25:00
573,PHOR,84,105,19678696.0,27794403.0,2921,4101,6737.0,6777.0,7022,47473099.0,189,64,93,19147963.0,24628586.0,2844,3632,6733.0,6781.0,6476,43776549.0,157,2023-11-08 14:30:00
574,PHOR,72,82,10598987.0,16408321.0,1570,2420,6751.0,6780.0,3990,27007308.0,154,64,67,10802605.0,16113188.0,1604,2375,6735.0,6785.0,3979,26915793.0,131,2023-11-08 14:35:00
575,PHOR,76,57,14151999.0,15025940.0,2102,2213,6733.0,6790.0,4315,29177939.0,133,53,50,13687327.0,14374916.0,2034,2117,6729.0,6790.0,4151,28062243.0,103,2023-11-08 14:40:00
576,PHOR,391,219,34628620.0,30350972.0,5130,4484,6750.0,6769.0,9614,64979592.0,610,372,214,34397682.0,30261868.0,5102,4468,6742.0,6773.0,9570,64659550.0,586,2023-11-08 14:45:00
577,PHOR,244,204,31623679.0,33285776.0,4690,4916,6743.0,6771.0,9606,64909455.0,448,224,181,31047312.0,32443377.0,4606,4784,6741.0,6782.0,9390,63490689.0,405,2023-11-08 14:50:00
578,PHOR,116,144,32352063.0,36010304.0,4806,5319,6732.0,6770.0,10125,68362367.0,260,92,108,32149827.0,32343093.0,4776,4768,6732.0,6783.0,9544,64492920.0,200,2023-11-08 14:55:00
579,PHOR,74,115,27228405.0,19669487.0,3205,2904,8496.0,6773.0,6109,46897892.0,189,63,101,20415135.0,18324520.0,3035,2702,6727.0,6782.0,5737,38739655.0,164,2023-11-08 15:00:00
580,PHOR,118,118,19815955.0,27544948.0,2945,4066,6729.0,6774.0,7011,47360903.0,236,82,107,17246540.0,26159857.0,2561,3858,6734.0,6781.0,6419,43406397.0,189,2023-11-08 15:05:00
581,PHOR,42,32,6059875.0,5791121.0,900,858,6733.0,6750.0,1758,11850996.0,74,33,22,6342374.0,5066303.0,942,746,6733.0,6791.0,1688,11408677.0,55,2023-11-08 15:10:00
582,PHOR,64,66,12559927.0,16344394.0,1865,2417,6735.0,6762.0,4282,28904321.0,130,51,57,12279943.0,14108465.0,1824,2080,6732.0,6783.0,3904,26388408.0,108,2023-11-08 15:15:00
583,PHOR,63,56,7521969.0,12445510.0,1117,1838,6734.0,6771.0,2955,19967479.0,119,52,49,7500650.0,12134457.0,1114,1789,6733.0,6783.0,2903,19635107.0,101,2023-11-08 15:20:00
584,PHOR,148,82,23136459.0,24479952.0,3435,3622,6736.0,6759.0,7057,47616411.0,230,128,66,22083237.0,22866146.0,3279,3375,6735.0,6775.0,6654,44949383.0,194,2023-11-08 15:25:00
585,PHOR,252,268,55663046.0,69550842.0,8240,10256,6755.0,6781.0,18496,125213888.0,520,197,230,50529795.0,65708990.0,7501,9686,6736.0,6784.0,17187,116238785.0,427,2023-11-08 15:30:00
586,PHOR,131,135,16750603.0,19934859.0,2486,2945,6738.0,6769.0,5431,36685462.0,266,102,115,16070422.0,19812007.0,2386,2922,6735.0,6780.0,5308,35882429.0,217,2023-11-08 15:35:00
587,PHOR,99,93,14587377.0,15646555.0,2166,2309,6735.0,6776.0,4475,30233932.0,192,79,89,13209994.0,15346222.0,1962,2263,6733.0,6781.0,4225,28556216.0,168,2023-11-08 15:40:00
588,PHOR,83,98,16805617.0,17250216.0,2493,2547,6741.0,6773.0,5040,34055833.0,181,68,82,15249393.0,16403838.0,2265,2419,6733.0,6781.0,4684,31653231.0,150,2023-11-08 15:45:00
589,PHOR,243,211,29887626.0,41542450.0,4425,6134,6754.0,6772.0,10559,71430076.0,454,219,200,28699530.0,39777011.0,4259,5869,6739.0,6777.0,10128,68476541.0,419,2023-11-08 15:50:00
590,PHOR,194,184,43007622.0,45935752.0,6380,6791,6741.0,6764.0,13171,88943374.0,378,163,162,41379465.0,46633964.0,6140,6881,6739.0,6777.0,13021,88013429.0,325,2023-11-08 15:55:00
591,PHOR,294,326,40199538.0,55414865.0,5964,8183,6740.0,6772.0,14147,95614403.0,620,277,309,40381396.0,51943664.0,5994,7667,6737.0,6775.0,13661,92325060.0,586,2023-11-08 16:00:00
592,PHOR,198,225,35590013.0,47942046.0,5278,7075,6743.0,6776.0,12353,83532059.0,423,157,219,33624248.0,50008674.0,4993,7381,6734.0,6775.0,12374,83632922.0,376,2023-11-08 16:05:00
593,PHOR,98,99,18724519.0,27717509.0,2766,4084,6770.0,6787.0,6850,46442028.0,197,86,92,17718784.0,27675049.0,2629,4078,6740.0,6786.0,6707,45393833.0,178,2023-11-08 16:10:00
594,PHOR,129,255,40718897.0,43319828.0,6036,6384,6746.0,6786.0,12420,84038725.0,384,103,235,31660437.0,42588222.0,4701,6278,6735.0,6784.0,10979,74248659.0,338,2023-11-08 16:15:00
595,PHOR,159,210,32474083.0,41538087.0,4815,6120,6744.0,6787.0,10935,74012170.0,369,131,192,31604263.0,40523977.0,4688,5972,6742.0,6786.0,10660,72128240.0,323,2023-11-08 16:20:00
596,PHOR,115,204,17404104.0,24750048.0,2577,3651,6754.0,6779.0,6228,42154152.0,319,103,198,22625483.0,25009728.0,3352,3689,6750.0,6780.0,7041,47635211.0,301,2023-11-08 16:25:00
597,PHOR,192,357,21955099.0,32845356.0,3250,4851,6755.0,6771.0,8101,54800455.0,549,181,349,20698152.0,32480742.0,3065,4793,6753.0,6777.0,7858,53178894.0,530,2023-11-08 16:30:00
598,PHOR,214,370,34702749.0,59349275.0,5136,8751,6757.0,6782.0,13887,94052024.0,584,198,345,33659687.0,58954685.0,4989,8692,6747.0,6783.0,13681,92614372.0,543,2023-11-08 16:35:00
599,PHOR,200,334,38690144.0,54443986.0,5734,8032,6747.0,6778.0,13766,93134130.0,534,185,300,38357257.0,53499663.0,5685,7891,6747.0,6780.0,13576,91856920.0,485,2023-11-08 16:40:00
600,PHOR,183,477,40180775.0,73547396.0,5929,10841,6777.0,6784.0,16770,113728171.0,660,172,444,38014224.0,72507900.0,5634,10689,6747.0,6783.0,16323,110522124.0,616,2023-11-08 16:45:00
601,PHOR,408,468,90595703.0,85971421.0,13378,12659,6772.0,6791.0,26037,176567124.0,876,394,432,87847146.0,84558100.0,13008,12451,6753.0,6791.0,25459,172405246.0,826,2023-11-08 16:50:00
602,PHOR,154,365,29707748.0,36369853.0,4395,5359,6759.0,6787.0,9754,66077601.0,519,146,342,29954154.0,35185511.0,4433,5184,6757.0,6787.0,9617,65139665.0,488,2023-11-08 16:55:00
603,PHOR,193,232,35326547.0,34767388.0,5227,5124,6758.0,6785.0,10351,70093935.0,425,181,210,33754875.0,34317207.0,4995,5056,6758.0,6787.0,10051,68072082.0,391,2023-11-08 17:00:00
604,PHOR,195,319,21593733.0,33014950.0,3195,4867,6759.0,6783.0,8062,54608683.0,514,188,298,21478539.0,32467877.0,3178,4786,6759.0,6784.0,7964,53946416.0,486,2023-11-08 17:05:00
605,PHOR,153,175,31649791.0,32408503.0,4670,4772,6777.0,6791.0,9442,64058294.0,328,140,155,30359075.0,31413425.0,4495,4621,6754.0,6798.0,9116,61772500.0,295,2023-11-08 17:10:00
606,PHOR,151,138,37156068.0,31443248.0,4942,4622,7518.0,6803.0,9564,68599316.0,289,137,109,42291302.0,29021439.0,6265,4264,6750.0,6806.0,10529,71312741.0,246,2023-11-08 17:15:00
607,PHOR,101,100,21095644.0,33669724.0,3123,4958,6755.0,6791.0,8081,54765368.0,201,90,74,20940388.0,20190046.0,3102,2969,6751.0,6800.0,6071,41130434.0,164,2023-11-08 17:20:00
608,PHOR,53,56,11430715.0,11675282.0,1691,1718,6760.0,6796.0,3409,23105997.0,109,37,36,10947004.0,11385625.0,1620,1674,6757.0,6801.0,3294,22332629.0,73,2023-11-08 17:25:00
609,PHOR,224,251,59887102.0,68245431.0,7971,10042,7513.0,6796.0,18013,128132533.0,475,206,229,50794863.0,65139832.0,7523,9581,6752.0,6799.0,17104,115934695.0,435,2023-11-08 17:30:00
610,PHOR,303,309,35998124.0,42051340.0,5325,6191,6760.0,6792.0,11516,78049464.0,612,283,297,35297200.0,40111495.0,5223,5904,6758.0,6794.0,11127,75408695.0,580,2023-11-08 17:35:00
611,PHOR,78,61,14237399.0,16045109.0,2104,2354,6767.0,6816.0,4458,30282508.0,139,65,54,12369287.0,16231044.0,1832,2382,6752.0,6814.0,4214,28600331.0,119,2023-11-08 17:40:00
612,PHOR,237,459,35848637.0,56831301.0,5308,8391,6754.0,6773.0,13699,92679938.0,696,219,439,35166892.0,54290433.0,5207,7983,6754.0,6801.0,13190,89457325.0,658,2023-11-08 17:45:00
613,PHOR,213,222,29778298.0,37332943.0,4400,5495,6768.0,6794.0,9895,67111241.0,435,195,206,29576342.0,38034775.0,4376,5596,6759.0,6797.0,9972,67611117.0,401,2023-11-08 17:50:00
614,PHOR,126,129,18139823.0,15729625.0,2684,2308,6759.0,6815.0,4992,33869448.0,255,113,119,17976610.0,15209337.0,2660,2231,6758.0,6817.0,4891,33185947.0,232,2023-11-08 17:55:00
615,PHOR,174,357,27000756.0,46178087.0,3984,6813,6777.0,6778.0,10797,73178843.0,531,148,349,25584810.0,42479882.0,3786,6252,6758.0,6795.0,10038,68064692.0,497,2023-11-08 18:00:00
616,PHOR,108,74,10284563.0,14657776.0,1522,2157,6757.0,6795.0,3679,24942339.0,182,96,65,9687367.0,14306049.0,1435,2103,6751.0,6803.0,3538,23993416.0,161,2023-11-08 18:05:00
617,PHOR,45,37,4622696.0,6455854.0,685,950,6748.0,6796.0,1635,11078550.0,82,31,28,4333329.0,6093788.0,643,894,6739.0,6816.0,1537,10427117.0,59,2023-11-08 18:10:00
618,PHOR,343,247,92634809.0,79188492.0,12684,11637,7303.0,6805.0,24321,171823301.0,590,292,211,80007300.0,72783439.0,10940,10692,7313.0,6807.0,21632,152790739.0,503,2023-11-08 18:15:00
619,PHOR,401,571,69143752.0,80661126.0,9691,11856,7135.0,6803.0,21547,149804878.0,972,394,540,69698440.0,79061122.0,9302,11622,7493.0,6803.0,20924,148759562.0,934,2023-11-08 18:20:00
620,PHOR,229,448,30349782.0,56258758.0,4477,8274,6779.0,6799.0,12751,86608540.0,677,209,429,32642850.0,54243455.0,4816,7977,6778.0,6800.0,12793,86886305.0,638,2023-11-08 18:25:00
621,PHOR,113,196,23911173.0,29606383.0,3531,4355,6772.0,6798.0,7886,53517556.0,309,96,177,28537158.0,33209054.0,4218,4876,6766.0,6811.0,9094,61746212.0,273,2023-11-08 18:30:00
622,PHOR,290,239,61163050.0,53850091.0,9005,7904,6792.0,6813.0,16909,115013141.0,529,252,178,57827114.0,50642247.0,8533,7432,6777.0,6814.0,15965,108469361.0,430,2023-11-08 18:35:00
623,PHOR,326,91,50316377.0,19182887.0,7378,2818,6820.0,6807.0,10196,69499264.0,417,304,50,56330269.0,19731545.0,7789,2894,7232.0,6818.0,10683,76061814.0,354,2023-11-08 18:40:00
624,PHOR,4040,2546,1415713677.0,965912084.0,205074,140929,6903.0,6854.0,346003,2381625761.0,6586,3861,2152,1364413812.0,908881877.0,200449,132488,6807.0,6860.0,332937,2273295689.0,6013,2023-11-09 10:05:00
625,PHOR,1286,1158,231095655.0,209984329.0,33798,30535,6838.0,6877.0,64333,441079984.0,2444,1195,988,221160658.0,198643420.0,32385,28879,6829.0,6878.0,61264,419804078.0,2183,2023-11-09 10:10:00
626,PHOR,774,704,120392322.0,89910144.0,17645,13080,6823.0,6874.0,30725,210302466.0,1478,724,570,118229087.0,81661572.0,17342,11870,6818.0,6880.0,29212,199890659.0,1294,2023-11-09 10:15:00
627,PHOR,378,485,80649027.0,78811656.0,11840,11516,6812.0,6844.0,23356,159460683.0,863,333,402,73792647.0,68631699.0,10841,9993,6807.0,6868.0,20834,142424346.0,735,2023-11-09 10:20:00
628,PHOR,695,1573,128251649.0,256391902.0,18835,37426,6809.0,6851.0,56261,384643551.0,2268,629,1506,125097345.0,252152145.0,18373,36797,6809.0,6853.0,55170,377249490.0,2135,2023-11-09 10:25:00
629,PHOR,373,559,60419372.0,67805810.0,8857,9882,6822.0,6862.0,18739,128225182.0,932,321,510,57573797.0,65313090.0,8449,9522,6814.0,6859.0,17971,122886887.0,831,2023-11-09 10:30:00
630,PHOR,219,246,53933328.0,49823991.0,7926,7258,6805.0,6865.0,15184,103757319.0,465,194,198,52128261.0,44351652.0,7658,6456,6807.0,6870.0,14114,96479913.0,392,2023-11-09 10:35:00
631,PHOR,389,395,87659212.0,70477546.0,12861,10272,6816.0,6861.0,23133,158136758.0,784,355,365,77908033.0,67624865.0,11442,9855,6809.0,6862.0,21297,145532898.0,720,2023-11-09 10:40:00
632,PHOR,122,152,23092636.0,32282931.0,3391,4710,6810.0,6854.0,8101,55375567.0,274,99,127,22584436.0,28410337.0,3317,4139,6809.0,6864.0,7456,50994773.0,226,2023-11-09 10:45:00
633,PHOR,144,150,32148795.0,30491115.0,4722,4450,6808.0,6852.0,9172,62639910.0,294,115,116,31285557.0,30569019.0,4595,4459,6809.0,6856.0,9054,61854576.0,231,2023-11-09 10:50:00
634,PHOR,215,410,55502901.0,71807008.0,8137,10475,6821.0,6855.0,18612,127309909.0,625,166,372,50409549.0,69870472.0,7401,10189,6811.0,6857.0,17590,120280021.0,538,2023-11-09 10:55:00
635,PHOR,192,260,57119657.0,71046849.0,8385,10377,6812.0,6847.0,18762,128166506.0,452,175,228,57332197.0,65991005.0,8416,9620,6812.0,6860.0,18036,123323202.0,403,2023-11-09 11:00:00
636,PHOR,220,191,48511966.0,37715482.0,7116,5508,6817.0,6847.0,12624,86227448.0,411,187,164,45930483.0,36188614.0,6743,5280,6812.0,6854.0,12023,82119097.0,351,2023-11-09 11:05:00
637,PHOR,441,423,101954078.0,111489021.0,14972,16286,6810.0,6846.0,31258,213443099.0,864,397,379,99339158.0,112322669.0,14589,16392,6809.0,6852.0,30981,211661827.0,776,2023-11-09 11:10:00
638,PHOR,814,1107,162240320.0,183038535.0,23849,26799,6803.0,6830.0,50648,345278855.0,1921,771,1074,156687466.0,174826823.0,23023,25576,6806.0,6836.0,48599,331514289.0,1845,2023-11-09 11:15:00
639,PHOR,568,466,120830815.0,103926471.0,17757,15193,6805.0,6840.0,32950,224757286.0,1034,540,444,118946023.0,109282128.0,17491,15973,6800.0,6842.0,33464,228228151.0,984,2023-11-09 11:20:00
640,PHOR,650,664,160417062.0,142460292.0,23532,20811,6817.0,6845.0,44343,302877354.0,1314,614,637,149740168.0,139508015.0,22016,20373,6801.0,6848.0,42389,289248183.0,1251,2023-11-09 11:25:00
641,PHOR,663,704,140131433.0,124990683.0,20594,18261,6804.0,6845.0,38855,265122116.0,1367,629,663,135687196.0,123001936.0,19945,17960,6803.0,6849.0,37905,258689132.0,1292,2023-11-09 11:30:00
642,PHOR,573,1402,121561893.0,204687632.0,17899,29972,6792.0,6829.0,47871,326249525.0,1975,556,1356,121181202.0,201201127.0,17842,29437,6792.0,6835.0,47279,322382329.0,1912,2023-11-09 11:35:00
643,PHOR,538,922,133851548.0,156247232.0,19699,22862,6795.0,6834.0,42561,290098780.0,1460,502,890,132667162.0,154287055.0,19526,22569,6794.0,6836.0,42095,286954217.0,1392,2023-11-09 11:40:00
644,PHOR,213,368,86535734.0,73709803.0,9011,10769,9603.0,6845.0,19780,160245537.0,581,183,348,57420766.0,71790530.0,8448,10486,6797.0,6846.0,18934,129211296.0,531,2023-11-09 11:45:00
645,PHOR,437,503,92909817.0,79255197.0,9926,11577,9360.0,6846.0,21503,172165014.0,940,395,454,89499207.0,76307300.0,9448,11144,9473.0,6847.0,20592,165806507.0,849,2023-11-09 11:50:00
646,PHOR,149,123,25385383.0,18977171.0,3728,2765,6809.0,6863.0,6493,44362554.0,272,131,103,23837612.0,16999277.0,3504,2479,6803.0,6857.0,5983,40836889.0,234,2023-11-09 11:55:00
647,PHOR,230,117,38502028.0,39155361.0,5655,5723,6808.0,6842.0,11378,77657389.0,347,207,96,34684230.0,28163192.0,5100,4111,6801.0,6851.0,9211,62847422.0,303,2023-11-09 12:00:00
648,PHOR,69,50,13727742.0,7914512.0,2020,1154,6796.0,6858.0,3174,21642254.0,119,60,38,13815752.0,7799285.0,2034,1136,6792.0,6866.0,3170,21615037.0,98,2023-11-09 12:05:00
649,PHOR,49,90,14108251.0,14591878.0,2073,2136,6806.0,6831.0,4209,28700129.0,139,31,51,11763510.0,12453083.0,1729,1816,6804.0,6857.0,3545,24216593.0,82,2023-11-09 12:10:00
650,PHOR,50,64,9880950.0,10593341.0,1451,1545,6810.0,6857.0,2996,20474291.0,114,38,46,9624167.0,9879878.0,1415,1440,6802.0,6861.0,2855,19504045.0,84,2023-11-09 12:15:00
651,PHOR,190,135,65886984.0,40223710.0,7187,5864,9168.0,6859.0,13051,106110694.0,325,170,119,73188685.0,39449178.0,7045,5749,10389.0,6862.0,12794,112637863.0,289,2023-11-09 12:20:00
652,PHOR,114,53,12833462.0,7504456.0,1868,1093,6870.0,6866.0,2961,20337918.0,167,91,39,11519812.0,7306415.0,1690,1063,6816.0,6873.0,2753,18826227.0,130,2023-11-09 12:25:00
653,PHOR,53,66,25679450.0,13340321.0,3769,1945,6813.0,6859.0,5714,39019771.0,119,40,52,28888443.0,12856619.0,1766,1874,16358.0,6861.0,3640,41745062.0,92,2023-11-09 12:30:00
654,PHOR,150,117,34214346.0,23978385.0,5011,3494,6828.0,6863.0,8505,58192731.0,267,126,92,31686388.0,23353753.0,4657,3403,6804.0,6863.0,8060,55040141.0,218,2023-11-09 12:35:00
655,PHOR,127,121,19448691.0,22463733.0,2848,3276,6829.0,6857.0,6124,41912424.0,248,102,99,18622080.0,15947185.0,2731,2323,6819.0,6865.0,5054,34569265.0,201,2023-11-09 12:40:00
656,PHOR,220,210,76940137.0,66354569.0,11280,9661,6821.0,6868.0,20941,143294706.0,430,184,174,76639936.0,60325676.0,11255,8790,6809.0,6863.0,20045,136965612.0,358,2023-11-09 12:45:00
657,PHOR,296,275,63621933.0,61547109.0,9322,8948,6825.0,6878.0,18270,125169042.0,571,248,237,57565948.0,58681641.0,8442,8532,6819.0,6878.0,16974,116247589.0,485,2023-11-09 12:50:00
658,PHOR,181,142,40476192.0,42466375.0,5932,6183,6823.0,6868.0,12115,82942567.0,323,143,116,40149505.0,38848572.0,5886,5652,6821.0,6873.0,11538,78998077.0,259,2023-11-09 12:55:00
659,PHOR,491,101,173194642.0,27451612.0,10620,4005,16308.0,6854.0,14625,200646254.0,592,471,91,69316346.0,21294242.0,10142,3103,6835.0,6862.0,13245,90610588.0,562,2023-11-09 13:00:00
660,PHOR,92,83,21627312.0,12840485.0,3169,1873,6825.0,6856.0,5042,34467797.0,175,86,66,21153623.0,12206445.0,3100,1780,6824.0,6858.0,4880,33360068.0,152,2023-11-09 13:05:00
661,PHOR,69,94,13469399.0,11739230.0,1973,1713,6827.0,6853.0,3686,25208629.0,163,59,59,12953685.0,10623644.0,1898,1547,6825.0,6867.0,3445,23577329.0,118,2023-11-09 13:10:00
662,PHOR,141,181,24833074.0,31137421.0,3628,4544,6845.0,6852.0,8172,55970495.0,322,124,157,24125464.0,30234306.0,3538,4411,6819.0,6854.0,7949,54359770.0,281,2023-11-09 13:15:00
663,PHOR,65,72,15160426.0,11781780.0,2224,1721,6817.0,6846.0,3945,26942206.0,137,49,56,14178437.0,11253583.0,2080,1639,6817.0,6866.0,3719,25432020.0,105,2023-11-09 13:20:00
664,PHOR,68,82,13022972.0,10626634.0,1908,1555,6825.0,6834.0,3463,23649606.0,150,57,61,11928984.0,9611894.0,1748,1400,6824.0,6866.0,3148,21540878.0,118,2023-11-09 13:25:00
665,PHOR,131,171,25584039.0,26981890.0,3739,3933,6842.0,6860.0,7672,52565929.0,302,116,157,24276294.0,26560293.0,3556,3872,6827.0,6860.0,7428,50836587.0,273,2023-11-09 13:30:00
666,PHOR,78,74,19325019.0,13489759.0,2836,1961,6814.0,6879.0,4797,32814778.0,152,63,57,18237530.0,12106891.0,2675,1760,6818.0,6879.0,4435,30344421.0,120,2023-11-09 13:35:00
667,PHOR,94,126,14402312.0,16558178.0,2101,2411,6855.0,6868.0,4512,30960490.0,220,77,109,13052645.0,14800154.0,1912,2156,6827.0,6865.0,4068,27852799.0,186,2023-11-09 13:40:00
668,PHOR,573,328,123507113.0,64840132.0,18054,9471,6841.0,6846.0,27525,188347245.0,901,559,315,122316420.0,63376292.0,17883,9250,6840.0,6851.0,27133,185692712.0,874,2023-11-09 13:45:00
669,PHOR,130,143,31824971.0,32297040.0,4666,4709,6821.0,6859.0,9375,64122011.0,273,122,122,31310923.0,29098651.0,4591,4240,6820.0,6863.0,8831,60409574.0,244,2023-11-09 13:50:00
670,PHOR,136,129,42303513.0,34334077.0,6149,4996,6880.0,6872.0,11145,76637590.0,265,119,107,35972432.0,33201293.0,5274,4832,6821.0,6871.0,10106,69173725.0,226,2023-11-09 13:55:00
671,PHOR,306,110,65439963.0,27687206.0,9569,4034,6839.0,6863.0,13603,93127169.0,416,307,91,67613841.0,28314535.0,9887,4122,6839.0,6869.0,14009,95928376.0,398,2023-11-09 14:00:00
672,PHOR,150,157,36061026.0,34932662.0,5281,5078,6828.0,6879.0,10359,70993688.0,307,139,142,35475886.0,33457472.0,5200,4863,6822.0,6880.0,10063,68933358.0,281,2023-11-09 14:05:00
673,PHOR,194,227,44856473.0,34799031.0,6575,5083,6822.0,6846.0,11658,79655504.0,421,187,204,43019107.0,31482383.0,6305,4592,6823.0,6856.0,10897,74501490.0,391,2023-11-09 14:10:00
674,PHOR,205,275,47754734.0,57576655.0,7002,8402,6820.0,6853.0,15404,105331389.0,480,178,252,44475903.0,55494141.0,6516,8091,6826.0,6859.0,14607,99970044.0,430,2023-11-09 14:15:00
675,PHOR,169,580,32079028.0,128558822.0,4700,18769,6825.0,6850.0,23469,160637850.0,749,154,556,31361554.0,123610227.0,4596,18045,6824.0,6850.0,22641,154971781.0,710,2023-11-09 14:20:00
676,PHOR,128,150,23497116.0,29145618.0,3442,4253,6827.0,6853.0,7695,52642734.0,278,111,141,22747507.0,28477116.0,3332,4153,6827.0,6857.0,7485,51224623.0,252,2023-11-09 14:25:00
677,PHOR,176,159,32335733.0,23731610.0,4729,3462,6838.0,6855.0,8191,56067343.0,335,166,149,31950499.0,23379738.0,4676,3410,6833.0,6856.0,8086,55330237.0,315,2023-11-09 14:30:00
678,PHOR,113,126,28091793.0,26731274.0,4117,3900,6823.0,6854.0,8017,54823067.0,239,103,117,23857276.0,23464661.0,3497,3419,6822.0,6863.0,6916,47321937.0,220,2023-11-09 14:35:00
679,PHOR,68,77,36368620.0,16925301.0,3937,2472,9238.0,6847.0,6409,53293921.0,145,58,70,25832358.0,16539294.0,3790,2407,6816.0,6871.0,6197,42371652.0,128,2023-11-09 14:40:00
680,PHOR,335,243,201010075.0,78097512.0,15526,11368,12947.0,6870.0,26894,279107587.0,578,313,219,200065925.0,73523852.0,14569,10698,13732.0,6873.0,25267,273589777.0,532,2023-11-09 14:45:00
681,PHOR,400,332,116056274.0,91856796.0,16935,13343,6853.0,6884.0,30278,207913070.0,732,327,297,104420235.0,90523512.0,15267,13149,6840.0,6884.0,28416,194943747.0,624,2023-11-09 14:50:00
682,PHOR,567,665,146217718.0,141837517.0,21305,20587,6863.0,6890.0,41892,288055235.0,1232,500,535,139300243.0,135551485.0,20345,19673,6847.0,6890.0,40018,274851728.0,1035,2023-11-09 14:55:00
683,PHOR,463,387,77264599.0,68054008.0,11267,9869,6858.0,6896.0,21136,145318607.0,850,424,315,75392919.0,63062745.0,10995,9143,6857.0,6897.0,20138,138455664.0,739,2023-11-09 15:00:00
684,PHOR,619,433,101345784.0,74497037.0,14772,10820,6861.0,6885.0,25592,175842821.0,1052,577,372,99788650.0,71832204.0,14562,10431,6853.0,6886.0,24993,171620854.0,949,2023-11-09 15:05:00
685,PHOR,427,226,86162007.0,50889049.0,11215,7384,7683.0,6892.0,18599,137051056.0,653,392,180,94736269.0,50409121.0,11086,7308,8546.0,6898.0,18394,145145390.0,572,2023-11-09 15:10:00
686,PHOR,278,236,71686927.0,61277135.0,9266,9064,7737.0,6760.0,18330,132964062.0,514,257,200,63129072.0,50225514.0,9218,7282,6848.0,6897.0,16500,113354586.0,457,2023-11-09 15:15:00
687,PHOR,893,900,194244464.0,185321692.0,28375,26953,6846.0,6876.0,55328,379566156.0,1793,828,855,189868664.0,180541804.0,27739,26224,6845.0,6885.0,53963,370410468.0,1683,2023-11-09 15:20:00
688,PHOR,270,350,46310923.0,51703159.0,6751,7512,6860.0,6883.0,14263,98014082.0,620,241,323,44391147.0,50700706.0,6487,7363,6843.0,6886.0,13850,95091853.0,564,2023-11-09 15:25:00
689,PHOR,142,97,22164714.0,18941659.0,3235,2747,6852.0,6895.0,5982,41106373.0,239,127,83,21675938.0,18098624.0,3167,2625,6844.0,6895.0,5792,39774562.0,210,2023-11-09 15:30:00
690,PHOR,147,109,18163746.0,12936650.0,2653,1879,6846.0,6885.0,4532,31100396.0,256,139,101,17709372.0,12792970.0,2588,1854,6843.0,6900.0,4442,30502342.0,240,2023-11-09 15:35:00
691,PHOR,162,179,33647143.0,25156207.0,4918,3653,6842.0,6886.0,8571,58803350.0,341,155,158,32732522.0,24769246.0,4785,3595,6841.0,6890.0,8380,57501768.0,313,2023-11-09 15:40:00
692,PHOR,89,142,10754743.0,13213437.0,1573,1916,6837.0,6896.0,3489,23968180.0,231,76,124,10202577.0,12512802.0,1492,1813,6838.0,6902.0,3305,22715379.0,200,2023-11-09 15:45:00
693,PHOR,309,485,63893714.0,65751973.0,9313,9541,6861.0,6892.0,18854,129645687.0,794,280,466,60875293.0,64879757.0,8891,9415,6847.0,6891.0,18306,125755050.0,746,2023-11-09 15:50:00
694,PHOR,232,160,36492332.0,28238090.0,5314,4107,6867.0,6876.0,9421,64730422.0,392,191,130,35275761.0,26160596.0,5146,3794,6855.0,6895.0,8940,61436357.0,321,2023-11-09 15:55:00
695,PHOR,740,554,337433255.0,127859514.0,24570,18530,13734.0,6900.0,43100,465292769.0,1294,693,496,345801277.0,119987411.0,23500,17386,14715.0,6901.0,40886,465788688.0,1189,2023-11-09 16:00:00
696,PHOR,557,460,109822819.0,89027707.0,15966,12895,6879.0,6904.0,28861,198850526.0,1017,488,382,103266604.0,83223469.0,15034,12041,6869.0,6912.0,27075,186490073.0,870,2023-11-09 16:05:00
697,PHOR,527,342,97494643.0,63615576.0,14177,9209,6877.0,6908.0,23386,161110219.0,869,489,274,100309897.0,58652293.0,14603,8485,6869.0,6912.0,23088,158962190.0,763,2023-11-09 16:10:00
698,PHOR,588,302,104379784.0,65836900.0,14690,9547,7105.0,6896.0,24237,170216684.0,890,561,244,96163176.0,61377348.0,13994,8877,6872.0,6914.0,22871,157540524.0,805,2023-11-09 16:15:00
699,PHOR,306,255,62902067.0,74597232.0,9154,6010,6872.0,12412.0,15164,137499299.0,561,282,203,54504736.0,35507058.0,7934,5138,6870.0,6911.0,13072,90011794.0,485,2023-11-09 16:20:00
700,PHOR,112,110,26228169.0,21062069.0,3475,3052,7548.0,6901.0,6527,47290238.0,222,86,71,26601803.0,18098331.0,3393,2617,7840.0,6916.0,6010,44700134.0,157,2023-11-09 16:25:00
701,PHOR,202,150,52679099.0,37486417.0,7660,5435,6877.0,6897.0,13095,90165516.0,352,140,110,41767921.0,34137177.0,6081,4939,6869.0,6912.0,11020,75905098.0,250,2023-11-09 16:30:00
702,PHOR,133,100,110996128.0,18633953.0,3764,2700,29489.0,6901.0,6464,129630081.0,233,111,62,119112044.0,16344921.0,5870,2363,20292.0,6917.0,8233,135456965.0,173,2023-11-09 16:35:00
703,PHOR,211,183,38601558.0,43290741.0,5587,6269,6909.0,6906.0,11856,81892299.0,394,141,147,35730135.0,38938745.0,5197,5635,6875.0,6910.0,10832,74668880.0,288,2023-11-09 16:40:00
704,PHOR,103,90,16898973.0,22089237.0,2458,2796,6875.0,7900.0,5254,38988210.0,193,82,62,17129193.0,15824964.0,2493,2285,6871.0,6926.0,4778,32954157.0,144,2023-11-09 16:45:00
705,PHOR,201,133,47414331.0,40126174.0,6891,5816,6881.0,6899.0,12707,87540505.0,334,177,99,45771941.0,36079278.0,6662,5217,6871.0,6916.0,11879,81851219.0,276,2023-11-09 16:50:00
706,PHOR,90,92,18529065.0,20261049.0,2695,2935,6875.0,6903.0,5630,38790114.0,182,75,59,17282681.0,18212835.0,2516,2634,6869.0,6915.0,5150,35495516.0,134,2023-11-09 16:55:00
707,PHOR,125,118,32253572.0,27087452.0,4682,3919,6889.0,6912.0,8601,59341024.0,243,89,83,24813518.0,25523846.0,3610,3690,6874.0,6917.0,7300,50337364.0,172,2023-11-09 17:00:00
708,PHOR,312,420,89728840.0,75786347.0,13027,10959,6888.0,6915.0,23986,165515187.0,732,234,340,60827144.0,71543404.0,8850,10342,6873.0,6918.0,19192,132370548.0,574,2023-11-09 17:05:00
709,PHOR,5275,4705,1446635442.0,1383457578.0,208775,197584,6929.0,7002.0,406359,2830093020.0,9980,4401,3473,1257155559.0,1198029742.0,181885,171662,6912.0,6979.0,353547,2455185301.0,7874,2023-11-09 17:10:00
710,PHOR,1378,1724,270560583.0,371446699.0,38393,52849,7047.0,7028.0,91242,642007282.0,3102,1074,1460,264946303.0,347290750.0,38397,49470,6900.0,7020.0,87867,612237053.0,2534,2023-11-09 17:15:00
711,PHOR,1619,1799,352302458.0,408074584.0,49811,58865,7073.0,6932.0,108676,760377042.0,3418,1346,1599,318636636.0,404906741.0,44865,57701,7102.0,7017.0,102566,723543377.0,2945,2023-11-09 17:20:00
712,PHOR,1522,1311,313267486.0,286905707.0,45160,38701,6937.0,7413.0,83861,600173193.0,2833,1235,1089,271716117.0,241447607.0,39294,34673,6915.0,6964.0,73967,513163724.0,2324,2023-11-09 17:25:00
713,PHOR,1049,911,172252464.0,153274965.0,24873,22041,6925.0,6954.0,46914,325527429.0,1960,892,746,161355962.0,141763277.0,23336,20363,6914.0,6962.0,43699,303119239.0,1638,2023-11-09 17:30:00
714,PHOR,1598,1699,344237360.0,394327531.0,49314,56745,6981.0,6949.0,106059,738564891.0,3297,1266,1423,309871973.0,362498470.0,44817,52040,6914.0,6966.0,96857,672370443.0,2689,2023-11-09 17:35:00
715,PHOR,694,785,207340874.0,185918348.0,30040,26889,6902.0,6914.0,56929,393259222.0,1479,558,638,233905365.0,156422313.0,21565,22492,10847.0,6955.0,44057,390327678.0,1196,2023-11-09 17:40:00
716,PHOR,993,1109,177934936.0,201749495.0,25761,29063,6907.0,6942.0,54824,379684431.0,2102,815,1033,161137215.0,198936046.0,23352,28644,6900.0,6945.0,51996,360073261.0,1848,2023-11-09 17:45:00
717,PHOR,495,726,84072596.0,127132010.0,11327,18384,7422.0,6915.0,29711,211204606.0,1221,395,631,84886830.0,112746315.0,10816,16239,7848.0,6943.0,27055,197633145.0,1026,2023-11-09 17:50:00
718,PHOR,489,574,99224982.0,94007568.0,14391,13567,6895.0,6929.0,27958,193232550.0,1063,404,506,92716048.0,86945841.0,13475,12516,6881.0,6947.0,25991,179661889.0,910,2023-11-09 17:55:00
719,PHOR,643,433,106975602.0,93298524.0,15480,13428,6911.0,6948.0,28908,200274126.0,1076,569,379,102278755.0,82410567.0,14827,11855,6898.0,6952.0,26682,184689322.0,948,2023-11-09 18:00:00
720,PHOR,1599,1458,358286533.0,276839397.0,51871,39887,6907.0,6941.0,91758,635125930.0,3057,1527,1403,352660516.0,273231861.0,51088,39329,6903.0,6947.0,90417,625892377.0,2930,2023-11-09 18:05:00
721,PHOR,612,623,125878568.0,134834266.0,18237,19504,6902.0,6913.0,37741,260712834.0,1235,520,539,120447332.0,123121269.0,17472,17728,6894.0,6945.0,35200,243568601.0,1059,2023-11-09 18:10:00
722,PHOR,1184,1433,207428921.0,301150245.0,30114,43660,6888.0,6898.0,73774,508579166.0,2617,885,1229,190118229.0,263384637.0,27644,38074,6877.0,6918.0,65718,453502866.0,2114,2023-11-09 18:15:00
723,PHOR,736,660,99575644.0,116655323.0,14429,16867,6901.0,6916.0,31296,216230967.0,1396,630,584,95029863.0,109120536.0,13808,15750,6882.0,6928.0,29558,204150399.0,1214,2023-11-09 18:20:00
724,PHOR,615,634,104126345.0,119471763.0,15100,17314,6896.0,6900.0,32414,223598108.0,1249,524,570,97387589.0,114903023.0,14145,16586,6885.0,6928.0,30731,212290612.0,1094,2023-11-09 18:25:00
725,PHOR,901,1119,168255760.0,251587205.0,24499,36659,6868.0,6863.0,61158,419842965.0,2020,728,995,220343068.0,235556482.0,32063,34117,6872.0,6904.0,66180,455899550.0,1723,2023-11-09 18:30:00
726,PHOR,1595,1718,424666371.0,435884571.0,61924,63228,6858.0,6894.0,125152,860550942.0,3313,1287,1532,351619355.0,408336472.0,51321,59198,6851.0,6898.0,110519,759955827.0,2819,2023-11-09 18:35:00
727,PHOR,1978,3945,300290875.0,877491346.0,43791,127686,6857.0,6872.0,171477,1177782221.0,5923,1927,3906,298525984.0,890722911.0,43559,129524,6853.0,6877.0,173083,1189248895.0,5833,2023-11-09 18:40:00
728,PHOR,408,783,63471916.0,148107839.0,7501,20780,8462.0,7127.0,28281,211579755.0,1191,279,615,35380354.0,123019293.0,5154,17823,6865.0,6902.0,22977,158399647.0,894,2023-11-10 10:05:00
729,PHOR,381,832,42486187.0,138543207.0,6291,20066,6753.0,6904.0,26357,181029394.0,1213,294,766,27472006.0,134452606.0,4006,19482,6858.0,6901.0,23488,161924612.0,1060,2023-11-10 10:10:00
730,PHOR,1298,2577,279279545.0,559839151.0,40937,81593,6822.0,6861.0,122530,839118696.0,3875,1113,2419,272513036.0,542589147.0,39925,78873,6826.0,6879.0,118798,815102183.0,3532,2023-11-10 10:15:00
731,PHOR,786,1180,145321394.0,217692066.0,21241,31696,6842.0,6868.0,52937,363013460.0,1966,584,1094,132156218.0,211965908.0,19398,30864,6813.0,6868.0,50262,344122126.0,1678,2023-11-10 10:20:00
732,PHOR,1232,1288,271353910.0,271347530.0,39760,39459,6825.0,6877.0,79219,542701440.0,2520,1127,1224,265554664.0,264098580.0,38915,38390,6824.0,6879.0,77305,529653244.0,2351,2023-11-10 10:25:00
733,PHOR,613,542,112742316.0,149958912.0,16524,21876,6823.0,6855.0,38400,262701228.0,1155,510,489,107426208.0,147702528.0,15760,20840,6816.0,7087.0,36600,255128736.0,999,2023-11-10 10:30:00
734,PHOR,565,619,126239227.0,168640390.0,18541,24648,6809.0,6842.0,43189,294879617.0,1184,433,549,119249907.0,157205065.0,17519,22937,6807.0,6854.0,40456,276454972.0,982,2023-11-10 10:35:00
735,PHOR,573,719,146308872.0,154114009.0,21480,22488,6811.0,6853.0,43968,300422881.0,1292,474,669,142586198.0,158205572.0,20951,23079,6806.0,6855.0,44030,300791770.0,1143,2023-11-10 10:40:00
736,PHOR,623,636,95635193.0,119397992.0,14039,17448,6812.0,6843.0,31487,215033185.0,1259,528,603,90039934.0,112992126.0,13225,16477,6808.0,6858.0,29702,203032060.0,1131,2023-11-10 10:45:00
737,PHOR,460,456,95239870.0,97160563.0,9980,14249,9543.0,6819.0,24229,192400433.0,916,367,420,66903999.0,89563638.0,9844,13067,6796.0,6854.0,22911,156467637.0,787,2023-11-10 10:50:00
738,PHOR,168,153,33272149.0,27752614.0,4870,4051,6832.0,6851.0,8921,61024763.0,321,104,130,27156649.0,27234924.0,3992,3974,6803.0,6853.0,7966,54391573.0,234,2023-11-10 10:55:00
739,PHOR,423,849,171154277.0,242932633.0,25133,35461,6810.0,6851.0,60594,414086910.0,1272,334,811,166078330.0,233387068.0,24395,34084,6808.0,6847.0,58479,399465398.0,1145,2023-11-10 11:00:00
740,PHOR,271,1064,41889859.0,223092880.0,6136,32606,6827.0,6842.0,38742,264982739.0,1335,228,1045,43360114.0,228861281.0,6377,33429,6799.0,6846.0,39806,272221395.0,1273,2023-11-10 11:05:00
741,PHOR,302,415,42735039.0,83515022.0,6262,12194,6825.0,6849.0,18456,126250061.0,717,252,385,67089884.0,82282614.0,5841,12011,11486.0,6851.0,17852,149372498.0,637,2023-11-10 11:10:00
742,PHOR,327,354,74942626.0,68928374.0,10998,10046,6814.0,6861.0,21044,143871000.0,681,269,315,72153596.0,66343327.0,10602,9669,6806.0,6861.0,20271,138496923.0,584,2023-11-10 11:15:00
743,PHOR,573,557,100869509.0,120257560.0,14764,17522,6832.0,6863.0,32286,221127069.0,1130,507,520,97836345.0,118020617.0,14338,17196,6824.0,6863.0,31534,215856962.0,1027,2023-11-10 11:20:00
744,PHOR,473,338,74589337.0,57975504.0,10927,8441,6826.0,6868.0,19368,132564841.0,811,435,318,72399951.0,56758819.0,10606,8264,6826.0,6868.0,18870,129158770.0,753,2023-11-10 11:25:00
745,PHOR,245,163,51568570.0,34964009.0,7556,5094,6825.0,6864.0,12650,86532579.0,408,217,131,46569923.0,33578474.0,6826,4885,6822.0,6874.0,11711,80148397.0,348,2023-11-10 11:30:00
746,PHOR,285,227,67402775.0,54199327.0,9884,7212,6819.0,7515.0,17096,121602102.0,512,246,205,64778754.0,47941812.0,9500,6972,6819.0,6876.0,16472,112720566.0,451,2023-11-10 11:35:00
747,PHOR,115,126,19709339.0,21839818.0,2886,3180,6829.0,6868.0,6066,41549157.0,241,86,99,18984235.0,19658170.0,2787,2860,6812.0,6873.0,5647,38642405.0,185,2023-11-10 11:40:00
748,PHOR,142,140,21781583.0,22613424.0,3189,3294,6830.0,6865.0,6483,44395007.0,282,108,132,19983313.0,22175735.0,2930,3227,6820.0,6872.0,6157,42159048.0,240,2023-11-10 11:45:00
749,PHOR,450,339,85686454.0,83580069.0,12540,12154,6833.0,6877.0,24694,169266523.0,789,427,314,80757825.0,81965595.0,11830,11921,6827.0,6876.0,23751,162723420.0,741,2023-11-10 11:50:00
750,PHOR,309,584,59659069.0,80964292.0,8713,11781,6847.0,6872.0,20494,140623361.0,893,282,546,56721479.0,79888642.0,8296,11624,6837.0,6873.0,19920,136610121.0,828,2023-11-10 11:55:00
751,PHOR,903,510,133193913.0,103081687.0,19434,14971,6854.0,6885.0,34405,236275600.0,1413,853,472,130706768.0,98494784.0,19087,14308,6848.0,6884.0,33395,229201552.0,1325,2023-11-10 12:00:00
752,PHOR,771,757,179353047.0,175571745.0,26138,25451,6862.0,6898.0,51589,354924792.0,1528,720,702,171391472.0,173214464.0,24999,25114,6856.0,6897.0,50113,344605936.0,1422,2023-11-10 12:05:00
753,PHOR,172,204,41661371.0,43001389.0,6068,6233,6866.0,6899.0,12301,84662760.0,376,150,180,43720195.0,42836257.0,6389,6208,6843.0,6900.0,12597,86556452.0,330,2023-11-10 12:10:00
754,PHOR,200,386,63182376.0,74273121.0,9191,10768,6874.0,6898.0,19959,137455497.0,586,172,355,60658574.0,71392672.0,8851,10343,6853.0,6903.0,19194,132051246.0,527,2023-11-10 12:15:00
755,PHOR,131,149,40677762.0,42586014.0,5906,6160,6888.0,6913.0,12066,83263776.0,280,106,115,38089124.0,40470676.0,5552,5856,6860.0,6911.0,11408,78559800.0,221,2023-11-10 12:20:00
756,PHOR,164,191,37939313.0,52838138.0,5529,7655,6862.0,6902.0,13184,90777451.0,355,149,159,37330727.0,50639462.0,5442,7335,6860.0,6904.0,12777,87970189.0,308,2023-11-10 12:25:00
757,PHOR,196,190,55002565.0,55630484.0,8026,8059,6853.0,6903.0,16085,110633049.0,386,171,149,54409391.0,51352814.0,7940,7435,6853.0,6907.0,15375,105762205.0,320,2023-11-10 12:30:00
758,PHOR,435,1010,85519759.0,170603276.0,12508,24778,6837.0,6885.0,37286,256123035.0,1445,394,979,84012172.0,166366385.0,12289,24155,6836.0,6887.0,36444,250378557.0,1373,2023-11-10 12:35:00
759,PHOR,366,764,63707497.0,121964655.0,9301,17731,6850.0,6879.0,27032,185672152.0,1130,324,735,62258904.0,120063933.0,9100,17444,6842.0,6883.0,26544,182322837.0,1059,2023-11-10 12:40:00
760,PHOR,334,571,76580614.0,117027872.0,11192,16993,6842.0,6887.0,28185,193608486.0,905,299,543,73895351.0,115964078.0,10805,16836,6839.0,6888.0,27641,189859429.0,842,2023-11-10 12:45:00
761,PHOR,175,266,42155763.0,49875619.0,6160,7240,6843.0,6889.0,13400,92031382.0,441,161,236,41923327.0,47672927.0,6126,6905,6844.0,6904.0,13031,89596254.0,397,2023-11-10 12:50:00
762,PHOR,349,497,73565774.0,89222547.0,10756,12978,6840.0,6875.0,23734,162788321.0,846,318,473,71522048.0,86457055.0,10460,12555,6838.0,6886.0,23015,157979103.0,791,2023-11-10 12:55:00
763,PHOR,236,328,36646613.0,59047406.0,5361,8586,6836.0,6877.0,13947,95694019.0,564,211,314,36062502.0,58378380.0,5277,8488,6834.0,6878.0,13765,94440882.0,525,2023-11-10 13:00:00
764,PHOR,379,447,80590380.0,99062214.0,11806,14427,6826.0,6866.0,26233,179652594.0,826,334,406,79205154.0,93402565.0,11602,13576,6827.0,6880.0,25178,172607719.0,740,2023-11-10 13:05:00
765,PHOR,510,1230,114946375.0,205399508.0,16852,29926,6821.0,6864.0,46778,320345883.0,1740,457,1195,113389933.0,204378630.0,16626,29775,6820.0,6864.0,46401,317768563.0,1652,2023-11-10 13:10:00
766,PHOR,217,259,48691017.0,56330191.0,7143,8205,6817.0,6865.0,15348,105021208.0,476,191,228,47724890.0,54080457.0,7000,7873,6818.0,6869.0,14873,101805347.0,419,2023-11-10 13:15:00
767,PHOR,337,809,76920132.0,112723523.0,11280,16432,6819.0,6860.0,27712,189643655.0,1146,288,750,74922048.0,106555629.0,10991,15532,6817.0,6860.0,26523,181477677.0,1038,2023-11-10 13:20:00
768,PHOR,603,1977,125599934.0,313698341.0,18435,45835,6813.0,6844.0,64270,439298275.0,2580,529,1918,120890218.0,311049598.0,17755,45408,6809.0,6850.0,63163,431939816.0,2447,2023-11-10 13:25:00
769,PHOR,589,1125,135741401.0,178600319.0,19919,26076,6815.0,6849.0,45995,314341720.0,1714,517,1060,129036236.0,175485212.0,18949,25602,6810.0,6854.0,44551,304521448.0,1577,2023-11-10 13:30:00
770,PHOR,295,533,67599692.0,94394339.0,9931,13776,6807.0,6852.0,23707,161994031.0,828,239,471,66933747.0,90873314.0,9833,13257,6807.0,6855.0,23090,157807061.0,710,2023-11-10 13:35:00
771,PHOR,410,221,44275853.0,38927717.0,6501,5684,6811.0,6849.0,12185,83203570.0,631,354,178,40524257.0,36822428.0,5953,5372,6807.0,6855.0,11325,77346685.0,532,2023-11-10 13:40:00
772,PHOR,483,590,112137546.0,130562714.0,16503,19102,6795.0,6835.0,35605,242700260.0,1073,394,519,107281324.0,119413299.0,15789,17451,6795.0,6843.0,33240,226694623.0,913,2023-11-10 13:45:00
773,PHOR,402,1056,97157004.0,159446063.0,14298,23332,6795.0,6834.0,37630,256603067.0,1458,304,999,89676423.0,157387174.0,13205,23018,6791.0,6838.0,36223,247063597.0,1303,2023-11-10 13:50:00
774,PHOR,675,810,182538493.0,189549848.0,26852,27709,6798.0,6841.0,54561,372088341.0,1485,617,745,180782828.0,184919525.0,26599,27005,6797.0,6848.0,53604,365702353.0,1362,2023-11-10 13:55:00
775,PHOR,604,710,128777678.0,138321394.0,18945,20210,6797.0,6844.0,39155,267099072.0,1314,554,656,128137647.0,135137159.0,18857,19739,6795.0,6846.0,38596,263274806.0,1210,2023-11-10 14:00:00
776,PHOR,509,884,69712304.0,130869293.0,10248,19139,6803.0,6838.0,29387,200581597.0,1393,456,849,68030760.0,129669179.0,10003,18962,6801.0,6838.0,28965,197699939.0,1305,2023-11-10 14:05:00
777,PHOR,441,862,82363585.0,153056265.0,12118,22394,6797.0,6835.0,34512,235419850.0,1303,381,815,78587489.0,148434108.0,11564,21713,6796.0,6836.0,33277,227021597.0,1196,2023-11-10 14:10:00
778,PHOR,401,1007,60042505.0,151566199.0,8827,22184,6802.0,6832.0,31011,211608704.0,1408,329,949,59108287.0,149884645.0,8695,21936,6798.0,6833.0,30631,208992932.0,1278,2023-11-10 14:15:00
779,PHOR,355,688,64937116.0,126519895.0,9555,18507,6796.0,6836.0,28062,191457011.0,1043,286,633,62625856.0,124961630.0,9219,18274,6793.0,6838.0,27493,187587486.0,919,2023-11-10 14:20:00
780,PHOR,290,668,49042319.0,122348760.0,7214,17904,6798.0,6834.0,25118,171391079.0,958,212,603,48736782.0,121349285.0,7176,17752,6792.0,6836.0,24928,170086067.0,815,2023-11-10 14:25:00
781,PHOR,196,278,31259743.0,45596409.0,4599,6670,6797.0,6836.0,11269,76856152.0,474,140,226,29928097.0,42754778.0,4404,6245,6796.0,6846.0,10649,72682875.0,366,2023-11-10 14:30:00
782,PHOR,322,667,65620757.0,136437990.0,9647,19949,6802.0,6839.0,29596,202058747.0,989,261,608,63537185.0,134564369.0,9355,19674,6792.0,6840.0,29029,198101554.0,869,2023-11-10 14:35:00
783,PHOR,367,632,70027726.0,107676158.0,10305,15753,6796.0,6835.0,26058,177703884.0,999,302,558,67065103.0,104673012.0,9874,15307,6792.0,6838.0,25181,171738115.0,860,2023-11-10 14:40:00
784,PHOR,270,377,51979779.0,69737357.0,7649,10211,6796.0,6830.0,17860,121717136.0,647,224,314,51211134.0,66172992.0,7541,9667,6791.0,6845.0,17208,117384126.0,538,2023-11-10 14:45:00
785,PHOR,499,543,96704314.0,114164682.0,10679,16796,9056.0,6797.0,27475,210868996.0,1042,381,483,70953016.0,102509618.0,10457,15001,6785.0,6834.0,25458,173462634.0,864,2023-11-10 14:50:00
786,PHOR,304,344,49389027.0,60187806.0,7266,8807,6797.0,6834.0,16073,109576833.0,648,206,286,45285641.0,57825303.0,6675,8459,6784.0,6836.0,15134,103110944.0,492,2023-11-10 14:55:00
787,PHOR,404,229,40108194.0,41203732.0,5910,6026,6786.0,6838.0,11936,81311926.0,633,331,181,36687563.0,39671938.0,5410,5800,6781.0,6840.0,11210,76359501.0,512,2023-11-10 15:00:00
788,PHOR,241,258,40843874.0,57609479.0,6024,8434,6780.0,6831.0,14458,98453353.0,499,167,216,38149872.0,55824850.0,5629,8171,6777.0,6832.0,13800,93974722.0,383,2023-11-10 15:05:00
789,PHOR,346,386,84417203.0,104405845.0,12428,15307,6793.0,6821.0,27735,188823048.0,732,276,335,81996218.0,100013934.0,12085,14642,6785.0,6831.0,26727,182010152.0,611,2023-11-10 15:10:00
790,PHOR,485,399,66978541.0,65487752.0,9851,9593,6799.0,6827.0,19444,132466293.0,884,401,319,60148405.0,63011601.0,8863,9217,6786.0,6836.0,18080,123160006.0,720,2023-11-10 15:15:00
791,PHOR,439,447,96511175.0,118112208.0,14194,17280,6799.0,6835.0,31474,214623383.0,886,376,398,94049950.0,116047500.0,13851,16978,6790.0,6835.0,30829,210097450.0,774,2023-11-10 15:20:00
792,PHOR,687,827,171074345.0,183841692.0,25178,26884,6795.0,6838.0,52062,354916037.0,1514,632,749,164500191.0,179725836.0,24218,26270,6792.0,6841.0,50488,344226027.0,1381,2023-11-10 15:25:00
793,PHOR,408,567,105701880.0,124065122.0,15518,18139,6812.0,6840.0,33657,229767002.0,975,345,473,98894794.0,119556656.0,14541,17480,6801.0,6840.0,32021,218451450.0,818,2023-11-10 15:30:00
794,PHOR,324,460,79692717.0,97070309.0,11713,14193,6804.0,6839.0,25906,176763026.0,784,274,386,76672628.0,94132175.0,11280,13763,6797.0,6840.0,25043,170804803.0,660,2023-11-10 15:35:00
795,PHOR,242,351,51606854.0,76655247.0,7591,11215,6798.0,6835.0,18806,128262101.0,593,216,305,51286381.0,72687255.0,7546,10627,6796.0,6840.0,18173,123973636.0,521,2023-11-10 15:40:00
796,PHOR,266,504,58718316.0,117271513.0,8647,17166,6791.0,6832.0,25813,175989829.0,770,215,466,55608629.0,116333645.0,8191,17020,6789.0,6835.0,25211,171942274.0,681,2023-11-10 15:45:00
797,PHOR,258,395,47081010.0,89161713.0,6927,13054,6797.0,6830.0,19981,136242723.0,653,223,357,46103563.0,86366392.0,6787,12637,6793.0,6834.0,19424,132469955.0,580,2023-11-10 15:50:00
798,PHOR,274,395,34625597.0,49789200.0,5096,7293,6795.0,6827.0,12389,84414797.0,669,243,363,33671885.0,48594484.0,4956,7114,6794.0,6831.0,12070,82266369.0,606,2023-11-10 15:55:00
799,PHOR,306,353,55005192.0,76467409.0,8101,11197,6790.0,6829.0,19298,131472601.0,659,265,311,54225330.0,74858718.0,7988,10949,6788.0,6837.0,18937,129084048.0,576,2023-11-10 16:00:00
800,PHOR,285,444,65007211.0,101771756.0,9578,14901,6787.0,6830.0,24479,166778967.0,729,253,406,62772721.0,100341758.0,9250,14687,6786.0,6832.0,23937,163114479.0,659,2023-11-10 16:05:00
801,PHOR,252,386,47805987.0,73947383.0,7037,10836,6794.0,6824.0,17873,121753370.0,638,214,341,45446111.0,72677458.0,6695,10640,6788.0,6831.0,17335,118123569.0,555,2023-11-10 16:10:00
802,PHOR,581,731,136906802.0,142883514.0,20109,20906,6808.0,6835.0,41015,279790316.0,1312,513,668,124732429.0,139812053.0,18365,20456,6792.0,6835.0,38821,264544482.0,1181,2023-11-10 16:15:00
803,PHOR,162,225,53709403.0,46672425.0,5125,6827,10480.0,6836.0,11952,100381828.0,387,135,192,63051413.0,49496132.0,5711,7236,11040.0,6840.0,12947,112547545.0,327,2023-11-10 16:20:00
804,PHOR,161,190,31951982.0,39877256.0,4692,5838,6810.0,6831.0,10530,71829238.0,351,134,155,30961775.0,37819423.0,4552,5534,6802.0,6834.0,10086,68781198.0,289,2023-11-10 16:25:00
805,PHOR,133,132,26953503.0,32350713.0,3969,4730,6791.0,6839.0,8699,59304216.0,265,102,91,21392585.0,26609637.0,3149,3892,6793.0,6837.0,7041,48002222.0,193,2023-11-10 16:30:00
806,PHOR,281,326,66733582.0,69984180.0,9819,10219,6796.0,6848.0,20038,136717762.0,607,256,272,64337598.0,67486204.0,9470,9854,6794.0,6849.0,19324,131823802.0,528,2023-11-10 16:35:00
807,PHOR,153,197,26370286.0,34528688.0,3878,5043,6800.0,6847.0,8921,60898974.0,350,127,157,26350592.0,32735112.0,3876,4778,6798.0,6851.0,8654,59085704.0,284,2023-11-10 16:40:00
808,PHOR,583,263,75530823.0,63711211.0,11107,9317,6800.0,6838.0,20424,139242034.0,846,540,218,72962947.0,60651710.0,10729,8864,6801.0,6842.0,19593,133614657.0,758,2023-11-10 16:45:00
809,PHOR,134,182,30862487.0,44501166.0,4539,6518,6799.0,6827.0,11057,75363653.0,316,110,140,26925545.0,41556609.0,3963,6065,6794.0,6852.0,10028,68482154.0,250,2023-11-10 16:50:00
810,PHOR,107,122,20084161.0,25645319.0,2952,3752,6804.0,6835.0,6704,45729480.0,229,81,82,19512973.0,23496440.0,2871,3434,6797.0,6842.0,6305,43009413.0,163,2023-11-10 16:55:00
811,PHOR,157,262,25973120.0,37786019.0,3817,5524,6805.0,6840.0,9341,63759139.0,419,122,224,24771800.0,35644978.0,3643,5208,6800.0,6844.0,8851,60416778.0,346,2023-11-10 17:00:00
812,PHOR,237,231,26984959.0,46215599.0,3957,6749,6820.0,6848.0,10706,73200558.0,468,191,188,23909183.0,44484159.0,3516,6488,6800.0,6856.0,10004,68393342.0,379,2023-11-10 17:05:00
813,PHOR,118,181,15259917.0,28230571.0,2242,4124,6806.0,6845.0,6366,43490488.0,299,92,145,15928558.0,28081747.0,2343,4099,6798.0,6851.0,6442,44010305.0,237,2023-11-10 17:10:00
814,PHOR,135,181,11613215.0,18181127.0,1706,2651,6807.0,6858.0,4357,29794342.0,316,102,138,9080526.0,14920418.0,1335,2172,6802.0,6869.0,3507,24000944.0,240,2023-11-10 17:15:00
815,PHOR,178,202,33438820.0,34691185.0,4909,5073,6812.0,6838.0,9982,68130005.0,380,142,157,27574594.0,32167539.0,4052,4702,6805.0,6841.0,8754,59742133.0,299,2023-11-10 17:20:00
816,PHOR,1047,1039,276767608.0,317684809.0,40546,46398,6826.0,6847.0,86944,594452417.0,2086,916,880,258334235.0,296223098.0,37960,43227,6805.0,6853.0,81187,554557333.0,1796,2023-11-10 17:25:00
817,PHOR,572,940,127414350.0,214444918.0,18711,31351,6810.0,6840.0,50062,341859268.0,1512,531,878,125245090.0,207493527.0,18410,30328,6803.0,6842.0,48738,332738617.0,1409,2023-11-10 17:30:00
818,PHOR,243,677,44816151.0,104117422.0,6590,15228,6801.0,6837.0,21818,148933573.0,920,203,603,42475209.0,101941093.0,6248,14899,6798.0,6842.0,21147,144416302.0,806,2023-11-10 17:35:00
819,PHOR,140,382,17851810.0,69248761.0,2621,10129,6811.0,6837.0,12750,87100571.0,522,110,336,16231753.0,68021683.0,2388,9939,6797.0,6844.0,12327,84253436.0,446,2023-11-10 17:40:00
820,PHOR,199,514,17755785.0,104762297.0,2609,15318,6806.0,6839.0,17927,122518082.0,713,167,475,18046084.0,103448567.0,2654,15134,6800.0,6836.0,17788,121494651.0,642,2023-11-10 17:45:00
821,PHOR,637,904,136835985.0,155068942.0,19860,22637,6890.0,6850.0,42497,291904927.0,1541,565,796,135582731.0,147168269.0,17142,21458,7909.0,6858.0,38600,282751000.0,1361,2023-11-10 17:50:00
822,PHOR,680,357,102005737.0,60574331.0,14963,8831,6817.0,6859.0,23794,162580068.0,1037,650,319,100035467.0,58475915.0,14678,8524,6815.0,6860.0,23202,158511382.0,969,2023-11-10 17:55:00
823,PHOR,479,380,70032358.0,67331511.0,10260,9821,6826.0,6856.0,20081,137363869.0,859,450,334,70821504.0,68607099.0,10387,10004,6818.0,6858.0,20391,139428603.0,784,2023-11-10 18:00:00
824,PHOR,347,282,44042381.0,34513460.0,6459,5039,6819.0,6849.0,11498,78555841.0,629,309,239,37536667.0,30921561.0,5504,4508,6820.0,6859.0,10012,68458228.0,548,2023-11-10 18:05:00
825,PHOR,350,192,58118500.0,24880678.0,6754,3632,8605.0,6850.0,10386,82999178.0,542,322,158,46565140.0,22566910.0,6829,3291,6819.0,6857.0,10120,69132050.0,480,2023-11-10 18:10:00
826,PHOR,405,385,59022204.0,64249196.0,8630,9377,6839.0,6852.0,18007,123271400.0,790,360,337,56916874.0,61728893.0,8348,9000,6818.0,6859.0,17348,118645767.0,697,2023-11-10 18:15:00
827,PHOR,381,335,59095445.0,48644351.0,8664,7092,6821.0,6859.0,15756,107739796.0,716,338,286,74092241.0,50511710.0,9111,7359,8132.0,6864.0,16470,124603951.0,624,2023-11-10 18:20:00
828,PHOR,304,340,51536114.0,72210125.0,7559,10548,6818.0,6846.0,18107,123746239.0,644,272,327,51160601.0,73433163.0,7506,10669,6816.0,6883.0,18175,124593764.0,599,2023-11-10 18:25:00
829,PHOR,253,308,24242635.0,54368598.0,3554,7956,6821.0,6834.0,11510,78611233.0,561,231,294,24491376.0,54548377.0,3591,7982,6820.0,6834.0,11573,79039753.0,525,2023-11-10 18:30:00
830,PHOR,228,112,31063589.0,23426698.0,4554,3419,6821.0,6852.0,7973,54490287.0,340,207,100,29094105.0,22530542.0,4269,3288,6815.0,6852.0,7557,51624647.0,307,2023-11-10 18:35:00
831,PHOR,84,77,10285066.0,7809133.0,1497,1145,6870.0,6820.0,2642,18094199.0,161,67,69,10793058.0,8958759.0,1583,1308,6818.0,6849.0,2891,19751817.0,136,2023-11-10 18:40:00
832,PHOR,1187,1754,261293612.0,329678972.0,34759,47282,7517.0,6973.0,82041,590972584.0,2941,1011,1530,219975648.0,304616031.0,31574,44300,6967.0,6876.0,75874,524591679.0,2541,2023-11-13 10:05:00
833,PHOR,560,853,91510269.0,113095472.0,13363,16437,6848.0,6881.0,29800,204605741.0,1413,475,736,87227790.0,108360535.0,12754,15730,6839.0,6889.0,28484,195588325.0,1211,2023-11-13 10:10:00
834,PHOR,445,432,62706474.0,58955152.0,9166,8557,6841.0,6890.0,17723,121661626.0,877,363,329,59081081.0,53255673.0,8638,7726,6840.0,6893.0,16364,112336754.0,692,2023-11-13 10:15:00
835,PHOR,301,413,30593219.0,38808474.0,4471,5640,6843.0,6881.0,10111,69401693.0,714,234,349,26635733.0,34927875.0,3894,5074,6840.0,6884.0,8968,61563608.0,583,2023-11-13 10:20:00
836,PHOR,545,586,84391493.0,110270633.0,12329,16011,6845.0,6887.0,28340,194662126.0,1131,485,525,81612410.0,121685786.0,11926,17670,6843.0,6887.0,29596,203298196.0,1010,2023-11-13 10:25:00
837,PHOR,915,1952,204938019.0,311447409.0,29857,45127,6864.0,6902.0,74984,516385428.0,2867,813,1849,198243877.0,305338431.0,28909,44258,6858.0,6899.0,73167,503582308.0,2662,2023-11-13 10:30:00
838,PHOR,544,509,103632926.0,88505347.0,14876,12810,6966.0,6909.0,27686,192138273.0,1053,454,398,98168085.0,82177228.0,14087,11885,6969.0,6914.0,25972,180345313.0,852,2023-11-13 10:35:00
839,PHOR,492,459,110239398.0,105017216.0,16057,15274,6866.0,6876.0,31331,215256614.0,951,434,391,105205608.0,95148992.0,15327,13771,6864.0,6909.0,29098,200354600.0,825,2023-11-13 10:40:00
840,PHOR,750,676,183249969.0,158043426.0,26625,22909,6883.0,6899.0,49534,341293395.0,1426,692,622,182917204.0,144020171.0,26379,20868,6934.0,6901.0,47247,326937375.0,1314,2023-11-13 10:45:00
841,PHOR,534,474,78689027.0,91584009.0,11487,13300,6850.0,6886.0,24787,170273036.0,1008,495,440,77115178.0,88243037.0,11253,12808,6853.0,6890.0,24061,165358215.0,935,2023-11-13 10:50:00
842,PHOR,408,301,52202073.0,60061931.0,7619,8729,6852.0,6881.0,16348,112264004.0,709,364,272,48707477.0,59362807.0,7103,8622,6857.0,6885.0,15725,108070284.0,636,2023-11-13 10:55:00
843,PHOR,423,198,48735507.0,38125244.0,7105,5530,6859.0,6894.0,12635,86860751.0,621,399,179,48092926.0,36148150.0,7014,5244,6857.0,6893.0,12258,84241076.0,578,2023-11-13 11:00:00
844,PHOR,357,271,62797540.0,48587765.0,9155,7039,6859.0,6903.0,16194,111385305.0,628,332,239,60504495.0,44158512.0,8830,6394,6852.0,6906.0,15224,104663007.0,571,2023-11-13 11:05:00
845,PHOR,711,571,180499753.0,125246573.0,26330,18227,6855.0,6871.0,44557,305746326.0,1282,668,524,178206610.0,123357797.0,26002,17889,6854.0,6896.0,43891,301564407.0,1192,2023-11-13 11:10:00
846,PHOR,823,852,136556064.0,150328358.0,19945,21847,6847.0,6881.0,41792,286884422.0,1675,795,817,135754591.0,147359350.0,19825,21398,6848.0,6887.0,41223,283113941.0,1612,2023-11-13 11:15:00
847,PHOR,414,406,83949054.0,93364959.0,12273,13577,6840.0,6877.0,25850,177314013.0,820,379,374,82544667.0,92408374.0,12066,13414,6841.0,6889.0,25480,174953041.0,753,2023-11-13 11:20:00
848,PHOR,435,581,82700979.0,114577635.0,12088,16690,6842.0,6865.0,28778,197278614.0,1016,385,535,78242423.0,117536433.0,11441,17089,6839.0,6878.0,28530,195778856.0,920,2023-11-13 11:25:00
849,PHOR,253,799,51906190.0,150853278.0,7587,21949,6841.0,6873.0,29536,202759468.0,1052,213,754,48971287.0,149990207.0,7158,21819,6841.0,6874.0,28977,198961494.0,967,2023-11-13 11:30:00
850,PHOR,420,552,96985062.0,142064858.0,14166,19975,6846.0,7112.0,34141,239049920.0,972,365,500,94400796.0,139787556.0,13804,19624,6839.0,7123.0,33428,234188352.0,865,2023-11-13 11:35:00
851,PHOR,370,631,75288354.0,134742606.0,11028,19594,6827.0,6877.0,30622,210030960.0,1001,311,574,68179816.0,129748969.0,9973,18863,6836.0,6878.0,28836,197928785.0,885,2023-11-13 11:40:00
852,PHOR,146,133,29484649.0,27838797.0,4311,4051,6839.0,6872.0,8362,57323446.0,279,118,94,27070738.0,26510681.0,3959,3853,6838.0,6881.0,7812,53581419.0,212,2023-11-13 11:45:00
853,PHOR,240,266,46660290.0,53194421.0,6823,7732,6839.0,6880.0,14555,99854711.0,506,196,223,45726318.0,51041845.0,6690,7417,6835.0,6882.0,14107,96768163.0,419,2023-11-13 11:50:00
854,PHOR,461,424,85896849.0,97024945.0,12574,14104,6831.0,6879.0,26678,182921794.0,885,358,386,80617946.0,95512851.0,11787,13876,6840.0,6883.0,25663,176130797.0,744,2023-11-13 11:55:00
855,PHOR,1022,688,256035377.0,169317689.0,37285,24539,6867.0,6900.0,61824,425353066.0,1710,954,629,246077923.0,157003411.0,35916,22757,6851.0,6899.0,58673,403081334.0,1583,2023-11-13 12:00:00
856,PHOR,587,678,129383644.0,143971178.0,18888,20913,6850.0,6884.0,39801,273354822.0,1265,513,626,127218876.0,142067021.0,18582,20633,6846.0,6885.0,39215,269285897.0,1139,2023-11-13 12:05:00
857,PHOR,397,637,87258629.0,116261261.0,12739,16898,6850.0,6880.0,29637,203519890.0,1034,327,567,85546981.0,114042721.0,12493,16572,6848.0,6882.0,29065,199589702.0,894,2023-11-13 12:10:00
858,PHOR,278,399,52063949.0,75181658.0,7613,10932,6839.0,6877.0,18545,127245607.0,677,245,356,51592628.0,72921329.0,7546,10597,6837.0,6881.0,18143,124513957.0,601,2023-11-13 12:15:00
859,PHOR,335,554,63376595.0,103685174.0,9261,15085,6843.0,6873.0,24346,167061769.0,889,280,504,62070231.0,102642750.0,9075,14924,6840.0,6878.0,23999,164712981.0,784,2023-11-13 12:20:00
860,PHOR,407,536,81339885.0,106562768.0,11879,15494,6847.0,6878.0,27373,187902653.0,943,302,475,79246538.0,105067298.0,11581,15272,6843.0,6880.0,26853,184313836.0,777,2023-11-13 12:25:00
861,PHOR,289,659,58202919.0,130198921.0,8502,18944,6846.0,6873.0,27446,188401840.0,948,243,596,56911159.0,133162195.0,8319,18705,6841.0,7119.0,27024,190073354.0,839,2023-11-13 12:30:00
862,PHOR,334,596,66728578.0,128565641.0,9754,18098,6841.0,7104.0,27852,195294219.0,930,235,530,65100630.0,122997420.0,9520,17890,6838.0,6875.0,27410,188098050.0,765,2023-11-13 12:35:00
863,PHOR,206,304,37682877.0,57120431.0,5507,8307,6843.0,6876.0,13814,94803308.0,510,167,263,36580911.0,55710826.0,5348,8098,6840.0,6880.0,13446,92291737.0,430,2023-11-13 12:40:00
864,PHOR,416,326,45458547.0,50538683.0,6639,7355,6847.0,6871.0,13994,95997230.0,742,367,265,45371291.0,47638813.0,6629,6924,6844.0,6880.0,13553,93010104.0,632,2023-11-13 12:45:00
865,PHOR,238,354,53412911.0,65593804.0,7822,9543,6829.0,6873.0,17365,119006715.0,592,215,318,51526530.0,61627665.0,7546,8956,6828.0,6881.0,16502,113154195.0,533,2023-11-13 12:50:00
866,PHOR,575,1117,158406509.0,229534562.0,23229,33479,6819.0,6856.0,56708,387941071.0,1692,498,1052,154952896.0,225944366.0,22722,32916,6820.0,6864.0,55638,380897262.0,1550,2023-11-13 12:55:00
867,PHOR,439,961,121295293.0,222967832.0,17789,32519,6819.0,6857.0,50308,344263125.0,1400,358,904,116039009.0,224088434.0,17021,32062,6817.0,6989.0,49083,340127443.0,1262,2023-11-13 13:00:00
868,PHOR,255,463,63979829.0,89084827.0,9368,12987,6830.0,6860.0,22355,153064656.0,718,210,402,62598918.0,86298218.0,9179,12575,6820.0,6863.0,21754,148897136.0,612,2023-11-13 13:05:00
869,PHOR,228,276,53975352.0,56281094.0,7911,8203,6823.0,6861.0,16114,110256446.0,504,147,230,51805509.0,53599651.0,7596,7804,6820.0,6868.0,15400,105405160.0,377,2023-11-13 13:10:00
870,PHOR,483,833,106686938.0,164609341.0,15623,24001,6829.0,6858.0,39624,271296279.0,1316,415,768,102899222.0,161413869.0,15093,23530,6818.0,6860.0,38623,264313091.0,1183,2023-11-13 13:15:00
871,PHOR,290,496,53801150.0,75355486.0,7890,10998,6819.0,6852.0,18888,129156636.0,786,247,443,54062282.0,73386460.0,7932,10706,6816.0,6855.0,18638,127448742.0,690,2023-11-13 13:20:00
872,PHOR,210,225,42823073.0,45352417.0,6278,6609,6821.0,6862.0,12887,88175490.0,435,161,176,41335001.0,43738060.0,6066,6370,6814.0,6866.0,12436,85073061.0,337,2023-11-13 13:25:00
873,PHOR,259,216,60826361.0,65505109.0,8943,9557,6802.0,6854.0,18500,126331470.0,475,186,184,54173123.0,64217610.0,7959,9366,6807.0,6856.0,17325,118390733.0,370,2023-11-13 13:30:00
874,PHOR,332,509,87882781.0,118078440.0,12907,17232,6809.0,6852.0,30139,205961221.0,841,282,451,86394685.0,115937118.0,12694,16912,6806.0,6855.0,29606,202331803.0,733,2023-11-13 13:35:00
875,PHOR,147,196,49529405.0,49693107.0,7260,7274,6822.0,6832.0,14534,99222512.0,343,112,139,42058319.0,46273104.0,6174,6743,6812.0,6862.0,12917,88331423.0,251,2023-11-13 13:40:00
876,PHOR,134,217,35971120.0,43392320.0,5260,6318,6839.0,6868.0,11578,79363440.0,351,99,166,33900578.0,38779499.0,4969,5648,6822.0,6866.0,10617,72680077.0,265,2023-11-13 13:45:00
877,PHOR,369,445,105463345.0,110422301.0,15446,16079,6828.0,6867.0,31525,215885646.0,814,300,355,102271501.0,106820307.0,14994,15550,6821.0,6869.0,30544,209091808.0,655,2023-11-13 13:50:00
878,PHOR,218,298,51037100.0,67102879.0,7484,9779,6819.0,6862.0,17263,118139979.0,516,171,247,50737092.0,64617729.0,7442,9421,6818.0,6859.0,16863,115354821.0,418,2023-11-13 13:55:00
879,PHOR,105,113,23384407.0,25548781.0,3429,3726,6820.0,6857.0,7155,48933188.0,218,89,102,24539164.0,26817654.0,3600,3909,6816.0,6860.0,7509,51356818.0,191,2023-11-13 14:00:00
880,PHOR,385,628,101391466.0,133499805.0,14902,19504,6804.0,6845.0,34406,234891271.0,1013,352,582,101066579.0,130524960.0,14855,19039,6804.0,6856.0,33894,231591539.0,934,2023-11-13 14:05:00
881,PHOR,571,515,135676592.0,135610411.0,19895,19773,6820.0,6858.0,39668,271287003.0,1086,501,444,130356777.0,131242210.0,19146,19135,6809.0,6859.0,38281,261598987.0,945,2023-11-13 14:10:00
882,PHOR,237,240,59134215.0,58051353.0,8684,8471,6810.0,6853.0,17155,117185568.0,477,198,203,57540268.0,56450642.0,8452,8224,6808.0,6864.0,16676,113990910.0,401,2023-11-13 14:15:00
883,PHOR,334,479,84630436.0,104480683.0,12426,15249,6811.0,6852.0,27675,189111119.0,813,269,436,82524776.0,103161132.0,12123,15052,6807.0,6854.0,27175,185685908.0,705,2023-11-13 14:20:00
884,PHOR,271,340,63387520.0,75121855.0,9298,10958,6817.0,6855.0,20256,138509375.0,611,211,288,60068653.0,74089845.0,8813,10806,6816.0,6856.0,19619,134158498.0,499,2023-11-13 14:25:00
885,PHOR,927,506,227196112.0,157031513.0,33272,22860,6828.0,6869.0,56132,384227625.0,1433,846,417,225665935.0,151754427.0,33055,22094,6827.0,6869.0,55149,377420362.0,1263,2023-11-13 14:30:00
886,PHOR,710,364,159898066.0,85077285.0,23415,12401,6829.0,6861.0,35816,244975351.0,1074,650,301,157115105.0,82731481.0,23008,12051,6829.0,6865.0,35059,239846586.0,951,2023-11-13 14:35:00
887,PHOR,303,265,67549113.0,72449875.0,9895,10570,6827.0,6854.0,20465,139998988.0,568,234,191,65001400.0,68165663.0,9526,9925,6824.0,6868.0,19451,133167063.0,425,2023-11-13 14:40:00
888,PHOR,344,306,80221209.0,85005742.0,11752,12408,6826.0,6851.0,24160,165226951.0,650,272,226,77566144.0,81561974.0,11366,11881,6824.0,6865.0,23247,159128118.0,498,2023-11-13 14:45:00
889,PHOR,321,194,79397631.0,55886489.0,11639,8148,6822.0,6859.0,19787,135284120.0,515,263,133,77832352.0,53507715.0,11411,7800,6821.0,6860.0,19211,131340067.0,396,2023-11-13 14:50:00
890,PHOR,226,171,46932092.0,38233953.0,6876,5576,6825.0,6857.0,12452,85166045.0,397,157,109,44604814.0,36461684.0,6537,5316,6823.0,6859.0,11853,81066498.0,266,2023-11-13 14:55:00
891,PHOR,253,251,61097904.0,59081564.0,8953,8611,6824.0,6861.0,17564,120179468.0,504,185,180,59197055.0,57213766.0,8676,8334,6823.0,6865.0,17010,116410821.0,365,2023-11-13 15:00:00
892,PHOR,248,236,48077213.0,43419396.0,7039,6322,6830.0,6868.0,13361,91496609.0,484,186,171,46161321.0,42141054.0,6763,6134,6826.0,6870.0,12897,88302375.0,357,2023-11-13 15:05:00
893,PHOR,317,289,59612399.0,56060183.0,8732,8166,6827.0,6865.0,16898,115672582.0,606,248,218,57451235.0,54162018.0,8421,7887,6822.0,6867.0,16308,111613253.0,466,2023-11-13 15:10:00
894,PHOR,382,305,75454218.0,62378499.0,11042,9090,6833.0,6862.0,20132,137832717.0,687,323,216,71813219.0,58722792.0,10518,8556,6828.0,6863.0,19074,130536011.0,539,2023-11-13 15:15:00
895,PHOR,435,226,89910261.0,41725604.0,13156,6084,6834.0,6858.0,19240,131635865.0,661,361,158,87929415.0,39866178.0,12871,5808,6832.0,6864.0,18679,127795593.0,519,2023-11-13 15:20:00
896,PHOR,285,211,54964205.0,47715323.0,8048,6955,6830.0,6861.0,15003,102679528.0,496,219,150,51914126.0,45965469.0,7603,6698,6828.0,6863.0,14301,97879595.0,369,2023-11-13 15:25:00
897,PHOR,457,302,68120205.0,62513018.0,9971,9110,6832.0,6862.0,19081,130633223.0,759,286,235,64360200.0,60506991.0,9426,8812,6828.0,6866.0,18238,124867191.0,521,2023-11-13 15:30:00
898,PHOR,257,244,63366346.0,49298365.0,9275,7182,6832.0,6864.0,16457,112664711.0,501,200,191,61777042.0,48622181.0,9051,7081,6825.0,6867.0,16132,110399223.0,391,2023-11-13 15:35:00
899,PHOR,403,278,77082843.0,67900972.0,11276,9884,6836.0,6870.0,21160,144983815.0,681,344,203,75071126.0,64628151.0,10984,9401,6835.0,6875.0,20385,139699277.0,547,2023-11-13 15:40:00
900,PHOR,380,295,67930978.0,62395486.0,9945,9095,6831.0,6860.0,19040,130326464.0,675,305,225,65497343.0,59870128.0,9591,8718,6829.0,6867.0,18309,125367471.0,530,2023-11-13 15:45:00
901,PHOR,534,376,123484151.0,98173909.0,18055,14285,6839.0,6873.0,32340,221658060.0,910,462,305,118919626.0,96121807.0,17415,13986,6829.0,6873.0,31401,215041433.0,767,2023-11-13 15:50:00
902,PHOR,803,410,174284372.0,89673083.0,25489,13035,6838.0,6879.0,38524,263957455.0,1213,729,344,173606469.0,87538430.0,25390,12722,6838.0,6881.0,38112,261144899.0,1073,2023-11-13 15:55:00
903,PHOR,894,489,205337558.0,121553140.0,30024,17666,6839.0,6881.0,47690,326890698.0,1383,813,398,201682788.0,114706772.0,29503,16660,6836.0,6885.0,46163,316389560.0,1211,2023-11-13 16:00:00
904,PHOR,303,191,62121315.0,37150421.0,9084,5400,6839.0,6880.0,14484,99271736.0,494,233,114,60477356.0,34661081.0,8847,5034,6836.0,6885.0,13881,95138437.0,347,2023-11-13 16:05:00
905,PHOR,199,205,49181575.0,38036146.0,7198,5528,6833.0,6881.0,12726,87217721.0,404,152,150,47252573.0,36200745.0,6918,5259,6830.0,6884.0,12177,83453318.0,302,2023-11-13 16:10:00
906,PHOR,244,199,57592389.0,46582976.0,8434,6764,6829.0,6887.0,15198,104175365.0,443,195,144,55965686.0,44296909.0,8197,6429,6828.0,6890.0,14626,100262595.0,339,2023-11-13 16:15:00
907,PHOR,260,207,55835720.0,43132033.0,8172,6273,6833.0,6876.0,14445,98967753.0,467,201,140,53807861.0,41020218.0,7880,5962,6828.0,6880.0,13842,94828079.0,341,2023-11-13 16:20:00
908,PHOR,218,155,42975756.0,39569632.0,6290,5752,6832.0,6879.0,12042,82545388.0,373,172,115,41215226.0,37967970.0,6034,5517,6830.0,6882.0,11551,79183196.0,287,2023-11-13 16:25:00
909,PHOR,262,244,57466092.0,54802628.0,8407,7969,6836.0,6877.0,16376,112268720.0,506,217,178,55223706.0,51844119.0,8084,7534,6831.0,6881.0,15618,107067825.0,395,2023-11-13 16:30:00
910,PHOR,341,273,66228597.0,59644306.0,9694,8683,6832.0,6869.0,18377,125872903.0,614,291,217,63246339.0,56922888.0,9261,8274,6829.0,6880.0,17535,120169227.0,508,2023-11-13 16:35:00
911,PHOR,259,235,48701945.0,40727758.0,7124,5925,6836.0,6874.0,13049,89429703.0,494,211,177,46984169.0,38806476.0,6874,5641,6835.0,6879.0,12515,85790645.0,388,2023-11-13 16:40:00
912,PHOR,193,215,38574974.0,35119825.0,5644,5109,6835.0,6874.0,10753,73694799.0,408,145,158,36821046.0,33389079.0,5388,4854,6834.0,6879.0,10242,70210125.0,303,2023-11-13 16:45:00
913,PHOR,347,259,67847789.0,59589699.0,9905,8668,6850.0,6875.0,18573,127437488.0,606,278,195,63816250.0,57335621.0,9340,8335,6833.0,6879.0,17675,121151871.0,473,2023-11-13 16:50:00
914,PHOR,343,239,63464240.0,51807746.0,9281,7528,6838.0,6882.0,16809,115271986.0,582,293,164,60647003.0,48667037.0,8877,7069,6832.0,6885.0,15946,109314040.0,457,2023-11-13 16:55:00
915,PHOR,285,218,54319095.0,42707636.0,7948,6216,6834.0,6871.0,14164,97026731.0,503,232,150,52640443.0,40354336.0,7705,5865,6832.0,6881.0,13570,92994779.0,382,2023-11-13 17:00:00
916,PHOR,281,205,57495271.0,51894784.0,8417,7544,6831.0,6879.0,15961,109390055.0,486,230,163,55013284.0,50033222.0,8056,7271,6829.0,6881.0,15327,105046506.0,393,2023-11-13 17:05:00
917,PHOR,152,111,18119714.0,18390925.0,2646,2677,6848.0,6870.0,5323,36510639.0,263,104,62,16698132.0,17659527.0,2443,2567,6835.0,6879.0,5010,34357659.0,166,2023-11-13 17:10:00
918,PHOR,171,131,25584646.0,28667924.0,3739,3339,6843.0,8586.0,7078,54252570.0,302,134,87,23751300.0,20487066.0,3475,2979,6835.0,6877.0,6454,44238366.0,221,2023-11-13 17:15:00
919,PHOR,223,155,46476901.0,41182665.0,6816,6012,6819.0,6850.0,12828,87659566.0,378,184,114,43546601.0,37849605.0,6387,5491,6818.0,6893.0,11878,81396206.0,298,2023-11-13 17:20:00
920,PHOR,291,390,54362352.0,57679206.0,7961,8396,6829.0,6870.0,16357,112041558.0,681,234,333,51299229.0,55893109.0,7518,8135,6824.0,6871.0,15653,107192338.0,567,2023-11-13 17:25:00
921,PHOR,157,203,26276000.0,26568160.0,3849,3858,6827.0,6887.0,7707,52844160.0,360,105,142,23688888.0,25468315.0,3472,3694,6823.0,6895.0,7166,49157203.0,247,2023-11-13 17:30:00
922,PHOR,205,207,28651873.0,26515844.0,4199,3848,6823.0,6891.0,8047,55167717.0,412,144,145,27511131.0,25304716.0,4034,3670,6820.0,6895.0,7704,52815847.0,289,2023-11-13 17:35:00
923,PHOR,197,150,18480419.0,17583289.0,2703,2558,6837.0,6874.0,5261,36063708.0,347,151,105,18509732.0,15846612.0,2708,2302,6835.0,6884.0,5010,34356344.0,256,2023-11-13 17:40:00
924,PHOR,165,128,21163099.0,14478994.0,3093,2109,6842.0,6865.0,5202,35642093.0,293,118,80,19916929.0,13853100.0,2914,2016,6835.0,6872.0,4930,33770029.0,198,2023-11-13 17:45:00
925,PHOR,232,152,26654332.0,22615054.0,3893,3293,6847.0,6868.0,7186,49269386.0,384,166,111,24292412.0,20993347.0,3554,3053,6835.0,6876.0,6607,45285759.0,277,2023-11-13 17:50:00
926,PHOR,230,230,21233029.0,18793311.0,3097,2734,6856.0,6874.0,5831,40026340.0,460,154,158,18841603.0,16308578.0,2754,2364,6842.0,6899.0,5118,35150181.0,312,2023-11-13 17:55:00
927,PHOR,207,200,35293146.0,30470990.0,5167,4415,6830.0,6902.0,9582,65764136.0,407,163,141,33161766.0,29170606.0,4859,4224,6825.0,6906.0,9083,62332372.0,304,2023-11-13 18:00:00
928,PHOR,182,186,32071377.0,30113747.0,4687,4377,6843.0,6880.0,9064,62185124.0,368,137,136,29785741.0,27051086.0,4361,3922,6830.0,6897.0,8283,56836827.0,273,2023-11-13 18:05:00
929,PHOR,206,182,33899270.0,26143074.0,4922,3801,6887.0,6878.0,8723,60042344.0,388,161,138,27795134.0,22792441.0,4064,3311,6839.0,6884.0,7375,50587575.0,299,2023-11-13 18:10:00
930,PHOR,180,285,32777978.0,39388502.0,4796,5729,6834.0,6875.0,10525,72166480.0,465,143,236,31486187.0,37705697.0,4608,5482,6833.0,6878.0,10090,69191884.0,379,2023-11-13 18:15:00
931,PHOR,236,320,46919159.0,45557728.0,6864,6622,6836.0,6880.0,13486,92476887.0,556,175,274,42552988.0,44103710.0,6231,6409,6829.0,6882.0,12640,86656698.0,449,2023-11-13 18:20:00
932,PHOR,74,153,6819898.0,11826115.0,996,1724,6847.0,6860.0,2720,18646013.0,227,47,135,5459647.0,11014071.0,798,1605,6842.0,6862.0,2403,16473718.0,182,2023-11-13 18:25:00
933,PHOR,63,183,7002335.0,11986395.0,1018,1743,6879.0,6877.0,2761,18988730.0,246,35,171,6660179.0,11924342.0,975,1734,6831.0,6877.0,2709,18584521.0,206,2023-11-13 18:30:00
934,PHOR,53,107,11875801.0,12133116.0,1734,1767,6849.0,6867.0,3501,24008917.0,160,48,101,11576570.0,11203002.0,1696,1630,6826.0,6873.0,3326,22779572.0,149,2023-11-13 18:35:00
935,PHOR,32,41,7288424.0,5429349.0,1059,789,6882.0,6881.0,1848,12717773.0,73,29,41,12610107.0,12658228.0,1849,1837,6820.0,6891.0,3686,25268335.0,70,2023-11-13 18:40:00
936,PHOR,373,993,107389095.0,207412009.0,14140,30450,7595.0,6812.0,44590,314801104.0,1366,218,858,67634849.0,184587049.0,9976,27040,6780.0,6826.0,37016,252221898.0,1076,2023-11-14 10:05:00
937,PHOR,1098,1386,207663434.0,297717923.0,30730,43876,6758.0,6785.0,74606,505381357.0,2484,862,1243,198284041.0,286761987.0,29343,42169,6757.0,6800.0,71512,485046028.0,2105,2023-11-14 10:10:00
938,PHOR,1087,1540,239453570.0,332935232.0,35071,49027,6828.0,6791.0,84098,572388802.0,2627,868,1448,226810249.0,322000250.0,33586,47405,6753.0,6793.0,80991,548810499.0,2316,2023-11-14 10:15:00
939,PHOR,793,1599,160007855.0,344739704.0,23688,50754,6755.0,6792.0,74442,504747559.0,2392,624,1501,159864511.0,337363559.0,23686,49656,6749.0,6794.0,73342,497228070.0,2125,2023-11-14 10:20:00
940,PHOR,657,533,126075509.0,147329075.0,18693,21732,6745.0,6779.0,40425,273404584.0,1190,427,441,115268294.0,132128507.0,17103,19481,6740.0,6782.0,36584,247396801.0,868,2023-11-14 10:25:00
941,PHOR,747,637,168754067.0,151255038.0,24999,22296,6750.0,6784.0,47295,320009105.0,1384,599,574,155925050.0,144331695.0,23113,21267,6746.0,6787.0,44380,300256745.0,1173,2023-11-14 10:30:00
942,PHOR,418,701,87988128.0,122902730.0,13007,18081,6765.0,6797.0,31088,210890858.0,1119,329,632,82141548.0,121119975.0,12163,17802,6753.0,6804.0,29965,203261523.0,961,2023-11-14 10:35:00
943,PHOR,388,730,94801959.0,141020451.0,14031,20756,6757.0,6794.0,34787,235822410.0,1118,329,685,93560216.0,131916175.0,13844,19413,6758.0,6795.0,33257,225476391.0,1014,2023-11-14 10:40:00
944,PHOR,469,480,100771597.0,108682757.0,14456,16012,6971.0,6788.0,30468,209454354.0,949,381,452,97266414.0,111029849.0,14040,16349,6928.0,6791.0,30389,208296263.0,833,2023-11-14 10:45:00
945,PHOR,595,805,142083001.0,185200269.0,21005,26611,6764.0,6960.0,47616,327283270.0,1400,479,760,133797863.0,178530770.0,19824,25845,6749.0,6908.0,45669,312328633.0,1239,2023-11-14 10:50:00
946,PHOR,696,478,166819622.0,111583160.0,24658,16408,6765.0,6801.0,41066,278402782.0,1174,633,446,165389172.0,109547373.0,24460,16107,6762.0,6801.0,40567,274936545.0,1079,2023-11-14 10:55:00
947,PHOR,707,741,208748019.0,213725764.0,30893,31421,6757.0,6802.0,62314,422473783.0,1448,634,708,204319855.0,210657023.0,30252,30951,6754.0,6806.0,61203,414976878.0,1342,2023-11-14 11:00:00
948,PHOR,520,744,170415032.0,195530576.0,25220,28734,6757.0,6805.0,53954,365945608.0,1264,473,677,167624576.0,193261309.0,24814,28398,6755.0,6805.0,53212,360885885.0,1150,2023-11-14 11:05:00
949,PHOR,1312,718,315069152.0,193274302.0,46513,28336,6774.0,6821.0,74849,508343454.0,2030,1257,674,311065852.0,189494751.0,45920,27788,6774.0,6819.0,73708,500560603.0,1931,2023-11-14 11:10:00
950,PHOR,704,446,160018911.0,107557288.0,23585,15776,6785.0,6818.0,39361,267576199.0,1150,670,403,157226609.0,106569917.0,23193,15628,6779.0,6819.0,38821,263796526.0,1073,2023-11-14 11:15:00
951,PHOR,360,454,86220785.0,91172485.0,12720,13371,6778.0,6819.0,26091,177393270.0,814,333,424,83990103.0,89715855.0,12394,13153,6777.0,6821.0,25547,173705958.0,757,2023-11-14 11:20:00
952,PHOR,201,384,54078630.0,78896205.0,7968,11579,6787.0,6814.0,19547,132974835.0,585,154,350,52315740.0,77064926.0,7713,11295,6783.0,6823.0,19008,129380666.0,504,2023-11-14 11:25:00
953,PHOR,284,503,77094481.0,114999828.0,11355,16850,6789.0,6825.0,28205,192094309.0,787,219,464,71437810.0,113073634.0,10526,16559,6787.0,6829.0,27085,184511444.0,683,2023-11-14 11:30:00
954,PHOR,419,803,124363462.0,170556325.0,18284,24936,6802.0,6840.0,43220,294919787.0,1222,354,743,118283672.0,166749985.0,17413,24385,6793.0,6838.0,41798,285033657.0,1097,2023-11-14 11:35:00
955,PHOR,330,467,95152046.0,103409765.0,13972,15110,6810.0,6844.0,29082,198561811.0,797,269,389,94338993.0,101379449.0,13859,14807,6807.0,6847.0,28666,195718442.0,658,2023-11-14 11:40:00
956,PHOR,311,412,84493338.0,91113472.0,12410,13325,6808.0,6838.0,25735,175606810.0,723,244,347,82792807.0,87733148.0,12163,12814,6807.0,6847.0,24977,170525955.0,591,2023-11-14 11:45:00
957,PHOR,297,339,74004089.0,84003292.0,10860,12266,6814.0,6848.0,23126,158007381.0,636,221,295,69541933.0,81264386.0,10217,11867,6806.0,6848.0,22084,150806319.0,516,2023-11-14 11:50:00
958,PHOR,365,207,81308888.0,58304946.0,11937,8506,6812.0,6855.0,20443,139613834.0,572,303,176,74795561.0,57208165.0,10977,8341,6814.0,6859.0,19318,132003726.0,479,2023-11-14 11:55:00
959,PHOR,400,279,84655694.0,85049776.0,12409,12413,6822.0,6852.0,24822,169705470.0,679,320,241,82110885.0,82743168.0,12043,12066,6818.0,6858.0,24109,164854053.0,561,2023-11-14 12:00:00
960,PHOR,339,295,79582914.0,80993547.0,11673,11811,6818.0,6857.0,23484,160576461.0,634,282,263,71186388.0,74837206.0,10442,10913,6817.0,6858.0,21355,146023594.0,545,2023-11-14 12:05:00
961,PHOR,1008,642,273113026.0,216396626.0,39800,31428,6862.0,6885.0,71228,489509652.0,1650,921,532,269646935.0,195870129.0,39504,28434,6826.0,6889.0,67938,465517064.0,1453,2023-11-14 12:10:00
962,PHOR,537,518,156830067.0,150816489.0,22939,21977,6837.0,6862.0,44916,307646556.0,1055,467,448,150759259.0,141740424.0,22072,20606,6830.0,6879.0,42678,292499683.0,915,2023-11-14 12:15:00
963,PHOR,501,408,161926635.0,141928211.0,23629,20632,6853.0,6879.0,44261,303854846.0,909,425,329,148848570.0,136521433.0,21767,19823,6838.0,6887.0,41590,285370003.0,754,2023-11-14 12:20:00
964,PHOR,227,179,61510181.0,61162408.0,8980,8885,6850.0,6884.0,17865,122672589.0,406,178,117,58599903.0,57877747.0,8559,8400,6847.0,6890.0,16959,116477650.0,295,2023-11-14 12:25:00
965,PHOR,296,233,78411543.0,84509310.0,11467,12285,6838.0,6879.0,23752,162920853.0,529,244,170,76404089.0,71860027.0,11174,10440,6838.0,6883.0,21614,148264116.0,414,2023-11-14 12:30:00
966,PHOR,260,216,64510432.0,57476181.0,9443,8360,6832.0,6875.0,17803,121986613.0,476,224,176,63501397.0,54136501.0,9292,7869,6834.0,6880.0,17161,117637898.0,400,2023-11-14 12:35:00
967,PHOR,228,164,54130564.0,46582886.0,7911,6779,6842.0,6872.0,14690,100713450.0,392,152,125,50258138.0,45388938.0,7354,6603,6834.0,6874.0,13957,95647076.0,277,2023-11-14 12:40:00
968,PHOR,262,193,70399206.0,63082667.0,10284,9169,6846.0,6880.0,19453,133481873.0,455,205,172,64764660.0,63412296.0,9476,9217,6835.0,6880.0,18693,128176956.0,377,2023-11-14 12:45:00
969,PHOR,169,170,42542267.0,49203087.0,6209,7124,6852.0,6907.0,13333,91745354.0,339,127,129,40879991.0,43615461.0,5977,6336,6840.0,6884.0,12313,84495452.0,256,2023-11-14 12:50:00
970,PHOR,211,144,49596189.0,41883353.0,7239,6083,6851.0,6885.0,13322,91479542.0,355,173,119,47484158.0,40342113.0,6937,5858,6845.0,6887.0,12795,87826271.0,292,2023-11-14 12:55:00
971,PHOR,247,210,65333792.0,57888609.0,9531,8397,6855.0,6894.0,17928,123222401.0,457,194,150,64619350.0,54578080.0,9444,7916,6842.0,6895.0,17360,119197430.0,344,2023-11-14 13:00:00
972,PHOR,393,245,106967722.0,89811676.0,15639,13071,6840.0,6871.0,28710,196779398.0,638,338,187,104028201.0,83539099.0,15209,12126,6840.0,6889.0,27335,187567300.0,525,2023-11-14 13:05:00
973,PHOR,362,346,88325838.0,99055867.0,12923,14431,6835.0,6864.0,27354,187381705.0,708,303,279,85091908.0,95877263.0,12452,13934,6834.0,6881.0,26386,180969171.0,582,2023-11-14 13:10:00
974,PHOR,244,169,52614138.0,51115661.0,7700,7445,6833.0,6866.0,15145,103729799.0,413,165,140,48109175.0,47853746.0,7039,6959,6835.0,6877.0,13998,95962921.0,305,2023-11-14 13:15:00
975,PHOR,316,181,74883519.0,60914989.0,10955,8900,6836.0,6844.0,19855,135798508.0,497,259,147,71028235.0,57643646.0,10400,8381,6830.0,6878.0,18781,128671881.0,406,2023-11-14 13:20:00
976,PHOR,203,161,54434498.0,57167203.0,7969,8312,6831.0,6878.0,16281,111601701.0,364,165,133,52669475.0,55188726.0,7717,8022,6825.0,6880.0,15739,107858201.0,298,2023-11-14 13:25:00
977,PHOR,220,184,61627162.0,56097979.0,9013,8152,6838.0,6881.0,17165,117725141.0,404,176,187,60304277.0,55346886.0,8836,8042,6825.0,6882.0,16878,115651163.0,363,2023-11-14 13:30:00
978,PHOR,254,220,56803341.0,54003916.0,8306,7854,6839.0,6876.0,16160,110807257.0,474,196,187,54868807.0,51780869.0,8026,7518,6836.0,6888.0,15544,106649676.0,383,2023-11-14 13:35:00
979,PHOR,183,173,44022381.0,38315398.0,6437,5569,6839.0,6880.0,12006,82337779.0,356,142,133,42555705.0,36953538.0,6224,5366,6837.0,6887.0,11590,79509243.0,275,2023-11-14 13:40:00
980,PHOR,138,120,27808679.0,21820987.0,4065,3174,6841.0,6875.0,7239,49629666.0,258,104,108,27650141.0,20922840.0,4044,3041,6837.0,6880.0,7085,48572981.0,212,2023-11-14 13:45:00
981,PHOR,204,172,41709415.0,32683912.0,6097,4746,6841.0,6887.0,10843,74393327.0,376,169,145,40178384.0,31693774.0,5875,4600,6839.0,6890.0,10475,71872158.0,314,2023-11-14 13:50:00
982,PHOR,539,444,135371963.0,59796529.0,19856,8697,6818.0,6876.0,28553,195168492.0,983,489,400,135320824.0,59069770.0,19862,8588,6813.0,6878.0,28450,194390594.0,889,2023-11-14 13:55:00
983,PHOR,308,240,70522146.0,47637654.0,10299,6932,6847.0,6872.0,17231,118159800.0,548,252,210,71123280.0,47884859.0,10392,6964,6844.0,6876.0,17356,119008139.0,462,2023-11-14 14:00:00
984,PHOR,180,255,43003311.0,54955153.0,6286,7980,6841.0,6887.0,14266,97958464.0,435,141,219,42574481.0,51136971.0,6226,7428,6838.0,6884.0,13654,93711452.0,360,2023-11-14 14:05:00
985,PHOR,402,428,104789062.0,93022812.0,15310,13518,6844.0,6881.0,28828,197811874.0,830,338,375,99158842.0,89784823.0,14496,13043,6840.0,6884.0,27539,188943665.0,713,2023-11-14 14:10:00
986,PHOR,381,311,104270607.0,88416291.0,15244,12867,6840.0,6872.0,28111,192686898.0,692,323,251,102056480.0,81367887.0,14922,11823,6839.0,6882.0,26745,183424367.0,574,2023-11-14 14:15:00
987,PHOR,347,264,89060109.0,86698876.0,13021,12620,6840.0,6870.0,25641,175758985.0,611,272,216,85314973.0,84033510.0,12477,12215,6838.0,6880.0,24692,169348483.0,488,2023-11-14 14:20:00
988,PHOR,394,537,129680856.0,167156004.0,18984,24322,6831.0,6873.0,43306,296836860.0,931,339,445,127206763.0,162323372.0,18624,23597,6830.0,6879.0,42221,289530135.0,784,2023-11-14 14:25:00
989,PHOR,757,1196,222210921.0,317784521.0,32601,46391,6816.0,6850.0,78992,539995442.0,1953,645,1089,215793502.0,309481377.0,31654,45116,6817.0,6860.0,76770,525274879.0,1734,2023-11-14 14:30:00
990,PHOR,793,816,223129517.0,231617713.0,32691,33768,6825.0,6859.0,66459,454747230.0,1609,700,745,212403624.0,230513903.0,31140,33594,6821.0,6862.0,64734,442917527.0,1445,2023-11-14 14:35:00
991,PHOR,469,500,144422739.0,144706554.0,21128,21100,6836.0,6858.0,42228,289129293.0,969,417,411,137115433.0,126684347.0,20069,18423,6832.0,6876.0,38492,263799780.0,828,2023-11-14 14:40:00
992,PHOR,366,496,83620833.0,98387679.0,12249,14337,6827.0,6863.0,26586,182008512.0,862,323,441,82270575.0,94898152.0,12055,13825,6825.0,6864.0,25880,177168727.0,764,2023-11-14 14:45:00
993,PHOR,347,360,90021703.0,82170407.0,13170,11949,6835.0,6877.0,25119,172192110.0,707,286,315,85518649.0,79420115.0,12520,11549,6831.0,6877.0,24069,164938764.0,601,2023-11-14 14:50:00
994,PHOR,345,183,52968788.0,30165985.0,7752,4367,6833.0,6908.0,12119,83134773.0,528,305,162,50253181.0,30256065.0,7358,4378,6830.0,6911.0,11736,80509246.0,467,2023-11-14 14:55:00
995,PHOR,237,202,46721919.0,32996932.0,6829,4800,6842.0,6874.0,11629,79718851.0,439,188,152,45067757.0,31120987.0,6589,4519,6840.0,6887.0,11108,76188744.0,340,2023-11-14 15:00:00
996,PHOR,349,306,79457145.0,66058635.0,11631,9610,6831.0,6874.0,21241,145515780.0,655,303,268,73022257.0,64722801.0,10689,9402,6832.0,6884.0,20091,137745058.0,571,2023-11-14 15:05:00
997,PHOR,260,191,71501195.0,51204140.0,10454,7463,6840.0,6861.0,17917,122705335.0,451,217,150,68613773.0,47507262.0,10035,6912,6837.0,6873.0,16947,116121035.0,367,2023-11-14 15:10:00
998,PHOR,427,302,84654903.0,78792743.0,12388,11472,6834.0,6868.0,23860,163447646.0,729,370,250,84157259.0,75994509.0,12318,11057,6832.0,6873.0,23375,160151768.0,620,2023-11-14 15:15:00
999,PHOR,489,418,135208196.0,131976161.0,19806,19281,6827.0,6845.0,39087,267184357.0,907,421,362,130311285.0,124031202.0,19092,18050,6825.0,6872.0,37142,254342487.0,783,2023-11-14 15:20:00
1000,PHOR,266,204,57314820.0,48201512.0,8395,7025,6827.0,6861.0,15420,105516332.0,470,208,166,56116013.0,47362689.0,8222,6896,6825.0,6868.0,15118,103478702.0,374,2023-11-14 15:25:00
1001,PHOR,339,193,66068968.0,31700732.0,9659,4612,6840.0,6874.0,14271,97769700.0,532,297,169,63769144.0,30154458.0,9327,4382,6837.0,6881.0,13709,93923602.0,466,2023-11-14 15:30:00
1002,PHOR,1059,265,224489054.0,61286492.0,32821,8911,6840.0,6878.0,41732,285775546.0,1324,1014,240,223451658.0,60692703.0,32671,8824,6839.0,6878.0,41495,284144361.0,1254,2023-11-14 15:35:00
1003,PHOR,945,125,178326420.0,34446827.0,26055,5010,6844.0,6876.0,31065,212773247.0,1070,893,95,176478220.0,33890686.0,25787,4928,6844.0,6877.0,30715,210368906.0,988,2023-11-14 15:40:00
1004,PHOR,475,128,86794978.0,22248520.0,12665,3233,6853.0,6882.0,15898,109043498.0,603,425,102,83364627.0,21265029.0,12181,3087,6844.0,6889.0,15268,104629656.0,527,2023-11-14 15:45:00
1005,PHOR,245,98,55194870.0,25863784.0,8059,3758,6849.0,6882.0,11817,81058654.0,343,211,74,53686990.0,24567156.0,7847,3567,6842.0,6887.0,11414,78254146.0,285,2023-11-14 15:50:00
1006,PHOR,181,123,48031589.0,32219139.0,7016,4684,6846.0,6879.0,11700,80250728.0,304,148,100,44288251.0,31872870.0,6475,4633,6840.0,6880.0,11108,76161121.0,248,2023-11-14 15:55:00
1007,PHOR,270,126,45572172.0,30816662.0,6650,4493,6853.0,6859.0,11143,76388834.0,396,226,107,42721130.0,28626113.0,6246,4167,6840.0,6870.0,10413,71347243.0,333,2023-11-14 16:00:00
1008,PHOR,435,288,97208747.0,67103819.0,14159,9753,6866.0,6880.0,23912,164312566.0,723,381,231,91950016.0,64750660.0,13437,9411,6843.0,6880.0,22848,156700676.0,612,2023-11-14 16:05:00
1009,PHOR,382,253,78546138.0,62481811.0,11472,9098,6847.0,6868.0,20570,141027949.0,635,318,209,78098035.0,60036334.0,11408,8733,6846.0,6875.0,20141,138134369.0,527,2023-11-14 16:10:00
1010,PHOR,186,101,43328765.0,23633133.0,6326,3436,6849.0,6878.0,9762,66961898.0,287,148,64,42337854.0,21243752.0,6184,3087,6846.0,6882.0,9271,63581606.0,212,2023-11-14 16:15:00
1011,PHOR,236,167,56517008.0,57213623.0,8248,8311,6852.0,6884.0,16559,113730631.0,403,187,145,50441232.0,51890262.0,7364,7536,6850.0,6886.0,14900,102331494.0,332,2023-11-14 16:20:00
1012,PHOR,287,259,74685357.0,79186487.0,10907,11548,6847.0,6857.0,22455,153871844.0,546,234,226,71383385.0,74523103.0,10434,10830,6841.0,6881.0,21264,145906488.0,460,2023-11-14 16:25:00
1013,PHOR,311,231,82789123.0,65761381.0,12107,9563,6838.0,6877.0,21670,148550504.0,542,268,194,81510919.0,64770429.0,11923,9416,6836.0,6879.0,21339,146281348.0,462,2023-11-14 16:30:00
1014,PHOR,167,126,35774820.0,32211955.0,5221,4679,6852.0,6884.0,9900,67986775.0,293,132,93,35243254.0,31609635.0,5148,4591,6846.0,6885.0,9739,66852889.0,225,2023-11-14 16:35:00
1015,PHOR,154,84,28687279.0,21317051.0,4180,3099,6863.0,6879.0,7279,50004330.0,238,108,68,26912860.0,20720103.0,3928,3011,6852.0,6881.0,6939,47632963.0,176,2023-11-14 16:40:00
1016,PHOR,159,145,46427809.0,43906313.0,6728,6381,6901.0,6881.0,13109,90334122.0,304,120,95,39896748.0,38475541.0,5822,5587,6853.0,6887.0,11409,78372289.0,215,2023-11-14 16:45:00
1017,PHOR,118,75,25862918.0,22921871.0,3770,3328,6860.0,6888.0,7098,48784789.0,193,74,63,23382245.0,22510993.0,3417,3267,6843.0,6890.0,6684,45893238.0,137,2023-11-14 16:50:00
1018,PHOR,139,112,36040940.0,31495446.0,5252,4578,6862.0,6880.0,9830,67536386.0,251,112,81,35069651.0,28616078.0,5119,4157,6851.0,6884.0,9276,63685729.0,193,2023-11-14 16:55:00
1019,PHOR,286,168,59365457.0,47310848.0,8670,6876,6847.0,6881.0,15546,106676305.0,454,252,138,57510481.0,45556093.0,8402,6612,6845.0,6890.0,15014,103066574.0,390,2023-11-14 17:00:00
1020,PHOR,437,260,108173904.0,78538587.0,15770,11406,6859.0,6886.0,27176,186712491.0,697,386,216,103921435.0,77452540.0,15185,11241,6844.0,6890.0,26426,181373975.0,602,2023-11-14 17:05:00
1021,PHOR,129,92,30208318.0,17979040.0,4397,2613,6870.0,6881.0,7010,48187358.0,221,88,68,28122387.0,20944354.0,4111,3038,6841.0,6894.0,7149,49066741.0,156,2023-11-14 17:10:00
1022,PHOR,371,160,80463697.0,27241511.0,11738,3959,6855.0,6881.0,15697,107705208.0,531,319,133,78545491.0,27171967.0,11466,3940,6850.0,6896.0,15406,105717458.0,452,2023-11-14 17:15:00
1023,PHOR,1020,283,194653783.0,46958394.0,28390,6822,6856.0,6883.0,35212,241612177.0,1303,963,241,193034132.0,43732834.0,28160,6345,6855.0,6892.0,34505,236766966.0,1204,2023-11-14 17:20:00
1024,PHOR,854,226,155906468.0,31134719.0,22745,4527,6855.0,6878.0,27272,187041187.0,1080,814,197,153778808.0,32573406.0,22437,4728,6854.0,6889.0,27165,186352214.0,1011,2023-11-14 17:25:00
1025,PHOR,513,291,101664529.0,59276917.0,14786,8599,6876.0,6893.0,23385,160941446.0,804,443,223,94893599.0,51627053.0,13849,7486,6852.0,6896.0,21335,146520652.0,666,2023-11-14 17:30:00
1026,PHOR,602,196,110531392.0,33236492.0,16101,4408,6865.0,7540.0,20509,143767884.0,798,557,160,109254133.0,27838571.0,15923,4038,6861.0,6894.0,19961,137092704.0,717,2023-11-14 17:35:00
1027,PHOR,572,852,132587401.0,186778443.0,19362,27259,6848.0,6852.0,46621,319365844.0,1424,485,736,122170114.0,176167365.0,17864,25622,6839.0,6876.0,43486,298337479.0,1221,2023-11-14 17:40:00
1028,PHOR,204,229,31198370.0,36663288.0,4184,5005,7457.0,7325.0,9189,67861658.0,433,161,211,32792331.0,41453934.0,4796,5596,6837.0,7408.0,10392,74246265.0,372,2023-11-14 17:45:00
1029,PHOR,418,344,65444759.0,67997951.0,9539,9881,6861.0,6882.0,19420,133442710.0,762,377,292,62500897.0,65566087.0,9121,9518,6852.0,6889.0,18639,128066984.0,669,2023-11-14 17:50:00
1030,PHOR,426,514,65105391.0,83994571.0,9502,12214,6852.0,6877.0,21716,149099962.0,940,386,435,63220504.0,79185932.0,9230,11502,6849.0,6885.0,20732,142406436.0,821,2023-11-14 17:55:00
1031,PHOR,579,252,114604455.0,27267457.0,16712,3957,6858.0,6891.0,20669,141871912.0,831,539,226,106617796.0,26471378.0,15550,3839,6856.0,6895.0,19389,133089174.0,765,2023-11-14 18:00:00
1032,PHOR,339,282,72457256.0,60994388.0,10565,8858,6858.0,6886.0,19423,133451644.0,621,284,241,65835778.0,54479041.0,9600,7912,6858.0,6886.0,17512,120314819.0,525,2023-11-14 18:05:00
1033,PHOR,223,213,36970126.0,36627752.0,5385,5345,6865.0,6853.0,10730,73597878.0,436,163,126,34623026.0,33534800.0,5048,4871,6859.0,6885.0,9919,68157826.0,289,2023-11-14 18:10:00
1034,PHOR,155,134,26591742.0,20122882.0,3869,2926,6873.0,6877.0,6795,46714624.0,289,120,94,27883081.0,19343386.0,3693,2809,7550.0,6886.0,6502,47226467.0,214,2023-11-14 18:15:00
1035,PHOR,201,259,40156817.0,55121252.0,5854,8032,6860.0,6863.0,13886,95278069.0,460,149,190,37864773.0,50886780.0,5521,7390,6858.0,6886.0,12911,88751553.0,339,2023-11-14 18:20:00
1036,PHOR,74,148,16600921.0,30092202.0,2410,4372,6888.0,6883.0,6782,46693123.0,222,67,155,14902567.0,30881900.0,2174,4476,6855.0,6899.0,6650,45784467.0,222,2023-11-14 18:25:00
1037,PHOR,31,148,5242994.0,31025783.0,764,4524,6863.0,6858.0,5288,36268777.0,179,32,114,6992107.0,30129166.0,1021,4381,6848.0,6877.0,5402,37121273.0,146,2023-11-14 18:30:00
1038,PHOR,144,193,33314156.0,50971090.0,4856,7404,6860.0,6884.0,12260,84285246.0,337,124,168,29315956.0,49694956.0,4293,7210,6829.0,6893.0,11503,79010912.0,292,2023-11-14 18:35:00
1039,PHOR,10816,1638,2151902740.0,183402732.0,313768,26681,6858.0,6874.0,340449,2335305472.0,12454,10804,1630,2144437255.0,184064136.0,312682,26770,6858.0,6876.0,339452,2328501391.0,12434,2023-11-14 18:40:00
1040,PHOR,505,846,123791455.0,123791455.0,18266,29589,6777.2,6822.9,47855,325675533.0,1351,383,683,113748795.0,113748795.0,16762,27121,6786.1,6837.0,43883,299176305.0,1066,2023-11-29 10:05:00
1041,PHOR,1760,1940,561727262.0,561727262.0,82535,92608,6805.9,6829.7,175143,1194215083.0,3700,1704,1853,557356762.0,557356762.0,81878,91382,6807.2,6842.2,173260,1182608964.0,3557,2023-11-29 10:10:00
1042,PHOR,133,211,16506985.0,16506985.0,2443,4076,6756.9,6812.9,6519,44276215.0,344,90,187,13165276.0,13165276.0,1936,3786,6800.2,6825.1,5722,39004926.0,277,2023-11-29 10:15:00
1043,PHOR,504,1088,117613222.0,117613222.0,17347,31205,6780.0,6708.2,48552,326941875.0,1592,443,1048,113773249.0,113773249.0,16771,30353,6783.9,6824.6,47124,320920841.0,1491,2023-11-29 10:20:00
1044,PHOR,421,1097,82259285.0,82259285.0,12137,25702,6777.6,6818.0,37839,257494346.0,1518,384,1078,79478941.0,79478941.0,11715,25478,6784.4,6818.2,37193,253193094.0,1462,2023-11-29 10:25:00
1045,PHOR,411,717,76326911.0,76326911.0,11357,20233,6720.7,6819.3,31590,214301663.0,1128,364,687,75544460.0,75544460.0,11128,19215,6788.7,6824.3,30343,206672671.0,1051,2023-11-29 10:30:00
1046,PHOR,325,359,57042536.0,57042536.0,8422,13412,6773.0,6826.6,21834,148600649.0,684,279,339,55666031.0,55666031.0,8201,12942,6787.7,6824.7,21143,143991905.0,618,2023-11-29 10:35:00
1047,PHOR,252,561,64970266.0,64970266.0,9589,20589,6775.5,6819.9,30178,205385121.0,813,235,529,63583450.0,63583450.0,9369,20261,6786.6,6822.6,29630,201816029.0,764,2023-11-29 10:40:00
1048,PHOR,446,1135,126793357.0,126793357.0,18783,39512,6750.4,6801.4,58295,395529562.0,1581,401,1080,124064125.0,124064125.0,18315,36743,6773.9,6810.9,55058,374318043.0,1481,2023-11-29 10:45:00
1049,PHOR,161,105,25450684.0,25450684.0,3780,4418,6733.0,6734.4,8198,55203193.0,266,106,80,23979798.0,23979798.0,3545,4049,6764.4,6805.2,7594,51534232.0,186,2023-11-29 10:50:00
1050,PHOR,64,66,14277370.0,14277370.0,2135,2605,6687.3,6782.5,4740,31945853.0,130,45,36,12700678.0,12700678.0,1877,2056,6766.5,6800.4,3933,26682253.0,81,2023-11-29 10:55:00
1051,PHOR,631,738,189257784.0,189257784.0,28361,37544,6673.2,6432.9,65905,430774682.0,1369,482,674,181184665.0,181184665.0,26894,35210,6737.0,6776.8,62104,419796415.0,1156,2023-11-29 11:00:00
1052,PHOR,391,324,130869469.0,130869469.0,19590,17539,6680.4,6772.6,37129,249654014.0,715,320,292,126118611.0,126118611.0,18708,16209,6741.4,6786.7,34917,236123776.0,612,2023-11-29 11:05:00
1053,PHOR,163,253,53168296.0,53168296.0,8003,11446,6643.5,6771.6,19449,130675705.0,416,131,230,59592973.0,59592973.0,8845,11351,6737.5,6793.9,20196,136710448.0,361,2023-11-29 11:10:00
1054,PHOR,101,215,26529359.0,26529359.0,3957,7672,6704.4,6782.5,11629,78564969.0,316,70,197,26036142.0,26036142.0,3852,7296,6759.1,6792.0,11148,75590688.0,267,2023-11-29 11:15:00
1055,PHOR,148,202,42004196.0,42004196.0,6240,9775,6731.4,6794.3,16015,108418023.0,350,125,191,38404367.0,38404367.0,5687,9666,6753.0,6797.3,15353,104106956.0,316,2023-11-29 11:20:00
1056,PHOR,278,569,91670208.0,91670208.0,13592,23500,6744.4,6776.6,37092,250919205.0,847,252,542,87205837.0,87205837.0,12902,23268,6759.1,6794.5,36170,245300240.0,794,2023-11-29 11:25:00
1057,PHOR,185,498,69760038.0,69760038.0,10373,22697,6725.2,6800.3,33070,224106313.0,683,156,476,68874910.0,68874910.0,10200,22537,6752.4,6800.8,32737,222143629.0,632,2023-11-29 11:30:00
1058,PHOR,110,286,44931152.0,44931152.0,6694,17689,6712.2,6799.4,24383,165205541.0,396,98,275,38597406.0,38597406.0,5716,17634,6752.5,6803.5,23350,158571037.0,373,2023-11-29 11:35:00
1059,PHOR,193,419,63432840.0,63432840.0,9413,26804,6738.9,6796.7,36217,245610782.0,612,177,404,62358755.0,62358755.0,9221,27167,6762.7,6799.9,36388,247091751.0,581,2023-11-29 11:40:00
1060,PHOR,134,351,35223114.0,35223114.0,5210,28742,6760.7,6791.9,33952,230435136.0,485,121,336,34910182.0,34910182.0,5157,28607,6769.5,6794.9,33764,229293229.0,457,2023-11-29 11:45:00
1061,PHOR,274,944,99120856.0,99120856.0,14684,53836,6750.3,6783.3,68520,464308069.0,1218,260,870,102329994.0,102329994.0,15153,53607,6753.1,6791.0,68760,466373178.0,1130,2023-11-29 11:50:00
1062,PHOR,436,1750,153340164.0,153340164.0,22755,80443,6738.7,6780.0,103198,698746299.0,2186,408,1727,139599441.0,139599441.0,20696,80388,6745.2,6783.8,101084,684932476.0,2135,2023-11-29 11:55:00
1063,PHOR,261,735,68260924.0,68260924.0,10126,45985,6741.2,6787.3,56111,380376584.0,996,235,725,67569066.0,67569066.0,10008,45922,6751.5,6790.0,55930,379377374.0,960,2023-11-29 12:00:00
1064,PHOR,256,528,78454645.0,78454645.0,11677,43663,6718.7,6794.1,55340,375104263.0,784,232,518,79441445.0,79441445.0,11765,43442,6752.4,6794.2,55207,374595355.0,750,2023-11-29 12:05:00
1065,PHOR,152,282,44639104.0,44639104.0,6614,35698,6749.2,6793.8,42312,287162594.0,434,127,275,43424295.0,43424295.0,6424,35630,6759.7,6796.7,42054,285589722.0,402,2023-11-29 12:10:00
1066,PHOR,108,216,33514992.0,33514992.0,4981,36115,6728.6,6795.4,41096,278929864.0,324,92,207,33482698.0,33482698.0,4951,36054,6762.8,6797.7,41005,278566874.0,299,2023-11-29 12:15:00
1067,PHOR,181,288,47256479.0,47256479.0,7111,41045,6645.5,6796.0,48156,326198729.0,469,157,275,45484314.0,45484314.0,6728,40758,6760.5,6797.2,47486,322524312.0,432,2023-11-29 12:20:00
1068,PHOR,107,163,33506700.0,33506700.0,4983,39996,6724.2,6796.2,44979,305328107.0,270,99,151,33398718.0,33398718.0,4934,39921,6769.1,6798.5,44855,304803528.0,250,2023-11-29 12:25:00
1069,PHOR,117,167,35162241.0,35162241.0,5199,41950,6763.3,6798.7,47149,320368106.0,284,105,160,33799036.0,33799036.0,4993,41915,6769.3,6798.9,46908,318773392.0,265,2023-11-29 12:30:00
1070,PHOR,204,224,51555625.0,51555625.0,7626,47091,6760.5,6796.3,54717,371601424.0,428,189,216,51541532.0,51541532.0,7615,47067,6768.4,6798.2,54682,371513218.0,405,2023-11-29 12:35:00
1071,PHOR,156,195,44708747.0,44708747.0,6607,50581,6766.9,6797.5,57188,388533986.0,351,149,181,44243620.0,44243620.0,6537,50440,6768.2,6798.8,56977,387172765.0,330,2023-11-29 12:40:00
1072,PHOR,179,287,43499593.0,43499593.0,6439,53794,6755.6,6798.1,60233,409197527.0,466,163,282,43140521.0,43140521.0,6372,53790,6770.3,6798.2,60162,408817933.0,445,2023-11-29 12:45:00
1073,PHOR,3344,408,974397224.0,974397224.0,143736,61223,6779.1,6799.9,204959,1390707353.0,3752,3317,401,974263836.0,974263836.0,143704,61173,6779.7,6800.0,204877,1390240721.0,3718,2023-11-29 12:50:00
1074,PHOR,1787,609,403093168.0,403093168.0,59531,67429,6771.1,6800.6,126960,861653913.0,2396,1748,603,402244924.0,402244924.0,59363,67481,6776.0,6800.9,126844,861174644.0,2351,2023-11-29 12:55:00
1075,PHOR,368,408,95649112.0,95649112.0,14150,66500,6759.7,6800.0,80650,547851664.0,776,355,395,94382606.0,94382606.0,13959,66261,6761.4,6800.5,80220,544987593.0,750,2023-11-29 13:00:00
1076,PHOR,9501,708,2824231545.0,2824231545.0,416488,76997,6781.1,6798.3,493485,3347680720.0,10209,9485,697,2822719526.0,2822719526.0,416234,76905,6781.6,6801.0,493139,3345752081.0,10182,2023-11-29 13:05:00
1077,PHOR,553,517,143612051.0,143612051.0,21320,74307,6736.0,6800.5,95627,648937064.0,1070,548,506,144585046.0,144585046.0,21351,74419,6771.8,6800.8,95770,650694600.0,1054,2023-11-29 13:10:00
1078,PHOR,4130,827,1149573850.0,1149573850.0,169538,88504,6780.6,6801.6,258042,1751539215.0,4957,4115,815,1148513120.0,1148513120.0,169354,88313,6781.7,6802.9,257667,1749295486.0,4930,2023-11-29 13:15:00
1079,PHOR,2575,927,670630892.0,670630892.0,98927,96327,6779.0,6802.9,195254,1325937865.0,3502,2557,912,669871544.0,669871544.0,98810,96289,6779.4,6803.7,195099,1324994031.0,3469,2023-11-29 13:20:00
1080,PHOR,17136,5705,3888173494.0,3888173494.0,573204,150805,6783.2,6801.4,724009,4913854336.0,22841,17122,5686,3888611483.0,3888611483.0,573265,150756,6783.3,6801.7,724021,4914009716.0,22808,2023-11-29 13:25:00
1081,PHOR,4789,1430,1106697666.0,1106697666.0,163170,99791,6782.5,6802.8,262961,1785556971.0,6219,4777,1422,1105627952.0,1105627952.0,163012,99669,6782.5,6802.8,262681,1783652459.0,6199,2023-11-29 13:30:00
1082,PHOR,9448,3402,2166128150.0,2166128150.0,319168,122418,6786.8,6803.2,441586,2998956209.0,12850,9438,3399,2165860416.0,2165860416.0,319122,122403,6786.9,6803.1,441525,2998579148.0,12837,2023-11-29 13:35:00
1083,PHOR,8270,3199,1924278397.0,1924278397.0,283535,130027,6786.7,6803.7,413562,2808943281.0,11469,8256,3185,1922916225.0,1922916225.0,283326,129892,6786.9,6803.8,413218,2806670197.0,11441,2023-11-29 13:40:00
1084,PHOR,468,491,146121971.0,146121971.0,21589,96110,6768.4,6802.3,117699,799895415.0,959,458,481,146034602.0,146034602.0,21574,96056,6769.0,6802.7,117630,799473433.0,939,2023-11-29 13:45:00
1085,PHOR,629,686,188523861.0,188523861.0,27873,106652,6763.7,6804.0,134525,914178943.0,1315,613,672,184218302.0,184218302.0,27205,106514,6771.5,6803.9,133719,908926107.0,1285,2023-11-29 13:50:00
1086,PHOR,354,529,114123226.0,114123226.0,16862,98768,6768.1,6802.8,115630,786018610.0,883,344,519,114119241.0,114119241.0,16857,98753,6769.8,6802.8,115610,785920556.0,863,2023-11-29 13:55:00
1087,PHOR,517,569,158168348.0,158168348.0,23359,106153,6771.2,6802.0,129512,880221990.0,1086,504,555,160230086.0,160230086.0,23654,106326,6773.9,6803.4,129980,883604686.0,1059,2023-11-29 14:00:00
1088,PHOR,92,214,16686569.0,16686569.0,2467,88067,6763.9,6800.1,90534,615547636.0,306,80,203,15815707.0,15815707.0,2333,88019,6779.1,6800.5,90352,614390038.0,283,2023-11-29 14:05:00
1089,PHOR,290,297,68083576.0,68083576.0,10046,95546,6777.2,6801.4,105592,717930474.0,587,276,284,66117518.0,66117518.0,9752,95227,6779.9,6801.5,104979,713803846.0,560,2023-11-29 14:10:00
1090,PHOR,1489,382,417497310.0,417497310.0,61515,103686,6786.9,6802.4,165201,1122814899.0,1871,1480,366,416952810.0,416952810.0,61406,103610,6790.1,6802.8,165016,1121790944.0,1846,2023-11-29 14:15:00
1091,PHOR,14562,4769,2918008924.0,2918008924.0,429465,231942,6794.5,6803.1,661407,4495928170.0,19331,14554,4751,2918035273.0,2918035273.0,429435,231868,6795.1,6803.4,661303,4495526369.0,19305,2023-11-29 14:20:00
1092,PHOR,14478,573,4802174878.0,4802174878.0,706846,115996,6793.8,6802.0,822842,5591176417.0,15051,14471,553,4802319381.0,4802319381.0,706865,115892,6793.8,6802.8,822757,5590705760.0,15024,2023-11-29 14:25:00
1093,PHOR,20078,895,6047317265.0,6047317265.0,890130,123832,6793.7,6803.0,1013962,6889752113.0,20973,20058,873,6046567900.0,6046567900.0,889999,123757,6793.9,6803.4,1013756,6888531471.0,20931,2023-11-29 14:30:00
1094,PHOR,15854,3919,4053647676.0,4053647676.0,596712,159857,6793.3,6803.2,756569,5141184516.0,19773,15842,3905,4053391309.0,4053391309.0,596668,159655,6793.4,6803.2,756323,5139549962.0,19747,2023-11-29 14:35:00
1095,PHOR,5670,888,1751189937.0,1751189937.0,257851,129029,6791.5,6803.5,386880,2629036244.0,6558,5654,875,1750897206.0,1750897206.0,257800,128984,6791.7,6803.6,386784,2628451469.0,6529,2023-11-29 14:40:00
1096,PHOR,5973,1209,1496108749.0,1496108749.0,220284,130153,6791.7,6801.0,350437,2381279082.0,7182,5964,1186,1496085237.0,1496085237.0,220279,129978,6791.8,6802.5,350257,2380257776.0,7150,2023-11-29 14:45:00
1097,PHOR,389,394,113570312.0,113570312.0,16777,121447,6769.4,6802.0,138224,939655654.0,783,377,387,113075146.0,113075146.0,16700,121451,6771.0,6802.0,138151,939186199.0,764,2023-11-29 14:50:00
1098,PHOR,442,443,136027294.0,136027294.0,20085,126606,6772.6,6801.4,146691,997127314.0,885,424,429,135950465.0,135950465.0,20073,126561,6772.8,6802.2,146634,996845716.0,853,2023-11-29 14:55:00
1099,PHOR,587,475,161016202.0,161016202.0,23775,130759,6772.5,6801.9,154534,1050431915.0,1062,568,450,160727863.0,160727863.0,23720,130645,6776.0,6802.7,154365,1049472173.0,1018,2023-11-29 15:00:00
1100,PHOR,410,524,122805627.0,122805627.0,18150,135121,6766.2,6801.9,153271,1041883322.0,934,391,499,121389093.0,121389093.0,17926,134697,6771.7,6802.2,152623,1037619402.0,890,2023-11-29 15:05:00
1101,PHOR,346,463,111333790.0,111333790.0,16455,133672,6766.0,6801.9,150127,1020560435.0,809,329,445,110586475.0,110586475.0,16337,133608,6769.1,6801.9,149945,1019377919.0,774,2023-11-29 15:10:00
1102,PHOR,414,486,120522905.0,120522905.0,17847,137133,6753.1,6801.9,154980,1053285765.0,900,388,452,119559982.0,119559982.0,17656,136784,6771.6,6801.9,154440,1049955793.0,840,2023-11-29 15:15:00
1103,PHOR,301,324,103956911.0,103956911.0,15364,134419,6766.3,6801.4,149783,1018199897.0,625,297,319,103944655.0,103944655.0,15361,134406,6766.8,6801.6,149767,1018121376.0,616,2023-11-29 15:20:00
1104,PHOR,536,610,156904556.0,156904556.0,23211,148372,6759.9,6800.7,171583,1165942923.0,1146,521,597,156591025.0,156591025.0,23160,147871,6761.3,6801.1,171031,1162277063.0,1118,2023-11-29 15:25:00
1105,PHOR,503,535,143142321.0,143142321.0,21166,146376,6762.8,6800.7,167542,1138603386.0,1038,496,529,142819975.0,142819975.0,21117,146481,6763.3,6801.0,167598,1139035192.0,1025,2023-11-29 15:30:00
1106,PHOR,700,652,217505548.0,217505548.0,32140,157620,6767.4,6798.5,189760,1289082603.0,1352,668,642,216412173.0,216412173.0,31975,157465,6768.2,6801.8,189440,1287457984.0,1310,2023-11-29 15:35:00
1107,PHOR,451,466,143034971.0,143034971.0,21144,150404,6764.8,6800.4,171548,1165836247.0,917,447,461,142987834.0,142987834.0,21137,150380,6764.8,6801.2,171517,1165748503.0,908,2023-11-29 15:40:00
1108,PHOR,551,650,169146364.0,169146364.0,25010,159189,6763.1,6800.9,184199,1251771161.0,1201,541,642,168903512.0,168903512.0,24973,158997,6763.4,6801.1,183970,1250258353.0,1183,2023-11-29 15:45:00
1109,PHOR,688,675,172771471.0,172771471.0,25555,162464,6760.8,6801.0,188019,1277687185.0,1363,675,666,172620761.0,172620761.0,25526,162392,6762.5,6801.0,187918,1277055457.0,1341,2023-11-29 15:50:00
1110,PHOR,453,405,110544335.0,110544335.0,16408,122280,6737.2,6791.3,138688,940983351.0,858,423,393,108207552.0,108207552.0,16010,122067,6758.7,6801.0,138077,938383300.0,816,2023-11-29 15:55:00
1111,PHOR,485,607,133565246.0,133565246.0,19775,164114,6754.2,6794.6,183889,1248651520.0,1092,468,599,134112645.0,134112645.0,19855,163949,6754.6,6800.1,183804,1248976768.0,1067,2023-11-29 16:00:00
1112,PHOR,461,604,117897894.0,117897894.0,17462,165734,6751.7,6799.4,183196,1244782876.0,1065,450,597,117675393.0,117675393.0,17417,165707,6756.4,6799.4,183124,1244380184.0,1047,2023-11-29 16:05:00
1113,PHOR,940,1269,317816136.0,317816136.0,47106,201783,6746.8,6772.6,248889,1684401753.0,2209,858,1236,310463825.0,310463825.0,46015,200505,6747.0,6798.0,246520,1673505288.0,2094,2023-11-29 16:10:00
1114,PHOR,704,544,216907985.0,216907985.0,32193,172555,6737.7,6799.5,204748,1390188241.0,1248,674,523,215841318.0,215841318.0,31981,172507,6749.0,6799.4,204488,1388786772.0,1197,2023-11-29 16:15:00
1115,PHOR,361,344,104471692.0,104471692.0,15470,163944,6753.2,6799.8,179414,1219260307.0,705,361,340,103759696.0,103759696.0,15364,163895,6753.4,6799.8,179259,1218211657.0,701,2023-11-29 16:20:00
1116,PHOR,373,323,104377610.0,104377610.0,15457,166151,6752.8,6799.8,181608,1234164016.0,696,365,317,105522656.0,105522656.0,15624,166104,6753.9,6799.8,181728,1234997372.0,682,2023-11-29 16:25:00
1117,PHOR,787,1086,265566233.0,265566233.0,39374,208050,6744.7,6791.2,247424,1678482329.0,1873,757,1072,260243719.0,260243719.0,38586,207757,6744.5,6798.2,246343,1672625779.0,1829,2023-11-29 16:30:00
1118,PHOR,454,767,143151653.0,143151653.0,21218,186629,6746.7,6798.6,207847,1411962060.0,1221,435,759,142404001.0,142404001.0,21101,186604,6748.7,6798.6,207705,1411042782.0,1194,2023-11-29 16:35:00
1119,PHOR,437,719,132821260.0,132821260.0,19695,185380,6743.9,6798.6,205075,1393142935.0,1156,419,709,132675533.0,132675533.0,19658,185393,6749.2,6798.9,205051,1393143636.0,1128,2023-11-29 16:40:00
1120,PHOR,380,797,117940019.0,117940019.0,17476,189652,6748.7,6798.3,207128,1407256923.0,1177,369,795,117777531.0,117777531.0,17450,189535,6749.4,6798.3,206985,1406289960.0,1164,2023-11-29 16:45:00
1121,PHOR,349,590,116860847.0,116860847.0,17324,187543,6745.6,6799.2,204867,1391993853.0,939,344,582,116099662.0,116099662.0,17204,187447,6748.4,6799.0,204651,1390551609.0,926,2023-11-29 16:50:00
1122,PHOR,264,440,83026313.0,83026313.0,12317,183479,6740.8,6799.6,195796,1330617852.0,704,257,439,86883955.0,86883955.0,12872,183479,6749.8,6799.6,196351,1334472184.0,696,2023-11-29 16:55:00
1123,PHOR,309,430,95823651.0,95823651.0,14228,186861,6734.9,6798.6,201089,1366225078.0,739,295,427,95570600.0,95570600.0,14165,186814,6747.0,6799.4,200979,1365801154.0,722,2023-11-29 17:00:00
1124,PHOR,320,749,95752482.0,95752482.0,14191,195729,6747.4,6798.5,209920,1426406864.0,1069,317,741,95757748.0,95757748.0,14192,195709,6747.3,6798.5,209901,1426281749.0,1058,2023-11-29 17:05:00
1125,PHOR,313,574,107999118.0,107999118.0,16009,197609,6746.2,6798.8,213618,1451504160.0,887,314,572,109086898.0,109086898.0,16170,197750,6746.3,6798.8,213920,1453551606.0,886,2023-11-29 17:10:00
1126,PHOR,330,560,118106695.0,118106695.0,17526,199089,6738.9,6798.5,216615,1471615155.0,890,324,557,117247401.0,117247401.0,17386,199004,6743.8,6798.9,216390,1470248183.0,881,2023-11-29 17:15:00
1127,PHOR,526,824,162222903.0,162222903.0,24069,209878,6739.9,6798.8,233947,1589151585.0,1350,501,820,162020751.0,162020751.0,24025,209862,6743.8,6798.9,233887,1588841466.0,1321,2023-11-29 17:20:00
1128,PHOR,416,731,130217075.0,130217075.0,19318,209518,6740.7,6798.7,228836,1554656664.0,1147,409,726,130011978.0,130011978.0,19281,209501,6743.0,6798.7,228782,1554350585.0,1135,2023-11-29 17:25:00
1129,PHOR,529,954,132504853.0,132504853.0,19702,212819,6725.5,6793.5,232521,1578294221.0,1483,511,949,132278838.0,132278838.0,19603,212651,6747.9,6797.9,232254,1577867994.0,1460,2023-11-29 17:30:00
1130,PHOR,643,851,183934179.0,183934179.0,27289,217552,6740.2,6798.3,244841,1662923325.0,1494,623,843,184622048.0,184622048.0,27366,217643,6746.4,6798.5,245009,1664261852.0,1466,2023-11-29 17:35:00
1131,PHOR,579,743,181892792.0,181892792.0,26961,216502,6746.5,6798.7,243463,1653832652.0,1322,570,734,182102681.0,182102681.0,26989,216324,6747.3,6798.8,243313,1652851321.0,1304,2023-11-29 17:40:00
1132,PHOR,480,455,137548984.0,137548984.0,20413,208553,6738.3,6799.1,228966,1555527074.0,935,466,444,136723094.0,136723094.0,20257,208466,6749.4,6799.3,228723,1554146110.0,910,2023-11-29 17:45:00
1133,PHOR,259,244,69801220.0,69801220.0,10381,203121,6723.9,6799.2,213502,1450854050.0,503,245,241,69483735.0,69483735.0,10286,203116,6755.2,6799.2,213402,1450516932.0,486,2023-11-29 17:50:00
1134,PHOR,203,257,45091827.0,45091827.0,6681,203624,6749.3,6797.8,210305,1429290694.0,460,193,250,44828193.0,44828193.0,6632,203567,6759.4,6799.2,210199,1428919619.0,443,2023-11-29 17:55:00
1135,PHOR,175,282,44759124.0,44759124.0,6625,206964,6756.1,6799.1,213589,1451929079.0,457,166,280,42386563.0,42386563.0,6270,206972,6760.2,6799.2,213242,1449623977.0,446,2023-11-29 18:00:00
1136,PHOR,161,227,44240554.0,44240554.0,6570,208846,6733.7,6799.1,215416,1464195374.0,388,155,220,44209621.0,44209621.0,6543,208880,6756.8,6799.3,215423,1464443888.0,375,2023-11-29 18:05:00
1137,PHOR,469,709,146351344.0,146351344.0,21698,230955,6744.9,6796.1,252653,1715934943.0,1178,455,702,142529287.0,142529287.0,21133,230819,6744.4,6799.0,251952,1711869973.0,1157,2023-11-29 18:10:00
1138,PHOR,435,817,118682311.0,118682311.0,17583,234267,6749.8,6798.3,251850,1711297528.0,1252,418,809,120346457.0,120346457.0,17822,234235,6752.7,6798.3,252057,1712741490.0,1227,2023-11-29 18:15:00
1139,PHOR,262,570,62478414.0,62478414.0,9247,225709,6756.6,6798.9,234956,1597054322.0,832,251,563,61243282.0,61243282.0,9063,225646,6757.5,6798.9,234709,1595393203.0,814,2023-11-29 18:20:00
1140,PHOR,90,119,18592313.0,18592313.0,2755,3777,6748.6,6791.9,6532,44245242.0,209,81,122,21773361.0,21773361.0,3227,4310,6747.2,6796.2,7537,51065172.0,203,2023-11-29 18:25:00
1141,PHOR,49,48,6008910.0,6008910.0,893,1198,6728.9,6455.6,2091,13742689.0,97,38,46,7990162.0,7990162.0,1182,1432,6759.9,6793.2,2614,17718016.0,84,2023-11-29 18:30:00
1142,PHOR,50,189,6672266.0,6672266.0,993,7250,6719.3,6783.6,8243,55853111.0,239,38,183,6332403.0,6332403.0,937,7202,6758.2,6783.7,8139,55188634.0,221,2023-11-29 18:35:00
1143,PHOR,49,119,9905287.0,9905287.0,1468,3273,6747.5,6781.8,4741,32102129.0,168,41,117,8641749.0,8641749.0,1278,3518,6761.9,6793.2,4796,32540287.0,158,2023-11-29 18:40:00
1144,PHOR,244,869,59013534.0,59013534.0,8780,24288,6721.4,6771.0,33068,223466726.0,1113,180,772,50589952.0,50589952.0,7501,22446,6744.4,6770.4,29947,202559230.0,952,2023-11-30 10:05:00
1145,PHOR,785,872,151853338.0,151853338.0,22593,27216,6721.3,6752.8,49809,335638672.0,1657,716,838,146053167.0,146053167.0,21697,26558,6731.5,6764.3,48255,325698767.0,1554,2023-11-30 10:10:00
1146,PHOR,410,870,90699675.0,90699675.0,13502,31091,6717.5,6758.2,44593,300817846.0,1280,368,832,89458301.0,89458301.0,13293,30492,6729.7,6769.8,43785,295883895.0,1200,2023-11-30 10:15:00
1147,PHOR,871,1682,206405470.0,206405470.0,30806,52409,6700.2,6756.9,83215,560528537.0,2553,814,1627,207369125.0,207369125.0,30918,52002,6707.1,6756.1,82920,558698639.0,2441,2023-11-30 10:20:00
1148,PHOR,991,976,245976053.0,245976053.0,36831,39470,6678.5,6754.0,76301,512554558.0,1967,913,931,239101049.0,239101049.0,35554,39101,6725.0,6761.6,74655,503487535.0,1844,2023-11-30 10:25:00
1149,PHOR,386,556,80063202.0,80063202.0,11895,15730,6730.8,6772.0,27625,186587445.0,942,339,536,75559723.0,75559723.0,11217,15030,6736.2,6766.6,26247,177262257.0,875,2023-11-30 10:30:00
1150,PHOR,681,986,175163163.0,175163163.0,26322,36005,6654.6,6771.4,62327,418968089.0,1667,612,936,172115153.0,172115153.0,25530,35682,6741.7,6780.9,61212,414071841.0,1548,2023-11-30 10:35:00
1151,PHOR,463,346,113162507.0,113162507.0,16863,12438,6710.7,6791.2,29301,197631029.0,809,419,315,110507253.0,110507253.0,16370,12247,6750.6,6789.9,28617,193663327.0,734,2023-11-30 10:40:00
1152,PHOR,550,464,135583180.0,135583180.0,20152,18261,6728.0,6805.7,38413,259861914.0,1014,513,424,135797030.0,135797030.0,20088,17989,6760.1,6805.1,38077,258214117.0,937,2023-11-30 10:45:00
1153,PHOR,648,688,156180073.0,156180073.0,23195,21352,6733.4,6804.9,44547,301477650.0,1336,611,629,153737675.0,153737675.0,22704,21126,6771.4,6809.8,43830,297601193.0,1240,2023-11-30 10:50:00
1154,PHOR,286,406,67633757.0,67633757.0,9997,10265,6765.4,6782.4,20262,137254651.0,692,263,361,67019483.0,67019483.0,9888,10066,6777.9,6811.5,19954,135584199.0,624,2023-11-30 10:55:00
1155,PHOR,631,420,172439308.0,172439308.0,25498,17581,6762.9,6788.4,43079,291785546.0,1051,589,348,158380297.0,158380297.0,23376,16541,6775.3,6819.2,39917,271176381.0,937,2023-11-30 11:00:00
1156,PHOR,354,514,108671223.0,108671223.0,16076,18619,6759.8,6794.6,34695,235178989.0,868,331,473,102623697.0,102623697.0,15163,18358,6768.0,6809.5,33521,227632025.0,804,2023-11-30 11:05:00
1157,PHOR,654,1027,203742040.0,203742040.0,30250,31790,6735.3,6749.5,62040,418307813.0,1681,589,958,200177582.0,200177582.0,29609,30865,6760.7,6797.1,60474,409969118.0,1547,2023-11-30 11:10:00
1158,PHOR,477,691,154655128.0,154655128.0,22963,29470,6735.0,6719.6,52433,352681364.0,1168,422,639,153095623.0,153095623.0,22707,27994,6742.2,6784.5,50701,343021817.0,1061,2023-11-30 11:15:00
1159,PHOR,546,383,118065072.0,118065072.0,17637,17364,6694.2,6694.9,35001,234316181.0,929,472,329,117082888.0,117082888.0,17371,16627,6740.1,6774.4,33998,229720087.0,801,2023-11-30 11:20:00
1160,PHOR,711,458,166131986.0,166131986.0,24718,21861,6721.1,6747.4,46579,313635947.0,1169,644,413,165532862.0,165532862.0,24600,21339,6729.0,6769.4,45939,309984603.0,1057,2023-11-30 11:25:00
1161,PHOR,510,483,109341368.0,109341368.0,16274,18392,6718.8,6758.5,34666,233644465.0,993,449,439,108153338.0,108153338.0,16084,18074,6724.3,6759.4,34158,230322679.0,888,2023-11-30 11:30:00
1162,PHOR,446,685,117891687.0,117891687.0,17583,25661,6704.9,6655.6,43244,288681613.0,1131,369,640,115267237.0,115267237.0,17173,25087,6712.1,6753.2,42260,284685995.0,1009,2023-11-30 11:35:00
1163,PHOR,458,540,127457529.0,127457529.0,19047,22351,6691.7,6737.2,41398,278039704.0,998,430,526,126369137.0,126369137.0,18840,22202,6707.5,6749.4,41042,276218486.0,956,2023-11-30 11:40:00
1164,PHOR,476,694,137779124.0,137779124.0,20572,30811,6697.4,6751.6,51383,345803584.0,1170,424,664,135311152.0,135311152.0,20163,30777,6710.9,6751.7,50940,343108734.0,1088,2023-11-30 11:45:00
1165,PHOR,131,168,29624686.0,29624686.0,4419,6546,6703.9,6701.8,10965,73494438.0,299,111,137,29014529.0,29014529.0,4322,6192,6713.2,6754.9,10514,70841071.0,248,2023-11-30 11:50:00
1166,PHOR,286,489,71707795.0,71707795.0,10699,18836,6702.3,6737.3,29535,198611497.0,775,238,461,70116456.0,70116456.0,10457,18179,6705.2,6747.0,28636,192770128.0,699,2023-11-30 11:55:00
1167,PHOR,243,341,55412220.0,55412220.0,8288,14446,6685.8,6741.1,22734,152794426.0,584,194,333,52735669.0,52735669.0,7858,14330,6711.1,6743.9,22188,149376042.0,527,2023-11-30 12:00:00
1168,PHOR,301,463,87385798.0,87385798.0,13103,17050,6669.1,6681.0,30153,201297253.0,764,262,442,86768561.0,86768561.0,12927,16664,6712.2,6744.3,29591,199155341.0,704,2023-11-30 12:05:00
1169,PHOR,326,467,88355183.0,88355183.0,13174,19385,6706.8,6704.1,32559,218313517.0,793,273,440,82701660.0,82701660.0,12319,18838,6713.3,6742.8,31157,209723166.0,713,2023-11-30 12:10:00
1170,PHOR,268,474,73014703.0,73014703.0,10877,16214,6712.8,6740.9,27091,182311486.0,742,250,420,71150458.0,71150458.0,10588,15802,6719.9,6751.8,26390,177841830.0,670,2023-11-30 12:15:00
1171,PHOR,212,412,41005364.0,41005364.0,6116,12598,6704.6,6744.3,18714,125970322.0,624,171,395,38813542.0,38813542.0,5786,12324,6708.2,6746.3,18110,121955164.0,566,2023-11-30 12:20:00
1172,PHOR,333,582,97733065.0,97733065.0,14580,23062,6703.2,6733.7,37642,253025686.0,915,314,575,97838270.0,97838270.0,14594,22935,6704.0,6749.7,37529,252643165.0,889,2023-11-30 12:25:00
1173,PHOR,391,883,122015158.0,122015158.0,18211,35628,6700.1,6744.4,53839,362305856.0,1274,376,875,120926903.0,120926903.0,18038,35573,6704.0,6746.1,53611,360905001.0,1251,2023-11-30 12:30:00
1174,PHOR,281,538,70089668.0,70089668.0,10466,22333,6696.9,6735.5,32799,220513409.0,819,257,529,69733807.0,69733807.0,10401,22260,6704.5,6742.3,32661,219816777.0,786,2023-11-30 12:35:00
1175,PHOR,274,784,73582171.0,73582171.0,10971,32832,6707.0,6732.7,43803,294631173.0,1058,253,773,72571485.0,72571485.0,10820,32783,6707.2,6737.5,43603,293448337.0,1026,2023-11-30 12:40:00
1176,PHOR,421,803,106057331.0,106057331.0,15809,37393,6708.7,6738.8,53202,358041738.0,1224,409,798,104454048.0,104454048.0,15569,37364,6709.1,6741.1,52933,356329612.0,1207,2023-11-30 12:45:00
1177,PHOR,601,1006,177077196.0,177077196.0,26422,47257,6701.9,6740.8,73679,495627687.0,1607,562,989,171791764.0,171791764.0,25614,47117,6706.9,6747.3,72731,489706211.0,1551,2023-11-30 12:50:00
1178,PHOR,386,567,125799797.0,125799797.0,18768,27522,6702.9,6751.8,46290,311623468.0,953,360,561,123658687.0,123658687.0,18442,27472,6705.3,6752.0,45914,309150623.0,921,2023-11-30 12:55:00
1179,PHOR,234,396,73862743.0,73862743.0,11021,18471,6702.0,6745.9,29492,198465604.0,630,199,387,72165763.0,72165763.0,10756,18248,6709.3,6747.1,29004,195287335.0,586,2023-11-30 13:00:00
1180,PHOR,301,506,84918676.0,84918676.0,12677,27092,6698.6,6748.9,39769,267759650.0,807,263,502,81855155.0,81855155.0,12191,27672,6714.4,6749.2,39863,268618170.0,765,2023-11-30 13:05:00
1181,PHOR,275,364,86057975.0,86057975.0,12814,13193,6715.9,6749.7,26007,175106798.0,639,238,319,84379096.0,84379096.0,12563,12898,6716.5,6758.9,25461,171555815.0,557,2023-11-30 13:10:00
1182,PHOR,268,361,70311430.0,70311430.0,10518,13920,6684.9,6750.8,24438,164282149.0,629,214,343,65089642.0,65089642.0,9696,13810,6713.0,6750.9,23506,158319227.0,557,2023-11-30 13:15:00
1183,PHOR,251,538,68054895.0,68054895.0,10153,18608,6702.9,6747.3,28761,193609255.0,789,234,529,68169783.0,68169783.0,10165,18572,6706.3,6747.8,28737,193489154.0,763,2023-11-30 13:20:00
1184,PHOR,391,766,124928626.0,124928626.0,18683,32165,6686.8,6744.7,50848,341871286.0,1157,359,751,123650025.0,123650025.0,18434,32108,6707.7,6747.6,50542,340303478.0,1110,2023-11-30 13:25:00
1185,PHOR,370,654,99059037.0,99059037.0,14789,25310,6698.2,6748.2,40099,269855454.0,1024,333,646,98286738.0,98286738.0,14661,25315,6704.0,6748.2,39976,269116908.0,979,2023-11-30 13:30:00
1186,PHOR,409,785,103472694.0,103472694.0,15434,29896,6704.2,6740.6,45330,304989978.0,1194,394,778,103271384.0,103271384.0,15392,29872,6709.4,6745.0,45264,304757136.0,1172,2023-11-30 13:35:00
1187,PHOR,453,710,138919423.0,138919423.0,20777,33609,6686.2,6745.8,54386,365637800.0,1163,428,700,138206700.0,138206700.0,20602,33521,6708.4,6746.2,54123,364345954.0,1128,2023-11-30 13:40:00
1188,PHOR,389,598,116545291.0,116545291.0,17387,29971,6703.0,6738.7,47358,318512156.0,987,365,591,116053330.0,116053330.0,17297,29898,6709.4,6745.2,47195,317722644.0,956,2023-11-30 13:45:00
1189,PHOR,491,846,136334579.0,136334579.0,20387,40873,6687.3,6743.3,61260,411954979.0,1337,451,847,136464456.0,136464456.0,20326,41111,6713.8,6743.4,61437,413692461.0,1298,2023-11-30 13:50:00
1190,PHOR,625,1276,158349435.0,158349435.0,23633,57515,6700.4,6681.0,81148,542607327.0,1901,585,1256,155602622.0,155602622.0,23170,56304,6715.7,6743.7,79474,535297933.0,1841,2023-11-30 13:55:00
1191,PHOR,416,700,70377861.0,70377861.0,10533,27755,6681.7,6737.7,38288,257383033.0,1116,388,698,70870802.0,70870802.0,10553,27963,6715.7,6737.7,38516,259277314.0,1086,2023-11-30 14:00:00
1192,PHOR,690,1413,181220416.0,181220416.0,27085,62308,6690.8,6669.2,89393,596766094.0,2103,636,1398,177911597.0,177911597.0,26542,61640,6703.0,6736.4,88182,593146091.0,2034,2023-11-30 14:05:00
1193,PHOR,379,569,60034932.0,60034932.0,8951,31031,6707.1,6733.7,39982,268989299.0,948,366,555,58499190.0,58499190.0,8720,31246,6708.6,6736.1,39966,268974601.0,921,2023-11-30 14:10:00
1194,PHOR,466,469,71888863.0,71888863.0,10716,31508,6708.6,6729.7,42224,283928445.0,935,443,449,71445499.0,71445499.0,10649,31242,6709.1,6733.3,41891,281807978.0,892,2023-11-30 14:15:00
1195,PHOR,442,663,85115518.0,85115518.0,12711,37921,6696.2,6731.6,50632,340385575.0,1105,430,651,84114817.0,84114817.0,12559,37728,6697.6,6734.5,50287,338192909.0,1081,2023-11-30 14:20:00
1196,PHOR,408,473,87944018.0,87944018.0,13145,38577,6690.3,6734.8,51722,347752802.0,881,379,465,87240074.0,87240074.0,13034,38541,6693.3,6735.8,51575,346846348.0,844,2023-11-30 14:25:00
1197,PHOR,484,639,105084451.0,105084451.0,15695,45098,6695.4,6734.9,60793,408814490.0,1123,461,637,104543990.0,104543990.0,15609,45128,6697.7,6735.6,60737,408508319.0,1098,2023-11-30 14:30:00
1198,PHOR,247,363,45421323.0,45421323.0,6825,24793,6655.1,6731.6,31618,212318984.0,610,229,346,44204219.0,44204219.0,6600,24696,6697.6,6735.8,31296,210550677.0,575,2023-11-30 14:35:00
1199,PHOR,150,280,28727033.0,28727033.0,4287,8762,6701.0,6735.6,13049,87744201.0,430,130,251,31771927.0,31771927.0,4741,9134,6701.5,6743.2,13875,93364550.0,381,2023-11-30 14:40:00
1200,PHOR,229,377,50996239.0,50996239.0,7686,12377,6635.0,6739.2,20063,134407762.0,606,180,332,46728765.0,46728765.0,6978,11565,6696.6,6740.3,18543,124680883.0,512,2023-11-30 14:45:00
1201,PHOR,179,539,38885031.0,38885031.0,5809,12280,6693.9,6731.8,18089,121551853.0,718,142,496,38897276.0,38897276.0,5807,12085,6698.3,6734.6,17892,120285413.0,638,2023-11-30 14:50:00
1202,PHOR,242,605,66715956.0,66715956.0,10001,19144,6670.9,6664.7,29145,194305890.0,847,193,565,65704517.0,65704517.0,9821,18645,6690.2,6729.6,28466,191178403.0,758,2023-11-30 14:55:00
1203,PHOR,275,570,66436355.0,66436355.0,9963,18873,6668.3,6646.1,28836,191869010.0,845,220,529,64682088.0,64682088.0,9678,18457,6683.4,6726.5,28135,188833985.0,749,2023-11-30 15:00:00
1204,PHOR,407,696,91113561.0,91113561.0,13633,21797,6683.3,6667.2,35430,236439439.0,1103,329,648,85672841.0,85672841.0,12814,21390,6685.9,6725.2,34204,229524325.0,977,2023-11-30 15:05:00
1205,PHOR,191,422,48033217.0,48033217.0,7193,14661,6677.8,6698.5,21854,146240642.0,613,144,379,46511011.0,46511011.0,6957,13937,6685.5,6723.0,20894,140209628.0,523,2023-11-30 15:10:00
1206,PHOR,115,203,26606068.0,26606068.0,3996,6388,6658.2,6712.9,10384,69487786.0,318,83,172,26051280.0,26051280.0,3897,6269,6685.0,6720.0,10166,68178899.0,255,2023-11-30 15:15:00
1207,PHOR,117,150,18541251.0,18541251.0,2775,4171,6681.5,6690.9,6946,46449024.0,267,86,123,17617245.0,17617245.0,2635,3908,6685.9,6722.3,6543,43887925.0,209,2023-11-30 15:20:00
1208,PHOR,230,255,62095764.0,62095764.0,9341,12374,6647.7,5849.7,21715,134480158.0,485,164,208,59535128.0,59535128.0,8911,10515,6681.1,6721.0,19426,130206549.0,372,2023-11-30 15:25:00
1209,PHOR,232,287,56782030.0,56782030.0,8524,10656,6661.4,6722.7,19180,128418890.0,519,163,248,54215931.0,54215931.0,8120,9786,6676.8,6720.1,17906,119978788.0,411,2023-11-30 15:30:00
1210,PHOR,283,597,74653627.0,74653627.0,11274,18610,6621.8,6708.0,29884,199490124.0,880,226,551,72848321.0,72848321.0,10913,18349,6675.4,6716.2,29262,196083919.0,777,2023-11-30 15:35:00
1211,PHOR,306,470,75289817.0,75289817.0,11282,16258,6673.4,6714.7,27540,184457652.0,776,242,436,73643874.0,73643874.0,11031,15897,6676.1,6715.2,26928,180394819.0,678,2023-11-30 15:40:00
1212,PHOR,193,289,60657378.0,60657378.0,9101,10293,6664.9,6715.8,19394,129782847.0,482,152,259,56400907.0,56400907.0,8442,10184,6681.0,6717.3,18626,124809694.0,411,2023-11-30 15:45:00
1213,PHOR,212,460,74959675.0,74959675.0,11222,14908,6679.7,6709.9,26130,174990174.0,672,162,409,73860822.0,73860822.0,11055,14634,6681.2,6717.7,25689,172168234.0,571,2023-11-30 15:50:00
1214,PHOR,163,257,47741105.0,47741105.0,7153,9710,6674.3,6711.1,16863,112905519.0,420,114,230,45280601.0,45280601.0,6772,9455,6686.4,6719.4,16227,108812998.0,344,2023-11-30 15:55:00
1215,PHOR,510,585,151389406.0,151389406.0,22627,22798,6690.7,6735.1,45425,304936261.0,1095,443,510,141808069.0,141808069.0,21180,22258,6695.4,6735.0,43438,291714688.0,953,2023-11-30 16:00:00
1216,PHOR,538,587,141488989.0,141488989.0,21357,19737,6624.9,6738.1,41094,274478065.0,1125,497,525,138861900.0,138861900.0,20715,19145,6703.4,6742.0,39860,267936561.0,1022,2023-11-30 16:05:00
1217,PHOR,741,850,213148407.0,213148407.0,31784,24805,6706.2,6730.5,56589,380098372.0,1591,694,780,208690853.0,208690853.0,31120,24372,6706.0,6746.3,55492,373112710.0,1474,2023-11-30 16:10:00
1218,PHOR,821,629,222301659.0,222301659.0,33128,23758,6710.4,6749.8,56886,382664447.0,1450,797,546,219550338.0,219550338.0,32721,23304,6709.8,6751.8,56025,376894450.0,1343,2023-11-30 16:15:00
1219,PHOR,400,671,113433699.0,113433699.0,16925,23049,6702.1,6742.2,39974,268833588.0,1071,382,618,112991520.0,112991520.0,16854,22689,6704.1,6744.4,39543,266016267.0,1000,2023-11-30 16:20:00
1220,PHOR,489,545,141134466.0,141134466.0,21064,22022,6700.3,6745.6,43086,289685530.0,1034,455,492,138097980.0,138097980.0,20597,21665,6704.8,6748.0,42262,284292681.0,947,2023-11-30 16:25:00
1221,PHOR,279,522,79980339.0,79980339.0,11949,20304,6693.5,6735.8,32253,216743079.0,801,258,491,79150140.0,79150140.0,11824,20135,6694.0,6740.0,31959,214860093.0,749,2023-11-30 16:30:00
1222,PHOR,318,604,104267685.0,104267685.0,15593,22856,6686.8,6737.2,38449,258252676.0,922,295,575,102824388.0,102824388.0,15375,22505,6687.8,6738.9,37880,254482535.0,870,2023-11-30 16:35:00
1223,PHOR,301,475,85335069.0,85335069.0,12812,16983,6660.6,6698.0,29795,199087065.0,776,260,429,82024078.0,82024078.0,12263,16517,6688.7,6728.7,28780,193161929.0,689,2023-11-30 16:40:00
1224,PHOR,343,565,106336962.0,106336962.0,15916,20552,6681.1,6690.3,36468,243836019.0,908,298,532,103495705.0,103495705.0,15472,20265,6689.2,6728.2,35737,239843392.0,830,2023-11-30 16:45:00
1225,PHOR,157,343,45335184.0,45335184.0,6784,11380,6682.7,6732.6,18164,121952189.0,500,136,312,46018931.0,46018931.0,6872,11293,6696.6,6735.0,18165,122077812.0,448,2023-11-30 16:50:00
1226,PHOR,196,467,52623551.0,52623551.0,7880,14887,6678.1,6721.7,22767,152689012.0,663,152,426,50913360.0,50913360.0,7604,14608,6695.6,6726.0,22212,149167132.0,578,2023-11-30 16:55:00
1227,PHOR,248,279,63417700.0,63417700.0,9489,10822,6683.3,6724.0,20311,136185213.0,527,197,227,59254323.0,59254323.0,8854,10459,6692.4,6727.8,19313,129620010.0,424,2023-11-30 17:00:00
1228,PHOR,193,367,46251939.0,46251939.0,6948,9606,6656.9,6733.3,16554,110931905.0,560,161,321,43840334.0,43840334.0,6550,9069,6693.2,6732.5,15619,104897053.0,482,2023-11-30 17:05:00
1229,PHOR,320,529,81729018.0,81729018.0,12250,18441,6671.8,6709.0,30691,205449911.0,849,304,492,83556905.0,83556905.0,12489,18045,6690.4,6728.5,30534,204972043.0,796,2023-11-30 17:10:00
1230,PHOR,286,480,60319801.0,60319801.0,9028,14252,6681.4,6694.0,23280,155722406.0,766,230,422,58201444.0,58201444.0,8699,13889,6690.6,6725.7,22588,151614701.0,652,2023-11-30 17:15:00
1231,PHOR,516,407,130345126.0,130345126.0,19500,15848,6684.4,6704.6,35348,236600130.0,923,449,354,126037148.0,126037148.0,18850,14655,6686.3,6724.7,33505,224586906.0,803,2023-11-30 17:20:00
1232,PHOR,477,371,108159086.0,108159086.0,16188,10710,6681.4,6714.2,26898,180068495.0,848,432,306,107362550.0,107362550.0,16055,10280,6687.2,6726.5,26335,176510827.0,738,2023-11-30 17:25:00
1233,PHOR,349,286,69084000.0,69084000.0,10335,7438,6684.5,6717.0,17773,119045325.0,635,303,249,66747506.0,66747506.0,9984,7194,6685.4,6722.5,17178,115109354.0,552,2023-11-30 17:30:00
1234,PHOR,341,412,75103931.0,75103931.0,11252,11220,6674.7,6709.9,22472,150388687.0,753,271,359,71707033.0,71707033.0,10732,11006,6681.6,6726.4,21738,145737437.0,630,2023-11-30 17:35:00
1235,PHOR,536,428,123981829.0,123981829.0,18557,13624,6681.1,6735.4,32181,215744600.0,964,477,373,118673198.0,118673198.0,17732,13270,6692.6,6737.5,31002,208079242.0,850,2023-11-30 17:40:00
1236,PHOR,1500,609,353615712.0,353615712.0,52836,26452,6692.7,6737.5,79288,531837224.0,2109,1444,538,352041997.0,352041997.0,52561,26039,6697.8,6749.9,78600,527801879.0,1982,2023-11-30 17:45:00
1237,PHOR,966,353,189114258.0,189114258.0,28283,12705,6686.5,6744.3,40988,274801010.0,1319,894,302,187457002.0,187457002.0,27985,12475,6698.5,6748.7,40460,271647551.0,1196,2023-11-30 17:50:00
1238,PHOR,1310,738,304271458.0,304271458.0,45502,27531,6687.0,6743.5,73033,489927530.0,2048,1238,684,303045722.0,303045722.0,45279,27155,6692.9,6744.7,72434,486196726.0,1922,2023-11-30 17:55:00
1239,PHOR,387,282,73986374.0,73986374.0,11058,7855,6690.8,6729.9,18913,126849896.0,669,301,240,70781582.0,70781582.0,10574,7600,6693.9,6731.6,18174,121942014.0,541,2023-11-30 18:00:00
1240,PHOR,388,393,81418083.0,81418083.0,12154,11099,6698.9,6739.7,23253,156221528.0,781,332,338,77419187.0,77419187.0,11555,10828,6700.1,6743.8,22383,150440685.0,670,2023-11-30 18:05:00
1241,PHOR,606,395,131606546.0,131606546.0,19634,13693,6703.0,6665.2,33327,222872703.0,1001,539,350,120824940.0,120824940.0,18022,13156,6704.3,6743.9,31178,209548033.0,889,2023-11-30 18:10:00
1242,PHOR,256,217,44578760.0,44578760.0,6644,6675,6709.6,6742.3,13319,89583525.0,473,190,172,39187106.0,39187106.0,5841,6400,6709.0,6747.7,12241,82372126.0,362,2023-11-30 18:15:00
1243,PHOR,277,306,55098099.0,55098099.0,8208,11029,6712.7,6737.6,19237,129407510.0,583,233,250,50980972.0,50980972.0,7598,10445,6709.8,6753.4,18043,121519791.0,483,2023-11-30 18:20:00
1244,PHOR,739,587,200112795.0,200112795.0,29765,24251,6723.1,6752.4,54016,363864389.0,1326,713,539,195845150.0,195845150.0,29133,23423,6722.5,6767.2,52556,354353861.0,1252,2023-11-30 18:25:00
1245,PHOR,553,219,101014286.0,101014286.0,15073,8092,6701.7,6753.2,23165,155660823.0,772,519,203,99309249.0,99309249.0,14767,8002,6725.1,6764.3,22769,153437213.0,722,2023-11-30 18:30:00
1246,PHOR,461,383,102194451.0,102194451.0,15203,11007,6722.0,6694.2,26210,175877276.0,844,423,353,103009640.0,103009640.0,15324,11223,6722.1,6763.2,26547,178912708.0,776,2023-11-30 18:35:00
1247,PHOR,495,242,88224401.0,88224401.0,13107,6518,6731.1,6757.0,19625,132266451.0,737,496,224,91745292.0,91745292.0,13634,6511,6729.2,6771.3,20145,135832924.0,720,2023-11-30 18:40:00
0,POSI,3272,2213,147329014.0,167008697.0,69289,74907,2126.3,2229.5,144196,314337712.0,5485,2943,1433,132233812.0,98813902.0,62217,46235,2125.4,2137.2,108452,231047715.0,4376,2023-11-01 10:05:00
1,POSI,1273,317,74456203.0,56022748.0,35066,25642,2123.3,2184.8,60708,130478951.0,1590,1172,218,70460473.0,47139315.0,33237,22010,2119.9,2141.7,55247,117599789.0,1390,2023-11-01 10:10:00
2,POSI,808,284,44655254.0,47687079.0,21051,22234,2121.3,2144.8,43285,92342334.0,1092,690,235,42796442.0,44757233.0,20186,20970,2120.1,2134.3,41156,87553675.0,925,2023-11-01 10:15:00
3,POSI,1450,1426,193247746.0,228148537.0,66300,104237,2914.7,2188.7,170537,421396284.0,2876,1152,1235,118855740.0,210022586.0,56000,98031,2122.4,2142.4,154031,328878326.0,2387,2023-11-01 10:20:00
4,POSI,1475,1020,119948911.0,190837582.0,56234,88874,2133.0,2147.3,145108,310786494.0,2495,1361,884,117303051.0,178083402.0,55049,82927,2130.9,2147.5,137976,295386453.0,2245,2023-11-01 10:25:00
5,POSI,3450,1703,514052538.0,310165767.0,220201,143900,2334.5,2155.4,364101,824218305.0,5153,3209,1329,500637134.0,283287298.0,209516,131307,2389.5,2157.4,340823,783924432.0,4538,2023-11-01 10:30:00
6,POSI,576,472,79915550.0,68069288.0,37235,31664,2146.2,2149.7,68899,147984838.0,1048,465,328,73394091.0,53611674.0,34268,24841,2141.8,2158.2,59109,127005766.0,793,2023-11-01 10:35:00
7,POSI,435,456,72408276.0,60684674.0,33742,28324,2145.9,2142.5,62066,133092951.0,891,339,234,67561180.0,39332773.0,31537,18229,2142.3,2157.7,49766,106893954.0,573,2023-11-01 10:40:00
8,POSI,1419,425,158988632.0,93771746.0,73709,43509,2157.0,2155.2,117218,252760378.0,1844,1308,281,154580410.0,80937467.0,71999,37461,2147.0,2160.6,109460,235517877.0,1589,2023-11-01 10:45:00
9,POSI,1018,587,106556218.0,79702213.0,49654,36894,2146.0,2160.3,86548,186258431.0,1605,942,347,104323647.0,74470613.0,48663,34448,2143.8,2161.8,83111,178794260.0,1289,2023-11-01 10:50:00
10,POSI,343,352,46375954.0,53481774.0,21568,25025,2150.2,2137.1,46593,99857729.0,695,245,272,44768163.0,48877037.0,20898,22664,2142.2,2156.6,43562,93645200.0,517,2023-11-01 10:55:00
11,POSI,211,246,25302460.0,44857957.0,11776,20744,2148.6,2162.5,32520,70160418.0,457,159,168,23504432.0,32629470.0,10973,15124,2142.0,2157.5,26097,56133903.0,327,2023-11-01 11:00:00
12,POSI,681,1384,105913740.0,169182374.0,49575,79032,2136.4,2140.7,128607,275096115.0,2065,512,1197,99054949.0,163751313.0,46378,76091,2135.8,2152.0,122469,262806263.0,1709,2023-11-01 11:05:00
13,POSI,751,1603,132679912.0,184456091.0,51370,85912,2582.8,2147.0,137282,317136003.0,2354,681,1567,121023706.0,179930046.0,48932,83661,2473.3,2150.7,132593,300953753.0,2248,2023-11-01 11:10:00
14,POSI,710,208,64825838.0,54254207.0,30307,25185,2139.0,2154.2,55492,119080045.0,918,665,167,66026809.0,53358309.0,30878,24759,2138.3,2155.1,55637,119385118.0,832,2023-11-01 11:15:00
15,POSI,467,129,34485609.0,21476713.0,16123,9987,2138.9,2150.5,26110,55962322.0,596,440,95,30935987.0,22759260.0,14455,10563,2140.2,2154.6,25018,53695247.0,535,2023-11-01 11:20:00
16,POSI,1346,874,153990929.0,128863557.0,71679,59674,2148.3,2159.5,131353,282854487.0,2220,1214,596,148109123.0,119298657.0,69067,55232,2144.4,2160.0,124299,267407781.0,1810,2023-11-01 11:25:00
17,POSI,1831,1516,272532471.0,132283992.0,127109,61410,2144.1,2154.1,188519,404816464.0,3347,1762,1303,271818825.0,129746472.0,126809,60153,2143.5,2156.9,186962,401565297.0,3065,2023-11-01 11:30:00
18,POSI,905,637,100623156.0,63862243.0,46828,29568,2148.8,2159.8,76396,164485399.0,1542,790,591,92143107.0,67832466.0,42984,31413,2143.7,2159.4,74397,159975573.0,1381,2023-11-01 11:35:00
19,POSI,1420,2088,197079642.0,194432811.0,91141,90150,2162.4,2156.8,181291,391512454.0,3508,1298,2004,186239209.0,187107074.0,86741,86599,2147.1,2160.6,173340,373346284.0,3302,2023-11-01 11:40:00
20,POSI,1777,720,241331837.0,161814948.0,111524,74540,2163.9,2170.8,186064,403146786.0,2497,1578,510,227123524.0,144599038.0,105412,66570,2154.6,2172.1,171982,371722562.0,2088,2023-11-01 11:45:00
21,POSI,920,860,120574850.0,99478941.0,55929,45897,2155.9,2167.4,101826,220053792.0,1780,825,771,118749504.0,93719166.0,55120,43196,2154.4,2169.6,98316,212468670.0,1596,2023-11-01 11:50:00
22,POSI,989,312,76983756.0,54237025.0,35579,25004,2163.7,2169.1,60583,131220781.0,1301,895,260,72429981.0,52681572.0,33612,24280,2154.9,2169.8,57892,125111553.0,1155,2023-11-01 11:55:00
23,POSI,627,572,66634194.0,71186079.0,30932,32880,2154.2,2165.0,63812,137820273.0,1199,546,504,64725602.0,68822166.0,30059,31715,2153.3,2170.0,61774,133547768.0,1050,2023-11-01 12:00:00
24,POSI,1218,1700,191532876.0,239059012.0,89249,111023,2146.1,2153.2,200272,430591889.0,2918,1080,1647,172931348.0,232473497.0,80537,107428,2147.2,2164.0,187965,405404845.0,2727,2023-11-01 12:05:00
25,POSI,643,948,59470852.0,144834995.0,27646,66964,2151.2,2162.9,94610,204305848.0,1591,564,895,58716968.0,140928066.0,27336,65130,2148.0,2163.8,92466,199645034.0,1459,2023-11-01 12:10:00
26,POSI,2432,962,197535833.0,105323250.0,91714,48724,2153.8,2161.6,140438,302859083.0,3394,2334,915,194428628.0,102049522.0,90336,47109,2152.3,2166.2,137445,296478150.0,3249,2023-11-01 12:15:00
27,POSI,849,1703,128884535.0,185443310.0,59952,85839,2149.8,2160.4,145791,314327846.0,2552,759,1652,126688433.0,181477663.0,59023,83928,2146.4,2162.3,142951,308166096.0,2411,2023-11-01 12:20:00
28,POSI,1852,533,110046531.0,85660827.0,51103,39602,2153.4,2163.0,90705,195707358.0,2385,1734,497,107802818.0,83079331.0,50076,38393,2152.8,2163.9,88469,190882149.0,2231,2023-11-01 12:25:00
29,POSI,826,342,107009140.0,68886450.0,49470,31750,2163.1,2169.7,81220,175895590.0,1168,733,286,99947475.0,69945247.0,46438,32232,2152.3,2170.1,78670,169892722.0,1019,2023-11-01 12:30:00
30,POSI,378,224,27983518.0,28895253.0,12953,13320,2160.4,2169.3,26273,56878772.0,602,274,185,39879599.0,24253698.0,18688,11175,2134.0,2170.4,29863,64133297.0,459,2023-11-01 12:35:00
31,POSI,1140,531,142020758.0,109713408.0,65619,50421,2164.3,2175.9,116040,251734166.0,1671,1019,450,130508991.0,108345382.0,60470,49780,2158.2,2176.5,110250,238854373.0,1469,2023-11-01 12:40:00
32,POSI,6183,1891,615789392.0,350181655.0,283452,161157,2172.5,2172.9,444609,965971048.0,8074,5886,1596,582839151.0,322838284.0,268801,147804,2168.3,2184.2,416605,905677435.0,7482,2023-11-01 12:45:00
33,POSI,859,538,101385978.0,92352627.0,46834,42416,2164.8,2177.3,89250,193738606.0,1397,731,412,100440462.0,85301348.0,46442,39104,2162.7,2181.4,85546,185741810.0,1143,2023-11-01 12:50:00
34,POSI,822,233,81847635.0,38395838.0,37632,17551,2174.9,2187.7,55183,120243473.0,1055,697,154,76215272.0,30204562.0,35165,13848,2167.4,2181.1,49013,106419834.0,851,2023-11-01 12:55:00
35,POSI,2202,2294,285840100.0,359353474.0,131293,165087,2177.1,2176.8,296380,645193574.0,4496,2002,2107,269374351.0,348492399.0,124228,159636,2168.4,2183.0,283864,617866750.0,4109,2023-11-01 13:00:00
36,POSI,967,577,95928047.0,72465929.0,44121,33170,2174.2,2184.7,77291,168393976.0,1544,840,424,93579463.0,64887344.0,43115,29687,2170.5,2185.7,72802,158466807.0,1264,2023-11-01 13:05:00
37,POSI,857,418,94729305.0,82738549.0,43757,38034,2164.9,2175.4,81791,177467854.0,1275,741,357,90095415.0,80506126.0,41603,36837,2165.6,2185.5,78440,170601542.0,1098,2023-11-01 13:10:00
38,POSI,902,720,173461317.0,228321061.0,80384,85650,2157.9,2665.7,166034,401782378.0,1622,729,616,164969028.0,179354092.0,76491,82362,2156.7,2177.6,158853,344323121.0,1345,2023-11-01 13:15:00
39,POSI,748,371,91589430.0,69527199.0,43253,32037,2117.5,2170.2,75290,161116630.0,1119,619,319,48930143.0,67193550.0,22703,30926,2155.2,2172.7,53629,116123694.0,938,2023-11-01 13:20:00
40,POSI,286,115,18584574.0,21398734.0,8584,9863,2165.0,2169.6,18447,39983309.0,401,225,84,17185541.0,20133438.0,7972,9269,2155.7,2172.1,17241,37318979.0,309,2023-11-01 13:25:00
41,POSI,256,117,14933423.0,18822986.0,6899,8659,2164.6,2173.8,15558,33756410.0,373,245,83,14103296.0,15569117.0,6533,7164,2158.8,2173.2,13697,29672413.0,328,2023-11-01 13:30:00
42,POSI,882,1119,114117716.0,178737254.0,53045,82685,2151.3,2161.7,135730,292854970.0,2001,714,1040,104815909.0,169610076.0,48761,78325,2149.6,2165.5,127086,274425985.0,1754,2023-11-01 13:35:00
43,POSI,1141,497,113789368.0,125035694.0,52473,57726,2168.5,2166.0,110199,238825063.0,1638,991,405,101668495.0,115789890.0,47247,53452,2151.9,2166.2,100699,217458386.0,1396,2023-11-01 13:40:00
44,POSI,1297,695,110764265.0,81028852.0,51400,37384,2154.9,2167.5,88784,191793117.0,1992,1209,646,108989034.0,80636948.0,50586,37178,2154.5,2168.9,87764,189625983.0,1855,2023-11-01 13:45:00
45,POSI,769,285,42848257.0,47071473.0,19883,21671,2155.0,2172.1,41554,89919731.0,1054,670,245,43658344.0,41484335.0,20275,19133,2153.3,2168.2,39408,85142680.0,915,2023-11-01 13:50:00
46,POSI,262,107,22714856.0,14451395.0,10527,6699,2157.8,2157.2,17226,37166252.0,369,197,83,18258125.0,13535869.0,8474,6248,2154.6,2166.4,14722,31793994.0,280,2023-11-01 13:55:00
47,POSI,267,92,14529720.0,11927734.0,6743,5510,2154.8,2164.7,12253,26457454.0,359,218,74,13669394.0,11520597.0,6352,5315,2152.0,2167.6,11667,25189991.0,292,2023-11-01 14:00:00
48,POSI,990,782,123023629.0,100169628.0,57015,46167,2157.7,2169.7,103182,223193257.0,1772,844,740,101189661.0,98805182.0,46995,45530,2153.2,2170.1,92525,199994844.0,1584,2023-11-01 14:05:00
49,POSI,903,362,102492764.0,49734432.0,47489,22911,2158.2,2170.8,70400,152227196.0,1265,829,313,96821547.0,42318587.0,44836,19491,2159.5,2171.2,64327,139140134.0,1142,2023-11-01 14:10:00
50,POSI,1126,188,87029098.0,24999248.0,40250,11516,2162.2,2170.8,51766,112028346.0,1314,1044,145,86046883.0,22022765.0,39828,10134,2160.5,2173.2,49962,108069648.0,1189,2023-11-01 14:15:00
51,POSI,976,1461,115587850.0,91131707.0,53537,41904,2159.0,2174.8,95441,206719558.0,2437,894,1426,114561522.0,87444060.0,53083,40306,2158.2,2169.5,93389,202005582.0,2320,2023-11-01 14:20:00
52,POSI,796,167,73706700.0,19119162.0,34094,8813,2161.9,2169.4,42907,92825862.0,963,731,147,71696413.0,18008594.0,33184,8289,2160.6,2172.6,41473,89705007.0,878,2023-11-01 14:25:00
53,POSI,810,116,135951409.0,27808941.0,62916,12796,2160.8,2173.3,75712,163760350.0,926,746,106,134931019.0,33945604.0,62456,15622,2160.4,2172.9,78078,168876623.0,852,2023-11-01 14:30:00
54,POSI,611,126,72495830.0,18105551.0,33487,8351,2164.9,2168.1,41838,90601381.0,737,567,113,68849796.0,19199308.0,31848,8831,2161.8,2174.1,40679,88049105.0,680,2023-11-01 14:35:00
55,POSI,1204,3812,145036775.0,310302696.0,67336,143191,2153.9,2167.1,210527,455339472.0,5016,1143,3774,141594783.0,304356175.0,65761,140427,2153.2,2167.4,206188,445950959.0,4917,2023-11-01 14:40:00
56,POSI,401,1231,18745924.0,102651789.0,8673,47429,2161.4,2164.3,56102,121397714.0,1632,367,1220,17738208.0,102114203.0,8226,47172,2156.4,2164.7,55398,119852411.0,1587,2023-11-01 14:45:00
57,POSI,495,1713,36042526.0,168955361.0,16736,77965,2153.6,2167.1,94701,204997888.0,2208,435,1690,35151903.0,165764300.0,16326,76566,2153.1,2165.0,92892,200916203.0,2125,2023-11-01 14:50:00
58,POSI,398,658,27754600.0,62414096.0,12902,28813,2151.2,2166.2,41715,90168697.0,1056,367,631,30269920.0,62017513.0,14091,28618,2148.2,2167.1,42709,92287433.0,998,2023-11-01 14:55:00
59,POSI,859,753,65001540.0,117795310.0,30236,54463,2149.8,2162.9,84699,182796851.0,1612,797,705,62423516.0,114570309.0,29058,52904,2148.2,2165.6,81962,176993826.0,1502,2023-11-01 15:00:00
60,POSI,532,2342,58171601.0,193147536.0,27118,89428,2145.1,2159.8,116546,251319137.0,2874,449,2306,54408741.0,190205885.0,25368,87978,2144.8,2162.0,113346,244614626.0,2755,2023-11-01 15:05:00
61,POSI,355,540,26111544.0,130150338.0,12156,60212,2148.0,2161.5,72368,156261883.0,895,317,519,25855709.0,129394375.0,12038,59861,2147.8,2161.6,71899,155250085.0,836,2023-11-01 15:10:00
62,POSI,422,823,59264542.0,117817589.0,27546,54465,2151.5,2163.2,82011,177082131.0,1245,374,787,55797043.0,117069653.0,25967,54116,2148.8,2163.3,80083,172866697.0,1161,2023-11-01 15:15:00
63,POSI,251,169,26792596.0,21203128.0,12429,9786,2155.7,2166.7,22215,47995725.0,420,220,140,25878698.0,20185646.0,12016,9311,2153.7,2167.9,21327,46064344.0,360,2023-11-01 15:20:00
64,POSI,223,136,20926596.0,24750021.0,9715,11418,2154.1,2167.6,21133,45676617.0,359,216,119,25831361.0,26692675.0,9051,12304,2854.0,2169.4,21355,52524036.0,335,2023-11-01 15:25:00
65,POSI,376,138,27962565.0,19714464.0,12957,9070,2158.1,2173.6,22027,47677029.0,514,345,122,27949437.0,16279410.0,12962,7492,2156.3,2172.9,20454,44228847.0,467,2023-11-01 15:30:00
66,POSI,1686,373,158539256.0,65588092.0,73179,30130,2166.5,2176.8,103309,224127349.0,2059,1623,307,138261575.0,63289831.0,64005,29081,2160.2,2176.3,93086,201551406.0,1930,2023-11-01 15:35:00
67,POSI,1945,830,283246618.0,181833173.0,130478,83242,2170.8,2184.4,213720,465079791.0,2775,1830,612,258609822.0,173951548.0,119301,79534,2167.7,2187.1,198835,432561371.0,2442,2023-11-01 15:40:00
68,POSI,1088,503,121964989.0,83897320.0,56174,38500,2171.2,2179.2,94674,205862309.0,1591,1011,393,121200302.0,74327928.0,55855,33973,2169.9,2187.9,89828,195528230.0,1404,2023-11-01 15:45:00
69,POSI,645,1003,84471557.0,69312743.0,38976,31931,2167.3,2170.7,70907,153784300.0,1648,600,907,85303821.0,62885563.0,39368,28783,2166.8,2184.8,68151,148189385.0,1507,2023-11-01 15:50:00
70,POSI,1765,1152,281700360.0,197051283.0,129970,90408,2167.4,2179.6,220378,478751644.0,2917,1673,1041,260053190.0,189919826.0,120067,86901,2165.9,2185.5,206968,449973017.0,2714,2023-11-01 15:55:00
71,POSI,780,491,116971529.0,80351880.0,53776,36678,2175.2,2190.7,90454,197323409.0,1271,706,368,112060101.0,74423131.0,51572,33946,2172.9,2192.4,85518,186483232.0,1074,2023-11-01 16:00:00
72,POSI,745,397,119755600.0,62522177.0,55128,28703,2172.3,2178.2,83831,182277777.0,1142,686,325,115590582.0,58071622.0,53278,26532,2169.6,2188.7,79810,173662205.0,1011,2023-11-01 16:05:00
73,POSI,577,506,81643444.0,60844865.0,37585,27803,2172.2,2188.4,65388,142488309.0,1083,536,451,77890408.0,59684989.0,35874,27245,2171.2,2190.7,63119,137575397.0,987,2023-11-01 16:10:00
74,POSI,312,238,38275703.0,40171637.0,17639,18376,2169.9,2186.1,36015,78447340.0,550,302,196,37613779.0,35218062.0,17335,16080,2169.8,2190.2,33415,72831841.0,498,2023-11-01 16:15:00
75,POSI,542,263,62481538.0,26588507.0,28746,12238,2173.6,2172.6,40984,89070046.0,805,485,227,63589849.0,27542873.0,29298,12602,2170.5,2185.6,41900,91132722.0,712,2023-11-01 16:20:00
76,POSI,1078,435,71551483.0,32264667.0,32949,14856,2171.6,2171.8,47805,103816150.0,1513,1031,389,69109616.0,30867955.0,31840,14122,2170.5,2185.8,45962,99977571.0,1420,2023-11-01 16:25:00
77,POSI,815,969,67784392.0,65386202.0,31245,30189,2169.4,2165.9,61434,133170595.0,1784,770,934,65589891.0,62347826.0,30269,28629,2166.9,2177.8,58898,127937717.0,1704,2023-11-01 16:30:00
78,POSI,498,1291,66778994.0,192897033.0,30795,88501,2168.5,2179.6,119296,259676027.0,1789,430,1242,64719296.0,191203368.0,29866,87711,2167.0,2179.9,117577,255922665.0,1672,2023-11-01 16:35:00
79,POSI,369,944,28815215.0,60863432.0,13264,27986,2172.4,2174.8,41250,89678647.0,1313,310,918,27107534.0,59816739.0,12519,27491,2165.3,2175.9,40010,86924274.0,1228,2023-11-01 16:40:00
80,POSI,392,400,20348695.0,60948290.0,9346,28017,2177.3,2175.4,37363,81296986.0,792,366,383,18555894.0,60031068.0,8564,27559,2166.7,2178.3,36123,78586962.0,749,2023-11-01 16:45:00
81,POSI,189,173,7597820.0,24931559.0,3510,11453,2164.6,2176.9,14963,32529380.0,362,160,143,7973069.0,22036695.0,3685,10123,2163.7,2176.9,13808,30009765.0,303,2023-11-01 16:50:00
82,POSI,306,169,22142917.0,28272549.0,10110,13045,2190.2,2167.3,23155,50415466.0,475,276,154,20635634.0,31433141.0,9530,14434,2165.3,2177.7,23964,52068776.0,430,2023-11-01 16:55:00
83,POSI,656,481,39130995.0,82151413.0,17992,37795,2174.9,2173.6,55787,121282409.0,1137,579,448,37827625.0,80292585.0,17441,36845,2168.9,2179.2,54286,118120210.0,1027,2023-11-01 17:00:00
84,POSI,313,332,25803174.0,61531962.0,11884,28260,2171.3,2177.4,40144,87335136.0,645,283,274,26680328.0,60790576.0,12316,27901,2166.3,2178.8,40217,87470905.0,557,2023-11-01 17:05:00
85,POSI,596,3379,68171777.0,324115411.0,31417,148796,2169.9,2178.3,180213,392287188.0,3975,559,3316,65984988.0,322984871.0,30452,148265,2166.9,2178.4,178717,388969859.0,3875,2023-11-01 17:10:00
86,POSI,600,273,33485806.0,30823656.0,15429,14140,2170.3,2179.9,29569,64309462.0,873,557,219,31173837.0,30207099.0,14375,13852,2168.6,2180.7,28227,61380937.0,776,2023-11-01 17:15:00
87,POSI,261,192,18427899.0,18780965.0,8490,8613,2170.5,2180.5,17103,37208865.0,453,241,161,15500956.0,15533815.0,7143,7117,2170.1,2182.6,14260,31034771.0,402,2023-11-01 17:20:00
88,POSI,134,71,7701058.0,6858938.0,3540,3147,2175.4,2179.5,6687,14559996.0,205,116,54,6122213.0,5306074.0,2822,2430,2169.5,2183.6,5252,11428288.0,170,2023-11-01 17:25:00
89,POSI,219,163,15806039.0,16912284.0,7301,7809,2164.9,2165.7,15110,32718323.0,382,211,106,15682501.0,12793725.0,7244,5854,2164.9,2185.5,13098,28476226.0,317,2023-11-01 17:30:00
90,POSI,182,229,9835152.0,31635458.0,4554,14513,2159.7,2179.8,19067,41470610.0,411,158,208,9723008.0,30709042.0,4502,14075,2159.7,2181.8,18577,40432050.0,366,2023-11-01 17:35:00
91,POSI,320,320,20725435.0,36087958.0,9567,16564,2166.3,2178.7,26131,56813393.0,640,237,283,18951081.0,34688727.0,8761,15914,2163.1,2179.8,24675,53639809.0,520,2023-11-01 17:40:00
92,POSI,218,205,17170253.0,22639684.0,7927,10398,2166.0,2177.3,18325,39809937.0,423,190,180,16448894.0,21027221.0,7614,9624,2160.3,2184.9,17238,37476115.0,370,2023-11-01 17:45:00
93,POSI,395,103,19532908.0,10611226.0,9086,3961,2149.8,2678.9,13047,30144135.0,498,387,94,17379040.0,6628565.0,8019,3030,2167.2,2187.6,11049,24007606.0,481,2023-11-01 17:50:00
94,POSI,349,133,39262129.0,16140527.0,18128,7457,2165.8,2164.5,25585,55402656.0,482,311,108,38586655.0,15710174.0,17817,7193,2165.7,2184.1,25010,54296829.0,419,2023-11-01 17:55:00
95,POSI,846,700,59311947.0,48707521.0,27324,22457,2170.7,2168.9,49781,108019468.0,1546,793,673,56746026.0,47650517.0,26215,21909,2164.6,2174.9,48124,104396544.0,1466,2023-11-01 18:00:00
96,POSI,366,84,39503804.0,10754987.0,18245,4925,2165.2,2183.8,23170,50258791.0,450,359,80,39472333.0,10418808.0,18252,4768,2162.6,2185.2,23020,49891141.0,439,2023-11-01 18:05:00
97,POSI,257,128,30995445.0,18436875.0,14336,8503,2162.1,2168.3,22839,49432320.0,385,229,105,32664468.0,20181577.0,15107,9248,2162.2,2182.3,24355,52846046.0,334,2023-11-01 18:10:00
98,POSI,726,142,46744634.0,24322608.0,21568,11154,2167.3,2180.6,32722,71067243.0,868,719,128,44172549.0,23225366.0,20403,10645,2165.0,2181.8,31048,67397915.0,847,2023-11-01 18:15:00
99,POSI,529,97,50175787.0,5991133.0,23105,2740,2171.6,2186.5,25845,56166921.0,626,502,87,52397199.0,5898382.0,24170,2697,2167.9,2187.0,26867,58295581.0,589,2023-11-01 18:20:00
100,POSI,603,198,43802449.0,29995328.0,20216,12936,2166.7,2318.7,33152,73797777.0,801,571,167,40842544.0,27406864.0,18857,11672,2165.9,2348.1,30529,68249408.0,738,2023-11-01 18:25:00
101,POSI,243,469,16184190.0,27212301.0,7462,12516,2168.9,2174.2,19978,43396491.0,712,230,440,15812404.0,26240298.0,7300,12067,2166.1,2174.6,19367,42052703.0,670,2023-11-01 18:30:00
102,POSI,127,140,4466194.0,15126028.0,2050,6945,2178.6,2178.0,8995,19592222.0,267,115,128,4127623.0,14307833.0,1916,6569,2154.3,2178.1,8485,18435457.0,243,2023-11-01 18:35:00
103,POSI,458,667,28647167.0,80311902.0,13270,36914,2158.8,2175.6,50184,108959069.0,1125,433,662,27042942.0,79949250.0,12533,36735,2157.7,2176.4,49268,106992192.0,1095,2023-11-01 18:40:00
104,POSI,3669,2314,250545770.0,239904117.0,114804,105277,2182.4,2278.8,220081,490449887.0,5983,3144,1183,218555554.0,144398656.0,100121,65671,2182.9,2198.8,165792,362954211.0,4327,2023-11-02 10:05:00
105,POSI,1137,571,83704027.0,94981339.0,38211,43142,2190.6,2201.6,81353,178685366.0,1708,1003,397,75532740.0,84015026.0,34663,38172,2179.1,2201.0,72835,159547767.0,1400,2023-11-02 10:10:00
106,POSI,1354,1243,101224700.0,197427669.0,46513,77945,2176.3,2532.9,124458,298652370.0,2597,1218,1102,94259329.0,163147606.0,43360,74375,2173.9,2193.6,117735,257406936.0,2320,2023-11-02 10:15:00
107,POSI,746,491,64618397.0,60226789.0,29297,27189,2205.6,2215.1,56486,124845187.0,1237,621,371,51225681.0,49228789.0,23537,22373,2176.4,2200.4,45910,100454471.0,992,2023-11-02 10:20:00
108,POSI,448,394,53606205.0,55038037.0,24473,25052,2190.4,2197.0,49525,108644242.0,842,386,335,42052349.0,51411067.0,19279,23379,2181.3,2199.0,42658,93463417.0,721,2023-11-02 10:25:00
109,POSI,406,465,64018565.0,94705974.0,29400,43165,2177.5,2194.0,72565,158724539.0,871,310,366,60371117.0,90652628.0,27746,41284,2175.8,2195.8,69030,151023746.0,676,2023-11-02 10:30:00
110,POSI,784,379,118749681.0,42974338.0,54214,19545,2190.4,2198.7,73759,161724019.0,1163,678,324,99014635.0,41385374.0,45356,18828,2183.1,2198.1,64184,140400010.0,1002,2023-11-02 10:35:00
111,POSI,817,277,108067223.0,43064888.0,49364,19546,2189.2,2203.3,68910,151132112.0,1094,711,242,101946715.0,37437430.0,46654,17010,2185.2,2200.9,63664,139384146.0,953,2023-11-02 10:40:00
112,POSI,554,201,43956176.0,19748166.0,20041,8989,2193.3,2196.9,29030,63704342.0,755,473,129,41241423.0,17252818.0,18867,7846,2185.9,2198.9,26713,58494242.0,602,2023-11-02 10:45:00
113,POSI,456,269,49488158.0,20108164.0,22611,9160,2188.7,2195.2,31771,69596323.0,725,393,145,45637954.0,17213249.0,20876,7828,2186.1,2198.9,28704,62851204.0,538,2023-11-02 10:50:00
114,POSI,341,369,43870293.0,44210894.0,20123,20136,2180.1,2195.6,40259,88081188.0,710,271,232,42568121.0,40999032.0,19518,18646,2181.0,2198.8,38164,83567153.0,503,2023-11-02 10:55:00
115,POSI,731,490,54330808.0,55802105.0,24835,25271,2187.7,2208.1,50106,110132913.0,1221,660,432,51710053.0,52839916.0,23697,24068,2182.1,2195.4,47765,104549969.0,1092,2023-11-02 11:00:00
116,POSI,367,526,38146385.0,46196148.0,17488,21071,2181.3,2192.4,38559,84342534.0,893,281,479,35128796.0,44553199.0,16119,20286,2179.3,2196.3,36405,79681995.0,760,2023-11-02 11:05:00
117,POSI,227,294,23245183.0,27045985.0,10633,12329,2186.1,2193.7,22962,50291169.0,521,178,223,21924340.0,24618649.0,10048,11213,2182.0,2195.5,21261,46542989.0,401,2023-11-02 11:10:00
118,POSI,185,274,22622888.0,33121301.0,10375,15204,2180.5,2178.5,25579,55744189.0,459,162,222,22874547.0,31561008.0,10490,14376,2180.6,2195.4,24866,54435555.0,384,2023-11-02 11:15:00
119,POSI,1148,1027,137579751.0,150160655.0,63144,68595,2178.8,2189.1,131739,287740406.0,2175,1062,862,134205352.0,142516643.0,61618,65005,2178.0,2192.4,126623,276721995.0,1924,2023-11-02 11:20:00
120,POSI,756,516,75963710.0,63960950.0,34848,29206,2179.9,2190.0,64054,139924661.0,1272,700,428,74284824.0,59609802.0,34097,27196,2178.6,2191.9,61293,133894626.0,1128,2023-11-02 11:25:00
121,POSI,979,1160,85252413.0,102002312.0,39095,46750,2180.6,2181.9,85845,187254726.0,2139,960,1136,87064387.0,98882261.0,39956,45150,2179.0,2190.1,85106,185946648.0,2096,2023-11-02 11:30:00
122,POSI,294,394,46188779.0,68079657.0,21250,31194,2173.6,2182.5,52444,114268437.0,688,228,347,40518941.0,66033760.0,18654,30187,2172.1,2187.5,48841,106552701.0,575,2023-11-02 11:35:00
123,POSI,288,372,34609448.0,58218764.0,15876,26610,2180.0,2187.9,42486,92828212.0,660,236,346,31039822.0,56786032.0,14275,25930,2174.4,2190.0,40205,87825854.0,582,2023-11-02 11:40:00
124,POSI,330,796,50725218.0,76970089.0,23254,35140,2181.4,2190.4,58394,127695308.0,1126,285,754,49155243.0,75788346.0,22580,34594,2176.9,2190.8,57174,124943590.0,1039,2023-11-02 11:45:00
125,POSI,314,287,37282096.0,16434331.0,17082,7508,2182.5,2188.9,24590,53716428.0,601,313,287,37199103.0,16047621.0,17053,7331,2181.4,2189.0,24384,53246724.0,600,2023-11-02 11:50:00
126,POSI,1705,1320,275351597.0,212014608.0,125527,96348,2193.6,2200.5,221875,487366205.0,3025,1499,1164,245390126.0,203530060.0,112411,92493,2183.0,2200.5,204904,448920186.0,2663,2023-11-02 11:55:00
127,POSI,1319,693,182851490.0,138324430.0,83608,62775,2187.0,2203.5,146383,321175921.0,2012,1173,553,172524326.0,129621567.0,79026,58870,2183.1,2201.8,137896,302145893.0,1726,2023-11-02 12:00:00
128,POSI,454,795,79545073.0,77945161.0,36233,35521,2195.4,2194.3,71754,157490234.0,1249,395,713,77639039.0,71065642.0,35564,32301,2183.1,2200.1,67865,148704681.0,1108,2023-11-02 12:05:00
129,POSI,612,1156,46944047.0,72396146.0,21518,33011,2181.6,2193.1,54529,119340194.0,1768,577,1113,46865201.0,69738318.0,21481,31764,2181.7,2195.5,53245,116603519.0,1690,2023-11-02 12:10:00
130,POSI,154,144,14531862.0,17628126.0,6640,8045,2188.5,2191.2,14685,32159988.0,298,143,135,13506804.0,17155207.0,6190,7814,2182.0,2195.4,14004,30662011.0,278,2023-11-02 12:15:00
131,POSI,210,194,35908873.0,36164787.0,16494,16470,2177.1,2195.8,32964,72073660.0,404,203,165,34652824.0,30743581.0,15910,13985,2178.1,2198.3,29895,65396405.0,368,2023-11-02 12:20:00
132,POSI,232,137,15425039.0,14324589.0,7049,6528,2188.3,2194.3,13577,29749628.0,369,154,99,13840947.0,13715295.0,6356,6246,2177.6,2195.9,12602,27556242.0,253,2023-11-02 12:25:00
133,POSI,194,105,12015218.0,9455171.0,5490,4309,2188.6,2194.3,9799,21470390.0,299,180,89,11484481.0,7681632.0,5268,3501,2180.0,2194.1,8769,19166113.0,269,2023-11-02 12:30:00
134,POSI,240,489,43838729.0,43483527.0,20175,19834,2172.9,2192.4,40009,87322256.0,729,198,442,33192951.0,41537159.0,15253,18936,2176.2,2193.6,34189,74730111.0,640,2023-11-02 12:35:00
135,POSI,158,470,17089308.0,33563910.0,7847,15372,2177.8,2183.4,23219,50653219.0,628,148,466,16588489.0,32283326.0,7618,14740,2177.5,2190.2,22358,48871815.0,614,2023-11-02 12:40:00
136,POSI,240,158,29932303.0,25803289.0,13745,11868,2177.7,2174.2,25613,55735592.0,398,182,117,28805416.0,22531748.0,13232,10268,2177.0,2194.4,23500,51337165.0,299,2023-11-02 12:45:00
137,POSI,386,113,33956538.0,13643384.0,15561,6226,2182.2,2191.4,21787,47599922.0,499,372,106,32639709.0,12064382.0,14963,5498,2181.4,2194.3,20461,44704092.0,478,2023-11-02 12:50:00
138,POSI,117,88,14442314.0,9234754.0,6634,4214,2177.0,2191.4,10848,23677069.0,205,93,87,13455622.0,8862833.0,6174,4043,2179.4,2192.1,10217,22318455.0,180,2023-11-02 12:55:00
139,POSI,169,135,16069483.0,15094714.0,7355,6882,2184.8,2193.4,14237,31164197.0,304,134,102,14481424.0,14735991.0,6650,6628,2177.7,2223.3,13278,29217416.0,236,2023-11-02 13:00:00
140,POSI,202,126,20340456.0,12944647.0,9302,5909,2186.7,2190.7,15211,33285104.0,328,170,104,19710662.0,11302038.0,9040,5155,2180.4,2192.4,14195,31012700.0,274,2023-11-02 13:05:00
141,POSI,166,223,15868839.0,22782014.0,7280,10466,2179.8,2176.8,17746,38650853.0,389,156,200,15397004.0,21197392.0,7071,9671,2177.5,2191.9,16742,36594396.0,356,2023-11-02 13:10:00
142,POSI,180,168,23059037.0,18731956.0,10596,8568,2176.2,2186.3,19164,41790993.0,348,143,161,21882911.0,18644709.0,10055,8505,2176.3,2192.2,18560,40527621.0,304,2023-11-02 13:15:00
143,POSI,193,127,17739062.0,8618710.0,8134,3935,2180.9,2190.3,12069,26357773.0,320,172,115,17253504.0,8663592.0,7917,3953,2179.3,2191.6,11870,25917096.0,287,2023-11-02 13:20:00
144,POSI,129,155,20333720.0,20775129.0,9341,9472,2176.8,2193.3,18813,41108850.0,284,122,154,19700026.0,20920984.0,9063,9532,2173.7,2194.8,18595,40621010.0,276,2023-11-02 13:25:00
145,POSI,165,350,27863207.0,37278151.0,12809,17020,2175.3,2190.3,29829,65141358.0,515,145,324,27122079.0,33585523.0,12473,15328,2174.5,2191.1,27801,60707602.0,469,2023-11-02 13:30:00
146,POSI,157,138,12270035.0,16189814.0,5643,7396,2174.4,2189.0,13039,28459850.0,295,117,128,11444066.0,15127062.0,5267,6903,2172.8,2191.4,12170,26571129.0,245,2023-11-02 13:35:00
147,POSI,145,147,13579742.0,17052575.0,6232,7782,2179.0,2191.3,14014,30632318.0,292,126,136,11701243.0,16462971.0,5381,7513,2174.5,2191.3,12894,28164215.0,262,2023-11-02 13:40:00
148,POSI,178,113,7989396.0,10340475.0,3663,4728,2181.1,2187.1,8391,18329871.0,291,144,105,7135389.0,10173275.0,3277,4644,2177.4,2190.6,7921,17308664.0,249,2023-11-02 13:45:00
149,POSI,199,134,32314427.0,11152481.0,14823,5099,2180.0,2187.2,19922,43466909.0,333,194,115,10754465.0,10923700.0,4940,4987,2177.0,2190.4,9927,21678166.0,309,2023-11-02 13:50:00
150,POSI,167,168,12522503.0,15417663.0,5689,7055,2201.2,2185.4,12744,27940166.0,335,107,152,9616607.0,15111394.0,4415,6904,2178.2,2188.8,11319,24728001.0,259,2023-11-02 13:55:00
151,POSI,211,229,35788679.0,40370916.0,16415,18392,2180.2,2195.0,34807,76159596.0,440,179,195,30214849.0,36410088.0,13889,16587,2175.5,2195.1,30476,66624938.0,374,2023-11-02 14:00:00
152,POSI,452,100,32046134.0,22446364.0,14694,10248,2180.9,2190.3,24942,54492498.0,552,433,94,30674471.0,21276151.0,14083,9695,2178.1,2194.5,23778,51950622.0,527,2023-11-02 14:05:00
153,POSI,363,341,19020687.0,20714069.0,8695,9472,2187.5,2186.9,18167,39734756.0,704,343,338,18110396.0,19930579.0,8292,9114,2184.1,2186.8,17406,38040976.0,681,2023-11-02 14:10:00
154,POSI,691,125,40487078.0,16815344.0,18491,7678,2189.6,2190.1,26169,57302422.0,816,670,114,38743148.0,16629056.0,17742,7591,2183.7,2190.6,25333,55372204.0,784,2023-11-02 14:15:00
155,POSI,121,71,17591817.0,10588828.0,8069,4824,2180.2,2195.0,12893,28180646.0,192,104,54,22236314.0,9369980.0,10236,4267,2172.4,2195.9,14503,31606294.0,158,2023-11-02 14:20:00
156,POSI,320,109,44182055.0,21650158.0,20227,9874,2184.3,2192.6,30101,65832214.0,429,306,95,39205755.0,19034753.0,17971,8678,2181.6,2193.4,26649,58240508.0,401,2023-11-02 14:25:00
157,POSI,94,126,17515448.0,23595924.0,8045,10791,2177.2,2186.6,18836,41111372.0,220,79,112,17678268.0,23539699.0,8117,10746,2177.9,2190.6,18863,41217967.0,191,2023-11-02 14:30:00
158,POSI,156,115,10103246.0,12729281.0,4630,5814,2182.1,2189.4,10444,22832528.0,271,124,101,9455872.0,12353798.0,4342,5642,2177.8,2189.6,9984,21809671.0,225,2023-11-02 14:35:00
159,POSI,63,60,3070857.0,6928336.0,1409,3166,2179.5,2188.4,4575,9999193.0,123,47,44,3383576.0,6858568.0,1552,3134,2180.1,2188.4,4686,10242144.0,91,2023-11-02 14:40:00
160,POSI,128,70,23277230.0,13931361.0,10687,6371,2178.1,2186.7,17058,37208592.0,198,97,56,22541293.0,13049610.0,10372,5959,2173.3,2189.9,16331,35590904.0,153,2023-11-02 14:45:00
161,POSI,118,52,8895939.0,9121233.0,4080,4187,2180.4,2178.5,8267,18017173.0,170,93,47,7671253.0,8765854.0,3524,4004,2176.9,2189.3,7528,16437108.0,140,2023-11-02 14:50:00
162,POSI,133,411,21142872.0,38999050.0,9716,17821,2176.1,2188.4,27537,60141922.0,544,94,392,20021377.0,37949257.0,9208,17334,2174.3,2189.3,26542,57970634.0,486,2023-11-02 14:55:00
163,POSI,189,105,17977189.0,20472231.0,8252,9348,2178.5,2190.0,17600,38449421.0,294,154,95,17047175.0,19885755.0,7837,9068,2175.2,2193.0,16905,36932931.0,249,2023-11-02 15:00:00
164,POSI,129,77,11917320.0,12945752.0,5481,5905,2174.3,2192.3,11386,24863072.0,206,114,69,11746047.0,12222850.0,5403,5574,2174.0,2192.8,10977,23968897.0,183,2023-11-02 15:05:00
165,POSI,119,102,5685621.0,9014123.0,2609,4117,2179.2,2189.5,6726,14699745.0,221,81,78,5889000.0,7983017.0,2704,3645,2177.9,2190.1,6349,13872017.0,159,2023-11-02 15:10:00
166,POSI,118,72,7268850.0,8211998.0,3328,3747,2184.1,2191.6,7075,15480849.0,190,95,73,6220014.0,7908458.0,2856,3609,2177.9,2191.3,6465,14128472.0,168,2023-11-02 15:15:00
167,POSI,161,100,15017770.0,17108065.0,6907,7816,2174.3,2188.9,14723,32125836.0,261,139,90,14708117.0,17379094.0,6766,7917,2173.8,2195.2,14683,32087211.0,229,2023-11-02 15:20:00
168,POSI,173,93,10191684.0,7489166.0,4675,3423,2180.0,2187.9,8098,17680850.0,266,142,79,8955359.0,7065727.0,4109,3224,2179.4,2191.6,7333,16021086.0,221,2023-11-02 15:25:00
169,POSI,177,72,11758944.0,5262407.0,5389,2412,2182.0,2181.8,7801,17021351.0,249,143,55,9983348.0,5393749.0,4579,2449,2180.2,2202.4,7028,15377097.0,198,2023-11-02 15:30:00
170,POSI,276,101,26350594.0,17795334.0,12063,8115,2184.4,2192.9,20178,44145929.0,377,249,90,26308292.0,16600381.0,12073,7564,2179.1,2194.7,19637,42908674.0,339,2023-11-02 15:35:00
171,POSI,191,72,16306503.0,8200311.0,7473,3749,2182.1,2187.3,11222,24506814.0,263,183,66,16067433.0,7774496.0,7365,3549,2181.6,2190.6,10914,23841930.0,249,2023-11-02 15:40:00
172,POSI,865,97,49345130.0,13440377.0,22597,6132,2183.7,2191.8,28729,62785507.0,962,868,87,48965026.0,12789212.0,22429,5832,2183.1,2192.9,28261,61754239.0,955,2023-11-02 15:45:00
173,POSI,693,84,54523198.0,13641414.0,24936,6217,2186.5,2194.2,31153,68164612.0,777,647,86,53382322.0,13247487.0,24499,6032,2179.0,2196.2,30531,66629809.0,733,2023-11-02 15:50:00
174,POSI,397,528,48891168.0,49987884.0,22446,22813,2178.2,2191.2,45259,98879052.0,925,391,470,49133536.0,49386662.0,22561,22534,2177.8,2191.7,45095,98520199.0,861,2023-11-02 15:55:00
175,POSI,265,156,18337684.0,13377429.0,8388,6107,2186.2,2190.5,14495,31715113.0,421,231,128,20895450.0,16513385.0,9586,7533,2179.8,2192.1,17119,37408836.0,359,2023-11-02 16:00:00
176,POSI,380,116,28405886.0,18832828.0,12956,8592,2192.5,2191.9,21548,47238714.0,496,356,114,26834887.0,18647870.0,12301,8509,2181.5,2191.5,20810,45482757.0,470,2023-11-02 16:05:00
177,POSI,1245,988,50853581.0,77955924.0,23309,35738,2181.7,2181.3,59047,128809505.0,2233,1209,964,50829587.0,76418601.0,23306,34912,2181.0,2188.9,58218,127248188.0,2173,2023-11-02 16:10:00
178,POSI,472,540,35815776.0,37901808.0,16222,17319,2207.9,2188.5,33541,73717584.0,1012,437,512,32876349.0,36052778.0,15075,16471,2180.9,2188.9,31546,68929128.0,949,2023-11-02 16:15:00
179,POSI,414,95,28574597.0,8353083.0,13092,3818,2182.6,2187.8,16910,36927680.0,509,389,86,27909602.0,8141426.0,12795,3714,2181.3,2192.1,16509,36051028.0,475,2023-11-02 16:20:00
180,POSI,163,99,11001843.0,12118957.0,5047,5535,2179.9,2189.5,10582,23120801.0,262,148,96,9029605.0,12038797.0,4143,5497,2179.5,2190.1,9640,21068403.0,244,2023-11-02 16:25:00
181,POSI,155,113,8796782.0,8173045.0,3968,3729,2216.9,2191.8,7697,16969828.0,268,139,85,7997167.0,7858827.0,3668,3586,2180.3,2191.5,7254,15855994.0,224,2023-11-02 16:30:00
182,POSI,254,106,18835585.0,7786855.0,8615,3557,2186.4,2189.2,12172,26622440.0,360,240,96,16800848.0,7484117.0,7701,3414,2181.6,2192.2,11115,24284966.0,336,2023-11-02 16:35:00
183,POSI,215,277,17049898.0,14971008.0,7815,6844,2181.7,2187.5,14659,32020906.0,492,203,268,16551410.0,14560989.0,7590,6643,2180.7,2191.9,14233,31112399.0,471,2023-11-02 16:40:00
184,POSI,177,139,9588913.0,6173667.0,4397,2816,2180.8,2192.4,7213,15762581.0,316,141,121,8545335.0,5889027.0,3919,2686,2180.5,2192.5,6605,14434362.0,262,2023-11-02 16:45:00
185,POSI,189,87,13246303.0,8266501.0,6075,3770,2180.5,2192.7,9845,21512804.0,276,183,81,12824679.0,8134276.0,5885,3707,2179.2,2194.3,9592,20958956.0,264,2023-11-02 16:50:00
186,POSI,192,86,21989382.0,11638352.0,9890,5307,2223.4,2193.0,15197,33627735.0,278,154,77,18763858.0,11184320.0,8602,5097,2181.3,2194.3,13699,29948179.0,231,2023-11-02 16:55:00
187,POSI,504,208,56150641.0,32996313.0,25561,15025,2196.7,2196.1,40586,89146955.0,712,459,165,51616934.0,29664540.0,23652,13506,2182.3,2196.4,37158,81281474.0,624,2023-11-02 17:00:00
188,POSI,258,100,8065191.0,4682598.0,3688,2139,2186.9,2189.2,5827,12747789.0,358,264,91,9738644.0,4538087.0,4461,2066,2183.1,2196.6,6527,14276731.0,355,2023-11-02 17:05:00
189,POSI,244,115,14591888.0,5707816.0,6661,2607,2190.6,2189.4,9268,20299705.0,359,220,91,19395421.0,6058270.0,8960,2761,2164.7,2194.2,11721,25453692.0,311,2023-11-02 17:10:00
190,POSI,295,274,31019723.0,44712271.0,14218,20651,2181.7,2165.1,34869,75731995.0,569,290,233,33226824.0,41421964.0,15251,18895,2178.7,2192.2,34146,74648788.0,523,2023-11-02 17:15:00
191,POSI,255,288,14366099.0,27383007.0,6590,12565,2180.0,2179.3,19155,41749106.0,543,191,259,11444158.0,20498355.0,5260,9366,2175.7,2188.6,14626,31942513.0,450,2023-11-02 17:20:00
192,POSI,237,233,23547608.0,36291182.0,10981,16730,2144.4,2169.2,27711,59838790.0,470,201,210,17803179.0,33745952.0,8262,15426,2154.8,2187.6,23688,51549131.0,411,2023-11-02 17:25:00
193,POSI,237,165,7531644.0,13403318.0,3452,6145,2181.8,2181.2,9597,20934962.0,402,212,150,6447015.0,12522259.0,2960,5724,2178.0,2187.7,8684,18969274.0,362,2023-11-02 17:30:00
194,POSI,208,151,9959223.0,8905395.0,4547,4098,2190.3,2173.1,8645,18864619.0,359,185,135,12152848.0,11881833.0,5591,5424,2173.6,2190.6,11015,24034681.0,320,2023-11-02 17:35:00
195,POSI,162,302,15482903.0,46794186.0,7134,21848,2170.3,2141.8,28982,62277089.0,464,156,244,12835884.0,35713277.0,5910,16320,2171.9,2188.3,22230,48549161.0,400,2023-11-02 17:40:00
196,POSI,1350,1743,196027868.0,274803234.0,90244,126790,2172.2,2167.4,217034,470831102.0,3093,1196,1575,185021606.0,251626555.0,85244,115179,2170.5,2184.7,200423,436648161.0,2771,2023-11-02 17:45:00
197,POSI,2018,859,254590682.0,148489155.0,117224,67965,2171.8,2184.8,185189,403079838.0,2877,1948,755,250105049.0,127190923.0,115303,58148,2169.1,2187.4,173451,377295972.0,2703,2023-11-02 17:50:00
198,POSI,861,292,88041220.0,39093588.0,40254,17927,2187.1,2180.7,58181,127134809.0,1153,792,204,85795206.0,39729210.0,39539,18166,2169.9,2187.0,57705,125524416.0,996,2023-11-02 17:55:00
199,POSI,1115,114,139645336.0,10880365.0,64084,4989,2179.1,2180.9,69073,150525702.0,1229,1096,93,138895206.0,11795911.0,63900,5391,2173.6,2188.1,69291,150691118.0,1189,2023-11-02 18:00:00
200,POSI,199,118,31432606.0,14636615.0,14483,6726,2170.3,2176.1,21209,46069221.0,317,154,93,31006486.0,18071338.0,14304,8239,2167.7,2193.4,22543,49077824.0,247,2023-11-02 18:05:00
201,POSI,1314,2601,197863754.0,382881631.0,91486,176398,2162.8,2170.6,267884,580745386.0,3915,1234,2540,192837025.0,374377100.0,89153,172124,2163.0,2175.0,261277,567214126.0,3774,2023-11-02 18:10:00
202,POSI,2425,1081,238509909.0,203714017.0,95629,93611,2494.1,2176.2,189240,442223926.0,3506,2337,1046,205673547.0,199192103.0,95022,91529,2164.5,2176.3,186551,404865650.0,3383,2023-11-02 18:15:00
203,POSI,259,293,20593240.0,56185171.0,9521,25839,2162.9,2174.4,35360,76778412.0,552,206,263,20048849.0,54563050.0,9279,25048,2160.7,2178.3,34327,74611899.0,469,2023-11-02 18:20:00
204,POSI,182,175,12635914.0,18824791.0,5822,8628,2170.4,2181.8,14450,31460705.0,357,158,142,9325428.0,14857919.0,4313,6808,2162.2,2182.4,11121,24183348.0,300,2023-11-02 18:25:00
205,POSI,337,850,24192101.0,97954136.0,11158,45133,2168.1,2170.3,56291,122146237.0,1187,336,834,24575237.0,96910616.0,11339,44547,2167.3,2175.5,55886,121485853.0,1170,2023-11-02 18:30:00
206,POSI,499,585,47682045.0,121821477.0,21999,56005,2167.5,2175.2,78004,169503522.0,1084,492,572,47683603.0,120706449.0,22016,55440,2165.9,2177.2,77456,168390052.0,1064,2023-11-02 18:35:00
207,POSI,237,1967,46142268.0,310207267.0,21375,140804,2158.7,2203.1,162179,356349535.0,2204,210,1913,48056995.0,308939741.0,22268,141814,2158.1,2178.5,164082,356996736.0,2123,2023-11-02 18:40:00
208,POSI,1284,2846,114487484.0,286664564.0,53174,128301,2153.1,2234.3,181475,401152049.0,4130,1016,2048,96874003.0,206590786.0,44790,95176,2162.8,2170.6,139966,303464789.0,3064,2023-11-03 10:05:00
209,POSI,694,1075,88223989.0,97880945.0,26420,44986,3339.3,2175.8,71406,186104934.0,1769,582,1009,46498248.0,85307135.0,21563,39299,2156.4,2170.7,60862,131805384.0,1591,2023-11-03 10:10:00
210,POSI,425,590,36436534.0,78607974.0,16882,35906,2158.3,2189.3,52788,115044508.0,1015,292,505,33879937.0,74005541.0,15719,34002,2155.3,2176.5,49721,107885478.0,797,2023-11-03 10:15:00
211,POSI,1139,1074,81966349.0,120989041.0,37893,52880,2163.1,2288.0,90773,202955391.0,2213,1061,1004,79292937.0,105370655.0,36669,48420,2162.4,2176.2,85089,184663593.0,2065,2023-11-03 10:20:00
212,POSI,486,212,53093152.0,32692818.0,24518,14879,2165.5,2197.2,39397,85785970.0,698,451,168,51557871.0,26306255.0,23814,12076,2165.0,2178.4,35890,77864127.0,619,2023-11-03 10:25:00
213,POSI,536,393,69761879.0,66619196.0,32133,30477,2171.0,2185.9,62610,136381075.0,929,462,318,66418523.0,59317020.0,30680,27166,2164.9,2183.5,57846,125735544.0,780,2023-11-03 10:30:00
214,POSI,1604,2393,135908394.0,128261705.0,62657,58864,2169.1,2178.9,121521,264170099.0,3997,1559,2352,132638922.0,124968404.0,61122,57361,2170.1,2178.6,118483,257607327.0,3911,2023-11-03 10:35:00
215,POSI,266,812,33188708.0,56562694.0,15315,25930,2167.1,2181.4,41245,89751403.0,1078,237,772,32874646.0,56079210.0,15209,25704,2161.5,2181.7,40913,88953857.0,1009,2023-11-03 10:40:00
216,POSI,275,250,51263913.0,47781509.0,23614,21840,2170.9,2187.8,45454,99045422.0,525,235,192,51098458.0,45777805.0,23609,20925,2164.4,2187.7,44534,96876263.0,427,2023-11-03 10:45:00
217,POSI,415,467,72835607.0,73214717.0,33487,33484,2175.0,2186.6,66971,146050325.0,882,360,415,70463537.0,70425610.0,32500,32198,2168.1,2187.3,64698,140889147.0,775,2023-11-03 10:50:00
218,POSI,620,1244,86296105.0,183040566.0,39856,84037,2165.2,2178.1,123893,269336671.0,1864,543,1193,80178178.0,174905319.0,37058,80240,2163.6,2179.8,117298,255083497.0,1736,2023-11-03 10:55:00
219,POSI,211,146,14460284.0,24275172.0,6669,11151,2168.3,2177.0,17820,38735457.0,357,192,115,14796909.0,24878187.0,6838,11407,2163.9,2181.0,18245,39675097.0,307,2023-11-03 11:00:00
220,POSI,501,294,44933599.0,57788204.0,20697,26492,2171.0,2181.3,47189,102721803.0,795,445,251,43506809.0,54293122.0,20113,24869,2163.1,2183.2,44982,97799932.0,696,2023-11-03 11:05:00
221,POSI,431,374,70169353.0,85916218.0,32337,39330,2169.9,2184.5,71667,156085571.0,805,373,339,65883914.0,85439162.0,30431,39127,2165.0,2183.6,69558,151323076.0,712,2023-11-03 11:10:00
222,POSI,319,358,54038677.0,70803931.0,24981,32669,2163.2,2167.3,57650,124842609.0,677,274,299,50193666.0,65447519.0,23208,29959,2162.8,2184.6,53167,115641185.0,573,2023-11-03 11:15:00
223,POSI,334,185,21186647.0,29063602.0,9771,13320,2168.3,2182.0,23091,50250249.0,519,295,169,21096913.0,27531488.0,9745,12618,2164.9,2181.9,22363,48628402.0,464,2023-11-03 11:20:00
224,POSI,525,1142,83508671.0,139314643.0,38624,64052,2162.1,2175.0,102676,222823315.0,1667,491,1102,85115729.0,135441710.0,39363,62198,2162.3,2177.6,101561,220557440.0,1593,2023-11-03 11:25:00
225,POSI,481,1856,71230708.0,239266184.0,33038,110350,2156.0,2168.2,143388,310496892.0,2337,404,1839,63688968.0,237201195.0,29536,109153,2156.3,2173.1,138689,300890163.0,2243,2023-11-03 11:30:00
226,POSI,310,1935,49429606.0,356431332.0,22936,163924,2155.1,2174.4,186860,405860939.0,2245,272,1904,49318989.0,354419748.0,22881,163150,2155.5,2172.4,186031,403738738.0,2176,2023-11-03 11:35:00
227,POSI,156,298,12604881.0,37249570.0,5840,17191,2158.4,2166.8,23031,49854452.0,454,144,260,11098251.0,36386149.0,5151,16748,2154.6,2172.6,21899,47484400.0,404,2023-11-03 11:40:00
228,POSI,1250,1967,150665654.0,277526805.0,69611,127558,2164.4,2175.7,197169,428192459.0,3217,1165,1908,146175012.0,273902974.0,67658,125890,2160.5,2175.7,193548,420077986.0,3073,2023-11-03 11:45:00
229,POSI,613,1114,76860511.0,162628641.0,35571,74925,2160.8,2170.6,110496,239489153.0,1727,553,1019,74022492.0,158778126.0,34296,73036,2158.3,2174.0,107332,232800618.0,1572,2023-11-03 11:50:00
230,POSI,2000,1655,126412265.0,253721494.0,58481,116770,2161.6,2172.8,175251,380133760.0,3655,1960,1590,123985720.0,252113680.0,57362,116003,2161.5,2173.3,173365,376099401.0,3550,2023-11-03 11:55:00
231,POSI,245,170,31233713.0,31894891.0,14467,14678,2159.0,2173.0,29145,63128605.0,415,219,124,29741768.0,29955951.0,13794,13761,2156.1,2176.9,27555,59697719.0,343,2023-11-03 12:00:00
232,POSI,194,465,31228867.0,91183553.0,14480,41989,2156.7,2171.6,56469,122412420.0,659,184,441,30189519.0,88417364.0,14004,40704,2155.8,2172.2,54708,118606884.0,625,2023-11-03 12:05:00
233,POSI,240,145,15140340.0,14941957.0,7022,6866,2156.1,2176.2,13888,30082297.0,385,220,137,14919485.0,14825229.0,6905,6811,2160.7,2176.7,13716,29744714.0,357,2023-11-03 12:10:00
234,POSI,1511,388,92892994.0,80080918.0,42974,36810,2161.6,2175.5,79784,172973912.0,1899,1438,341,92000391.0,79773522.0,42579,36661,2160.7,2176.0,79240,171773914.0,1779,2023-11-03 12:15:00
235,POSI,558,1695,46295369.0,225674332.0,21450,103962,2158.3,2170.7,125412,271969701.0,2253,558,1662,46260817.0,224491538.0,21435,103419,2158.2,2170.7,124854,270752355.0,2220,2023-11-03 12:20:00
236,POSI,335,1560,23432151.0,252902132.0,10864,116695,2156.9,2167.2,127559,276334283.0,1895,296,1503,22723402.0,249413207.0,10535,114980,2156.9,2169.2,125515,272136609.0,1799,2023-11-03 12:25:00
237,POSI,2182,1680,157271213.0,305790020.0,72791,140926,2160.6,2169.9,213717,463061233.0,3862,2158,1653,138221883.0,304178066.0,63958,140145,2161.1,2170.5,204103,442399949.0,3811,2023-11-03 12:30:00
238,POSI,853,488,46398628.0,77208856.0,21464,35553,2161.7,2171.7,57017,123607484.0,1341,847,470,46192878.0,77048508.0,21375,35475,2161.1,2171.9,56850,123241386.0,1317,2023-11-03 12:35:00
239,POSI,613,204,37036138.0,27608798.0,17141,12686,2160.7,2176.3,29827,64644936.0,817,559,187,36406150.0,27100357.0,16852,12454,2160.3,2176.0,29306,63506508.0,746,2023-11-03 12:40:00
240,POSI,289,171,22121643.0,25515162.0,10186,11731,2171.8,2175.0,21917,47636805.0,460,260,160,19945203.0,25501875.0,9231,11727,2160.7,2174.6,20958,45447078.0,420,2023-11-03 12:45:00
241,POSI,318,603,47884467.0,80245023.0,22061,36845,2170.5,2177.9,58906,128129490.0,921,261,565,48075845.0,77397606.0,22263,35538,2159.5,2177.9,57801,125473451.0,826,2023-11-03 12:50:00
242,POSI,779,222,51462137.0,53375181.0,23782,24504,2163.9,2178.2,48286,104837318.0,1001,772,205,50917942.0,53396588.0,23532,24515,2163.8,2178.1,48047,104314530.0,977,2023-11-03 12:55:00
243,POSI,224,216,27166169.0,29398945.0,12575,13514,2160.3,2175.4,26089,56565114.0,440,211,216,25390195.0,29711735.0,11743,13650,2162.2,2176.7,25393,55101930.0,427,2023-11-03 13:00:00
244,POSI,221,216,20382818.0,34179971.0,9423,15700,2163.1,2177.1,25123,54562789.0,437,177,195,19890444.0,33807518.0,9200,15530,2162.0,2176.9,24730,53697963.0,372,2023-11-03 13:05:00
245,POSI,300,209,44638514.0,49285531.0,20554,22591,2171.8,2181.6,43145,93924045.0,509,267,166,41929871.0,48404969.0,19396,22179,2161.8,2182.5,41575,90334841.0,433,2023-11-03 13:10:00
246,POSI,267,162,31167792.0,36144353.0,14425,14796,2160.7,2442.8,29221,67312146.0,429,225,135,30442105.0,33836706.0,14087,14517,2161.0,2330.8,28604,64278811.0,360,2023-11-03 13:15:00
247,POSI,110,944,9990406.0,144294218.0,4620,66423,2162.4,2172.4,71043,154284624.0,1054,131,941,10073605.0,143219757.0,4663,65898,2160.3,2173.4,70561,153293362.0,1072,2023-11-03 13:20:00
248,POSI,278,628,43242604.0,124712183.0,20052,57412,2156.5,2172.2,77464,167954787.0,906,207,603,40154617.0,124513464.0,18621,57262,2156.4,2174.5,75883,164668081.0,810,2023-11-03 13:25:00
249,POSI,348,352,33146731.0,56942869.0,15332,26184,2161.9,2174.7,41516,90089600.0,700,309,337,32397785.0,56785865.0,14996,26114,2160.4,2174.5,41110,89183651.0,646,2023-11-03 13:30:00
250,POSI,275,410,35698367.0,54649088.0,16539,25167,2158.4,2171.5,41706,90347455.0,685,255,389,35218152.0,53501875.0,16319,24604,2158.1,2174.5,40923,88720027.0,644,2023-11-03 13:35:00
251,POSI,220,525,29410614.0,69533034.0,13608,32045,2161.3,2169.9,45653,98943648.0,745,169,503,30846574.0,68728384.0,14298,31631,2157.4,2172.8,45929,99574958.0,672,2023-11-03 13:40:00
252,POSI,161,166,17702168.0,23176257.0,8196,10647,2159.9,2176.8,18843,40878426.0,327,126,142,16939576.0,22704673.0,7854,10431,2156.8,2176.7,18285,39644250.0,268,2023-11-03 13:45:00
253,POSI,563,216,35998198.0,33097374.0,16614,15197,2166.7,2177.9,31811,69095573.0,779,550,193,35120491.0,33020797.0,16256,15163,2160.5,2177.7,31419,68141289.0,743,2023-11-03 13:50:00
254,POSI,355,208,36637987.0,34572140.0,16959,15876,2160.4,2177.6,32835,71210128.0,563,323,180,35728789.0,34259858.0,16548,15732,2159.1,2177.7,32280,69988648.0,503,2023-11-03 13:55:00
255,POSI,223,199,20608376.0,21079291.0,9536,9685,2161.1,2176.5,19221,41687668.0,422,209,196,21008438.0,20274671.0,9724,9311,2160.5,2177.5,19035,41283109.0,405,2023-11-03 14:00:00
256,POSI,199,210,15162996.0,17928532.0,6998,8251,2166.8,2172.9,15249,33091529.0,409,174,192,14207164.0,17903920.0,6573,8234,2161.4,2174.4,14807,32111085.0,366,2023-11-03 14:05:00
257,POSI,162,136,7611827.0,8671331.0,3522,3988,2161.2,2174.4,7510,16283159.0,298,154,122,6802305.0,7979801.0,3149,3667,2160.1,2176.1,6816,14782106.0,276,2023-11-03 14:10:00
258,POSI,627,129,48065645.0,17494199.0,22172,8034,2167.9,2177.5,30206,65559844.0,756,600,116,47343735.0,15173638.0,21872,6970,2164.6,2177.0,28842,62517373.0,716,2023-11-03 14:15:00
259,POSI,640,400,59577817.0,64329762.0,27540,29593,2163.3,2173.8,57133,123907579.0,1040,622,391,59064908.0,64974646.0,27305,29890,2163.2,2173.8,57195,124039555.0,1013,2023-11-03 14:20:00
260,POSI,367,82,22602202.0,7452138.0,10430,3418,2167.0,2180.3,13848,30054340.0,449,359,77,22812166.0,7876416.0,10536,3623,2165.2,2174.0,14159,30688583.0,436,2023-11-03 14:25:00
261,POSI,682,287,75744625.0,46216243.0,34901,21199,2170.3,2180.1,56100,121960869.0,969,630,257,73250335.0,43300703.0,33869,19870,2162.8,2179.2,53739,116551039.0,887,2023-11-03 14:30:00
262,POSI,667,245,78567614.0,53064740.0,36295,24324,2164.7,2181.6,60619,131632354.0,912,657,228,77837480.0,52262349.0,35973,23953,2163.8,2181.9,59926,130099829.0,885,2023-11-03 14:35:00
263,POSI,1428,171,127871707.0,31326950.0,58960,14359,2168.8,2181.7,73319,159198657.0,1599,1376,147,127251300.0,30563702.0,58680,14009,2168.6,2181.7,72689,157815002.0,1523,2023-11-03 14:40:00
264,POSI,2584,174,203570463.0,30662817.0,93749,14070,2171.4,2179.3,107819,234233281.0,2758,2562,153,202676041.0,30027547.0,93351,13768,2171.1,2181.0,107119,232703588.0,2715,2023-11-03 14:45:00
265,POSI,2494,194,202413869.0,32134916.0,93213,14735,2171.5,2180.9,107948,234548785.0,2688,2427,177,202354729.0,30007567.0,93197,13749,2171.3,2182.5,106946,232362296.0,2604,2023-11-03 14:50:00
266,POSI,3210,134,273672389.0,18640114.0,126019,8551,2171.7,2179.9,134570,292312503.0,3344,3229,116,273939074.0,18703740.0,126146,8578,2171.6,2180.4,134724,292642814.0,3345,2023-11-03 14:55:00
267,POSI,1477,245,160391728.0,38451170.0,73877,17629,2171.1,2181.1,91506,198842898.0,1722,1421,221,158758387.0,37583965.0,73140,17227,2170.6,2181.7,90367,196342352.0,1642,2023-11-03 15:00:00
268,POSI,529,239,73113951.0,46031809.0,33709,21070,2169.0,2184.7,54779,119145761.0,768,488,206,72607685.0,45563897.0,33498,20858,2167.5,2184.5,54356,118171582.0,694,2023-11-03 15:05:00
269,POSI,414,225,67818488.0,40209789.0,31246,18414,2170.5,2183.7,49660,108028278.0,639,403,170,65420161.0,38325019.0,30148,17537,2170.0,2185.4,47685,103745181.0,573,2023-11-03 15:10:00
270,POSI,637,846,111998031.0,95484674.0,51515,43820,2174.1,2179.0,95335,207482706.0,1483,554,811,103552104.0,93018955.0,47746,42589,2168.8,2184.1,90335,196571059.0,1365,2023-11-03 15:15:00
271,POSI,659,321,120115913.0,51729702.0,55172,23691,2177.1,2183.5,78863,171845615.0,980,629,250,114555291.0,48126949.0,52709,22002,2173.4,2187.4,74711,162682241.0,879,2023-11-03 15:20:00
272,POSI,375,405,55750317.0,43860638.0,25713,20045,2168.2,2188.1,45758,99610955.0,780,287,359,50243558.0,42587726.0,23235,19456,2162.4,2188.9,42691,92831284.0,646,2023-11-03 15:25:00
273,POSI,1032,447,157486575.0,95503954.0,72560,43590,2170.4,2191.0,116150,252990529.0,1479,957,337,153704201.0,91290609.0,70945,41662,2166.5,2191.2,112607,244994810.0,1294,2023-11-03 15:30:00
274,POSI,795,397,95306980.0,77130840.0,43641,35187,2183.9,2192.0,78828,172437821.0,1192,737,287,91371006.0,73743007.0,41936,33630,2178.8,2192.8,75566,165114013.0,1024,2023-11-03 15:35:00
275,POSI,697,297,77171116.0,57428892.0,35450,26229,2176.9,2189.5,61679,134600009.0,994,645,252,77589776.0,55542134.0,35657,25332,2176.0,2192.6,60989,133131911.0,897,2023-11-03 15:40:00
276,POSI,1383,509,181301940.0,114183604.0,82871,51958,2187.8,2197.6,134829,295485544.0,1892,1292,370,172131070.0,105218803.0,78952,47891,2180.2,2197.0,126843,277349874.0,1662,2023-11-03 15:45:00
277,POSI,1119,1147,159081390.0,155682636.0,73042,71364,2177.9,2181.5,144406,314764026.0,2266,1046,1117,154139800.0,151132698.0,70796,68983,2177.2,2190.9,139779,305272498.0,2163,2023-11-03 15:50:00
278,POSI,1242,461,162841288.0,89367562.0,74675,40750,2180.7,2193.1,115425,252208851.0,1703,1164,373,159980395.0,86888572.0,73386,39586,2180.0,2194.9,112972,246868967.0,1537,2023-11-03 15:55:00
279,POSI,669,242,87470023.0,26820899.0,40076,12235,2182.6,2192.1,52311,114290923.0,911,642,159,87010072.0,24953430.0,39873,11370,2182.2,2194.7,51243,111963502.0,801,2023-11-03 16:00:00
280,POSI,792,380,79074849.0,26146887.0,36181,11925,2185.5,2192.6,48106,105221736.0,1172,778,347,79971100.0,27700709.0,36645,12623,2182.3,2194.5,49268,107671810.0,1125,2023-11-03 16:05:00
281,POSI,820,1971,119139483.0,182256478.0,54694,83438,2178.3,2184.3,138132,301395961.0,2791,720,1905,117365045.0,178923227.0,53880,81760,2178.3,2188.4,135640,296288272.0,2625,2023-11-03 16:10:00
282,POSI,898,1326,113455203.0,166203754.0,52326,76134,2168.2,2183.0,128460,279658957.0,2224,792,1247,110052606.0,163753381.0,50768,74847,2167.8,2187.8,125615,273805987.0,2039,2023-11-03 16:15:00
283,POSI,289,234,27012093.0,27510720.0,12411,12583,2176.5,2186.3,24994,54522813.0,523,256,183,26604456.0,25937100.0,12225,11842,2176.2,2190.3,24067,52541557.0,439,2023-11-03 16:20:00
284,POSI,360,295,35425735.0,34157931.0,16278,15669,2176.3,2180.0,31947,69583666.0,655,286,253,33582733.0,33995636.0,15438,15541,2175.3,2187.5,30979,67578370.0,539,2023-11-03 16:25:00
285,POSI,599,266,79240114.0,43073187.0,36293,19683,2183.3,2188.3,55976,122313301.0,865,572,222,80882597.0,44926163.0,37110,20499,2179.5,2191.6,57609,125808761.0,794,2023-11-03 16:30:00
286,POSI,448,174,50638492.0,17263974.0,23197,7887,2183.0,2188.9,31084,67902467.0,622,433,146,50115245.0,14673886.0,22979,6699,2180.9,2190.5,29678,64789131.0,579,2023-11-03 16:35:00
287,POSI,314,203,38706960.0,28070804.0,17739,12817,2182.0,2190.1,30556,66777764.0,517,309,192,37724346.0,30078933.0,17305,13728,2180.0,2191.1,31033,67803280.0,501,2023-11-03 16:40:00
288,POSI,563,269,50923047.0,28068504.0,23328,12806,2182.9,2191.8,36134,78991551.0,832,505,222,49775452.0,26480347.0,22819,12080,2181.3,2192.1,34899,76255800.0,727,2023-11-03 16:45:00
289,POSI,868,486,112728933.0,69138767.0,51612,31502,2184.2,2194.7,83114,181867700.0,1354,830,393,106599601.0,66083335.0,48827,30094,2183.2,2195.9,78921,172682937.0,1223,2023-11-03 16:50:00
290,POSI,701,741,98774902.0,59231082.0,45236,27008,2183.5,2193.1,72244,158005985.0,1442,651,671,97762649.0,56614682.0,44780,25804,2183.2,2194.0,70584,154377331.0,1322,2023-11-03 16:55:00
291,POSI,606,243,62474622.0,31400279.0,28644,14331,2181.1,2191.1,42975,93874902.0,849,559,204,61509832.0,29030214.0,28199,13242,2181.3,2192.3,41441,90540047.0,763,2023-11-03 17:00:00
292,POSI,593,499,60657240.0,32727539.0,27805,14984,2181.5,2184.2,42789,93384779.0,1092,532,464,59285227.0,32247534.0,27189,14716,2180.5,2191.3,41905,91532761.0,996,2023-11-03 17:05:00
293,POSI,337,516,35953894.0,44756156.0,16498,20452,2179.3,2188.4,36950,80710050.0,853,306,459,32718839.0,39640509.0,15022,18082,2178.1,2192.3,33104,72359348.0,765,2023-11-03 17:10:00
294,POSI,362,309,55334613.0,48168964.0,25446,21992,2174.6,2190.3,47438,103503578.0,671,327,291,54678177.0,48365809.0,25155,22061,2173.7,2192.4,47216,103043986.0,618,2023-11-03 17:15:00
295,POSI,220,436,35063910.0,42823368.0,16084,19516,2180.0,2194.3,35600,77887279.0,656,190,403,32922864.0,42683250.0,15155,19453,2172.4,2194.2,34608,75606115.0,593,2023-11-03 17:20:00
296,POSI,227,277,19204612.0,23255315.0,8821,10634,2177.1,2186.9,19455,42459927.0,504,217,263,18740489.0,22438208.0,8610,10236,2176.6,2192.1,18846,41178698.0,480,2023-11-03 17:25:00
297,POSI,245,114,30527562.0,11085765.0,13999,5050,2180.7,2195.2,19049,41613328.0,359,212,93,30575557.0,11144215.0,14031,5076,2179.1,2195.5,19107,41719773.0,305,2023-11-03 17:30:00
298,POSI,388,216,33683389.0,14496915.0,15452,6612,2179.9,2192.5,22064,48180305.0,604,349,196,32978176.0,14546080.0,15127,6632,2180.1,2193.3,21759,47524257.0,545,2023-11-03 17:35:00
299,POSI,200,159,20897631.0,13924943.0,9582,6343,2180.9,2195.3,15925,34822575.0,359,176,146,18441057.0,13878249.0,8462,6323,2179.3,2194.9,14785,32319306.0,322,2023-11-03 17:40:00
300,POSI,121,160,6418879.0,10986204.0,2941,5015,2182.5,2190.7,7956,17405084.0,281,121,158,9750130.0,13124259.0,4477,5982,2177.8,2194.0,10459,22874389.0,279,2023-11-03 17:45:00
301,POSI,276,189,12979013.0,13989371.0,5871,6374,2210.7,2194.8,12245,26968385.0,465,208,163,10764734.0,13447869.0,4937,6128,2180.4,2194.5,11065,24212603.0,371,2023-11-03 17:50:00
302,POSI,1451,237,119360493.0,25121747.0,54582,11444,2186.8,2195.2,66026,144482240.0,1688,1424,198,116710516.0,24458781.0,53391,11138,2186.0,2196.0,64529,141169297.0,1622,2023-11-03 17:55:00
303,POSI,779,341,101128138.0,36078691.0,46295,16423,2184.4,2196.8,62718,137206830.0,1120,758,317,100955047.0,34805339.0,46222,15814,2184.1,2200.9,62036,135760387.0,1075,2023-11-03 18:00:00
304,POSI,226,186,13160241.0,11022661.0,6016,5027,2187.5,2192.7,11043,24182902.0,412,188,160,13461957.0,8133090.0,6186,3699,2176.2,2198.7,9885,21595048.0,348,2023-11-03 18:05:00
305,POSI,528,240,69883838.0,27481864.0,31970,12544,2185.9,2190.8,44514,97365703.0,768,508,219,61238698.0,24633145.0,28031,11216,2184.7,2196.3,39247,85871843.0,727,2023-11-03 18:10:00
306,POSI,981,472,132848225.0,71721675.0,60685,32608,2189.1,2199.5,93293,204569901.0,1453,876,366,126342977.0,67951062.0,57832,30859,2184.7,2202.0,88691,194294039.0,1242,2023-11-03 18:15:00
307,POSI,841,703,102139667.0,72274565.0,46647,32868,2189.6,2198.9,79515,174414232.0,1544,801,609,99713192.0,70783091.0,45592,32178,2187.1,2199.7,77770,170496283.0,1410,2023-11-03 18:20:00
308,POSI,343,298,77852495.0,48219094.0,35782,21879,2175.7,2203.9,57661,126071589.0,641,355,227,75277738.0,48262709.0,34648,21867,2172.6,2207.1,56515,123540447.0,582,2023-11-03 18:25:00
309,POSI,1141,431,183291319.0,63259246.0,83620,28706,2192.0,2203.7,112326,246550566.0,1572,1056,363,178274468.0,56110064.0,81537,25480,2186.4,2202.1,107017,234384533.0,1419,2023-11-03 18:30:00
310,POSI,3458,1216,497965663.0,263910900.0,227641,120163,2187.5,2196.3,347804,761876563.0,4674,3442,1144,486518134.0,259111993.0,222483,117830,2186.8,2199.0,340313,745630128.0,4586,2023-11-03 18:35:00
311,POSI,1582,743,147489959.0,120265757.0,67483,54688,2185.6,2199.1,122171,267755716.0,2325,1541,709,147327893.0,119864075.0,67417,54506,2185.3,2199.1,121923,267191969.0,2250,2023-11-03 18:40:00
312,POSI,3494,3080,596390874.0,353050052.0,267226,152078,2231.8,2321.5,419304,949440927.0,6574,2744,1664,527823589.0,234920604.0,236760,104476,2229.4,2248.6,341236,762744193.0,4408,2023-11-06 10:05:00
313,POSI,3535,915,496207283.0,183372171.0,222282,80765,2232.3,2270.4,303047,679579454.0,4450,3340,675,479661795.0,167241945.0,215105,74153,2229.9,2255.4,289258,646903740.0,4015,2023-11-06 10:10:00
314,POSI,2462,1234,371352489.0,186154090.0,165942,82346,2237.8,2260.6,248288,557506579.0,3696,2253,931,349696344.0,166641680.0,156461,73713,2235.0,2260.7,230174,516338024.0,3184,2023-11-06 10:15:00
315,POSI,1117,959,149140467.0,185306477.0,66837,80133,2231.4,2312.5,146970,334446945.0,2076,938,729,139071585.0,162972152.0,62436,72542,2227.4,2246.6,134978,302043738.0,1667,2023-11-06 10:20:00
316,POSI,620,621,107678778.0,114102411.0,48303,50847,2229.2,2244.0,99150,221781189.0,1241,496,490,98934487.0,111495930.0,44402,49628,2228.2,2246.6,94030,210430418.0,986,2023-11-06 10:25:00
317,POSI,2133,836,322444410.0,178260665.0,144148,79189,2236.9,2251.1,223337,500705075.0,2969,1947,655,308170710.0,167234741.0,137954,74313,2233.9,2250.4,212267,475405451.0,2602,2023-11-06 10:30:00
318,POSI,882,713,150445378.0,90958144.0,67131,40373,2241.1,2252.9,107504,241403523.0,1595,761,499,144939693.0,77826402.0,64760,34556,2238.1,2252.2,99316,222766095.0,1260,2023-11-06 10:35:00
319,POSI,1226,698,236415498.0,126346533.0,105702,56100,2236.6,2252.2,161802,362762031.0,1924,1141,574,233366540.0,123391400.0,104385,54741,2235.6,2254.1,159126,356757940.0,1715,2023-11-06 10:40:00
320,POSI,344,489,56103939.0,51118763.0,25059,22654,2238.9,2256.5,47713,107222703.0,833,281,385,53448070.0,44545756.0,23900,19784,2236.3,2251.6,43684,97993827.0,666,2023-11-06 10:45:00
321,POSI,3141,2708,647526595.0,499603328.0,288139,221475,2247.3,2255.8,509614,1147129924.0,5849,2635,2229,601749973.0,483821948.0,268331,214308,2242.6,2257.6,482639,1085571922.0,4864,2023-11-06 10:50:00
322,POSI,1554,2197,314648958.0,331976608.0,140111,146952,2245.7,2259.1,287063,646625567.0,3751,1355,1606,296807691.0,301113580.0,132304,133275,2243.4,2259.3,265579,597921271.0,2961,2023-11-06 10:55:00
323,POSI,1709,1632,268498352.0,304887866.0,119191,134601,2252.7,2265.1,253792,573386219.0,3341,1468,1190,253000004.0,283240382.0,112613,125131,2246.6,2263.6,237744,536240387.0,2658,2023-11-06 11:00:00
324,POSI,5831,1703,743779005.0,386118671.0,326804,169405,2275.9,2279.3,496209,1129897676.0,7534,5572,1294,710159903.0,356400415.0,312407,156157,2273.2,2282.3,468564,1066560319.0,6866,2023-11-06 11:05:00
325,POSI,1857,2032,408637231.0,293407562.0,175848,129086,2323.8,2273.0,304934,702044793.0,3889,1608,1541,378435424.0,266490668.0,167534,117089,2258.9,2276.0,284623,644926092.0,3149,2023-11-06 11:10:00
326,POSI,833,1684,142739317.0,195338876.0,63276,86316,2255.8,2263.1,149592,338078193.0,2517,677,1444,136359225.0,192475676.0,60533,84767,2252.6,2270.6,145300,328834901.0,2121,2023-11-06 11:15:00
327,POSI,1371,1495,237165975.0,382275370.0,105355,168645,2251.1,2266.7,274000,619441345.0,2866,1184,1312,230375537.0,369118799.0,102378,162625,2250.2,2269.8,265003,599494337.0,2496,2023-11-06 11:20:00
328,POSI,807,735,104050549.0,192867962.0,46116,85109,2256.3,2266.1,131225,296918512.0,1542,687,550,98804345.0,187625861.0,43881,82687,2251.6,2269.1,126568,286430206.0,1237,2023-11-06 11:25:00
329,POSI,805,905,98741909.0,238656730.0,43827,105573,2253.0,2260.6,149400,337398639.0,1710,714,754,94445072.0,233404290.0,41967,103011,2250.5,2265.8,144978,327849362.0,1468,2023-11-06 11:30:00
330,POSI,929,1595,146196079.0,245037654.0,65030,109004,2248.1,2248.0,174034,391233734.0,2524,796,1425,142571141.0,235783097.0,63426,104091,2247.8,2265.2,167517,378354239.0,2221,2023-11-06 11:35:00
331,POSI,1254,1000,215086028.0,159739092.0,95668,70691,2248.3,2259.7,166359,374825120.0,2254,1089,872,205380243.0,155559433.0,91384,68799,2247.4,2261.1,160183,360939677.0,1961,2023-11-06 11:40:00
332,POSI,654,1173,136150642.0,116955185.0,60486,51678,2250.9,2263.2,112164,253105827.0,1827,591,1080,133322661.0,116628245.0,59326,51541,2247.3,2262.8,110867,249950906.0,1671,2023-11-06 11:45:00
333,POSI,966,672,173042768.0,111613423.0,76729,49248,2255.2,2266.4,125977,284656191.0,1638,864,519,164120741.0,106129225.0,72893,46802,2251.5,2267.6,119695,270249966.0,1383,2023-11-06 11:50:00
334,POSI,377,459,61405461.0,56587876.0,27290,24999,2250.1,2263.6,52289,117993337.0,836,316,355,60899529.0,54108496.0,27078,23871,2249.0,2266.7,50949,115008026.0,671,2023-11-06 11:55:00
335,POSI,292,475,38957299.0,69172168.0,17296,30581,2252.4,2261.9,47877,108129467.0,767,215,370,37745979.0,66743747.0,16809,29504,2245.6,2262.2,46313,104489726.0,585,2023-11-06 12:00:00
336,POSI,408,406,55024964.0,89535533.0,24451,39333,2250.4,2276.3,63784,144560497.0,814,369,345,52466978.0,56795620.0,23340,25029,2247.9,2269.2,48369,109262598.0,714,2023-11-06 12:05:00
337,POSI,330,355,37860931.0,41894194.0,16769,18477,2257.8,2267.4,35246,79755126.0,685,266,254,35471353.0,51578638.0,15753,22734,2251.7,2268.8,38487,87049991.0,520,2023-11-06 12:10:00
338,POSI,315,209,36070728.0,28441727.0,15943,12584,2262.5,2260.1,28527,64512455.0,524,275,145,39014911.0,27906920.0,17343,12310,2249.6,2267.0,29653,66921831.0,420,2023-11-06 12:15:00
339,POSI,1267,413,117951957.0,112407399.0,52088,49444,2264.5,2273.4,101532,230359356.0,1680,1211,373,112138064.0,106929137.0,49734,46954,2254.8,2277.3,96688,219067202.0,1584,2023-11-06 12:20:00
340,POSI,1830,556,230007817.0,102109044.0,101524,44893,2265.6,2274.5,146417,332116861.0,2386,1740,380,223117131.0,95701956.0,98757,42038,2259.3,2276.6,140795,318819087.0,2120,2023-11-06 12:25:00
341,POSI,1493,1731,303879269.0,175953238.0,134530,77521,2258.8,2269.7,212051,479832507.0,3224,1400,1612,301533962.0,170640368.0,133531,75107,2258.2,2272.0,208638,472174330.0,3012,2023-11-06 12:30:00
342,POSI,446,775,86102771.0,66713013.0,38090,29405,2260.5,2268.8,67495,152815785.0,1221,389,716,82559802.0,65231470.0,36592,28726,2256.2,2270.8,65318,147791272.0,1105,2023-11-06 12:35:00
343,POSI,389,616,90425361.0,82151986.0,39860,36106,2268.6,2275.3,75966,172577347.0,1005,365,565,84314755.0,79104574.0,37389,34762,2255.1,2275.6,72151,163419330.0,930,2023-11-06 12:40:00
344,POSI,687,1100,140610466.0,105994552.0,62163,46737,2262.0,2267.9,108900,246605019.0,1787,637,1028,160746292.0,101057253.0,71409,44428,2251.1,2274.6,115837,261803546.0,1665,2023-11-06 12:45:00
345,POSI,356,863,74229707.0,76450121.0,32899,33704,2256.3,2268.3,66603,150679828.0,1219,298,773,72718988.0,71439009.0,32237,31432,2255.8,2272.8,63669,144157997.0,1071,2023-11-06 12:50:00
346,POSI,333,436,75136437.0,83247890.0,33356,36872,2252.6,2257.8,70228,158384328.0,769,281,380,71656482.0,79412081.0,31814,35010,2252.4,2268.3,66824,151068563.0,661,2023-11-06 12:55:00
347,POSI,356,910,40530670.0,88112357.0,17969,38929,2255.6,2263.4,56898,128643028.0,1266,267,850,38198857.0,85440372.0,17000,37723,2247.0,2264.9,54723,123639229.0,1117,2023-11-06 13:00:00
348,POSI,620,299,51856304.0,49587803.0,22986,21879,2256.0,2266.5,44865,101444108.0,919,585,268,50688809.0,49155519.0,22493,21651,2253.5,2270.4,44144,99844329.0,853,2023-11-06 13:05:00
349,POSI,165,153,16869997.0,17142494.0,7476,7563,2256.6,2266.6,15039,34012491.0,318,133,99,16138366.0,16536059.0,7154,7290,2255.9,2268.3,14444,32674425.0,232,2023-11-06 13:10:00
350,POSI,931,363,104893933.0,49554493.0,46441,21816,2258.6,2271.5,68257,154448427.0,1294,848,278,102488528.0,47345535.0,45383,20846,2258.3,2271.2,66229,149834063.0,1126,2023-11-06 13:15:00
351,POSI,748,572,79832807.0,89491028.0,35402,39798,2255.0,2248.6,75200,169323836.0,1320,692,522,76150614.0,85079597.0,33779,37528,2254.4,2267.1,71307,161230212.0,1214,2023-11-06 13:20:00
352,POSI,1178,608,84057057.0,83048493.0,37310,36951,2252.9,2247.5,74261,167105551.0,1786,1114,545,81807040.0,77039544.0,36332,33960,2251.7,2268.5,70292,158846584.0,1659,2023-11-06 13:25:00
353,POSI,369,266,32954895.0,49036328.0,14647,21755,2249.9,2254.0,36402,81991223.0,635,307,211,31984905.0,47420926.0,14223,20936,2248.8,2265.0,35159,79405831.0,518,2023-11-06 13:30:00
354,POSI,610,609,75511845.0,107248740.0,33534,47278,2251.8,2268.5,80812,182760585.0,1219,477,553,69513028.0,106730696.0,30897,47051,2249.8,2268.4,77948,176243724.0,1030,2023-11-06 13:35:00
355,POSI,693,402,46316934.0,94180740.0,20538,41550,2255.2,2266.7,62088,140497675.0,1095,686,369,47876873.0,90468091.0,21255,39769,2252.5,2274.8,61024,138344965.0,1055,2023-11-06 13:40:00
356,POSI,602,464,62721806.0,61034277.0,27838,26895,2253.1,2269.4,54733,123756083.0,1066,587,411,59669258.0,57933982.0,26502,25521,2251.5,2270.1,52023,117603240.0,998,2023-11-06 13:45:00
357,POSI,853,214,79329344.0,65734752.0,35236,28959,2251.4,2269.9,64195,145064097.0,1067,808,186,77018393.0,65084290.0,34225,28651,2250.4,2271.6,62876,142102683.0,994,2023-11-06 13:50:00
358,POSI,204,113,18919461.0,19214356.0,8389,8474,2255.3,2267.4,16863,38133817.0,317,191,112,17645426.0,18991726.0,7844,8370,2249.5,2269.0,16214,36637152.0,303,2023-11-06 13:55:00
359,POSI,348,156,33932662.0,39673532.0,15064,17533,2252.6,2262.8,32597,73606195.0,504,323,128,33122232.0,38913460.0,14723,17153,2249.7,2268.6,31876,72035693.0,451,2023-11-06 14:00:00
360,POSI,646,134,31790944.0,21015804.0,14086,9253,2256.9,2271.2,23339,52806749.0,780,621,109,30940722.0,20590848.0,13745,9062,2251.1,2272.2,22807,51531570.0,730,2023-11-06 14:05:00
361,POSI,378,126,16438179.0,16576587.0,7290,7329,2254.9,2261.8,14619,33014767.0,504,315,93,15434965.0,15807741.0,6854,6972,2252.0,2267.3,13826,31242706.0,408,2023-11-06 14:10:00
362,POSI,489,183,58021938.0,55961927.0,25770,24674,2251.5,2268.1,50444,113983865.0,672,448,131,56427314.0,53560707.0,25082,23578,2249.7,2271.6,48660,109988022.0,579,2023-11-06 14:15:00
363,POSI,147,142,12100957.0,23981685.0,5364,9810,2256.0,2444.6,15174,36082642.0,289,142,124,9609064.0,22687177.0,4268,9622,2251.4,2357.8,13890,32296241.0,266,2023-11-06 14:20:00
364,POSI,336,530,43831381.0,125704823.0,19490,55833,2248.9,2251.4,75323,169536204.0,866,281,474,40021028.0,118877521.0,17803,52148,2248.0,2279.6,69951,158898549.0,755,2023-11-06 14:25:00
365,POSI,642,1554,142333939.0,328507581.0,63334,145594,2247.4,2256.3,208928,470841520.0,2196,563,1495,134190581.0,316693498.0,59760,139837,2245.5,2264.7,199597,450884079.0,2058,2023-11-06 14:30:00
366,POSI,1220,2994,303153134.0,336281331.0,134766,148759,2249.5,2260.6,283525,639434465.0,4214,1131,2947,294657744.0,332376011.0,130904,146985,2250.9,2261.3,277889,627033755.0,4078,2023-11-06 14:35:00
367,POSI,743,1173,75591856.0,171167275.0,33580,75776,2251.1,2258.9,109356,246759132.0,1916,718,1139,74164880.0,169370388.0,32947,74925,2251.0,2260.5,107872,243535268.0,1857,2023-11-06 14:40:00
368,POSI,358,1091,36102812.0,165111772.0,16035,73095,2251.5,2258.9,89130,201214584.0,1449,334,1086,35446441.0,163510068.0,15744,72370,2251.4,2259.4,88114,198956510.0,1420,2023-11-06 14:45:00
369,POSI,256,270,10602005.0,34393785.0,4710,15219,2251.0,2259.9,19929,44995790.0,526,206,236,10258263.0,38786327.0,4557,17153,2251.1,2261.2,21710,49044590.0,442,2023-11-06 14:50:00
370,POSI,416,123,28255763.0,19934748.0,12567,8818,2248.4,2260.7,21385,48190512.0,539,419,104,28484430.0,19512173.0,12669,8595,2248.4,2270.2,21264,47996603.0,523,2023-11-06 14:55:00
371,POSI,161,142,25553321.0,23758565.0,11374,10475,2246.6,2268.1,21849,49311886.0,303,139,121,25304337.0,23795214.0,11272,10487,2244.9,2269.0,21759,49099551.0,260,2023-11-06 15:00:00
372,POSI,248,687,42348831.0,83406974.0,19052,36931,2222.8,2258.5,55983,125755805.0,935,214,668,42045525.0,81507635.0,18927,36008,2221.5,2263.6,54935,123553160.0,882,2023-11-06 15:05:00
373,POSI,196,398,28598550.0,91507603.0,12711,40465,2249.9,2261.4,53176,120106153.0,594,158,370,26824080.0,92145924.0,11947,40756,2245.3,2260.9,52703,118970004.0,528,2023-11-06 15:10:00
374,POSI,256,372,35731738.0,64587107.0,15920,28594,2244.5,2258.8,44514,100318845.0,628,217,329,33867549.0,59947597.0,15087,26509,2244.8,2261.4,41596,93815146.0,546,2023-11-06 15:15:00
375,POSI,303,267,22952308.0,49080950.0,10243,21803,2240.8,2251.1,32046,72033259.0,570,231,225,21293046.0,47981210.0,9486,21252,2244.7,2257.7,30738,69274256.0,456,2023-11-06 15:20:00
376,POSI,1076,1813,186247217.0,303702711.0,83184,134967,2239.0,2250.2,218151,489949929.0,2889,844,1656,164117484.0,302947968.0,73344,134333,2237.6,2255.2,207677,467065452.0,2500,2023-11-06 15:25:00
377,POSI,412,901,60501494.0,68755246.0,27051,30576,2236.6,2248.7,57627,129256740.0,1313,353,855,65595977.0,66435587.0,29341,29480,2235.6,2253.6,58821,132031564.0,1208,2023-11-06 15:30:00
378,POSI,779,504,70234593.0,46078406.0,31346,20479,2240.6,2250.0,51825,116312999.0,1283,712,460,68940080.0,47900695.0,30791,21280,2239.0,2251.0,52071,116840776.0,1172,2023-11-06 15:35:00
379,POSI,330,358,70134003.0,62677433.0,31347,27666,2237.3,2265.5,59013,132811437.0,688,307,322,70058072.0,58023982.0,31324,25714,2236.6,2256.5,57038,128082054.0,629,2023-11-06 15:40:00
380,POSI,874,681,115801283.0,117019191.0,51750,51997,2237.7,2250.5,103747,232820474.0,1555,801,635,114136841.0,111005948.0,51017,49290,2237.2,2252.1,100307,225142789.0,1436,2023-11-06 15:45:00
381,POSI,212,150,12522237.0,9076633.0,5591,4078,2239.7,2225.8,9669,21598870.0,362,174,134,12251941.0,8709245.0,5480,3863,2235.8,2254.5,9343,20961186.0,308,2023-11-06 15:50:00
382,POSI,340,206,32711788.0,26676009.0,14587,11840,2242.5,2253.0,26427,59387798.0,546,293,175,30115040.0,25879412.0,13458,11483,2237.7,2253.7,24941,55994452.0,468,2023-11-06 15:55:00
383,POSI,316,415,49239453.0,75222189.0,22038,33445,2234.3,2249.1,55483,124461643.0,731,301,396,50634098.0,69866738.0,22658,31018,2234.7,2252.5,53676,120500836.0,697,2023-11-06 16:00:00
384,POSI,402,826,50325349.0,147962079.0,22530,65887,2233.7,2245.7,88417,198287428.0,1228,327,774,46685935.0,147740615.0,20906,65728,2233.1,2247.8,86634,194426550.0,1101,2023-11-06 16:05:00
385,POSI,545,1003,69957542.0,177493594.0,31298,79144,2235.2,2242.7,110442,247451137.0,1548,445,951,63230698.0,185815049.0,28314,82645,2233.2,2248.4,110959,249045747.0,1396,2023-11-06 16:10:00
386,POSI,1294,740,158693892.0,127834551.0,70930,56796,2237.3,2250.8,127726,286528443.0,2034,1233,685,155809828.0,119443723.0,69682,53045,2236.0,2251.7,122727,275253552.0,1918,2023-11-06 16:15:00
387,POSI,2223,1439,320687383.0,243766471.0,142720,108192,2247.0,2253.1,250912,564453855.0,3662,2148,1360,313760646.0,240889089.0,140058,106923,2240.2,2252.9,246981,554649736.0,3508,2023-11-06 16:20:00
388,POSI,338,234,63103286.0,28285609.0,28155,12533,2241.3,2256.9,40688,91388896.0,572,307,194,60903019.0,26249540.0,27196,11628,2239.4,2257.4,38824,87152560.0,501,2023-11-06 16:25:00
389,POSI,2175,1341,478406984.0,266480298.0,212453,117898,2251.8,2260.3,330351,744887283.0,3516,2067,1190,461880780.0,254881870.0,205666,112637,2245.8,2262.9,318303,716762650.0,3257,2023-11-06 16:30:00
390,POSI,1215,1713,171537974.0,407245299.0,76469,180668,2243.2,2254.1,257137,578783274.0,2928,1112,1619,170542371.0,403146485.0,76046,178536,2242.6,2258.1,254582,573688857.0,2731,2023-11-06 16:35:00
391,POSI,227,1139,39778967.0,188856414.0,17752,83712,2240.8,2256.0,101464,228635381.0,1366,198,1111,37106592.0,187840978.0,16559,83257,2240.9,2256.2,99816,224947570.0,1309,2023-11-06 16:40:00
392,POSI,1147,1470,173410386.0,231499305.0,77162,102561,2247.4,2257.2,179723,404909691.0,2617,1043,1413,169842422.0,232536345.0,75665,102993,2244.7,2257.8,178658,402378767.0,2456,2023-11-06 16:45:00
393,POSI,988,952,218300226.0,102147850.0,96839,45051,2254.3,2267.4,141890,320448076.0,1940,939,836,213384996.0,98098733.0,94863,43266,2249.4,2267.3,138129,311483729.0,1775,2023-11-06 16:50:00
394,POSI,510,407,81226030.0,28042073.0,36042,12385,2253.6,2264.2,48427,109268104.0,917,537,381,81186389.0,27038818.0,36060,11938,2251.4,2264.9,47998,108225207.0,918,2023-11-06 16:55:00
395,POSI,439,238,82864360.0,47558102.0,36832,20982,2249.8,2266.6,57814,130422463.0,677,390,190,80898469.0,46374410.0,36014,20445,2246.3,2268.3,56459,127272879.0,580,2023-11-06 17:00:00
396,POSI,1354,788,293512697.0,59954402.0,129915,26436,2259.3,2267.9,156351,353467100.0,2142,1297,723,287770683.0,57862831.0,127687,25514,2253.7,2267.9,153201,345633514.0,2020,2023-11-06 17:05:00
397,POSI,736,435,180447829.0,72522313.0,80134,31967,2251.8,2268.7,112101,252970142.0,1171,716,399,181767680.0,74271658.0,80741,32728,2251.2,2269.4,113469,256039339.0,1115,2023-11-06 17:10:00
398,POSI,874,1227,248661546.0,128588466.0,110629,56955,2247.7,2257.7,167584,377250012.0,2101,822,1149,246681525.0,123885584.0,109745,54792,2247.8,2261.0,164537,370567110.0,1971,2023-11-06 17:15:00
399,POSI,578,1405,113579601.0,90976649.0,50498,40257,2249.2,2259.9,90755,204556251.0,1983,523,1381,112803783.0,90271033.0,50158,39973,2249.0,2258.3,90131,203074817.0,1904,2023-11-06 17:20:00
400,POSI,578,532,59890514.0,32299322.0,26602,14287,2251.4,2260.7,40889,92189836.0,1110,555,519,59110543.0,32734737.0,26274,14476,2249.8,2261.3,40750,91845280.0,1074,2023-11-06 17:25:00
401,POSI,286,229,47014803.0,17939078.0,20918,7928,2247.6,2262.7,28846,64953881.0,515,257,189,47197726.0,16881995.0,20999,7447,2247.6,2267.0,28446,64079721.0,446,2023-11-06 17:30:00
402,POSI,433,285,50453038.0,27998218.0,22543,12383,2238.1,2261.0,34926,78451256.0,718,416,243,48810801.0,27230184.0,21754,12028,2243.8,2263.9,33782,76040985.0,659,2023-11-06 17:35:00
403,POSI,789,1009,109867277.0,182495576.0,48838,80842,2249.6,2257.4,129680,292362854.0,1798,702,949,104957260.0,178512596.0,46796,79062,2242.9,2257.9,125858,283469856.0,1651,2023-11-06 17:40:00
404,POSI,435,478,44346331.0,29031549.0,19747,12844,2245.7,2260.3,32591,73377880.0,913,447,463,43456546.0,28808739.0,19350,12740,2245.8,2261.3,32090,72265286.0,910,2023-11-06 17:45:00
405,POSI,315,420,45530104.0,76282578.0,20291,33738,2243.9,2261.0,54029,121812683.0,735,276,405,46373561.0,76124897.0,20688,33665,2241.6,2261.2,54353,122498458.0,681,2023-11-06 17:50:00
406,POSI,167,202,19651617.0,24238522.0,8761,10737,2243.1,2257.5,19498,43890139.0,369,146,172,20332579.0,24080340.0,9073,10630,2241.0,2265.3,19703,44412920.0,318,2023-11-06 17:55:00
407,POSI,171,266,17050941.0,37716201.0,7581,16683,2249.2,2260.8,24264,54767142.0,437,147,271,15418885.0,37750488.0,6869,16703,2244.7,2260.1,23572,53169373.0,418,2023-11-06 18:00:00
408,POSI,1448,901,192724314.0,96518269.0,85620,42648,2250.9,2263.1,128268,289242583.0,2349,1413,838,191825608.0,95369684.0,85310,42142,2248.6,2263.1,127452,287195292.0,2251,2023-11-06 18:05:00
409,POSI,825,1115,126207737.0,194674670.0,56081,86687,2250.5,2245.7,142768,320882407.0,1940,728,1055,119013270.0,185902341.0,52971,82269,2246.8,2259.7,135240,304915611.0,1783,2023-11-06 18:10:00
410,POSI,385,1912,53102873.0,311971591.0,23616,138111,2248.6,2258.8,161727,365074465.0,2297,359,1867,52285727.0,310365908.0,23288,137392,2245.2,2259.0,160680,362651636.0,2226,2023-11-06 18:15:00
411,POSI,332,398,44888774.0,74759144.0,20002,33058,2244.2,2261.5,53060,119647919.0,730,331,373,45121135.0,73643650.0,20113,32553,2243.4,2262.3,52666,118764785.0,704,2023-11-06 18:20:00
412,POSI,340,804,32931080.0,102882215.0,14673,45833,2244.3,2244.7,60506,135813295.0,1144,308,787,30483758.0,104534894.0,13587,46301,2243.6,2257.7,59888,135018652.0,1095,2023-11-06 18:25:00
413,POSI,656,485,48809758.0,81902336.0,21699,36295,2249.4,2256.6,57994,130712095.0,1141,645,448,50475988.0,80837843.0,22462,35810,2247.2,2257.4,58272,131313831.0,1093,2023-11-06 18:30:00
414,POSI,411,477,37741379.0,67113391.0,16822,29753,2243.6,2255.7,46575,104854771.0,888,428,476,38033109.0,65723528.0,16953,29118,2243.4,2257.1,46071,103756637.0,904,2023-11-06 18:35:00
415,POSI,283,247,48468960.0,40159821.0,21530,17774,2251.2,2259.5,39304,88628781.0,530,268,252,50728587.0,41477409.0,22646,18325,2240.1,2263.4,40971,92205997.0,520,2023-11-06 18:40:00
416,POSI,2393,3663,206890175.0,480157229.0,92393,208061,2239.2,2307.8,300454,687047405.0,6056,1727,2562,165726037.0,374196071.0,73569,165326,2252.7,2263.4,238895,539922108.0,4289,2023-11-07 10:05:00
417,POSI,841,1332,166230411.0,252648709.0,73613,110547,2258.2,2285.4,184160,418879121.0,2173,679,1077,147984836.0,222404832.0,65794,97936,2249.2,2270.9,163730,370389669.0,1756,2023-11-07 10:10:00
418,POSI,725,451,87635384.0,54322782.0,38917,23941,2251.9,2269.0,62858,141958166.0,1176,632,287,83192453.0,50045514.0,36952,22029,2251.4,2271.8,58981,133237968.0,919,2023-11-07 10:15:00
419,POSI,3211,2572,406456402.0,583679924.0,181287,256573,2242.1,2274.9,437860,990136326.0,5783,2898,2338,383909815.0,548785916.0,171358,242792,2240.4,2260.3,414150,932695731.0,5236,2023-11-07 10:20:00
420,POSI,709,744,101947278.0,198104000.0,45471,58169,2242.0,3405.7,103640,300051278.0,1453,609,628,94527119.0,122938686.0,42206,54420,2239.7,2259.1,96626,217465805.0,1237,2023-11-07 10:25:00
421,POSI,1810,1415,306747708.0,335375089.0,137122,149040,2237.0,2250.2,286162,642122798.0,3225,1399,1218,276768008.0,312603561.0,123921,138730,2233.4,2253.3,262651,589371570.0,2617,2023-11-07 10:30:00
422,POSI,1528,647,175057052.0,108425795.0,78174,48149,2239.3,2251.9,126323,283482847.0,2175,1365,560,167996051.0,99260982.0,75148,44064,2235.5,2252.7,119212,267257033.0,1925,2023-11-07 10:35:00
423,POSI,848,671,168679968.0,160561724.0,75134,71142,2245.1,2256.9,146276,329241692.0,1519,711,569,152191982.0,154002460.0,68045,68281,2236.6,2255.4,136326,306194442.0,1280,2023-11-07 10:40:00
424,POSI,1493,1105,148999809.0,223234363.0,66502,99080,2240.5,2253.1,165582,372234173.0,2598,1393,998,142247289.0,211307792.0,63570,93769,2237.6,2253.5,157339,353555082.0,2391,2023-11-07 10:45:00
425,POSI,1077,341,114419268.0,52677902.0,50887,23385,2248.5,2252.6,74272,167097170.0,1418,1003,282,111145466.0,48096182.0,49545,21303,2243.3,2257.7,70848,159241648.0,1285,2023-11-07 10:50:00
426,POSI,567,298,70595792.0,48143911.0,31398,21085,2248.4,2283.3,52483,118739703.0,865,477,230,65937281.0,45834749.0,29419,20046,2241.3,2286.5,49465,111772030.0,707,2023-11-07 10:55:00
427,POSI,779,422,127201464.0,67276998.0,56655,29694,2245.2,2265.7,86349,194478463.0,1201,725,351,125697318.0,59257126.0,56024,26261,2243.6,2256.5,82285,184954444.0,1076,2023-11-07 11:00:00
428,POSI,435,1327,105345835.0,152800763.0,47082,68181,2237.5,2241.1,115263,258146598.0,1762,362,1262,99476603.0,148251324.0,44473,65793,2236.8,2253.3,110266,247727927.0,1624,2023-11-07 11:05:00
429,POSI,1480,1111,153087181.0,169446999.0,68311,75321,2241.0,2249.7,143632,322534180.0,2591,1398,1087,147648866.0,165517213.0,65907,73575,2240.3,2249.6,139482,313166080.0,2485,2023-11-07 11:10:00
430,POSI,716,334,104781260.0,57209712.0,46807,25440,2238.6,2248.8,72247,161990972.0,1050,627,278,101980169.0,52914099.0,45566,23496,2238.1,2252.0,69062,154894268.0,905,2023-11-07 11:15:00
431,POSI,316,342,40479503.0,52290730.0,18116,23274,2234.5,2246.7,41390,92770233.0,658,245,288,38923270.0,50601918.0,17429,22498,2233.2,2249.2,39927,89525188.0,533,2023-11-07 11:20:00
432,POSI,1195,1712,275349180.0,401324238.0,123670,154854,2226.5,2591.6,278524,676673418.0,2907,947,1523,264840222.0,399810274.0,119017,148577,2225.2,2690.9,267594,664650497.0,2470,2023-11-07 11:25:00
433,POSI,448,954,74528186.0,106640822.0,33349,47649,2234.8,2238.0,80998,181169009.0,1402,335,881,66468775.0,104885566.0,29849,46742,2226.8,2243.9,76591,171354341.0,1216,2023-11-07 11:30:00
434,POSI,327,364,67307389.0,70670995.0,30209,31465,2228.1,2246.0,61674,137978385.0,691,273,337,65732798.0,68335456.0,29527,30427,2226.2,2245.9,59954,134068254.0,610,2023-11-07 11:35:00
435,POSI,853,727,122039551.0,129354091.0,54817,57734,2226.3,2240.5,112551,251393643.0,1580,743,681,117840248.0,123871510.0,52949,55275,2225.5,2241.0,108224,241711759.0,1424,2023-11-07 11:40:00
436,POSI,1455,3289,276115394.0,360365064.0,123853,160727,2229.4,2242.1,284580,636480458.0,4744,1325,3221,272279719.0,356477303.0,122175,158954,2228.6,2242.6,281129,628757023.0,4546,2023-11-07 11:45:00
437,POSI,1592,1274,158273928.0,230698769.0,71044,102903,2227.8,2241.9,173947,388972697.0,2866,1495,1230,149239791.0,227476381.0,66989,101438,2227.8,2242.5,168427,376716172.0,2725,2023-11-07 11:50:00
438,POSI,394,278,55648865.0,60286266.0,24947,26800,2230.7,2249.5,51747,115935131.0,672,335,248,49624728.0,52864372.0,22273,23526,2228.0,2247.1,45799,102489100.0,583,2023-11-07 11:55:00
439,POSI,357,151,34571076.0,22275373.0,15456,9938,2236.7,2241.4,25394,56846449.0,508,301,126,32482217.0,25330495.0,14535,11210,2234.8,2259.6,25745,57812713.0,427,2023-11-07 12:00:00
440,POSI,6858,4969,1549164934.0,1242371349.0,693919,554405,2232.5,2240.9,1248324,2791536283.0,11827,5502,4069,1397685964.0,1136203944.0,627331,506267,2228.0,2244.3,1133598,2533889909.0,9571,2023-11-07 12:05:00
441,POSI,4644,3878,893000299.0,977425594.0,403087,435970,2215.4,2242.0,839057,1870425894.0,8522,3197,3186,827528698.0,914262966.0,374630,406220,2208.9,2250.7,780850,1741791664.0,6383,2023-11-07 12:10:00
442,POSI,3417,2869,688585527.0,713570621.0,311774,322039,2208.6,2215.8,633813,1402156149.0,6286,2522,2389,637566348.0,655303631.0,288916,294550,2206.8,2224.8,583466,1292869980.0,4911,2023-11-07 12:15:00
443,POSI,8134,6605,1574505033.0,1592407472.0,717723,725595,2193.8,2194.6,1443318,3166912505.0,14739,5266,5409,1418864544.0,1463508411.0,648485,663791,2188.0,2204.8,1312276,2882372956.0,10675,2023-11-07 12:20:00
444,POSI,4228,3777,888085125.0,891416533.0,405758,406025,2188.7,2195.5,811783,1779501658.0,8005,3112,3273,804047123.0,833795751.0,368372,378686,2182.7,2201.8,747058,1637842874.0,6385,2023-11-07 12:25:00
445,POSI,6406,4648,1248438609.0,1327727843.0,572762,608569,2179.7,2181.7,1181331,2576166452.0,11054,4371,3824,1131170841.0,1204703888.0,520183,548507,2174.6,2196.3,1068690,2335874729.0,8195,2023-11-07 12:30:00
446,POSI,3704,2684,835541109.0,576944641.0,362811,263029,2303.0,2193.5,625840,1412485751.0,6388,2691,2066,740769714.0,534394016.0,339949,243324,2179.1,2196.2,583273,1275163730.0,4757,2023-11-07 12:35:00
447,POSI,5002,4211,992681011.0,858127299.0,437817,389712,2267.3,2202.0,827529,1850808311.0,9213,4354,3377,886655629.0,783439462.0,404809,354707,2190.3,2208.7,759516,1670095092.0,7731,2023-11-07 12:40:00
448,POSI,3331,3075,501929256.0,707125792.0,229356,322286,2188.4,2194.1,551642,1209055048.0,6406,2787,2721,513272303.0,671232174.0,215768,304629,2378.8,2203.4,520397,1184504478.0,5508,2023-11-07 12:45:00
449,POSI,1086,1179,220495652.0,254126973.0,100511,115457,2193.7,2201.1,215968,474622626.0,2265,829,931,211816025.0,248231434.0,96867,112664,2186.7,2203.3,209531,460047459.0,1760,2023-11-07 12:50:00
450,POSI,1953,2862,401675678.0,515494683.0,183414,234411,2190.0,2199.1,417825,917170361.0,4815,1736,2570,389220746.0,492752799.0,177868,223464,2188.3,2205.1,401332,881973545.0,4306,2023-11-07 12:55:00
451,POSI,1871,1503,313445867.0,325326552.0,143174,147762,2189.3,2201.7,290936,638772420.0,3374,1504,1340,299812369.0,323444279.0,137168,146828,2185.7,2202.9,283996,623256649.0,2844,2023-11-07 13:00:00
452,POSI,3071,2168,674803419.0,406855498.0,306862,184107,2199.0,2209.9,490969,1081658917.0,5239,2792,1813,654065878.0,386699460.0,298228,174931,2193.2,2210.6,473159,1040765338.0,4605,2023-11-07 13:05:00
453,POSI,2259,2739,405788968.0,607224224.0,185117,275700,2192.1,2202.5,460817,1013013193.0,4998,1939,2597,393212568.0,596136902.0,179595,270523,2189.4,2203.6,450118,989349471.0,4536,2023-11-07 13:10:00
454,POSI,1296,1553,253512973.0,249721739.0,115361,113429,2197.6,2201.6,228790,503234713.0,2849,1118,1378,248972574.0,240326519.0,113726,108990,2189.2,2205.0,222716,489299094.0,2496,2023-11-07 13:15:00
455,POSI,1571,659,253631282.0,146096288.0,115963,66417,2187.2,2199.7,182380,399727570.0,2230,1411,528,240879084.0,138966754.0,110535,63005,2179.2,2205.6,173540,379845838.0,1939,2023-11-07 13:20:00
456,POSI,1173,999,238915940.0,174243977.0,108787,79154,2196.2,2201.3,187941,413159917.0,2172,1021,897,228590130.0,167307381.0,104428,75892,2189.0,2204.5,180320,395897511.0,1918,2023-11-07 13:25:00
457,POSI,1211,1102,250939895.0,174398466.0,114175,78924,2197.9,2209.7,193099,425338362.0,2313,955,932,210334438.0,166109342.0,95886,75123,2193.6,2211.2,171009,376443780.0,1887,2023-11-07 13:30:00
458,POSI,1007,1280,134942459.0,267410758.0,61455,121305,2195.8,2204.4,182760,402353218.0,2287,924,1177,129866111.0,266073997.0,59223,120589,2192.8,2206.5,179812,395940108.0,2101,2023-11-07 13:35:00
459,POSI,676,778,89670288.0,116632427.0,40838,52858,2195.8,2206.5,93696,206302715.0,1454,633,743,84903544.0,113387440.0,38760,51303,2190.5,2210.2,90063,198290985.0,1376,2023-11-07 13:40:00
460,POSI,496,458,71494610.0,94395166.0,32579,42926,2194.5,2199.0,75505,165889776.0,954,359,368,67457270.0,87305040.0,30817,39494,2189.0,2210.6,70311,154762310.0,727,2023-11-07 13:45:00
461,POSI,2040,1639,226025146.0,355864669.0,103119,161862,2191.9,2198.6,264981,581889815.0,3679,1798,1557,217710496.0,340120653.0,99477,154346,2188.6,2203.6,253823,557831149.0,3355,2023-11-07 13:50:00
462,POSI,1441,2649,162609274.0,299498162.0,74203,135923,2191.4,2203.4,210126,462107436.0,4090,1323,2575,159403671.0,301895211.0,72809,136973,2189.3,2204.0,209782,461298883.0,3898,2023-11-07 13:55:00
463,POSI,1951,1209,271313410.0,217781981.0,123033,98624,2205.2,2208.2,221657,489095391.0,3160,1796,1076,256094875.0,210965300.0,116662,95350,2195.2,2212.5,212012,467060176.0,2872,2023-11-07 14:00:00
464,POSI,936,2193,158779535.0,245351769.0,72402,111196,2193.0,2206.5,183598,404131305.0,3129,828,2019,158124595.0,242800065.0,72108,109913,2192.9,2209.0,182021,400924660.0,2847,2023-11-07 14:05:00
465,POSI,991,896,99920250.0,112978181.0,45531,51378,2194.6,2199.0,96909,212898432.0,1887,860,756,90906202.0,108600271.0,41443,49192,2193.5,2207.7,90635,199506473.0,1616,2023-11-07 14:10:00
466,POSI,489,763,76309772.0,123831433.0,34849,56337,2189.7,2198.0,91186,200141206.0,1252,402,671,72385208.0,118610422.0,33070,53783,2188.8,2205.4,86853,190995630.0,1073,2023-11-07 14:15:00
467,POSI,491,445,64915313.0,88545500.0,29548,40124,2196.9,2206.8,69672,153460813.0,936,408,353,64196734.0,87601187.0,29323,39685,2189.3,2207.4,69008,151797922.0,761,2023-11-07 14:20:00
468,POSI,2108,821,264588615.0,161056923.0,119942,72829,2206.0,2211.4,192771,425645538.0,2929,1987,672,253071730.0,154499224.0,115226,69835,2196.3,2212.3,185061,407570955.0,2659,2023-11-07 14:25:00
469,POSI,2327,1689,439018417.0,261527798.0,198219,118071,2214.8,2215.0,316290,700546215.0,4016,2104,1391,398183327.0,246874875.0,180841,111242,2201.8,2219.3,292083,645058203.0,3495,2023-11-07 14:30:00
470,POSI,2582,1765,379160282.0,275907536.0,171230,124308,2214.3,2219.5,295538,655067818.0,4347,2303,1483,363915981.0,258013011.0,164901,116057,2206.9,2223.2,280958,621928992.0,3786,2023-11-07 14:35:00
471,POSI,757,869,149956388.0,94845342.0,67673,42682,2215.9,2222.1,110355,244801731.0,1626,617,707,134987026.0,93293587.0,61096,41938,2209.4,2224.6,103034,228280613.0,1324,2023-11-07 14:40:00
472,POSI,577,436,115334292.0,75231698.0,52027,33881,2216.8,2220.5,85908,190565990.0,1013,491,339,112535940.0,69673295.0,50940,31311,2209.2,2225.2,82251,182209235.0,830,2023-11-07 14:45:00
473,POSI,455,407,85720752.0,66479731.0,38712,30044,2214.3,2212.7,68756,152200483.0,862,369,309,82474155.0,63745094.0,37378,28651,2206.5,2224.9,66029,146219250.0,678,2023-11-07 14:50:00
474,POSI,1186,1570,254205666.0,255023031.0,115008,115668,2210.3,2204.8,230676,509228697.0,2756,1075,1445,247362267.0,239320805.0,112228,107800,2204.1,2220.0,220028,486683072.0,2520,2023-11-07 14:55:00
475,POSI,1404,605,156129138.0,113285786.0,70673,51088,2209.2,2217.5,121761,269414924.0,2009,1305,516,152669754.0,105108218.0,69206,47353,2206.0,2219.7,116559,257777973.0,1821,2023-11-07 15:00:00
476,POSI,2237,1420,224371271.0,242356188.0,101684,109586,2206.6,2211.6,211270,466727460.0,3657,2165,1333,218893016.0,238501062.0,99427,107612,2201.5,2216.3,207039,457394079.0,3498,2023-11-07 15:05:00
477,POSI,510,553,112015799.0,101539306.0,50778,45817,2206.0,2216.2,96595,213555105.0,1063,436,525,107691798.0,96490094.0,48905,43409,2202.1,2222.8,92314,204181892.0,961,2023-11-07 15:10:00
478,POSI,1519,1161,241580909.0,287778213.0,109914,130125,2197.9,2211.6,240039,529359122.0,2680,1361,1092,232878924.0,278371982.0,105990,125624,2197.2,2215.9,231614,511250906.0,2453,2023-11-07 15:15:00
479,POSI,1166,555,118354849.0,134694369.0,53797,60785,2200.0,2215.9,114582,253049219.0,1721,1086,503,115481762.0,133027347.0,52566,60007,2196.9,2216.9,112573,248509109.0,1589,2023-11-07 15:20:00
480,POSI,461,306,78660179.0,84520126.0,35661,38157,2205.8,2215.1,73818,163180306.0,767,397,276,75976598.0,83660816.0,34528,37758,2200.4,2215.7,72286,159637415.0,673,2023-11-07 15:25:00
481,POSI,343,238,33959956.0,46258089.0,15418,20911,2202.6,2212.1,36329,80218046.0,581,251,210,30571672.0,47375931.0,13910,21366,2197.8,2217.4,35276,77947603.0,461,2023-11-07 15:30:00
482,POSI,902,494,127568512.0,104957226.0,57746,47307,2209.1,2218.6,105053,232525738.0,1396,844,450,122027924.0,103490883.0,55421,46645,2201.8,2218.7,102066,225518808.0,1294,2023-11-07 15:35:00
483,POSI,536,574,75255376.0,114430564.0,34132,51732,2204.8,2212.0,85864,189685940.0,1110,474,506,73699820.0,111054171.0,33450,50086,2203.3,2217.3,83536,184753992.0,980,2023-11-07 15:40:00
484,POSI,368,1424,53186746.0,199303466.0,24149,90036,2202.4,2213.6,114185,252490212.0,1792,322,1388,51083725.0,196473225.0,23239,88736,2198.2,2214.1,111975,247556950.0,1710,2023-11-07 15:45:00
485,POSI,441,649,57563211.0,150005782.0,26123,67748,2203.5,2214.2,93871,207568994.0,1090,394,635,57157744.0,148426360.0,26000,67018,2198.4,2214.7,93018,205584105.0,1029,2023-11-07 15:50:00
486,POSI,685,1515,108528715.0,204140910.0,49221,92141,2204.9,2215.5,141362,312669625.0,2200,611,1470,135923181.0,199310745.0,62017,89945,2191.7,2215.9,151962,335233926.0,2081,2023-11-07 15:55:00
487,POSI,561,530,94165001.0,109910139.0,42670,49614,2206.8,2215.3,92284,204075140.0,1091,544,503,94146299.0,109295513.0,42751,49304,2202.2,2216.8,92055,203441812.0,1047,2023-11-07 16:00:00
488,POSI,1502,436,162974729.0,95056745.0,73919,42980,2204.8,2211.7,116899,258031474.0,1938,1475,390,160786949.0,92943089.0,73006,41897,2202.4,2218.4,114903,253730039.0,1865,2023-11-07 16:05:00
489,POSI,699,283,72274548.0,51007511.0,32808,23024,2203.0,2215.4,55832,123282060.0,982,614,246,70094233.0,49391586.0,31844,22265,2201.2,2218.4,54109,119485820.0,860,2023-11-07 16:10:00
490,POSI,712,669,111181058.0,118538504.0,50402,53576,2205.9,2212.5,103978,229719563.0,1381,663,628,107986725.0,115992238.0,49050,52304,2201.6,2217.7,101354,223978963.0,1291,2023-11-07 16:15:00
491,POSI,477,455,93071476.0,91191534.0,42046,41119,2213.6,2217.7,83165,184263010.0,932,421,362,85998404.0,85829933.0,39009,38604,2204.6,2223.3,77613,171828338.0,783,2023-11-07 16:20:00
492,POSI,751,866,129496918.0,85108284.0,58658,38415,2207.7,2215.5,97073,214605202.0,1617,711,813,128154241.0,82409888.0,58073,37084,2206.8,2222.2,95157,210564129.0,1524,2023-11-07 16:25:00
493,POSI,552,366,100607043.0,54090659.0,45572,24341,2207.7,2222.2,69913,154697702.0,918,497,328,99908230.0,55275164.0,45312,24838,2204.9,2225.4,70150,155183394.0,825,2023-11-07 16:30:00
494,POSI,324,279,39439701.0,25730800.0,17670,11258,2232.0,2285.6,28928,65170502.0,603,260,222,32942258.0,21121371.0,14930,9466,2206.4,2231.3,24396,54063629.0,482,2023-11-07 16:35:00
495,POSI,364,317,77964528.0,31451822.0,35254,14152,2211.5,2222.4,49406,109416351.0,681,312,267,76940891.0,26775351.0,34808,12036,2210.4,2224.6,46844,103716243.0,579,2023-11-07 16:40:00
496,POSI,212,266,33351767.0,17399072.0,14997,7878,2223.9,2208.6,22875,50750839.0,478,190,248,31144970.0,16467177.0,14117,7412,2206.2,2221.7,21529,47612148.0,438,2023-11-07 16:45:00
497,POSI,271,221,33375459.0,23653294.0,15107,10672,2209.3,2216.4,25779,57028753.0,492,225,185,30973288.0,19141824.0,14036,8557,2206.7,2237.0,22593,50115112.0,410,2023-11-07 16:50:00
498,POSI,629,870,100572489.0,56447184.0,45574,25540,2206.8,2210.1,71114,157019674.0,1499,554,823,97639086.0,54560902.0,44241,24589,2207.0,2218.9,68830,152199988.0,1377,2023-11-07 16:55:00
499,POSI,535,1128,65079563.0,87260884.0,29475,39431,2208.0,2213.0,68906,152340447.0,1663,484,1089,62462238.0,83565232.0,28319,37702,2205.7,2216.5,66021,146027471.0,1573,2023-11-07 17:00:00
500,POSI,1211,360,172926990.0,40330899.0,78123,18290,2213.5,2205.1,96413,213257890.0,1571,1126,299,171174870.0,41509785.0,77494,18710,2208.9,2218.6,96204,212684655.0,1425,2023-11-07 17:05:00
501,POSI,638,1125,76523348.0,149798330.0,34686,67713,2206.2,2212.3,102399,226321679.0,1763,585,1082,73377626.0,145074729.0,33271,65478,2205.5,2215.6,98749,218452356.0,1667,2023-11-07 17:10:00
502,POSI,1312,829,106130131.0,121430439.0,48094,54798,2206.7,2216.0,102892,227560571.0,2141,1192,785,101207015.0,118257083.0,45930,53333,2203.5,2217.3,99263,219464099.0,1977,2023-11-07 17:15:00
503,POSI,741,1826,93794315.0,287362467.0,42597,129878,2201.9,2212.6,172475,381156783.0,2567,653,1762,87056963.0,279932630.0,39603,126409,2198.2,2214.5,166012,366989594.0,2415,2023-11-07 17:20:00
504,POSI,476,1183,66044010.0,250349939.0,30011,113208,2200.7,2211.4,143219,316393949.0,1659,411,1143,67410650.0,250642384.0,30695,113244,2196.1,2213.3,143939,318053035.0,1554,2023-11-07 17:25:00
505,POSI,979,1589,129645294.0,306475774.0,59066,138744,2194.9,2208.9,197810,436121068.0,2568,825,1512,121406186.0,299251922.0,55336,135268,2194.0,2212.3,190604,420658108.0,2337,2023-11-07 17:30:00
506,POSI,664,700,79143354.0,113883061.0,35948,51471,2201.6,2212.6,87419,193026416.0,1364,556,637,68939698.0,112340987.0,31376,50763,2197.2,2213.0,82139,181280686.0,1193,2023-11-07 17:35:00
507,POSI,391,382,37403050.0,67945194.0,16891,30720,2214.4,2211.8,47611,105348245.0,773,351,340,34925928.0,65148529.0,15888,29387,2198.3,2216.9,45275,100074457.0,691,2023-11-07 17:40:00
508,POSI,1001,2395,76296081.0,340067462.0,34724,153906,2197.2,2209.6,188630,416363543.0,3396,859,2311,73625399.0,338451766.0,33547,152945,2194.7,2212.9,186492,412077165.0,3170,2023-11-07 17:45:00
509,POSI,1358,2635,133460875.0,453004275.0,60774,205095,2196.0,2208.8,265869,586465150.0,3993,1287,2600,133461864.0,453775946.0,60858,205341,2193.0,2209.9,266199,587237811.0,3887,2023-11-07 17:50:00
510,POSI,306,294,44682623.0,46113748.0,20276,20851,2203.7,2211.6,41127,90796372.0,600,242,261,41878099.0,48970806.0,19080,22090,2194.9,2216.9,41170,90848906.0,503,2023-11-07 17:55:00
511,POSI,330,405,50751734.0,65973532.0,23027,29786,2204.0,2214.9,52813,116725266.0,735,285,376,49871353.0,61793717.0,22699,27869,2197.1,2217.3,50568,111665071.0,661,2023-11-07 18:00:00
512,POSI,1972,893,174174131.0,163008067.0,79111,73793,2201.6,2209.0,152904,337182198.0,2865,1875,817,169511156.0,159163429.0,77087,71872,2199.0,2214.5,148959,328674585.0,2692,2023-11-07 18:05:00
513,POSI,791,372,70327786.0,63608935.0,31915,28670,2203.6,2218.7,60585,133936722.0,1163,742,333,68075637.0,56335993.0,30964,25389,2198.5,2218.9,56353,124411630.0,1075,2023-11-07 18:10:00
514,POSI,316,239,34150241.0,47033146.0,15543,21240,2197.1,2214.4,36783,81183387.0,555,265,207,33833793.0,45439139.0,15415,20483,2194.9,2218.4,35898,79272933.0,472,2023-11-07 18:15:00
515,POSI,916,795,108047282.0,99186598.0,49042,44915,2203.2,2208.3,93957,207233880.0,1711,863,740,106168843.0,94783563.0,48266,42831,2199.7,2213.0,91097,200952407.0,1603,2023-11-07 18:20:00
516,POSI,644,409,81182257.0,104496553.0,36955,47302,2196.8,2209.1,84257,185678811.0,1053,564,364,75602292.0,101547693.0,34451,45865,2194.5,2214.1,80316,177149986.0,928,2023-11-07 18:25:00
517,POSI,316,467,32062933.0,123481692.0,14599,55918,2196.2,2208.3,70517,155544626.0,783,262,426,30376613.0,121701663.0,13846,55044,2193.9,2211.0,68890,152078276.0,688,2023-11-07 18:30:00
518,POSI,518,271,63190805.0,66991377.0,28659,30285,2204.9,2212.0,58944,130182182.0,789,431,240,58811665.0,67513950.0,26777,30505,2196.4,2213.2,57282,126325615.0,671,2023-11-07 18:35:00
519,POSI,576,389,84533195.0,32619598.0,38298,14768,2207.2,2208.8,53066,117152794.0,965,537,350,78545371.0,31261869.0,35637,14130,2204.0,2212.4,49767,109807240.0,887,2023-11-07 18:40:00
520,POSI,1715,2493,204963246.0,325615042.0,93350,140932,2195.6,2310.4,234282,530578288.0,4208,1161,1692,172964417.0,240236404.0,78691,107712,2198.0,2230.4,186403,413200821.0,2853,2023-11-08 10:05:00
521,POSI,1762,869,236369476.0,141606752.0,106850,63588,2212.2,2226.9,170438,377976228.0,2631,1656,719,230556908.0,128215408.0,104533,57677,2205.6,2223.0,162210,358772316.0,2375,2023-11-08 10:10:00
522,POSI,867,1016,100039337.0,223185996.0,45569,100682,2195.3,2216.7,146251,323225334.0,1883,694,832,90284968.0,209041880.0,41159,94095,2193.6,2221.6,135254,299326848.0,1526,2023-11-08 10:15:00
523,POSI,633,567,54295825.0,106229874.0,24778,45508,2191.3,2334.3,70286,160525699.0,1200,439,445,44227352.0,95253549.0,20166,43067,2193.2,2211.8,63233,139480902.0,884,2023-11-08 10:20:00
524,POSI,1124,2185,143577302.0,520183080.0,65654,234900,2186.9,2214.5,300554,663760383.0,3309,908,2038,134612971.0,503223979.0,61565,228197,2186.5,2205.2,289762,637836950.0,2946,2023-11-08 10:25:00
525,POSI,1097,929,138727564.0,256883907.0,63367,116511,2189.3,2204.8,179878,395611472.0,2026,932,788,128915691.0,246435707.0,58942,111804,2187.2,2204.2,170746,375351399.0,1720,2023-11-08 10:30:00
526,POSI,852,774,99803280.0,116932427.0,45423,52761,2197.2,2216.3,98184,216735708.0,1626,735,677,94315398.0,117856539.0,42995,53285,2193.6,2211.8,96280,212171937.0,1412,2023-11-08 10:35:00
527,POSI,656,1023,74360940.0,189728307.0,33864,85935,2195.9,2207.8,119799,264089247.0,1679,561,982,70360374.0,185951747.0,32059,84225,2194.7,2207.8,116284,256312122.0,1543,2023-11-08 10:40:00
528,POSI,571,1354,89062741.0,157469956.0,40628,71965,2192.2,2188.1,112593,246532697.0,1925,452,1288,84717431.0,150977247.0,38657,68785,2191.5,2194.9,107442,235694678.0,1740,2023-11-08 10:45:00
529,POSI,628,530,65547581.0,146193426.0,29934,66477,2189.7,2199.2,96411,211741007.0,1158,529,477,61151528.0,139691835.0,27978,63415,2185.7,2202.8,91393,200843363.0,1006,2023-11-08 10:50:00
530,POSI,1753,1060,283082227.0,229847907.0,128347,104123,2205.6,2207.5,232470,512930134.0,2813,1682,994,274292746.0,230690515.0,124920,104483,2195.7,2207.9,229403,504983262.0,2676,2023-11-08 10:55:00
531,POSI,495,355,102918751.0,63024189.0,46831,28698,2197.7,2196.1,75529,165942940.0,850,414,292,98376385.0,52732734.0,44771,23810,2197.3,2214.7,68581,151109120.0,706,2023-11-08 11:00:00
532,POSI,296,375,50333708.0,69655326.0,22964,31567,2191.9,2206.6,54531,119989034.0,671,239,332,45157655.0,67285164.0,20614,30454,2190.6,2209.4,51068,112442819.0,571,2023-11-08 11:05:00
533,POSI,259,317,28229248.0,53543999.0,12890,24183,2190.0,2214.1,37073,81773248.0,576,194,270,25973499.0,49003959.0,11849,22207,2192.0,2206.7,34056,74977458.0,464,2023-11-08 11:10:00
534,POSI,254,393,27261014.0,65480021.0,12415,29684,2195.8,2205.9,42099,92741035.0,647,196,335,25970198.0,64618210.0,11846,29287,2192.3,2206.4,41133,90588408.0,531,2023-11-08 11:15:00
535,POSI,360,546,51623652.0,102738217.0,23535,46603,2193.5,2204.5,70138,154361869.0,906,306,494,52345011.0,98255882.0,23881,44525,2191.9,2206.8,68406,150600893.0,800,2023-11-08 11:20:00
536,POSI,765,1169,154391462.0,206026075.0,70461,93371,2191.2,2206.5,163832,360417537.0,1934,630,1075,145923581.0,203188197.0,66622,92036,2190.3,2207.7,158658,349111779.0,1705,2023-11-08 11:25:00
537,POSI,282,299,40137482.0,36822761.0,18318,16685,2191.1,2206.9,35003,76960244.0,581,247,266,37985113.0,35872487.0,17330,16247,2191.9,2207.9,33577,73857600.0,513,2023-11-08 11:30:00
538,POSI,1190,613,129616540.0,107148601.0,58881,48380,2201.3,2214.7,107261,236765141.0,1803,1060,484,121028442.0,102354160.0,55037,46198,2199.0,2215.6,101235,223382603.0,1544,2023-11-08 11:35:00
539,POSI,873,384,115331184.0,72363230.0,52328,32608,2204.0,2219.2,84936,187694415.0,1257,856,311,112734105.0,67752705.0,51177,30525,2202.8,2219.6,81702,180486810.0,1167,2023-11-08 11:40:00
540,POSI,1014,1140,151104835.0,106935796.0,68551,48219,2204.3,2217.7,116770,258040632.0,2154,970,1038,150405485.0,104420669.0,68291,47060,2202.4,2218.9,115351,254826154.0,2008,2023-11-08 11:45:00
541,POSI,971,556,149430419.0,53117641.0,67721,23902,2206.6,2222.3,91623,202548061.0,1527,908,494,147658091.0,49511645.0,66933,22296,2206.1,2220.7,89229,197169737.0,1402,2023-11-08 11:50:00
542,POSI,1105,477,228910332.0,65385214.0,103503,29464,2211.6,2219.2,132967,294295546.0,1582,1065,407,226255906.0,66951655.0,102544,30137,2206.4,2221.6,132681,293207561.0,1472,2023-11-08 11:55:00
543,POSI,671,449,91020098.0,51573118.0,41202,23379,2209.1,2206.0,64581,142593217.0,1120,628,410,86123433.0,48914822.0,39047,22001,2205.6,2223.3,61048,135038255.0,1038,2023-11-08 12:00:00
544,POSI,842,439,73899118.0,50816012.0,33550,23006,2202.7,2208.8,56556,124715131.0,1281,785,365,72965961.0,47590353.0,33137,21439,2201.9,2219.8,54576,120556315.0,1150,2023-11-08 12:05:00
545,POSI,1382,917,178919145.0,171487127.0,81374,77712,2198.7,2206.7,159086,350406272.0,2299,1328,828,176454961.0,164798363.0,80253,74351,2198.7,2216.5,154604,341253325.0,2156,2023-11-08 12:10:00
546,POSI,994,375,108047264.0,120036805.0,49160,54258,2197.9,2212.3,103418,228084069.0,1369,898,313,104871967.0,102685101.0,47749,46395,2196.3,2213.3,94144,207557069.0,1211,2023-11-08 12:15:00
547,POSI,709,252,39745576.0,33852974.0,18050,15334,2202.0,2207.7,33384,73598550.0,961,663,223,39523713.0,29843923.0,17978,13484,2198.4,2213.3,31462,69367637.0,886,2023-11-08 12:20:00
548,POSI,376,310,48860239.0,58952931.0,22261,26704,2194.9,2207.6,48965,107813170.0,686,341,238,47675996.0,54102620.0,21730,24437,2194.0,2214.0,46167,101778616.0,579,2023-11-08 12:25:00
549,POSI,459,398,36332945.0,77807824.0,16567,35358,2193.1,2200.6,51925,114140769.0,857,391,355,32896564.0,76156321.0,15007,34521,2192.1,2206.1,49528,109052886.0,746,2023-11-08 12:30:00
550,POSI,264,317,28706306.0,39994425.0,13077,18137,2195.2,2205.1,31214,68700731.0,581,200,256,26206870.0,38829478.0,11950,17582,2193.0,2208.5,29532,65036349.0,456,2023-11-08 12:35:00
551,POSI,207,1208,39461117.0,147563839.0,18017,66927,2190.2,2204.8,84944,187024957.0,1415,201,1192,39211975.0,145267517.0,17904,65866,2190.1,2205.5,83770,184479493.0,1393,2023-11-08 12:40:00
552,POSI,327,598,38867581.0,79699075.0,17691,36104,2197.0,2207.5,53795,118566656.0,925,248,535,36572932.0,77430066.0,16689,35073,2191.4,2207.7,51762,114002998.0,783,2023-11-08 12:45:00
553,POSI,254,313,32812169.0,44573084.0,14902,20166,2201.9,2210.3,35068,77385253.0,567,230,290,30708431.0,43843466.0,14008,19818,2192.2,2212.3,33826,74551898.0,520,2023-11-08 12:50:00
554,POSI,447,334,42981469.0,45267846.0,19597,20496,2193.3,2208.6,40093,88249315.0,781,393,270,42787777.0,43613740.0,19525,19711,2191.4,2212.7,39236,86401517.0,663,2023-11-08 12:55:00
555,POSI,322,414,26292406.0,77482177.0,11953,35222,2199.6,2199.8,47175,103774584.0,736,257,369,27390656.0,87074068.0,12503,39438,2190.7,2207.9,51941,114464725.0,626,2023-11-08 13:00:00
556,POSI,277,245,19360780.0,18091529.0,8811,8192,2197.3,2208.4,17003,37452309.0,522,225,215,13369544.0,17622841.0,6100,7990,2191.7,2205.6,14090,30992385.0,440,2023-11-08 13:05:00
557,POSI,184,204,19161006.0,26272385.0,8822,11913,2172.0,2205.4,20735,45433391.0,388,173,180,18492550.0,25973150.0,8502,11763,2175.1,2208.0,20265,44465700.0,353,2023-11-08 13:10:00
558,POSI,228,513,23362763.0,37074110.0,10668,16804,2190.0,2206.3,27472,60436874.0,741,179,488,20946368.0,36516951.0,9571,16542,2188.5,2207.5,26113,57463319.0,667,2023-11-08 13:15:00
559,POSI,218,554,32103751.0,44696444.0,14540,20229,2208.0,2209.5,34769,76800195.0,772,180,516,29809066.0,44036185.0,13609,19924,2190.4,2210.2,33533,73845252.0,696,2023-11-08 13:20:00
560,POSI,178,225,14370613.0,18260694.0,6543,8281,2196.3,2205.1,14824,32631308.0,403,137,172,14000556.0,17700688.0,6378,8012,2195.1,2209.3,14390,31701245.0,309,2023-11-08 13:25:00
561,POSI,191,271,26784220.0,24894155.0,12194,11294,2196.5,2204.2,23488,51678376.0,462,183,261,26238371.0,23744181.0,11954,10744,2194.9,2210.0,22698,49982552.0,444,2023-11-08 13:30:00
562,POSI,1324,340,172979901.0,23848519.0,78533,10785,2202.6,2211.3,89318,196828420.0,1664,1296,300,170202337.0,23250874.0,77381,10510,2199.5,2212.3,87891,193453211.0,1596,2023-11-08 13:35:00
563,POSI,228,597,46997304.0,41722581.0,21396,18960,2196.5,2200.6,40356,88719886.0,825,213,572,46922213.0,40563507.0,21367,18361,2196.0,2209.2,39728,87485721.0,785,2023-11-08 13:40:00
564,POSI,440,521,76049797.0,69588247.0,34857,31573,2181.8,2204.0,66430,145638044.0,961,378,470,51575235.0,62101902.0,23553,28131,2189.8,2207.6,51684,113677137.0,848,2023-11-08 13:45:00
565,POSI,248,242,23256994.0,24879800.0,10588,11294,2196.5,2202.9,21882,48136795.0,490,184,187,22318140.0,23809221.0,10188,10796,2190.6,2205.4,20984,46127361.0,371,2023-11-08 13:50:00
566,POSI,359,1670,58710059.0,255234079.0,26796,116032,2191.0,2199.7,142828,313944138.0,2029,305,1634,57608690.0,254010934.0,26308,115287,2189.8,2203.3,141595,311619625.0,1939,2023-11-08 13:55:00
567,POSI,426,646,53313320.0,118500670.0,24320,53761,2192.2,2204.2,78081,171813990.0,1072,401,637,50824185.0,116955923.0,23263,53056,2184.8,2204.4,76319,167780108.0,1038,2023-11-08 14:00:00
568,POSI,296,655,42941449.0,134768375.0,19621,61218,2188.5,2201.5,80839,177709825.0,951,290,628,42662160.0,134056064.0,19499,60819,2187.9,2204.2,80318,176718225.0,918,2023-11-08 14:05:00
569,POSI,378,2009,27111739.0,247248197.0,12371,112307,2191.6,2201.5,124678,274359937.0,2387,304,1962,25784577.0,246108296.0,11771,111775,2190.5,2201.8,123546,271892873.0,2266,2023-11-08 14:10:00
570,POSI,470,1747,50447818.0,343430858.0,23024,156129,2191.1,2199.7,179153,393878677.0,2217,401,1697,49384743.0,341150214.0,22555,154916,2189.5,2202.2,177471,390534957.0,2098,2023-11-08 14:15:00
571,POSI,329,1408,18202534.0,268016793.0,8314,121910,2189.4,2198.5,130224,286219327.0,1737,238,1351,15798686.0,264047754.0,7219,120029,2188.5,2199.9,127248,279846440.0,1589,2023-11-08 14:20:00
572,POSI,236,396,19973300.0,100427509.0,9123,45633,2189.3,2200.8,54756,120400809.0,632,198,363,19531123.0,98701199.0,8935,44812,2185.9,2202.6,53747,118232323.0,561,2023-11-08 14:25:00
573,POSI,556,1047,58271958.0,173639185.0,26651,79066,2186.5,2196.1,105717,231911143.0,1603,530,1019,59709823.0,169182380.0,27326,76878,2185.1,2200.7,104204,228892204.0,1549,2023-11-08 14:30:00
574,POSI,1223,2065,255968288.0,340759853.0,117258,155722,2182.9,2188.3,272980,596728141.0,3288,894,1875,223547959.0,305341655.0,102543,139031,2180.0,2196.2,241574,528889614.0,2769,2023-11-08 14:35:00
575,POSI,1162,987,188697807.0,114258223.0,86386,52110,2184.4,2192.6,138496,302956030.0,2149,1001,899,183820166.0,116780312.0,84196,53145,2183.2,2197.4,137341,300600478.0,1900,2023-11-08 14:40:00
576,POSI,292,260,43791510.0,32120633.0,20043,14618,2184.9,2197.3,34661,75912143.0,552,217,233,39088011.0,31039680.0,17913,14111,2182.1,2199.7,32024,70127691.0,450,2023-11-08 14:45:00
577,POSI,338,553,45024973.0,31169969.0,20612,14230,2184.4,2190.4,34842,76194942.0,891,282,530,44052481.0,30924026.0,20169,14097,2184.2,2193.7,34266,74976507.0,812,2023-11-08 14:50:00
578,POSI,929,533,119785936.0,52873581.0,54810,24105,2185.5,2193.5,78915,172659518.0,1462,843,491,117736996.0,52209413.0,53887,23770,2184.9,2196.4,77657,169946409.0,1334,2023-11-08 14:55:00
579,POSI,554,662,61713871.0,79126944.0,28302,36117,2180.5,2190.9,64419,140840815.0,1216,482,618,57987257.0,76279990.0,26591,34752,2180.7,2195.0,61343,134267248.0,1100,2023-11-08 15:00:00
580,POSI,774,819,87260534.0,94749711.0,39901,43098,2186.9,2198.5,82999,182010245.0,1593,710,779,83239972.0,93789655.0,38116,42659,2183.9,2198.6,80775,177029627.0,1489,2023-11-08 15:05:00
581,POSI,267,416,30441765.0,64496632.0,13941,29354,2183.6,2197.2,43295,94938397.0,683,221,361,29895940.0,63548761.0,13693,28910,2183.3,2198.2,42603,93444701.0,582,2023-11-08 15:10:00
582,POSI,190,166,26525611.0,26585764.0,12123,12094,2188.0,2198.3,24217,53111375.0,356,176,158,26057673.0,26264096.0,11937,11933,2182.9,2201.0,23870,52321769.0,334,2023-11-08 15:15:00
583,POSI,1046,1212,151097084.0,208487145.0,69291,95105,2180.6,2192.2,164396,359584230.0,2258,908,1136,145214293.0,196372547.0,66622,89476,2179.7,2194.7,156098,341586841.0,2044,2023-11-08 15:20:00
584,POSI,2254,658,144376824.0,128339309.0,66040,58606,2186.2,2189.9,124646,272716133.0,2912,2115,598,139584935.0,124025064.0,64065,56602,2178.8,2191.2,120667,263609999.0,2713,2023-11-08 15:25:00
585,POSI,585,267,41831204.0,47371177.0,19115,21611,2188.4,2192.0,40726,89202381.0,852,489,228,38920248.0,45814112.0,17852,20895,2180.2,2192.6,38747,84734360.0,717,2023-11-08 15:30:00
586,POSI,889,593,145742015.0,131116793.0,66529,59720,2190.7,2195.5,126249,276858808.0,1482,787,547,138575523.0,129026184.0,63342,58773,2187.7,2195.3,122115,267601707.0,1334,2023-11-08 15:35:00
587,POSI,439,394,78020571.0,57463845.0,35680,26102,2186.7,2201.5,61782,135484416.0,833,429,341,76751453.0,56762637.0,35185,25779,2181.4,2201.9,60964,133514090.0,770,2023-11-08 15:40:00
588,POSI,312,512,28516401.0,20195655.0,13054,9203,2184.5,2194.5,22257,48712057.0,824,270,466,27816455.0,19973926.0,12735,9092,2184.3,2196.9,21827,47790382.0,736,2023-11-08 15:45:00
589,POSI,348,201,56804837.0,20880350.0,25982,9494,2186.3,2199.3,35476,77685188.0,549,345,181,56133315.0,19565773.0,25690,8896,2185.0,2199.4,34586,75699088.0,526,2023-11-08 15:50:00
590,POSI,360,215,85470027.0,32706604.0,39094,14907,2186.3,2194.0,54001,118176631.0,575,298,162,83935407.0,31483623.0,38423,14304,2184.5,2201.0,52727,115419031.0,460,2023-11-08 15:55:00
591,POSI,1299,594,174999854.0,129554362.0,79953,58779,2188.8,2204.1,138732,304554216.0,1893,1226,527,173717238.0,127310578.0,79448,57780,2186.6,2203.4,137228,301027816.0,1753,2023-11-08 16:00:00
592,POSI,1694,722,245895571.0,76807196.0,112075,34867,2194.0,2202.9,146942,322702768.0,2416,1639,645,244320896.0,75511392.0,111454,34261,2192.1,2204.0,145715,319832289.0,2284,2023-11-08 16:05:00
593,POSI,1503,374,204497026.0,57043913.0,93180,25837,2194.6,2207.8,119017,261540939.0,1877,1488,326,203500565.0,55029262.0,92824,24920,2192.3,2208.2,117744,258529828.0,1814,2023-11-08 16:10:00
594,POSI,1344,396,280160381.0,82672809.0,127687,37428,2194.1,2208.8,165115,362833190.0,1740,1315,321,275328554.0,78014399.0,125537,35311,2193.2,2209.4,160848,353342953.0,1636,2023-11-08 16:15:00
595,POSI,626,228,152537285.0,42462535.0,69544,19226,2193.4,2208.6,88770,194999820.0,854,579,193,152217486.0,21719473.0,69400,9839,2193.3,2207.5,79239,173936959.0,772,2023-11-08 16:20:00
596,POSI,453,186,104822904.0,8556480.0,47779,3882,2193.9,2204.1,51661,113379384.0,639,448,143,103891378.0,8233549.0,47357,3734,2193.8,2205.0,51091,112124927.0,591,2023-11-08 16:25:00
597,POSI,161,192,22888020.0,18433611.0,10464,8356,2187.3,2206.0,18820,41321631.0,353,131,165,22299574.0,17434340.0,10198,7895,2186.7,2208.3,18093,39733914.0,296,2023-11-08 16:30:00
598,POSI,355,250,45369190.0,27690685.0,20642,12577,2197.9,2201.7,33219,73059876.0,605,330,186,45091552.0,28640825.0,20593,12978,2189.7,2206.9,33571,73732377.0,516,2023-11-08 16:35:00
599,POSI,628,1265,112726741.0,139664511.0,51411,63470,2192.7,2200.5,114881,252391253.0,1893,610,1224,113177174.0,136641545.0,51623,62069,2192.4,2201.4,113692,249818719.0,1834,2023-11-08 16:40:00
600,POSI,1021,1706,170243489.0,266236771.0,77748,121122,2189.7,2198.1,198870,436480260.0,2727,965,1669,166757504.0,264583037.0,76163,120337,2189.5,2198.7,196500,431340542.0,2634,2023-11-08 16:45:00
601,POSI,1293,2784,201288259.0,452637378.0,91936,206057,2189.4,2196.7,297993,653925637.0,4077,1219,2718,198612900.0,448856405.0,90723,204216,2189.2,2197.9,294939,647469306.0,3937,2023-11-08 16:50:00
602,POSI,507,1650,50813961.0,309079029.0,23230,140680,2187.4,2197.0,163910,359892991.0,2157,480,1591,50759216.0,308573065.0,23205,140449,2187.4,2197.0,163654,359332282.0,2071,2023-11-08 16:55:00
603,POSI,388,1506,28172128.0,362559029.0,12891,165061,2185.4,2196.5,177952,390731158.0,1894,371,1478,28206551.0,362785673.0,12910,165153,2184.9,2196.7,178063,390992224.0,1849,2023-11-08 17:00:00
604,POSI,182,323,8019773.0,32038365.0,3673,14591,2183.4,2195.8,18264,40058139.0,505,139,281,7937949.0,31705614.0,3637,14429,2182.6,2197.4,18066,39643564.0,420,2023-11-08 17:05:00
605,POSI,185,432,12508887.0,80047036.0,5710,36423,2190.7,2197.7,42133,92555923.0,617,151,402,8295838.0,79074108.0,3798,35977,2184.3,2197.9,39775,87369946.0,553,2023-11-08 17:10:00
606,POSI,285,608,20334002.0,112235885.0,9293,51119,2188.1,2195.6,60412,132569888.0,893,249,562,19435334.0,111237219.0,8884,50627,2187.7,2197.2,59511,130672553.0,811,2023-11-08 17:15:00
607,POSI,407,2717,28859331.0,536821578.0,13206,244593,2185.3,2194.8,257799,565680909.0,3124,340,2647,25998316.0,533028858.0,11920,242789,2181.1,2195.4,254709,559027174.0,2987,2023-11-08 17:20:00
608,POSI,929,1858,106380576.0,393856747.0,48759,179415,2181.8,2195.2,228174,500237324.0,2787,875,1824,103201693.0,386430726.0,47317,175966,2181.1,2196.1,223283,489632420.0,2699,2023-11-08 17:25:00
609,POSI,377,222,32537642.0,33121362.0,13987,15191,2326.3,2180.3,29178,65659004.0,599,243,154,27533777.0,30013243.0,12638,13673,2178.6,2195.1,26311,57547020.0,397,2023-11-08 17:30:00
610,POSI,496,500,42693739.0,74108681.0,19609,33765,2177.3,2194.8,53374,116802421.0,996,439,487,43949595.0,77654424.0,20190,35349,2176.8,2196.8,55539,121604020.0,926,2023-11-08 17:35:00
611,POSI,232,158,21630586.0,17632917.0,9922,8033,2180.1,2195.1,17955,39263503.0,390,168,124,20094487.0,15937330.0,9225,7251,2178.3,2197.9,16476,36031817.0,292,2023-11-08 17:40:00
612,POSI,761,1301,119403910.0,246578360.0,54680,112284,2183.7,2196.0,166964,365982270.0,2062,722,1256,116968285.0,241015879.0,53648,109755,2180.3,2195.9,163403,357984165.0,1978,2023-11-08 17:45:00
613,POSI,424,1322,58913656.0,136927956.0,27911,62426,2110.8,2193.4,90337,195841612.0,1746,348,1293,45811923.0,135253183.0,21011,61664,2180.4,2193.4,82675,181065106.0,1641,2023-11-08 17:50:00
614,POSI,736,2089,81297370.0,311406809.0,37311,142129,2178.9,2191.0,179440,392704180.0,2825,671,2019,79170059.0,306901266.0,36338,139977,2178.7,2192.5,176315,386071325.0,2690,2023-11-08 17:55:00
615,POSI,404,496,26071607.0,127424505.0,11953,58123,2181.2,2192.3,70076,153496113.0,900,310,464,24924715.0,144724009.0,11461,65912,2174.7,2195.7,77373,169648724.0,774,2023-11-08 18:00:00
616,POSI,378,1976,38515655.0,158934456.0,17710,72680,2174.8,2186.8,90390,197450112.0,2354,303,1923,36900690.0,156932940.0,16996,71632,2171.1,2190.8,88628,193833631.0,2226,2023-11-08 18:05:00
617,POSI,540,1498,46992680.0,286376553.0,21514,130680,2184.3,2191.4,152194,333369233.0,2038,473,1482,45495388.0,285328106.0,20930,130188,2173.7,2191.7,151118,330823494.0,1955,2023-11-08 18:10:00
618,POSI,825,1876,64427775.0,403151519.0,29534,183939,2181.5,2191.8,213473,467579294.0,2701,765,1864,62162838.0,400128425.0,28531,182590,2178.8,2191.4,211121,462291264.0,2629,2023-11-08 18:15:00
619,POSI,1180,2250,128875552.0,486012082.0,59053,221574,2182.4,2193.5,280627,614887634.0,3430,1108,2200,127405560.0,484562736.0,58448,220883,2179.8,2193.8,279331,611968296.0,3308,2023-11-08 18:20:00
620,POSI,878,1240,73569060.0,282286845.0,33683,128698,2184.2,2193.4,162381,355855906.0,2118,858,1203,71837033.0,279895598.0,32940,127590,2180.8,2193.7,160530,351732631.0,2061,2023-11-08 18:25:00
621,POSI,1039,2160,155783864.0,264697392.0,71372,120717,2182.7,2192.7,192089,420481256.0,3199,975,2138,154714794.0,262685627.0,70892,119721,2182.4,2194.1,190613,417400421.0,3113,2023-11-08 18:30:00
622,POSI,1047,967,149173220.0,217313644.0,68258,98983,2185.4,2195.5,167241,366486864.0,2014,974,925,144890850.0,216979410.0,66350,98833,2183.7,2195.4,165183,361870261.0,1899,2023-11-08 18:35:00
623,POSI,1008,222,195315480.0,20106019.0,89244,9139,2188.6,2200.0,98383,215421499.0,1230,972,193,192081516.0,18643874.0,87781,8455,2188.2,2205.1,96236,210725390.0,1165,2023-11-08 18:40:00
624,POSI,2049,3503,193231695.0,398443128.0,88806,175908,2175.9,2265.1,264714,591674823.0,5552,1567,2748,151144407.0,315244842.0,69330,143370,2180.1,2198.8,212700,466389249.0,4315,2023-11-09 10:05:00
625,POSI,2341,1288,146912528.0,138462453.0,67541,62788,2175.2,2205.2,130329,285374982.0,3629,1884,1160,132127611.0,126023537.0,60845,57186,2171.5,2203.7,118031,258151148.0,3044,2023-11-09 10:10:00
626,POSI,743,809,114801438.0,113810833.0,43353,49766,2648.1,2286.9,93119,228612272.0,1552,518,671,83049189.0,96541805.0,38311,44173,2167.8,2185.5,82484,179590995.0,1189,2023-11-09 10:15:00
627,POSI,570,374,82457765.0,44048616.0,37968,20131,2171.8,2188.1,58099,126506381.0,944,371,299,76646078.0,41577180.0,35291,18996,2171.8,2188.7,54287,118223258.0,670,2023-11-09 10:20:00
628,POSI,737,397,66791894.0,45959448.0,30603,21033,2182.5,2185.1,51636,112751342.0,1134,637,355,61655873.0,46133439.0,28383,21103,2172.3,2186.1,49486,107789312.0,992,2023-11-09 10:25:00
629,POSI,879,391,114978960.0,77954971.0,52859,35464,2175.2,2198.1,88323,192933931.0,1270,757,367,112794071.0,71115073.0,51903,32463,2173.2,2190.7,84366,183909145.0,1124,2023-11-09 10:30:00
630,POSI,620,288,73989782.0,28715302.0,33968,13159,2178.2,2182.2,47127,102705084.0,908,521,192,69382410.0,22809086.0,31881,10416,2176.3,2189.8,42297,92191496.0,713,2023-11-09 10:35:00
631,POSI,1039,371,91477171.0,63603962.0,41954,29028,2180.4,2191.1,70982,155081133.0,1410,980,328,83398998.0,62023929.0,38327,28296,2176.0,2192.0,66623,145422928.0,1308,2023-11-09 10:40:00
632,POSI,654,240,86982539.0,33185754.0,39883,15132,2180.9,2193.1,55015,120168294.0,894,595,193,85652723.0,31920212.0,39307,14544,2179.1,2194.7,53851,117572935.0,788,2023-11-09 10:45:00
633,POSI,373,351,37878922.0,44946138.0,17395,20531,2177.6,2189.2,37926,82825060.0,724,325,306,36769452.0,43009892.0,16892,19638,2176.7,2190.1,36530,79779344.0,631,2023-11-09 10:50:00
634,POSI,769,602,78513205.0,68448748.0,36015,31253,2180.0,2190.1,67268,146961953.0,1371,684,555,76018127.0,63447857.0,34874,28977,2179.8,2189.6,63851,139465985.0,1239,2023-11-09 10:55:00
635,POSI,725,2228,103498239.0,335500259.0,47536,153598,2177.3,2184.3,201134,438998499.0,2953,671,2187,98059537.0,326292458.0,45053,149336,2176.5,2185.0,194389,424351996.0,2858,2023-11-09 11:00:00
636,POSI,491,2327,97609344.0,286294861.0,44998,131105,2169.2,2183.7,176103,383904206.0,2818,410,2242,96269812.0,282569192.0,44386,129353,2168.9,2184.5,173739,378839005.0,2652,2023-11-09 11:05:00
637,POSI,421,830,43688069.0,114273095.0,20106,52354,2172.9,2182.7,72460,157961165.0,1251,359,815,41823942.0,111548440.0,19298,51100,2167.3,2182.9,70398,153372382.0,1174,2023-11-09 11:10:00
638,POSI,225,401,16859849.0,107429730.0,7748,48764,2176.0,2203.1,56512,124289579.0,626,165,225,16891714.0,53552025.0,7785,24555,2169.8,2180.9,32340,70443739.0,390,2023-11-09 11:15:00
639,POSI,205,257,19508411.0,42907502.0,8965,19665,2176.1,2181.9,28630,62415914.0,462,171,243,18599477.0,43575534.0,8576,19962,2168.8,2182.9,28538,62175011.0,414,2023-11-09 11:20:00
640,POSI,215,371,25708928.0,63555790.0,11771,29115,2184.1,2182.9,40886,89264718.0,586,148,336,24138139.0,62503553.0,11138,28632,2167.2,2183.0,39770,86641692.0,484,2023-11-09 11:25:00
641,POSI,368,1604,54321550.0,214650717.0,25039,98558,2169.5,2177.9,123597,268972268.0,1972,348,1553,52949539.0,207250881.0,24413,95026,2168.9,2181.0,119439,260200421.0,1901,2023-11-09 11:30:00
642,POSI,2870,1713,375155920.0,248546364.0,172011,113559,2181.0,2188.7,285570,623702284.0,4583,2779,1550,367121879.0,239439641.0,168773,109425,2175.2,2188.2,278198,606561520.0,4329,2023-11-09 11:35:00
643,POSI,337,999,62222896.0,84786374.0,28669,38803,2170.4,2185.0,67472,147009270.0,1336,306,940,58964512.0,82022187.0,27177,37520,2169.6,2186.1,64697,140986700.0,1246,2023-11-09 11:40:00
644,POSI,216,737,22462797.0,53109341.0,10367,24218,2166.8,2193.0,34585,75572138.0,953,162,708,20163485.0,48717532.0,9290,22314,2170.5,2183.3,31604,68881017.0,870,2023-11-09 11:45:00
645,POSI,862,617,176224495.0,78490676.0,80965,35960,2176.6,2182.7,116925,254715172.0,1479,808,561,172407164.0,76481138.0,79231,35006,2176.0,2184.8,114237,248888303.0,1369,2023-11-09 11:50:00
646,POSI,1197,349,126903770.0,56658166.0,58353,25897,2174.8,2187.8,84250,183561937.0,1546,1182,320,126753477.0,55585934.0,58283,25400,2174.8,2188.4,83683,182339412.0,1502,2023-11-09 11:55:00
647,POSI,426,247,79686774.0,39626237.0,36670,18121,2173.1,2186.8,54791,119313012.0,673,379,219,79301488.0,39043313.0,36494,17822,2173.0,2190.7,54316,118344802.0,598,2023-11-09 12:00:00
648,POSI,272,215,43705552.0,13213380.0,16207,6040,2696.7,2187.6,22247,56918932.0,487,250,191,56500886.0,11984377.0,16466,5481,3431.4,2186.5,21947,68485263.0,441,2023-11-09 12:05:00
649,POSI,2203,634,221219114.0,146721843.0,101649,67159,2176.3,2184.7,168808,367940957.0,2837,2036,602,210438862.0,141452804.0,96710,64547,2176.0,2191.5,161257,351891666.0,2638,2023-11-09 12:10:00
650,POSI,962,303,112025273.0,50153710.0,51366,22847,2180.9,2195.2,74213,162178983.0,1265,900,251,109462642.0,50178215.0,50203,22850,2180.4,2196.0,73053,159640857.0,1151,2023-11-09 12:15:00
651,POSI,273,189,41873093.0,13994414.0,19183,6381,2182.8,2193.1,25564,55867508.0,462,261,181,41674285.0,13163321.0,19107,6000,2181.1,2193.9,25107,54837607.0,442,2023-11-09 12:20:00
652,POSI,1053,184,100694964.0,20434322.0,46104,9305,2184.1,2196.1,55409,121129286.0,1237,1017,185,99874055.0,19734418.0,45769,8980,2182.1,2197.6,54749,119608473.0,1202,2023-11-09 12:25:00
653,POSI,581,428,37673164.0,47630800.0,17276,18177,2180.7,2620.4,35453,85303965.0,1009,528,397,36820368.0,38435700.0,16889,17565,2180.1,2188.2,34454,75256068.0,925,2023-11-09 12:30:00
654,POSI,219,136,18298226.0,10751677.0,8391,4912,2180.7,2188.9,13303,29049904.0,355,209,123,16890014.0,10384301.0,7758,4741,2177.1,2190.3,12499,27274316.0,332,2023-11-09 12:35:00
655,POSI,265,129,22233072.0,16255984.0,10226,7419,2174.2,2191.1,17645,38489057.0,394,255,124,20747311.0,16641605.0,9541,7588,2174.5,2193.1,17129,37388917.0,379,2023-11-09 12:40:00
656,POSI,195,405,9043983.0,45236990.0,4101,20696,2205.3,2185.8,24797,54280973.0,600,163,385,8508757.0,45008289.0,3905,20589,2178.9,2186.0,24494,53517046.0,548,2023-11-09 12:45:00
657,POSI,300,450,24422676.0,83693080.0,11213,38286,2178.1,2186.0,49499,108115756.0,750,262,442,22471228.0,83017976.0,10330,37949,2175.3,2187.6,48279,105489204.0,704,2023-11-09 12:50:00
658,POSI,222,114,16067084.0,10701918.0,7360,4888,2183.0,2189.4,12248,26769002.0,336,200,105,15188576.0,10613182.0,6971,4841,2178.8,2192.4,11812,25801759.0,305,2023-11-09 12:55:00
659,POSI,225,91,25000774.0,16146664.0,11483,7371,2177.2,2190.6,18854,41147439.0,316,219,66,24726428.0,10947059.0,11360,5003,2176.6,2188.1,16363,35673487.0,285,2023-11-09 13:00:00
660,POSI,473,235,38911842.0,34068407.0,17883,14021,2175.9,2429.8,31904,72980249.0,708,400,196,38138138.0,37310963.0,17533,13428,2175.2,2778.6,30961,75449102.0,596,2023-11-09 13:05:00
661,POSI,170,75,18303111.0,14595371.0,8428,6669,2171.7,2188.5,15097,32898482.0,245,180,80,16741273.0,12596919.0,7704,5746,2173.1,2192.3,13450,29338193.0,260,2023-11-09 13:10:00
662,POSI,221,142,7537778.0,14411890.0,3455,5243,2181.7,2748.8,8698,21949668.0,363,202,120,7170600.0,13810680.0,3297,4757,2174.9,2903.2,8054,20981280.0,322,2023-11-09 13:15:00
663,POSI,229,126,6997185.0,6269538.0,3214,2863,2177.1,2189.8,6077,13266724.0,355,214,106,6798183.0,6232022.0,3128,2843,2173.3,2192.1,5971,13030206.0,320,2023-11-09 13:20:00
664,POSI,291,128,18752394.0,11064636.0,8603,5077,2179.8,2179.4,13680,29817030.0,419,265,99,18103526.0,10084512.0,8327,4599,2174.1,2192.8,12926,28188039.0,364,2023-11-09 13:25:00
665,POSI,187,139,9631776.0,9014843.0,4428,4121,2175.2,2187.5,8549,18646620.0,326,161,121,9393611.0,8873125.0,4322,4052,2173.4,2189.8,8374,18266737.0,282,2023-11-09 13:30:00
666,POSI,303,108,15562588.0,6405697.0,7250,2951,2146.6,2170.7,10201,21968285.0,411,306,101,10353470.0,6022630.0,4756,2746,2176.9,2193.2,7502,16376100.0,407,2023-11-09 13:35:00
667,POSI,166,87,4654772.0,5500893.0,2142,2514,2173.1,2188.1,4656,10155666.0,253,139,88,4123534.0,5409118.0,1900,2471,2170.3,2189.0,4371,9532653.0,227,2023-11-09 13:40:00
668,POSI,147,93,6636180.0,8180345.0,3044,3714,2180.1,2202.6,6758,14816525.0,240,99,73,6236559.0,7735973.0,2872,3496,2171.5,2212.8,6368,13972533.0,172,2023-11-09 13:45:00
669,POSI,413,121,16508658.0,4558926.0,7581,2086,2177.6,2185.5,9667,21067585.0,534,374,97,17126743.0,4894611.0,7865,2235,2177.6,2190.0,10100,22021354.0,471,2023-11-09 13:50:00
670,POSI,164,131,6847412.0,9841093.0,3148,4512,2175.2,2181.1,7660,16688506.0,295,154,133,6428204.0,9504033.0,2957,4344,2173.9,2187.9,7301,15932237.0,287,2023-11-09 13:55:00
671,POSI,158,108,6646416.0,11059103.0,3059,5050,2172.7,2189.9,8109,17705519.0,266,137,85,7064121.0,11011684.0,3251,5033,2172.9,2187.9,8284,18075806.0,222,2023-11-09 14:00:00
672,POSI,146,111,5723172.0,9097227.0,2631,4159,2175.3,2187.4,6790,14820399.0,257,148,112,5643777.0,9051857.0,2597,4136,2173.2,2188.6,6733,14695634.0,260,2023-11-09 14:05:00
673,POSI,238,191,17897029.0,21046762.0,8229,9657,2174.9,2179.4,17886,38943792.0,429,221,171,17863242.0,20494510.0,8216,9375,2174.2,2186.1,17591,38357753.0,392,2023-11-09 14:10:00
674,POSI,283,414,30996955.0,65280826.0,14261,29943,2173.5,2180.2,44204,96277782.0,697,241,382,29307691.0,57349247.0,13488,26250,2172.9,2184.7,39738,86656938.0,623,2023-11-09 14:15:00
675,POSI,390,147,24008239.0,19470899.0,11021,7633,2178.4,2550.9,18654,43479138.0,537,377,131,29169349.0,18655534.0,13502,7178,2160.4,2599.0,20680,47824884.0,508,2023-11-09 14:20:00
676,POSI,182,177,10486178.0,18403693.0,4825,8442,2173.3,2180.0,13267,28889871.0,359,137,160,8696598.0,17797514.0,4006,8144,2170.9,2185.4,12150,26494113.0,297,2023-11-09 14:25:00
677,POSI,133,148,9256374.0,18703536.0,4252,8556,2176.9,2186.0,12808,27959910.0,281,112,120,9727254.0,18412440.0,4484,8419,2169.3,2187.0,12903,28139694.0,232,2023-11-09 14:30:00
678,POSI,610,546,53231938.0,61254195.0,24427,28015,2179.2,2186.5,52442,114486133.0,1156,580,535,52297949.0,60813950.0,24022,27815,2177.1,2186.4,51837,113111900.0,1115,2023-11-09 14:35:00
679,POSI,316,174,22419325.0,18270044.0,10292,8347,2178.3,2188.8,18639,40689369.0,490,310,157,22120956.0,18616241.0,10160,8504,2177.3,2189.1,18664,40737197.0,467,2023-11-09 14:40:00
680,POSI,244,156,33239333.0,30405117.0,15289,13928,2174.1,2183.0,29217,63644450.0,400,232,159,33084144.0,28937807.0,15228,13199,2172.6,2192.4,28427,62021951.0,391,2023-11-09 14:45:00
681,POSI,634,891,62733261.0,87630990.0,28787,40175,2179.2,2181.2,68962,150364252.0,1525,611,878,61115644.0,85939319.0,28083,39315,2176.3,2185.9,67398,147054964.0,1489,2023-11-09 14:50:00
682,POSI,1836,968,152415515.0,94310554.0,69954,43143,2178.8,2186.0,113097,246726069.0,2804,1800,940,151463586.0,91361420.0,69523,41775,2178.6,2187.0,111298,242825006.0,2740,2023-11-09 14:55:00
683,POSI,287,232,9632069.0,34727480.0,4417,15899,2180.7,2184.3,20316,44359550.0,519,231,205,8836070.0,34235462.0,4063,15672,2174.8,2184.5,19735,43071533.0,436,2023-11-09 15:00:00
684,POSI,395,379,24452928.0,74746765.0,11247,34212,2174.2,2184.8,45459,99199694.0,774,231,363,22161437.0,73415663.0,10213,33588,2169.9,2185.8,43801,95577100.0,594,2023-11-09 15:05:00
685,POSI,273,1124,20424685.0,206837851.0,9386,94710,2176.1,2183.9,104096,227262536.0,1397,254,1104,19830807.0,206910882.0,9122,94745,2174.0,2183.9,103867,226741689.0,1358,2023-11-09 15:10:00
686,POSI,1038,185,56987084.0,20590952.0,26142,9411,2179.9,2188.0,35553,77578036.0,1223,1032,183,54450100.0,20341985.0,24981,9288,2179.7,2190.1,34269,74792086.0,1215,2023-11-09 15:15:00
687,POSI,458,580,36406511.0,47962322.0,16740,21925,2174.8,2187.6,38665,84368833.0,1038,416,544,36303414.0,46711273.0,16697,21342,2174.2,2188.7,38039,83014688.0,960,2023-11-09 15:20:00
688,POSI,240,290,20354046.0,25161775.0,9251,11503,2200.2,2187.4,20754,45515821.0,530,202,294,17992795.0,24723079.0,8282,11283,2172.5,2191.2,19565,42715875.0,496,2023-11-09 15:25:00
689,POSI,1465,335,90291664.0,41464592.0,41448,18931,2178.4,2190.3,60379,131756256.0,1800,1465,325,90255115.0,41286136.0,41444,18834,2177.8,2192.1,60278,131541251.0,1790,2023-11-09 15:30:00
690,POSI,252,236,20577169.0,21072737.0,9430,9608,2182.1,2193.2,19038,41649906.0,488,217,216,19822057.0,20567463.0,9107,9380,2176.6,2192.7,18487,40389520.0,433,2023-11-09 15:35:00
691,POSI,108,111,9124022.0,15314922.0,4183,6987,2181.2,2191.9,11170,24438944.0,219,103,114,8869231.0,15194011.0,4083,6934,2172.2,2191.2,11017,24063242.0,217,2023-11-09 15:40:00
692,POSI,766,401,58122059.0,28265683.0,26676,12914,2178.8,2188.8,39590,86387743.0,1167,740,380,57542129.0,26221601.0,26407,11974,2179.0,2189.9,38381,83763731.0,1120,2023-11-09 15:45:00
693,POSI,262,309,26412454.0,15618548.0,12123,7158,2178.7,2182.0,19281,42031003.0,571,280,307,26524001.0,15659220.0,12175,7163,2178.6,2186.1,19338,42183222.0,587,2023-11-09 15:50:00
694,POSI,309,189,34343342.0,23418172.0,15788,10712,2175.3,2186.2,26500,57761515.0,498,226,168,33596271.0,21408683.0,15446,9770,2175.1,2191.3,25216,55004954.0,394,2023-11-09 15:55:00
695,POSI,150,69,10421059.0,7809123.0,4794,3588,2173.8,2176.5,8382,18230182.0,219,140,63,9862556.0,7343831.0,4540,3355,2172.4,2188.9,7895,17206388.0,203,2023-11-09 16:00:00
696,POSI,209,217,20948785.0,29776513.0,9637,13620,2173.8,2186.2,23257,50725299.0,426,156,190,19325112.0,29268171.0,8895,13385,2172.6,2186.6,22280,48593284.0,346,2023-11-09 16:05:00
697,POSI,218,250,18556666.0,44070603.0,8533,20171,2174.7,2184.8,28704,62627270.0,468,209,232,18129897.0,34362282.0,8343,15711,2173.1,2187.1,24054,52492180.0,441,2023-11-09 16:10:00
698,POSI,143,82,8401255.0,7860910.0,3860,3622,2176.5,2170.3,7482,16262165.0,225,110,60,10800207.0,10232052.0,4977,4672,2170.0,2190.1,9649,21032260.0,170,2023-11-09 16:15:00
699,POSI,1330,967,135538063.0,135652900.0,62353,62319,2173.7,2176.8,124672,271190964.0,2297,1294,911,133058389.0,131330418.0,61206,60157,2173.9,2183.1,121363,264388808.0,2205,2023-11-09 16:20:00
700,POSI,758,773,101837575.0,94004084.0,46840,43093,2174.2,2181.4,89933,195841660.0,1531,699,711,97414194.0,96156223.0,44807,44067,2174.1,2182.0,88874,193570418.0,1410,2023-11-09 16:25:00
701,POSI,1634,1000,154460137.0,93755763.0,70955,42975,2176.9,2181.6,113930,248215900.0,2634,1505,975,152449508.0,94216103.0,70065,43183,2175.8,2181.8,113248,246665612.0,2480,2023-11-09 16:30:00
702,POSI,1756,1047,167292526.0,102281677.0,76908,46885,2175.2,2181.5,123793,269574204.0,2803,1662,986,166511096.0,99325871.0,76557,45507,2175.0,2182.7,122064,265836968.0,2648,2023-11-09 16:35:00
703,POSI,865,709,78664355.0,85205923.0,36160,39059,2175.5,2181.5,75219,163870279.0,1574,829,701,77987394.0,84541641.0,35878,38744,2173.7,2182.1,74622,162529035.0,1530,2023-11-09 16:40:00
704,POSI,417,904,21550017.0,80613765.0,9904,36976,2175.9,2180.2,46880,102163782.0,1321,362,874,20500537.0,80085449.0,9431,36734,2173.7,2180.1,46165,100585986.0,1236,2023-11-09 16:45:00
705,POSI,422,325,27932122.0,33560897.0,12786,15377,2184.6,2182.5,28163,61493019.0,747,382,313,26133274.0,32766170.0,12022,15008,2173.8,2183.2,27030,58899444.0,695,2023-11-09 16:50:00
706,POSI,208,306,17085867.0,27525718.0,7860,12614,2173.8,2182.2,20474,44611585.0,514,193,300,16753060.0,27175799.0,7711,12452,2172.6,2182.4,20163,43928859.0,493,2023-11-09 16:55:00
707,POSI,926,401,43539688.0,27146489.0,19947,12450,2182.8,2180.4,32397,70686178.0,1327,918,383,41711524.0,27075583.0,19175,12404,2175.3,2182.8,31579,68787107.0,1301,2023-11-09 17:00:00
708,POSI,653,194,61444993.0,12752864.0,28208,5844,2178.3,2182.2,34052,74197857.0,847,623,176,61830966.0,12774326.0,28401,5851,2177.1,2183.3,34252,74605293.0,799,2023-11-09 17:05:00
709,POSI,303,171,57850677.0,18217040.0,26585,8337,2176.1,2185.1,34922,76067718.0,474,299,179,57400646.0,16982161.0,26383,7773,2175.7,2184.8,34156,74382807.0,478,2023-11-09 17:10:00
710,POSI,515,957,86232908.0,136375044.0,39791,62511,2167.1,2181.6,102302,222607952.0,1472,434,903,82281482.0,122358656.0,37975,56056,2166.7,2182.8,94031,204640138.0,1337,2023-11-09 17:15:00
711,POSI,341,794,40838514.0,80380482.0,18869,36923,2164.3,2177.0,55792,121218996.0,1135,278,791,34856540.0,78725192.0,16109,36140,2163.8,2178.3,52249,113581733.0,1069,2023-11-09 17:20:00
712,POSI,1026,2283,202795366.0,487012426.0,93836,224548,2161.2,2168.9,318384,689807793.0,3309,766,2208,179400029.0,476242415.0,82983,218946,2161.9,2175.2,301929,655642445.0,2974,2023-11-09 17:25:00
713,POSI,431,1409,58234688.0,307770932.0,26897,141278,2165.1,2178.5,168175,366005620.0,1840,371,1365,56905703.0,308205890.0,26315,141455,2162.5,2178.8,167770,365111593.0,1736,2023-11-09 17:30:00
714,POSI,233,202,12167076.0,30119563.0,5591,13829,2176.2,2178.0,19420,42286640.0,435,166,172,9361258.0,28136015.0,4335,12903,2159.5,2180.6,17238,37497273.0,338,2023-11-09 17:35:00
715,POSI,453,566,26320570.0,173656980.0,12118,79806,2172.0,2176.0,91924,199977551.0,1019,418,539,24119098.0,172716115.0,11134,79298,2166.3,2178.1,90432,196835214.0,957,2023-11-09 17:40:00
716,POSI,256,928,31207814.0,128004834.0,14415,58833,2165.0,2175.7,73248,159212649.0,1184,242,891,29648958.0,126740739.0,13693,58203,2165.3,2177.6,71896,156389698.0,1133,2023-11-09 17:45:00
717,POSI,396,2645,53051913.0,338863172.0,24544,155736,2161.5,2175.9,180280,391915085.0,3041,306,2571,53443928.0,337128463.0,24727,154890,2161.4,2176.6,179617,390572391.0,2877,2023-11-09 17:50:00
718,POSI,554,529,35398274.0,49076841.0,16375,22601,2161.7,2171.4,38976,84475115.0,1083,484,487,37514968.0,45377592.0,17384,20851,2158.0,2176.3,38235,82892560.0,971,2023-11-09 17:55:00
719,POSI,351,165,11432715.0,12505451.0,5283,5788,2164.1,2160.6,11071,23938167.0,516,241,95,11558326.0,9880246.0,5349,4538,2160.8,2177.2,9887,21438572.0,336,2023-11-09 18:00:00
720,POSI,805,456,45381654.0,77345364.0,20844,35653,2177.2,2169.4,56497,122727019.0,1261,714,408,46065856.0,76148112.0,21330,35058,2159.7,2172.1,56388,122213968.0,1122,2023-11-09 18:05:00
721,POSI,908,912,76963514.0,70562406.0,35490,32427,2168.6,2176.0,67917,147525921.0,1820,854,870,74619484.0,70009304.0,34536,32151,2160.6,2177.5,66687,144628789.0,1724,2023-11-09 18:10:00
722,POSI,1494,687,200557667.0,110786289.0,92559,50958,2166.8,2174.1,143517,311343956.0,2181,1379,597,195962444.0,107507589.0,90587,49340,2163.3,2178.9,139927,303470034.0,1976,2023-11-09 18:15:00
723,POSI,329,408,33363558.0,51562439.0,15396,23736,2167.0,2172.3,39132,84925997.0,737,294,382,33016238.0,50255667.0,15277,23109,2161.2,2174.7,38386,83271905.0,676,2023-11-09 18:20:00
724,POSI,374,176,40106979.0,18270089.0,18409,8425,2178.7,2168.6,26834,58377068.0,550,327,152,39353039.0,17500551.0,18172,8041,2165.6,2176.4,26213,56853590.0,479,2023-11-09 18:25:00
725,POSI,294,182,30916628.0,21062786.0,14268,9665,2166.9,2179.3,23933,51979414.0,476,244,136,33867511.0,24517426.0,15657,11247,2163.1,2179.9,26904,58384938.0,380,2023-11-09 18:30:00
726,POSI,1094,435,167476223.0,65202848.0,77008,29947,2174.8,2177.3,106955,232679071.0,1529,1065,412,160981365.0,61172835.0,74236,28087,2168.5,2178.0,102323,222154200.0,1477,2023-11-09 18:35:00
727,POSI,627,581,150702633.0,71957386.0,69454,32972,2169.8,2182.4,102426,222660019.0,1208,644,543,152592533.0,72044830.0,70411,33002,2167.2,2183.0,103413,224637363.0,1187,2023-11-09 18:40:00
728,POSI,1067,3146,168721502.0,398977943.0,77839,175610,2167.6,2272.0,253449,567699446.0,4213,749,2381,155351030.0,324202107.0,71476,147792,2173.5,2193.6,219268,479553137.0,3130,2023-11-10 10:05:00
729,POSI,619,2232,66681745.0,442968016.0,30769,202896,2167.2,2183.2,233665,509649761.0,2851,513,2110,62401526.0,432723970.0,28775,198200,2168.6,2183.3,226975,495125497.0,2623,2023-11-10 10:10:00
730,POSI,1001,2690,193741988.0,349293249.0,89400,160236,2167.1,2179.9,249636,543035238.0,3691,889,2611,181462897.0,344934062.0,83781,158216,2165.9,2180.1,241997,526396959.0,3500,2023-11-10 10:15:00
731,POSI,1332,2484,208359791.0,533552577.0,96095,244650,2168.3,2180.9,340745,741912369.0,3816,1208,2405,201801443.0,521779529.0,93081,239042,2168.0,2182.8,332123,723580973.0,3613,2023-11-10 10:20:00
732,POSI,497,494,54294246.0,117696731.0,25015,54026,2170.5,2178.5,79041,171990977.0,991,387,431,48852994.0,106245473.0,22578,48749,2163.7,2179.4,71327,155098467.0,818,2023-11-10 10:25:00
733,POSI,1351,1530,204793415.0,202756294.0,94664,93171,2163.4,2176.2,187835,407549709.0,2881,1173,1462,172966544.0,198078143.0,79956,91012,2163.3,2176.4,170968,371044687.0,2635,2023-11-10 10:30:00
734,POSI,1176,2468,160403316.0,504724942.0,74259,234030,2160.1,2156.7,308289,665128258.0,3644,806,2343,134291438.0,480772701.0,62211,221480,2158.6,2170.7,283691,615064140.0,3149,2023-11-10 10:35:00
735,POSI,555,1120,73869095.0,191243648.0,34222,88144,2158.5,2169.7,122366,265112744.0,1675,375,1054,66839326.0,186983304.0,30999,86168,2156.2,2170.0,117167,253822630.0,1429,2023-11-10 10:40:00
736,POSI,583,679,93633043.0,115938719.0,43275,53218,2163.7,2178.6,96493,209571762.0,1262,510,630,89408188.0,111348292.0,41431,51237,2158.0,2173.2,92668,200756481.0,1140,2023-11-10 10:45:00
737,POSI,1087,1727,244428171.0,207217628.0,113077,95206,2161.6,2176.5,208283,451645800.0,2814,1012,1600,242189116.0,202600871.0,112114,93176,2160.2,2174.4,205290,444789987.0,2612,2023-11-10 10:50:00
738,POSI,594,508,124338723.0,69882852.0,57506,31946,2162.2,2187.5,89452,194221575.0,1102,493,455,122496186.0,74294852.0,56654,34130,2162.2,2176.8,90784,196791038.0,948,2023-11-10 10:55:00
739,POSI,308,683,44779725.0,56688826.0,20724,26148,2160.8,2168.0,46872,101468552.0,991,295,662,43984969.0,55405703.0,20376,25476,2158.7,2174.8,45852,99390672.0,957,2023-11-10 11:00:00
740,POSI,2613,1369,373034120.0,218155956.0,171543,100098,2174.6,2179.4,271641,591190076.0,3982,2522,1295,358527211.0,209490755.0,165498,96082,2166.4,2180.3,261580,568017966.0,3817,2023-11-10 11:05:00
741,POSI,641,580,106691738.0,64940163.0,49327,29827,2162.9,2177.2,79154,171631901.0,1221,589,509,107655609.0,62799484.0,49769,28779,2163.1,2182.1,78548,170455094.0,1098,2023-11-10 11:10:00
742,POSI,661,351,106512192.0,55592318.0,49194,25483,2165.1,2181.5,74677,162104510.0,1012,607,297,104169754.0,53426153.0,48125,24488,2164.6,2181.7,72613,157595908.0,904,2023-11-10 11:15:00
743,POSI,616,728,133047239.0,107178681.0,61486,49149,2163.9,2180.7,110635,240225920.0,1344,580,666,132391572.0,106381051.0,61183,48763,2163.9,2181.6,109946,238772624.0,1246,2023-11-10 11:20:00
744,POSI,862,632,160233447.0,106535431.0,74137,48831,2161.3,2181.7,122968,266768879.0,1494,779,450,154140993.0,90722297.0,71307,41622,2161.7,2179.7,112929,244863291.0,1229,2023-11-10 11:25:00
745,POSI,323,173,51706917.0,28169969.0,23919,12939,2161.8,2177.1,36858,79876886.0,496,216,120,49664136.0,23208725.0,22971,10667,2162.0,2175.8,33638,72872861.0,336,2023-11-10 11:30:00
746,POSI,691,167,72383980.0,35139432.0,33456,16078,2163.6,2185.6,49534,107523413.0,858,648,143,72655902.0,34054600.0,33588,15617,2163.2,2180.6,49205,106710502.0,791,2023-11-10 11:35:00
747,POSI,377,114,69288972.0,11693296.0,31978,5353,2166.8,2184.4,37331,80982269.0,491,352,88,68600350.0,10070820.0,31668,4622,2166.2,2178.9,36290,78671170.0,440,2023-11-10 11:40:00
748,POSI,275,95,41861845.0,10982131.0,19327,5056,2166.0,2172.1,24383,52843977.0,370,280,83,41234148.0,9117720.0,19041,4188,2165.5,2177.1,23229,50351869.0,363,2023-11-10 11:45:00
749,POSI,315,126,43751751.0,17533828.0,20225,8056,2163.3,2176.5,28281,61285579.0,441,286,94,43507998.0,18006051.0,20114,8253,2163.1,2181.8,28367,61514050.0,380,2023-11-10 11:50:00
750,POSI,1051,548,217358615.0,88944292.0,100312,40350,2166.8,2204.3,140662,306302907.0,1599,1029,516,211163667.0,79733982.0,97483,36545,2166.2,2181.8,134028,290897650.0,1545,2023-11-10 11:55:00
751,POSI,7025,1503,802464756.0,366057952.0,369295,167295,2173.0,2188.1,536590,1168522709.0,8528,6958,1415,787199623.0,358380719.0,362311,163762,2172.7,2188.4,526073,1145580342.0,8373,2023-11-10 12:00:00
752,POSI,288,202,38239823.0,12695709.0,17588,5820,2174.2,2181.4,23408,50935533.0,490,248,162,38353773.0,12288753.0,17653,5622,2172.6,2185.8,23275,50642526.0,410,2023-11-10 12:05:00
753,POSI,145,209,42275463.0,26633607.0,19485,12191,2169.6,2184.7,31676,68909071.0,354,159,199,45294421.0,19953319.0,20880,9122,2169.3,2187.4,30002,65247740.0,358,2023-11-10 12:10:00
754,POSI,210,269,57754956.0,52983830.0,26696,24249,2163.4,2185.0,50945,110738786.0,479,169,231,57981849.0,46821587.0,26798,21414,2163.7,2186.5,48212,104803437.0,400,2023-11-10 12:15:00
755,POSI,426,377,121670552.0,103369941.0,56245,46739,2163.2,2211.6,102984,225040494.0,803,365,330,116504854.0,101859306.0,53860,46192,2163.1,2205.1,100052,218364160.0,695,2023-11-10 12:20:00
756,POSI,2732,1280,785946824.0,510468575.0,362047,229845,2170.8,2220.9,591892,1296415400.0,4012,2699,1247,785701984.0,510342278.0,361933,232806,2170.8,2192.1,594739,1296044262.0,3946,2023-11-10 12:25:00
757,POSI,248,137,58191921.0,58051753.0,26869,22380,2165.8,2593.9,49249,116243674.0,385,231,122,57178521.0,35112348.0,26396,12442,2166.2,2822.1,38838,92290869.0,353,2023-11-10 12:30:00
758,POSI,611,396,92332786.0,56833027.0,42657,22654,2164.5,2508.7,65311,149165813.0,1007,606,384,90794968.0,56873555.0,41946,22532,2164.6,2524.1,64478,147668523.0,990,2023-11-10 12:35:00
759,POSI,689,903,124749649.0,153438877.0,57820,65121,2157.6,2356.2,122941,278188526.0,1592,606,781,122777092.0,157169445.0,56893,65054,2158.0,2416.0,121947,279946538.0,1387,2023-11-10 12:40:00
760,POSI,458,990,47409716.0,95559983.0,21819,44131,2172.9,2165.4,65950,142969699.0,1448,349,926,40405307.0,94085510.0,18727,43238,2157.6,2176.0,61965,134490817.0,1275,2023-11-10 12:45:00
761,POSI,660,809,44244255.0,118762902.0,20481,54859,2160.3,2164.9,75340,163007157.0,1469,591,761,39843957.0,117109794.0,18456,54044,2158.9,2166.9,72500,156953751.0,1352,2023-11-10 12:50:00
762,POSI,178,157,12307774.0,18158577.0,5700,8380,2159.3,2166.9,14080,30466351.0,335,182,134,12104148.0,17699376.0,5612,8159,2156.8,2169.3,13771,29803525.0,316,2023-11-10 12:55:00
763,POSI,266,148,14368301.0,20332557.0,6640,9427,2163.9,2156.8,16067,34700859.0,414,216,130,9264167.0,19606753.0,4293,9043,2158.0,2168.2,13336,28870921.0,346,2023-11-10 13:00:00
764,POSI,433,541,29294379.0,105358318.0,13552,48653,2161.6,2165.5,62205,134652698.0,974,331,502,27547048.0,104311989.0,12767,48139,2157.7,2166.9,60906,131859037.0,833,2023-11-10 13:05:00
765,POSI,469,302,26891354.0,54945017.0,12449,25425,2160.1,2161.1,37874,81836371.0,771,432,285,26007797.0,52038360.0,12048,24009,2158.7,2167.5,36057,78046158.0,717,2023-11-10 13:10:00
766,POSI,522,601,78610985.0,89476951.0,36468,41357,2155.6,2163.5,77825,168087936.0,1123,428,552,80553143.0,88478498.0,37404,40755,2153.6,2171.0,78159,169031641.0,980,2023-11-10 13:15:00
767,POSI,828,696,134665182.0,121117209.0,62568,55791,2152.3,2170.9,118359,255782392.0,1524,752,648,130584243.0,122092145.0,60697,56155,2151.4,2174.2,116852,252676389.0,1400,2023-11-10 13:20:00
768,POSI,1071,739,92615095.0,88169833.0,42951,40692,2156.3,2166.8,83643,180784928.0,1810,964,694,91475752.0,85356361.0,42425,39336,2156.2,2169.9,81761,176832113.0,1658,2023-11-10 13:25:00
769,POSI,484,1065,99560154.0,206821518.0,46270,95440,2151.7,2167.0,141710,306381672.0,1549,425,1029,96331972.0,205822612.0,44785,94946,2151.0,2167.8,139731,302154585.0,1454,2023-11-10 13:30:00
770,POSI,367,469,40672474.0,74590111.0,18886,34453,2153.6,2165.0,53339,115262585.0,836,295,441,38812808.0,71642062.0,18018,33056,2154.1,2167.3,51074,110454870.0,736,2023-11-10 13:35:00
771,POSI,323,373,27056361.0,37972019.0,12538,17559,2157.9,2162.5,30097,65028381.0,696,230,339,25167564.0,36724758.0,11671,16950,2156.4,2166.7,28621,61892323.0,569,2023-11-10 13:40:00
772,POSI,848,986,127065892.0,140277644.0,58873,64652,2158.3,2169.7,123525,267343537.0,1834,756,934,121519445.0,132725399.0,56345,61170,2156.7,2169.8,117515,254244845.0,1690,2023-11-10 13:45:00
773,POSI,516,390,64923368.0,70550469.0,30101,32556,2156.9,2167.0,62657,135473837.0,906,472,365,63400072.0,69912202.0,29406,32175,2156.0,2172.9,61581,133312274.0,837,2023-11-10 13:50:00
774,POSI,396,520,67426762.0,76183893.0,31292,35043,2154.8,2174.0,66335,143610655.0,916,357,497,67093956.0,70702949.0,31141,32519,2154.5,2174.2,63660,137796905.0,854,2023-11-10 13:55:00
775,POSI,441,152,44055157.0,37024386.0,20439,17029,2155.4,2174.2,37468,81079543.0,593,387,139,42854070.0,36535626.0,19893,16783,2154.2,2176.9,36676,79389696.0,526,2023-11-10 14:00:00
776,POSI,298,479,30394414.0,35402029.0,14081,16307,2158.5,2171.0,30388,65796444.0,777,245,459,30109232.0,33110216.0,13956,15252,2157.4,2170.9,29208,63219449.0,704,2023-11-10 14:05:00
777,POSI,2443,584,199032602.0,90921185.0,92017,41801,2163.0,2175.1,133818,289953787.0,3027,2356,525,193595855.0,85006404.0,89526,39057,2162.5,2176.5,128583,278602260.0,2881,2023-11-10 14:10:00
778,POSI,994,764,74158156.0,65478581.0,34292,30138,2162.5,2172.6,64430,139636737.0,1758,950,753,73739870.0,62563821.0,34110,28774,2161.8,2174.3,62884,136303692.0,1703,2023-11-10 14:15:00
779,POSI,1227,124,70574640.0,36351687.0,32636,16710,2162.5,2175.4,49346,106926328.0,1351,1195,112,70036915.0,36540001.0,32391,16788,2162.2,2176.6,49179,106576916.0,1307,2023-11-10 14:20:00
780,POSI,836,292,48751996.0,33521203.0,22552,15448,2161.8,2169.9,38000,82273199.0,1128,776,253,47253139.0,33097703.0,21865,15220,2161.1,2174.6,37085,80350842.0,1029,2023-11-10 14:25:00
781,POSI,1553,447,98275251.0,59996750.0,45515,27618,2159.2,2172.4,73133,158272002.0,2000,1482,430,95728627.0,57744360.0,44328,26566,2159.6,2173.6,70894,153472987.0,1912,2023-11-10 14:30:00
782,POSI,901,187,45194516.0,16718693.0,20903,7701,2162.1,2171.0,28604,61913209.0,1088,870,176,44259072.0,16114401.0,20476,7420,2161.5,2171.8,27896,60373473.0,1046,2023-11-10 14:35:00
783,POSI,1779,225,110507631.0,51386309.0,51188,23634,2158.9,2174.3,74822,161893941.0,2004,1709,200,109493140.0,51551832.0,50714,23703,2159.0,2174.9,74417,161044973.0,1909,2023-11-10 14:40:00
784,POSI,1300,548,96173101.0,61899133.0,44548,28521,2158.9,2170.3,73069,158072234.0,1848,1255,524,98735538.0,60539132.0,45741,27839,2158.6,2174.6,73580,159274670.0,1779,2023-11-10 14:45:00
785,POSI,410,513,49992549.0,106392461.0,23214,49047,2153.6,2169.2,72261,156385011.0,923,355,494,44126467.0,103973883.0,20492,47913,2153.4,2170.1,68405,148100350.0,849,2023-11-10 14:50:00
786,POSI,335,280,30003722.0,33252671.0,13923,15373,2155.0,2163.1,29296,63256394.0,615,275,264,28321390.0,32680236.0,13147,15058,2154.2,2170.3,28205,61001627.0,539,2023-11-10 14:55:00
787,POSI,352,145,28531600.0,23908589.0,13231,11006,2156.4,2172.3,24237,52440190.0,497,292,124,27242446.0,21727583.0,12648,10002,2153.9,2172.3,22650,48970029.0,416,2023-11-10 15:00:00
788,POSI,299,146,26619825.0,38528811.0,12354,17750,2154.8,2170.6,30104,65148636.0,445,254,127,25092180.0,38355742.0,11664,17650,2151.3,2173.1,29314,63447923.0,381,2023-11-10 15:05:00
789,POSI,302,362,32698368.0,49135526.0,15159,22631,2157.0,2171.2,37790,81833894.0,664,245,351,31643492.0,50882067.0,14679,23433,2155.7,2171.4,38112,82525560.0,596,2023-11-10 15:10:00
790,POSI,282,435,23706114.0,40154596.0,10995,18501,2156.1,2170.4,29496,63860710.0,717,224,425,23280708.0,43588962.0,10802,20072,2155.2,2171.6,30874,66869670.0,649,2023-11-10 15:15:00
791,POSI,201,177,10949857.0,17270076.0,5071,7967,2159.3,2167.7,13038,28219933.0,378,145,162,10360951.0,18128810.0,4806,8355,2155.8,2169.8,13161,28489762.0,307,2023-11-10 15:20:00
792,POSI,221,382,17741538.0,36835244.0,8225,16993,2157.0,2167.7,25218,54576783.0,603,162,350,17150063.0,36323827.0,7955,16746,2155.9,2169.1,24701,53473890.0,512,2023-11-10 15:25:00
793,POSI,314,522,38477661.0,95465384.0,17836,44028,2157.3,2168.3,61864,133943046.0,836,277,511,37546157.0,96705734.0,17430,44590,2154.1,2168.8,62020,134251892.0,788,2023-11-10 15:30:00
794,POSI,1624,691,120728963.0,126943604.0,55945,58507,2158.0,2169.7,114452,247672567.0,2315,1560,663,118943068.0,124849297.0,55145,57530,2156.9,2170.2,112675,243792365.0,2223,2023-11-10 15:35:00
795,POSI,279,288,38344183.0,40997793.0,17830,18913,2150.5,2167.7,36743,79341976.0,567,219,255,36709292.0,40285405.0,17041,18543,2154.2,2172.5,35584,76994698.0,474,2023-11-10 15:40:00
796,POSI,327,176,29532725.0,27499869.0,13682,12688,2158.5,2167.4,26370,57032595.0,503,252,141,29027742.0,26789074.0,13454,12340,2157.6,2170.9,25794,55816817.0,393,2023-11-10 15:45:00
797,POSI,340,244,43747629.0,53043149.0,20331,24458,2151.8,2168.7,44789,96790779.0,584,311,222,42364323.0,51620325.0,19694,23744,2151.1,2174.0,43438,93984649.0,533,2023-11-10 15:50:00
798,POSI,256,113,19771528.0,19908372.0,9155,9172,2159.6,2170.6,18327,39679900.0,369,202,94,18125110.0,19114444.0,8402,8807,2157.2,2170.4,17209,37239554.0,296,2023-11-10 15:55:00
799,POSI,229,98,9263605.0,9678158.0,4272,4400,2168.4,2199.6,8672,18941763.0,327,168,77,12244097.0,11150689.0,5679,5131,2156.0,2173.2,10810,23394787.0,245,2023-11-10 16:00:00
800,POSI,290,422,26696743.0,31081809.0,12378,14439,2156.8,2152.6,26817,57778552.0,712,257,409,25943047.0,30041112.0,12034,13860,2155.8,2167.5,25894,55984159.0,666,2023-11-10 16:05:00
801,POSI,287,244,22407584.0,33785069.0,10378,15404,2159.1,2193.3,25782,56192654.0,531,216,228,21623822.0,30298397.0,10040,13966,2153.8,2169.4,24006,51922219.0,444,2023-11-10 16:10:00
802,POSI,273,135,14828124.0,21277739.0,6873,9907,2157.4,2147.7,16780,36105863.0,408,245,129,14409950.0,21026356.0,6683,9697,2156.2,2168.3,16380,35436307.0,374,2023-11-10 16:15:00
803,POSI,286,95,12875421.0,10217433.0,5959,4713,2160.7,2167.9,10672,23092854.0,381,245,79,12201114.0,9886534.0,5662,4556,2154.9,2170.0,10218,22087649.0,324,2023-11-10 16:20:00
804,POSI,286,241,20265899.0,62771196.0,9400,29033,2155.9,2162.1,38433,83037095.0,527,257,220,19715836.0,60488443.0,9151,27951,2154.5,2164.1,37102,80204279.0,477,2023-11-10 16:25:00
805,POSI,518,317,21496642.0,98562593.0,9962,45582,2157.9,2162.3,55544,120059235.0,835,429,298,20232694.0,98584740.0,9381,45567,2156.8,2163.5,54948,118817434.0,727,2023-11-10 16:30:00
806,POSI,396,262,20423208.0,64743754.0,9461,29920,2158.7,2163.9,39381,85166963.0,658,351,256,19678850.0,64124005.0,9123,29629,2157.1,2164.2,38752,83802855.0,607,2023-11-10 16:35:00
807,POSI,217,106,12406610.0,16855288.0,5752,7780,2156.9,2166.5,13532,29261898.0,323,152,84,11905884.0,15476447.0,5525,7142,2154.9,2167.0,12667,27382331.0,236,2023-11-10 16:40:00
808,POSI,232,112,18498846.0,19672817.0,8569,9180,2158.8,2143.0,17749,38171663.0,344,174,97,13940276.0,19351714.0,6469,8924,2154.9,2168.5,15393,33291991.0,271,2023-11-10 16:45:00
809,POSI,497,799,20606961.0,81140879.0,9539,36382,2160.3,2230.2,45921,101747840.0,1296,448,789,21610861.0,78251017.0,10026,36157,2155.5,2164.2,46183,99861878.0,1237,2023-11-10 16:50:00
810,POSI,219,148,16385603.0,33617966.0,7604,14408,2154.9,2333.3,22012,50003570.0,367,206,137,15318964.0,32226428.0,7110,13758,2154.6,2342.4,20868,47545392.0,343,2023-11-10 16:55:00
811,POSI,321,384,23778990.0,49917817.0,11011,23096,2159.6,2161.3,34107,73696808.0,705,224,350,20064882.0,46831017.0,9311,21618,2155.0,2166.3,30929,66895900.0,574,2023-11-10 17:00:00
812,POSI,497,373,24630385.0,42666713.0,11406,17207,2159.4,2479.6,28613,67297099.0,870,392,362,21588236.0,42252305.0,10011,15869,2156.5,2662.6,25880,63840541.0,754,2023-11-10 17:05:00
813,POSI,321,118,11150009.0,13791708.0,5159,6378,2161.3,2162.4,11537,24941718.0,439,251,93,10582083.0,13360265.0,4905,6169,2157.4,2165.7,11074,23942349.0,344,2023-11-10 17:10:00
814,POSI,323,519,14653193.0,87317738.0,6790,40312,2158.1,2166.0,47102,101970931.0,842,253,506,13660473.0,86894379.0,6336,40117,2156.0,2166.0,46453,100554852.0,759,2023-11-10 17:15:00
815,POSI,273,478,27485862.0,18731124.0,12745,8739,2156.6,2143.4,21484,46216987.0,751,217,460,38522085.0,15028511.0,17867,6941,2156.0,2165.2,24808,53550596.0,677,2023-11-10 17:20:00
816,POSI,262,873,27632188.0,122925030.0,12810,56807,2157.1,2163.9,69617,150557218.0,1135,204,873,16208825.0,123591927.0,7518,57108,2156.0,2164.2,64626,139800753.0,1077,2023-11-10 17:25:00
817,POSI,538,692,32378814.0,137667014.0,14989,63600,2160.2,2164.6,78589,170045829.0,1230,482,678,34454525.0,139878571.0,15963,64609,2158.4,2165.0,80572,174333097.0,1160,2023-11-10 17:30:00
818,POSI,315,514,22916408.0,77473922.0,10642,35779,2153.4,2165.3,46421,100390330.0,829,229,482,19396547.0,72198970.0,9011,33349,2152.5,2165.0,42360,91595518.0,711,2023-11-10 17:35:00
819,POSI,275,437,38309895.0,49243842.0,17799,22746,2152.4,2164.9,40545,87553737.0,712,228,421,30773881.0,47031702.0,14314,21686,2149.9,2168.8,36000,77805584.0,649,2023-11-10 17:40:00
820,POSI,236,206,15832216.0,25882508.0,7345,11948,2155.5,2166.3,19293,41714724.0,442,194,190,14388178.0,26404662.0,6681,12183,2153.6,2167.3,18864,40792841.0,384,2023-11-10 17:45:00
821,POSI,235,344,11425495.0,85935688.0,5288,39696,2160.6,2164.8,44984,97361183.0,579,212,336,11656600.0,85900804.0,5408,39667,2155.4,2165.5,45075,97557404.0,548,2023-11-10 17:50:00
822,POSI,880,962,141895565.0,113208672.0,65637,52232,2161.8,2167.4,117869,255104237.0,1842,819,939,136471678.0,111805131.0,63161,51586,2160.7,2167.4,114747,248276809.0,1758,2023-11-10 17:55:00
823,POSI,489,228,76690959.0,18953162.0,35494,8731,2160.7,2170.8,44225,95644121.0,717,425,191,74626788.0,17517478.0,34539,8045,2160.7,2177.4,42584,92144266.0,616,2023-11-10 18:00:00
824,POSI,316,176,50703270.0,23667784.0,23485,10866,2159.0,2178.2,34351,74371055.0,492,251,150,50753236.0,23028060.0,23544,10565,2155.7,2179.7,34109,73781297.0,401,2023-11-10 18:05:00
825,POSI,223,116,29706278.0,17678684.0,13746,8185,2161.1,2159.9,21931,47384962.0,339,204,113,28511247.0,13486896.0,13204,6181,2159.3,2182.0,19385,41998143.0,317,2023-11-10 18:10:00
826,POSI,346,406,56404048.0,57249651.0,26166,26293,2155.6,2177.4,52459,113653699.0,752,269,357,55350684.0,54243126.0,25686,24900,2154.9,2178.4,50586,109593810.0,626,2023-11-10 18:15:00
827,POSI,743,207,61980191.0,22246634.0,28642,10237,2164.0,2173.2,38879,84226825.0,950,717,197,59569129.0,22382531.0,27546,10288,2162.5,2175.6,37834,81951661.0,914,2023-11-10 18:20:00
828,POSI,645,283,88596701.0,28557560.0,40969,13108,2162.5,2178.6,54077,117154262.0,928,593,211,84691990.0,27058628.0,39179,12415,2161.7,2179.5,51594,111750618.0,804,2023-11-10 18:25:00
829,POSI,288,366,36444330.0,23217327.0,16793,10671,2170.2,2175.7,27464,59661658.0,654,276,345,35123027.0,21305767.0,16225,9791,2164.7,2176.1,26016,56428794.0,621,2023-11-10 18:30:00
830,POSI,262,98,30232421.0,11641065.0,13961,5341,2165.5,2179.6,19302,41873486.0,360,248,89,30016850.0,11261484.0,13882,5153,2162.3,2185.4,19035,41278335.0,337,2023-11-10 18:35:00
831,POSI,248,69,26917870.0,4310590.0,12431,2012,2165.4,2142.4,14443,31228460.0,317,220,55,25912798.0,3476439.0,11971,1598,2164.6,2175.5,13569,29389237.0,275,2023-11-10 18:40:00
832,POSI,1601,3700,224208114.0,438476048.0,104223,198863,2151.2,2204.9,303086,662684162.0,5301,1260,2813,206679715.0,362525451.0,95886,167506,2155.5,2164.3,263392,569205166.0,4073,2023-11-13 10:05:00
833,POSI,2133,2520,268256273.0,474583833.0,125556,219600,2136.5,2161.1,345156,742840107.0,4653,1508,2223,229473770.0,445020143.0,107476,206588,2135.1,2154.1,314064,674493914.0,3731,2023-11-13 10:10:00
834,POSI,1531,722,162231761.0,159502992.0,66163,74047,2452.0,2154.1,140210,321734753.0,2253,1332,597,132800513.0,152836694.0,62106,70931,2138.3,2154.7,133037,285637207.0,1929,2023-11-13 10:15:00
835,POSI,1570,843,161741270.0,153598126.0,75420,71436,2144.5,2150.2,146856,315339397.0,2413,1409,739,155327310.0,148895014.0,72572,69095,2140.3,2154.9,141667,304222324.0,2148,2023-11-13 10:20:00
836,POSI,427,553,58862554.0,117994895.0,27570,54806,2135.0,2153.0,82376,176857450.0,980,283,504,58814633.0,115708501.0,27555,53734,2134.4,2153.4,81289,174523134.0,787,2023-11-13 10:25:00
837,POSI,418,291,40967038.0,66496656.0,19125,30941,2142.1,2149.1,50066,107463694.0,709,306,226,40225067.0,63213309.0,18821,29376,2137.2,2151.9,48197,103438376.0,532,2023-11-13 10:30:00
838,POSI,428,372,48324090.0,73896296.0,22604,34221,2137.9,2159.4,56825,122220386.0,800,289,314,41546324.0,66310809.0,19450,30802,2136.1,2152.8,50252,107857133.0,603,2023-11-13 10:35:00
839,POSI,276,439,33469983.0,89581348.0,15723,39132,2128.7,2289.2,54855,123051331.0,715,222,356,30331231.0,70413636.0,14213,32734,2134.0,2151.1,46947,100744867.0,578,2023-11-13 10:40:00
840,POSI,249,220,23329473.0,26966366.0,10863,12595,2147.6,2141.0,23458,50295839.0,469,148,169,21956183.0,25714215.0,10272,11947,2137.5,2152.4,22219,47670398.0,317,2023-11-13 10:45:00
841,POSI,181,226,16840665.0,20911872.0,7841,9844,2147.8,2124.3,17685,37752538.0,407,117,185,11657636.0,17781954.0,5454,8264,2137.4,2151.7,13718,29439591.0,302,2023-11-13 10:50:00
842,POSI,285,227,36564096.0,33766822.0,17046,15564,2145.0,2169.5,32610,70330918.0,512,177,183,31889026.0,24693524.0,14909,11468,2138.9,2153.3,26377,56582550.0,360,2023-11-13 10:55:00
843,POSI,279,304,44549772.0,40052250.0,20798,18609,2142.0,2152.3,39407,84602022.0,583,224,255,39330665.0,37987639.0,18377,17632,2140.2,2154.5,36009,77318304.0,479,2023-11-13 11:00:00
844,POSI,225,271,26519484.0,40205267.0,12392,18709,2140.0,2149.0,31101,66724751.0,496,123,230,25025882.0,37327900.0,11712,17349,2136.8,2151.6,29061,62353783.0,353,2023-11-13 11:05:00
845,POSI,212,272,14724489.0,47533891.0,6860,22150,2146.4,2146.0,29010,62258380.0,484,125,250,13024152.0,46545144.0,6093,21657,2137.6,2149.2,27750,59569297.0,375,2023-11-13 11:10:00
846,POSI,272,282,31629825.0,45386902.0,14790,21104,2138.6,2150.6,35894,77016727.0,554,214,241,28743891.0,44257849.0,13464,20554,2134.9,2153.2,34018,73001741.0,455,2023-11-13 11:15:00
847,POSI,374,1178,65826491.0,135254934.0,30843,63401,2134.2,2133.3,94244,201081425.0,1552,294,1134,63209798.0,124733738.0,29615,57971,2134.4,2151.7,87586,187943536.0,1428,2023-11-13 11:20:00
848,POSI,210,213,29566985.0,58627150.0,13866,27352,2132.3,2143.4,41218,88194135.0,423,129,171,28303678.0,56304969.0,13275,26192,2132.1,2149.7,39467,84608648.0,300,2023-11-13 11:25:00
849,POSI,380,729,61538645.0,177914700.0,28822,82587,2135.1,2154.3,111409,239453345.0,1109,275,625,57211463.0,166469217.0,26826,77342,2132.7,2152.4,104168,223680680.0,900,2023-11-13 11:30:00
850,POSI,361,971,85581226.0,106247159.0,40236,49399,2127.0,2150.8,89635,191828385.0,1332,282,899,79529999.0,90747305.0,37463,42146,2122.9,2153.2,79609,170277304.0,1181,2023-11-13 11:35:00
851,POSI,610,343,65180675.0,34476613.0,30467,16070,2139.4,2145.4,46537,99657288.0,953,516,314,64225616.0,34205383.0,30038,15923,2138.1,2148.2,45961,98430999.0,830,2023-11-13 11:40:00
852,POSI,293,755,58557595.0,88929817.0,27449,41723,2133.3,2131.4,69172,147487412.0,1048,222,703,56028960.0,83516918.0,26275,38922,2132.4,2145.8,65197,139545879.0,925,2023-11-13 11:45:00
853,POSI,228,574,31598879.0,58230080.0,14809,27178,2133.8,2142.5,41987,89828959.0,802,160,529,31128323.0,56270170.0,14608,26245,2130.9,2144.0,40853,87398493.0,689,2023-11-13 11:50:00
854,POSI,814,455,98087154.0,65268982.0,45887,30390,2137.6,2147.7,76277,163356136.0,1269,682,414,93226707.0,63885362.0,43677,29738,2134.5,2148.3,73415,157112069.0,1096,2023-11-13 11:55:00
855,POSI,529,1066,135963037.0,102758067.0,63676,47814,2135.2,2149.1,111490,238721104.0,1595,452,1034,128130826.0,99085580.0,60012,46120,2135.1,2148.4,106132,227216406.0,1486,2023-11-13 12:00:00
856,POSI,544,279,91166519.0,42706431.0,42620,19872,2139.1,2149.1,62492,133872951.0,823,482,246,90294212.0,41555250.0,42253,19336,2137.0,2149.1,61589,131849463.0,728,2023-11-13 12:05:00
857,POSI,1152,536,109846166.0,78575894.0,51419,29139,2136.3,2696.6,80558,188422061.0,1688,1095,508,109159345.0,61625209.0,51125,28627,2135.1,2152.7,79752,170784555.0,1603,2023-11-13 12:10:00
858,POSI,776,229,95009814.0,37344738.0,44444,17374,2137.7,2149.5,61818,132354553.0,1005,701,204,93084371.0,35683211.0,43562,16583,2136.8,2151.8,60145,128767582.0,905,2023-11-13 12:15:00
859,POSI,1031,382,107794006.0,26663541.0,50379,12239,2139.7,2178.6,62618,134457547.0,1413,1005,359,107352688.0,25136369.0,50183,11555,2139.2,2175.4,61738,132489057.0,1364,2023-11-13 12:20:00
860,POSI,334,346,45465798.0,54471263.0,21310,25055,2133.5,2174.1,46365,99937061.0,680,224,322,44467539.0,53765685.0,20866,22438,2131.1,2396.2,43304,98233224.0,546,2023-11-13 12:25:00
861,POSI,277,227,36071381.0,52611127.0,16935,16884,2130.0,3116.0,33819,88682509.0,504,236,200,35725023.0,52304173.0,16770,16257,2130.3,3217.3,33027,88029196.0,436,2023-11-13 12:30:00
862,POSI,284,178,24643408.0,24629694.0,11527,11496,2137.9,2142.5,23023,49273102.0,462,206,149,22162209.0,28215503.0,10386,13152,2133.9,2145.3,23538,50377713.0,355,2023-11-13 12:35:00
863,POSI,355,435,34268326.0,59585317.0,16055,21690,2134.4,2747.1,37745,93853644.0,790,345,411,33453180.0,60679499.0,15680,21072,2133.5,2879.6,36752,94132679.0,756,2023-11-13 12:40:00
864,POSI,317,197,30118939.0,25849543.0,14114,12102,2134.0,2136.0,26216,55968482.0,514,217,165,28966278.0,24684598.0,13578,11490,2133.3,2148.4,25068,53650877.0,382,2023-11-13 12:45:00
865,POSI,789,1264,129964273.0,176206376.0,61024,82810,2129.7,2127.8,143834,306170649.0,2053,674,1203,126938983.0,168916736.0,59635,78847,2128.6,2142.3,138482,295855720.0,1877,2023-11-13 12:50:00
866,POSI,343,792,57084089.0,79637201.0,26800,37243,2130.0,2138.3,64043,136721290.0,1135,232,737,50687921.0,77508694.0,23825,36224,2127.5,2139.7,60049,128196615.0,969,2023-11-13 12:55:00
867,POSI,286,414,52030861.0,93330243.0,24463,38987,2126.9,2393.9,63450,145361104.0,700,236,372,50881324.0,86009170.0,23946,37583,2124.8,2288.5,61529,136890494.0,608,2023-11-13 13:00:00
868,POSI,354,306,87510331.0,93517804.0,41198,37776,2124.1,2475.6,78974,181028135.0,660,236,243,85761093.0,87340043.0,40403,34639,2122.6,2521.4,75042,173101136.0,479,2023-11-13 13:05:00
869,POSI,389,297,80661440.0,88406988.0,37965,35500,2124.6,2490.3,73465,169068429.0,686,216,217,71547064.0,84049546.0,33747,33291,2120.1,2524.7,67038,155596610.0,433,2023-11-13 13:10:00
870,POSI,287,161,51072232.0,39557770.0,24047,18510,2123.9,2137.1,42557,90630002.0,448,177,114,44247491.0,37790193.0,20866,17668,2120.6,2138.9,38534,82037684.0,291,2023-11-13 13:15:00
871,POSI,325,384,60025167.0,96015641.0,28297,45217,2121.3,2123.4,73514,156040809.0,709,222,327,55861704.0,91746796.0,26360,42979,2119.2,2134.7,69339,147608500.0,549,2023-11-13 13:20:00
872,POSI,303,273,70372626.0,74765118.0,33184,34980,2120.7,2137.4,68164,145137745.0,576,221,236,64674177.0,69535528.0,30519,32508,2119.1,2139.0,63027,134209706.0,457,2023-11-13 13:25:00
873,POSI,224,111,46948761.0,21866755.0,12607,10237,3724.0,2136.1,22844,68815516.0,335,163,88,24094213.0,21559371.0,11354,10087,2122.1,2137.3,21441,45653585.0,251,2023-11-13 13:30:00
874,POSI,425,179,67028529.0,25123102.0,31499,11764,2128.0,2135.6,43263,92151631.0,604,322,151,58873684.0,28536020.0,27678,13362,2127.1,2135.6,41040,87409704.0,473,2023-11-13 13:35:00
875,POSI,928,107,171911123.0,66528881.0,80814,31150,2127.2,2135.8,111964,238440004.0,1035,858,81,171154950.0,19339077.0,80468,9040,2127.0,2139.3,89508,190494027.0,939,2023-11-13 13:40:00
876,POSI,330,127,53461732.0,44255486.0,25179,20681,2123.3,2139.9,45860,97717218.0,457,263,111,52275844.0,44004892.0,24658,20564,2120.0,2139.9,45222,96280736.0,374,2023-11-13 13:45:00
877,POSI,537,431,98118215.0,94931205.0,46234,44465,2122.2,2135.0,90699,193049421.0,968,439,373,94356290.0,88400966.0,44497,41370,2120.5,2136.8,85867,182757256.0,812,2023-11-13 13:50:00
878,POSI,328,142,39067733.0,26862667.0,18374,12602,2126.3,2131.6,30976,65930400.0,470,254,111,36653040.0,25038312.0,17267,11728,2122.7,2134.9,28995,61691353.0,365,2023-11-13 13:55:00
879,POSI,501,1086,122276002.0,242741925.0,57752,113909,2117.3,2131.0,171661,365017928.0,1587,388,1048,116461310.0,238062897.0,55041,111611,2115.9,2133.0,166652,354524208.0,1436,2023-11-13 14:00:00
880,POSI,267,396,27063757.0,102236852.0,12737,47582,2124.8,2148.6,60319,129300609.0,663,177,377,28298023.0,92432148.0,13382,43393,2114.6,2130.1,56775,120730171.0,554,2023-11-13 14:05:00
881,POSI,276,266,34873335.0,60080931.0,16440,28324,2121.2,2121.2,44764,94954266.0,542,191,227,32120583.0,54460239.0,15175,25543,2116.7,2132.1,40718,86580822.0,418,2023-11-13 14:10:00
882,POSI,225,88,20525763.0,15945479.0,9684,7517,2119.6,2121.3,17201,36471243.0,313,150,52,18851198.0,15239367.0,8899,7148,2118.4,2132.0,16047,34090565.0,202,2023-11-13 14:15:00
883,POSI,216,134,22183603.0,20323752.0,10464,9542,2120.0,2129.9,20006,42507355.0,350,131,93,20518270.0,16862401.0,9698,7905,2115.7,2133.1,17603,37380672.0,224,2023-11-13 14:20:00
884,POSI,252,129,36072224.0,30837482.0,17005,13266,2121.3,2324.6,30271,66909706.0,381,141,87,33705918.0,39590622.0,15932,12661,2115.6,3127.0,28593,73296540.0,228,2023-11-13 14:25:00
885,POSI,254,146,36340052.0,30578222.0,17135,14395,2120.8,2124.2,31530,66918275.0,400,149,109,35309826.0,30469901.0,16698,14287,2114.6,2132.7,30985,65779727.0,258,2023-11-13 14:30:00
886,POSI,329,239,85845564.0,37135219.0,20861,16939,4115.1,2192.3,37800,122980783.0,568,239,193,61923964.0,37902335.0,19727,16540,3139.0,2291.6,36267,99826300.0,432,2023-11-13 14:35:00
887,POSI,365,154,72861220.0,35428738.0,34229,16607,2128.6,2133.4,50836,108289958.0,519,296,117,68872193.0,33334900.0,32479,15605,2120.5,2136.2,48084,102207094.0,413,2023-11-13 14:40:00
888,POSI,251,127,39145241.0,23000935.0,18434,10774,2123.5,2134.9,29208,62146177.0,378,203,103,37626433.0,22630085.0,17740,10600,2121.0,2134.9,28340,60256518.0,306,2023-11-13 14:45:00
889,POSI,169,98,13961874.0,16383952.0,6584,7683,2120.6,2132.5,14267,30345826.0,267,115,76,11936947.0,14647321.0,5632,6865,2119.5,2133.6,12497,26584269.0,191,2023-11-13 14:50:00
890,POSI,388,212,87487346.0,96924015.0,41158,45448,2125.6,2132.6,86606,184411362.0,600,295,176,84467976.0,95971327.0,39821,44894,2121.2,2137.7,84715,180439304.0,471,2023-11-13 14:55:00
891,POSI,390,302,89221152.0,100455653.0,42151,47217,2116.7,2127.5,89368,189676805.0,692,312,257,79556384.0,143174265.0,37587,67242,2116.6,2129.2,104829,222730649.0,569,2023-11-13 15:00:00
892,POSI,336,356,53642370.0,57403502.0,25280,26923,2121.9,2132.1,52203,111045872.0,692,256,330,48862391.0,63459810.0,23060,29298,2118.9,2166.0,52358,112322202.0,586,2023-11-13 15:05:00
893,POSI,323,184,67167539.0,29412861.0,31557,13760,2128.5,2137.6,45317,96580401.0,507,261,149,64921042.0,27885562.0,30583,13045,2122.8,2137.6,43628,92806605.0,410,2023-11-13 15:10:00
894,POSI,245,139,47873984.0,20402276.0,22559,9558,2122.2,2134.6,32117,68276260.0,384,225,107,45577238.0,18301771.0,21482,8573,2121.6,2134.8,30055,63879009.0,332,2023-11-13 15:15:00
895,POSI,215,492,55795255.0,52330831.0,26406,24501,2113.0,2135.9,50907,108126086.0,707,196,470,47962663.0,50590097.0,22651,23678,2117.5,2136.6,46329,98552761.0,666,2023-11-13 15:20:00
896,POSI,296,1436,75482328.0,265576707.0,35687,124682,2115.1,2130.0,160369,341059036.0,1732,249,1388,65239428.0,219572242.0,30825,103025,2116.4,2131.3,133850,284811670.0,1637,2023-11-13 15:25:00
897,POSI,228,138,33993137.0,61361853.0,16021,28803,2121.8,2130.4,44824,95354991.0,366,129,118,29687340.0,60328254.0,14028,28303,2116.3,2131.5,42331,90015595.0,247,2023-11-13 15:30:00
898,POSI,252,191,39689510.0,70743121.0,18767,33150,2114.9,2134.0,51917,110432631.0,443,189,174,38404967.0,92779175.0,18159,43542,2114.9,2130.8,61701,131184142.0,363,2023-11-13 15:35:00
899,POSI,308,261,50564884.0,98701706.0,23900,46358,2115.7,2129.1,70258,149266590.0,569,208,211,48738860.0,72656187.0,23049,34056,2114.6,2133.4,57105,121395048.0,419,2023-11-13 15:40:00
900,POSI,299,246,39660086.0,47055547.0,18728,22105,2117.7,2128.7,40833,86715634.0,545,245,177,39703846.0,49356463.0,18777,23164,2114.5,2130.7,41941,89060309.0,422,2023-11-13 15:45:00
901,POSI,329,259,49856415.0,66940726.0,23610,31496,2111.7,2125.4,55106,116797141.0,588,203,201,45379546.0,54739696.0,21506,25713,2110.1,2128.9,47219,100119243.0,404,2023-11-13 15:50:00
902,POSI,278,214,36925801.0,45970855.0,17472,21603,2113.4,2128.0,39075,82896656.0,492,171,172,30946430.0,44185065.0,14650,20751,2112.4,2129.3,35401,75131495.0,343,2023-11-13 15:55:00
903,POSI,181,190,19056900.0,34037708.0,8995,16009,2118.6,2126.2,25004,53094608.0,371,162,162,18543563.0,33250146.0,8771,15624,2114.2,2128.1,24395,51793709.0,324,2023-11-13 16:00:00
904,POSI,233,230,19973964.0,37252921.0,9430,17652,2118.1,2110.4,27082,57226885.0,463,152,204,20518589.0,38837070.0,9708,18253,2113.6,2127.7,27961,59355660.0,356,2023-11-13 16:05:00
905,POSI,170,140,18253676.0,18961594.0,8620,8916,2117.6,2126.7,17536,37215270.0,310,126,117,17355308.0,18158599.0,8201,8534,2116.2,2127.8,16735,35513908.0,243,2023-11-13 16:10:00
906,POSI,214,179,18825588.0,38632315.0,8887,18176,2118.3,2125.5,27063,57457904.0,393,134,155,16679800.0,37926351.0,7884,17827,2115.7,2127.5,25711,54606151.0,289,2023-11-13 16:15:00
907,POSI,173,287,17667754.0,67726681.0,8329,31869,2121.2,2125.2,40198,85394435.0,460,137,261,17978094.0,67519602.0,8497,31740,2115.8,2127.3,40237,85497697.0,398,2023-11-13 16:20:00
908,POSI,1560,350,194258972.0,89178223.0,89615,41774,2167.7,2134.8,131389,283437195.0,1910,1463,305,184874675.0,88923101.0,87050,41662,2123.8,2134.4,128712,273797777.0,1768,2023-11-13 16:25:00
909,POSI,439,104,121775268.0,17950364.0,57303,8428,2125.1,2129.8,65731,139725633.0,543,416,81,132773245.0,15922132.0,62604,7462,2120.8,2133.8,70066,148695378.0,497,2023-11-13 16:30:00
910,POSI,274,127,39721946.0,24195149.0,18703,11335,2123.8,2134.6,30038,63917095.0,401,238,107,38795060.0,24001439.0,18278,11236,2122.5,2136.1,29514,62796500.0,345,2023-11-13 16:35:00
911,POSI,275,97,58146876.0,15413298.0,27319,7222,2128.4,2134.2,34541,73560174.0,372,223,72,56914461.0,14833044.0,26791,6948,2124.4,2134.9,33739,71747505.0,295,2023-11-13 16:40:00
912,POSI,226,93,42602625.0,17613524.0,20049,8286,2124.9,2125.7,28335,60216149.0,319,193,76,43732830.0,19172816.0,20595,8974,2123.5,2136.5,29569,62905646.0,269,2023-11-13 16:45:00
913,POSI,920,236,147288232.0,44349551.0,69235,20651,2127.4,2147.6,89886,191637783.0,1156,886,209,146538430.0,40871650.0,68918,19140,2126.3,2135.4,88058,187410080.0,1095,2023-11-13 16:50:00
914,POSI,1085,127,169964924.0,25044574.0,79875,11728,2127.9,2135.5,91603,195009498.0,1212,1025,95,167001201.0,22834613.0,78524,10690,2126.8,2136.1,89214,189835815.0,1120,2023-11-13 16:55:00
915,POSI,239,122,31662325.0,19402159.0,14886,9111,2127.0,2129.5,23997,51064485.0,361,208,107,31391361.0,18837721.0,14771,8821,2125.2,2135.6,23592,50229082.0,315,2023-11-13 17:00:00
916,POSI,400,76,57363593.0,8834341.0,26971,4144,2126.9,2131.8,31115,66197934.0,476,384,59,57307609.0,8803650.0,26950,4122,2126.4,2135.8,31072,66111259.0,443,2023-11-13 17:05:00
917,POSI,153,56,16818237.0,9224127.0,7886,4322,2132.7,2134.2,12208,26042364.0,209,134,44,15830061.0,8988656.0,7446,4210,2126.0,2135.1,11656,24818718.0,178,2023-11-13 17:10:00
918,POSI,296,39,42423592.0,3916193.0,19919,1834,2129.8,2135.3,21753,46339786.0,335,264,21,42146764.0,3492831.0,19814,1636,2127.1,2135.0,21450,45639595.0,285,2023-11-13 17:15:00
919,POSI,529,80,75021466.0,11027689.0,35270,5147,2127.1,2142.5,40417,86049155.0,609,476,63,72614935.0,8013146.0,34144,3742,2126.7,2141.4,37886,80628082.0,539,2023-11-13 17:20:00
920,POSI,201,73,20943469.0,8953809.0,9837,4207,2129.1,2128.3,14044,29897278.0,274,217,53,20934335.0,8715797.0,9847,4079,2126.0,2136.7,13926,29650132.0,270,2023-11-13 17:25:00
921,POSI,129,77,15017307.0,14439437.0,7092,6760,2117.5,2136.0,13852,29456744.0,206,102,66,14621733.0,16124566.0,6895,7541,2120.6,2138.3,14436,30746299.0,168,2023-11-13 17:30:00
922,POSI,311,74,30468826.0,14386044.0,14288,6727,2132.5,2138.6,21015,44854870.0,385,230,59,28988652.0,12441939.0,13650,5813,2123.7,2140.4,19463,41430591.0,289,2023-11-13 17:35:00
923,POSI,448,193,57023868.0,49337635.0,26707,23009,2135.2,2144.3,49716,106361504.0,641,405,139,53587070.0,47288830.0,25236,22064,2123.4,2143.3,47300,100875900.0,544,2023-11-13 17:40:00
924,POSI,318,149,40147805.0,24378989.0,18840,11440,2131.0,2131.0,30280,64526794.0,467,291,93,39867654.0,23303054.0,18731,10879,2128.4,2142.0,29610,63170709.0,384,2023-11-13 17:45:00
925,POSI,231,99,16266057.0,10503832.0,7578,4981,2146.5,2108.8,12559,26769889.0,330,172,70,17520266.0,11978368.0,8247,5589,2124.4,2143.2,13836,29498635.0,242,2023-11-13 17:50:00
926,POSI,502,43,79250924.0,7309326.0,37220,3421,2129.3,2136.6,40641,86560250.0,545,460,22,79584551.0,7356239.0,37396,3427,2128.2,2146.6,40823,86940791.0,482,2023-11-13 17:55:00
927,POSI,233,74,23622335.0,17245733.0,11123,8041,2123.7,2144.7,19164,40868068.0,307,194,50,25150180.0,18673966.0,11855,8692,2121.5,2148.4,20547,43824146.0,244,2023-11-13 18:00:00
928,POSI,1158,514,183530043.0,92828416.0,85416,43304,2148.7,2143.6,128720,276358459.0,1672,1147,434,178151121.0,90203564.0,83490,42065,2133.8,2144.4,125555,268354685.0,1581,2023-11-13 18:05:00
929,POSI,612,1061,99102831.0,161057890.0,46639,75385,2124.9,2136.5,122024,260160721.0,1673,549,1015,95791734.0,155274801.0,45091,72627,2124.4,2138.0,117718,251066536.0,1564,2023-11-13 18:10:00
930,POSI,361,493,42577604.0,108627864.0,20011,50829,2127.7,2137.1,70840,151205468.0,854,321,456,43110713.0,108604453.0,20286,50793,2125.1,2138.2,71079,151715166.0,777,2023-11-13 18:15:00
931,POSI,210,90,28939101.0,24668212.0,13609,11517,2126.5,2141.9,25126,53607313.0,300,179,69,27015809.0,22227160.0,12752,10362,2118.6,2145.1,23114,49242969.0,248,2023-11-13 18:20:00
932,POSI,411,245,57982312.0,59545368.0,27316,27951,2122.7,2130.3,55267,117527680.0,656,357,238,56245081.0,55549596.0,26526,25987,2120.4,2137.6,52513,111794677.0,595,2023-11-13 18:25:00
933,POSI,213,29,8393564.0,2760585.0,3948,1294,2126.0,2133.4,5242,11154149.0,242,168,18,12445201.0,782249.0,5867,366,2121.2,2137.3,6233,13227451.0,186,2023-11-13 18:30:00
934,POSI,30207,805,1105885340.0,198650619.0,519763,93087,2127.7,2134.0,612850,1304535959.0,31012,30139,784,1102786944.0,197662146.0,518304,92619,2127.7,2134.1,610923,1300449090.0,30923,2023-11-13 18:35:00
935,POSI,381,1252,74650512.0,272377358.0,35168,127673,2122.7,2133.4,162841,347027870.0,1633,362,1224,73718279.0,270125530.0,34734,126610,2122.4,2133.5,161344,343843809.0,1586,2023-11-13 18:40:00
936,POSI,2851,8759,994162751.0,1377758822.0,467816,640845,2125.1,2149.9,1108661,2371921573.0,11610,2475,7996,972407841.0,1304543115.0,457378,609457,2126.0,2140.5,1066835,2276950956.0,10471,2023-11-14 10:05:00
937,POSI,1758,2459,337135102.0,552049659.0,160410,262279,2101.7,2104.8,422689,889184761.0,4217,978,1911,312927858.0,516523810.0,148961,243662,2100.7,2119.8,392623,829451668.0,2889,2023-11-14 10:10:00
938,POSI,1394,2341,373646890.0,662996339.0,179363,315608,2083.2,2100.7,494971,1036643229.0,3735,796,2055,344100691.0,632341179.0,165371,300489,2080.8,2104.4,465860,976441870.0,2851,2023-11-14 10:15:00
939,POSI,1234,1459,308064840.0,332603611.0,147108,157799,2094.1,2107.8,304907,640668451.0,2693,794,1276,274737333.0,318021326.0,131543,150821,2088.6,2108.6,282364,592758660.0,2070,2023-11-14 10:20:00
940,POSI,585,1032,150854093.0,249982847.0,71908,118770,2097.9,2104.8,190678,400836940.0,1617,368,924,134694958.0,238991468.0,64456,113445,2089.7,2106.7,177901,373686426.0,1292,2023-11-14 10:25:00
941,POSI,1199,857,232833162.0,235942113.0,110884,111807,2099.8,2110.3,222691,468775275.0,2056,935,724,217519878.0,228011154.0,103865,107957,2094.3,2112.1,211822,445531033.0,1659,2023-11-14 10:30:00
942,POSI,632,746,152633531.0,204697680.0,72836,97045,2095.6,2109.3,169881,357331211.0,1378,373,646,158342201.0,191953820.0,75674,90863,2092.4,2112.6,166537,350296021.0,1019,2023-11-14 10:35:00
943,POSI,302,251,66001522.0,71910901.0,31559,34070,2091.4,2110.7,65629,137912423.0,553,162,204,50060586.0,67475583.0,23922,31963,2092.7,2111.1,55885,117536170.0,366,2023-11-14 10:40:00
944,POSI,252,212,40918479.0,45880870.0,19522,21759,2096.0,2108.6,41281,86799349.0,464,158,169,38778219.0,44981087.0,18504,21317,2095.7,2110.1,39821,83759306.0,327,2023-11-14 10:45:00
945,POSI,807,533,180233268.0,137530182.0,85885,65063,2098.5,2113.8,150948,317763450.0,1340,629,479,176509483.0,132188071.0,84270,62597,2094.6,2111.7,146867,308697555.0,1108,2023-11-14 10:50:00
946,POSI,394,225,63805569.0,50620998.0,30391,23871,2099.5,2120.6,54262,114426567.0,619,252,171,60261302.0,43712605.0,28774,20693,2094.3,2112.4,49467,103973907.0,423,2023-11-14 10:55:00
947,POSI,481,392,97959636.0,99412259.0,46874,47388,2089.9,2097.8,94262,197371896.0,873,361,345,82889212.0,93919003.0,39670,44553,2089.5,2108.0,84223,176808215.0,706,2023-11-14 11:00:00
948,POSI,267,162,24916223.0,26086766.0,11907,12513,2092.6,2084.8,24420,51002990.0,429,147,115,22800052.0,23786069.0,10903,11290,2091.2,2106.8,22193,46586122.0,262,2023-11-14 11:05:00
949,POSI,248,157,45550164.0,44779144.0,21627,21228,2106.2,2109.4,42855,90329309.0,405,149,103,48190291.0,39849662.0,23082,18888,2087.8,2109.8,41970,88039953.0,252,2023-11-14 11:10:00
950,POSI,454,390,79284232.0,77777120.0,37975,37113,2087.8,2095.7,75088,157061353.0,844,376,338,80464269.0,75011731.0,38558,35576,2086.8,2108.5,74134,155476001.0,714,2023-11-14 11:15:00
951,POSI,374,383,81995946.0,74970137.0,39298,35851,2086.5,2091.2,75149,156966083.0,757,277,245,80093007.0,70408163.0,38393,33435,2086.1,2105.8,71828,150501171.0,522,2023-11-14 11:20:00
952,POSI,448,348,92012862.0,76370292.0,44134,36543,2084.9,2089.9,80677,168383154.0,796,301,297,86116397.0,72136960.0,41314,34297,2084.4,2103.3,75611,158253357.0,598,2023-11-14 11:25:00
953,POSI,1015,865,215135554.0,268110177.0,103708,128876,2074.4,2080.4,232584,483245732.0,1880,578,711,195671573.0,246583934.0,94318,117798,2074.6,2093.3,212116,442255507.0,1289,2023-11-14 11:30:00
954,POSI,1075,554,236167578.0,187279481.0,113650,89791,2078.0,2085.7,203441,423447059.0,1629,837,450,227020197.0,174846760.0,109497,83504,2073.3,2093.9,193001,401866958.0,1287,2023-11-14 11:35:00
955,POSI,927,1366,250875156.0,355843103.0,121296,171376,2068.3,2076.4,292672,606718259.0,2293,610,1232,234405183.0,335963591.0,113371,161062,2067.6,2085.9,274433,570368774.0,1842,2023-11-14 11:40:00
956,POSI,651,897,126592697.0,180825554.0,61059,86658,2073.3,2086.7,147717,307418252.0,1548,463,630,121980044.0,177119301.0,58887,84858,2071.4,2087.2,143745,299099345.0,1093,2023-11-14 11:45:00
957,POSI,464,443,64713703.0,119675076.0,31197,57396,2074.4,2085.1,88593,184388779.0,907,328,395,57012956.0,116949152.0,27520,56066,2071.7,2085.9,83586,173962109.0,723,2023-11-14 11:50:00
958,POSI,1193,776,353754034.0,272437105.0,169688,129939,2084.7,2096.7,299627,626191139.0,1969,958,625,339590760.0,258766327.0,163419,123345,2078.0,2097.9,286764,598357087.0,1583,2023-11-14 11:55:00
959,POSI,817,371,208454770.0,144393854.0,100027,68825,2084.0,2098.0,168852,352848625.0,1188,694,315,198374149.0,141323506.0,95398,67332,2079.4,2098.9,162730,339697655.0,1009,2023-11-14 12:00:00
960,POSI,568,488,122397164.0,125022761.0,58822,59986,2080.8,2084.2,118808,247419926.0,1056,432,427,121190511.0,117249681.0,58240,55970,2080.9,2094.9,114210,238440192.0,859,2023-11-14 12:05:00
961,POSI,390,241,76654145.0,54233776.0,36815,25916,2082.1,2092.7,62731,130887922.0,631,343,191,74743134.0,46779912.0,35954,22331,2078.9,2094.8,58285,121523046.0,534,2023-11-14 12:10:00
962,POSI,345,252,80029514.0,68972589.0,38418,32946,2083.1,2093.5,71364,149002103.0,597,255,217,77571342.0,65284969.0,37380,31167,2075.2,2094.7,68547,142856311.0,472,2023-11-14 12:15:00
963,POSI,331,214,59265491.0,49314108.0,28378,23348,2088.4,2112.1,51726,108579600.0,545,219,146,46096549.0,40855285.0,22168,19471,2079.4,2098.3,41639,86951834.0,365,2023-11-14 12:20:00
964,POSI,568,347,106179293.0,79535844.0,51033,38215,2080.6,2081.3,89248,185715137.0,915,482,227,103643009.0,75355381.0,49844,35949,2079.3,2096.2,85793,178998391.0,709,2023-11-14 12:25:00
965,POSI,375,335,69450980.0,88402144.0,33460,42307,2075.6,2089.5,75767,157853125.0,710,299,287,68666577.0,83859399.0,33105,40077,2074.2,2092.5,73182,152525976.0,586,2023-11-14 12:30:00
966,POSI,417,602,98903748.0,156749168.0,47710,75151,2073.0,2085.8,122861,255652916.0,1019,363,498,94055586.0,149635088.0,45391,71538,2072.1,2091.7,116929,243690674.0,861,2023-11-14 12:35:00
967,POSI,725,671,75172057.0,140908530.0,36281,67547,2071.9,2086.1,103828,216080587.0,1396,552,625,70936292.0,136011990.0,34283,65105,2069.1,2089.1,99388,206948282.0,1177,2023-11-14 12:40:00
968,POSI,364,272,70191050.0,98200530.0,33935,47052,2068.4,2087.1,80987,168391581.0,636,281,242,69966094.0,94364131.0,33834,45126,2067.9,2091.1,78960,164330226.0,523,2023-11-14 12:45:00
969,POSI,566,632,93564356.0,151981770.0,45169,72972,2071.4,2082.7,118141,245546126.0,1198,453,599,88153251.0,148281328.0,42634,71042,2067.7,2087.2,113676,236434580.0,1052,2023-11-14 12:50:00
970,POSI,254,151,41612480.0,59421087.0,20077,21037,2072.6,2824.6,41114,101033568.0,405,191,104,39595405.0,40353733.0,19137,19308,2069.0,2090.0,38445,79949139.0,295,2023-11-14 12:55:00
971,POSI,334,199,118555659.0,53694541.0,27471,25684,4315.7,2090.6,53155,172250200.0,533,268,148,53338185.0,46066832.0,25733,22016,2072.8,2092.4,47749,99405017.0,416,2023-11-14 13:00:00
972,POSI,179,136,28333948.0,34199988.0,13647,16101,2076.2,2124.1,29748,62533936.0,315,136,105,27953348.0,30262531.0,13489,14438,2072.3,2096.0,27927,58215879.0,241,2023-11-14 13:05:00
973,POSI,355,162,24510395.0,29234783.0,11794,13954,2078.2,2095.1,25748,53745179.0,517,329,130,23720870.0,29409463.0,11442,14018,2073.1,2098.0,25460,53130333.0,459,2023-11-14 13:10:00
974,POSI,207,101,28089286.0,32484544.0,13536,15773,2075.2,2059.5,29309,60573830.0,308,130,74,27139495.0,28934468.0,13100,13793,2071.7,2097.8,26893,56073963.0,204,2023-11-14 13:15:00
975,POSI,156,75,5699648.0,9197683.0,2737,4391,2082.4,2094.7,7128,14897332.0,231,134,61,5234854.0,9090175.0,2527,4346,2071.6,2091.6,6873,14325030.0,195,2023-11-14 13:20:00
976,POSI,193,255,29893428.0,50339387.0,14335,23989,2085.3,2098.4,38324,80232816.0,448,152,234,26949252.0,50794894.0,12980,24255,2076.2,2094.2,37235,77744146.0,386,2023-11-14 13:25:00
977,POSI,272,245,29110640.0,42126858.0,13976,20103,2082.9,2095.6,34079,71237499.0,517,243,223,27873646.0,38209686.0,13414,18224,2078.0,2096.7,31638,66083332.0,466,2023-11-14 13:30:00
978,POSI,189,112,9797666.0,12673858.0,4708,6058,2081.1,2092.1,10766,22471524.0,301,138,95,10214764.0,12575752.0,4921,6007,2075.7,2093.5,10928,22790517.0,233,2023-11-14 13:35:00
979,POSI,190,133,25449639.0,29586854.0,12252,14178,2077.2,2086.8,26430,55036493.0,323,149,103,25031079.0,24584260.0,12050,11727,2077.3,2096.4,23777,49615340.0,252,2023-11-14 13:40:00
980,POSI,157,99,19089344.0,18356076.0,9203,8850,2074.3,2074.1,18053,37445420.0,256,138,75,18066696.0,15690255.0,8692,7502,2078.5,2091.5,16194,33756952.0,213,2023-11-14 13:45:00
981,POSI,164,100,12361993.0,17479933.0,5947,8374,2078.7,2087.4,14321,29841926.0,264,103,85,11533546.0,20077342.0,5555,9608,2076.2,2089.6,15163,31610888.0,188,2023-11-14 13:50:00
982,POSI,154,210,17572046.0,41537500.0,8450,19957,2079.5,2081.3,28407,59109546.0,364,146,191,17038099.0,40499390.0,8203,19380,2077.1,2089.8,27583,57537489.0,337,2023-11-14 13:55:00
983,POSI,158,285,14107144.0,58397353.0,6762,27953,2086.2,2089.1,34715,72504497.0,443,103,269,14222755.0,59923759.0,6848,28662,2076.9,2090.7,35510,74146514.0,372,2023-11-14 14:00:00
984,POSI,120,320,7994266.0,60178076.0,3851,28821,2075.9,2088.0,32672,68172342.0,440,123,302,8892510.0,59730731.0,4292,28589,2071.9,2089.3,32881,68623241.0,425,2023-11-14 14:05:00
985,POSI,221,289,24267204.0,60401782.0,11669,29028,2079.6,2080.8,40697,84668987.0,510,142,248,22305616.0,56853310.0,10739,27197,2077.1,2090.4,37936,79158926.0,390,2023-11-14 14:10:00
986,POSI,135,243,13812738.0,50714831.0,6643,24419,2079.3,2076.9,31062,64527569.0,378,116,200,13539406.0,47619314.0,6516,22790,2077.9,2089.5,29306,61158720.0,316,2023-11-14 14:15:00
987,POSI,181,120,20998349.0,21799868.0,10098,10513,2079.5,2073.6,20611,42798217.0,301,115,87,18974181.0,20218572.0,9135,9667,2077.1,2091.5,18802,39192753.0,202,2023-11-14 14:20:00
988,POSI,144,207,21528415.0,31132112.0,10293,15020,2091.6,2072.7,25313,52660528.0,351,144,132,21256918.0,23713432.0,10231,11337,2077.7,2091.7,21568,44970351.0,276,2023-11-14 14:25:00
989,POSI,175,233,23683584.0,36068641.0,11304,17343,2095.2,2079.7,28647,59752225.0,408,120,177,23063320.0,32863250.0,11105,15718,2076.8,2090.8,26823,55926571.0,297,2023-11-14 14:30:00
990,POSI,597,812,134728719.0,219796866.0,64731,105279,2081.4,2087.8,170010,354525585.0,1409,514,714,124664199.0,217092978.0,59924,103751,2080.4,2092.4,163675,341757177.0,1228,2023-11-14 14:35:00
991,POSI,511,405,155468527.0,81535840.0,74544,38919,2085.6,2095.0,113463,237004367.0,916,490,335,153174231.0,74785992.0,73549,35642,2082.6,2098.3,109191,227960224.0,825,2023-11-14 14:40:00
992,POSI,264,141,41340364.0,33949004.0,19907,16231,2076.7,2091.6,36138,75289368.0,405,212,101,40216907.0,30565970.0,19385,14576,2074.6,2097.0,33961,70782878.0,313,2023-11-14 14:45:00
993,POSI,237,127,24265460.0,22133695.0,11668,10656,2079.7,2077.1,22324,46399155.0,364,160,90,22490227.0,19905967.0,10822,9509,2078.2,2093.4,20331,42396194.0,250,2023-11-14 14:50:00
994,POSI,297,241,87362899.0,59617139.0,36193,28459,2413.8,2094.8,64652,146980039.0,538,257,185,135063328.0,53261898.0,35369,25379,3818.7,2098.7,60748,188325226.0,442,2023-11-14 14:55:00
995,POSI,183,59,30261084.0,10596603.0,14513,5073,2085.1,2088.8,19586,40857687.0,242,157,41,28933111.0,11300665.0,13879,5388,2084.7,2097.4,19267,40233776.0,198,2023-11-14 15:00:00
996,POSI,148,100,18167662.0,8692281.0,8712,4143,2085.4,2098.1,12855,26859943.0,248,136,79,18750779.0,8448246.0,9005,4028,2082.3,2097.4,13033,27199025.0,215,2023-11-14 15:05:00
997,POSI,177,87,25392343.0,11062551.0,12168,5293,2086.8,2090.0,17461,36454894.0,264,144,43,24520628.0,9813617.0,11769,4679,2083.5,2097.4,16448,34334245.0,187,2023-11-14 15:10:00
998,POSI,183,95,20603477.0,12429727.0,9891,5934,2083.1,2094.7,15825,33033205.0,278,113,67,20356896.0,12363965.0,9771,5889,2083.4,2099.5,15660,32720862.0,180,2023-11-14 15:15:00
999,POSI,138,102,13701376.0,9896989.0,6571,4720,2085.1,2096.8,11291,23598365.0,240,140,73,13404883.0,9204792.0,6439,4387,2081.8,2098.2,10826,22609676.0,213,2023-11-14 15:20:00
1000,POSI,128,60,13018498.0,9694763.0,6242,4633,2085.6,2092.5,10875,22713261.0,188,90,48,13310903.0,9136876.0,6385,4357,2084.7,2097.1,10742,22447779.0,138,2023-11-14 15:25:00
1001,POSI,146,78,13235199.0,15258500.0,6343,7281,2086.6,2095.7,13624,28493699.0,224,112,60,12498546.0,14596191.0,6002,6961,2082.4,2096.9,12963,27094737.0,172,2023-11-14 15:30:00
1002,POSI,174,65,13191636.0,7565230.0,6331,3630,2083.7,2084.1,9961,20756867.0,239,154,51,12812670.0,6891332.0,6151,3284,2083.0,2098.5,9435,19704003.0,205,2023-11-14 15:35:00
1003,POSI,172,119,19219118.0,28307722.0,9220,13625,2084.5,2077.6,22845,47526840.0,291,137,80,18751863.0,21118048.0,8999,10072,2083.8,2096.7,19071,39869911.0,217,2023-11-14 15:40:00
1004,POSI,143,91,12944985.0,18784176.0,6200,8966,2087.9,2095.0,15166,31729162.0,234,114,69,12940042.0,18308106.0,6215,8736,2082.1,2095.7,14951,31248149.0,183,2023-11-14 15:45:00
1005,POSI,191,81,10969316.0,12131169.0,5269,5788,2081.9,2095.9,11057,23100485.0,272,150,74,10710610.0,12952144.0,5146,6177,2081.3,2096.8,11323,23662754.0,224,2023-11-14 15:50:00
1006,POSI,135,55,11951168.0,12257126.0,5725,5957,2087.5,2057.6,11682,24208295.0,190,138,37,11866483.0,10329025.0,5699,4929,2082.2,2095.6,10628,22195509.0,175,2023-11-14 15:55:00
1007,POSI,348,407,79346319.0,100611440.0,38141,48109,2080.3,2091.3,86250,179957760.0,755,338,380,78555698.0,98902982.0,37766,47174,2080.1,2096.6,84940,177458681.0,718,2023-11-14 16:00:00
1008,POSI,200,142,22899578.0,30804013.0,11009,14695,2080.1,2096.2,25704,53703591.0,342,143,125,22453568.0,30401408.0,10801,14499,2078.8,2096.8,25300,52854976.0,268,2023-11-14 16:05:00
1009,POSI,111,106,13519512.0,16570230.0,6485,7913,2084.7,2094.1,14398,30089742.0,217,81,89,15650711.0,18999296.0,7514,9058,2082.9,2097.5,16572,34650007.0,170,2023-11-14 16:10:00
1010,POSI,376,274,59968617.0,66862942.0,28838,29919,2079.5,2234.8,58757,126831559.0,650,313,251,55393401.0,62127427.0,26631,29692,2080.0,2092.4,56323,117520828.0,564,2023-11-14 16:15:00
1011,POSI,525,693,77124314.0,192618935.0,37183,92697,2074.2,2077.9,129880,269743249.0,1218,432,637,71550839.0,185048948.0,34522,88669,2072.6,2087.0,123191,256599788.0,1069,2023-11-14 16:20:00
1012,POSI,329,278,47230531.0,90845701.0,22796,42546,2071.9,2135.2,65342,138076232.0,607,237,253,42505904.0,85939837.0,20549,40170,2068.5,2139.4,60719,128445741.0,490,2023-11-14 16:25:00
1013,POSI,192,317,24176904.0,103925189.0,11678,50020,2070.3,2077.7,61698,128102094.0,509,143,269,21456411.0,101533550.0,10365,48752,2070.1,2082.7,59117,122989961.0,412,2023-11-14 16:30:00
1014,POSI,1106,714,182278135.0,180895842.0,88317,86552,2063.9,2090.0,174869,363173977.0,1820,875,561,170807004.0,169243868.0,82960,81513,2058.9,2076.3,164473,340050872.0,1436,2023-11-14 16:35:00
1015,POSI,697,439,126874056.0,88200142.0,61353,42556,2067.9,2072.6,103909,215074198.0,1136,460,345,110358014.0,78829837.0,53546,37981,2061.0,2075.5,91527,189187852.0,805,2023-11-14 16:40:00
1016,POSI,1080,1159,239819330.0,211492321.0,115642,101674,2073.8,2080.1,217316,451311651.0,2239,926,1062,236088065.0,202369949.0,114127,97219,2068.6,2081.6,211346,438458014.0,1988,2023-11-14 16:45:00
1017,POSI,3199,1121,552139957.0,203570966.0,226480,97848,2437.9,2080.5,324328,755710924.0,4320,3077,1041,470016996.0,201494548.0,226574,96773,2074.5,2082.1,323347,671511544.0,4118,2023-11-14 16:50:00
1018,POSI,1219,661,291182106.0,125326757.0,140015,60265,2079.6,2079.6,200280,416508863.0,1880,1171,612,287928745.0,121418695.0,138557,58192,2078.1,2086.5,196749,409347441.0,1783,2023-11-14 16:55:00
1019,POSI,393,1088,61550652.0,215071204.0,29641,102168,2076.5,2105.1,131809,276621856.0,1481,347,1037,59877633.0,210710320.0,28854,101073,2075.2,2084.7,129927,270587953.0,1384,2023-11-14 17:00:00
1020,POSI,680,751,102856925.0,175169512.0,49469,83912,2079.2,2087.5,133381,278026437.0,1431,598,703,101330129.0,169350496.0,48774,81164,2077.5,2086.5,129938,270680625.0,1301,2023-11-14 17:05:00
1021,POSI,468,272,96845047.0,54072086.0,46523,25849,2081.7,2091.8,72372,150917133.0,740,447,227,94064397.0,53818944.0,45254,25723,2078.6,2092.2,70977,147883341.0,674,2023-11-14 17:10:00
1022,POSI,614,348,123528780.0,61921959.0,59351,29644,2081.3,2088.9,88995,185450740.0,962,558,308,122012269.0,60738889.0,58654,29038,2080.2,2091.7,87692,182751158.0,866,2023-11-14 17:15:00
1023,POSI,328,244,45370731.0,40756445.0,21778,19514,2083.3,2088.6,41292,86127176.0,572,298,225,44108741.0,40985976.0,21213,19613,2079.3,2089.7,40826,85094717.0,523,2023-11-14 17:20:00
1024,POSI,192,131,18418061.0,18476726.0,8839,8822,2083.7,2094.4,17661,36894788.0,323,143,97,18014534.0,17990763.0,8658,8588,2080.7,2094.9,17246,36005297.0,240,2023-11-14 17:25:00
1025,POSI,131,94,6509492.0,12310451.0,3121,5895,2085.7,2088.3,9016,18819944.0,225,102,77,5755987.0,14129525.0,2766,6633,2081.0,2130.2,9399,19885512.0,179,2023-11-14 17:30:00
1026,POSI,1296,347,227030205.0,85016208.0,109048,40630,2081.9,2092.4,149678,312046413.0,1643,1279,320,227424071.0,81233643.0,109237,38810,2081.9,2093.1,148047,308657714.0,1599,2023-11-14 17:35:00
1027,POSI,465,826,88641268.0,50806920.0,42607,24382,2080.4,2083.8,66989,139448188.0,1291,421,764,85014995.0,46920885.0,40890,22497,2079.1,2085.7,63387,131935881.0,1185,2023-11-14 17:40:00
1028,POSI,382,1263,62286028.0,258917733.0,29977,124111,2077.8,2086.2,154088,321203762.0,1645,322,1234,61594546.0,257597020.0,29726,123361,2072.1,2088.2,153087,319191567.0,1556,2023-11-14 17:45:00
1029,POSI,364,919,44604510.0,248795973.0,21516,119196,2073.1,2087.3,140712,293400484.0,1283,365,897,45910707.0,249953054.0,22153,119734,2072.4,2087.6,141887,295863761.0,1262,2023-11-14 17:50:00
1030,POSI,458,250,51842744.0,70795190.0,25018,33917,2072.2,2087.3,58935,122637934.0,708,372,197,49186931.0,69131466.0,23741,33030,2071.8,2093.0,56771,118318398.0,569,2023-11-14 17:55:00
1031,POSI,227,341,20124744.0,113659924.0,9740,54448,2066.2,2087.5,64188,133784669.0,568,207,326,18991810.0,111231333.0,9194,53273,2065.7,2087.9,62467,130223144.0,533,2023-11-14 18:00:00
1032,POSI,156,131,8289015.0,35131737.0,3995,16830,2074.8,2087.4,20825,43420752.0,287,150,118,6556676.0,35114006.0,3172,16812,2067.0,2088.6,19984,41670683.0,268,2023-11-14 18:05:00
1033,POSI,237,384,123152567.0,117420563.0,23747,56132,5186.0,2091.9,79879,240573130.0,621,229,328,131578033.0,115901568.0,23863,55385,5513.9,2092.7,79248,247479601.0,557,2023-11-14 18:10:00
1034,POSI,226,305,36225260.0,114164834.0,17478,54613,2072.6,2090.4,72091,150390094.0,531,154,280,34292595.0,111493185.0,16564,53297,2070.3,2091.9,69861,145785780.0,434,2023-11-14 18:15:00
1035,POSI,177,432,13544181.0,148163402.0,6541,70943,2070.7,2088.5,77484,161707584.0,609,151,406,13446950.0,147854806.0,6497,70775,2069.7,2089.1,77272,161301757.0,557,2023-11-14 18:20:00
1036,POSI,480,700,118482739.0,154742044.0,56932,73924,2081.1,2093.3,130856,273224783.0,1180,437,659,116007014.0,153430718.0,55863,73268,2076.6,2094.1,129131,269437732.0,1096,2023-11-14 18:25:00
1037,POSI,196,168,51503910.0,65535439.0,24845,31266,2073.0,2096.1,56111,117039350.0,364,172,134,50644764.0,60153816.0,24435,28667,2072.6,2098.4,53102,110798580.0,306,2023-11-14 18:30:00
1038,POSI,174,62,9929848.0,4519392.0,4799,2174,2069.1,2078.8,6973,14449240.0,236,122,37,7208462.0,4570391.0,3499,2181,2060.1,2095.5,5680,11778853.0,159,2023-11-14 18:35:00
1039,POSI,79,44,3531106.0,4667577.0,1696,2263,2082.0,2062.6,3959,8198684.0,123,87,35,3327384.0,4881838.0,1606,2326,2071.8,2098.8,3932,8209222.0,122,2023-11-14 18:40:00
1040,POSI,2862,1804,228320720.0,228320720.0,109010,107919,2094.5,2167.9,216929,462272973.0,4666,2711,1302,216087166.0,216087166.0,102736,87235,2103.3,2115.1,189971,400602247.0,4013,2023-11-29 10:05:00
1041,POSI,259,593,51025664.0,51025664.0,24425,31729,2089.1,2109.1,56154,117946613.0,852,200,536,46538279.0,46538279.0,22167,29580,2099.4,2114.8,51747,109094602.0,736,2023-11-29 10:10:00
1042,POSI,160,119,13369223.0,13369223.0,6426,4491,2080.5,2155.1,10917,23047976.0,279,97,82,12189480.0,12189480.0,5806,2971,2099.5,2114.7,8777,18472237.0,179,2023-11-29 10:15:00
1043,POSI,494,319,56833438.0,56833438.0,27089,25960,2098.0,2118.4,53049,111828166.0,813,455,262,52346715.0,52346715.0,24909,24048,2101.5,2116.9,48957,103255028.0,717,2023-11-29 10:20:00
1044,POSI,178,93,10939073.0,10939073.0,5258,4283,2080.5,2090.5,9541,19892649.0,271,114,63,13240604.0,13240604.0,6306,3963,2099.7,2115.7,10269,21624942.0,177,2023-11-29 10:25:00
1045,POSI,180,109,22083774.0,22083774.0,10532,9366,2096.8,2110.6,19898,41851966.0,289,156,84,17271207.0,17271207.0,8225,8764,2099.8,2117.7,16989,35830936.0,240,2023-11-29 10:30:00
1046,POSI,425,321,115118092.0,115118092.0,54830,34121,2099.5,2115.8,88951,187309714.0,746,356,283,98472806.0,98472806.0,46828,34439,2102.9,2120.7,81267,171506179.0,639,2023-11-29 10:35:00
1047,POSI,359,406,79121367.0,79121367.0,37739,34289,2096.5,2120.1,72028,151817003.0,765,300,298,67717241.0,67717241.0,32112,30030,2108.8,2125.2,62142,131537594.0,598,2023-11-29 10:40:00
1048,POSI,195,300,26255572.0,26255572.0,12511,15783,2098.6,2080.2,28294,59088121.0,495,168,201,24325533.0,24325533.0,11532,11384,2109.4,2125.2,22916,48518705.0,369,2023-11-29 10:45:00
1049,POSI,203,173,23160351.0,23160351.0,10991,11089,2107.2,2115.0,22080,46613629.0,376,143,148,21233540.0,21233540.0,10066,11440,2109.4,2125.3,21506,45546498.0,291,2023-11-29 10:50:00
1050,POSI,123,111,12474184.0,12474184.0,5964,6791,2091.6,2115.5,12755,26840350.0,234,121,78,12254988.0,12254988.0,5807,5325,2110.4,2129.5,11132,23594443.0,199,2023-11-29 10:55:00
1051,POSI,292,349,83951716.0,83951716.0,39910,39525,2103.5,2096.4,79435,166811860.0,641,301,277,117481049.0,117481049.0,55738,36771,2107.7,2123.5,92509,195562505.0,578,2023-11-29 11:00:00
1052,POSI,245,208,38140991.0,38140991.0,18117,15669,2105.3,2119.6,33786,71353724.0,453,212,178,38138353.0,38138353.0,18110,16095,2105.9,2121.2,34205,72278817.0,390,2023-11-29 11:05:00
1053,POSI,335,210,47163293.0,47163293.0,22610,21331,2085.9,2122.4,43941,92436415.0,545,315,168,44988299.0,44988299.0,21350,20012,2107.2,2123.7,41362,87488442.0,483,2023-11-29 11:10:00
1054,POSI,198,109,21051720.0,21051720.0,9989,6827,2107.5,2100.9,16816,35394648.0,307,161,96,19314271.0,19314271.0,9162,6750,2108.1,2122.0,15912,33637917.0,257,2023-11-29 11:15:00
1055,POSI,615,176,73255624.0,73255624.0,34808,9077,2104.6,2119.9,43885,92498095.0,791,621,170,72878694.0,72878694.0,34514,8978,2111.6,2123.1,43492,91939734.0,791,2023-11-29 11:20:00
1056,POSI,825,273,81195706.0,81195706.0,38448,5640,2111.8,2118.5,44088,93144006.0,1098,796,221,81379540.0,81379540.0,38525,5056,2112.4,2122.6,43581,92111585.0,1017,2023-11-29 11:25:00
1057,POSI,272,115,26223945.0,26223945.0,12476,3753,2102.0,2112.9,16229,34153672.0,387,226,106,24603819.0,24603819.0,11666,4707,2109.0,2139.4,16373,34674127.0,332,2023-11-29 11:30:00
1058,POSI,284,80,28815785.0,28815785.0,13715,3771,2101.0,2243.4,17486,37275761.0,364,312,105,27492184.0,27492184.0,13028,2484,2110.2,2122.4,15512,32764301.0,417,2023-11-29 11:35:00
1059,POSI,133,113,3387478.0,3387478.0,1619,2004,2092.3,2156.0,3623,7708112.0,246,77,63,2800418.0,2800418.0,1331,2109,2104.0,2121.8,3440,7275325.0,140,2023-11-29 11:40:00
1060,POSI,105,116,6272773.0,6272773.0,3020,5090,2077.1,2079.4,8110,16856844.0,221,122,124,6365055.0,6365055.0,3024,2905,2104.8,2121.7,5929,12528486.0,246,2023-11-29 11:45:00
1061,POSI,280,184,36025052.0,36025052.0,17109,7008,2105.6,2090.2,24117,50673511.0,464,271,142,35688768.0,35688768.0,16942,7816,2106.5,2118.5,24758,52246642.0,413,2023-11-29 11:50:00
1062,POSI,447,344,63838517.0,63838517.0,30327,15366,2105.0,2105.7,45693,96193952.0,791,406,277,63881369.0,63881369.0,30337,14901,2105.7,2120.2,45238,95474178.0,683,2023-11-29 11:55:00
1063,POSI,158,125,17979478.0,17979478.0,8574,7571,2097.0,2118.7,16145,34019817.0,283,172,138,19572681.0,19572681.0,9308,8583,2102.8,2129.0,17891,37845587.0,310,2023-11-29 12:00:00
1064,POSI,262,183,35846382.0,35846382.0,17052,11429,2102.2,2117.9,28481,60052099.0,445,230,148,33387078.0,33387078.0,15864,11163,2104.6,2120.4,27027,57056883.0,378,2023-11-29 12:05:00
1065,POSI,211,94,28892233.0,28892233.0,13728,6967,2104.6,2099.9,20695,43522133.0,305,191,98,28738489.0,28738489.0,13652,5910,2105.1,2120.9,19562,41273022.0,289,2023-11-29 12:10:00
1066,POSI,368,135,61202615.0,61202615.0,29094,12172,2103.6,2114.4,41266,86939319.0,503,372,115,60624616.0,60624616.0,28811,11495,2104.2,2120.0,40306,84993688.0,487,2023-11-29 12:15:00
1067,POSI,266,144,45641503.0,45641503.0,21762,13048,2097.3,2085.1,34810,72847404.0,410,242,128,43820945.0,43820945.0,20842,12500,2102.5,2117.1,33342,70284184.0,370,2023-11-29 12:20:00
1068,POSI,541,214,77884977.0,77884977.0,37843,17726,2058.1,2118.7,55569,115441567.0,755,513,208,76906488.0,76906488.0,36524,17765,2105.6,2118.5,54289,114542035.0,721,2023-11-29 12:25:00
1069,POSI,1371,404,167464732.0,167464732.0,79521,36301,2105.9,2102.6,115822,243791964.0,1775,1336,364,164778177.0,164778177.0,78185,35771,2107.5,2119.5,113956,240593621.0,1700,2023-11-29 12:30:00
1070,POSI,725,261,61628045.0,61628045.0,29277,10713,2105.0,2119.9,39990,84338745.0,986,709,254,61349723.0,61349723.0,29095,10544,2108.6,2121.5,39639,83718425.0,963,2023-11-29 12:35:00
1071,POSI,147,313,26532823.0,26532823.0,12621,21537,2102.3,2114.2,34158,72065393.0,460,141,293,27091463.0,27091463.0,12876,21051,2104.0,2115.6,33927,71626705.0,434,2023-11-29 12:40:00
1072,POSI,319,2015,59885314.0,59885314.0,28503,100125,2101.0,2110.5,128628,271201012.0,2334,283,1909,59918823.0,59918823.0,28515,99517,2101.3,2112.0,128032,270095312.0,2192,2023-11-29 12:45:00
1073,POSI,259,1418,13810942.0,13810942.0,6601,66327,2092.2,2110.7,72928,153806241.0,1677,274,1409,14069846.0,14069846.0,6696,66279,2101.2,2110.6,72975,153959637.0,1683,2023-11-29 12:50:00
1074,POSI,220,659,20363070.0,20363070.0,9775,34265,2083.2,2092.8,44040,92073314.0,879,166,648,19759846.0,19759846.0,9402,33846,2101.7,2111.7,43248,91231978.0,814,2023-11-29 12:55:00
1075,POSI,643,730,51615958.0,51615958.0,24644,33646,2094.5,2097.6,58290,122190820.0,1373,622,717,51449396.0,51449396.0,24502,32852,2099.8,2111.7,57354,120821491.0,1339,2023-11-29 13:00:00
1076,POSI,417,399,30808867.0,30808867.0,14681,18697,2098.6,2112.4,33378,70304565.0,816,378,393,30223262.0,30223262.0,14397,18327,2099.3,2111.6,32724,68922712.0,771,2023-11-29 13:05:00
1077,POSI,126,174,33663055.0,33663055.0,16062,19620,2095.8,2102.4,35682,74913083.0,300,148,161,33519268.0,33519268.0,15977,19330,2098.0,2112.5,35307,74354787.0,309,2023-11-29 13:10:00
1078,POSI,130,129,12753643.0,12753643.0,6088,8736,2094.9,2094.6,14824,31052239.0,259,68,107,12324568.0,12324568.0,5873,8634,2098.5,2111.4,14507,30554364.0,175,2023-11-29 13:15:00
1079,POSI,322,178,29731521.0,29731521.0,14303,9074,2078.7,2103.5,23377,48818271.0,500,297,165,25004550.0,25004550.0,11898,8750,2101.6,2112.8,20648,43491412.0,462,2023-11-29 13:20:00
1080,POSI,98,103,12507428.0,12507428.0,5995,7534,2086.3,2117.1,13529,28457891.0,201,118,99,14643278.0,14643278.0,6972,7277,2100.3,2116.7,14249,30046759.0,217,2023-11-29 13:25:00
1081,POSI,255,121,28025046.0,28025046.0,13368,10480,2096.4,2115.6,23848,50196826.0,376,234,97,28706747.0,28706747.0,13655,9818,2102.3,2117.0,23473,49491333.0,331,2023-11-29 13:30:00
1082,POSI,1749,152,103419132.0,103419132.0,49174,11649,2103.1,2112.5,60823,128027588.0,1901,1742,166,103439828.0,103439828.0,49143,11571,2104.9,2115.9,60714,127922431.0,1908,2023-11-29 13:35:00
1083,POSI,1427,222,85109232.0,85109232.0,40428,12361,2105.2,2113.9,52789,111238678.0,1649,1394,207,84972743.0,84972743.0,40364,12243,2105.2,2113.7,52607,110850348.0,1601,2023-11-29 13:40:00
1084,POSI,613,108,51294886.0,51294886.0,24391,9466,2103.0,2111.3,33857,71280347.0,721,643,109,51257496.0,51257496.0,24357,9282,2104.4,2116.5,33639,70902978.0,752,2023-11-29 13:45:00
1085,POSI,680,78,38786269.0,38786269.0,18432,681,2104.3,2122.3,19113,40231587.0,758,650,58,38084625.0,38084625.0,18096,673,2104.6,2119.3,18769,39510928.0,708,2023-11-29 13:50:00
1086,POSI,657,106,49638413.0,49638413.0,23586,6522,2104.6,2110.3,30108,63402077.0,763,640,96,49266472.0,49266472.0,23398,6252,2105.6,2114.9,29650,62488625.0,736,2023-11-29 13:55:00
1087,POSI,1264,53,88559127.0,88559127.0,42052,4016,2105.9,2116.9,46068,97060526.0,1317,1263,65,91093122.0,91093122.0,43260,4237,2105.7,2117.1,47497,100063174.0,1328,2023-11-29 14:00:00
1088,POSI,973,312,97822449.0,97822449.0,46575,25893,2100.3,2111.3,72468,152489826.0,1285,963,292,94988405.0,94988405.0,45159,24734,2103.4,2113.1,69893,147254909.0,1255,2023-11-29 14:05:00
1089,POSI,189,976,34543850.0,34543850.0,16571,52568,2084.6,2108.9,69139,145402051.0,1165,169,972,33758778.0,33758778.0,16083,52110,2099.0,2109.5,68193,143684713.0,1141,2023-11-29 14:10:00
1090,POSI,280,2068,46428247.0,46428247.0,22121,90190,2098.8,2109.4,112311,236672053.0,2348,225,2057,46228652.0,46228652.0,22020,90377,2099.4,2109.5,112397,236876969.0,2282,2023-11-29 14:15:00
1091,POSI,133,232,7505402.0,7505402.0,3585,11113,2093.6,2110.3,14698,30957203.0,365,134,227,8681472.0,8681472.0,4137,11333,2098.5,2109.9,15470,32593111.0,361,2023-11-29 14:20:00
1092,POSI,268,1501,45199807.0,45199807.0,21588,66612,2093.7,2104.4,88200,185375706.0,1769,247,1475,43528491.0,43528491.0,20753,65928,2097.5,2107.8,86681,182494231.0,1722,2023-11-29 14:25:00
1093,POSI,166,679,21229850.0,21229850.0,10139,29221,2093.9,2106.0,39360,82770523.0,845,160,671,20478347.0,20478347.0,9765,29243,2097.1,2106.7,39008,82085130.0,831,2023-11-29 14:30:00
1094,POSI,155,181,7160869.0,7160869.0,3412,5618,2098.7,2100.1,9030,18959079.0,336,128,174,6743851.0,6743851.0,3213,5608,2098.9,2109.2,8821,18572156.0,302,2023-11-29 14:35:00
1095,POSI,96,73,4210947.0,4210947.0,2041,2700,2063.2,2038.5,4741,9714770.0,169,82,64,3948195.0,3948195.0,1883,2409,2096.8,2111.9,4292,9035784.0,146,2023-11-29 14:40:00
1096,POSI,474,192,29415694.0,29415694.0,14060,9295,2092.2,2112.8,23355,49053875.0,666,445,175,27818731.0,27818731.0,13234,8801,2102.1,2112.5,22035,46410896.0,620,2023-11-29 14:45:00
1097,POSI,216,94,17889438.0,17889438.0,8542,6354,2094.3,2110.9,14896,31301955.0,310,199,85,17178969.0,17178969.0,8179,5942,2100.4,2113.6,14121,29737964.0,284,2023-11-29 14:50:00
1098,POSI,162,93,16129908.0,16129908.0,7728,6045,2087.2,2106.4,13773,28863186.0,255,129,66,15083373.0,15083373.0,7183,5982,2099.9,2113.3,13165,27724898.0,195,2023-11-29 14:55:00
1099,POSI,137,82,22315837.0,22315837.0,10639,9406,2097.6,2110.8,20045,42169775.0,219,133,71,23261099.0,23261099.0,11088,9301,2097.9,2115.6,20389,42938217.0,204,2023-11-29 15:00:00
1100,POSI,110,68,7947619.0,7947619.0,3785,3138,2099.8,2108.4,6923,14563688.0,178,90,61,8024863.0,8024863.0,3823,2830,2099.1,2114.8,6653,14009694.0,151,2023-11-29 15:05:00
1101,POSI,181,136,18942528.0,18942528.0,9111,7914,2079.1,2055.3,17025,35208249.0,317,172,124,18714286.0,18714286.0,8909,7619,2100.6,2114.1,16528,34821586.0,296,2023-11-29 15:10:00
1102,POSI,108,37,8329783.0,8329783.0,3966,2607,2100.3,2114.7,6573,13842805.0,145,120,46,8276478.0,8276478.0,3940,2653,2100.6,2114.4,6593,13885990.0,166,2023-11-29 15:15:00
1103,POSI,180,89,11574499.0,11574499.0,5509,3730,2101.0,2115.2,9239,19464334.0,269,152,78,11454906.0,11454906.0,5450,3793,2101.8,2113.6,9243,19471727.0,230,2023-11-29 15:20:00
1104,POSI,557,82,43466641.0,43466641.0,20690,8668,2100.9,2085.2,29358,61541193.0,639,562,72,43352869.0,43352869.0,20616,8207,2102.9,2114.5,28823,60706805.0,634,2023-11-29 15:25:00
1105,POSI,103,173,6381999.0,6381999.0,3041,7475,2098.7,2109.8,10516,22152561.0,276,81,164,6286468.0,6286468.0,2994,7446,2099.7,2109.9,10440,21996588.0,245,2023-11-29 15:30:00
1106,POSI,422,317,59626024.0,59626024.0,28652,28637,2081.0,2113.0,57289,120135426.0,739,378,299,58137619.0,58137619.0,27688,28378,2099.7,2113.2,56066,118106407.0,677,2023-11-29 15:35:00
1107,POSI,675,296,54799635.0,54799635.0,26069,17324,2102.1,2111.4,43393,91377252.0,971,665,273,54577357.0,54577357.0,25960,17071,2102.4,2113.5,43031,90657036.0,938,2023-11-29 15:40:00
1108,POSI,444,127,30306484.0,30306484.0,14411,6982,2103.0,2100.5,21393,44971853.0,571,464,123,29923941.0,29923941.0,14230,6812,2102.9,2113.0,21042,44317762.0,587,2023-11-29 15:45:00
1109,POSI,167,126,11657406.0,11657406.0,5585,10006,2087.3,2150.8,15591,33178037.0,293,130,117,11788056.0,11788056.0,5618,7567,2098.3,2111.9,13185,27769108.0,247,2023-11-29 15:50:00
1110,POSI,119,38,7778803.0,7778803.0,3714,3132,2094.5,2110.1,6846,14387542.0,157,94,34,7623694.0,7623694.0,3632,3088,2099.0,2115.1,6720,14155084.0,128,2023-11-29 15:55:00
1111,POSI,151,88,10332603.0,10332603.0,4931,4418,2095.4,2102.4,9349,19621100.0,239,140,71,9450840.0,9450840.0,4502,4150,2099.3,2113.3,8652,18221176.0,211,2023-11-29 16:00:00
1112,POSI,101,37,2146080.0,2146080.0,1024,643,2095.8,2115.3,1667,3506213.0,138,116,39,2098724.0,2098724.0,1002,592,2094.5,2117.3,1594,3352184.0,155,2023-11-29 16:05:00
1113,POSI,78,43,7682991.0,7682991.0,3767,2605,2039.6,2095.2,6372,13140950.0,121,82,52,10256561.0,10256561.0,4891,3721,2097.0,2113.9,8612,18122275.0,134,2023-11-29 16:10:00
1114,POSI,123,60,7983269.0,7983269.0,4099,3796,1947.6,2079.8,7895,15878323.0,183,81,43,7583560.0,7583560.0,3612,3787,2099.5,2112.8,7399,15584844.0,124,2023-11-29 16:15:00
1115,POSI,565,235,38315273.0,38315273.0,18720,10002,2046.8,2113.5,28722,59454832.0,800,559,221,37472058.0,37472058.0,17822,10442,2102.6,2113.3,28264,59539264.0,780,2023-11-29 16:20:00
1116,POSI,117,68,11810152.0,11810152.0,5634,4244,2096.2,2117.2,9878,20795688.0,185,102,62,11669487.0,11669487.0,5556,4105,2100.3,2117.7,9661,20362843.0,164,2023-11-29 16:25:00
1117,POSI,129,78,8706292.0,8706292.0,4204,2670,2071.0,2110.6,6874,14341463.0,207,104,76,8867014.0,8867014.0,4215,2520,2103.7,2116.9,6735,14201517.0,180,2023-11-29 16:30:00
1118,POSI,145,95,7306163.0,7306163.0,3484,2136,2097.1,2078.4,5620,11745656.0,240,125,74,7172107.0,7172107.0,3411,2062,2102.6,2117.1,5473,11537548.0,199,2023-11-29 16:35:00
1119,POSI,104,50,11455401.0,11455401.0,5507,2651,2080.2,2062.3,8158,16922539.0,154,127,53,11517973.0,11517973.0,5475,2630,2103.7,2117.5,8105,17087097.0,180,2023-11-29 16:40:00
1120,POSI,131,72,8951683.0,8951683.0,4270,2898,2096.4,2102.5,7168,15044603.0,203,100,56,8851819.0,8851819.0,4207,2721,2104.1,2117.5,6928,14613491.0,156,2023-11-29 16:45:00
1121,POSI,154,86,7891486.0,7891486.0,4006,3015,1969.9,2067.6,7021,14125174.0,240,144,81,7860048.0,7860048.0,3736,2834,2103.9,2117.1,6570,13859851.0,225,2023-11-29 16:50:00
1122,POSI,137,90,10364485.0,10364485.0,4931,4966,2101.9,2115.3,9897,20869085.0,227,135,71,10676969.0,10676969.0,5076,4791,2103.4,2116.6,9867,20817485.0,206,2023-11-29 16:55:00
1123,POSI,171,512,15139239.0,15139239.0,7210,22882,2099.8,2110.3,30092,63427039.0,683,171,516,17747013.0,17747013.0,8451,23892,2100.0,2111.0,32343,68184075.0,687,2023-11-29 17:00:00
1124,POSI,373,685,31481809.0,31481809.0,14979,30788,2101.7,2111.1,45767,96477149.0,1058,358,681,31921278.0,31921278.0,15180,31078,2102.9,2111.8,46258,97551229.0,1039,2023-11-29 17:05:00
1125,POSI,339,843,16326387.0,16326387.0,7775,41317,2099.9,2109.7,49092,103492540.0,1182,330,833,16925918.0,16925918.0,8058,37169,2100.5,2110.2,45227,95361320.0,1163,2023-11-29 17:10:00
1126,POSI,166,182,12795700.0,12795700.0,6100,9135,2097.7,2105.1,15235,32025899.0,348,161,183,9419916.0,9419916.0,4488,12897,2098.9,2109.0,17385,36619194.0,344,2023-11-29 17:15:00
1127,POSI,163,224,5787516.0,5787516.0,2814,13484,2056.7,2108.4,16298,34217694.0,387,135,210,8111131.0,8111131.0,3865,13593,2098.6,2108.6,17458,36773404.0,345,2023-11-29 17:20:00
1128,POSI,393,1722,74797095.0,74797095.0,35662,116599,2097.4,2100.0,152261,319652798.0,2115,343,1693,70776070.0,70776070.0,33736,115214,2097.9,2108.8,148950,313733764.0,2036,2023-11-29 17:25:00
1129,POSI,437,1158,67151218.0,67151218.0,32106,77978,2091.5,2108.2,110084,231542273.0,1595,425,1123,64774557.0,64774557.0,30876,77575,2097.9,2108.6,108451,228346440.0,1548,2023-11-29 17:30:00
1130,POSI,1200,2124,141594949.0,141594949.0,67680,105223,2092.1,2103.0,172903,362883207.0,3324,1135,2080,138360401.0,138360401.0,65841,104629,2101.4,2110.3,170470,359158395.0,3215,2023-11-29 17:35:00
1131,POSI,580,1414,59771628.0,59771628.0,28455,55402,2100.6,2102.3,83857,176241435.0,1994,575,1403,59438657.0,59438657.0,28258,54974,2103.4,2111.9,83232,175536901.0,1978,2023-11-29 17:40:00
1132,POSI,297,2528,35874837.0,35874837.0,17166,76916,2089.9,2110.7,94082,198222273.0,2825,290,2534,35779720.0,35779720.0,17017,76855,2102.6,2110.7,93872,197993960.0,2824,2023-11-29 17:45:00
1133,POSI,336,1795,57140599.0,57140599.0,27168,71800,2103.2,2112.2,98968,208795936.0,2131,303,1769,56856532.0,56856532.0,27032,71675,2103.3,2112.7,98707,208281692.0,2072,2023-11-29 17:50:00
1134,POSI,509,823,39717002.0,39717002.0,18908,32667,2100.5,2111.3,51575,108686055.0,1332,514,816,39653116.0,39653116.0,18851,32301,2103.5,2111.6,51152,107858955.0,1330,2023-11-29 17:55:00
1135,POSI,575,1445,70546751.0,70546751.0,33580,62020,2100.9,2107.0,95600,201225081.0,2020,564,1424,70629104.0,70629104.0,33605,61839,2101.7,2110.7,95444,201150699.0,1988,2023-11-29 18:00:00
1136,POSI,137,1140,16101618.0,16101618.0,7775,31113,2070.9,2107.2,38888,81663176.0,1277,139,1127,16277580.0,16277580.0,7770,29920,2094.9,2108.3,37690,79356976.0,1266,2023-11-29 18:05:00
1137,POSI,235,405,33926047.0,33926047.0,16267,14548,2085.6,2109.0,30815,64607663.0,640,253,392,33792012.0,33792012.0,16093,14287,2099.8,2110.5,30380,63945071.0,645,2023-11-29 18:10:00
1138,POSI,102,179,11967351.0,11967351.0,5721,7914,2091.8,2057.1,13635,28247359.0,281,79,171,11657360.0,11657360.0,5555,7760,2098.5,2111.4,13315,28041493.0,250,2023-11-29 18:15:00
1139,POSI,175,734,12838837.0,12838837.0,6144,24953,2089.7,2108.0,31097,65438517.0,909,141,712,12042224.0,12042224.0,5738,22908,2098.7,2108.5,28646,60343044.0,853,2023-11-29 18:20:00
1140,POSI,127,261,10686249.0,10686249.0,5100,8708,2095.3,2094.5,13808,28925368.0,388,125,253,10512177.0,10512177.0,5009,8753,2098.7,2110.2,13762,28983050.0,378,2023-11-29 18:25:00
1141,POSI,83,51,5250740.0,5250740.0,2518,3043,2085.3,2092.9,5561,11619474.0,134,76,42,5241341.0,5241341.0,2503,2324,2094.0,2117.6,4827,10162734.0,118,2023-11-29 18:30:00
1142,POSI,257,808,17667837.0,17667837.0,8447,21966,2091.6,2100.7,30413,63811347.0,1065,218,802,17025407.0,17025407.0,8125,22744,2095.4,2106.8,30869,64943280.0,1020,2023-11-29 18:35:00
1143,POSI,219,1862,13716900.0,13716900.0,6591,39722,2081.2,2102.7,46313,97240976.0,2081,211,1858,13902951.0,13902951.0,6635,39876,2095.4,2104.7,46511,97829604.0,2069,2023-11-29 18:40:00
1144,POSI,3977,3296,607111373.0,607111373.0,290534,311678,2089.6,2114.2,602212,1266065553.0,7273,3664,2754,559953843.0,559953843.0,267671,290499,2091.9,2104.7,558170,1171380362.0,6418,2023-11-30 10:05:00
1145,POSI,455,2340,82599529.0,82599529.0,39577,136642,2087.1,2104.6,176219,370175246.0,2795,354,2273,79193589.0,79193589.0,37928,133290,2088.0,2102.7,171218,359464454.0,2627,2023-11-30 10:10:00
1146,POSI,779,1221,111988116.0,111988116.0,53670,87225,2086.6,2102.2,140895,295350379.0,2000,717,1146,105840998.0,105840998.0,50619,84638,2090.9,2104.5,135257,283962744.0,1863,2023-11-30 10:15:00
1147,POSI,213,780,39543416.0,39543416.0,19134,37946,2066.7,2100.2,57080,119238492.0,993,172,722,36204450.0,36204450.0,17321,33554,2090.2,2102.2,50875,106742500.0,894,2023-11-30 10:20:00
1148,POSI,210,563,56961075.0,56961075.0,27317,34830,2085.2,2097.3,62147,130008408.0,773,176,529,56101989.0,56101989.0,26857,34217,2088.9,2102.6,61074,128045322.0,705,2023-11-30 10:25:00
1149,POSI,190,166,55283282.0,55283282.0,26529,24651,2083.9,2101.4,51180,107084745.0,356,145,135,52248426.0,52248426.0,25045,22777,2086.2,2103.2,47822,100152448.0,280,2023-11-30 10:30:00
1150,POSI,234,301,33909451.0,33909451.0,16297,18068,2080.7,2101.8,34365,71884156.0,535,191,269,32674549.0,32674549.0,15641,17381,2089.0,2102.4,33022,69216768.0,460,2023-11-30 10:35:00
1151,POSI,276,384,56181719.0,56181719.0,26955,30301,2084.3,2014.8,57256,117233049.0,660,200,342,51153901.0,51153901.0,24526,27515,2085.7,2100.7,52041,108954773.0,542,2023-11-30 10:40:00
1152,POSI,209,246,39117875.0,39117875.0,18765,22294,2084.6,2099.1,41059,85915873.0,455,144,216,36489565.0,36489565.0,17496,20895,2085.6,2099.9,38391,80366244.0,360,2023-11-30 10:45:00
1153,POSI,262,550,44494826.0,44494826.0,21367,29664,2082.4,2084.2,51031,106321562.0,812,181,495,39743379.0,39743379.0,19063,28344,2084.8,2098.7,47407,99228038.0,676,2023-11-30 10:50:00
1154,POSI,167,308,39880576.0,39880576.0,19124,21998,2085.4,2090.7,41122,85871371.0,475,131,265,38802447.0,38802447.0,18593,21416,2086.9,2099.6,40009,83767652.0,396,2023-11-30 10:55:00
1155,POSI,237,540,51245307.0,51245307.0,24626,39234,2080.9,1955.1,63860,127951125.0,777,164,445,46122721.0,46122721.0,22130,35072,2084.2,2098.8,57202,119733035.0,609,2023-11-30 11:00:00
1156,POSI,675,920,140868491.0,140868491.0,67972,83938,2072.4,2041.1,151910,312195795.0,1595,529,798,129036315.0,129036315.0,61984,67504,2081.8,2097.3,129488,270609359.0,1327,2023-11-30 11:05:00
1157,POSI,441,744,114404525.0,114404525.0,54887,65063,2084.4,2098.4,119950,250932230.0,1185,382,685,113998494.0,113998494.0,54641,64274,2086.3,2100.3,118915,248992321.0,1067,2023-11-30 11:10:00
1158,POSI,457,395,84113434.0,84113434.0,40371,35773,2083.5,2096.3,76144,159103667.0,852,403,339,80934829.0,80934829.0,38802,32585,2085.8,2099.9,71387,149361201.0,742,2023-11-30 11:15:00
1159,POSI,721,975,168239691.0,168239691.0,80797,87546,2082.3,2080.6,168343,350385352.0,1696,577,877,167346203.0,167346203.0,80277,86696,2084.6,2099.5,166973,349362132.0,1454,2023-11-30 11:20:00
1160,POSI,487,624,74396630.0,74396630.0,35811,43204,2077.5,2092.3,79015,164791544.0,1111,416,573,74374279.0,74374279.0,35673,42644,2084.9,2098.6,78317,163866717.0,989,2023-11-30 11:25:00
1161,POSI,175,344,33085307.0,33085307.0,15899,21359,2081.0,1972.1,37258,75206530.0,519,149,297,30917877.0,30917877.0,14832,19586,2084.5,2097.6,34418,72001055.0,446,2023-11-30 11:30:00
1162,POSI,114,196,12242408.0,12242408.0,5903,9893,2073.9,2085.9,15796,32878069.0,310,94,178,11661746.0,11661746.0,5601,9657,2082.1,2097.6,15258,31918278.0,272,2023-11-30 11:35:00
1163,POSI,417,1517,92599782.0,92599782.0,44631,87536,2074.8,2081.7,132167,274826670.0,1934,365,1475,89766079.0,89766079.0,43176,86112,2079.1,2091.8,129288,269895922.0,1840,2023-11-30 11:40:00
1164,POSI,517,877,89476558.0,89476558.0,43200,60930,2071.2,2086.4,104130,216599777.0,1394,383,825,86020164.0,86020164.0,41452,58270,2075.2,2088.4,99722,207710781.0,1208,2023-11-30 11:45:00
1165,POSI,373,422,69077790.0,69077790.0,33392,38590,2068.7,2069.7,71982,148947452.0,795,244,366,63346656.0,63346656.0,30562,38124,2072.7,2087.8,68686,142942856.0,610,2023-11-30 11:50:00
1166,POSI,1190,1331,60979868.0,60979868.0,29463,56254,2069.7,2062.5,85717,177005918.0,2521,1088,1274,58421636.0,58421636.0,28167,54312,2074.1,2084.6,82479,171639565.0,2362,2023-11-30 11:55:00
1167,POSI,413,232,40038928.0,40038928.0,19336,18334,2070.7,2083.1,37670,78229868.0,645,346,196,37824788.0,37824788.0,18225,17224,2075.4,2088.3,35449,73793856.0,542,2023-11-30 12:00:00
1168,POSI,282,702,37136530.0,37136530.0,17953,32638,2068.5,2085.1,50591,105190115.0,984,219,676,37156713.0,37156713.0,17915,32290,2074.1,2086.6,50205,104532446.0,895,2023-11-30 12:05:00
1169,POSI,161,136,24154193.0,24154193.0,11710,12178,2062.7,2066.1,23888,49315679.0,297,145,115,23186260.0,23186260.0,11182,11799,2073.5,2086.1,22981,47800340.0,260,2023-11-30 12:10:00
1170,POSI,239,567,30281952.0,30281952.0,14682,23986,2062.5,2080.9,38668,80195296.0,806,169,535,28628481.0,28628481.0,13852,21550,2066.7,2083.5,35402,73527606.0,704,2023-11-30 12:15:00
1171,POSI,151,175,12393611.0,12393611.0,6018,7752,2059.4,2048.0,13770,28269461.0,326,124,136,13270533.0,13270533.0,6404,7213,2072.2,2085.5,13617,28313181.0,260,2023-11-30 12:20:00
1172,POSI,221,105,23079376.0,23079376.0,11227,11275,2055.7,2059.4,22502,46299124.0,326,163,79,22756358.0,22756358.0,10989,9954,2070.8,2085.7,20943,43517286.0,242,2023-11-30 12:25:00
1173,POSI,222,200,18486661.0,18486661.0,8941,11830,2067.6,2050.6,20771,42745006.0,422,163,156,17460124.0,17460124.0,8434,10882,2070.2,2084.5,19316,40143752.0,319,2023-11-30 12:30:00
1174,POSI,220,254,31222904.0,31222904.0,15216,16931,2052.0,2052.0,32147,65965894.0,474,192,177,29151731.0,29151731.0,14083,15611,2070.0,2084.4,29694,61690958.0,369,2023-11-30 12:35:00
1175,POSI,140,118,9948035.0,9948035.0,4977,5955,1998.8,2041.1,10932,22102586.0,258,76,94,7144915.0,7144915.0,3452,5325,2069.8,2083.0,8777,18236954.0,170,2023-11-30 12:40:00
1176,POSI,203,132,15640953.0,15640953.0,7580,8709,2063.5,2009.0,16289,33137733.0,335,173,108,15094610.0,15094610.0,7290,7919,2070.6,2083.9,15209,31597359.0,281,2023-11-30 12:45:00
1177,POSI,432,298,66949281.0,66949281.0,32920,28771,2033.7,2078.0,61691,126736259.0,730,342,271,58310253.0,58310253.0,28139,26539,2072.2,2085.6,54678,113659690.0,613,2023-11-30 12:50:00
1178,POSI,388,165,42652117.0,42652117.0,20597,13366,2070.8,2069.8,33963,70316911.0,553,347,122,38958580.0,38958580.0,18782,12418,2074.3,2088.4,31200,64892493.0,469,2023-11-30 12:55:00
1179,POSI,349,167,35449369.0,35449369.0,17119,14748,2070.8,2069.6,31867,65972472.0,516,293,139,34517166.0,34517166.0,16647,13263,2073.5,2086.6,29910,62191318.0,432,2023-11-30 13:00:00
1180,POSI,196,117,18263325.0,18263325.0,8858,9801,2061.8,2086.6,18659,38714514.0,313,150,102,18167318.0,18167318.0,8768,9374,2072.0,2086.8,18142,37728998.0,252,2023-11-30 13:05:00
1181,POSI,288,98,27175933.0,27175933.0,13230,11564,2054.1,2073.4,24794,51152223.0,386,240,78,25391647.0,25391647.0,12243,10906,2074.0,2088.0,23149,48163498.0,318,2023-11-30 13:10:00
1182,POSI,550,289,102910106.0,102910106.0,50133,35396,2052.7,2083.2,85529,176645614.0,839,505,245,95321731.0,95321731.0,45977,34210,2073.2,2088.7,80187,166777216.0,750,2023-11-30 13:15:00
1183,POSI,228,234,33697080.0,33697080.0,16267,14943,2071.5,2086.3,31210,64872062.0,462,160,201,32339062.0,32339062.0,15584,14291,2075.1,2088.7,29875,62188513.0,361,2023-11-30 13:20:00
1184,POSI,287,219,38520814.0,38520814.0,18701,18493,2059.8,2088.1,37194,77135973.0,506,243,189,36842629.0,36842629.0,17754,18292,2075.2,2089.1,36046,75056560.0,432,2023-11-30 13:25:00
1185,POSI,251,150,25090868.0,25090868.0,12102,11191,2073.3,2086.6,23293,48441725.0,401,214,117,25268606.0,25268606.0,12179,10894,2074.8,2089.9,23073,48035783.0,331,2023-11-30 13:30:00
1186,POSI,228,178,24734945.0,24734945.0,12002,12062,2060.9,2087.1,24064,49908976.0,406,219,152,24561981.0,24561981.0,11837,11907,2075.0,2089.7,23744,49444285.0,371,2023-11-30 13:35:00
1187,POSI,142,87,10380476.0,10380476.0,5030,5276,2063.7,2089.5,10306,21404686.0,229,105,70,9816878.0,9816878.0,4730,4923,2075.4,2089.8,9653,20104976.0,175,2023-11-30 13:40:00
1188,POSI,194,176,31622333.0,31622333.0,15294,13502,2067.6,2047.5,28796,59267520.0,370,175,156,29643972.0,29643972.0,14292,12746,2074.2,2088.1,27038,56258675.0,331,2023-11-30 13:45:00
1189,POSI,182,131,16843192.0,16843192.0,8181,8551,2058.8,2054.8,16732,34413872.0,313,115,119,16213103.0,16213103.0,7817,8556,2074.1,2090.5,16373,34099216.0,234,2023-11-30 13:50:00
1190,POSI,298,95,28999979.0,28999979.0,14029,8788,2067.1,2087.0,22817,47340205.0,393,251,76,26028724.0,26028724.0,12533,8601,2076.8,2089.7,21134,44001846.0,327,2023-11-30 13:55:00
1191,POSI,548,404,74251226.0,74251226.0,35950,29192,2065.4,2091.8,65142,135316223.0,952,536,360,69554175.0,69554175.0,33478,28474,2077.6,2091.6,61952,129111511.0,896,2023-11-30 14:00:00
1192,POSI,180,169,21678842.0,21678842.0,10446,14848,2075.3,2089.2,25294,52699226.0,349,151,147,20661886.0,20661886.0,9949,14289,2076.8,2089.1,24238,50513500.0,298,2023-11-30 14:05:00
1193,POSI,127,76,19698512.0,19698512.0,9503,7902,2072.9,2090.8,17405,36219629.0,203,98,60,21988580.0,21988580.0,10578,7543,2078.7,2091.6,18121,37765265.0,158,2023-11-30 14:10:00
1194,POSI,173,127,17103084.0,17103084.0,8283,6283,2064.8,1950.0,14566,29354988.0,300,112,106,19258342.0,19258342.0,9722,5224,1980.9,2090.7,14946,30180334.0,218,2023-11-30 14:15:00
1195,POSI,181,499,27624258.0,27624258.0,13324,24286,2073.3,2092.4,37610,78441156.0,680,169,471,26072733.0,26072733.0,12548,21530,2077.8,2088.3,34078,71034819.0,640,2023-11-30 14:20:00
1196,POSI,102,121,11687927.0,11687927.0,5625,5762,2077.9,2084.5,11387,23698798.0,223,78,109,11319618.0,11319618.0,5446,5407,2078.5,2090.3,10853,22621761.0,187,2023-11-30 14:25:00
1197,POSI,222,142,38341825.0,38341825.0,18438,14784,2079.5,2088.8,33222,69221956.0,364,170,119,28233778.0,28233778.0,13582,11594,2078.8,2091.7,25176,52484621.0,289,2023-11-30 14:30:00
1198,POSI,496,567,134915712.0,134915712.0,64877,52896,2079.6,2087.4,117773,245330835.0,1063,436,525,134058379.0,134058379.0,64460,51857,2079.7,2091.6,116317,242523066.0,961,2023-11-30 14:35:00
1199,POSI,412,103,57658665.0,57658665.0,27684,7854,2082.7,2090.0,35538,74073777.0,515,428,95,56551980.0,56551980.0,27147,7772,2083.2,2090.9,34919,72802422.0,523,2023-11-30 14:40:00
1200,POSI,277,106,59365699.0,59365699.0,28498,8715,2083.2,2069.6,37213,77402618.0,383,248,87,56800942.0,56800942.0,27262,8021,2083.5,2093.1,35283,73590066.0,335,2023-11-30 14:45:00
1201,POSI,245,202,61648083.0,61648083.0,29847,12106,2065.5,2086.6,41953,86908391.0,447,189,177,60634394.0,60634394.0,29119,11821,2082.3,2092.5,40940,85369779.0,366,2023-11-30 14:50:00
1202,POSI,141,94,53090819.0,53090819.0,25475,4633,2084.0,2085.2,30108,62751678.0,235,149,84,55002081.0,55002081.0,26393,3774,2084.0,2092.6,30167,62899671.0,233,2023-11-30 14:55:00
1203,POSI,150,101,68293597.0,68293597.0,32778,6822,2083.5,2090.2,39600,82553226.0,251,133,88,65946946.0,65946946.0,31647,6788,2083.8,2093.2,38435,80155793.0,221,2023-11-30 15:00:00
1204,POSI,170,384,82312936.0,82312936.0,39539,20855,2081.8,2082.2,60394,125737217.0,554,129,355,81608991.0,81608991.0,39174,19424,2083.2,2093.6,58598,122275545.0,484,2023-11-30 15:05:00
1205,POSI,123,110,75289416.0,75289416.0,36119,4353,2084.5,2077.1,40472,84331046.0,233,136,79,76770043.0,76770043.0,36831,4204,2084.4,2093.9,41035,85572894.0,215,2023-11-30 15:10:00
1206,POSI,101,49,75320872.0,75320872.0,36135,2132,2084.4,2033.7,38267,79656764.0,150,84,39,72390114.0,72390114.0,34726,2028,2084.6,2094.5,36754,76637835.0,123,2023-11-30 15:15:00
1207,POSI,199,112,88722281.0,88722281.0,42585,6486,2083.4,2094.9,49071,102309562.0,311,173,94,89992936.0,89992936.0,43186,5540,2083.8,2095.6,48726,101602804.0,267,2023-11-30 15:20:00
1208,POSI,151,129,83829550.0,83829550.0,40340,6238,2078.1,2091.8,46578,96878318.0,280,135,115,85378407.0,85378407.0,40961,6141,2084.4,2095.8,47102,98248885.0,250,2023-11-30 15:25:00
1209,POSI,132,120,99247279.0,99247279.0,47625,12278,2083.9,1993.0,59903,123716966.0,252,123,101,99042936.0,99042936.0,47527,11592,2083.9,2096.3,59119,123343051.0,224,2023-11-30 15:30:00
1210,POSI,135,162,99371949.0,99371949.0,47683,9972,2084.0,2053.0,57655,119844565.0,297,99,147,99356715.0,99356715.0,47671,9456,2084.2,2095.1,57127,119167809.0,246,2023-11-30 15:35:00
1211,POSI,127,50,99130727.0,99130727.0,47559,5800,2084.4,2088.6,53359,111244749.0,177,133,43,98990167.0,98990167.0,47490,5753,2084.4,2096.2,53243,111049665.0,176,2023-11-30 15:40:00
1212,POSI,116,32,89742906.0,89742906.0,43063,1100,2084.0,2095.0,44163,92047377.0,148,78,33,88581402.0,88581402.0,42488,1119,2084.9,2095.0,43607,90925734.0,111,2023-11-30 15:45:00
1213,POSI,147,84,96126888.0,96126888.0,46117,5989,2084.4,2092.1,52106,108656572.0,231,136,70,96106465.0,96106465.0,46105,5925,2084.5,2096.6,52030,108528849.0,206,2023-11-30 15:50:00
1214,POSI,154,109,96247660.0,96247660.0,46178,6846,2084.3,2065.7,53024,110389780.0,263,159,91,96946968.0,96946968.0,46505,5647,2084.7,2092.7,52152,108764362.0,250,2023-11-30 15:55:00
1215,POSI,161,68,118768285.0,118768285.0,56997,10303,2083.8,2083.7,67300,140236347.0,229,139,55,120340074.0,120340074.0,57745,10173,2084.0,2098.2,67918,141685060.0,194,2023-11-30 16:00:00
1216,POSI,161,172,124672827.0,124672827.0,59821,14695,2084.1,2076.6,74516,155188887.0,333,153,159,124173351.0,124173351.0,59578,13517,2084.2,2092.5,73095,152457623.0,312,2023-11-30 16:05:00
1217,POSI,270,337,163556898.0,163556898.0,78521,32641,2083.0,2087.5,111162,231696131.0,607,259,319,165233808.0,165233808.0,79325,33620,2083.0,2091.9,112945,235564367.0,578,2023-11-30 16:10:00
1218,POSI,323,446,165346432.0,165346432.0,79427,37815,2081.7,2083.8,117242,244143998.0,769,287,432,161928436.0,161928436.0,77741,36743,2082.9,2092.4,114484,238811098.0,719,2023-11-30 16:15:00
1219,POSI,244,197,121982414.0,121982414.0,58530,9174,2084.1,2061.4,67704,140893300.0,441,261,175,124328245.0,124328245.0,59655,8907,2084.1,2091.1,68562,142953885.0,436,2023-11-30 16:20:00
1220,POSI,368,302,172741866.0,172741866.0,82919,25105,2083.3,2083.8,108024,225054756.0,670,308,268,173099087.0,173099087.0,83092,24311,2083.2,2091.8,107403,223953932.0,576,2023-11-30 16:25:00
1221,POSI,305,285,150437057.0,150437057.0,72216,22141,2083.2,2090.7,94357,196727614.0,590,296,262,150005289.0,150005289.0,72001,22040,2083.4,2092.7,94041,196129231.0,558,2023-11-30 16:30:00
1222,POSI,405,502,167633834.0,167633834.0,80492,33767,2082.6,2087.4,114259,238119473.0,907,356,455,167549217.0,167549217.0,80449,33031,2082.7,2091.7,113480,236639761.0,811,2023-11-30 16:35:00
1223,POSI,347,281,140082775.0,140082775.0,67264,20971,2082.6,2060.0,88235,183282154.0,628,302,246,139582769.0,139582769.0,67017,20444,2082.8,2091.8,87461,182348068.0,548,2023-11-30 16:40:00
1224,POSI,332,346,153497536.0,153497536.0,73718,28705,2082.2,2090.5,102423,213504528.0,678,323,306,152594187.0,152594187.0,73275,27799,2082.5,2091.6,101074,210738668.0,629,2023-11-30 16:45:00
1225,POSI,514,444,150519735.0,150519735.0,72282,30021,2082.4,2086.1,102303,213147704.0,958,431,386,149607660.0,149607660.0,71837,29521,2082.6,2092.0,101358,211365940.0,817,2023-11-30 16:50:00
1226,POSI,413,337,136697768.0,136697768.0,65631,19037,2082.8,2092.1,84668,176524234.0,750,349,293,135678954.0,135678954.0,65139,18703,2082.9,2092.1,83842,174807923.0,642,2023-11-30 16:55:00
1227,POSI,527,279,145204272.0,145204272.0,69731,20855,2082.3,2087.0,90586,188728593.0,806,497,229,145012949.0,145012949.0,69625,20453,2082.8,2092.6,90078,187812084.0,726,2023-11-30 17:00:00
1228,POSI,493,306,133845279.0,133845279.0,64265,22133,2082.7,2081.7,86398,179918723.0,799,434,258,133459940.0,133459940.0,64079,23462,2082.7,2092.8,87541,182561550.0,692,2023-11-30 17:05:00
1229,POSI,415,151,108801008.0,108801008.0,52242,11428,2082.6,2089.7,63670,132681838.0,566,397,120,108986066.0,108986066.0,52308,10299,2083.5,2092.1,62607,130532748.0,517,2023-11-30 17:10:00
1230,POSI,624,251,149362801.0,149362801.0,71755,24170,2081.6,2086.7,95925,199799219.0,875,556,214,146697176.0,146697176.0,70448,22609,2082.3,2092.4,93057,194004988.0,770,2023-11-30 17:15:00
1231,POSI,391,138,104759498.0,104759498.0,50283,7004,2083.4,2088.0,57287,119383814.0,529,419,125,107650912.0,107650912.0,51668,8277,2083.5,2094.1,59945,124983916.0,544,2023-11-30 17:20:00
1232,POSI,669,492,156710330.0,156710330.0,75315,40605,2080.7,2081.9,115920,241247890.0,1161,496,367,155679935.0,155679935.0,74813,39319,2080.9,2092.7,114132,237964155.0,863,2023-11-30 17:25:00
1233,POSI,244,187,53782173.0,53782173.0,25827,9100,2082.4,2087.9,34927,72782296.0,431,260,144,54543213.0,54543213.0,26193,9060,2082.4,2091.7,35253,73494244.0,404,2023-11-30 17:30:00
1234,POSI,337,215,44525177.0,44525177.0,21486,8829,2072.3,2009.4,30315,62265846.0,552,291,150,42945271.0,42945271.0,20625,8209,2082.2,2094.0,28834,60135116.0,441,2023-11-30 17:35:00
1235,POSI,239,117,48219587.0,48219587.0,23303,6595,2069.2,2086.9,29898,61982756.0,356,180,94,47477408.0,47477408.0,22792,6376,2083.1,2093.6,29168,60825950.0,274,2023-11-30 17:40:00
1236,POSI,287,61,40006537.0,40006537.0,19207,2372,2082.9,2059.9,21579,44892701.0,348,285,47,39890445.0,39890445.0,19137,2144,2084.5,2093.4,21281,44378652.0,332,2023-11-30 17:45:00
1237,POSI,369,200,58933976.0,58933976.0,28347,10892,2079.0,1983.1,39239,80534380.0,569,258,165,57630423.0,57630423.0,27670,10181,2082.8,2094.4,37851,78953423.0,423,2023-11-30 17:50:00
1238,POSI,242,65,50632718.0,50632718.0,24339,4016,2080.3,2083.0,28355,58997946.0,307,223,52,50861691.0,50861691.0,24406,3828,2084.0,2094.4,28234,58879126.0,275,2023-11-30 17:55:00
1239,POSI,248,49,47739191.0,47739191.0,22940,1042,2081.0,2013.1,23982,49836888.0,297,189,28,47415461.0,47415461.0,22746,919,2084.6,2096.2,23665,49341894.0,217,2023-11-30 18:00:00
1240,POSI,324,65,48694214.0,48694214.0,23385,1437,2082.3,2089.1,24822,51696297.0,389,260,55,48731828.0,48731828.0,23384,1310,2084.0,2094.7,24694,51475881.0,315,2023-11-30 18:05:00
1241,POSI,394,87,82035135.0,82035135.0,39445,8193,2079.7,2096.0,47638,99207331.0,481,393,75,79692420.0,79692420.0,38240,8254,2084.0,2096.3,46494,96995382.0,468,2023-11-30 18:10:00
1242,POSI,566,52,88982315.0,88982315.0,42709,4164,2083.5,2095.5,46873,97707985.0,618,502,37,88385292.0,88385292.0,42389,4813,2085.1,2099.3,47202,98489261.0,539,2023-11-30 18:15:00
1243,POSI,627,249,115825077.0,115825077.0,55570,22353,2084.3,2089.8,77923,162539385.0,876,528,211,117881459.0,117881459.0,56558,23957,2084.3,2099.1,80515,168168516.0,739,2023-11-30 18:20:00
1244,POSI,343,193,94339215.0,94339215.0,45241,8115,2085.3,2082.0,53356,111234683.0,536,264,143,92468473.0,92468473.0,44338,7399,2085.5,2103.4,51737,108031619.0,407,2023-11-30 18:25:00
1245,POSI,331,230,114371515.0,114371515.0,54942,10671,2081.7,2094.6,65613,136722892.0,561,281,181,113313678.0,113313678.0,54304,10357,2086.7,2106.7,64661,135132719.0,462,2023-11-30 18:30:00
1246,POSI,218,169,102384968.0,102384968.0,49104,11704,2085.1,2063.2,60808,126532229.0,387,175,128,101182110.0,101182110.0,48516,5755,2085.5,2113.2,54271,113343640.0,303,2023-11-30 18:35:00
1247,POSI,153,68,105611347.0,105611347.0,50657,6180,2084.8,2067.8,56837,118390167.0,221,166,59,106354370.0,106354370.0,51005,4710,2085.2,2107.2,55715,116279219.0,225,2023-11-30 18:40:00
0,SBER,20998,20758,8144078239.0,8804516245.0,3034802,3208945,268.36,274.37,6243747,16948594485.0,41756,20156,19953,8005862517.0,8319990825.0,2984429,3096903,268.25,268.66,6081332,16325853342.0,40109,2023-11-01 10:05:00
1,SBER,5447,5567,2460436746.0,2563631720.0,910345,943477,270.28,271.72,1853822,5024068466.0,11014,4739,5076,2268857657.0,2446761635.0,842456,899982,269.31,271.87,1742438,4715619292.0,9815,2023-11-01 10:10:00
2,SBER,3796,3806,1465362376.0,1803924738.0,544418,656104,269.16,274.94,1200522,3269287114.0,7602,3271,3333,1384166100.0,1658652673.0,515378,616627,268.57,268.99,1132005,3042818774.0,6604,2023-11-01 10:15:00
3,SBER,3811,4516,1245928807.0,2392786145.0,464148,861106,268.43,277.87,1325254,3638714953.0,8327,3147,4075,1162704821.0,2286972946.0,433351,834307,268.31,274.12,1267658,3449677768.0,7222,2023-11-01 10:20:00
4,SBER,4567,5020,2131234391.0,3031602198.0,791697,1113285,269.2,272.31,1904982,5162836589.0,9587,3694,4645,2041892672.0,2990898485.0,760027,1092179,268.66,273.85,1852206,5032791158.0,8339,2023-11-01 10:25:00
5,SBER,4815,6827,4471216545.0,4931262898.0,1635138,1823348,273.45,270.45,3458486,9402479444.0,11642,4288,6428,4425470267.0,4856660463.0,1623104,1795791,272.65,270.45,3418895,9282130730.0,10716,2023-11-01 10:30:00
6,SBER,4985,5812,2920405084.0,3603196664.0,1085714,1325770,268.98,271.78,2411484,6523601748.0,10797,4292,5380,2829992523.0,3551497390.0,1055249,1306501,268.18,271.83,2361750,6381489914.0,9672,2023-11-01 10:35:00
7,SBER,3710,5039,2196891561.0,3135450955.0,818354,1166801,268.45,268.72,1985155,5332342516.0,8749,3144,4571,2136527401.0,3085567854.0,795956,1148103,268.42,268.75,1944059,5222095255.0,7715,2023-11-01 10:40:00
8,SBER,5838,6119,2991174409.0,3945057749.0,1113955,1409268,268.52,279.94,2523223,6936232158.0,11957,5310,5642,2839688519.0,3715364021.0,1054245,1382783,269.36,268.69,2437028,6555052540.0,10952,2023-11-01 10:45:00
9,SBER,8981,7947,5302352286.0,4485489827.0,1978435,1637423,268.01,273.94,3615858,9787842114.0,16928,8437,7566,5204580027.0,4436215271.0,1942196,1627055,267.97,272.65,3569251,9640795298.0,16003,2023-11-01 10:50:00
10,SBER,8606,11980,3975715551.0,5903027574.0,1482610,2198354,268.16,268.52,3680964,9878743125.0,20586,8076,11646,3943266236.0,5867440622.0,1471207,2184727,268.03,268.57,3655934,9810706858.0,19722,2023-11-01 10:55:00
11,SBER,9027,11704,5855088700.0,7469575887.0,2181919,2786190,268.35,268.09,4968109,13324664588.0,20731,8246,11161,5903052135.0,7392533705.0,2203113,2756209,267.94,268.21,4959322,13295585840.0,19407,2023-11-01 11:00:00
12,SBER,6429,8212,3720922649.0,4563252514.0,1387997,1703473,268.08,267.88,3091470,8284175163.0,14641,5609,7728,3631777441.0,4503295044.0,1352976,1680550,268.43,267.97,3033526,8135072486.0,13337,2023-11-01 11:05:00
13,SBER,12777,13254,6807894763.0,7382578682.0,2542746,2753104,267.74,268.15,5295850,14190473446.0,26031,12131,12968,6708089526.0,7328282024.0,2505902,2732665,267.69,268.17,5238567,14036371551.0,25099,2023-11-01 11:10:00
14,SBER,9280,8421,4582100297.0,4399316652.0,1710308,1641129,267.91,268.07,3351437,8981416949.0,17701,8557,8201,4518583854.0,4363585180.0,1688255,1627486,267.65,268.12,3315741,8882169035.0,16758,2023-11-01 11:15:00
15,SBER,19558,20149,8965104420.0,9005462020.0,3346828,3357067,267.87,268.25,6703895,17970566440.0,39707,18963,19806,8925126725.0,8954315596.0,3331213,3337925,267.92,268.26,6669138,17879442322.0,38769,2023-11-01 11:20:00
16,SBER,14281,15736,7032419268.0,7925496776.0,2621108,2955306,268.3,268.18,5576414,14957916045.0,30017,13546,15558,6959985963.0,7868580037.0,2594321,2933765,268.28,268.21,5528086,14828566001.0,29104,2023-11-01 11:25:00
17,SBER,15553,15772,6577569909.0,7408761050.0,2455378,2761024,267.88,268.33,5216402,13986330960.0,31325,14886,15651,6531120874.0,7395439012.0,2438070,2755965,267.88,268.34,5194035,13926559887.0,30537,2023-11-01 11:30:00
18,SBER,9963,11836,4156991775.0,6138418264.0,1550722,2285394,268.07,268.59,3836116,10295410039.0,21799,9270,11689,4037684426.0,6107100747.0,1506274,2273891,268.06,268.57,3780165,10144785173.0,20959,2023-11-01 11:35:00
19,SBER,18662,10213,5932255942.0,5312696246.0,2208838,1966128,268.57,270.21,4174966,11244952189.0,28875,17973,9985,5896507248.0,5278743705.0,2196603,1953328,268.44,270.24,4149931,11175250953.0,27958,2023-11-01 11:40:00
20,SBER,6484,5094,2714763824.0,2706916326.0,1011106,1006690,268.49,268.89,2017796,5421680150.0,11578,5757,4960,2642538772.0,2692887482.0,984502,1001142,268.41,268.98,1985644,5335426255.0,10717,2023-11-01 11:45:00
21,SBER,8723,7716,5708362036.0,4883193623.0,2118884,1790420,269.4,272.74,3909304,10591555659.0,16439,7617,7173,5466046228.0,4739900467.0,2032331,1739459,268.95,272.49,3771790,10205946696.0,14790,2023-11-01 11:50:00
22,SBER,11842,10820,9381319143.0,4784166715.0,3481230,1753341,269.48,272.86,5234571,14165485858.0,22662,11001,10285,9249762050.0,4660150564.0,3433961,1709218,269.36,272.65,5143179,13909912614.0,21286,2023-11-01 11:55:00
23,SBER,9775,8201,5507382595.0,4810777101.0,2047061,1782992,269.04,269.81,3830053,10318159696.0,17976,8953,7965,5444210690.0,4765253430.0,2024068,1763314,268.97,270.24,3787382,10209464120.0,16918,2023-11-01 12:00:00
24,SBER,5552,4354,3030104127.0,2080359881.0,1120481,767119,270.43,271.19,1887600,5110464008.0,9906,4859,4156,2889934842.0,2027406144.0,1074139,749855,269.05,270.37,1823994,4917340987.0,9015,2023-11-01 12:05:00
25,SBER,6412,7325,2817510228.0,3989489384.0,1044728,1478280,269.69,269.87,2523008,6806999613.0,13737,5440,6982,2736940699.0,3888862376.0,1015663,1440631,269.47,269.94,2456294,6625803075.0,12422,2023-11-01 12:10:00
26,SBER,4944,5312,2313899383.0,2894063798.0,858505,1072968,269.53,269.73,1931473,5207963181.0,10256,4317,4914,2268067161.0,2822072688.0,841707,1045695,269.46,269.88,1887402,5090139850.0,9231,2023-11-01 12:15:00
27,SBER,4156,3565,2168010620.0,2381969348.0,799231,883035,271.26,269.75,1682266,4549979968.0,7721,3551,3308,2062020200.0,2428535882.0,763006,851147,270.25,285.33,1614153,4490556082.0,6859,2023-11-01 12:20:00
28,SBER,5462,5884,2998102913.0,3770544334.0,1110756,1394450,269.92,270.4,2505206,6768647248.0,11346,4946,5570,2911386174.0,3674570745.0,1078769,1362356,269.88,269.72,2441125,6585956920.0,10516,2023-11-01 12:25:00
29,SBER,7603,7876,4505716026.0,4163387703.0,1664164,1544593,270.75,269.55,3208757,8669103730.0,15479,7070,7496,4423955747.0,4093879577.0,1636906,1518631,270.26,269.58,3155537,8517835325.0,14566,2023-11-01 12:30:00
30,SBER,5505,4873,3948812270.0,1931368571.0,1449462,711966,272.43,271.27,2161428,5880180842.0,10378,5050,4613,3924559472.0,1887480063.0,1440509,695578,272.44,271.35,2136087,5812039536.0,9663,2023-11-01 12:35:00
31,SBER,14361,10723,7514810586.0,5417077442.0,2781774,2007808,270.14,269.8,4789582,12931888029.0,25084,13805,10286,7318937261.0,5310970960.0,2707178,1968475,270.35,269.8,4675653,12629908222.0,24091,2023-11-01 12:40:00
32,SBER,4886,3262,2225870410.0,1578485539.0,819552,577247,271.6,273.45,1396799,3804355949.0,8148,3453,2707,2058680601.0,1468942337.0,760943,540987,270.54,271.53,1301930,3527622939.0,6160,2023-11-01 12:45:00
33,SBER,31740,16910,28553386462.0,6694889494.0,10576445,2448400,269.97,273.44,13024845,35248275956.0,48650,31125,16283,28475941348.0,6584081946.0,10547317,2411667,269.98,273.01,12958984,35060023294.0,47408,2023-11-01 12:50:00
34,SBER,9066,7249,4720367415.0,3576622625.0,1748995,1320821,269.89,270.79,3069816,8296990040.0,16315,8243,6801,4663057500.0,3516195537.0,1728103,1298196,269.84,270.85,3026299,8179253037.0,15044,2023-11-01 12:55:00
35,SBER,6344,6486,4069597705.0,3444442704.0,1508135,1274634,269.84,270.23,2782769,7514040410.0,12830,5763,5823,4024394252.0,3335730719.0,1491709,1231774,269.78,270.81,2723483,7360124971.0,11586,2023-11-01 13:00:00
36,SBER,6834,6397,3000349028.0,2715464388.0,1112331,1001452,269.74,271.15,2113783,5715813416.0,13231,6233,5840,2958201101.0,2627675721.0,1096943,968562,269.68,271.3,2065505,5585876822.0,12073,2023-11-01 13:05:00
37,SBER,3711,2738,2353808912.0,1745200899.0,873188,627684,269.56,278.04,1500872,4099009811.0,6449,3229,2336,2242716006.0,1659187572.0,832178,614062,269.5,270.2,1446240,3901903579.0,5565,2023-11-01 13:10:00
38,SBER,15999,18312,7109574080.0,7142520863.0,2637243,2647537,269.58,269.78,5284780,14252094943.0,34311,15431,17736,7050966641.0,7074025580.0,2615823,2621323,269.55,269.86,5237146,14124992222.0,33167,2023-11-01 13:15:00
39,SBER,2295,2216,1241060448.0,1356000416.0,460422,494870,269.55,274.01,955292,2597060865.0,4511,1783,2018,1197596962.0,1092550438.0,444631,404621,269.35,270.02,849252,2290147401.0,3801,2023-11-01 13:20:00
40,SBER,10603,5365,5522859621.0,2674575177.0,2047869,990314,269.69,270.07,3038183,8197434799.0,15968,10028,5129,5471736581.0,2666716948.0,2029166,987150,269.65,270.14,3016316,8138453529.0,15157,2023-11-01 13:25:00
41,SBER,6765,9935,6350181621.0,3184765174.0,2352190,1178778,269.97,270.18,3530968,9534946796.0,16700,6127,9770,6283632410.0,3144320959.0,2327847,1163392,269.93,270.27,3491239,9427953369.0,15897,2023-11-01 13:30:00
42,SBER,2676,1939,1455189251.0,1519908265.0,539170,528671,269.89,287.5,1067841,2975097517.0,4615,2044,1727,1417188009.0,1116969262.0,525325,396456,269.77,281.74,921781,2534157271.0,3771,2023-11-01 13:35:00
43,SBER,2807,6952,1341722181.0,4041983374.0,494938,1454666,271.09,277.86,1949604,5383705556.0,9759,2175,6609,1287559498.0,3957326964.0,475075,1432140,271.02,276.32,1907215,5244886463.0,8784,2023-11-01 13:40:00
44,SBER,8203,3324,5022271317.0,1680709375.0,1862602,622470,269.64,270.01,2485072,6702980692.0,11527,7612,3133,4980993027.0,1640104059.0,1847596,607261,269.59,270.08,2454857,6621097086.0,10745,2023-11-01 13:45:00
45,SBER,5135,7652,1904618701.0,2891167884.0,706460,1070733,269.6,270.02,1777193,4795786586.0,12787,4575,7517,1890331361.0,2871294723.0,701331,1063291,269.53,270.04,1764622,4761626084.0,12092,2023-11-01 13:50:00
46,SBER,3250,3925,1545237885.0,1639499918.0,573111,607182,269.62,270.02,1180293,3184737803.0,7175,2682,3792,1526676749.0,1595131679.0,566419,590610,269.53,270.08,1157029,3121808429.0,6474,2023-11-01 13:55:00
47,SBER,7783,4457,3895103388.0,2449328244.0,1444250,906857,269.7,270.09,2351107,6344431632.0,12240,7492,4333,3860041053.0,2427993297.0,1431353,898911,269.68,270.1,2330264,6288034350.0,11825,2023-11-01 14:00:00
48,SBER,1027,725,825398462.0,733694821.0,306364,271480,269.42,270.26,577844,1559093283.0,1752,723,565,789764610.0,704622213.0,293216,260538,269.35,270.45,553754,1494386823.0,1288,2023-11-01 14:05:00
49,SBER,1776,1800,1868801648.0,1413494432.0,693309,523295,269.55,270.11,1216604,3282296080.0,3576,1419,1638,1855122423.0,1355147470.0,688305,501605,269.52,270.16,1189910,3210269893.0,3057,2023-11-01 14:10:00
50,SBER,2328,2494,2096055599.0,2250819217.0,778217,833424,269.34,270.07,1611641,4346874817.0,4822,1947,2346,2071324992.0,2229146839.0,769074,824922,269.33,270.23,1593996,4300471832.0,4293,2023-11-01 14:15:00
51,SBER,1409,1288,983621256.0,1235427767.0,363901,457246,270.3,270.19,821147,2219049023.0,2697,1199,1178,953465019.0,1182886506.0,353952,437638,269.38,270.29,791590,2136351526.0,2377,2023-11-01 14:20:00
52,SBER,1699,2159,1323657725.0,1699130475.0,491329,628882,269.4,270.18,1120211,3022788201.0,3858,1533,2007,1311913218.0,1669717184.0,487070,617925,269.35,270.21,1104995,2981630403.0,3540,2023-11-01 14:25:00
53,SBER,2269,1460,1164405344.0,1067520395.0,431566,395140,269.81,270.16,826706,2231925740.0,3729,2070,1353,1123746545.0,1055874818.0,416968,390709,269.5,270.25,807677,2179621363.0,3423,2023-11-01 14:30:00
54,SBER,1313,1271,925565452.0,910636552.0,343104,336987,269.76,270.23,680091,1836202004.0,2584,1129,1131,908602254.0,881408973.0,336995,326096,269.62,270.29,663091,1790011228.0,2260,2023-11-01 14:35:00
55,SBER,2842,3205,1516767261.0,2168237006.0,562894,803062,269.46,270.0,1365956,3685004267.0,6047,2653,3064,1501768921.0,2150450856.0,557440,796252,269.4,270.07,1353692,3652219778.0,5717,2023-11-01 14:40:00
56,SBER,4869,6828,2524911871.0,3580291756.0,937296,1327200,269.38,269.76,2264496,6105203628.0,11697,4699,6751,2476187952.0,3554650626.0,919418,1317208,269.32,269.86,2236626,6030838578.0,11450,2023-11-01 14:45:00
57,SBER,4945,6743,2076316287.0,3013031093.0,770841,1116956,269.36,269.75,1887797,5089347380.0,11688,4745,6288,2063083480.0,2990419734.0,766043,1108270,269.32,269.83,1874313,5053503214.0,11033,2023-11-01 14:50:00
58,SBER,6677,7728,2420917513.0,3523448386.0,899195,1305954,269.23,269.8,2205149,5944365900.0,14405,6016,7651,2389428695.0,3518649846.0,887325,1304147,269.28,269.8,2191472,5908078541.0,13667,2023-11-01 14:55:00
59,SBER,4135,6143,1851630279.0,3121894942.0,687621,1157018,269.28,269.82,1844639,4973525221.0,10278,4516,5827,1847091295.0,3110151667.0,686214,1152641,269.17,269.83,1838855,4957242962.0,10343,2023-11-01 15:00:00
60,SBER,3374,5483,1900915956.0,3379988727.0,706140,1253288,269.2,269.69,1959428,5280904684.0,8857,3232,5359,1896561676.0,3369168478.0,704548,1249065,269.19,269.74,1953613,5265730154.0,8591,2023-11-01 15:05:00
61,SBER,3484,4022,1759131838.0,2409344100.0,653896,894221,269.02,269.43,1548117,4168475939.0,7506,3197,3843,1735911855.0,2370535295.0,645993,879349,268.72,269.58,1525342,4106447151.0,7040,2023-11-01 15:10:00
62,SBER,3461,3933,1787314631.0,2227807895.0,664582,826562,268.94,269.53,1491144,4015122527.0,7394,3279,3821,1779986639.0,2207014092.0,661890,818570,268.92,269.62,1480460,3987000732.0,7100,2023-11-01 15:15:00
63,SBER,4376,5952,2165132430.0,3088224008.0,805110,1146060,268.92,269.46,1951170,5253356439.0,10328,4096,5803,2136407014.0,3086037059.0,794634,1145016,268.85,269.52,1939650,5222444073.0,9899,2023-11-01 15:20:00
64,SBER,4275,4879,1808154726.0,2225194809.0,671883,825274,269.12,269.63,1497157,4033349535.0,9154,4137,4775,1775276208.0,2208938860.0,659732,819138,269.09,269.67,1478870,3984215069.0,8912,2023-11-01 15:25:00
65,SBER,5266,7158,2810866652.0,4137073387.0,1043854,1532799,269.28,269.9,2576653,6947940039.0,12424,5125,7051,2791080805.0,4116555147.0,1036815,1525188,269.2,269.9,2562003,6907635952.0,12176,2023-11-01 15:30:00
66,SBER,2121,1929,1115164788.0,1070082865.0,413926,396721,269.41,269.73,810647,2185247654.0,4050,1898,1848,1081535391.0,1054773094.0,401537,390621,269.35,270.02,792158,2136308485.0,3746,2023-11-01 15:35:00
67,SBER,3375,5435,1498372452.0,3041551854.0,555859,1126364,269.56,270.03,1682223,4539924306.0,8810,3164,5264,1452964647.0,3030027539.0,539182,1122066,269.48,270.04,1661248,4482992186.0,8428,2023-11-01 15:40:00
68,SBER,3458,5459,1694448596.0,2838831513.0,628966,1051681,269.4,269.93,1680647,4533280109.0,8917,3311,5344,1682802303.0,2826026862.0,624684,1046690,269.38,270.0,1671374,4508829165.0,8655,2023-11-01 15:45:00
69,SBER,4660,5994,2192523993.0,3251865005.0,813022,1204046,269.68,270.08,2017068,5444388999.0,10654,4474,5851,2148683081.0,3223101690.0,797045,1193332,269.58,270.09,1990377,5371784772.0,10325,2023-11-01 15:50:00
70,SBER,2218,2494,1156800874.0,1376557536.0,429291,509713,269.47,270.07,939004,2533358411.0,4712,2079,2368,1152780339.0,1360416558.0,427925,503664,269.39,270.1,931589,2513196897.0,4447,2023-11-01 15:55:00
71,SBER,1995,7907,999024384.0,3939853210.0,370766,1460465,269.45,269.77,1831231,4938877594.0,9902,1872,7807,973420129.0,3926663828.0,361365,1455454,269.37,269.79,1816819,4900083958.0,9679,2023-11-01 16:00:00
72,SBER,3275,3208,1552150028.0,1413117491.0,575899,523284,269.52,270.05,1099183,2965267519.0,6483,3150,3120,1542630011.0,1404631923.0,572454,520062,269.48,270.09,1092516,2947261935.0,6270,2023-11-01 16:05:00
73,SBER,1832,1776,839924317.0,889770482.0,311755,330533,269.42,269.19,642288,1729694800.0,3608,1691,1717,792567669.0,865297849.0,294178,320367,269.42,270.1,614545,1657865519.0,3408,2023-11-01 16:10:00
74,SBER,3662,2862,1981742120.0,1579113833.0,735448,585340,269.46,269.78,1320788,3560855953.0,6524,3521,2786,1971710756.0,1570702044.0,731884,577095,269.4,272.17,1308979,3542412800.0,6307,2023-11-01 16:15:00
75,SBER,2167,2879,1010801543.0,1480131504.0,375384,548578,269.27,269.81,923962,2490933048.0,5046,2044,2788,1005423251.0,1459565252.0,373451,540768,269.22,269.91,914219,2464988504.0,4832,2023-11-01 16:20:00
76,SBER,1344,1471,636233278.0,804403013.0,236401,298348,269.13,269.62,534749,1440636291.0,2815,1198,1370,627602836.0,786115809.0,233228,291364,269.09,269.81,524592,1413718645.0,2568,2023-11-01 16:25:00
77,SBER,7870,10730,2706691099.0,5504997401.0,1005486,2042182,269.19,269.56,3047668,8211688500.0,18600,7693,10621,2683468349.0,5472981309.0,996935,2030412,269.17,269.55,3027347,8156449659.0,18314,2023-11-01 16:30:00
78,SBER,1850,1408,1119094129.0,958723480.0,415587,355229,269.28,269.89,770816,2077817609.0,3258,1693,1335,1095151061.0,944966406.0,406901,349747,269.14,270.19,756648,2040117467.0,3028,2023-11-01 16:35:00
79,SBER,2455,2893,977866041.0,1351822444.0,363399,501400,269.09,269.61,864799,2329688485.0,5348,2327,2824,963501858.0,1344105660.0,358055,498407,269.09,269.68,856462,2307607518.0,5151,2023-11-01 16:40:00
80,SBER,5381,7318,1863798933.0,4111448525.0,692398,1526183,269.18,269.39,2218581,5975247458.0,12699,5252,7244,1831753503.0,4089815297.0,680642,1518034,269.12,269.42,2198676,5921568801.0,12496,2023-11-01 16:45:00
81,SBER,5034,5195,1870673466.0,3256344810.0,695300,1204017,269.05,270.46,1899317,5127018276.0,10229,4895,5175,1836055587.0,3248641808.0,682451,1205871,269.04,269.4,1888322,5084697396.0,10070,2023-11-01 16:50:00
82,SBER,1464,843,723877563.0,489672631.0,268901,181515,269.2,269.77,450416,1213550195.0,2307,1186,793,698447097.0,496408518.0,259619,183995,269.03,269.79,443614,1194855616.0,1979,2023-11-01 16:55:00
83,SBER,7271,8525,3093078937.0,5564157221.0,1140156,2062444,271.29,269.78,3202600,8657236158.0,15796,7141,8343,3061956566.0,5492879770.0,1134393,2036034,269.92,269.78,3170427,8554836336.0,15484,2023-11-01 17:00:00
84,SBER,21956,33111,7582007062.0,19634129408.0,2814199,7277185,269.42,269.8,10091384,27216136470.0,55067,21637,32955,7564148986.0,19619042543.0,2807689,7271201,269.41,269.82,10078890,27183191529.0,54592,2023-11-01 17:05:00
85,SBER,1618,1668,871817884.0,1064877098.0,323654,394990,269.37,269.6,718644,1936694983.0,3286,1445,1563,834555918.0,1022122556.0,309928,378606,269.27,269.97,688534,1856678475.0,3008,2023-11-01 17:10:00
86,SBER,6154,13879,1570521632.0,3745876757.0,580035,1388474,270.76,269.78,1968509,5316398390.0,20033,5874,13757,1563608951.0,3731231166.0,578681,1382962,270.2,269.8,1961643,5294840118.0,19631,2023-11-01 17:15:00
87,SBER,1270,1511,745997831.0,1199229547.0,232471,444206,320.9,269.97,676677,1945227378.0,2781,1176,1396,763754026.0,1165536877.0,244168,431682,312.8,270.0,675850,1929290904.0,2572,2023-11-01 17:20:00
88,SBER,3513,4452,1661360098.0,2384081000.0,606717,883473,273.83,269.85,1490190,4045441099.0,7965,3395,4322,1653324624.0,2359557325.0,605232,874539,273.17,269.81,1479771,4012881949.0,7717,2023-11-01 17:25:00
89,SBER,3896,4635,1800774409.0,1931426876.0,667597,716029,269.74,269.74,1383626,3732201285.0,8531,3758,4498,1752382211.0,1908518413.0,649821,707261,269.67,269.85,1357082,3660900625.0,8256,2023-11-01 17:30:00
90,SBER,1425,1252,671103029.0,593510221.0,243218,219970,275.93,269.81,463188,1264613251.0,2677,1302,1162,673040391.0,590222475.0,241746,218674,278.41,269.91,460420,1263262866.0,2464,2023-11-01 17:35:00
91,SBER,1045,947,561067385.0,514701449.0,208246,190697,269.43,269.91,398943,1075768835.0,1992,926,854,555355443.0,497526704.0,206199,184293,269.33,269.97,390492,1052882148.0,1780,2023-11-01 17:40:00
92,SBER,1775,1747,610769869.0,555771518.0,226318,205995,269.87,269.8,432313,1166541387.0,3522,1632,1675,597642737.0,557204662.0,221528,206486,269.78,269.85,428014,1154847399.0,3307,2023-11-01 17:45:00
93,SBER,1900,1381,768950846.0,543734757.0,285417,188487,269.41,288.47,473904,1312685603.0,3281,1689,1295,746773729.0,497999068.0,277378,184470,269.23,269.96,461848,1244772797.0,2984,2023-11-01 17:50:00
94,SBER,4712,5893,1853742836.0,2637525374.0,688677,974771,269.17,270.58,1663448,4491268210.0,10605,4599,5847,1843717264.0,2629683903.0,684974,971831,269.17,270.59,1656805,4473401167.0,10446,2023-11-01 17:55:00
95,SBER,2005,2259,681400478.0,941417490.0,253122,349047,269.2,269.71,602169,1622817969.0,4264,1889,2206,661065646.0,931938962.0,245592,345483,269.17,269.75,591075,1593004608.0,4095,2023-11-01 18:00:00
96,SBER,9640,10286,3622589573.0,6083732506.0,1343600,2258162,269.62,269.41,3601762,9706322079.0,19926,9451,9975,3572228834.0,6043806459.0,1325179,2243268,269.57,269.42,3568447,9616035293.0,19426,2023-11-01 18:05:00
97,SBER,1109,832,453667106.0,330191491.0,168765,122436,268.82,269.68,291201,783858597.0,1941,945,783,427027630.0,325495575.0,158881,120691,268.77,269.69,279572,752523206.0,1728,2023-11-01 18:10:00
98,SBER,3886,3090,1847849442.0,1078020996.0,686369,399949,269.22,269.54,1086318,2925870438.0,6976,3776,3001,1833546316.0,1048647030.0,681096,388901,269.21,269.64,1069997,2882193347.0,6777,2023-11-01 18:15:00
99,SBER,1250,976,534907808.0,493426288.0,198808,149165,269.06,330.79,347973,1028334097.0,2226,1123,908,548246539.0,358899439.0,203927,133099,268.84,269.65,337026,907145979.0,2031,2023-11-01 18:20:00
100,SBER,2499,2001,1177268414.0,1033691304.0,437266,315716,269.23,327.41,752982,2210959718.0,4500,2364,1931,1193951894.0,1033674494.0,443904,308502,268.97,335.06,752406,2227626389.0,4295,2023-11-01 18:25:00
101,SBER,13240,27971,3097674858.0,9159597828.0,1150762,3399649,269.18,269.43,4550411,12257272687.0,41211,13119,27896,3069557617.0,9153429925.0,1140293,3397185,269.19,269.44,4537478,12222987543.0,41015,2023-11-01 18:30:00
102,SBER,874,861,487421912.0,485271557.0,180943,148995,269.38,325.7,329938,972693469.0,1735,731,777,391291026.0,458167214.0,145459,138811,269.0,330.07,284270,849458240.0,1508,2023-11-01 18:35:00
103,SBER,1226,1085,546537353.0,560254751.0,202379,207793,270.06,269.62,410172,1106792104.0,2311,1114,1044,504847175.0,558950657.0,187667,207287,269.01,269.65,394954,1063797833.0,2158,2023-11-01 18:40:00
104,SBER,19258,21775,10433680193.0,10148930801.0,3833216,3626702,272.19,279.84,7459918,20582610995.0,41033,16757,19684,9800542462.0,9058761879.0,3627586,3319328,270.17,272.91,6946914,18859304342.0,36441,2023-11-02 10:05:00
105,SBER,5007,9472,1731032183.0,4286216024.0,639827,1586834,270.55,270.11,2226661,6017248207.0,14479,3998,8616,1504938207.0,3920270241.0,557754,1451173,269.82,270.14,2008927,5425208449.0,12614,2023-11-02 10:10:00
106,SBER,16457,13259,5195178190.0,4676420934.0,1921759,1682135,270.33,278.01,3603894,9871599125.0,29716,15543,12455,5008782301.0,4552755375.0,1855216,1644673,269.98,276.82,3499889,9561537676.0,27998,2023-11-02 10:15:00
107,SBER,3275,3909,1419589039.0,1552087751.0,525155,563917,270.32,275.23,1089072,2971676790.0,7184,2630,3313,1326271801.0,1360228173.0,489776,492818,270.79,276.01,982594,2686499975.0,5943,2023-11-02 10:20:00
108,SBER,11896,15013,4862902247.0,7648385206.0,1801743,2806644,269.9,272.51,4608387,12511287454.0,26909,10347,14407,4731395061.0,7405545618.0,1753768,2740899,269.78,270.19,4494667,12136940680.0,24754,2023-11-02 10:25:00
109,SBER,4475,6630,2164422516.0,3550119319.0,781761,1295142,276.86,274.11,2076903,5714541835.0,11105,3948,6142,2034296656.0,3426455855.0,739986,1246904,274.91,274.8,1986890,5460752512.0,10090,2023-11-02 10:30:00
110,SBER,7592,7662,3242124796.0,3721105700.0,1201066,1376765,269.94,270.28,2577831,6963230496.0,15254,6258,7169,3136138893.0,3629143782.0,1162484,1342402,269.78,270.35,2504886,6765282675.0,13427,2023-11-02 10:35:00
111,SBER,4890,5616,2083241523.0,3166189859.0,771252,1171292,270.11,270.32,1942544,5249431382.0,10506,4588,5042,2028831498.0,3077422928.0,751850,1138221,269.85,270.37,1890071,5106254426.0,9630,2023-11-02 10:40:00
112,SBER,6554,6782,3788759601.0,3705745670.0,1396564,1371334,271.29,270.23,2767898,7494505272.0,13336,6217,6374,3735778879.0,3567108129.0,1379152,1319935,270.88,270.25,2699087,7302887009.0,12591,2023-11-02 10:45:00
113,SBER,3415,3506,1691210841.0,2160142688.0,625799,773281,270.25,279.35,1399080,3851353530.0,6921,2932,3008,1596270746.0,2043855505.0,591476,727741,269.88,280.85,1319217,3640126252.0,5940,2023-11-02 10:50:00
114,SBER,7285,7124,3939480509.0,4003356490.0,1457294,1481530,270.33,270.22,2938824,7942836999.0,14409,6891,6592,3740905931.0,3872569156.0,1386406,1432804,269.83,270.28,2819210,7613475087.0,13483,2023-11-02 10:55:00
115,SBER,6218,5710,3143543794.0,3503081374.0,1165545,1260202,269.71,277.98,2425747,6646625169.0,11928,5372,5228,3075893249.0,3449545177.0,1140377,1232602,269.73,279.86,2372979,6525438427.0,10600,2023-11-02 11:00:00
116,SBER,8318,8972,4557125050.0,5441075642.0,1692309,1964377,269.28,276.99,3656686,9998200693.0,17290,7496,8125,4327992371.0,5207787733.0,1608229,1885667,269.12,276.18,3493896,9535780104.0,15621,2023-11-02 11:05:00
117,SBER,5754,6126,3210184881.0,3907193400.0,1192901,1406243,269.11,277.85,2599144,7117378281.0,11880,4972,5495,3028985101.0,3810920101.0,1126750,1372954,268.82,277.57,2499704,6839905203.0,10467,2023-11-02 11:10:00
118,SBER,3912,3360,2012103311.0,1965149683.0,748281,729304,268.9,269.46,1477585,3977252994.0,7272,3326,3104,1923153337.0,1888542528.0,715416,700539,268.82,269.58,1415955,3811695865.0,6430,2023-11-02 11:15:00
119,SBER,20187,11004,8341192920.0,5790757756.0,3094751,2135950,269.53,271.11,5230701,14131950676.0,31191,19632,10574,8255628935.0,5685827235.0,3064066,2106485,269.43,269.92,5170551,13941456170.0,30206,2023-11-02 11:20:00
120,SBER,3460,3158,1884110286.0,1538292098.0,698333,569944,269.8,269.9,1268277,3422402384.0,6618,3452,2898,1824279918.0,1494639638.0,677106,543367,269.42,275.07,1220473,3318919556.0,6350,2023-11-02 11:25:00
121,SBER,7150,9648,2708157441.0,10550234836.0,1005859,3887507,269.24,271.39,4893366,13258392277.0,16798,6544,9473,2663336454.0,10502419330.0,989245,3881779,269.23,270.56,4871024,13165755784.0,16017,2023-11-02 11:30:00
122,SBER,3876,3554,1612338307.0,2863515356.0,598916,1061847,269.21,269.67,1660763,4475853664.0,7430,3424,3399,1611771575.0,2833472508.0,598884,1050452,269.13,269.74,1649336,4445244083.0,6823,2023-11-02 11:35:00
123,SBER,12347,9533,4182597101.0,5290423517.0,1552565,1960409,269.4,269.86,3512974,9473020619.0,21880,11875,9398,4060307473.0,5269477369.0,1506544,1952612,269.51,269.87,3459156,9329784842.0,21273,2023-11-02 11:40:00
124,SBER,4294,4669,1911137318.0,3263003013.0,700861,1209073,272.68,269.88,1909934,5174140332.0,8963,3814,4433,1797521418.0,3196739417.0,667007,1184071,269.49,269.98,1851078,4994260836.0,8247,2023-11-02 11:45:00
125,SBER,7581,7981,3933563167.0,4470957120.0,1452872,1655210,270.74,270.11,3108082,8404520287.0,15562,6929,7826,3888001608.0,4428014379.0,1436662,1639130,270.63,270.14,3075792,8316015988.0,14755,2023-11-02 11:50:00
126,SBER,6252,1970,3242697960.0,1170234551.0,1201623,433077,269.86,270.21,1634700,4412932512.0,8222,5744,1817,3209672446.0,1146890359.0,1189692,416855,269.79,275.13,1606547,4356562805.0,7561,2023-11-02 11:55:00
127,SBER,5777,4638,3403443661.0,2882545826.0,1245895,1066049,273.17,270.4,2311944,6285989487.0,10415,5168,4407,3323539962.0,2843847924.0,1226722,1051578,270.93,270.44,2278300,6167387887.0,9575,2023-11-02 12:00:00
128,SBER,2736,2051,1409627257.0,1339727209.0,515894,495751,273.24,270.24,1011645,2749354466.0,4787,1938,1805,1324729964.0,1279181763.0,483354,472917,274.07,270.49,956271,2603911727.0,3743,2023-11-02 12:05:00
129,SBER,5003,2325,2903631833.0,1960382362.0,1066671,699291,272.21,280.34,1765962,4864014195.0,7328,4332,2081,2819954939.0,1973195953.0,1034999,703530,272.46,280.47,1738529,4793150892.0,6413,2023-11-02 12:10:00
130,SBER,4297,2328,2559392974.0,1346313781.0,948266,498072,269.9,270.31,1446338,3905706755.0,6625,3944,2108,2535050973.0,1330892420.0,939598,492165,269.8,270.42,1431763,3865943393.0,6052,2023-11-02 12:15:00
131,SBER,14478,8781,7726917255.0,4299278387.0,2863905,1590087,269.8,270.38,4453992,12026195642.0,23259,14060,8557,7709824879.0,4253273471.0,2857797,1572956,269.78,270.4,4430753,11963098350.0,22617,2023-11-02 12:20:00
132,SBER,7300,3460,3610956592.0,1878505986.0,1338230,694754,269.83,270.38,2032984,5489462579.0,10760,6931,3137,3680127406.0,1866303476.0,1364253,690151,269.75,270.42,2054404,5546430882.0,10068,2023-11-02 12:25:00
133,SBER,11546,7325,5564796321.0,2988292202.0,2061551,1105169,269.93,270.39,3166720,8553088524.0,18871,11169,7024,5537599906.0,2995011657.0,2051812,1107611,269.89,270.4,3159423,8532611563.0,18193,2023-11-02 12:30:00
134,SBER,2357,2122,1160489239.0,1349994254.0,429869,499424,269.96,270.31,929293,2510483494.0,4479,2065,1825,1146316608.0,1286231633.0,424755,475653,269.88,270.41,900408,2432548241.0,3890,2023-11-02 12:35:00
135,SBER,2991,2315,1619612215.0,1483321903.0,600015,548736,269.93,270.32,1148751,3102934118.0,5306,2696,2034,1607029700.0,1468484777.0,595445,543118,269.89,270.38,1138563,3075514478.0,4730,2023-11-02 12:40:00
136,SBER,2474,2627,1206971764.0,2307406111.0,447382,853818,269.79,270.25,1301200,3514377876.0,5101,2206,2306,1161521805.0,2274631531.0,430709,841574,269.68,270.28,1272283,3436153337.0,4512,2023-11-02 12:45:00
137,SBER,1902,1890,1093648498.0,1184657814.0,405386,438440,269.78,270.2,843826,2278306313.0,3792,1605,1638,1067110691.0,1175124087.0,395713,434816,269.67,270.26,830529,2242234778.0,3243,2023-11-02 12:50:00
138,SBER,7368,6997,2765686667.0,4966306852.0,1025312,1835118,269.74,270.63,2860430,7731993519.0,14365,7077,6681,2740724172.0,4943194588.0,1016139,1829709,269.72,270.16,2845848,7683918760.0,13758,2023-11-02 12:55:00
139,SBER,2608,2165,1421572028.0,1554031288.0,527373,563519,269.56,275.77,1090892,2975603316.0,4773,2300,1913,1349387483.0,1469678553.0,500585,540516,269.56,271.9,1041101,2819066037.0,4213,2023-11-02 13:00:00
140,SBER,851,770,471550229.0,459160016.0,174777,169918,269.8,270.22,344695,930710245.0,1621,622,527,451152404.0,447809227.0,167382,165703,269.53,270.25,333085,898961631.0,1149,2023-11-02 13:05:00
141,SBER,976,748,488270619.0,468058353.0,180902,173237,269.91,270.18,354139,956328973.0,1724,735,451,476856667.0,452766929.0,176899,167522,269.56,270.27,344421,929623597.0,1186,2023-11-02 13:10:00
142,SBER,2395,1509,1536927828.0,1016437621.0,569780,376439,269.74,270.01,946219,2553365450.0,3904,2109,1280,1525564349.0,997532772.0,565711,369292,269.67,270.12,935003,2523097121.0,3389,2023-11-02 13:15:00
143,SBER,1337,1016,632485761.0,700197910.0,234469,258951,269.75,270.4,493420,1332683671.0,2353,1022,862,623669391.0,657482329.0,231342,243342,269.59,270.19,474684,1281151721.0,1884,2023-11-02 13:20:00
144,SBER,952,585,341460232.0,435979198.0,126578,161366,269.76,270.18,287944,777439430.0,1537,584,532,337354427.0,429765262.0,125151,159028,269.56,270.25,284179,767119689.0,1116,2023-11-02 13:25:00
145,SBER,5894,8774,2921350569.0,2638968523.0,1082159,976982,269.96,270.11,2059141,5560319093.0,14668,5491,8681,2861715652.0,2633431922.0,1060557,974838,269.83,270.14,2035395,5495147575.0,14172,2023-11-02 13:30:00
146,SBER,1857,807,974299367.0,666827465.0,361036,246677,269.86,270.32,607713,1641126832.0,2664,1439,748,951677952.0,656993725.0,352886,243028,269.68,270.34,595914,1608671678.0,2187,2023-11-02 13:35:00
147,SBER,10547,5534,4267494972.0,4120420886.0,1579748,1523978,270.14,270.37,3103726,8387915859.0,16081,10101,5354,4191894505.0,4056274842.0,1553357,1500210,269.86,270.38,3053567,8248169348.0,15455,2023-11-02 13:40:00
148,SBER,12280,9858,5717463518.0,6685929266.0,2112971,2462152,270.59,271.55,4575123,12403392785.0,22138,11515,9563,5527413626.0,6559194925.0,2044325,2424845,270.38,270.5,4469170,12086608552.0,21078,2023-11-02 13:45:00
149,SBER,5749,7850,2767829777.0,5892280697.0,1024594,2168116,270.14,271.77,3192710,8660110475.0,13599,5348,7581,2695647603.0,5829005161.0,998149,2144620,270.06,271.8,3142769,8524652764.0,12929,2023-11-02 13:50:00
150,SBER,4773,6381,2104811502.0,5113902490.0,779127,1890651,270.15,270.48,2669778,7218713993.0,11154,4348,6210,2062133261.0,5087343287.0,763935,1880748,269.94,270.5,2644683,7149476549.0,10558,2023-11-02 13:55:00
151,SBER,4335,2791,2577448655.0,2446694884.0,952874,903897,270.49,270.68,1856771,5024143540.0,7126,3925,2669,2516854017.0,2408750325.0,931485,889841,270.2,270.69,1821326,4925604342.0,6594,2023-11-02 14:00:00
152,SBER,877,525,560661779.0,678584351.0,207421,250684,270.3,270.69,458105,1239246130.0,1402,531,395,503843260.0,637174347.0,186658,235272,269.93,270.82,421930,1141017607.0,926,2023-11-02 14:05:00
153,SBER,2559,1652,1327258209.0,1516817004.0,491200,560413,270.21,270.66,1051613,2844075214.0,4211,2020,1482,1224555902.0,1465099972.0,453546,541194,270.0,270.72,994740,2689655875.0,3502,2023-11-02 14:10:00
154,SBER,2306,2804,1821604404.0,3128644195.0,674380,1156251,270.12,270.59,1830631,4950248599.0,5110,1978,2665,1810551806.0,3073018178.0,670398,1135683,270.07,270.59,1806081,4883569985.0,4643,2023-11-02 14:15:00
155,SBER,1365,2763,748892721.0,1681993279.0,277361,621875,270.01,270.47,899236,2430886001.0,4128,1211,2682,732358866.0,1676074323.0,271276,619602,269.97,270.51,890878,2408433190.0,3893,2023-11-02 14:20:00
156,SBER,11569,11639,3949259051.0,11371398052.0,1462174,4205494,270.1,270.39,5667668,15320657103.0,23208,11414,11567,3925343927.0,11353575325.0,1453373,4198748,270.09,270.4,5652121,15278919253.0,22981,2023-11-02 14:25:00
157,SBER,1956,4135,1055165235.0,3532893561.0,391055,1302197,269.83,271.3,1693252,4588058796.0,6091,1634,4038,1015173195.0,3490235415.0,376261,1291169,269.81,270.32,1667430,4505408610.0,5672,2023-11-02 14:30:00
158,SBER,8336,6054,4004792864.0,1792781550.0,1482855,662986,270.07,270.41,2145841,5797574414.0,14390,8151,5980,4001889207.0,1789130163.0,1481837,661596,270.06,270.43,2143433,5791019371.0,14131,2023-11-02 14:35:00
159,SBER,3938,3362,2078018723.0,2132932424.0,769214,787490,270.15,270.85,1556704,4210951147.0,7300,3635,3221,2057757096.0,2110000199.0,761999,778984,270.05,270.87,1540983,4167757296.0,6856,2023-11-02 14:40:00
160,SBER,1401,1359,680174004.0,811293719.0,251670,299844,270.26,270.57,551514,1491467724.0,2760,1140,1276,650713471.0,798894611.0,240923,295197,270.09,270.63,536120,1449608082.0,2416,2023-11-02 14:45:00
161,SBER,1813,1313,503692725.0,1770982216.0,186437,654421,270.17,270.62,840858,2274674942.0,3126,1640,1222,505148799.0,1756579975.0,187057,649075,270.05,270.63,836132,2261728774.0,2862,2023-11-02 14:50:00
162,SBER,2870,3366,1223515258.0,3155531874.0,453344,1152539,269.89,273.79,1605883,4379047133.0,6236,2685,3306,1210271236.0,3100332703.0,448472,1146442,269.87,270.43,1594914,4310603939.0,5991,2023-11-02 14:55:00
163,SBER,2694,2155,1326140107.0,1801079180.0,491079,665704,270.05,270.55,1156783,3127219287.0,4849,2482,2078,1333666995.0,1738763478.0,494116,642627,269.91,270.57,1136743,3072430473.0,4560,2023-11-02 15:00:00
164,SBER,2086,1017,1278781981.0,810475650.0,473565,299555,270.03,270.56,773120,2089257631.0,3103,1885,928,1242712593.0,803954155.0,460213,297100,270.03,270.6,757313,2046666748.0,2813,2023-11-02 15:05:00
165,SBER,2301,1677,1061093524.0,1901769519.0,392626,703056,270.26,270.5,1095682,2962863043.0,3978,2154,1586,1048168841.0,1885196514.0,388230,696906,269.99,270.51,1085136,2933365355.0,3740,2023-11-02 15:10:00
166,SBER,3590,5377,1819038564.0,4255448339.0,673294,1573337,270.17,270.47,2246631,6074486904.0,8967,3361,5316,1795966750.0,4239236143.0,664882,1567255,270.12,270.49,2232137,6035202894.0,8677,2023-11-02 15:15:00
167,SBER,2237,1876,1132811306.0,1594838440.0,419583,589326,269.99,270.62,1008909,2727649747.0,4113,2023,1771,1103942072.0,1581169792.0,409067,584048,269.87,270.73,993115,2685111865.0,3794,2023-11-02 15:20:00
168,SBER,1038,874,526007585.0,609039371.0,195036,225058,269.7,270.61,420094,1135046957.0,1912,883,807,516435482.0,605489073.0,191540,223694,269.62,270.68,415234,1121924555.0,1690,2023-11-02 15:25:00
169,SBER,971,3277,536584188.0,1847866874.0,198721,683433,270.02,270.38,882154,2384451062.0,4248,819,3186,530203867.0,1884795564.0,196434,696925,269.91,270.44,893359,2414999432.0,4005,2023-11-02 15:30:00
170,SBER,704,672,283835412.0,506963270.0,105092,187344,270.08,270.61,292436,790798683.0,1376,526,602,276316109.0,456192366.0,102370,168559,269.92,270.64,270929,732508476.0,1128,2023-11-02 15:35:00
171,SBER,3079,1646,1633064158.0,1169854876.0,604352,432191,270.22,270.68,1036543,2802919034.0,4725,2902,1563,1614139082.0,1153016778.0,597710,425902,270.05,270.72,1023612,2767155860.0,4465,2023-11-02 15:40:00
172,SBER,3159,2051,1395377817.0,2214241837.0,517083,819093,269.86,270.33,1336176,3609619655.0,5210,2947,1969,1373505840.0,2189104482.0,509034,809368,269.83,270.47,1318402,3562610322.0,4916,2023-11-02 15:45:00
173,SBER,5328,3301,2750389897.0,2388254234.0,1000732,883273,274.84,270.39,1884005,5138644132.0,8629,5131,3228,2700175025.0,2381662261.0,991120,880794,272.44,270.4,1871914,5081837286.0,8359,2023-11-02 15:50:00
174,SBER,5617,5772,1746018604.0,2934281355.0,628700,1046626,277.72,280.36,1675326,4680299960.0,11389,5444,5707,1718109254.0,2960925925.0,618442,1044769,277.81,283.4,1663211,4679035180.0,11151,2023-11-02 15:55:00
175,SBER,2400,3641,1051477362.0,2249400584.0,389530,832286,269.93,270.27,1221816,3300877946.0,6041,2179,3578,1032537582.0,2231721282.0,382552,825667,269.91,270.29,1208219,3264258865.0,5757,2023-11-02 16:00:00
176,SBER,1024,1040,519336768.0,911546875.0,192110,335047,270.33,272.07,527157,1430883643.0,2064,886,977,499475039.0,905931606.0,185141,335008,269.78,270.42,520149,1405406646.0,1863,2023-11-02 16:05:00
177,SBER,1304,1303,602702441.0,1123033674.0,223318,415351,269.89,270.38,638669,1725736115.0,2607,1132,1258,590438621.0,1144707814.0,218792,423287,269.86,270.43,642079,1735146436.0,2390,2023-11-02 16:10:00
178,SBER,1430,1808,501816879.0,1579689268.0,185740,584404,270.17,270.31,770144,2081506147.0,3238,1317,1761,507157848.0,1573634935.0,188068,582041,269.67,270.36,770109,2080792783.0,3078,2023-11-02 16:15:00
179,SBER,5509,6624,2479331328.0,5062563731.0,918880,1874543,269.82,270.07,2793423,7541895059.0,12133,5292,6410,2441224066.0,4990909189.0,904911,1846717,269.78,270.26,2751628,7432133255.0,11702,2023-11-02 16:20:00
180,SBER,4020,5356,2018377773.0,3737470246.0,748894,1384555,269.51,269.94,2133449,5755848019.0,9376,3645,5054,1972604848.0,3704602655.0,732073,1371859,269.45,270.04,2103932,5677207504.0,8699,2023-11-02 16:25:00
181,SBER,8563,10193,3856728653.0,7194399939.0,1432039,2666816,269.32,269.77,4098855,11051128593.0,18756,8165,9967,3811865467.0,7102899829.0,1415616,2632346,269.27,269.83,4047962,10914765296.0,18132,2023-11-02 16:30:00
182,SBER,1575,1483,802101458.0,992683797.0,298062,367790,269.11,269.91,665852,1794785256.0,3058,1310,1373,766757232.0,975301241.0,284732,361259,269.29,269.97,645991,1742058474.0,2683,2023-11-02 16:35:00
183,SBER,2008,5199,1083275149.0,2311720181.0,402118,856798,269.39,269.81,1258916,3394995331.0,7207,1788,5101,1062792963.0,2272902926.0,394698,842238,269.27,269.86,1236936,3335695890.0,6889,2023-11-02 16:40:00
184,SBER,2045,1822,1036487346.0,1219330264.0,384502,451614,269.57,269.99,836116,2255817610.0,3867,1750,1665,968471665.0,1178229725.0,359535,436323,269.37,270.04,795858,2146701391.0,3415,2023-11-02 16:45:00
185,SBER,1311,806,591165374.0,669219323.0,219311,247968,269.56,269.88,467279,1260384697.0,2117,1122,742,560253736.0,652886480.0,207929,241716,269.44,270.1,449645,1213140217.0,1864,2023-11-02 16:50:00
186,SBER,1140,498,545369770.0,328726511.0,202189,121702,269.73,270.11,323891,874096282.0,1638,949,435,513771460.0,329301003.0,190633,121874,269.51,270.2,312507,843072463.0,1384,2023-11-02 16:55:00
187,SBER,2874,1511,1785458410.0,1490950569.0,662110,543828,269.66,274.16,1205938,3276408980.0,4385,2700,1405,1776841984.0,1219746491.0,659140,451283,269.57,270.28,1110423,2996588475.0,4105,2023-11-02 17:00:00
188,SBER,5571,4910,2601926248.0,3649991219.0,963628,1351379,270.01,270.09,2315007,6251917467.0,10481,5374,4805,2548535055.0,3592249112.0,945138,1329811,269.65,270.13,2274949,6140784168.0,10179,2023-11-02 17:05:00
189,SBER,1675,3322,612481061.0,1617376985.0,226986,587988,269.83,275.07,814974,2229858046.0,4997,1506,3211,592895694.0,1266871879.0,219941,469153,269.57,270.03,689094,1859767573.0,4717,2023-11-02 17:10:00
190,SBER,2655,4759,1095720135.0,3331865740.0,404220,1234803,271.07,269.83,1639023,4427585876.0,7414,2479,4639,1086780944.0,3291219915.0,400924,1219238,271.07,269.94,1620162,4378000859.0,7118,2023-11-02 17:15:00
191,SBER,9663,14519,3005990182.0,6957043479.0,1115798,2579922,269.4,269.66,3695720,9963033661.0,24182,9307,14331,2934856916.0,6900471216.0,1089593,2557733,269.35,269.79,3647326,9835328133.0,23638,2023-11-02 17:20:00
192,SBER,10845,7570,3851583797.0,4817274259.0,1428603,1784718,269.6,269.92,3213321,8668858057.0,18415,10709,7480,3827900915.0,4796139111.0,1419865,1776872,269.6,269.92,3196737,8624040027.0,18189,2023-11-02 17:25:00
193,SBER,6746,12707,2445559660.0,6778116348.0,907375,2511679,269.52,269.86,3419054,9223676008.0,19453,6577,12587,2418733862.0,6746587878.0,897619,2499657,269.46,269.9,3397276,9165321741.0,19164,2023-11-02 17:30:00
194,SBER,2749,2911,1023716323.0,1716749962.0,377555,637855,271.14,269.14,1015410,2740466285.0,5660,2460,2673,966572495.0,1665611344.0,356537,617430,271.1,269.77,973967,2632183840.0,5133,2023-11-02 17:35:00
195,SBER,4053,5140,1547594606.0,2698593268.0,573162,1004055,270.01,268.77,1577217,4246187875.0,9193,3541,4612,1484775968.0,2488078163.0,549950,924089,269.98,269.25,1474039,3972854131.0,8153,2023-11-02 17:40:00
196,SBER,10157,9809,3145341203.0,3937861539.0,1161123,1463587,270.89,269.06,2624710,7083202742.0,19966,9381,9196,2950838450.0,3746067308.0,1098478,1391290,268.63,269.25,2489768,6696905758.0,18577,2023-11-02 17:45:00
197,SBER,6519,8247,2335294763.0,2732955733.0,869146,1018194,268.69,268.41,1887340,5068250497.0,14766,5869,7705,2167275641.0,2589863564.0,807766,963398,268.3,268.83,1771164,4757139206.0,13574,2023-11-02 17:50:00
198,SBER,4448,5003,1671288990.0,1856402573.0,620150,690404,269.5,268.89,1310554,3527691564.0,9451,4073,4662,1573015587.0,1776887437.0,585267,660194,268.77,269.15,1245461,3349903024.0,8735,2023-11-02 17:55:00
199,SBER,2437,4469,828807279.0,1845849493.0,308200,686093,268.92,269.04,994293,2674656772.0,6906,2179,4305,781395862.0,1747335259.0,290718,649080,268.78,269.2,939798,2528731121.0,6484,2023-11-02 18:00:00
200,SBER,4363,4009,1752467834.0,1286241021.0,651645,478045,268.93,269.06,1129690,3038708855.0,8372,4041,3848,1709396794.0,1212996189.0,635916,450526,268.81,269.24,1086442,2922392984.0,7889,2023-11-02 18:05:00
201,SBER,15711,5475,4167930591.0,1478208610.0,1539701,549907,270.7,268.81,2089608,5646139202.0,21186,15213,5123,4063334631.0,1422282738.0,1502295,528412,270.48,269.16,2030707,5485617369.0,20336,2023-11-02 18:10:00
202,SBER,9604,3986,2724955219.0,1059370556.0,1009967,393447,269.81,269.25,1403414,3784325776.0,13590,9354,3783,2697199599.0,1023663251.0,999901,380058,269.75,269.34,1379959,3720862851.0,13137,2023-11-02 18:15:00
203,SBER,3369,2513,1371082019.0,702189028.0,509290,260757,269.21,269.29,770047,2073271048.0,5882,3164,2399,1343380565.0,689877533.0,499212,256094,269.1,269.38,755306,2033258099.0,5563,2023-11-02 18:20:00
204,SBER,2260,5382,676032406.0,1488297013.0,251276,553165,269.04,269.05,804441,2164329420.0,7642,1985,5266,658130378.0,1469586609.0,244729,545946,268.92,269.18,790675,2127716988.0,7251,2023-11-02 18:25:00
205,SBER,5159,5793,2145217724.0,2474094522.0,797757,919507,268.91,269.07,1717264,4619312246.0,10952,4955,5659,2125462094.0,2454498274.0,790602,911882,268.84,269.17,1702484,4579960368.0,10614,2023-11-02 18:30:00
206,SBER,10134,6146,3591131221.0,1634003827.0,1336022,609474,268.79,268.1,1945496,5225135049.0,16280,9716,5801,3504329056.0,1519927676.0,1303976,565015,268.74,269.01,1868991,5024256732.0,15517,2023-11-02 18:35:00
207,SBER,5873,5640,2655469050.0,2841316456.0,988525,1057532,268.63,268.67,2046057,5496785507.0,11513,5519,5467,2617452891.0,2790917948.0,974698,1038157,268.54,268.83,2012855,5408370840.0,10986,2023-11-02 18:40:00
208,SBER,38161,33853,17740208551.0,15334452015.0,6588666,5657150,269.25,271.06,12245816,33074660567.0,72014,37250,32909,17498205601.0,14974739224.0,6501204,5557539,269.15,269.45,12058743,32472944826.0,70159,2023-11-03 10:05:00
209,SBER,9173,10834,3605897353.0,4249051696.0,1340696,1578543,268.96,269.18,2919239,7854949049.0,20007,8418,10356,3422436591.0,4073089682.0,1273713,1512582,268.7,269.28,2786295,7495526273.0,18774,2023-11-03 10:10:00
210,SBER,3071,2232,1054371270.0,818901985.0,391109,302390,269.59,270.81,693499,1873273256.0,5303,2598,1912,991870042.0,772132676.0,368997,286542,268.8,269.47,655539,1764002718.0,4510,2023-11-03 10:15:00
211,SBER,3853,3745,1591788784.0,1198962255.0,588725,445097,270.38,269.37,1033822,2790751039.0,7598,3438,3192,1564015581.0,1150526724.0,578600,426955,270.31,269.47,1005555,2714542306.0,6630,2023-11-03 10:20:00
212,SBER,3117,1595,1699527351.0,947582158.0,631488,351617,269.13,269.49,983105,2647109509.0,4712,2799,1241,1641659079.0,892030474.0,610144,330930,269.06,269.55,941074,2533689553.0,4040,2023-11-03 10:25:00
213,SBER,2937,2540,1768476703.0,1492860398.0,656357,546613,269.44,273.11,1202970,3261337101.0,5477,2433,2098,1668492067.0,1413684940.0,619781,524021,269.21,269.78,1143802,3082177007.0,4531,2023-11-03 10:30:00
214,SBER,6857,9714,3910961896.0,5094062271.0,1448483,1881211,270.0,270.79,3329694,9005024168.0,16571,6569,9207,3852853760.0,5031616422.0,1427517,1857978,269.9,270.81,3285495,8884470182.0,15776,2023-11-03 10:35:00
215,SBER,10704,10077,4306073349.0,5360222476.0,1600188,1987775,269.1,269.66,3587963,9666295826.0,20781,10383,9664,4277369479.0,5317411404.0,1589579,1971836,269.09,269.67,3561415,9594780883.0,20047,2023-11-03 10:40:00
216,SBER,7536,7419,6333124948.0,6294860035.0,2351028,2335094,269.38,269.58,4686122,12627984984.0,14955,7321,7110,6305180452.0,6251457008.0,2340925,2318944,269.35,269.58,4659869,12556637461.0,14431,2023-11-03 10:45:00
217,SBER,6150,5061,4844068762.0,5202432363.0,1802920,1931010,268.68,269.42,3733930,10046501126.0,11211,5747,4595,4781841825.0,5119868036.0,1779701,1899985,268.69,269.47,3679686,9901709861.0,10342,2023-11-03 10:50:00
218,SBER,9080,12591,5412103267.0,9368501515.0,2018881,3483969,268.07,268.9,5502850,14780604782.0,21671,7862,11180,5181048656.0,9140047816.0,1933101,3399254,268.02,268.88,5332355,14321096473.0,19042,2023-11-03 10:55:00
219,SBER,1815,3933,1664832309.0,3429007662.0,620836,1275252,268.16,268.89,1896088,5093839971.0,5748,1402,3567,1613688611.0,3383166346.0,601983,1257962,268.06,268.94,1859945,4996854957.0,4969,2023-11-03 11:00:00
220,SBER,2712,5464,2753980918.0,5464183157.0,1002949,2032582,274.59,268.83,3035531,8218164076.0,8176,2304,4936,2685955236.0,5406987850.0,979387,2011075,274.25,268.86,2990462,8092943086.0,7240,2023-11-03 11:05:00
221,SBER,1897,1726,1863353896.0,1328852085.0,693515,493806,268.68,269.1,1187321,3192205981.0,3623,1561,1460,1798605969.0,1232974619.0,669897,458180,268.49,269.1,1128077,3031580588.0,3021,2023-11-03 11:10:00
222,SBER,3467,3494,2603818745.0,3902445307.0,960177,1451075,271.18,268.93,2411252,6506264053.0,6961,3014,3232,2538507738.0,3850473621.0,945898,1431287,268.37,269.02,2377185,6388981360.0,6246,2023-11-03 11:15:00
223,SBER,3074,4606,2108379676.0,6057112325.0,776751,2248883,271.44,269.34,3025634,8165492002.0,7680,2413,4329,1998791933.0,5930767373.0,745884,2199815,267.98,269.6,2945699,7929559307.0,6742,2023-11-03 11:20:00
224,SBER,1602,3336,910012110.0,4164493354.0,339741,1551715,267.85,268.38,1891456,5074505465.0,4938,956,3152,845650400.0,4117717763.0,315915,1533447,267.68,268.53,1849362,4963368163.0,4108,2023-11-03 11:25:00
225,SBER,9530,15559,4406113492.0,16493965464.0,1628868,6145411,270.5,268.39,7774279,20900078956.0,25089,8851,15319,4314065967.0,16450905395.0,1594793,6129004,270.51,268.41,7723797,20764971363.0,24170,2023-11-03 11:30:00
226,SBER,7502,8896,4077012400.0,7786175402.0,1522809,2905131,267.73,268.01,4427940,11863187803.0,16398,6617,8187,3958390889.0,7499712291.0,1478386,2795791,267.75,268.25,4274177,11458103180.0,14804,2023-11-03 11:35:00
227,SBER,14991,18443,8391336028.0,9435544317.0,3136022,3527192,267.58,267.51,6663214,17826880345.0,33434,13412,16464,8155637090.0,9170066178.0,3052149,3424851,267.21,267.75,6477000,17325703269.0,29876,2023-11-03 11:40:00
228,SBER,10765,9024,9377662055.0,3508135898.0,3502683,1308631,267.73,268.08,4811314,12885797953.0,19789,10015,8575,9155642184.0,3400825341.0,3420148,1268252,267.7,268.15,4688400,12556467525.0,18590,2023-11-03 11:45:00
229,SBER,15979,15761,9697150344.0,7302851463.0,3587025,2721111,270.34,268.38,6308136,17000001808.0,31740,15380,15310,9498478892.0,7208039023.0,3544836,2685087,267.95,268.45,6229923,16706517915.0,30690,2023-11-03 11:50:00
230,SBER,7093,4093,4421997971.0,2210264031.0,1649673,823227,268.05,268.49,2472900,6632262002.0,11186,6600,3755,4370909021.0,2157541939.0,1631266,803330,267.95,268.57,2434596,6528450961.0,10355,2023-11-03 11:55:00
231,SBER,6268,3813,5066994328.0,2269209523.0,1853092,845042,273.43,268.53,2698134,7336203851.0,10081,5853,3532,5023917634.0,2231140269.0,1845432,830378,272.24,268.69,2675810,7255057903.0,9385,2023-11-03 12:00:00
232,SBER,15683,10343,11866388937.0,4966411035.0,4428760,1850401,267.94,268.4,6279161,16832799973.0,26026,15195,10015,11806313884.0,4922025433.0,4406544,1833744,267.93,268.41,6240288,16728339318.0,25210,2023-11-03 12:05:00
233,SBER,6704,9448,3361875733.0,6702006893.0,1255072,2498655,267.86,268.22,3753727,10063882626.0,16152,6102,9273,3303342735.0,6580348772.0,1223384,2453089,270.02,268.25,3676473,9883691507.0,15375,2023-11-03 12:10:00
234,SBER,21478,36222,9630573501.0,27631647857.0,3576802,10298394,269.25,268.31,13875196,37262221358.0,57700,21061,35885,9553682612.0,27583352099.0,3556280,10280225,268.64,268.31,13836505,37137034711.0,56946,2023-11-03 12:15:00
235,SBER,3828,10134,1643577530.0,8491821992.0,614154,3166226,267.62,268.2,3780380,10135399523.0,13962,3346,9751,1618601885.0,8422363143.0,604922,3139990,267.57,268.23,3744912,10040965028.0,13097,2023-11-03 12:20:00
236,SBER,2218,3007,1025050708.0,1987147243.0,383267,741733,267.45,267.91,1125000,3012197951.0,5225,1832,2673,982090683.0,1970674542.0,367568,735428,267.19,267.96,1102996,2952765225.0,4505,2023-11-03 12:25:00
237,SBER,5321,5806,2418429898.0,3888881423.0,902091,1448510,268.09,268.47,2350601,6307311321.0,11127,4734,5497,2357175741.0,3886670560.0,879995,1447746,267.86,268.46,2327741,6243846302.0,10231,2023-11-03 12:30:00
238,SBER,6565,6027,3343728173.0,3419827998.0,1247456,1266865,268.04,269.94,2514321,6763556172.0,12592,6368,5675,3312163161.0,3325517260.0,1235757,1231597,268.03,270.02,2467354,6637680421.0,12043,2023-11-03 12:35:00
239,SBER,5102,5483,4904126999.0,2148220081.0,1829723,800125,268.03,268.49,2629848,7052347081.0,10585,4920,5203,4883094819.0,2136437879.0,1821993,795686,268.01,268.5,2617679,7019532699.0,10123,2023-11-03 12:40:00
240,SBER,3480,3833,2023807216.0,2432483031.0,754718,905583,268.15,268.61,1660301,4456290247.0,7313,3276,3530,1988235312.0,2409672073.0,741499,897050,268.14,268.62,1638549,4397907385.0,6806,2023-11-03 12:45:00
241,SBER,6360,8500,3744961991.0,5030497748.0,1396560,1873086,268.16,268.57,3269646,8775459740.0,14860,6163,8193,3715631611.0,5007434988.0,1385785,1864475,268.12,268.57,3250260,8723066599.0,14356,2023-11-03 12:50:00
242,SBER,2384,3512,1450064653.0,1820400232.0,540863,677940,268.1,268.52,1218803,3270464885.0,5896,2207,3218,1442949782.0,1811204227.0,538413,674453,268.0,268.54,1212866,3254154009.0,5425,2023-11-03 12:55:00
243,SBER,4163,7355,2653262899.0,5143059831.0,989289,1915137,268.2,268.55,2904426,7796322730.0,11518,3984,7079,2519044212.0,5135397324.0,939267,1912264,268.19,268.55,2851531,7654441537.0,11063,2023-11-03 13:00:00
244,SBER,18689,15833,10056631976.0,11244060133.0,3743348,4184773,268.65,268.69,7928121,21300692110.0,34522,18471,15476,10026288880.0,11146298321.0,3737170,4148306,268.29,268.7,7885476,21172587201.0,33947,2023-11-03 13:05:00
245,SBER,1959,1911,1158707588.0,1281224719.0,432071,475700,268.18,269.33,907771,2439932307.0,3870,1747,1580,1151065968.0,1267753062.0,429287,471798,268.13,268.71,901085,2418819031.0,3327,2023-11-03 13:10:00
246,SBER,3203,3516,1620872843.0,2354213831.0,604395,877135,268.18,268.4,1481530,3975086675.0,6719,2940,3199,1601259385.0,2347156929.0,597368,873760,268.05,268.63,1471128,3948416315.0,6139,2023-11-03 13:15:00
247,SBER,2812,2915,1739430063.0,2205990082.0,648621,821187,268.17,268.63,1469808,3945420145.0,5727,2630,2687,1696885456.0,2210690850.0,632823,822806,268.15,268.68,1455629,3907576307.0,5317,2023-11-03 13:20:00
248,SBER,1557,1263,1038921304.0,928907816.0,387595,345665,268.04,268.73,733260,1967829120.0,2820,1232,1102,1016893382.0,909263663.0,379368,338311,268.05,268.77,717679,1926157045.0,2334,2023-11-03 13:25:00
249,SBER,4431,8015,3509928105.0,4829457744.0,1309223,1797649,268.09,268.65,3106872,8339385849.0,12446,4041,7892,3473358153.0,4811923403.0,1295588,1791068,268.09,268.66,3086656,8285281556.0,11933,2023-11-03 13:30:00
250,SBER,5905,5509,3332784231.0,3791430138.0,1243240,1412110,268.07,268.49,2655350,7124214370.0,11414,5477,5174,3274794719.0,3554659242.0,1221603,1323645,268.07,268.55,2545248,6829453962.0,10651,2023-11-03 13:35:00
251,SBER,10979,16701,5581553104.0,9687327959.0,2083613,3610326,267.88,268.32,5693939,15268881063.0,27680,10577,16556,5451655591.0,9746500040.0,2035396,3632290,267.84,268.33,5667686,15198155632.0,27133,2023-11-03 13:40:00
252,SBER,8746,11816,4872742935.0,6662295402.0,1818499,2482345,267.95,268.39,4300844,11535038338.0,20562,8241,11747,4845555127.0,6649386950.0,1808506,2477445,267.93,268.4,4285951,11494942077.0,19988,2023-11-03 13:45:00
253,SBER,2549,2819,1708236826.0,2041626051.0,637381,760003,268.01,268.63,1397384,3749862877.0,5368,2226,2751,1689312506.0,2009152594.0,630548,747829,267.91,268.66,1378377,3698465100.0,4977,2023-11-03 13:50:00
254,SBER,7471,9746,3863945995.0,7229499358.0,1442729,2695080,267.82,268.25,4137809,11093445353.0,17217,7011,9529,3820841092.0,7212421805.0,1426716,2687880,267.81,268.33,4114596,11033262897.0,16540,2023-11-03 13:55:00
255,SBER,2555,2456,1038121622.0,1766110947.0,387632,658556,267.81,268.18,1046188,2804232569.0,5011,2108,2336,1094501014.0,1733411151.0,408800,646147,267.74,268.27,1054947,2827912165.0,4444,2023-11-03 14:00:00
256,SBER,1212,10677,1209078617.0,19768506774.0,452267,7371523,267.34,268.17,7823790,20977585392.0,11889,780,10416,1162865507.0,19694665633.0,435054,7343852,267.29,268.18,7778906,20857531141.0,11196,2023-11-03 14:05:00
257,SBER,14852,22981,7398296723.0,22900923719.0,2762640,8538530,267.8,268.21,11301170,30299220442.0,37833,14232,22751,7322862765.0,22863376658.0,2734639,8524313,267.78,268.21,11258952,30186239423.0,36983,2023-11-03 14:10:00
258,SBER,8461,14254,4245009707.0,15222526492.0,1585838,5675460,267.68,268.22,7261298,19467536199.0,22715,8155,14157,4125530194.0,15211762992.0,1541214,5671386,267.68,268.22,7212600,19337293186.0,22312,2023-11-03 14:15:00
259,SBER,9982,9225,4977215887.0,6627798255.0,1856731,2469621,268.06,268.37,4326352,11605014143.0,19207,8607,9132,5030573516.0,6622778337.0,1877447,2467730,267.95,268.38,4345177,11653351853.0,17739,2023-11-03 14:20:00
260,SBER,2629,3226,1563713589.0,2231772147.0,583478,831091,268.0,268.54,1414569,3795485737.0,5855,2447,3141,1539637877.0,2207598439.0,574627,821958,267.94,268.58,1396585,3747236316.0,5588,2023-11-03 14:25:00
261,SBER,2397,1953,2119533146.0,2163945030.0,790740,805474,268.04,268.65,1596214,4283478177.0,4350,2023,1783,2041453095.0,2146126729.0,761946,798872,267.93,268.64,1560818,4187579824.0,3806,2023-11-03 14:30:00
262,SBER,2254,2562,1977951547.0,2847702020.0,732639,1059750,269.98,268.71,1792389,4825653568.0,4816,2065,2475,2011894460.0,2825240807.0,748004,1051367,268.97,268.72,1799371,4837135267.0,4540,2023-11-03 14:35:00
263,SBER,1769,3850,1838097485.0,5188483245.0,686138,1932304,267.89,268.51,2618442,7026580730.0,5619,1556,3729,1778563284.0,5176564485.0,663708,1927826,267.97,268.52,2591534,6955127769.0,5285,2023-11-03 14:40:00
264,SBER,6698,3484,7225542699.0,3697815083.0,2689192,1373792,268.69,269.17,4062984,10923357782.0,10182,5835,3230,7039545222.0,3647530004.0,2621087,1354965,268.57,269.2,3976052,10687075226.0,9065,2023-11-03 14:45:00
265,SBER,16900,5983,24530935277.0,2015724167.0,9123525,741697,268.88,271.77,9865222,26546659445.0,22883,15685,5731,24484255918.0,1970000311.0,9106717,724586,268.86,271.88,9831303,26454256229.0,21416,2023-11-03 14:50:00
266,SBER,4325,4175,4110463906.0,4385816490.0,1527023,1628795,269.18,269.27,3155818,8496280397.0,8500,4113,4017,4073517976.0,4327041504.0,1515539,1606835,268.78,269.29,3122374,8400559480.0,8130,2023-11-03 14:55:00
267,SBER,20833,17697,11190860936.0,10529782203.0,4159080,3913664,269.07,269.05,8072744,21720643140.0,38530,20324,17506,11196268010.0,10529306327.0,4164070,3913461,268.88,269.05,8077531,21725574337.0,37830,2023-11-03 15:00:00
268,SBER,16810,20143,9879891000.0,15697276366.0,3677823,5835155,268.63,269.01,9512978,25577167366.0,36953,15745,20019,9856457386.0,15645889836.0,3669200,5815736,268.63,269.03,9484936,25502347223.0,35764,2023-11-03 15:05:00
269,SBER,1489,1263,933985340.0,953352417.0,345058,354359,270.67,269.04,699417,1887337757.0,2752,1339,1193,926962942.0,933875929.0,342482,347064,270.66,269.08,689546,1860838872.0,2532,2023-11-03 15:10:00
270,SBER,2231,1941,1343415134.0,1452287336.0,497603,539935,269.98,268.97,1037538,2795702470.0,4172,2117,1868,1335365532.0,1442941830.0,494646,536431,269.96,268.99,1031077,2778307362.0,3985,2023-11-03 15:15:00
271,SBER,2433,1394,1143711583.0,852545788.0,422555,306003,270.67,278.61,728558,1996257372.0,3827,2239,1335,1127650344.0,806073000.0,415268,299578,271.55,269.07,714846,1933723345.0,3574,2023-11-03 15:20:00
272,SBER,24047,32167,14929612363.0,23003001783.0,5560940,8546625,268.47,269.15,14107565,37932614146.0,56214,23799,32095,14830582057.0,22966299188.0,5524173,8532858,268.47,269.15,14057031,37796881246.0,55894,2023-11-03 15:25:00
273,SBER,17356,22761,9149171660.0,15943263963.0,3406931,5928210,268.55,268.94,9335141,25092435624.0,40117,17212,22718,9145219095.0,15943714120.0,3405567,5928360,268.54,268.94,9333927,25088933215.0,39930,2023-11-03 15:30:00
274,SBER,3693,5471,2135288358.0,4359521809.0,794519,1612629,268.75,270.34,2407148,6494810167.0,9164,3532,5378,2093113224.0,4314774771.0,779077,1603640,268.67,269.06,2382717,6407887996.0,8910,2023-11-03 15:35:00
275,SBER,2221,1890,1356207532.0,1400837181.0,504783,507718,268.67,275.91,1012501,2757044713.0,4111,2024,1780,1346258995.0,1399784236.0,501197,498770,268.61,280.65,999967,2746043232.0,3804,2023-11-03 15:40:00
276,SBER,4437,6118,2881135478.0,3811489718.0,1072904,1416556,268.54,269.07,2489460,6692625196.0,10555,4255,6050,2870205924.0,3799231374.0,1069075,1411991,268.48,269.07,2481066,6669437299.0,10305,2023-11-03 15:45:00
277,SBER,2917,2315,1776401472.0,1647170454.0,661822,604573,268.41,272.45,1266395,3423571926.0,5232,2799,2196,1785627058.0,1581780343.0,665471,587870,268.33,269.07,1253341,3367407402.0,4995,2023-11-03 15:50:00
278,SBER,1053,673,577010040.0,550540501.0,214969,190220,268.42,289.42,405189,1127550541.0,1726,846,626,557690679.0,524627659.0,207866,187380,268.29,279.98,395246,1082318338.0,1472,2023-11-03 15:55:00
279,SBER,10258,8253,5988256226.0,5932047069.0,2229750,2205090,268.56,269.02,4434840,11920303296.0,18511,10146,8204,5980496153.0,5928322031.0,2227036,2203676,268.54,269.02,4430712,11908818185.0,18350,2023-11-03 16:00:00
280,SBER,1729,942,812055681.0,646036055.0,302151,232237,268.76,278.18,534388,1458091736.0,2671,1255,863,772113018.0,639878280.0,287433,231027,268.62,276.97,518460,1411991299.0,2118,2023-11-03 16:05:00
281,SBER,1594,948,910494477.0,863510338.0,338874,305369,268.68,282.78,644243,1774004815.0,2542,1389,841,897887312.0,722831150.0,334225,253039,268.65,285.66,587264,1620718463.0,2230,2023-11-03 16:10:00
282,SBER,12353,7632,8010399582.0,7510147266.0,2982369,2791430,268.59,269.04,5773799,15520546848.0,19985,12223,7563,7976484662.0,7503071246.0,2969789,2788762,268.59,269.05,5758551,15479555908.0,19786,2023-11-03 16:15:00
283,SBER,1108,708,752156628.0,484478888.0,280055,180060,268.57,269.07,460115,1236635517.0,1816,946,673,725948852.0,483543385.0,270432,179635,268.44,269.18,450067,1209492237.0,1619,2023-11-03 16:20:00
284,SBER,1469,630,807797771.0,464158675.0,300798,166457,268.55,278.85,467255,1271956446.0,2099,1163,529,698195615.0,445070701.0,259941,157546,268.6,282.5,417487,1143266317.0,1692,2023-11-03 16:25:00
285,SBER,5873,7757,3399694326.0,4236914915.0,1266057,1575578,268.53,268.91,2841635,7636609242.0,13630,5671,7644,3400564820.0,4199896846.0,1266610,1561429,268.48,268.98,2828039,7600461667.0,13315,2023-11-03 16:30:00
286,SBER,3661,3349,2461298338.0,2546485351.0,918043,947018,268.1,268.9,1865061,5007783689.0,7010,3492,3285,2320321460.0,2534570217.0,864743,942502,268.32,268.92,1807245,4854891677.0,6777,2023-11-03 16:35:00
287,SBER,1322,858,862242684.0,655748900.0,320020,242158,269.43,270.79,562178,1517991584.0,2180,1136,801,843630980.0,655311195.0,313448,243451,269.15,269.18,556899,1498942176.0,1937,2023-11-03 16:40:00
288,SBER,1334,718,719731971.0,604324354.0,265155,218676,271.44,276.36,483831,1324056325.0,2052,1038,639,697698666.0,619725355.0,257663,218264,270.78,283.93,475927,1317424021.0,1677,2023-11-03 16:45:00
289,SBER,914,454,451119344.0,385178141.0,167891,143035,268.7,269.29,310926,836297485.0,1368,608,367,382105977.0,364218995.0,142244,135198,268.63,269.4,277442,746324972.0,975,2023-11-03 16:50:00
290,SBER,1268,525,496066542.0,428329497.0,182929,159264,271.18,268.94,342193,924396039.0,1793,896,450,478937521.0,418030469.0,178239,155178,268.71,269.39,333417,896967990.0,1346,2023-11-03 16:55:00
291,SBER,1781,1048,986064130.0,732145170.0,356308,271828,276.74,269.34,628136,1718209301.0,2829,1512,961,965269819.0,724476761.0,348819,268928,276.73,269.39,617747,1689746580.0,2473,2023-11-03 17:00:00
292,SBER,8669,7765,3621201883.0,8874582087.0,1325459,3286452,273.2,270.04,4611911,12495783970.0,16434,8114,7482,3519473825.0,8534893555.0,1286752,3167549,273.52,269.45,4454301,12054367380.0,15596,2023-11-03 17:05:00
293,SBER,4880,5621,2958027207.0,4869703274.0,1099595,1802178,269.01,270.21,2901773,7827730481.0,10501,4680,5487,2949650184.0,4847181790.0,1096776,1798596,268.94,269.5,2895372,7796831975.0,10167,2023-11-03 17:10:00
294,SBER,3502,4785,2046484553.0,3591851305.0,761099,1333478,268.89,269.36,2094577,5638335859.0,8287,3311,4705,2036276958.0,3579194718.0,757231,1328614,268.91,269.39,2085845,5615471676.0,8016,2023-11-03 17:15:00
295,SBER,1945,1191,1245161189.0,1082533917.0,462871,399286,269.01,271.12,862157,2327695106.0,3136,1772,1118,1208283717.0,1008133877.0,449362,373955,268.89,269.59,823317,2216417595.0,2890,2023-11-03 17:20:00
296,SBER,4130,4336,1821961428.0,4561144869.0,677056,1689342,269.1,270.0,2366398,6383106297.0,8466,3908,4241,1802790931.0,4523216623.0,669988,1674107,269.08,270.19,2344095,6326007554.0,8149,2023-11-03 17:25:00
297,SBER,3559,2665,1650247896.0,3190654761.0,613581,1166250,268.95,273.58,1779831,4840902657.0,6224,3385,2580,1629179751.0,2867602148.0,605865,1052177,268.9,272.54,1658042,4496781899.0,5965,2023-11-03 17:30:00
298,SBER,1415,716,765399529.0,564379489.0,284557,207551,268.98,271.92,492108,1329779019.0,2131,1299,654,754449307.0,551299927.0,280649,202315,268.82,272.5,482964,1305749235.0,1953,2023-11-03 17:35:00
299,SBER,967,715,515368363.0,552724295.0,191487,205065,269.14,269.54,396552,1068092658.0,1682,851,630,499822424.0,533359291.0,185812,197807,268.99,269.64,383619,1033181715.0,1481,2023-11-03 17:40:00
300,SBER,1643,1048,1065979199.0,827505791.0,389563,306892,273.63,269.64,696455,1893484991.0,2691,1474,917,998095275.0,809444637.0,367962,300079,271.25,269.74,668041,1807539913.0,2391,2023-11-03 17:45:00
301,SBER,1861,1950,1056418246.0,1120123274.0,392486,415579,269.16,269.53,808065,2176541520.0,3811,1650,1677,1036667171.0,1089794767.0,385347,404156,269.02,269.65,789503,2126461939.0,3327,2023-11-03 17:50:00
302,SBER,1522,1125,833655147.0,780114133.0,309828,289507,269.07,269.46,599335,1613769281.0,2647,1253,915,816338386.0,736649210.0,303590,273119,268.9,269.72,576709,1552987597.0,2168,2023-11-03 17:55:00
303,SBER,1782,1062,1043392273.0,995952962.0,387827,340236,269.04,292.72,728063,2039345236.0,2844,1486,948,999991696.0,985182870.0,371835,336279,268.93,292.97,708114,1985174566.0,2434,2023-11-03 18:00:00
304,SBER,1326,650,604724790.0,482271503.0,224714,174079,269.11,277.04,398793,1086996293.0,1976,1034,547,578223071.0,488791567.0,215041,181277,268.89,269.64,396318,1067014638.0,1581,2023-11-03 18:05:00
305,SBER,953,645,540431818.0,452581569.0,200904,168013,269.0,269.37,368917,993013387.0,1598,823,553,512477724.0,450798495.0,190580,167192,268.9,269.63,357772,963276220.0,1376,2023-11-03 18:10:00
306,SBER,4127,5357,2772350994.0,4149581061.0,1031059,1540992,268.88,269.28,2572051,6921932056.0,9484,3954,5120,2734169648.0,4070969881.0,1016988,1511626,268.85,269.31,2528614,6805139529.0,9074,2023-11-03 18:15:00
307,SBER,1687,1340,957293221.0,1044403424.0,355579,387739,269.22,269.36,743318,2001696645.0,3027,1481,1264,921598376.0,1016513514.0,342752,377339,268.88,269.39,720091,1938111891.0,2745,2023-11-03 18:20:00
308,SBER,1260,715,651672646.0,590859573.0,242245,219381,269.01,269.33,461626,1242532219.0,1975,1098,642,643198397.0,599428918.0,239243,222493,268.85,269.41,461736,1242627315.0,1740,2023-11-03 18:25:00
309,SBER,1186,1824,611722233.0,1024212042.0,227381,380479,269.03,269.19,607860,1635934275.0,3010,1050,1737,599993725.0,992757063.0,223180,368639,268.84,269.3,591819,1592750788.0,2787,2023-11-03 18:30:00
310,SBER,3416,2895,2469767190.0,2356373912.0,918382,875093,268.93,269.27,1793475,4826141103.0,6311,3220,2814,2480933332.0,2342057980.0,923056,869530,268.77,269.35,1792586,4822991313.0,6034,2023-11-03 18:35:00
311,SBER,3368,3032,2971785966.0,3467305181.0,1104605,1282720,269.04,270.31,2387325,6439091148.0,6400,3182,2998,2926766822.0,3458052290.0,1088910,1278698,268.78,270.44,2367608,6384819112.0,6180,2023-11-03 18:40:00
312,SBER,34735,28767,13184988037.0,12907182259.0,4906221,4787105,268.74,269.62,9693326,26092170296.0,63502,33862,28059,12975997043.0,12716784497.0,4828594,4721938,268.73,269.31,9550532,25692781540.0,61921,2023-11-06 10:05:00
313,SBER,6279,6921,2828278031.0,2694745409.0,1051056,995721,269.09,270.63,2046777,5523023441.0,13200,5591,6317,2735807159.0,2579416493.0,1017310,957749,268.93,269.32,1975059,5315223652.0,11908,2023-11-06 10:10:00
314,SBER,3345,3258,1106008661.0,1422136100.0,410334,522871,269.54,271.99,933205,2528144762.0,6603,2995,2832,1071104748.0,1369810867.0,398006,503304,269.12,272.16,901310,2440915616.0,5827,2023-11-06 10:15:00
315,SBER,8012,8495,3047326085.0,2998465600.0,1133000,1099729,268.96,272.65,2232729,6045791685.0,16507,7312,7981,2982823414.0,2923245178.0,1109134,1080724,268.93,270.49,2189858,5906068592.0,15293,2023-11-06 10:20:00
316,SBER,12226,16725,4169730162.0,6924080324.0,1550785,2572335,268.88,269.17,4123120,11093810486.0,28951,12000,16298,4154451164.0,6887039767.0,1545273,2558503,268.85,269.18,4103776,11041490931.0,28298,2023-11-06 10:25:00
317,SBER,2870,2762,1593018879.0,1560434101.0,592393,579783,268.91,269.14,1172176,3153452980.0,5632,2574,2492,1558095518.0,1536579635.0,579792,570873,268.73,269.16,1150665,3094675153.0,5066,2023-11-06 10:30:00
318,SBER,5833,12886,2155044034.0,3795036938.0,801623,1410012,268.84,269.15,2211635,5950080973.0,18719,5550,12551,2119242619.0,3725268480.0,788451,1384352,268.79,269.1,2172803,5844511100.0,18101,2023-11-06 10:35:00
319,SBER,2192,1885,1124559188.0,1108603514.0,417787,411406,269.17,269.47,829193,2233162702.0,4077,1999,1541,1108807636.0,1082241743.0,412322,401598,268.92,269.48,813920,2191049379.0,3540,2023-11-06 10:40:00
320,SBER,2588,815,1623937439.0,668119722.0,603829,247898,268.94,269.51,851727,2292057162.0,3403,2286,585,1557949871.0,659365405.0,579157,244628,269.0,269.54,823785,2217315276.0,2871,2023-11-06 10:45:00
321,SBER,8287,2990,4714603128.0,2904287596.0,1742441,1048998,270.57,276.86,2791439,7618890725.0,11277,4492,2195,4426540585.0,2746181005.0,1638565,1007740,270.15,272.51,2646305,7172721590.0,6687,2023-11-06 10:50:00
322,SBER,6619,5713,4415058777.0,3616623315.0,1634614,1338236,270.1,270.25,2972850,8031682092.0,12332,6045,4829,4286242155.0,3483166120.0,1587641,1288099,269.98,270.41,2875740,7769408275.0,10874,2023-11-06 10:55:00
323,SBER,8613,8022,6745109516.0,5701275154.0,2499424,2109182,269.87,270.31,4608606,12446384670.0,16635,8153,7647,6595012873.0,5625749212.0,2444329,2081223,269.81,270.31,4525552,12220762085.0,15800,2023-11-06 11:00:00
324,SBER,6779,7647,4515364418.0,6454532437.0,1671655,2388375,270.11,270.25,4060030,10969896855.0,14426,6552,7291,4449147251.0,6372081572.0,1648628,2357825,269.87,270.25,4006453,10821228824.0,13843,2023-11-06 11:05:00
325,SBER,2553,1739,1565714679.0,1260594372.0,578993,466039,270.42,270.49,1045032,2826309052.0,4292,1939,1264,1472320939.0,1145911312.0,544923,423334,270.19,270.69,968257,2618232251.0,3203,2023-11-06 11:10:00
326,SBER,4694,4275,3244585223.0,1864013811.0,1199157,680678,270.57,273.85,1879835,5108599035.0,8969,4008,2412,3063217609.0,1767397380.0,1132828,642662,270.4,275.01,1775490,4830614989.0,6420,2023-11-06 11:15:00
327,SBER,3297,1939,2363075608.0,1772472675.0,862769,619601,273.89,286.07,1482370,4135548283.0,5236,2489,1451,2160365889.0,1668500201.0,798563,588784,270.53,283.38,1387347,3828866090.0,3940,2023-11-06 11:20:00
328,SBER,2045,1193,1144284049.0,1141623134.0,422279,421488,270.98,270.86,843767,2285907184.0,3238,1397,866,1056021091.0,1078402224.0,390276,397831,270.58,271.07,788107,2134423316.0,2263,2023-11-06 11:25:00
329,SBER,3345,1932,2055157577.0,1495983676.0,737096,533054,278.82,280.64,1270150,3551141254.0,5277,2501,1350,1871454313.0,1286327498.0,689285,474219,271.51,271.25,1163504,3157781812.0,3851,2023-11-06 11:30:00
330,SBER,5460,5158,3090665910.0,4097961822.0,1137611,1509472,271.68,271.48,2647083,7188627732.0,10618,4359,4490,2960074009.0,3982264977.0,1072606,1467248,275.97,271.41,2539854,6942338987.0,8849,2023-11-06 11:35:00
331,SBER,9014,10272,6295904402.0,4886536557.0,2323011,1802292,271.02,271.13,4125303,11182440960.0,19286,8105,8083,6157827540.0,4689348806.0,2272767,1728345,270.94,271.32,4001112,10847176346.0,16188,2023-11-06 11:40:00
332,SBER,11076,33651,9418519134.0,12333713088.0,3466024,4546403,271.74,271.29,8012427,21752232222.0,44727,10497,33231,9362627054.0,12266021466.0,3456093,4521051,270.9,271.31,7977144,21628648520.0,43728,2023-11-06 11:45:00
333,SBER,3053,2203,1743558202.0,1475913275.0,632506,544156,275.66,271.23,1176662,3219471477.0,5256,2604,1871,1671141343.0,1401559536.0,616543,516138,271.05,271.55,1132681,3072700880.0,4475,2023-11-06 11:50:00
334,SBER,2923,2188,1421043669.0,1180038570.0,524299,435647,271.04,270.87,959946,2601082240.0,5111,2518,1960,1382900631.0,1139236813.0,510421,419986,270.93,271.26,930407,2522137445.0,4478,2023-11-06 11:55:00
335,SBER,3611,2385,1654356200.0,1207913106.0,610419,445442,271.02,271.17,1055861,2862269307.0,5996,3233,2220,1641310804.0,1187825466.0,606010,437935,270.84,271.23,1043945,2829136270.0,5453,2023-11-06 12:00:00
336,SBER,6800,5463,3395179482.0,3295679555.0,1247454,1213533,272.17,271.58,2460987,6690859038.0,12263,5846,5001,3253920589.0,3166268613.0,1198051,1165747,271.6,271.61,2363798,6420189203.0,10847,2023-11-06 12:05:00
337,SBER,7770,18176,2925643052.0,6226166888.0,1079392,2294311,271.05,271.37,3373703,9151809941.0,25946,7384,17843,2868669226.0,6165793769.0,1058363,2271737,271.05,271.41,3330100,9034462996.0,25227,2023-11-06 12:10:00
338,SBER,3864,2922,1959412147.0,1632085310.0,723256,601863,270.92,271.17,1325119,3591497458.0,6786,3531,2644,1921634027.0,1567428483.0,709385,577682,270.89,271.33,1287067,3489062511.0,6175,2023-11-06 12:15:00
339,SBER,9986,12288,4676618909.0,6657901318.0,1727367,2456451,270.74,271.04,4183818,11334520227.0,22274,9626,11735,4624807076.0,6565003561.0,1708283,2421785,270.73,271.08,4130068,11189810638.0,21361,2023-11-06 12:20:00
340,SBER,2929,2264,1457303462.0,1339514035.0,535172,494501,272.31,270.88,1029673,2796817497.0,5193,2626,1921,1433157140.0,1276189340.0,529617,470867,270.6,271.03,1000484,2709346481.0,4547,2023-11-06 12:25:00
341,SBER,3556,6001,1064158784.0,3804144325.0,393009,1403066,270.77,271.13,1796075,4868303109.0,9557,3390,5713,1051765745.0,3777278061.0,385554,1393117,272.79,271.14,1778671,4829043806.0,9103,2023-11-06 12:30:00
342,SBER,1395,1333,812011927.0,850305997.0,278349,294813,291.72,288.42,573162,1662317925.0,2728,1295,1025,732964962.0,762846844.0,268221,281385,273.27,271.1,549606,1495811806.0,2320,2023-11-06 12:35:00
343,SBER,1150,1800,592170912.0,927753217.0,218599,342297,270.89,271.04,560896,1519924130.0,2950,940,1541,569306840.0,899314138.0,210417,331672,270.56,271.15,542089,1468620979.0,2481,2023-11-06 12:40:00
344,SBER,14593,12042,7521839863.0,6647797149.0,2777363,2455293,270.83,270.75,5232656,14169637012.0,26635,14322,11727,7477942883.0,6604165504.0,2763793,2437771,270.57,270.91,5201564,14082108388.0,26049,2023-11-06 12:45:00
345,SBER,8009,13899,2790356069.0,6302969599.0,1030899,2326315,270.67,270.94,3357214,9093325669.0,21908,7807,13596,2761194582.0,6310894034.0,1017584,2329204,271.35,270.95,3346788,9072088617.0,21403,2023-11-06 12:50:00
346,SBER,6229,14463,1542899512.0,5655043659.0,569462,2085931,270.94,271.1,2655393,7197943171.0,20692,6091,14126,1545749384.0,5622118599.0,570725,2073697,270.84,271.12,2644422,7167867984.0,20217,2023-11-06 12:55:00
347,SBER,2374,2405,1040657624.0,1250406889.0,384067,461373,270.96,271.02,845440,2291064514.0,4779,2143,2077,1019918236.0,1192596710.0,376554,439614,270.86,271.28,816168,2212514946.0,4220,2023-11-06 13:00:00
348,SBER,2493,6812,1002651214.0,4820349190.0,370230,1777321,270.82,271.21,2147551,5823000404.0,9305,2310,6516,986606474.0,4757851916.0,364351,1754892,270.78,271.12,2119243,5744458390.0,8826,2023-11-06 13:05:00
349,SBER,1827,1490,897228453.0,1018685675.0,331731,376232,270.47,270.76,707963,1915914129.0,3317,1574,1236,860807682.0,982622785.0,318220,362566,270.51,271.02,680786,1843430467.0,2810,2023-11-06 13:10:00
350,SBER,3593,2972,1778787850.0,2008981259.0,647832,742156,274.58,270.7,1389988,3787769110.0,6565,3254,2706,1702264979.0,1980196758.0,619758,730138,274.67,271.21,1349896,3682461737.0,5960,2023-11-06 13:15:00
351,SBER,1976,1730,861509823.0,1198256361.0,318449,442349,270.53,270.88,760798,2059766184.0,3706,1756,1540,851374523.0,1186018522.0,314757,437783,270.49,270.91,752540,2037393045.0,3296,2023-11-06 13:20:00
352,SBER,1633,1570,682570291.0,1023732654.0,252290,377864,270.55,270.93,630154,1706302946.0,3203,1336,1413,667935518.0,991845509.0,246933,366136,270.49,270.9,613069,1659781028.0,2749,2023-11-06 13:25:00
353,SBER,4333,3963,2177215694.0,3280428045.0,804658,1211364,270.58,270.8,2016022,5457643739.0,8296,4069,3737,2169088784.0,3275040251.0,801717,1209324,270.56,270.82,2011041,5444129036.0,7806,2023-11-06 13:30:00
354,SBER,1993,1407,815559273.0,871489006.0,300954,321646,270.99,270.95,622600,1687048279.0,3400,1641,1247,781059769.0,830902617.0,288659,306494,270.58,271.1,595153,1611962386.0,2888,2023-11-06 13:35:00
355,SBER,2094,1702,522926709.0,486828934.0,193072,179562,270.85,271.12,372634,1009755643.0,3796,1826,1565,507907411.0,476235858.0,187592,175629,270.75,271.16,363221,984143270.0,3391,2023-11-06 13:40:00
356,SBER,1115,551,516515952.0,450903913.0,190521,166338,271.11,271.08,356859,967419865.0,1666,732,437,477131842.0,426144588.0,176230,157099,270.74,271.26,333329,903276430.0,1169,2023-11-06 13:45:00
357,SBER,1389,850,684447001.0,571337039.0,252523,210600,271.04,271.29,463123,1255784041.0,2239,1094,742,636947970.0,553277721.0,235158,203846,270.86,271.42,439004,1190225692.0,1836,2023-11-06 13:50:00
358,SBER,1703,1083,856103720.0,776237220.0,315492,286164,271.36,271.26,601656,1632340940.0,2786,1329,903,804131303.0,734995286.0,296709,270693,271.02,271.52,567402,1539126590.0,2232,2023-11-06 13:55:00
359,SBER,1282,848,546542516.0,560386676.0,200765,206344,272.23,271.58,407109,1106929193.0,2130,1018,732,526748319.0,536628898.0,194249,197585,271.17,271.59,391834,1063377217.0,1750,2023-11-06 14:00:00
360,SBER,586,407,329490716.0,394261965.0,121491,145314,271.21,271.32,266805,723752681.0,993,324,260,328279613.0,376732470.0,121138,138647,271.0,271.72,259785,705012084.0,584,2023-11-06 14:05:00
361,SBER,2481,1421,1098076464.0,908318779.0,404965,334833,271.15,271.28,739798,2006395243.0,3902,2084,1240,1057387016.0,832823487.0,390059,306723,271.08,271.52,696782,1890210503.0,3324,2023-11-06 14:10:00
362,SBER,1462,926,645809066.0,518536429.0,238289,191134,271.02,271.29,429423,1164345495.0,2388,1243,806,646053941.0,500395280.0,238431,184373,270.96,271.4,422804,1146449222.0,2049,2023-11-06 14:15:00
363,SBER,1009,1027,531389094.0,662046953.0,196634,244399,270.24,270.89,441033,1193436048.0,2036,884,966,502981443.0,665140642.0,186115,245053,270.25,271.43,431168,1168122086.0,1850,2023-11-06 14:20:00
364,SBER,1542,1098,768354111.0,719467326.0,283591,265589,270.94,270.9,549180,1487821438.0,2640,1383,984,742606275.0,696551784.0,274132,256665,270.89,271.39,530797,1439158060.0,2367,2023-11-06 14:25:00
365,SBER,1512,827,732665149.0,513878934.0,270421,189496,270.94,271.18,459917,1246544084.0,2339,1313,721,702836971.0,493481722.0,259372,181803,270.98,271.44,441175,1196318693.0,2034,2023-11-06 14:30:00
366,SBER,2288,1566,1198101413.0,962390058.0,440060,354420,272.26,271.54,794480,2160491471.0,3854,1933,1367,1077733295.0,839676417.0,398008,309135,270.78,271.62,707143,1917409713.0,3300,2023-11-06 14:35:00
367,SBER,5105,2758,1927098487.0,1050774251.0,710123,386988,271.38,271.53,1097111,2977872738.0,7863,4952,2609,1896225632.0,1013676782.0,698873,373258,271.33,271.58,1072131,2909902415.0,7561,2023-11-06 14:40:00
368,SBER,1795,958,974886434.0,728226488.0,358405,268412,272.01,271.31,626817,1703112922.0,2753,1548,778,889735518.0,622014405.0,328211,229016,271.09,271.6,557227,1511749924.0,2326,2023-11-06 14:45:00
369,SBER,2328,1831,1306860243.0,975407970.0,481456,359785,271.44,271.11,841241,2282268213.0,4159,2197,1712,1274831130.0,953017966.0,470436,351275,270.99,271.3,821711,2227849097.0,3909,2023-11-06 14:50:00
370,SBER,1864,1064,895826402.0,493775547.0,330069,182038,271.41,271.25,512107,1389601950.0,2928,1747,995,868328107.0,493170978.0,320425,181724,270.99,271.38,502149,1361499085.0,2742,2023-11-06 14:55:00
371,SBER,1501,860,766692948.0,507028402.0,282752,186780,271.15,271.46,469532,1273721351.0,2361,1362,688,746450214.0,483372194.0,275440,178006,271.0,271.55,453446,1229822408.0,2050,2023-11-06 15:00:00
372,SBER,1123,885,599541015.0,484812448.0,220869,178590,271.45,271.47,399459,1084353463.0,2008,963,763,552635948.0,439027344.0,203811,161618,271.15,271.65,365429,991663293.0,1726,2023-11-06 15:05:00
373,SBER,1056,627,634536977.0,442252748.0,234027,162803,271.14,271.65,396830,1076789725.0,1683,932,486,628578798.0,416450894.0,231847,153336,271.12,271.59,385183,1045029692.0,1418,2023-11-06 15:10:00
374,SBER,2138,1064,1061426225.0,481573683.0,391339,177459,271.23,271.37,568798,1542999909.0,3202,2007,971,1048580544.0,451776847.0,386645,166355,271.2,271.57,553000,1500357392.0,2978,2023-11-06 15:15:00
375,SBER,1229,604,599423870.0,412271260.0,221059,151808,271.16,271.57,372867,1011695130.0,1833,1114,495,590216414.0,404299523.0,217692,148844,271.12,271.63,366536,994515938.0,1609,2023-11-06 15:20:00
376,SBER,856,537,386330637.0,285913109.0,142492,105382,271.12,271.31,247874,672243747.0,1393,740,441,375912068.0,276285486.0,138664,101749,271.1,271.54,240413,652197555.0,1181,2023-11-06 15:25:00
377,SBER,886,578,479113488.0,373085471.0,176561,137485,271.36,271.36,314046,852198960.0,1464,764,496,460345703.0,389545689.0,169785,143434,271.13,271.59,313219,849891392.0,1260,2023-11-06 15:30:00
378,SBER,849,621,449177150.0,430405831.0,165655,158524,271.15,271.51,324179,879582981.0,1470,726,482,438159284.0,386501862.0,161642,142293,271.07,271.62,303935,824661147.0,1208,2023-11-06 15:35:00
379,SBER,870,736,399423201.0,432267751.0,147376,159309,271.02,271.34,306685,831690953.0,1606,721,638,385559776.0,448530639.0,142325,165236,270.9,271.45,307561,834090415.0,1359,2023-11-06 15:40:00
380,SBER,994,703,466519184.0,424358400.0,172242,156599,270.85,270.98,328841,890877584.0,1697,820,628,443083512.0,411582101.0,163590,151671,270.85,271.37,315261,854665613.0,1448,2023-11-06 15:45:00
381,SBER,898,3113,481321891.0,1870268234.0,177654,688932,270.93,271.47,866586,2351590126.0,4011,784,3057,469429407.0,1868366853.0,173330,688866,270.83,271.22,862196,2337796261.0,3841,2023-11-06 15:50:00
382,SBER,2604,10495,1390240161.0,5615267448.0,513466,2070982,270.76,271.14,2584448,7005507610.0,13099,2446,10417,1364449048.0,5597211719.0,503957,2062825,270.75,271.34,2566782,6961660767.0,12863,2023-11-06 15:55:00
383,SBER,952,892,490957024.0,579189177.0,181282,213571,270.83,271.19,394853,1070146202.0,1844,865,801,483744866.0,555656057.0,178658,204887,270.77,271.2,383545,1039400923.0,1666,2023-11-06 16:00:00
384,SBER,3783,13148,1581534578.0,4376061149.0,584315,1615411,270.66,270.89,2199726,5957595728.0,16931,3527,13021,1555412012.0,4342701526.0,574785,1602499,270.61,271.0,2177284,5898113538.0,16548,2023-11-06 16:05:00
385,SBER,1186,735,446427359.0,406958669.0,164795,150067,270.9,271.18,314862,853386028.0,1921,1117,671,445301242.0,413559136.0,164498,152470,270.7,271.24,316968,858860379.0,1788,2023-11-06 16:10:00
386,SBER,1300,935,547365579.0,498647559.0,201998,183830,270.98,271.25,385828,1046013139.0,2235,1188,847,528443100.0,500051184.0,195097,184315,270.86,271.3,379412,1028494285.0,2035,2023-11-06 16:15:00
387,SBER,1807,1064,646370021.0,480672506.0,238590,177244,270.91,271.19,415834,1127042528.0,2871,1750,992,645247642.0,467808090.0,238271,172484,270.8,271.22,410755,1113055732.0,2742,2023-11-06 16:20:00
388,SBER,1403,936,573559728.0,463984865.0,211797,171146,270.81,271.1,382943,1037544594.0,2339,1331,885,567653945.0,461126462.0,209625,170033,270.79,271.2,379658,1028780407.0,2216,2023-11-06 16:25:00
389,SBER,1440,835,573444932.0,444962722.0,211855,164188,270.68,271.01,376043,1018407654.0,2275,1302,774,566413581.0,432680318.0,209314,159563,270.6,271.17,368877,999093900.0,2076,2023-11-06 16:30:00
390,SBER,854,809,334490217.0,409868669.0,123578,151263,270.67,270.96,274841,744358886.0,1663,726,754,335304562.0,407651399.0,123993,150369,270.42,271.1,274362,742955962.0,1480,2023-11-06 16:35:00
391,SBER,1108,678,427721377.0,341119899.0,157862,125794,270.95,271.17,283656,768841276.0,1786,1033,621,424792631.0,344351550.0,156933,126978,270.68,271.19,283911,769144181.0,1654,2023-11-06 16:40:00
392,SBER,1033,857,428487658.0,390076681.0,158171,143807,270.9,271.25,301978,818564340.0,1890,967,810,416381485.0,387352602.0,153746,142803,270.82,271.25,296549,803734088.0,1777,2023-11-06 16:45:00
393,SBER,830,628,466992954.0,385525884.0,172337,142187,270.98,271.14,314524,852518838.0,1458,687,539,459638490.0,367142346.0,169662,135274,270.91,271.41,304936,826780836.0,1226,2023-11-06 16:50:00
394,SBER,977,524,428383705.0,321987684.0,158038,117939,271.06,273.01,275977,750371389.0,1501,745,468,407058089.0,345515545.0,150224,126479,270.97,273.18,276703,752573634.0,1213,2023-11-06 16:55:00
395,SBER,676,469,317000699.0,253274119.0,107874,93009,293.86,272.31,200883,570274819.0,1145,602,366,294867921.0,233796341.0,104290,86116,282.74,271.49,190406,528664263.0,968,2023-11-06 17:00:00
396,SBER,2394,1229,1056207803.0,776374639.0,386161,285531,273.51,271.91,671692,1832582442.0,3623,1795,1057,1002334077.0,740377692.0,365135,272565,274.51,271.63,637700,1742711770.0,2852,2023-11-06 17:05:00
397,SBER,1011,486,511108075.0,374985036.0,188206,138074,271.57,271.58,326280,886093111.0,1497,809,390,480099837.0,363197331.0,177041,133676,271.18,271.7,310717,843297168.0,1199,2023-11-06 17:10:00
398,SBER,558,369,254822237.0,241767336.0,93931,83779,271.29,288.58,177710,496589574.0,927,462,276,249106446.0,230490734.0,91869,79591,271.15,289.59,171460,479597180.0,738,2023-11-06 17:15:00
399,SBER,780,611,320468340.0,349592862.0,118064,118409,271.44,295.24,236473,670061203.0,1391,681,527,299581719.0,321865936.0,110494,108787,271.13,295.87,219281,621447655.0,1208,2023-11-06 17:20:00
400,SBER,1476,856,477711084.0,333264960.0,176048,122097,271.35,272.95,298145,810976045.0,2332,1367,767,473069714.0,337750401.0,174442,123679,271.19,273.09,298121,810820116.0,2134,2023-11-06 17:25:00
401,SBER,604,399,114047714.0,144338162.0,42058,53178,271.17,271.42,95236,258385876.0,1003,456,296,105406078.0,121860580.0,38909,44842,270.9,271.76,83751,227266658.0,752,2023-11-06 17:30:00
402,SBER,927,697,309857423.0,221410611.0,114240,81626,271.23,271.25,195866,531268035.0,1624,834,625,299975104.0,213061707.0,110616,78454,271.19,271.58,189070,513036811.0,1459,2023-11-06 17:35:00
403,SBER,1290,586,409512075.0,254993176.0,150936,93966,271.32,271.37,244902,664505251.0,1876,1025,499,366206676.0,231684343.0,135104,85339,271.06,271.49,220443,597891019.0,1524,2023-11-06 17:40:00
404,SBER,1277,1270,381790064.0,450240326.0,140686,166002,271.38,271.23,306688,832030391.0,2547,1231,1198,373523164.0,437688052.0,137748,161251,271.16,271.43,298999,811211217.0,2429,2023-11-06 17:45:00
405,SBER,1172,874,365298402.0,317020858.0,134714,116820,271.17,271.38,251534,682319260.0,2046,1075,795,333490787.0,308124166.0,123077,113505,270.96,271.46,236582,641614954.0,1870,2023-11-06 17:50:00
406,SBER,1572,846,595876344.0,302651573.0,189950,111493,313.7,271.45,301443,898527917.0,2418,1268,604,466557043.0,265221616.0,163077,97622,286.1,271.68,260699,731778660.0,1872,2023-11-06 17:55:00
407,SBER,3491,2772,1315996561.0,906456434.0,447552,331018,294.04,273.84,778570,2222452996.0,6263,2387,1942,993369395.0,772388397.0,330405,283867,300.65,272.1,614272,1765757792.0,4329,2023-11-06 18:00:00
408,SBER,6955,5835,2441498049.0,2160348842.0,881392,794073,277.0,272.06,1675465,4601846892.0,12790,5079,4594,2063612537.0,1730557690.0,757706,634373,272.35,272.8,1392079,3794170228.0,9673,2023-11-06 18:05:00
409,SBER,4209,5241,1408707520.0,1347667270.0,509773,494902,276.34,272.31,1004675,2756374791.0,9450,3827,3824,1321180681.0,1253737427.0,480324,459941,275.06,272.59,940265,2574918109.0,7651,2023-11-06 18:10:00
410,SBER,1643,926,608389438.0,300599310.0,221036,110612,275.24,271.76,331648,908988748.0,2569,1385,712,565802725.0,279449626.0,205418,102506,275.44,272.62,307924,845252352.0,2097,2023-11-06 18:15:00
411,SBER,3383,2224,1274798288.0,863187404.0,462528,316608,275.62,272.64,779136,2137985692.0,5607,2752,1847,1112397419.0,802137896.0,401336,293954,277.17,272.88,695290,1914535316.0,4599,2023-11-06 18:20:00
412,SBER,4310,3847,1832806311.0,1352034722.0,649239,493918,282.3,273.74,1143157,3184841034.0,8157,3622,2991,1662281986.0,1147509121.0,590709,419946,281.4,273.25,1010655,2809791108.0,6613,2023-11-06 18:25:00
413,SBER,6211,2687,1422234163.0,977750305.0,517156,332353,275.01,294.19,849509,2399984468.0,8898,3085,1964,1140078658.0,842596354.0,417553,286539,273.04,294.06,704092,1982675012.0,5049,2023-11-06 18:30:00
414,SBER,3488,3621,1479900403.0,1146663625.0,538554,421996,274.79,271.72,960550,2626564029.0,7109,2553,2448,1174273581.0,802271840.0,429864,293127,273.17,273.69,722991,1976545421.0,5001,2023-11-06 18:35:00
415,SBER,3982,3350,1801139681.0,1205504304.0,654773,382520,275.08,315.15,1037293,3006643985.0,7332,2928,1877,1555123845.0,806044792.0,568854,294359,273.38,273.83,863213,2361168637.0,4805,2023-11-06 18:40:00
416,SBER,7572,7552,3225087653.0,2888005821.0,1141215,1052395,282.6,274.42,2193610,6113093474.0,15124,6166,6029,2890964498.0,2475279212.0,1019964,905857,283.44,273.25,1925821,5366243711.0,12195,2023-11-07 10:05:00
417,SBER,20544,18556,10408940019.0,9425428503.0,3795301,3417346,274.26,275.81,7212647,19834368523.0,39100,18685,16805,9771066268.0,8955643425.0,3574677,3270384,273.34,273.84,6845061,18726709693.0,35490,2023-11-07 10:10:00
418,SBER,13759,11982,8244538308.0,6187695216.0,2999759,2255164,274.84,274.38,5254923,14432233524.0,25741,12789,10580,7949243986.0,5486475361.0,2899799,2000072,274.13,274.31,4899871,13435719347.0,23369,2023-11-07 10:15:00
419,SBER,8989,6928,5909785428.0,3225259882.0,2137352,1144704,276.5,281.75,3282056,9135045311.0,15917,8091,5377,5593965746.0,2960842220.0,2031029,1049790,275.43,282.04,3080819,8554807966.0,13468,2023-11-07 10:20:00
420,SBER,13665,11688,9115767988.0,6151886870.0,3325315,2211130,274.13,278.22,5536445,15267654859.0,25353,12704,10468,8849125493.0,5778232769.0,3232113,2104051,273.79,274.62,5336164,14627358262.0,23172,2023-11-07 10:25:00
421,SBER,15298,13862,10977712202.0,6420048977.0,4011826,2311666,273.63,277.72,6323492,17397761180.0,29160,14537,13040,10831453227.0,6276084029.0,3956872,2257346,273.74,278.03,6214218,17107537257.0,27577,2023-11-07 10:30:00
422,SBER,21752,34497,9799058641.0,19140044754.0,3560604,6999830,275.21,273.44,10560434,28939103396.0,56249,20896,33371,9545692846.0,18905612437.0,3474196,6916721,274.76,273.33,10390917,28451305283.0,54267,2023-11-07 10:35:00
423,SBER,10774,15914,5326805517.0,8811146967.0,1950803,3222339,273.06,273.44,5173142,14137952484.0,26688,10076,14755,5164363986.0,8705763398.0,1894185,3185048,272.64,273.33,5079233,13870127384.0,24831,2023-11-07 10:40:00
424,SBER,6660,6657,4120529799.0,4566505734.0,1504086,1658600,273.96,275.32,3162686,8687035534.0,13317,6106,5877,4007152496.0,4437005542.0,1465362,1622403,273.46,273.48,3087765,8444158038.0,11983,2023-11-07 10:45:00
425,SBER,8602,8179,5013131804.0,5404573750.0,1837505,1973419,272.82,273.87,3810924,10417705554.0,16781,8206,7634,4973844021.0,5299248122.0,1823320,1937881,272.79,273.46,3761201,10273092143.0,15840,2023-11-07 10:50:00
426,SBER,9264,10554,3726518027.0,6385956632.0,1360770,2337569,273.85,273.19,3698339,10112474659.0,19818,8844,10118,3640440604.0,6377760025.0,1334514,2302839,272.79,276.95,3637353,10018200630.0,18962,2023-11-07 10:55:00
427,SBER,4678,4932,2914395131.0,3444659507.0,1056439,1259654,275.87,273.46,2316093,6359054638.0,9610,4308,4427,2788541249.0,3371400806.0,1022944,1232927,272.6,273.45,2255871,6159942056.0,8735,2023-11-07 11:00:00
428,SBER,7580,7272,4864719375.0,4386281000.0,1785062,1595645,272.52,274.89,3380707,9251000375.0,14852,6992,6596,4660845930.0,4290345824.0,1710025,1565879,272.56,273.99,3275904,8951191755.0,13588,2023-11-07 11:05:00
429,SBER,5985,4842,3377554072.0,3117153493.0,1237502,1125603,272.93,276.93,2363105,6494707566.0,10827,5588,4460,3432291512.0,3067461148.0,1258325,1107423,272.77,276.99,2365748,6499752661.0,10048,2023-11-07 11:10:00
430,SBER,9795,6002,4398150869.0,4927597033.0,1606988,1766647,273.69,278.92,3373635,9325747902.0,15797,9089,5706,4324147922.0,4887005613.0,1580678,1751932,273.56,278.95,3332610,9211153535.0,14795,2023-11-07 11:15:00
431,SBER,3296,2751,1841183821.0,1798733411.0,674759,641948,272.87,280.2,1316707,3639917233.0,6047,2939,2535,1816985867.0,1751175947.0,665957,623574,272.84,280.83,1289531,3568161815.0,5474,2023-11-07 11:20:00
432,SBER,3473,2665,1871184630.0,1692575276.0,683262,619364,273.86,273.28,1302626,3563759907.0,6138,2999,2420,1828596543.0,1663584673.0,670660,608428,272.66,273.42,1279088,3492181216.0,5419,2023-11-07 11:25:00
433,SBER,7365,8016,3202381664.0,4536540814.0,1173853,1656972,272.81,273.79,2830825,7738922478.0,15381,6926,7777,3162910942.0,4480221888.0,1159571,1639158,272.77,273.32,2798729,7643132831.0,14703,2023-11-07 11:30:00
434,SBER,9464,9407,4500548621.0,5197157653.0,1650961,1903023,272.6,273.1,3553984,9697706274.0,18871,8927,9134,4424616709.0,5148171696.0,1623100,1877775,272.6,274.16,3500875,9572788406.0,18061,2023-11-07 11:35:00
435,SBER,6418,6555,3155786841.0,3365085479.0,1154955,1232536,273.24,273.02,2387491,6520872321.0,12973,5955,6334,3123730649.0,3333556143.0,1143278,1220707,273.23,273.08,2363985,6457286792.0,12289,2023-11-07 11:40:00
436,SBER,2609,1615,1478937477.0,1149173467.0,542398,420618,272.67,273.21,963016,2628110945.0,4224,2118,1432,1427189736.0,1100634912.0,523538,402784,272.6,273.26,926322,2527824648.0,3550,2023-11-07 11:45:00
437,SBER,2799,2150,1456753100.0,1350204792.0,534308,494249,272.64,273.18,1028557,2806957893.0,4949,2340,1994,1439642637.0,1325234580.0,528112,484894,272.6,273.3,1013006,2764877217.0,4334,2023-11-07 11:50:00
438,SBER,7946,6718,3287684246.0,3388225422.0,1203744,1227969,273.12,275.92,2431713,6675909669.0,14664,7543,6516,3237322587.0,3352624280.0,1186079,1217606,272.94,275.35,2403685,6589946867.0,14059,2023-11-07 11:55:00
439,SBER,3912,3675,2158089550.0,2219438191.0,790212,797281,273.1,278.38,1587493,4377527741.0,7587,3529,3474,2139208782.0,2174192019.0,783728,784202,272.95,277.25,1567930,4313400801.0,7003,2023-11-07 12:00:00
440,SBER,6206,4534,2293191157.0,2763904018.0,839424,992476,273.19,278.49,1831900,5057095176.0,10740,5836,4404,2266401386.0,2724469455.0,830067,982282,273.04,277.36,1812349,4990870841.0,10240,2023-11-07 12:05:00
441,SBER,4161,2256,1549568967.0,1644592838.0,567551,594181,273.03,276.78,1161732,3194161806.0,6417,2627,2046,1539445418.0,1618170324.0,563938,586487,272.98,275.91,1150425,3157615742.0,4673,2023-11-07 12:10:00
442,SBER,4310,4287,1999788621.0,2497238989.0,733078,913859,272.79,273.26,1646937,4497027610.0,8597,3886,4037,1969413001.0,2465679069.0,722072,899935,272.74,273.98,1622007,4435092070.0,7923,2023-11-07 12:15:00
443,SBER,5656,4378,2839496650.0,2286374858.0,1040728,836693,272.84,273.26,1877421,5125871508.0,10034,5290,4075,2808970391.0,2247625671.0,1029917,822453,272.74,273.28,1852370,5056596063.0,9365,2023-11-07 12:20:00
444,SBER,3133,2879,1671248889.0,1417301759.0,612446,518600,272.88,273.29,1131046,3088550649.0,6012,3002,2521,1656358270.0,1374566756.0,607309,502931,272.74,273.31,1110240,3030925027.0,5523,2023-11-07 12:25:00
445,SBER,1959,2142,1325541053.0,1490349224.0,486160,545778,272.66,273.07,1031938,2815890277.0,4101,1649,1656,1304599370.0,1442557623.0,478643,519437,272.56,277.72,998080,2747156994.0,3305,2023-11-07 12:30:00
446,SBER,24626,17880,15077574598.0,10798995185.0,5538641,3947420,272.23,273.57,9486061,25876569784.0,42506,23127,15787,14816540371.0,10527245101.0,5443063,3848024,272.21,273.58,9291087,25343785473.0,38914,2023-11-07 12:35:00
447,SBER,7176,5815,5056139022.0,3242059557.0,1857297,1189662,272.23,272.52,3046959,8298198579.0,12991,6501,5172,4868174584.0,3127839243.0,1788343,1143137,272.22,273.62,2931480,7996013828.0,11673,2023-11-07 12:40:00
448,SBER,6380,6393,3785074308.0,2935353031.0,1381693,1074518,273.94,273.18,2456211,6720427339.0,12773,5950,6085,3733732720.0,2920469375.0,1371961,1070976,272.15,272.69,2442937,6654202096.0,12035,2023-11-07 12:45:00
449,SBER,4689,4600,2659610926.0,2146082672.0,976943,787071,272.24,272.67,1764014,4805693599.0,9289,4254,4122,2644844533.0,2077186826.0,971756,761078,272.17,272.93,1732834,4722031359.0,8376,2023-11-07 12:50:00
450,SBER,2497,2516,1595472112.0,1653019286.0,586619,575050,271.98,287.46,1161669,3248491398.0,5013,2190,2186,1481763825.0,1533476059.0,544768,562180,272.0,272.77,1106948,3015239884.0,4376,2023-11-07 12:55:00
451,SBER,3204,2725,1861544613.0,1564330560.0,683849,574072,272.22,272.5,1257921,3425875173.0,5929,2898,2352,1800903171.0,1522978286.0,662011,558684,272.04,272.6,1220695,3323881458.0,5250,2023-11-07 13:00:00
452,SBER,1847,2002,971757736.0,1138249011.0,357167,414573,272.07,274.56,771740,2110006747.0,3849,1645,1664,950349274.0,1137991265.0,349397,401293,272.0,283.58,750690,2088340540.0,3309,2023-11-07 13:05:00
453,SBER,3794,2913,2016252823.0,1799459183.0,692141,659706,291.31,272.77,1351847,3815712006.0,6707,2496,2458,1914311108.0,1735368490.0,671255,636158,285.18,272.79,1307413,3649679598.0,4954,2023-11-07 13:10:00
454,SBER,1218,1055,686426959.0,673070878.0,250263,246797,274.28,272.72,497060,1359497838.0,2273,1065,807,660663215.0,651896048.0,242841,238990,272.06,272.77,481831,1312559263.0,1872,2023-11-07 13:15:00
455,SBER,2933,2918,1566701341.0,1692261005.0,572439,620355,273.69,272.79,1192794,3258962346.0,5851,2637,2653,1542044980.0,1666400944.0,562621,610576,274.08,272.92,1173197,3208445924.0,5290,2023-11-07 13:20:00
456,SBER,2241,2117,1314181598.0,1400147920.0,459437,513133,286.04,272.86,972570,2714329519.0,4358,1905,1904,1331072201.0,1368278726.0,449757,501271,295.95,272.96,951028,2699350928.0,3809,2023-11-07 13:25:00
457,SBER,2117,2862,1123420758.0,2002577631.0,402907,733498,278.83,273.02,1136405,3125998390.0,4979,1796,2590,1095705968.0,1951978566.0,402128,714781,272.48,273.09,1116909,3047684534.0,4386,2023-11-07 13:30:00
458,SBER,4218,4587,2409703020.0,3173991290.0,884980,1162406,272.29,273.05,2047386,5583694310.0,8805,3839,4452,2390735648.0,3155132104.0,878046,1155461,272.28,273.06,2033507,5545867752.0,8291,2023-11-07 13:35:00
459,SBER,4836,4005,2600286467.0,2449386288.0,954408,898216,272.45,272.69,1852624,5049672755.0,8841,4365,3809,2530080684.0,2387602042.0,929461,875344,272.21,272.76,1804805,4917682726.0,8174,2023-11-07 13:40:00
460,SBER,2486,1959,1340987820.0,1337202490.0,492614,486590,272.22,274.81,979204,2678190310.0,4445,2124,1826,1300463613.0,1258000608.0,477932,461116,272.1,272.82,939048,2558464222.0,3950,2023-11-07 13:45:00
461,SBER,4613,5049,3098022255.0,3430338063.0,1136114,1239473,272.69,276.76,2375587,6528360318.0,9662,4073,4492,2913970669.0,3033083366.0,1069446,1101998,272.47,275.23,2171444,5947054035.0,8565,2023-11-07 13:50:00
462,SBER,6200,5676,4082989020.0,3718312798.0,1492930,1359772,273.49,273.45,2852702,7801301819.0,11876,5442,5114,3759450865.0,3546389048.0,1377628,1296542,272.89,273.53,2674170,7305839913.0,10556,2023-11-07 13:55:00
463,SBER,18042,15132,10890508351.0,9264399423.0,3976887,3270312,273.85,283.29,7247199,20154907774.0,33174,16773,14017,10529876981.0,8923862461.0,3850048,3160509,273.5,282.36,7010557,19453739443.0,30790,2023-11-07 14:00:00
464,SBER,1958,2191,1425353004.0,1930887328.0,521269,685687,273.44,281.6,1206956,3356240332.0,4149,1181,1896,1280458528.0,1725421954.0,468794,608428,273.14,283.59,1077222,3005880482.0,3077,2023-11-07 14:05:00
465,SBER,7088,5289,2670250781.0,5139969325.0,978230,1850745,272.97,277.72,2828975,7810220107.0,12377,6579,5005,2590594330.0,5057590912.0,949502,1819143,272.84,278.02,2768645,7648185243.0,11584,2023-11-07 14:10:00
466,SBER,1401,1213,780731089.0,829286449.0,286106,291502,272.88,284.49,577608,1610017539.0,2614,1097,1035,762272037.0,838790028.0,279427,291929,272.8,287.33,571356,1601062066.0,2132,2023-11-07 14:15:00
467,SBER,4616,5570,1652386484.0,2304958746.0,605383,834632,272.95,276.16,1440015,3957345230.0,10186,4443,5416,1627486648.0,2276416677.0,596723,821315,272.74,277.17,1418038,3903903326.0,9859,2023-11-07 14:20:00
468,SBER,1531,1557,947860584.0,1429231019.0,347660,502716,272.64,284.3,850376,2377091603.0,3088,1346,1427,902470403.0,1063553373.0,331011,380090,272.64,279.82,711101,1966023777.0,2773,2023-11-07 14:25:00
469,SBER,3630,3695,2073046748.0,2626656951.0,761207,947281,272.34,277.28,1708488,4699703700.0,7325,3254,3488,2018822595.0,2575295072.0,741531,926731,272.25,277.89,1668262,4594117667.0,6742,2023-11-07 14:30:00
470,SBER,3160,7665,1795531213.0,4063435637.0,659138,1477589,272.41,275.0,2136727,5858966850.0,10825,2897,7494,1757918554.0,4037630685.0,645378,1465056,272.39,275.6,2110434,5795549240.0,10391,2023-11-07 14:35:00
471,SBER,2446,2493,1292451189.0,1555645082.0,475111,571275,272.03,272.31,1046386,2848096271.0,4939,2028,2250,1288207430.0,1500435617.0,473859,550358,271.85,272.63,1024217,2788643047.0,4278,2023-11-07 14:40:00
472,SBER,1768,1676,1116615204.0,1132891559.0,409715,412508,272.53,274.64,822223,2249506763.0,3444,1546,1523,1047117448.0,1105154749.0,384995,396867,271.98,278.47,781862,2152272197.0,3069,2023-11-07 14:45:00
473,SBER,3805,4698,2002247211.0,2555312542.0,733087,936973,273.13,272.72,1670060,4557559754.0,8503,3607,4556,1981695227.0,2530346401.0,725683,928080,273.08,272.64,1653763,4512041629.0,8163,2023-11-07 14:50:00
474,SBER,2129,2228,1245825158.0,1317236660.0,457722,483211,272.18,272.6,940933,2563061819.0,4357,1869,1965,1125763996.0,1272419237.0,413842,466646,272.03,272.67,880488,2398183233.0,3834,2023-11-07 14:55:00
475,SBER,5607,2988,2383683005.0,1641280897.0,874368,601217,272.62,272.99,1475585,4024963902.0,8595,5404,2793,2351024320.0,1615245090.0,863014,591639,272.42,273.01,1454653,3966269411.0,8197,2023-11-07 15:00:00
476,SBER,2410,2351,1495799503.0,1344833540.0,549236,492678,272.34,272.96,1041914,2840633043.0,4761,2328,2167,1470817229.0,1271078201.0,540113,465650,272.32,272.97,1005763,2741895431.0,4495,2023-11-07 15:05:00
477,SBER,3177,3388,1656969389.0,1988807050.0,608531,728937,272.29,272.84,1337468,3645776439.0,6565,3042,3303,1646571120.0,1995946206.0,604919,731454,272.2,272.87,1336373,3642517326.0,6345,2023-11-07 15:10:00
478,SBER,4546,6218,2349652555.0,3646300981.0,863722,1337034,272.04,272.72,2200756,5995953536.0,10764,4394,6067,2331872453.0,3639728507.0,857112,1334559,272.06,272.73,2191671,5971600961.0,10461,2023-11-07 15:15:00
479,SBER,3123,7650,1807807254.0,3761269556.0,664718,1380247,271.97,272.51,2044965,5569076810.0,10773,2888,7529,1706978218.0,3717678011.0,627607,1364138,271.98,272.53,1991745,5424656229.0,10417,2023-11-07 15:20:00
480,SBER,2693,2902,1602336776.0,1730240487.0,587699,634931,272.65,272.51,1222630,3332577264.0,5595,2452,2790,1648896275.0,1714635207.0,606215,629000,272.0,272.6,1235215,3363531482.0,5242,2023-11-07 15:25:00
481,SBER,2269,2284,1313324861.0,1147440942.0,481303,420527,272.87,272.86,901830,2460765803.0,4553,2110,2161,1279579561.0,1147198946.0,469173,420432,272.73,272.86,889605,2426778508.0,4271,2023-11-07 15:30:00
482,SBER,10005,8398,5504753017.0,4423845282.0,2018997,1619592,272.65,273.15,3638589,9928598300.0,18403,9886,8181,5443789169.0,4385381252.0,1998322,1605514,272.42,273.15,3603836,9829170422.0,18067,2023-11-07 15:35:00
483,SBER,7659,8555,4712280388.0,3921518904.0,1728548,1435765,272.61,273.13,3164313,8633799293.0,16214,7497,8378,4691483852.0,3885917163.0,1720496,1422516,272.68,273.17,3143012,8577401016.0,15875,2023-11-07 15:40:00
484,SBER,7142,6535,4237710854.0,3227797997.0,1553661,1181068,272.76,273.29,2734729,7465508852.0,13677,6985,6327,4163421162.0,3196883839.0,1526965,1169657,272.66,273.32,2696622,7360305002.0,13312,2023-11-07 15:45:00
485,SBER,2741,2410,1414380836.0,1117351737.0,518392,404354,272.84,276.33,922746,2531732573.0,5151,2621,2269,1414350176.0,1098017376.0,518457,397037,272.8,276.55,915494,2512367552.0,4890,2023-11-07 15:50:00
486,SBER,5789,3688,2753385227.0,1627866608.0,1009254,595470,272.81,273.38,1604724,4381251836.0,9477,4304,3573,2703024741.0,1614141792.0,990799,590425,272.81,273.39,1581224,4317166533.0,7877,2023-11-07 15:55:00
487,SBER,8494,9024,5290364426.0,3000184482.0,1937771,1097638,273.01,273.33,3035409,8290548909.0,17518,8401,8890,5284738655.0,2944078298.0,1935793,1076967,273.0,273.37,3012760,8228816954.0,17291,2023-11-07 16:00:00
488,SBER,5452,5146,2906547273.0,2272520687.0,1065141,831546,272.88,273.29,1896687,5179067961.0,10598,5360,5039,2887745996.0,2244571726.0,1058263,821076,272.88,273.37,1879339,5132317722.0,10399,2023-11-07 16:05:00
489,SBER,2736,2484,1562064098.0,1379807486.0,568754,497740,274.65,277.21,1066494,2941871585.0,5220,2623,2361,1548013329.0,1347697301.0,567625,488908,272.72,275.65,1056533,2895710631.0,4984,2023-11-07 16:10:00
490,SBER,2560,3068,1358587309.0,1238627246.0,498431,453347,272.57,273.22,951778,2597214556.0,5628,2455,2951,1341877996.0,1216587272.0,492317,445227,272.56,273.25,937544,2558465268.0,5406,2023-11-07 16:15:00
491,SBER,4461,4180,2604285388.0,1767794705.0,954999,647054,272.7,273.21,1602053,4372080094.0,8641,4403,4068,2594625702.0,1735256902.0,951508,634964,272.69,273.28,1586472,4329882605.0,8471,2023-11-07 16:20:00
492,SBER,1813,1944,772182949.0,1110976460.0,283409,407053,272.46,272.93,690462,1883159409.0,3757,1582,1856,760364381.0,1051963384.0,279123,385268,272.41,273.05,664391,1812327765.0,3438,2023-11-07 16:25:00
493,SBER,1415,1331,741587394.0,899922925.0,272135,329747,272.51,272.91,601882,1641510320.0,2746,1251,1261,708219242.0,889632728.0,260018,325930,272.37,272.95,585948,1597851970.0,2512,2023-11-07 16:30:00
494,SBER,2436,1366,1334792601.0,702297614.0,489414,255139,272.73,275.26,744553,2037090216.0,3802,2306,1272,1308014187.0,690051253.0,479802,252570,272.62,273.21,732372,1998065441.0,3578,2023-11-07 16:35:00
495,SBER,2234,1668,1324766311.0,733470908.0,485665,268364,272.77,273.31,754029,2058237219.0,3902,2132,1581,1298979072.0,714146522.0,476324,261275,272.71,273.33,737599,2013125594.0,3713,2023-11-07 16:40:00
496,SBER,1766,1304,1201552657.0,941998784.0,440118,344472,273.01,273.46,784590,2143551442.0,3070,1552,1183,1160956227.0,923272710.0,425667,337607,272.74,273.48,763274,2084228937.0,2735,2023-11-07 16:45:00
497,SBER,4723,2666,1930949728.0,1064245864.0,707559,389257,272.9,273.4,1096816,2995195592.0,7389,4579,2499,1906235680.0,1062464668.0,698765,388513,272.8,273.47,1087278,2968700348.0,7078,2023-11-07 16:50:00
498,SBER,2152,1583,1308345317.0,1039567093.0,476245,376003,274.72,276.48,852248,2347912411.0,3735,1807,1356,1235542768.0,1003289174.0,450132,362578,274.48,276.71,812710,2238831942.0,3163,2023-11-07 16:55:00
499,SBER,3667,4876,2405269183.0,2811114699.0,872021,1027125,275.83,273.69,1899146,5216383882.0,8543,3212,4487,2275567716.0,2709227055.0,832767,989392,273.25,273.83,1822159,4984794772.0,7699,2023-11-07 17:00:00
500,SBER,2381,2279,1586535603.0,1628834484.0,577591,572715,274.68,284.41,1150306,3215370087.0,4660,2022,1959,1473233364.0,1463590584.0,536430,534146,274.64,274.01,1070576,2936823948.0,3981,2023-11-07 17:05:00
501,SBER,2392,1909,1559552360.0,1272638931.0,570749,465071,273.25,273.64,1035820,2832191291.0,4301,2189,1695,1543174728.0,1218292954.0,564879,444813,273.19,273.89,1009692,2761467683.0,3884,2023-11-07 17:10:00
502,SBER,2677,10443,1229439483.0,5831633497.0,450066,2133090,273.17,273.39,2583156,7061072980.0,13120,2473,10309,1190491778.0,5758589914.0,435838,2105809,273.15,273.46,2541647,6949081693.0,12782,2023-11-07 17:15:00
503,SBER,2063,1482,998564505.0,854915714.0,365518,312236,273.19,273.8,677754,1853480220.0,3545,1774,1335,940112546.0,827632816.0,344273,302242,273.07,273.83,646515,1767745363.0,3109,2023-11-07 17:20:00
504,SBER,9711,4431,3563810020.0,2667523075.0,1301488,974018,273.83,273.87,2275506,6231333095.0,14142,9192,3997,3384429784.0,2597868198.0,1237006,948239,273.6,273.97,2185245,5982297983.0,13189,2023-11-07 17:25:00
505,SBER,3383,2881,1428265855.0,1184994557.0,520470,419987,274.42,282.15,940457,2613260413.0,6264,2965,2564,1323912697.0,1104407976.0,483754,393726,273.67,280.5,877480,2428320674.0,5529,2023-11-07 17:30:00
506,SBER,2130,2498,864910958.0,992262458.0,316016,353428,273.69,280.75,669444,1857173417.0,4628,1922,2272,831627253.0,934286852.0,304323,336263,273.27,277.84,640586,1765914105.0,4194,2023-11-07 17:35:00
507,SBER,1912,2162,666122938.0,1121503380.0,243473,405046,273.59,276.88,648519,1787626318.0,4074,1717,1976,650977586.0,1080537422.0,238071,394242,273.44,274.08,632313,1731515009.0,3693,2023-11-07 17:40:00
508,SBER,4277,3890,1633782585.0,3099808864.0,597212,1127530,273.57,274.92,1724742,4733591450.0,8167,4104,3755,1611812064.0,3061731822.0,589274,1117938,273.53,273.87,1707212,4673543887.0,7859,2023-11-07 17:45:00
509,SBER,6140,5196,2899302191.0,3165854782.0,1051178,1162352,275.81,272.37,2213530,6065156974.0,11336,5424,5011,2741046868.0,2917524003.0,1003027,1065655,273.28,273.78,2068682,5658570872.0,10435,2023-11-07 17:50:00
510,SBER,2401,1764,946700268.0,859591244.0,332825,312247,284.44,275.29,645072,1806291512.0,4165,2113,1585,841026864.0,819205252.0,307095,299117,273.87,273.87,606212,1660232116.0,3698,2023-11-07 17:55:00
511,SBER,3176,7115,1470188683.0,5138741393.0,534430,1863096,275.09,275.82,2397526,6608930076.0,10291,2849,6928,1451558780.0,5185924540.0,525241,1876930,276.36,276.3,2402171,6637483320.0,9777,2023-11-07 18:00:00
512,SBER,2861,1960,1173504178.0,1007354598.0,422114,367462,278.01,274.14,789576,2180858777.0,4821,2496,1786,1096376883.0,969609610.0,400696,350409,273.62,276.71,751105,2065986493.0,4282,2023-11-07 18:05:00
513,SBER,1595,1719,453945609.0,1056767544.0,165794,379347,273.8,278.58,545141,1510713154.0,3314,1385,1576,436884759.0,1057676679.0,158783,375687,275.15,281.53,534470,1494561438.0,2961,2023-11-07 18:10:00
514,SBER,2981,2429,1248442617.0,1326354511.0,453138,484233,275.51,273.91,937371,2574797128.0,5410,2160,2126,1064766622.0,1247313224.0,386540,454677,275.46,274.33,841217,2312079847.0,4286,2023-11-07 18:15:00
515,SBER,3255,4930,1053315914.0,1984479597.0,382333,720630,275.5,275.38,1102963,3037795512.0,8185,2957,4632,1013307410.0,2502833533.0,366436,889965,276.53,281.23,1256401,3516140943.0,7589,2023-11-07 18:20:00
516,SBER,3008,2368,1354073073.0,1025011924.0,492481,373695,274.95,274.29,866176,2379084998.0,5376,2744,2116,1251141842.0,984063847.0,456839,358512,273.87,274.49,815351,2235205689.0,4860,2023-11-07 18:25:00
517,SBER,5273,5122,2170397927.0,3059150271.0,791229,1106124,274.31,276.56,1897353,5229548198.0,10395,4058,4781,2036938812.0,3025738035.0,744580,1080100,273.57,280.13,1824680,5062676847.0,8839,2023-11-07 18:30:00
518,SBER,7087,13382,3075920077.0,5011909179.0,1116615,1826668,275.47,274.37,2943283,8087829256.0,20469,6019,12822,2744381884.0,4812000400.0,1001678,1753468,273.98,274.43,2755146,7556382284.0,18841,2023-11-07 18:35:00
519,SBER,3368,2044,1052167865.0,1494330631.0,383523,534020,274.34,279.83,917543,2546498496.0,5412,3116,1777,1105285016.0,1365825545.0,403421,497732,273.98,274.41,901153,2471110561.0,4893,2023-11-07 18:40:00
520,SBER,15339,12676,6218154200.0,4975437966.0,2267007,1807273,274.29,275.3,4074280,11193592167.0,28015,14195,11608,5817283114.0,4659972963.0,2125623,1702028,273.67,273.79,3827651,10477256078.0,25803,2023-11-08 10:05:00
521,SBER,14339,9151,6452112484.0,3595955399.0,2337465,1288902,276.03,278.99,3626367,10048067884.0,23490,13297,8303,6181312513.0,3315756957.0,2258316,1205779,273.71,274.99,3464095,9497069470.0,21600,2023-11-08 10:10:00
522,SBER,7947,7120,3460771540.0,3167642826.0,1228429,1137748,281.72,278.41,2366177,6628414366.0,15067,7251,6464,3282805516.0,2956558867.0,1174707,1079426,279.46,273.9,2254133,6239364384.0,13715,2023-11-08 10:15:00
523,SBER,4518,3552,1886378870.0,1586538805.0,684538,576122,275.57,275.38,1260660,3472917675.0,8070,3637,3021,1752069021.0,1489915065.0,638547,543768,274.38,274.0,1182315,3241984086.0,6658,2023-11-08 10:20:00
524,SBER,6636,5521,4940141035.0,4550264631.0,1803208,1660836,273.96,273.97,3464044,9490405667.0,12157,6149,5047,4824111071.0,4408616815.0,1761685,1608509,273.84,274.08,3370194,9232727887.0,11196,2023-11-08 10:25:00
525,SBER,6620,6836,4304459224.0,4229415618.0,1558535,1542421,276.19,274.21,3100956,8533874842.0,13456,6012,6140,4146406748.0,4088759502.0,1502779,1490439,275.92,274.33,2993218,8235166251.0,12152,2023-11-08 10:30:00
526,SBER,9013,8538,7513590588.0,7400015233.0,2724035,2686567,275.83,275.45,5410602,14913605822.0,17551,8639,8006,7404073147.0,7279976990.0,2700951,2653918,274.13,274.31,5354869,14684050138.0,16645,2023-11-08 10:35:00
527,SBER,10403,6662,6220425416.0,4062033376.0,2183360,1457961,284.9,278.61,3641321,10282458793.0,17065,9488,5723,5936095881.0,3860107654.0,2091562,1387195,283.81,278.27,3478757,9796203536.0,15211,2023-11-08 10:40:00
528,SBER,11627,10735,10188611045.0,7460538038.0,3464372,2664138,294.1,280.04,6128510,17649149083.0,22362,9878,8393,9110772139.0,6825714538.0,3106863,2459189,293.25,277.56,5566052,15936486678.0,18271,2023-11-08 10:45:00
529,SBER,14532,12167,9033919875.0,8079252772.0,3266152,2862761,276.59,282.22,6128913,17113172647.0,26699,12894,10584,8606035818.0,7666346078.0,3126381,2755601,275.27,278.21,5881982,16272381897.0,23478,2023-11-08 10:50:00
530,SBER,8961,9438,4660886662.0,6207549779.0,1695922,2250496,274.83,275.83,3946418,10868436442.0,18399,8123,8613,4505720889.0,5942989891.0,1639890,2154172,274.76,275.88,3794062,10448710780.0,16736,2023-11-08 10:55:00
531,SBER,6575,5933,3737443802.0,3681231255.0,1350401,1337435,276.77,275.25,2687836,7418675057.0,12508,5879,4872,3600259209.0,3552806887.0,1307182,1289404,275.42,275.54,2596586,7153066097.0,10751,2023-11-08 11:00:00
532,SBER,6788,5448,3908711120.0,3596662758.0,1410709,1294497,277.07,277.84,2705206,7505373879.0,12236,6216,4728,3798158308.0,3453347023.0,1381474,1243301,274.94,277.76,2624775,7251505331.0,10944,2023-11-08 11:05:00
533,SBER,4758,3961,3240784587.0,2768317853.0,1146549,970782,282.66,285.16,2117331,6009102441.0,8719,4091,3342,3030827558.0,2621632768.0,1071541,931221,282.85,281.53,2002762,5652460326.0,7433,2023-11-08 11:10:00
534,SBER,7228,6740,4323628890.0,4415848338.0,1566956,1566376,275.93,281.91,3133332,8739477229.0,13968,6408,5819,4125203944.0,4267467419.0,1496650,1496610,275.63,285.14,2993260,8392671364.0,12227,2023-11-08 11:15:00
535,SBER,15302,13540,10289578534.0,8674613657.0,3718232,3124003,276.73,277.68,6842235,18964192191.0,28842,11678,11299,9500875714.0,8084562590.0,3440594,2909095,276.14,277.91,6349689,17585438305.0,22977,2023-11-08 11:20:00
536,SBER,17030,14198,9813411430.0,9756423476.0,3523318,3502370,278.53,278.57,7025688,19569834907.0,31228,11137,11595,9145677944.0,9227585233.0,3298608,3329931,277.26,277.11,6628539,18373263177.0,22732,2023-11-08 11:25:00
537,SBER,12838,12752,8046396057.0,8697743217.0,2844638,3115548,282.86,279.17,5960186,16744139275.0,25590,10600,10890,7531610329.0,7999896146.0,2692095,2868184,279.77,278.92,5560279,15531506476.0,21490,2023-11-08 11:30:00
538,SBER,9374,9066,5604646807.0,6218206416.0,2022514,2239208,277.11,277.7,4261722,11822853223.0,18440,7493,8013,5289158322.0,5909479571.0,1909735,2126193,276.96,277.94,4035928,11198637893.0,15506,2023-11-08 11:35:00
539,SBER,12066,14027,5974095430.0,9014659781.0,2155778,3256369,277.12,276.83,5412147,14988755211.0,26093,9467,13098,5684506483.0,8711415393.0,2051052,3144199,277.15,277.06,5195251,14395921877.0,22565,2023-11-08 11:40:00
540,SBER,16603,15627,5317168588.0,8088335478.0,1921987,2920766,276.65,276.93,4842753,13405504067.0,32230,10903,15020,5089746688.0,7883163394.0,1840373,2844911,276.56,277.1,4685284,12972910082.0,25923,2023-11-08 11:45:00
541,SBER,11901,8009,5953176628.0,5911852641.0,2119110,2131109,280.93,277.41,4250219,11865029270.0,19910,6342,5930,5430789723.0,5710219359.0,1952250,2057622,278.18,277.52,4009872,11141009082.0,12272,2023-11-08 11:50:00
542,SBER,12287,11067,6696343557.0,7865597729.0,2379185,2778865,281.46,283.05,5158050,14561941287.0,23354,8271,9329,6371260996.0,7416325585.0,2284626,2633571,278.88,281.61,4918197,13787586581.0,17600,2023-11-08 11:55:00
543,SBER,11866,8040,5025234442.0,5495892069.0,1789563,1976584,280.81,278.05,3766147,10521126512.0,19906,6614,6971,4804131135.0,5192506522.0,1705561,1863406,281.67,278.66,3568967,9996637657.0,13585,2023-11-08 12:00:00
544,SBER,15995,12133,5915764822.0,10485835275.0,2102175,3754147,281.41,279.31,5856322,16401600098.0,28128,11935,11334,5678228929.0,10290608374.0,2046939,3683178,277.4,279.39,5730117,15968837303.0,23269,2023-11-08 12:05:00
545,SBER,9934,7563,4394120865.0,5142249891.0,1496298,1846445,293.67,278.49,3342743,9536370756.0,17497,5889,6827,4217313973.0,4952852866.0,1435697,1777932,293.75,278.57,3213629,9170166840.0,12716,2023-11-08 12:10:00
546,SBER,8612,8691,4478500864.0,6121005089.0,1529641,2184075,292.78,280.26,3713716,10599505953.0,17303,7061,7872,4220731658.0,5873977363.0,1465367,2102665,288.03,279.36,3568032,10094709021.0,14933,2023-11-08 12:15:00
547,SBER,6379,6398,4276042561.0,4535332869.0,1473956,1634816,290.11,277.42,3108772,8811375431.0,12777,5435,5701,4035770339.0,4343544242.0,1390008,1565800,290.34,277.4,2955808,8379314581.0,11136,2023-11-08 12:20:00
548,SBER,4632,5920,2543267842.0,3929328387.0,918764,1417117,276.81,277.28,2335881,6472596229.0,10552,3940,5339,2498012061.0,3795009771.0,902612,1368272,276.75,277.36,2270884,6293021833.0,9279,2023-11-08 12:25:00
549,SBER,4026,5303,2647665007.0,3783493344.0,940521,1365471,281.51,277.08,2305992,6431158352.0,9329,3364,4644,2461483271.0,3639541012.0,888783,1313225,276.95,277.15,2202008,6101024283.0,8008,2023-11-08 12:30:00
550,SBER,5376,6486,3715532658.0,4246990110.0,1329744,1525976,279.42,278.31,2855720,7962522769.0,11862,4689,5678,3588558668.0,4129423825.0,1281272,1485649,280.08,277.95,2766921,7717982493.0,10367,2023-11-08 12:35:00
551,SBER,8775,9890,5281341978.0,5819036225.0,1902632,2099434,277.58,277.17,4002066,11100378204.0,18665,8045,9227,5148109964.0,5683483285.0,1855126,2046944,277.51,277.66,3902070,10831593249.0,17272,2023-11-08 12:40:00
552,SBER,4550,12295,2818738355.0,4223762838.0,1006733,1526102,279.99,276.77,2532835,7042501194.0,16845,3947,11728,2675035282.0,4100587423.0,955327,1479057,280.01,277.24,2434384,6775622705.0,15675,2023-11-08 12:45:00
553,SBER,3235,2935,1859235675.0,1762256495.0,661295,635519,281.15,277.29,1296814,3621492170.0,6170,2728,2448,1776101488.0,1716058827.0,641800,618719,276.74,277.36,1260519,3492160316.0,5176,2023-11-08 12:50:00
554,SBER,3813,4056,2309266058.0,2345543265.0,833309,841130,277.12,278.86,1674439,4654809323.0,7869,3204,3533,2229721823.0,2259034640.0,801234,811786,278.29,278.28,1613020,4488756463.0,6737,2023-11-08 12:55:00
555,SBER,2875,2723,1793948779.0,1932929026.0,616918,688839,290.79,280.61,1305757,3726877806.0,5598,2349,2268,1726296854.0,1851422699.0,598341,659726,288.51,280.64,1258067,3577719554.0,4617,2023-11-08 13:00:00
556,SBER,3583,4699,2263008773.0,2747986225.0,806872,990713,280.47,277.37,1797585,5010994998.0,8282,3066,4137,2173628882.0,2681694155.0,784602,966086,277.04,277.58,1750688,4855323037.0,7203,2023-11-08 13:05:00
557,SBER,2263,2583,1549484525.0,1804583232.0,559010,650445,277.18,277.44,1209455,3354067758.0,4846,1727,1999,1530172869.0,1747294833.0,552466,629435,276.97,277.6,1181901,3277467703.0,3726,2023-11-08 13:10:00
558,SBER,3054,3541,2080894599.0,2274864005.0,751299,820588,276.97,277.22,1571887,4355758604.0,6595,2501,2290,2022577220.0,2173617526.0,730441,783275,276.9,277.5,1513716,4196194747.0,4791,2023-11-08 13:15:00
559,SBER,4777,4949,2854633364.0,3305196912.0,1028960,1191686,277.43,277.35,2220646,6159830277.0,9726,4134,4478,2751649713.0,3231307261.0,992378,1164541,277.28,277.47,2156919,5982956975.0,8612,2023-11-08 13:20:00
560,SBER,4660,5731,2859019419.0,3978039464.0,1031709,1433872,277.11,277.43,2465581,6837058884.0,10391,3966,5379,2789849976.0,3915831941.0,1007602,1411244,276.88,277.47,2418846,6705681917.0,9345,2023-11-08 13:25:00
561,SBER,5109,5154,2854120038.0,3350146611.0,1030121,1207211,277.07,277.51,2237332,6204266649.0,10263,4493,4815,2822114060.0,3291229800.0,1019152,1185715,276.91,277.57,2204867,6113343860.0,9308,2023-11-08 13:30:00
562,SBER,6673,5819,3625286669.0,3802589010.0,1308936,1371784,276.96,277.2,2680720,7427875679.0,12492,5873,5374,3509291408.0,3690372876.0,1267599,1330152,276.85,277.44,2597751,7199664284.0,11247,2023-11-08 13:35:00
563,SBER,16946,21646,9475071800.0,12884959019.0,3422518,4652058,276.85,276.97,8074576,22360030819.0,38592,15984,21108,9395157385.0,12744791723.0,3395909,4599341,276.66,277.1,7995250,22139949109.0,37092,2023-11-08 13:40:00
564,SBER,4495,6427,2779419414.0,4650793642.0,995676,1680167,279.15,276.81,2675843,7430213056.0,10922,3701,6112,2668221368.0,4578087747.0,956170,1653223,279.05,276.92,2609393,7246309116.0,9813,2023-11-08 13:45:00
565,SBER,6641,8267,3381182276.0,4564378326.0,1222321,1647351,276.62,277.07,2869672,7945560603.0,14908,5800,6971,3321332436.0,4516009444.0,1201390,1629811,276.46,277.09,2831201,7837341880.0,12771,2023-11-08 13:50:00
566,SBER,5982,7194,3225581023.0,4761227644.0,1164737,1717746,276.94,277.18,2882483,7986808667.0,13176,5283,6776,3133788327.0,4672940027.0,1133400,1685880,276.49,277.18,2819280,7806728355.0,12059,2023-11-08 13:55:00
567,SBER,4067,6296,2469066971.0,3940962779.0,892515,1415335,276.64,278.45,2307850,6410029750.0,10363,3669,6097,2430846869.0,3924218942.0,878868,1408658,276.59,278.58,2287526,6355065811.0,9766,2023-11-08 14:00:00
568,SBER,3163,2553,4618903804.0,2812630956.0,1669933,1014723,276.59,277.18,2684656,7431534761.0,5716,2707,2403,4556048240.0,2796582150.0,1647333,1008823,276.57,277.21,2656156,7352630391.0,5110,2023-11-08 14:05:00
569,SBER,4333,4319,2583772219.0,2579648660.0,933488,930407,276.79,277.26,1863895,5163420879.0,8652,3734,4031,2474975062.0,2505771480.0,894398,903678,276.72,277.29,1798076,4980746542.0,7765,2023-11-08 14:10:00
570,SBER,2419,2396,1432424607.0,1489678179.0,517272,537131,276.92,277.34,1054403,2922102787.0,4815,2045,2165,1423874830.0,1446312499.0,513792,521291,277.13,277.45,1035083,2870187329.0,4210,2023-11-08 14:15:00
571,SBER,4363,3013,2377566320.0,2147407131.0,856626,773774,277.55,277.52,1630400,4524973452.0,7376,3103,2730,2234814503.0,2100707622.0,806741,756679,277.02,277.62,1563420,4335522126.0,5833,2023-11-08 14:20:00
572,SBER,5991,3731,2879256553.0,2618059649.0,1038349,925642,277.29,282.84,1963991,5497316202.0,9722,4451,3372,2821706029.0,1906500589.0,1018072,686546,277.16,277.69,1704618,4728206618.0,7823,2023-11-08 14:25:00
573,SBER,3449,2403,2074776112.0,1987609679.0,747237,715289,277.66,277.88,1462526,4062385791.0,5852,2422,1999,1886233304.0,1880813841.0,680594,676634,277.15,277.97,1357228,3767047145.0,4421,2023-11-08 14:30:00
574,SBER,8505,6732,4900835873.0,4429965988.0,1766188,1594652,277.48,277.8,3360840,9330801862.0,15237,6799,6217,4810121955.0,4346985262.0,1734537,1563928,277.31,277.95,3298465,9157107218.0,13016,2023-11-08 14:35:00
575,SBER,8841,7131,4562054833.0,4748466556.0,1645849,1709776,277.19,277.72,3355625,9310521390.0,15972,7181,6836,4495801853.0,4613996126.0,1621959,1660934,277.18,277.8,3282893,9109797979.0,14017,2023-11-08 14:40:00
576,SBER,4544,4738,2722750824.0,2835592992.0,982340,1021389,277.17,277.62,2003729,5558343816.0,9282,4180,4502,2617744222.0,2774113731.0,944870,998996,277.05,277.69,1943866,5391857953.0,8682,2023-11-08 14:45:00
577,SBER,10925,6660,3096777242.0,3678147078.0,1117935,1325527,277.01,277.49,2443462,6774924320.0,17585,6013,6376,3051843103.0,3635790385.0,1101819,1309786,276.98,277.59,2411605,6687633488.0,12389,2023-11-08 14:50:00
578,SBER,6270,6882,2468990890.0,3049270502.0,881624,1099170,280.05,277.42,1980794,5518261392.0,13152,5936,6644,2403200069.0,3033442850.0,857941,1093198,280.11,277.48,1951139,5436642919.0,12580,2023-11-08 14:55:00
579,SBER,7155,13952,2728995632.0,5141126012.0,983577,1856412,277.46,276.94,2839989,7870121645.0,21107,6659,13646,2661983621.0,5067847047.0,961986,1827989,276.72,277.24,2789975,7729830669.0,20305,2023-11-08 15:00:00
580,SBER,6810,5665,2850478009.0,4341346500.0,1029193,1565434,276.96,277.33,2594627,7191824509.0,12475,6437,5418,2795929054.0,4291292695.0,1009816,1547165,276.88,277.36,2556981,7087221750.0,11855,2023-11-08 15:05:00
581,SBER,6555,4193,2956541683.0,3148853004.0,1065844,1130378,277.39,278.57,2196222,6105394687.0,10748,6330,3976,2937598888.0,3079647580.0,1059078,1109827,277.37,277.49,2168905,6017246468.0,10306,2023-11-08 15:10:00
582,SBER,4492,2774,2402959988.0,2116294699.0,866933,762905,277.18,277.4,1629838,4519254687.0,7266,4175,2576,2320638574.0,2094355688.0,837765,754904,277.0,277.43,1592669,4414994262.0,6751,2023-11-08 15:15:00
583,SBER,4207,5202,2073297714.0,3071494279.0,748901,1107912,276.85,277.23,1856813,5144791994.0,9409,3978,4979,2057024137.0,3008575997.0,743130,1084494,276.81,277.42,1827624,5065600135.0,8957,2023-11-08 15:20:00
584,SBER,3800,3633,2039157826.0,2283716698.0,705307,823323,289.12,277.38,1528630,4322874524.0,7433,2687,3373,1997331891.0,2183773238.0,690734,786730,289.16,277.58,1477464,4181105130.0,6060,2023-11-08 15:25:00
585,SBER,3483,3646,1893114381.0,1935304107.0,663222,696406,285.44,277.9,1359628,3828418489.0,7129,2634,3315,1857903155.0,1848517489.0,645152,665217,287.98,277.88,1310369,3706420644.0,5949,2023-11-08 15:30:00
586,SBER,5804,5095,3175743221.0,3171681556.0,1145689,1143341,277.19,277.4,2289030,6347424777.0,10899,5414,4842,3121814573.0,3093517004.0,1126420,1113777,277.14,277.75,2240197,6215331577.0,10256,2023-11-08 15:35:00
587,SBER,5527,5956,2881895198.0,3674091240.0,1040600,1324318,276.95,277.43,2364918,6555986439.0,11483,5156,5744,2838708151.0,3640975952.0,1025110,1311778,276.92,277.56,2336888,6479684103.0,10900,2023-11-08 15:40:00
588,SBER,9664,4051,4574945792.0,2325038139.0,1648874,837423,277.46,277.64,2486297,6899983932.0,13715,9135,3838,4527121812.0,2302301302.0,1632316,829176,277.34,277.66,2461492,6829423114.0,12973,2023-11-08 15:45:00
589,SBER,12615,36283,4113901899.0,13149979257.0,1484023,4734899,277.21,277.72,6218922,17263881156.0,48898,12076,35976,4065565536.0,13072242368.0,1467263,4706556,277.08,277.75,6173819,17137807905.0,48052,2023-11-08 15:50:00
590,SBER,4045,5331,2329207023.0,3136320313.0,840918,1131003,276.98,277.3,1971921,5465527336.0,9376,3477,5031,2284714651.0,3081736555.0,825385,1110884,276.81,277.41,1936269,5366451207.0,8508,2023-11-08 15:55:00
591,SBER,7396,9687,3580892812.0,5373986073.0,1293000,1937698,276.94,277.34,3230698,8954878886.0,17083,6871,9318,3487583311.0,5327835729.0,1259979,1920752,276.8,277.38,3180731,8815419040.0,16189,2023-11-08 16:00:00
592,SBER,6140,8741,3298015650.0,5586123839.0,1191156,2015320,276.88,277.18,3206476,8884139489.0,14881,5581,8317,3246883531.0,5519419377.0,1173547,1990691,276.67,277.26,3164238,8766302908.0,13898,2023-11-08 16:05:00
593,SBER,12555,12073,5347858719.0,6554057212.0,1929452,2361053,277.17,277.59,4290505,11901915932.0,24628,12035,11728,5215037572.0,6506392312.0,1882476,2343887,277.03,277.59,4226363,11721429884.0,23763,2023-11-08 16:10:00
594,SBER,3274,3580,2337547247.0,2402716055.0,841946,864843,277.64,277.82,1706789,4740263302.0,6854,2675,3101,2251244335.0,2341472073.0,811744,842586,277.33,277.89,1654330,4592716408.0,5776,2023-11-08 16:15:00
595,SBER,3860,3003,2224231815.0,1897445552.0,801178,682646,277.62,277.95,1483824,4121677368.0,6863,3323,2608,2183915979.0,1833683350.0,787227,659856,277.42,277.89,1447083,4017599330.0,5931,2023-11-08 16:20:00
596,SBER,6133,6800,3821036845.0,3579121685.0,1377239,1288679,277.44,277.74,2665918,7400158530.0,12933,5599,6418,3767432931.0,3513110447.0,1358354,1264533,277.35,277.82,2622887,7280543379.0,12017,2023-11-08 16:25:00
597,SBER,4073,4174,2305059394.0,2504890422.0,806008,901900,285.98,277.73,1707908,4809949816.0,8247,3498,3880,2216226076.0,2472245053.0,781512,890008,283.58,277.78,1671520,4688471129.0,7378,2023-11-08 16:30:00
598,SBER,9301,10960,5995186454.0,6760289733.0,2130732,2422402,281.37,279.07,4553134,12755476187.0,20261,8162,9812,5596776864.0,6540192716.0,1993064,2351586,280.81,278.12,4344650,12136969580.0,17974,2023-11-08 16:35:00
599,SBER,11052,15572,7229628779.0,8734348505.0,2608076,3150321,277.2,277.25,5758397,15963977285.0,26624,10147,14853,7048237298.0,8541085892.0,2543696,3078091,277.09,277.48,5621787,15589323191.0,25000,2023-11-08 16:40:00
600,SBER,11293,14076,5910207000.0,7232744620.0,2133310,2607300,277.04,277.4,4740610,13142951621.0,25369,10655,13592,5814839254.0,7167147138.0,2099970,2583384,276.9,277.43,4683354,12981986392.0,24247,2023-11-08 16:45:00
601,SBER,7268,9882,4251715419.0,5151251477.0,1534548,1856658,277.07,277.45,3391206,9402966897.0,17150,6671,9543,4196927133.0,5061385562.0,1515414,1824089,276.95,277.47,3339503,9258312696.0,16214,2023-11-08 16:50:00
602,SBER,4743,6182,2899688438.0,3659893041.0,1046511,1320096,277.08,277.24,2366607,6559581480.0,10925,4212,5848,2842803823.0,3547260211.0,1026641,1278506,276.9,277.45,2305147,6390064035.0,10060,2023-11-08 16:55:00
603,SBER,3011,3384,1977842083.0,2377865510.0,715007,860347,276.62,276.38,1575354,4355707593.0,6395,2504,2977,1912820979.0,2190673453.0,689283,790257,277.51,277.21,1479540,4103494432.0,5481,2023-11-08 17:00:00
604,SBER,3557,4714,2112911092.0,2719981015.0,761760,981041,277.37,277.25,1742801,4832892107.0,8271,3300,4217,2046545110.0,2623362798.0,740139,905953,276.51,289.57,1646092,4669907908.0,7517,2023-11-08 17:05:00
605,SBER,6150,5951,3761551927.0,2793144566.0,1358930,1008566,276.8,276.94,2367496,6554696493.0,12101,5767,5628,3672611789.0,2748747824.0,1327888,992088,276.58,277.07,2319976,6421359613.0,11395,2023-11-08 17:10:00
606,SBER,3042,3236,1845854918.0,1311573096.0,666570,473037,276.92,277.27,1139607,3157428014.0,6278,2878,3027,1839410956.0,1261220687.0,664457,454835,276.83,277.29,1119292,3100631644.0,5905,2023-11-08 17:15:00
607,SBER,2310,2369,1311096785.0,980679340.0,473658,352756,276.8,278.01,826414,2291776125.0,4679,2045,2134,1284349022.0,964788146.0,464748,346759,276.35,278.23,811507,2249137168.0,4179,2023-11-08 17:20:00
608,SBER,3762,3733,1986828905.0,1904892668.0,718364,687713,276.58,276.99,1406077,3891721573.0,7495,3536,3435,2085918861.0,1850208001.0,699157,667429,298.35,277.21,1366586,3936126862.0,6971,2023-11-08 17:25:00
609,SBER,4531,3789,2377198013.0,1312559537.0,858988,473746,276.74,277.06,1332734,3689757551.0,8320,4291,3611,2385830448.0,1283926751.0,862417,463266,276.64,277.15,1325683,3669757199.0,7902,2023-11-08 17:30:00
610,SBER,8120,12067,2623697600.0,4534862966.0,948022,1637290,276.75,276.97,2585312,7158560567.0,20187,7929,11899,2589065826.0,4526353993.0,935874,1634004,276.65,277.01,2569878,7115419819.0,19828,2023-11-08 17:35:00
611,SBER,3305,3250,1610260711.0,1519760851.0,581344,549745,276.99,276.45,1131089,3130021562.0,6555,2957,3038,1516340765.0,1449063018.0,548518,523060,276.44,277.04,1071578,2965403784.0,5995,2023-11-08 17:40:00
612,SBER,3077,4046,1559756849.0,1790671187.0,562994,645593,277.05,277.37,1208587,3350428037.0,7123,2823,3770,1513291260.0,1726788777.0,546808,622457,276.75,277.41,1169265,3240080037.0,6593,2023-11-08 17:45:00
613,SBER,3061,2793,1158901060.0,938449369.0,418073,338022,277.2,277.63,756095,2097350429.0,5854,2807,2538,1070170430.0,830750965.0,386157,299108,277.13,277.74,685265,1900921395.0,5345,2023-11-08 17:50:00
614,SBER,3353,2853,1854303374.0,1145230403.0,668282,412373,277.47,277.72,1080655,2999533777.0,6206,3076,2533,1774391256.0,1730607826.0,640016,605213,277.24,285.95,1245229,3504999082.0,5609,2023-11-08 17:55:00
615,SBER,13629,6157,6059844767.0,2802579907.0,2173420,1008804,278.82,277.81,3182224,8862424675.0,19786,12821,5167,5649445141.0,2483711260.0,2032453,891991,277.96,278.45,2924444,8133156402.0,17988,2023-11-08 18:00:00
616,SBER,9716,8853,4223536586.0,4181053039.0,1513949,1505144,278.97,277.78,3019093,8404589625.0,18569,8602,8165,3992845153.0,3838001469.0,1435019,1380196,278.24,278.08,2815215,7830846623.0,16767,2023-11-08 18:05:00
617,SBER,5974,3180,2382832176.0,1662925381.0,855131,599021,278.65,277.61,1454152,4045757557.0,9154,5591,2938,2321737793.0,1621005714.0,830047,583443,279.71,277.83,1413490,3942743507.0,8529,2023-11-08 18:10:00
618,SBER,3194,2719,1616782306.0,1488910401.0,577818,535712,279.81,277.93,1113530,3105692708.0,5913,2899,2535,1529269018.0,1420294208.0,545192,510916,280.5,277.99,1056108,2949563227.0,5434,2023-11-08 18:15:00
619,SBER,2998,2691,1726486703.0,1248449600.0,622318,440186,277.43,283.62,1062504,2974936304.0,5689,2716,2489,1684992839.0,1168178429.0,607473,420230,277.38,277.99,1027703,2853171268.0,5205,2023-11-08 18:20:00
620,SBER,5417,7447,2106781742.0,4106152103.0,752281,1479863,280.05,277.47,2232144,6212933846.0,12864,5129,7340,2038386778.0,4025983171.0,735620,1450745,277.1,277.51,2186365,6064369949.0,12469,2023-11-08 18:25:00
621,SBER,6570,4528,2805029719.0,2141231781.0,1011545,771347,277.3,277.6,1782892,4946261500.0,11098,6330,4394,2763506677.0,2153648957.0,996722,775662,277.26,277.65,1772384,4917155635.0,10724,2023-11-08 18:30:00
622,SBER,6258,5643,2284538835.0,2447132891.0,823759,881472,277.33,277.62,1705231,4731671727.0,11901,5956,5468,2229912350.0,2412574992.0,804238,868433,277.27,277.81,1672671,4642487342.0,11424,2023-11-08 18:35:00
623,SBER,4971,3648,2680600530.0,1964416736.0,966489,707882,277.35,277.51,1674371,4645017266.0,8619,4665,3484,2648692660.0,1861560988.0,955413,670684,277.23,277.56,1626097,4510253648.0,8149,2023-11-08 18:40:00
624,SBER,15300,20636,7661205292.0,7975653034.0,2740267,2788424,279.58,286.03,5528691,15636858326.0,35936,13469,18229,7176513436.0,7294987342.0,2579430,2584391,278.22,282.27,5163821,14471500778.0,31698,2023-11-09 10:05:00
625,SBER,4522,7367,2492534045.0,6381195513.0,890214,2296664,279.99,277.85,3186878,8873729558.0,11889,3226,6543,2195917528.0,6140395327.0,789446,2204086,278.16,278.59,2993532,8336312856.0,9769,2023-11-09 10:10:00
626,SBER,4004,3632,2243645698.0,2440420933.0,784929,871743,285.84,279.95,1656672,4684066631.0,7636,2955,2792,2017036713.0,2258396382.0,706801,805750,285.38,280.28,1512551,4275433095.0,5747,2023-11-09 10:15:00
627,SBER,6064,7300,4096879340.0,4757611107.0,1469105,1713491,278.87,277.66,3182596,8854490448.0,13364,4811,6221,3874456590.0,4413278539.0,1395532,1591027,277.63,277.39,2986559,8287735129.0,11032,2023-11-09 10:20:00
628,SBER,5965,8910,4754422032.0,8137893327.0,1717156,2921990,276.88,278.51,4639146,12892315359.0,14875,4460,7996,4340060371.0,7860327031.0,1569613,2833402,276.51,277.42,4403015,12200387403.0,12456,2023-11-09 10:25:00
629,SBER,4456,4255,3599683990.0,2920535690.0,1283153,1041985,280.53,280.29,2325138,6520219681.0,8711,3815,3382,3398677268.0,2685647484.0,1226376,962985,277.13,278.89,2189361,6084324753.0,7197,2023-11-09 10:30:00
630,SBER,2618,1940,2227353374.0,1713609942.0,804300,614966,276.93,278.65,1419266,3940963316.0,4558,1912,1381,2108647675.0,1612481051.0,762435,578001,276.57,278.98,1340436,3721128727.0,3293,2023-11-09 10:35:00
631,SBER,3030,2451,2118551781.0,2218460519.0,765517,797895,276.75,278.04,1563412,4337012301.0,5481,2342,1950,1992167317.0,2095696084.0,720673,755767,276.43,277.29,1476440,4087863402.0,4292,2023-11-09 10:40:00
632,SBER,2157,5180,2062168303.0,5003111489.0,745932,1804173,276.46,277.31,2550105,7065279792.0,7337,1667,4663,1987549738.0,4937564914.0,719296,1780962,276.32,277.24,2500258,6925114653.0,6330,2023-11-09 10:45:00
633,SBER,2658,3743,2739194879.0,2684309750.0,987261,967794,277.45,277.36,1955055,5423504629.0,6401,2151,2435,2620453468.0,2507810208.0,947188,904116,276.66,277.38,1851304,5128263676.0,4586,2023-11-09 10:50:00
634,SBER,2704,2925,2684998144.0,2289689349.0,965739,825190,278.03,277.47,1790929,4974687494.0,5629,2295,2253,2601485488.0,2291493969.0,937909,825725,277.37,277.51,1763634,4892979458.0,4548,2023-11-09 10:55:00
635,SBER,4062,4235,2612752763.0,2637112099.0,944717,952214,276.56,276.95,1896931,5249864862.0,8297,3656,3726,2503950858.0,2535276357.0,905494,914558,276.53,277.21,1820052,5039227215.0,7382,2023-11-09 11:00:00
636,SBER,7710,9242,4856793155.0,5744721319.0,1757483,2080767,276.35,276.09,3838250,10601514475.0,16952,6623,7790,4656948916.0,5310785832.0,1686277,1918754,276.17,276.78,3605031,9967734749.0,14413,2023-11-09 11:05:00
637,SBER,14856,15789,9381555379.0,7894634196.0,3388505,2852659,276.86,276.75,6241164,17276189576.0,30645,12877,14726,8940365787.0,7672175996.0,3233966,2771733,276.45,276.8,6005699,16612541783.0,27603,2023-11-09 11:10:00
638,SBER,8636,6738,5090687829.0,3127326898.0,1837936,1127962,276.98,277.25,2965898,8218014727.0,15374,7828,5993,4977988126.0,3001357607.0,1798227,1081820,276.83,277.44,2880047,7979345734.0,13821,2023-11-09 11:15:00
639,SBER,23613,14929,17221182825.0,6010331382.0,6214648,2166382,277.11,277.44,8381030,23231514207.0,38542,23074,14423,17146032510.0,5770281523.0,6187955,2079398,277.09,277.5,8267353,22916314033.0,37497,2023-11-09 11:20:00
640,SBER,7425,8303,4723901035.0,3323339603.0,1706060,1199041,276.89,277.17,2905101,8047240639.0,15728,6809,7959,4598827952.0,3230604302.0,1661439,1164788,276.8,277.36,2826227,7829432255.0,14768,2023-11-09 11:25:00
641,SBER,8153,9447,4083873656.0,5217865198.0,1477279,1883391,276.45,277.05,3360670,9301738854.0,17600,7557,9169,4036268737.0,5124341408.0,1460245,1849295,276.41,277.1,3309540,9160610146.0,16726,2023-11-09 11:30:00
642,SBER,8900,13852,4819112195.0,5673663230.0,1733630,2044000,277.98,277.58,3777630,10492775425.0,22752,8241,13283,4695382129.0,5587392785.0,1699013,2012459,276.36,277.64,3711472,10282774914.0,21524,2023-11-09 11:35:00
643,SBER,5402,4827,3024055672.0,2589939782.0,1082866,933936,279.26,277.31,2016802,5613995454.0,10229,4901,4497,2981005468.0,2534674492.0,1067862,913902,279.16,277.35,1981764,5515679960.0,9398,2023-11-09 11:40:00
644,SBER,3971,3016,2194598339.0,1773117924.0,793292,639507,276.64,277.26,1432799,3967716263.0,6987,3581,2826,2173552210.0,1745888785.0,785823,629417,276.6,277.38,1415240,3919440995.0,6407,2023-11-09 11:45:00
645,SBER,5258,4242,2635853054.0,2370960397.0,953124,855584,276.55,277.12,1808708,5006813452.0,9500,4835,4124,2629322714.0,2358408747.0,941187,850894,279.36,277.17,1792081,4987731461.0,8959,2023-11-09 11:50:00
646,SBER,6851,6298,4318319593.0,3215975408.0,1536855,1159345,280.98,277.4,2696200,7534295002.0,13149,6457,6035,4264116899.0,3180052897.0,1520990,1146322,280.35,277.41,2667312,7444169796.0,12492,2023-11-09 11:55:00
647,SBER,2552,2074,1447153347.0,1111038828.0,522483,400300,276.98,277.55,922783,2558192175.0,4626,2250,1893,1434347631.0,1085437423.0,517980,391001,276.91,277.6,908981,2519785054.0,4143,2023-11-09 12:00:00
648,SBER,9488,5155,6246388765.0,2550906052.0,2256052,919665,276.87,277.37,3175717,8797294817.0,14643,9098,4997,6221701136.0,2520507861.0,2247242,908639,276.86,277.39,3155881,8742208997.0,14095,2023-11-09 12:05:00
649,SBER,2263,2781,1373322318.0,1385081435.0,495951,499293,276.91,277.41,995244,2758403754.0,5044,1959,2599,1323651330.0,1349330071.0,478285,486335,276.75,277.45,964620,2672981402.0,4558,2023-11-09 12:10:00
650,SBER,2341,2227,1450374226.0,1193606922.0,523815,430311,276.89,277.38,954126,2643981148.0,4568,2035,2000,1401424284.0,1161776025.0,506322,418710,276.79,277.47,925032,2563200310.0,4035,2023-11-09 12:15:00
651,SBER,2980,3389,1461943978.0,1537229654.0,527770,554118,277.0,277.42,1081888,2999173633.0,6369,2579,3094,1414704689.0,1504551755.0,510894,542243,276.91,277.47,1053137,2919256445.0,5673,2023-11-09 12:20:00
652,SBER,2942,3126,1890124934.0,1772379912.0,662673,635151,285.23,279.05,1297824,3662504846.0,6068,2545,2778,1782027126.0,1727019774.0,643677,621961,276.85,277.67,1265638,3509046900.0,5323,2023-11-09 12:25:00
653,SBER,2906,5450,2274679206.0,2076698579.0,821455,746874,276.91,278.05,1568329,4351377786.0,8356,2758,4996,2259741342.0,2038559483.0,816264,731167,276.84,278.81,1547431,4298300825.0,7754,2023-11-09 12:30:00
654,SBER,5048,2974,1870311336.0,1498417475.0,675380,540324,276.93,277.32,1215704,3368728811.0,8022,2697,2626,1845080433.0,1467274766.0,666495,528729,276.83,277.51,1195224,3312355200.0,5323,2023-11-09 12:35:00
655,SBER,3284,3854,3074408742.0,1480500928.0,1109888,533622,277.0,277.44,1643510,4554909670.0,7138,3111,3563,3055189582.0,1442121733.0,1103080,519756,276.97,277.46,1622836,4497311315.0,6674,2023-11-09 12:40:00
656,SBER,4139,3931,2267937168.0,2282295231.0,819687,823346,276.68,277.2,1643033,4550232399.0,8070,3914,3599,2247544275.0,2253732205.0,812428,812829,276.65,277.27,1625257,4501276480.0,7513,2023-11-09 12:45:00
657,SBER,2659,2010,1717750345.0,1169792840.0,620410,421891,276.87,277.27,1042301,2887543186.0,4669,2424,1701,1698351362.0,1148143298.0,613709,413786,276.74,277.47,1027495,2846494661.0,4125,2023-11-09 12:50:00
658,SBER,4806,4075,3204932963.0,2469710310.0,1154912,889383,277.5,277.69,2044295,5674643273.0,8881,4377,3600,3062813478.0,2325031716.0,1105148,836941,277.14,277.8,1942089,5387845194.0,7977,2023-11-09 12:55:00
659,SBER,6205,5761,3783685383.0,3015658679.0,1364867,1079928,277.22,279.25,2444795,6799344062.0,11966,5841,5365,3653487625.0,2950050576.0,1318689,1062133,277.05,277.75,2380822,6603538202.0,11206,2023-11-09 13:00:00
660,SBER,9879,17742,4583588283.0,7263649148.0,1646649,2620249,278.36,277.21,4266898,11847237431.0,27621,9565,17386,4526268586.0,7174178301.0,1635710,2587376,276.72,277.28,4223086,11700446887.0,26951,2023-11-09 13:05:00
661,SBER,3403,5499,1862425279.0,3187759611.0,673237,1148059,276.64,277.67,1821296,5050184891.0,8902,3213,5190,1848636689.0,3099956424.0,668308,1118623,276.61,277.12,1786931,4948593113.0,8403,2023-11-09 13:10:00
662,SBER,1609,2419,1024447090.0,1424472369.0,350378,514227,292.38,277.01,864605,2448919459.0,4028,1421,2181,945397979.0,1418976473.0,341810,511957,276.59,277.17,853767,2364374452.0,3602,2023-11-09 13:15:00
663,SBER,1472,1168,733619727.0,756128763.0,265189,272868,276.64,277.1,538057,1489748490.0,2640,1187,1003,730117200.0,736391708.0,263995,265620,276.56,277.24,529615,1466508908.0,2190,2023-11-09 13:20:00
664,SBER,1497,1081,676906146.0,618339019.0,244789,223216,276.53,277.01,468005,1295245165.0,2578,1169,928,651452768.0,604024036.0,235586,217929,276.52,277.17,453515,1255476804.0,2097,2023-11-09 13:25:00
665,SBER,5649,3335,3126601426.0,1581195993.0,1128675,570159,277.02,277.33,1698834,4707797419.0,8984,5320,3147,3028527301.0,1546005239.0,1093904,557394,276.85,277.36,1651298,4574532541.0,8467,2023-11-09 13:30:00
666,SBER,8047,11458,3207069719.0,4892261958.0,1158697,1764828,276.78,277.21,2923525,8099331678.0,19505,7641,11310,3173695384.0,4839105693.0,1146680,1745568,276.77,277.22,2892248,8012801077.0,18951,2023-11-09 13:35:00
667,SBER,5777,4520,1479230733.0,2628993048.0,534672,949198,276.66,276.97,1483870,4108223782.0,10297,5418,4393,1466279251.0,2584038458.0,530107,932912,276.6,276.99,1463019,4050317709.0,9811,2023-11-09 13:40:00
668,SBER,1218,1159,554825320.0,689068352.0,200685,248711,276.47,277.06,449396,1243893673.0,2377,925,1054,547089467.0,672010022.0,197968,242484,276.35,277.14,440452,1219099490.0,1979,2023-11-09 13:45:00
669,SBER,3835,5363,2106968084.0,3038068756.0,762748,1097704,276.23,276.77,1860452,5145036840.0,9198,3353,4834,2069043430.0,2993485155.0,749178,1081022,276.18,276.91,1830200,5062528586.0,8187,2023-11-09 13:50:00
670,SBER,5868,14652,2606330265.0,10460008214.0,942045,3776499,276.67,276.98,4718544,13066338480.0,20520,5467,14435,2570662469.0,10284192201.0,929443,3713384,276.58,276.95,4642827,12854854670.0,19902,2023-11-09 13:55:00
671,SBER,2484,2859,1053642049.0,1724170416.0,381089,622293,276.48,277.07,1003382,2777812465.0,5343,2200,2755,1066339111.0,1665303408.0,385834,601252,276.37,276.97,987086,2731642520.0,4955,2023-11-09 14:00:00
672,SBER,1290,2677,1103859726.0,3028553879.0,399506,1093687,276.31,276.91,1493193,4132413605.0,3967,988,2587,1101061021.0,3030738162.0,398599,1094149,276.23,277.0,1492748,4131799183.0,3575,2023-11-09 14:05:00
673,SBER,3968,5688,2163829013.0,3345427596.0,783074,1210714,276.32,276.32,1993788,5509256610.0,9656,3493,4805,2079140660.0,3186375994.0,752934,1151805,276.14,276.64,1904739,5265516655.0,8298,2023-11-09 14:10:00
674,SBER,6981,14488,3040844990.0,6790921543.0,1100922,2455412,276.21,276.57,3556334,9831766534.0,21469,6487,14320,2991124174.0,6772712128.0,1083436,2448673,276.08,276.59,3532109,9763836303.0,20807,2023-11-09 14:15:00
675,SBER,2801,2916,1707889473.0,1829205186.0,617900,660490,276.4,276.95,1278390,3537094660.0,5717,2594,2717,1669425326.0,1809057025.0,604172,653118,276.32,276.99,1257290,3478482351.0,5311,2023-11-09 14:20:00
676,SBER,2847,2456,1429846967.0,1206584451.0,516893,435613,276.62,276.99,952506,2636431418.0,5303,2692,2078,1402490587.0,1185590782.0,507126,427760,276.56,277.16,934886,2588081370.0,4770,2023-11-09 14:25:00
677,SBER,2301,1973,1409426025.0,1260037218.0,508968,454477,276.92,277.25,963445,2669463243.0,4274,2151,1775,1373320288.0,1202886270.0,496401,433735,276.66,277.33,930136,2576206558.0,3926,2023-11-09 14:30:00
678,SBER,2510,2302,1412250815.0,1389756518.0,510435,501213,276.68,277.28,1011648,2802007334.0,4812,2276,2051,1384140930.0,1350836681.0,500384,487045,276.62,277.35,987429,2734977611.0,4327,2023-11-09 14:35:00
679,SBER,2687,2228,1565049481.0,1388416989.0,565598,500732,276.71,277.28,1066330,2953466470.0,4915,2529,2073,1558771967.0,1360204162.0,563779,490503,276.49,277.31,1054282,2918976129.0,4602,2023-11-09 14:40:00
680,SBER,3390,2831,2007240739.0,1594734897.0,725376,575205,276.72,277.25,1300581,3601975637.0,6221,3193,2482,1978387045.0,1554452946.0,715138,560595,276.64,277.29,1275733,3532839992.0,5675,2023-11-09 14:45:00
681,SBER,2606,2313,1453138070.0,1486886408.0,525517,536392,276.52,277.2,1061909,2940024478.0,4919,2259,2207,1398434335.0,1474437746.0,505787,531803,276.49,277.25,1037590,2872872082.0,4466,2023-11-09 14:50:00
682,SBER,2863,2620,1546750542.0,1639677906.0,558986,586511,276.71,279.56,1145497,3186428448.0,5483,2740,2468,1538502765.0,1612576836.0,556153,581612,276.63,277.26,1137765,3151079601.0,5208,2023-11-09 14:55:00
683,SBER,3216,2503,1832426601.0,1502916789.0,662306,541904,276.67,277.34,1204210,3335343391.0,5719,3040,2420,1776714935.0,1497359906.0,642096,539908,276.71,277.34,1182004,3274074841.0,5460,2023-11-09 15:00:00
684,SBER,2814,1813,1550151592.0,1206019021.0,559271,434467,277.17,277.59,993738,2756170614.0,4627,2499,1684,1510430960.0,1193664058.0,545452,429975,276.91,277.61,975427,2704095018.0,4183,2023-11-09 15:05:00
685,SBER,8852,5317,4007365001.0,3042889616.0,1444577,1095963,277.41,277.65,2540540,7050254617.0,14169,8544,5079,3909691230.0,3005532321.0,1410874,1082389,277.11,277.68,2493263,6915223551.0,13623,2023-11-09 15:10:00
686,SBER,3983,3241,2000960027.0,1744117839.0,722315,628112,277.02,277.68,1350427,3745077867.0,7224,3764,3066,1935800986.0,1703109600.0,698296,613232,277.22,277.73,1311528,3638910587.0,6830,2023-11-09 15:15:00
687,SBER,5772,4409,3076789883.0,1811368130.0,1110134,652436,277.15,277.63,1762570,4888158013.0,10181,5628,4290,3030737341.0,1799874580.0,1093518,648152,277.15,277.69,1741670,4830611921.0,9918,2023-11-09 15:20:00
688,SBER,6247,1830,3500386074.0,1139952476.0,1261844,410350,277.4,277.8,1672194,4640338550.0,8077,6059,1729,3472913518.0,1115517527.0,1252215,401527,277.34,277.82,1653742,4588431045.0,7788,2023-11-09 15:25:00
689,SBER,3740,3366,2129654473.0,1602202417.0,767892,576529,277.34,277.9,1344421,3731856891.0,7106,3582,2990,1939931674.0,1466429823.0,699640,527376,277.28,278.06,1227016,3406361497.0,6572,2023-11-09 15:30:00
690,SBER,11933,6012,8839232977.0,2491056419.0,3181792,895744,277.81,278.1,4077536,11330289396.0,17945,11770,5683,8717058023.0,2457201376.0,3138069,883452,277.78,278.14,4021521,11174259399.0,17453,2023-11-09 15:35:00
691,SBER,5298,3572,4278192117.0,1591356743.0,1541244,572512,277.58,277.96,2113756,5869548860.0,8870,5154,3433,4257385524.0,1534254832.0,1533770,551655,277.58,278.12,2085425,5791640356.0,8587,2023-11-09 15:40:00
692,SBER,2380,3061,1706580930.0,1240111682.0,614853,446162,277.56,277.95,1061015,2946692612.0,5441,2262,2964,1700777647.0,1226729927.0,612852,441280,277.52,277.99,1054132,2927507574.0,5226,2023-11-09 15:45:00
693,SBER,3023,2228,3383271120.0,1152205133.0,1218221,414382,277.72,278.05,1632603,4535476254.0,5251,2863,2073,3336801456.0,1122048945.0,1201735,403417,277.67,278.14,1605152,4458850402.0,4936,2023-11-09 15:50:00
694,SBER,2713,3009,1659320519.0,1388328930.0,597031,499242,277.93,278.09,1096273,3047649450.0,5722,2520,2825,1625114623.0,1359814898.0,585109,488890,277.75,278.14,1073999,2984929522.0,5345,2023-11-09 15:55:00
695,SBER,2466,3370,1283588465.0,1515209068.0,462340,545204,277.63,277.92,1007544,2798797533.0,5836,2350,3208,1252649173.0,1492551030.0,451375,536586,277.52,278.16,987961,2745200203.0,5558,2023-11-09 16:00:00
696,SBER,6853,4523,4415378790.0,2262765404.0,1590363,788939,277.63,286.81,2379302,6678144194.0,11376,6717,4419,4382394483.0,2179690960.0,1578616,783757,277.61,278.11,2362373,6562085443.0,11136,2023-11-09 16:05:00
697,SBER,10140,8515,7076232886.0,4251222464.0,2547989,1529114,277.72,278.02,4077103,11327455351.0,18655,9926,8379,7062997262.0,4209958655.0,2543344,1514036,277.71,278.06,4057380,11272955917.0,18305,2023-11-09 16:10:00
698,SBER,6565,6222,3465592967.0,3221647158.0,1249577,1110982,277.34,289.98,2360559,6687240126.0,12787,6338,6098,3424686139.0,3196188680.0,1235024,1092885,277.3,292.45,2327909,6620874819.0,12436,2023-11-09 16:15:00
699,SBER,3983,3532,1979754892.0,1737398441.0,713582,624298,277.44,278.3,1337880,3717153333.0,7515,3867,3425,1974586792.0,1714863209.0,711812,617005,277.4,277.93,1328817,3689450002.0,7292,2023-11-09 16:20:00
700,SBER,1773,1154,1028143835.0,711869088.0,370636,256101,277.4,277.96,626737,1740012923.0,2927,1608,1086,1005030145.0,712238779.0,362365,256188,277.35,278.01,618553,1717268925.0,2694,2023-11-09 16:25:00
701,SBER,1542,1229,793043432.0,762291841.0,285427,274250,277.84,277.96,559677,1555335273.0,2771,1114,1140,737479882.0,776794995.0,265846,279373,277.41,278.05,545219,1514274878.0,2254,2023-11-09 16:30:00
702,SBER,4722,2696,2405541489.0,1634678956.0,865433,587540,277.96,278.22,1452973,4040220446.0,7418,4465,2401,2332429127.0,1587671814.0,839992,570524,277.67,278.28,1410516,3920100941.0,6866,2023-11-09 16:35:00
703,SBER,3977,4084,2182821904.0,2265865023.0,784449,813533,278.26,278.52,1597982,4448686928.0,8061,3672,3739,2125793005.0,2301326374.0,765409,826628,277.73,278.4,1592037,4427119380.0,7411,2023-11-09 16:40:00
704,SBER,2258,2566,1269608958.0,1486785090.0,457296,534470,277.63,278.18,991766,2756394049.0,4824,2034,2344,1248601569.0,1339194153.0,449789,481250,277.6,278.27,931039,2587795722.0,4378,2023-11-09 16:45:00
705,SBER,5967,5926,3354454626.0,3238887125.0,1208361,1164254,277.6,278.19,2372615,6593341751.0,11893,5730,5805,3313393086.0,3184180902.0,1193703,1144713,277.57,278.16,2338416,6497573989.0,11535,2023-11-09 16:50:00
706,SBER,3823,4358,2332706103.0,2219198435.0,840540,798731,277.52,277.84,1639271,4551904539.0,8181,3627,4211,2319888720.0,2180586228.0,836128,784298,277.46,278.03,1620426,4500474948.0,7838,2023-11-09 16:55:00
707,SBER,3142,3727,1382923740.0,1925443750.0,498440,692845,277.45,277.9,1191285,3308367490.0,6869,2506,3630,1340688779.0,1925233479.0,483338,692648,277.38,277.95,1175986,3265922258.0,6136,2023-11-09 17:00:00
708,SBER,16074,22001,5941298198.0,11230512499.0,2141837,4041098,277.39,277.91,6182935,17171810697.0,38075,15856,21902,5933466608.0,11245295524.0,2139053,4046382,277.39,277.91,6185435,17178762132.0,37758,2023-11-09 17:05:00
709,SBER,2075,2143,1018305427.0,1246985578.0,367270,449031,277.26,277.71,816301,2265291005.0,4218,1919,2058,1002507901.0,1224744823.0,361615,440671,277.23,277.93,802286,2227252724.0,3977,2023-11-09 17:10:00
710,SBER,2481,2824,1219967083.0,1828787460.0,439825,658342,277.38,277.79,1098167,3048754544.0,5305,2339,2729,1183839051.0,1791074525.0,426885,644509,277.32,277.9,1071394,2974913576.0,5068,2023-11-09 17:15:00
711,SBER,1756,4923,825477985.0,3609981187.0,297596,1299714,277.38,277.75,1597310,4435459172.0,6679,1609,4848,812268812.0,3611511319.0,292906,1300089,277.31,277.79,1592995,4423780131.0,6457,2023-11-09 17:20:00
712,SBER,12164,10466,3913789619.0,10628286362.0,1410742,3828067,277.43,277.64,5238809,14542075981.0,22630,11946,10380,3881028663.0,10601801365.0,1399124,3818227,277.39,277.66,5217351,14482830028.0,22326,2023-11-09 17:25:00
713,SBER,2585,2433,1233152789.0,1622837310.0,444621,584108,277.35,277.83,1028729,2855990100.0,5018,2252,2282,1216077564.0,1544540661.0,438516,555802,277.32,277.89,994318,2760618225.0,4534,2023-11-09 17:30:00
714,SBER,4337,3602,2084815356.0,1797609404.0,751295,647084,277.5,277.8,1398379,3882424760.0,7939,4187,3498,2062309083.0,1780553149.0,743533,640859,277.37,277.84,1384392,3842862232.0,7685,2023-11-09 17:35:00
715,SBER,1616,1796,813138039.0,1321768804.0,293249,475856,277.29,277.77,769105,2134906843.0,3412,1434,1654,805156727.0,1298934698.0,290428,467521,277.23,277.83,757949,2104091425.0,3088,2023-11-09 17:40:00
716,SBER,4439,4706,1859121403.0,2640192313.0,670770,952385,277.16,277.22,1623155,4499313716.0,9145,4019,4579,1796840017.0,2618493381.0,648481,942733,277.08,277.76,1591214,4415333398.0,8598,2023-11-09 17:45:00
717,SBER,3412,3982,1375932357.0,1919055875.0,496342,691233,277.21,277.63,1187575,3294988232.0,7394,3189,3883,1344974907.0,1863393688.0,485352,671060,277.11,277.68,1156412,3208368596.0,7072,2023-11-09 17:50:00
718,SBER,3299,2714,1779938888.0,1734574806.0,641852,622374,277.31,278.7,1264226,3514513695.0,6013,2952,2594,1748221739.0,1725577003.0,630706,621084,277.18,277.83,1251790,3473798742.0,5546,2023-11-09 17:55:00
719,SBER,4002,3930,1958760318.0,2124066775.0,706597,765355,277.21,277.53,1471952,4082827093.0,7932,3775,3812,1946639856.0,2104172415.0,702327,758027,277.17,277.59,1460354,4050812272.0,7587,2023-11-09 18:00:00
720,SBER,2388,3223,1023570558.0,1503035818.0,368010,541474,278.14,277.58,909484,2526606377.0,5611,2141,3066,927437024.0,1491430195.0,334753,536946,277.05,277.76,871699,2418867219.0,5207,2023-11-09 18:05:00
721,SBER,3761,6990,1169997982.0,6068222870.0,421729,2184603,277.43,277.77,2606332,7238220852.0,10751,3565,6833,1158919369.0,6012743962.0,418000,2164214,277.25,277.83,2582214,7171663331.0,10398,2023-11-09 18:10:00
722,SBER,1824,2935,592570502.0,3173326681.0,213703,1142702,277.29,277.7,1356405,3765897183.0,4759,1631,2838,535004431.0,3148574075.0,193036,1133627,277.15,277.74,1326663,3683578506.0,4469,2023-11-09 18:15:00
723,SBER,2697,3681,1062069714.0,1891480883.0,382959,681327,277.33,277.62,1064286,2953550597.0,6378,2476,3553,1014532686.0,1834230904.0,365958,660285,277.23,277.79,1026243,2848763590.0,6029,2023-11-09 18:20:00
724,SBER,1909,1698,652375068.0,1073388384.0,235203,386649,277.37,277.61,621852,1725763452.0,3607,1767,1573,639288942.0,1065513312.0,230557,383531,277.28,277.82,614088,1704802255.0,3340,2023-11-09 18:25:00
725,SBER,6761,4185,2452776731.0,3044809051.0,884217,1096367,277.4,277.72,1980584,5497585783.0,10946,6484,3941,2390170146.0,2980459076.0,861942,1072991,277.3,277.77,1934933,5370629223.0,10425,2023-11-09 18:30:00
726,SBER,1446,1343,512493794.0,845596433.0,184904,304665,277.17,277.55,489569,1358090227.0,2789,1226,1268,462875726.0,838037294.0,167105,301031,277.0,278.39,468136,1300913020.0,2494,2023-11-09 18:35:00
727,SBER,7613,7353,2372141085.0,3246620049.0,855007,1169990,277.44,277.49,2024997,5618761134.0,14966,7427,7286,2367743324.0,3250582394.0,853660,1170959,277.36,277.6,2024619,5618325719.0,14713,2023-11-09 18:40:00
728,SBER,19366,18997,9472357560.0,8494415412.0,3408338,3041542,277.92,279.28,6449880,17966772972.0,38363,17822,17647,8965948360.0,8194858903.0,3231887,2955944,277.42,277.23,6187831,17160807263.0,35469,2023-11-10 10:05:00
729,SBER,14424,12737,9074719824.0,7264253078.0,3248447,2614605,279.36,277.83,5863052,16338972903.0,27161,13498,11856,8811679144.0,6995836289.0,3174782,2519487,277.55,277.67,5694269,15807515433.0,25354,2023-11-10 10:10:00
730,SBER,5726,5017,3782950102.0,2839896433.0,1322585,1024292,286.03,277.25,2346877,6622846535.0,10743,5143,4494,3673452394.0,2678351065.0,1286944,965529,285.44,277.4,2252473,6351803460.0,9637,2023-11-10 10:15:00
731,SBER,12242,5565,10743130946.0,3115313944.0,3733190,1117742,287.77,278.71,4850932,13858444891.0,17807,10415,4696,10506897295.0,2919321533.0,3658846,1051756,287.16,277.57,4710602,13426218829.0,15111,2023-11-10 10:20:00
732,SBER,11581,9891,10148499205.0,7845841598.0,3617487,2806459,280.54,279.56,6423946,17994340803.0,21472,9822,7948,9386923670.0,7404957561.0,3373292,2657263,278.27,278.67,6030555,16791881232.0,17770,2023-11-10 10:25:00
733,SBER,12647,11453,10944083005.0,8343430496.0,3909272,2974747,279.95,280.48,6884019,19287513501.0,24100,10974,9136,10492454280.0,7795245720.0,3756567,2788879,279.31,279.51,6545446,18287700000.0,20110,2023-11-10 10:30:00
734,SBER,12114,14768,8947559091.0,8136801498.0,3174770,2910241,281.83,279.59,6085011,17084360589.0,26882,10085,10194,8344863478.0,7366111231.0,2972516,2630636,280.73,280.01,5603152,15710974710.0,20279,2023-11-10 10:35:00
735,SBER,7711,8011,5362452255.0,4579066945.0,1858511,1639158,288.53,279.35,3497669,9941519201.0,15722,6752,6630,5055891232.0,4189417711.0,1765736,1496664,286.33,279.92,3262400,9245308943.0,13382,2023-11-10 10:40:00
736,SBER,20006,17960,13292797984.0,10172211751.0,4735189,3583317,280.72,283.88,8318506,23465009735.0,37966,18316,15359,12636948050.0,9483400087.0,4504552,3371803,280.54,281.26,7876355,22120348138.0,33675,2023-11-10 10:45:00
737,SBER,28018,23266,19321829379.0,12359105328.0,6847420,4372213,282.18,282.67,11219633,31680934708.0,51284,26369,20324,18863532660.0,11464066105.0,6701007,4055459,281.5,282.68,10756466,30327598766.0,46693,2023-11-10 10:50:00
738,SBER,16666,21597,9518402276.0,12331586519.0,3391185,4401209,280.68,280.19,7792394,21849988796.0,38263,15382,19497,9162466619.0,11876420936.0,3273152,4233953,279.93,280.5,7507105,21038887556.0,34879,2023-11-10 10:55:00
739,SBER,10350,9548,6029671343.0,5346099471.0,2147677,1907871,280.75,280.21,4055548,11375770814.0,19898,9325,8573,5643601616.0,5026820533.0,2017215,1793057,279.77,280.35,3810272,10670422149.0,17898,2023-11-10 11:00:00
740,SBER,9547,9806,6206017215.0,6849039274.0,2164754,2443979,286.68,280.24,4608733,13055056489.0,19353,8559,8807,5858180235.0,6595140517.0,2091970,2352842,280.03,280.31,4444812,12453320753.0,17366,2023-11-10 11:05:00
741,SBER,8015,10945,4183742142.0,7804419827.0,1496536,2784505,279.56,280.28,4281041,11988161969.0,18960,7224,10052,4002065304.0,7537637251.0,1432736,2693145,279.33,279.88,4125881,11539702556.0,17276,2023-11-10 11:10:00
742,SBER,5648,5988,3308520810.0,3731357962.0,1181248,1335177,280.09,279.47,2516425,7039878772.0,11636,5057,5397,3109016648.0,3568085336.0,1113061,1274545,279.32,279.95,2387606,6677101984.0,10454,2023-11-10 11:15:00
743,SBER,7281,9469,4398553538.0,6130732573.0,1561160,2193357,281.75,279.51,3754517,10529286112.0,16750,6417,8520,4198382714.0,5902735023.0,1501928,2110619,279.53,279.67,3612547,10101117738.0,14937,2023-11-10 11:20:00
744,SBER,7384,6613,4348402764.0,4605033779.0,1554821,1644614,279.67,280.01,3199435,8953436543.0,13997,6673,5978,4126198720.0,4405760390.0,1476823,1573608,279.4,279.98,3050431,8531959110.0,12651,2023-11-10 11:25:00
745,SBER,5501,4743,3357303797.0,2479110415.0,1201464,885904,279.43,279.84,2087368,5836414212.0,10244,4958,4331,3314475178.0,2377187649.0,1186237,848822,279.41,280.06,2035059,5691662827.0,9289,2023-11-10 11:30:00
746,SBER,4670,4846,2922769384.0,2696405256.0,1045656,963375,279.52,279.89,2009031,5619174641.0,9516,4112,4493,2845990347.0,2663161143.0,1018726,951249,279.37,279.96,1969975,5509151491.0,8605,2023-11-10 11:35:00
747,SBER,7172,6429,4633070523.0,3352642435.0,1657769,1179101,279.48,284.34,2836870,7985712959.0,13601,6654,6066,4604402241.0,3237317317.0,1647643,1146804,279.45,282.29,2794447,7841719558.0,12720,2023-11-10 11:40:00
748,SBER,6779,7580,4799824121.0,4346707779.0,1720786,1554077,278.93,279.7,3274863,9146531900.0,14359,6258,7293,4596121547.0,4326926254.0,1647441,1537059,278.99,281.51,3184500,8923047802.0,13551,2023-11-10 11:45:00
749,SBER,8395,10963,4799828966.0,5931488580.0,1675687,2120368,286.44,279.74,3796055,10731317546.0,19358,7795,10599,4705064952.0,5845836447.0,1643450,2089007,286.29,279.84,3732457,10550901399.0,18394,2023-11-10 11:50:00
750,SBER,13063,13678,7064636164.0,7549308358.0,2525452,2696559,279.74,279.96,5222011,14613944523.0,26741,12356,13247,6958419384.0,7336252711.0,2488504,2619694,279.62,280.04,5108198,14294672096.0,25603,2023-11-10 11:55:00
751,SBER,3468,2864,2223110216.0,2279095793.0,794861,813989,279.69,279.99,1608850,4502206009.0,6332,2652,2532,2122478251.0,2254474445.0,759835,805175,279.33,280.0,1565010,4376952696.0,5184,2023-11-10 12:00:00
752,SBER,11610,6742,5420399598.0,3549510956.0,1926892,1267818,281.3,279.97,3194710,8969910554.0,18352,10742,6231,5244673459.0,3358083888.0,1865879,1198101,281.08,280.28,3063980,8602757347.0,16973,2023-11-10 12:05:00
753,SBER,3914,3465,2418856694.0,2129097225.0,864046,759927,279.95,280.17,1623973,4547953919.0,7379,3354,3022,2372665923.0,2056832184.0,848864,733478,279.51,280.42,1582342,4429498108.0,6376,2023-11-10 12:10:00
754,SBER,5733,7299,3051248469.0,3576692903.0,1086721,1268917,280.78,281.87,2355638,6627941373.0,13032,4738,6915,2947317709.0,3475745423.0,1050638,1239432,280.53,280.43,2290070,6423063132.0,11653,2023-11-10 12:15:00
755,SBER,3157,5166,2017416528.0,2398302570.0,721362,856366,279.67,280.06,1577728,4415719099.0,8323,2610,4752,1967147981.0,2312570823.0,704442,824851,279.25,280.36,1529293,4279718805.0,7362,2023-11-10 12:20:00
756,SBER,10128,12564,4322390968.0,8565920144.0,1540845,3062214,280.52,279.73,4603059,12888311112.0,22692,9523,12105,4213139421.0,8438425009.0,1502057,3014350,280.49,279.94,4516407,12651564430.0,21628,2023-11-10 12:25:00
757,SBER,4200,4488,2713717264.0,2897124030.0,954027,1033927,284.45,280.21,1987954,5610841294.0,8688,3897,3922,2667589570.0,2821724243.0,938198,1006498,284.33,280.35,1944696,5489313813.0,7819,2023-11-10 12:30:00
758,SBER,4586,5452,2760998738.0,2746923477.0,987828,980952,279.5,280.03,1968780,5507922216.0,10038,4217,5026,2659355812.0,2760981292.0,951486,985184,279.5,280.25,1936670,5420337104.0,9243,2023-11-10 12:35:00
759,SBER,6644,6738,3674784776.0,3212776575.0,1313652,1127006,279.74,285.07,2440658,6887561352.0,13382,6343,6243,3635644509.0,3018476865.0,1299947,1077036,279.68,280.26,2376983,6654121374.0,12586,2023-11-10 12:40:00
760,SBER,6999,5970,3734335093.0,3084327355.0,1334792,1097884,279.77,280.93,2432676,6818662448.0,12969,6552,5458,3680638861.0,3039367198.0,1316007,1084546,279.68,280.24,2400553,6720006059.0,12010,2023-11-10 12:45:00
761,SBER,10951,13602,5284099830.0,5633957015.0,1888023,2011772,279.87,280.05,3899795,10918056845.0,24553,10617,13106,5242270192.0,5588025544.0,1873571,1994992,279.8,280.1,3868563,10830295737.0,23723,2023-11-10 12:50:00
762,SBER,2105,2549,1621876271.0,1642860046.0,576358,584871,281.4,280.89,1161229,3264736317.0,4654,1803,2072,1559573962.0,1591445437.0,554290,565517,281.36,281.41,1119807,3151019399.0,3875,2023-11-10 12:55:00
763,SBER,7433,8086,4394659493.0,4777662557.0,1562812,1704565,281.2,280.29,3267377,9172322050.0,15519,7096,7655,4462195401.0,4744144862.0,1545663,1691269,288.69,280.51,3236932,9206340263.0,14751,2023-11-10 13:00:00
764,SBER,10068,14536,4897765096.0,7101265559.0,1741743,2530606,281.2,280.62,4272349,11999030655.0,24604,9759,14073,4832477526.0,7018180974.0,1722283,2505227,280.59,280.14,4227510,11850658500.0,23832,2023-11-10 13:05:00
765,SBER,4407,5753,2700569726.0,3372934801.0,964589,1203777,279.97,280.2,2168366,6073504527.0,10160,4113,5347,2681050300.0,3367204717.0,957992,1201502,279.86,280.25,2159494,6048255017.0,9460,2023-11-10 13:10:00
766,SBER,5325,6625,3212074673.0,3957744920.0,1147332,1411752,279.96,280.34,2559084,7169819593.0,11950,5038,6190,3192498974.0,3795786882.0,1140316,1354723,279.97,280.19,2495039,6988285856.0,11228,2023-11-10 13:15:00
767,SBER,5515,5973,4225641417.0,3318392961.0,1512164,1186470,279.44,279.69,2698634,7544034379.0,11488,5046,5568,4144494194.0,3347596910.0,1483531,1196008,279.37,279.9,2679539,7492091104.0,10614,2023-11-10 13:20:00
768,SBER,2993,2889,1873302858.0,1979891554.0,670397,708307,279.43,279.52,1378704,3853194412.0,5882,2545,2527,1748547414.0,1891383975.0,626287,675980,279.19,279.8,1302267,3639931390.0,5072,2023-11-10 13:25:00
769,SBER,4805,10559,1964956931.0,6051710101.0,703433,2161740,279.34,279.95,2865173,8016667032.0,15364,4235,10349,1881494943.0,5980054274.0,673911,2138335,279.19,279.66,2812246,7861549217.0,14584,2023-11-10 13:30:00
770,SBER,3262,4882,1882695117.0,2610004432.0,671107,933370,280.54,279.63,1604477,4492699550.0,8144,2768,4682,1812101445.0,2589117091.0,646357,925449,280.36,279.77,1571806,4401218537.0,7450,2023-11-10 13:35:00
771,SBER,5090,5847,2843190648.0,3507342699.0,1018545,1255602,279.14,279.34,2274147,6350533348.0,10937,4549,5603,2835521184.0,3335065236.0,1015942,1192555,279.1,279.66,2208497,6170586420.0,10152,2023-11-10 13:40:00
772,SBER,5916,7258,2987126062.0,3310976777.0,1070580,1185652,279.02,279.25,2256232,6298102839.0,13174,5349,7041,2889077526.0,3255479427.0,1035637,1164723,278.97,279.51,2200360,6144556953.0,12390,2023-11-10 13:45:00
773,SBER,4490,3955,2382693456.0,2280813760.0,844654,816234,282.09,279.43,1660888,4663507217.0,8445,4016,3749,2314270800.0,2226785773.0,829647,796510,278.95,279.57,1626157,4541056573.0,7765,2023-11-10 13:50:00
774,SBER,3689,3106,2494435651.0,2031548435.0,889157,725812,280.54,279.9,1614969,4525984086.0,6795,3312,2802,2413222943.0,1952211773.0,858049,697412,281.25,279.92,1555461,4365434716.0,6114,2023-11-10 13:55:00
775,SBER,2100,2046,1362179649.0,1441303694.0,486062,515186,280.25,279.76,1001248,2803483343.0,4146,1724,1823,1342339984.0,1393729972.0,479326,497903,280.05,279.92,977229,2736069957.0,3547,2023-11-10 14:00:00
776,SBER,967,505,941025320.0,684776738.0,318211,244498,295.72,280.07,562709,1625802059.0,1472,624,377,914330296.0,675862224.0,309803,241278,295.13,280.12,551081,1590192520.0,1001,2023-11-10 14:05:00
777,SBER,1309,2636,1165461545.0,1773719962.0,402803,634128,289.34,279.71,1036931,2939181507.0,3945,959,2386,1136104202.0,1724122822.0,392183,616222,289.69,279.79,1008405,2860227024.0,3345,2023-11-10 14:10:00
778,SBER,2293,2275,1996815819.0,2328328718.0,715846,832852,278.94,279.56,1548698,4325144537.0,4568,1964,2129,1975695186.0,2292784023.0,708330,819657,278.92,279.72,1527987,4268479210.0,4093,2023-11-10 14:15:00
779,SBER,1149,1204,919714693.0,1186762916.0,329594,424289,279.04,279.71,753883,2106477609.0,2353,812,1029,911573862.0,1159930098.0,326745,414571,278.99,279.79,741316,2071503961.0,1841,2023-11-10 14:20:00
780,SBER,2069,2579,1886786122.0,2541001580.0,676346,909179,278.97,279.48,1585525,4427787703.0,4648,1841,2444,1854858093.0,2505433525.0,665180,895727,278.85,279.71,1560907,4360291618.0,4285,2023-11-10 14:25:00
781,SBER,1901,2360,1702601980.0,1877952746.0,609625,671326,279.29,279.74,1280951,3580554727.0,4261,1613,2178,1683641462.0,1832453953.0,603139,654990,279.15,279.77,1258129,3516095415.0,3791,2023-11-10 14:30:00
782,SBER,1691,1158,1270242784.0,1215593189.0,441884,434897,287.46,279.51,876781,2485835973.0,2849,1435,1034,1161412762.0,1196916035.0,416400,427892,278.92,279.72,844292,2358328798.0,2469,2023-11-10 14:35:00
783,SBER,2572,2403,1729649666.0,1728899016.0,618926,619016,279.46,279.3,1237942,3458548683.0,4975,2314,2224,1693152933.0,1678371430.0,606489,600161,279.17,279.65,1206650,3371524364.0,4538,2023-11-10 14:40:00
784,SBER,1960,2179,1157916241.0,1469115806.0,414255,526155,279.52,279.22,940410,2627032047.0,4139,1709,1943,1128928945.0,1419051240.0,395330,507353,285.57,279.7,902683,2547980185.0,3652,2023-11-10 14:45:00
785,SBER,6851,7986,2909791603.0,4720728506.0,1041531,1689743,279.38,279.38,2731274,7630520110.0,14837,6373,7663,2821626792.0,4634326216.0,1011049,1657703,279.08,279.56,2668752,7455953008.0,14036,2023-11-10 14:50:00
786,SBER,2802,3106,1620617383.0,2558448059.0,580356,915173,279.25,279.56,1495529,4179065442.0,5908,2364,2842,1564162210.0,2435038633.0,560446,870850,279.09,279.62,1431296,3999200844.0,5206,2023-11-10 14:55:00
787,SBER,4504,3744,2349625897.0,2143560526.0,841264,766588,279.3,279.62,1607852,4493186423.0,8248,4230,3551,2326676426.0,2107003696.0,833333,753343,279.2,279.69,1586676,4433680122.0,7781,2023-11-10 15:00:00
788,SBER,2754,6206,1964273947.0,3950959841.0,636563,1412793,308.57,279.66,2049356,5915233788.0,8960,2375,6009,1795239538.0,3916305027.0,621372,1400290,288.92,279.68,2021662,5711544566.0,8384,2023-11-10 15:05:00
789,SBER,3024,2736,1690047942.0,1902421154.0,604786,679879,279.45,279.82,1284665,3592469096.0,5760,2716,2526,1662265643.0,1870015560.0,595058,668093,279.35,279.9,1263151,3532281203.0,5242,2023-11-10 15:10:00
790,SBER,4418,2966,1779275813.0,3809547363.0,636305,1361819,279.63,279.74,1998124,5588823176.0,7384,4088,2794,1681786021.0,3789071149.0,601756,1354281,279.48,279.78,1956037,5470857170.0,6882,2023-11-10 15:15:00
791,SBER,3273,3761,2448184580.0,2671853375.0,828404,953548,295.53,280.2,1781952,5120037956.0,7034,2933,3341,2399920182.0,2645257509.0,812566,944058,295.35,280.2,1756624,5045177691.0,6274,2023-11-10 15:20:00
792,SBER,2600,2511,2035297667.0,1775713479.0,650919,633852,312.68,280.15,1284771,3811011147.0,5111,2278,2270,2003490021.0,1743600387.0,640321,622258,312.89,280.21,1262579,3747090409.0,4548,2023-11-10 15:25:00
793,SBER,1454,1757,1095872075.0,1260710093.0,362120,450254,302.63,280.0,812374,2356582168.0,3211,1235,1492,1089650888.0,1216418402.0,360021,434213,302.66,280.14,794234,2306069290.0,2727,2023-11-10 15:30:00
794,SBER,1266,1906,1098973558.0,1512017634.0,378406,540069,290.42,279.97,918475,2610991192.0,3172,1094,1698,1086964481.0,1480920413.0,373709,528722,290.86,280.09,902431,2567884894.0,2792,2023-11-10 15:35:00
795,SBER,1159,1304,958037421.0,1235043838.0,342788,441480,279.48,279.75,784268,2193081260.0,2463,868,1138,938199870.0,1184483446.0,335894,423099,279.31,279.95,758993,2122683317.0,2006,2023-11-10 15:40:00
796,SBER,1430,771,1339810114.0,943446862.0,441827,336920,303.24,280.02,778747,2283256976.0,2201,1207,640,1323136743.0,941410511.0,437501,335979,302.43,280.2,773480,2264547255.0,1847,2023-11-10 15:45:00
797,SBER,1197,1619,1443493870.0,1618931519.0,503697,578059,286.58,280.06,1081756,3062425389.0,2816,948,1309,1437816002.0,1573116739.0,500630,561523,287.2,280.15,1062153,3010932741.0,2257,2023-11-10 15:50:00
798,SBER,2161,3064,1980368430.0,2536469940.0,688679,905782,287.56,280.03,1594461,4516838370.0,5225,1932,2883,1953236610.0,2518453346.0,678707,899317,287.79,280.04,1578024,4471689957.0,4815,2023-11-10 15:55:00
799,SBER,2261,12442,2079203430.0,16139279956.0,744320,5737738,279.34,281.28,6482058,18218483386.0,14703,2054,12234,2061990761.0,16119971515.0,738259,5730098,279.3,281.32,6468357,18181962277.0,14288,2023-11-10 16:00:00
800,SBER,5032,5086,2815156180.0,3693436114.0,1007246,1319445,279.49,279.92,2326691,6508592294.0,10118,4842,4888,2941311420.0,3669204577.0,1053414,1310619,279.22,279.96,2364033,6610515997.0,9730,2023-11-10 16:05:00
801,SBER,3656,3528,2294655455.0,3463163174.0,819645,1239246,279.96,279.46,2058891,5757818630.0,7184,3401,3294,2244442107.0,3390014150.0,802753,1211603,279.59,279.8,2014356,5634456258.0,6695,2023-11-10 16:10:00
802,SBER,4955,4567,2852267814.0,2731311043.0,1011253,975833,282.05,279.9,1987086,5583578858.0,9522,4757,4294,2750963755.0,2689704333.0,977857,960420,281.33,280.06,1938277,5440668088.0,9051,2023-11-10 16:15:00
803,SBER,4111,4536,2956584672.0,2835925113.0,1056533,1012817,279.84,280.0,2069350,5792509786.0,8647,3766,4078,2849676003.0,2774005546.0,1019250,989907,279.59,280.23,2009157,5623681550.0,7844,2023-11-10 16:20:00
804,SBER,7707,5356,2753064245.0,2410284946.0,980996,860094,280.64,280.24,1841090,5163349192.0,13063,7443,4653,2722509682.0,2337140507.0,972066,834021,280.07,280.23,1806087,5059650189.0,12096,2023-11-10 16:25:00
805,SBER,8182,10576,4058852221.0,5115303071.0,1442080,1825768,281.46,280.17,3267848,9174155292.0,18758,7955,10256,3993511480.0,5058324738.0,1419055,1805127,281.42,280.22,3224182,9051836219.0,18211,2023-11-10 16:30:00
806,SBER,4376,4610,2617109968.0,2727223632.0,932735,974395,280.58,279.89,1907130,5344333600.0,8986,4112,4390,2599314029.0,2669359979.0,926506,952618,280.55,280.21,1879124,5268674009.0,8502,2023-11-10 16:35:00
807,SBER,3627,3125,2302794780.0,1868255424.0,823209,666957,279.73,280.12,1490166,4171050205.0,6752,3380,2931,2271962501.0,1842275464.0,812616,657583,279.59,280.16,1470199,4114237965.0,6311,2023-11-10 16:40:00
808,SBER,15389,21339,5542760226.0,7650185029.0,1946127,2731714,284.81,280.05,4677841,13192945255.0,36728,15168,20917,5514849541.0,7607137786.0,1936468,2716113,284.79,280.07,4652581,13121987327.0,36085,2023-11-10 16:45:00
809,SBER,3222,3261,1739987934.0,1723872567.0,621633,615729,279.91,279.97,1237362,3463860501.0,6483,3053,3098,1676473060.0,1710257659.0,599300,610388,279.74,280.19,1209688,3386730719.0,6151,2023-11-10 16:50:00
810,SBER,2719,2188,1704445742.0,1390881610.0,600242,496605,283.96,280.08,1096847,3095327353.0,4907,2516,1988,1686494812.0,1362930753.0,593758,486305,284.04,280.26,1080063,3049425566.0,4504,2023-11-10 16:55:00
811,SBER,3965,3393,2991581704.0,2432386918.0,1058708,860173,282.57,282.78,1918881,5423968622.0,7358,3643,2962,2826486746.0,2346000481.0,1003268,836181,281.73,280.56,1839449,5172487227.0,6605,2023-11-10 17:00:00
812,SBER,9866,21231,4209305500.0,8659068151.0,1502871,3090275,280.08,280.2,4593146,12868373652.0,31097,9557,20958,4126922982.0,8582157840.0,1474625,3061868,279.86,280.29,4536493,12709080822.0,30515,2023-11-10 17:05:00
813,SBER,7350,6556,4368618585.0,3436392610.0,1559031,1224221,280.21,280.7,2783252,7805011196.0,13906,7094,6365,4273096311.0,3425412152.0,1524828,1215272,280.23,281.86,2740100,7698508463.0,13459,2023-11-10 17:10:00
814,SBER,1082,981,524057369.0,397274434.0,170333,141812,307.67,280.14,312145,921331804.0,2063,833,804,498405079.0,355759444.0,161069,126848,309.44,280.46,287917,854164523.0,1637,2023-11-10 17:15:00
815,SBER,1659,1292,900871249.0,596020869.0,319509,212534,281.95,280.44,532043,1496892118.0,2951,1410,1098,863647668.0,581909992.0,306702,207299,281.59,280.71,514001,1445557660.0,2508,2023-11-10 17:20:00
816,SBER,1909,1632,1207712284.0,803572831.0,416877,286785,289.7,280.2,703662,2011285116.0,3541,1666,1407,1162360247.0,762967941.0,401268,271940,289.67,280.56,673208,1925328188.0,3073,2023-11-10 17:25:00
817,SBER,2858,2652,1483466958.0,1270927618.0,505511,453496,293.46,280.25,959007,2754394576.0,5510,2655,2494,1466442356.0,1196171290.0,499433,426712,293.62,280.32,926145,2662613646.0,5149,2023-11-10 17:30:00
818,SBER,1651,1382,820040362.0,712059224.0,277962,254079,295.02,280.25,532041,1532099586.0,3033,1401,1254,796917243.0,680735347.0,270435,242717,294.68,280.46,513152,1477652590.0,2655,2023-11-10 17:35:00
819,SBER,2101,2520,1240911825.0,1291910943.0,437268,460923,283.79,280.29,898191,2532822769.0,4621,1868,2396,1190010670.0,1269861977.0,419393,452893,283.75,280.39,872286,2459872648.0,4264,2023-11-10 17:40:00
820,SBER,2525,2376,1504259979.0,1275657377.0,523111,455391,287.56,280.12,978502,2779917357.0,4901,2302,2260,1462822903.0,1258043555.0,508622,448574,287.61,280.45,957196,2720866458.0,4562,2023-11-10 17:45:00
821,SBER,4613,7046,2302743305.0,2668150375.0,819396,949348,281.03,281.05,1768744,4970893681.0,11659,4239,6685,2239857578.0,2608804662.0,797355,927949,280.91,281.14,1725304,4848662241.0,10924,2023-11-10 17:50:00
822,SBER,3828,3709,2301687432.0,1886230869.0,819157,670274,280.98,281.41,1489431,4187918302.0,7537,3552,3466,2236935999.0,1851495297.0,796767,657812,280.75,281.46,1454579,4088431297.0,7018,2023-11-10 17:55:00
823,SBER,6721,6413,3257483086.0,3234080499.0,1160937,1147994,280.59,281.72,2308931,6491563585.0,13134,6346,6115,3162024453.0,3165659354.0,1127579,1123467,280.43,281.78,2251046,6327683808.0,12461,2023-11-10 18:00:00
824,SBER,3743,3733,1795381980.0,1898508439.0,640203,666059,280.44,285.04,1306262,3693890420.0,7476,3403,3509,1733730521.0,1839338710.0,618428,646271,280.34,284.61,1264699,3573069231.0,6912,2023-11-10 18:05:00
825,SBER,3917,4867,2015914331.0,2776045474.0,720091,983454,279.95,282.28,1703545,4791959806.0,8784,3671,4613,1993274266.0,2739409492.0,712133,970136,279.9,282.37,1682269,4732683759.0,8284,2023-11-10 18:10:00
826,SBER,2809,3108,1461042797.0,1480270745.0,521690,527733,280.06,280.5,1049423,2941313542.0,5917,2536,2842,1423894225.0,1458607121.0,508530,513564,280.0,284.02,1022094,2882501346.0,5378,2023-11-10 18:15:00
827,SBER,5598,6904,3691238466.0,3084692180.0,1317790,1100228,280.11,280.37,2418018,6775930646.0,12502,5335,6716,3651531604.0,3021834576.0,1303699,1077606,280.09,280.42,2381305,6673366181.0,12051,2023-11-10 18:20:00
828,SBER,3676,3761,1501581973.0,1523476745.0,518133,543750,289.81,280.18,1061883,3025058719.0,7437,3452,3639,1429824385.0,1515561145.0,510688,540607,279.98,280.34,1051295,2945385531.0,7091,2023-11-10 18:25:00
829,SBER,2589,3039,836976308.0,1136964213.0,298518,406582,280.38,279.64,705100,1973940521.0,5628,2283,2854,775768878.0,1072109619.0,277053,382471,280.01,280.31,659524,1847878497.0,5137,2023-11-10 18:30:00
830,SBER,1315,1437,606585887.0,553038054.0,198337,197498,305.84,280.02,395835,1159623941.0,2752,1029,1238,483153333.0,522832280.0,172545,186428,280.02,280.45,358973,1005985614.0,2267,2023-11-10 18:35:00
831,SBER,1250,987,552351490.0,475847225.0,197086,169948,280.26,280.0,367034,1028198715.0,2237,945,796,359488634.0,350701640.0,128686,124956,279.35,280.66,253642,710190274.0,1741,2023-11-10 18:40:00
832,SBER,34704,21169,17565783525.0,8567541399.0,6193017,3008568,283.64,284.77,9201585,26133324925.0,55873,32052,18842,16788811730.0,7812507792.0,5948371,2779262,282.24,281.1,8727633,24601319522.0,50894,2023-11-13 10:05:00
833,SBER,7752,4675,6297672382.0,3018100099.0,2224134,1072808,283.15,281.33,3296942,9315772481.0,12427,6084,3113,5820190703.0,2543180151.0,2064310,902276,281.94,281.86,2966586,8363370855.0,9197,2023-11-13 10:10:00
834,SBER,6061,8021,3985842388.0,5420917408.0,1418676,1929391,280.96,280.97,3348067,9406759796.0,14082,4846,7011,3591580843.0,5034040685.0,1278830,1788502,280.85,281.47,3067332,8625621529.0,11857,2023-11-13 10:15:00
835,SBER,6095,7869,2482065284.0,4740966922.0,877981,1683795,282.7,281.56,2561776,7223032206.0,13964,5066,7012,2230185622.0,4622696893.0,789459,1641892,282.5,281.55,2431351,6852882515.0,12078,2023-11-13 10:20:00
836,SBER,5556,6598,2919284003.0,3930318257.0,1036351,1396564,281.69,281.43,2432915,6849602260.0,12154,4687,5911,2888866434.0,3829337090.0,1025826,1360379,281.61,281.49,2386205,6718203524.0,10598,2023-11-13 10:25:00
837,SBER,15738,15103,9531329182.0,9275904997.0,3342471,3250240,285.16,285.39,6592711,18807234180.0,30841,13803,13302,9084235971.0,8713384115.0,3203794,3067878,283.55,284.02,6271672,17797620087.0,27105,2023-11-13 10:30:00
838,SBER,11865,14231,7326369558.0,6094837877.0,2592015,2138764,282.65,284.97,4730779,13421207435.0,26096,10766,9926,6919282461.0,5778651660.0,2450469,2015974,282.37,286.64,4466443,12697934122.0,20692,2023-11-13 10:35:00
839,SBER,5256,5105,3306027040.0,3144003097.0,1154187,1115814,286.44,281.77,2270001,6450030137.0,10361,4402,4463,3109845148.0,2977696965.0,1094486,1054821,284.14,282.29,2149307,6087542114.0,8865,2023-11-13 10:40:00
840,SBER,3618,3382,2511090034.0,2107217611.0,890101,746421,282.11,282.31,1636522,4618307645.0,7000,3016,2887,2370248453.0,2002862007.0,841144,709191,281.79,282.42,1550335,4373110460.0,5903,2023-11-13 10:45:00
841,SBER,5129,3533,3516355839.0,2217292333.0,1247276,786042,281.92,282.08,2033318,5733648172.0,8662,4629,2922,3412452661.0,2112070512.0,1211027,748042,281.78,282.35,1959069,5524523174.0,7551,2023-11-13 10:50:00
842,SBER,3292,4725,1901445185.0,2499397356.0,674570,886440,281.88,281.96,1561010,4400842542.0,8017,2875,4234,1816082835.0,2385600723.0,644720,845466,281.69,282.16,1490186,4201683559.0,7109,2023-11-13 10:55:00
843,SBER,5126,3621,4095254833.0,2230153610.0,1415820,789914,289.25,282.33,2205734,6325408443.0,8747,4620,3188,3965810922.0,2146385966.0,1376668,759804,288.07,282.49,2136472,6112196888.0,7808,2023-11-13 11:00:00
844,SBER,7174,5120,4723767637.0,3162011022.0,1670726,1119062,282.74,282.56,2789788,7885778659.0,12294,6256,4461,4619763231.0,3057357991.0,1621319,1081142,284.94,282.79,2702461,7677121222.0,10717,2023-11-13 11:05:00
845,SBER,7601,5897,5732108517.0,4225944235.0,1956584,1493618,292.97,282.93,3450202,9958052753.0,13498,6555,4594,5356767200.0,3918548567.0,1838139,1383364,291.42,283.26,3221503,9275315767.0,11149,2023-11-13 11:10:00
846,SBER,7412,6591,4926778790.0,4155682638.0,1738127,1458928,283.45,284.84,3197055,9082461428.0,14003,6592,5783,4618940138.0,3947274762.0,1631053,1392914,283.19,283.38,3023967,8566214901.0,12375,2023-11-13 11:15:00
847,SBER,5041,6099,3060898859.0,4099049617.0,1081708,1430832,282.97,286.48,2512540,7159948477.0,11140,4262,5461,2950559584.0,3871665435.0,1043804,1357614,282.67,285.18,2401418,6822225019.0,9723,2023-11-13 11:20:00
848,SBER,7339,6164,4924064867.0,3890273110.0,1730042,1374931,284.62,282.94,3104973,8814337978.0,13503,6553,5757,4781794548.0,3812780256.0,1690171,1346535,282.92,283.15,3036706,8594574804.0,12310,2023-11-13 11:25:00
849,SBER,5979,4055,3390584432.0,3163234725.0,1191253,1114964,284.62,283.71,2306217,6553819157.0,10034,5365,3618,3465216525.0,3075813883.0,1214651,1076428,285.28,285.74,2291079,6541030409.0,8983,2023-11-13 11:30:00
850,SBER,5737,5375,3924126811.0,3302188157.0,1384352,1165283,283.46,283.38,2549635,7226314969.0,11112,4873,4071,3764668171.0,3116655009.0,1330658,1098790,282.92,283.64,2429448,6881323181.0,8944,2023-11-13 11:35:00
851,SBER,7828,5351,4137581997.0,2417007252.0,1462260,853488,282.96,283.19,2315748,6554589250.0,13179,7119,4611,4023791759.0,2281738624.0,1422686,805240,282.83,283.36,2227926,6305530383.0,11730,2023-11-13 11:40:00
852,SBER,5422,4870,3451865702.0,3849122337.0,1221287,1312031,282.64,293.37,2533318,7300988040.0,10292,4491,4413,3330966416.0,3605780586.0,1178828,1266807,282.57,284.64,2445635,6936747002.0,8904,2023-11-13 11:45:00
853,SBER,8755,8346,4898088975.0,5474216116.0,1734839,1901447,282.34,287.9,3636286,10372305092.0,17101,7689,7915,4733199680.0,5235568082.0,1677155,1812333,282.22,288.89,3489488,9968767762.0,15604,2023-11-13 11:50:00
854,SBER,12468,14190,4729143353.0,6047528654.0,1671234,2120846,282.97,285.15,3792080,10776672007.0,26658,11236,13953,4599261101.0,6058642752.0,1629564,2143373,282.24,282.67,3772937,10657903853.0,25189,2023-11-13 11:55:00
855,SBER,7467,9225,2885543458.0,3426047697.0,1018729,1212378,283.25,282.59,2231107,6311591156.0,16692,6860,8989,2784539650.0,3362388975.0,983324,1189721,283.18,282.62,2173045,6146928625.0,15849,2023-11-13 12:00:00
856,SBER,2987,2123,1865534561.0,1783015961.0,642582,630071,290.32,282.99,1272653,3648550523.0,5110,2334,1860,1730945396.0,1697142228.0,603932,600129,286.61,282.8,1204061,3428087624.0,4194,2023-11-13 12:05:00
857,SBER,3951,3534,2379833676.0,2323769742.0,842156,821139,282.59,282.99,1663295,4703603419.0,7485,3338,3221,2283404486.0,2287618640.0,808615,808291,282.38,283.02,1616906,4571023126.0,6559,2023-11-13 12:10:00
858,SBER,3382,4911,1715958227.0,2443814670.0,606929,863405,282.73,283.04,1470334,4159772897.0,8293,2950,4632,1681505040.0,2368712964.0,595261,836781,282.48,283.07,1432042,4050218004.0,7582,2023-11-13 12:15:00
859,SBER,10082,7321,6805139195.0,4466491167.0,2377328,1557801,286.25,286.72,3935129,11271630362.0,17403,9252,6771,6572784065.0,4288904338.0,2322513,1516042,283.0,282.9,3838555,10861688403.0,16023,2023-11-13 12:20:00
860,SBER,13018,7935,7014537825.0,3296147321.0,2480195,1163817,282.82,283.22,3644012,10310685147.0,20953,12548,7442,6870790401.0,3188350453.0,2430339,1125787,282.71,283.21,3556126,10059140854.0,19990,2023-11-13 12:25:00
861,SBER,7619,5732,3788219871.0,2533444041.0,1339630,894962,282.78,283.08,2234592,6321663913.0,13351,7249,5266,3730500556.0,2468776267.0,1319533,871391,282.71,283.31,2190924,6199276823.0,12515,2023-11-13 12:30:00
862,SBER,4154,4117,2092566190.0,2089678389.0,738251,719029,283.45,290.63,1457280,4182244580.0,8271,3453,3517,1969018995.0,1976551574.0,695971,697146,282.92,283.52,1393117,3945570569.0,6970,2023-11-13 12:35:00
863,SBER,13845,16558,8844517963.0,6939834753.0,3129640,2431242,282.6,285.44,5560882,15784352717.0,30403,13333,16085,8610994565.0,6842055086.0,3046708,2398948,282.63,285.21,5445656,15453049652.0,29418,2023-11-13 12:40:00
864,SBER,2901,2466,1858938075.0,1592683785.0,657905,554049,282.55,287.46,1211954,3451621860.0,5367,2494,2175,1770041149.0,1532059634.0,626608,531386,282.48,288.31,1157994,3302100784.0,4669,2023-11-13 12:45:00
865,SBER,3974,3451,2834304716.0,1902472118.0,967447,666976,292.97,285.24,1634423,4736776834.0,7425,3688,3058,2701481837.0,1862141912.0,956716,648205,282.37,287.28,1604921,4563623749.0,6746,2023-11-13 12:50:00
866,SBER,3172,3313,2056990676.0,2034371143.0,724303,714261,284.0,284.82,1438564,4091361819.0,6485,2818,2912,1987965831.0,2001463633.0,704415,702160,282.22,285.04,1406575,3989429464.0,5730,2023-11-13 12:55:00
867,SBER,3757,2530,2087798909.0,1585297431.0,739884,550930,282.18,287.75,1290814,3673096340.0,6287,3381,2168,2036724176.0,1550530160.0,721946,538399,282.12,287.99,1260345,3587254337.0,5549,2023-11-13 13:00:00
868,SBER,7231,5126,4986580374.0,2847425133.0,1761540,1006680,283.08,282.85,2768220,7834005508.0,12357,6864,4685,4941684780.0,2794806384.0,1746041,988123,283.02,282.84,2734164,7736491165.0,11549,2023-11-13 13:05:00
869,SBER,3208,2821,2125486516.0,1583489957.0,751656,559741,282.77,282.9,1311397,3708976474.0,6029,2930,2465,2057143442.0,1518301270.0,728429,536452,282.41,283.03,1264881,3575444713.0,5395,2023-11-13 13:10:00
870,SBER,9864,8058,6269581765.0,3859381257.0,2217907,1354968,282.68,284.83,3572875,10128963022.0,17922,9589,7750,6249620370.0,3800312718.0,2208146,1338742,283.03,283.87,3546888,10049933088.0,17339,2023-11-13 13:15:00
871,SBER,5859,5438,2952230651.0,2589338938.0,1045528,915642,282.37,282.79,1961170,5541569590.0,11297,5518,5203,2921523898.0,2563289925.0,1034835,906263,282.32,282.84,1941098,5484813823.0,10721,2023-11-13 13:20:00
872,SBER,2635,1549,1509606668.0,1052431052.0,534592,372121,282.38,282.82,906713,2562037720.0,4184,2261,1388,1485995748.0,993742304.0,526333,351402,282.33,282.79,877735,2479738052.0,3649,2023-11-13 13:25:00
873,SBER,3157,2807,1735141381.0,1646382370.0,614510,582097,282.36,282.84,1196607,3381523751.0,5964,2657,2624,1692827647.0,1618032589.0,599562,572028,282.34,282.86,1171590,3310860236.0,5281,2023-11-13 13:30:00
874,SBER,3635,3630,1691458642.0,1973617080.0,598836,697950,282.46,282.77,1296786,3665075722.0,7265,3046,3416,1639303283.0,1936193861.0,580500,684377,282.4,282.91,1264877,3575497144.0,6462,2023-11-13 13:35:00
875,SBER,2402,1892,1224977653.0,1166988714.0,434288,412633,282.07,282.82,846921,2391966367.0,4294,1864,1744,1171124033.0,1152316069.0,414647,407277,282.44,282.93,821924,2323440102.0,3608,2023-11-13 13:40:00
876,SBER,4266,3921,2099232158.0,2159172540.0,742804,763049,282.61,282.97,1505853,4258404699.0,8187,3599,3734,2069355315.0,2156730469.0,732458,762006,282.52,283.03,1494464,4226085784.0,7333,2023-11-13 13:45:00
877,SBER,7209,6141,3876263927.0,3491732642.0,1371643,1233569,282.6,283.06,2605212,7367996569.0,13350,6473,5927,3964125242.0,3434866012.0,1403558,1213475,282.43,283.06,2617033,7398991254.0,12400,2023-11-13 13:50:00
878,SBER,10963,8672,5154871111.0,3244310159.0,1824085,1147014,282.6,282.85,2971099,8399181271.0,19635,10364,8459,5123735310.0,3184343201.0,1813143,1125205,282.59,283.0,2938348,8308078511.0,18823,2023-11-13 13:55:00
879,SBER,7823,5252,3183122349.0,3259625597.0,1126572,1152529,282.55,282.82,2279101,6442747947.0,13075,7195,5075,3164358275.0,3211563795.0,1120286,1134841,282.46,283.0,2255127,6375922070.0,12270,2023-11-13 14:00:00
880,SBER,1049,573,577250770.0,591353541.0,204275,209227,282.59,282.64,413502,1168604312.0,1622,615,449,549952822.0,544613609.0,194795,192457,282.32,282.98,387252,1094566431.0,1064,2023-11-13 14:05:00
881,SBER,2709,1984,1515853137.0,1329255955.0,536284,469764,282.66,282.96,1006048,2845109092.0,4693,2064,1694,1402607673.0,1254832907.0,496441,443338,282.53,283.04,939779,2657440581.0,3758,2023-11-13 14:10:00
882,SBER,2589,2024,1494590583.0,1196001500.0,528872,422722,282.6,282.93,951594,2690592084.0,4613,2120,1853,1452291934.0,1168846899.0,513932,412930,282.58,283.06,926862,2621138834.0,3973,2023-11-13 14:15:00
883,SBER,5708,3704,3569056972.0,2215299648.0,1261499,782269,282.92,283.19,2043768,5784356621.0,9412,5057,3469,3471894366.0,2218804743.0,1228237,783422,282.67,283.22,2011659,5690699109.0,8526,2023-11-13 14:20:00
884,SBER,6230,7705,2596408402.0,7308661144.0,900374,2565490,288.37,284.88,3465864,9905069546.0,13935,5853,7467,2479823208.0,7197855921.0,877087,2544064,282.73,282.93,3421151,9677679129.0,13320,2023-11-13 14:25:00
885,SBER,3445,2214,1724913003.0,864845186.0,609998,305713,282.77,282.89,915711,2589758190.0,5659,3232,2088,1664961804.0,848765082.0,589143,300010,282.61,282.91,889153,2513726887.0,5320,2023-11-13 14:30:00
886,SBER,4744,4023,2219477004.0,2118285406.0,785751,748851,282.47,282.87,1534602,4337762411.0,8767,4528,3851,2209650008.0,2098725623.0,782365,741794,282.43,282.93,1524159,4308375632.0,8379,2023-11-13 14:35:00
887,SBER,8790,7670,4737378383.0,3773209844.0,1677005,1334069,282.49,282.83,3011074,8510588227.0,16460,8556,7521,4705519967.0,3741828717.0,1665723,1322804,282.49,282.87,2988527,8447348685.0,16077,2023-11-13 14:40:00
888,SBER,11997,12294,5216923546.0,7726827982.0,1846609,2732168,282.51,282.81,4578777,12943751528.0,24291,11821,12149,5200838992.0,7696230403.0,1840994,2721320,282.5,282.81,4562314,12897069396.0,23970,2023-11-13 14:45:00
889,SBER,10709,10281,4768393347.0,7176968905.0,1688380,2537496,282.42,282.84,4225876,11945362253.0,20990,10458,10106,4568754393.0,7135557589.0,1617813,2522679,282.4,282.86,4140492,11704311983.0,20564,2023-11-13 14:50:00
890,SBER,4827,3690,2468971412.0,2243825850.0,873668,792786,282.6,283.03,1666454,4712797263.0,8517,4641,3521,2441548050.0,2219422679.0,864076,783932,282.56,283.11,1648008,4660970729.0,8162,2023-11-13 14:55:00
891,SBER,3312,2987,1897334106.0,1879389124.0,671380,664237,282.6,282.94,1335617,3776723230.0,6299,3228,2828,1888873332.0,1846343508.0,668623,652243,282.5,283.08,1320866,3735216840.0,6056,2023-11-13 15:00:00
892,SBER,7992,7380,4461353231.0,3967571852.0,1577829,1401182,282.75,283.16,2979011,8428925083.0,15372,7683,7066,4392831154.0,3876775786.0,1554117,1368700,282.66,283.25,2922817,8269606941.0,14749,2023-11-13 15:05:00
893,SBER,14008,14349,6620002153.0,6150101422.0,2341877,2173619,282.68,282.94,4515496,12770103575.0,28357,13770,13078,6565855382.0,6112097208.0,2323073,2158995,282.64,283.1,4482068,12677952590.0,26848,2023-11-13 15:10:00
894,SBER,5807,6556,3177261842.0,3560219096.0,1124993,1258860,282.43,282.81,2383853,6737480939.0,12363,5588,5784,3134448510.0,3526982964.0,1109932,1246297,282.4,283.0,2356229,6661431475.0,11372,2023-11-13 15:15:00
895,SBER,9371,11181,5002331721.0,5674969471.0,1771085,2006459,282.44,282.84,3777544,10677301192.0,20552,9145,10649,4963156498.0,5613395645.0,1757265,1983963,282.44,282.94,3741228,10576552144.0,19794,2023-11-13 15:20:00
896,SBER,26070,22614,13304613958.0,11789749268.0,4671250,4167643,284.82,282.89,8838893,25094363226.0,48684,25895,22234,13337688294.0,11756028376.0,4702475,4154913,283.63,282.94,8857388,25093716670.0,48129,2023-11-13 15:25:00
897,SBER,4608,4735,2708476950.0,3309954527.0,955706,1170330,283.4,282.82,2126036,6018431478.0,9343,4398,4157,2720924176.0,3271312931.0,943861,1155816,288.28,283.03,2099677,5992237108.0,8555,2023-11-13 15:30:00
898,SBER,7779,7443,3354188144.0,3538517278.0,1186651,1250996,282.66,282.86,2437647,6892705422.0,15222,7584,6564,3372164190.0,3498138155.0,1191177,1235951,283.1,283.03,2427128,6870302345.0,14148,2023-11-13 15:35:00
899,SBER,2563,1983,1377926695.0,1275337031.0,487584,450569,282.6,283.05,938153,2653263726.0,4546,2428,1791,1369848474.0,1247514272.0,484808,440638,282.55,283.12,925446,2617362747.0,4219,2023-11-13 15:40:00
900,SBER,9045,7747,3701595594.0,4921131163.0,1309684,1739418,282.63,282.92,3049102,8622726757.0,16792,8859,7586,3671004705.0,4901259159.0,1299124,1732328,282.58,282.93,3031452,8572263864.0,16445,2023-11-13 15:45:00
901,SBER,1567,1133,844319044.0,835545922.0,298700,295218,282.66,283.03,593918,1679864966.0,2700,1320,979,835979015.0,837426249.0,295926,295745,282.5,283.16,591671,1673405265.0,2299,2023-11-13 15:50:00
902,SBER,5115,4304,2484989466.0,2758897247.0,878828,974736,282.76,283.04,1853564,5243886713.0,9419,4960,4132,2433248695.0,2721638600.0,861027,961403,282.6,283.09,1822430,5154887296.0,9092,2023-11-13 15:55:00
903,SBER,5543,4204,2725947564.0,2357662345.0,963981,832595,282.78,283.17,1796576,5083609909.0,9747,5307,3995,2725749635.0,2349259613.0,964151,829470,282.71,283.22,1793621,5075009249.0,9302,2023-11-13 16:00:00
904,SBER,6298,4711,3262858963.0,2669724271.0,1154246,942535,282.68,283.25,2096781,5932583234.0,11009,6065,4495,3205524819.0,2636806492.0,1133941,930848,282.69,283.27,2064789,5842331311.0,10560,2023-11-13 16:05:00
905,SBER,3484,3879,1984860535.0,2258550290.0,702433,798235,282.57,282.94,1500668,4243410825.0,7363,3263,3662,1940986238.0,2213709801.0,687021,781829,282.52,283.15,1468850,4154696040.0,6925,2023-11-13 16:10:00
906,SBER,4526,3117,2422062313.0,1882429712.0,856990,664936,282.62,283.1,1521926,4304492025.0,7643,4357,2952,2396865826.0,1863855975.0,848183,658205,282.59,283.17,1506388,4260721802.0,7309,2023-11-13 16:15:00
907,SBER,5214,4216,2548741547.0,1501620210.0,887518,515767,287.18,291.14,1403285,4050361757.0,9430,5023,4037,2451868622.0,1441891942.0,867146,499662,282.75,288.57,1366808,3893760564.0,9060,2023-11-13 16:20:00
908,SBER,3956,4888,2376799630.0,2710265693.0,839013,956624,283.29,283.32,1795637,5087065324.0,8844,3516,4538,2260515816.0,2635989538.0,799296,930237,282.81,283.37,1729533,4896505354.0,8054,2023-11-13 16:25:00
909,SBER,11803,10970,7064840390.0,6087590683.0,2495557,2134702,283.1,285.17,4630259,13152431074.0,22773,11317,10379,6987923099.0,5949810238.0,2469348,2084502,282.99,285.43,4553850,12937733337.0,21696,2023-11-13 16:30:00
910,SBER,4528,4055,3572361046.0,1901236849.0,1262279,670790,283.01,283.43,1933069,5473597895.0,8583,4255,3770,3521819379.0,1841492983.0,1244595,649539,282.97,283.51,1894134,5363312362.0,8025,2023-11-13 16:35:00
911,SBER,1713,1737,1141057286.0,1132475234.0,403234,390035,282.98,290.35,793269,2273532520.0,3450,1557,1482,1104862424.0,1078845353.0,390562,371007,282.89,290.79,761569,2183707777.0,3039,2023-11-13 16:40:00
912,SBER,6263,5248,4086422988.0,3442403157.0,1441532,1213819,283.48,283.6,2655351,7528826146.0,11511,5813,4819,3880985295.0,3368708932.0,1370337,1187333,283.21,283.72,2557670,7249694227.0,10632,2023-11-13 16:45:00
913,SBER,10977,10744,6799024140.0,6516120731.0,2396845,2287656,283.67,284.84,4684501,13315144872.0,21721,10356,9940,6572959324.0,6443208819.0,2305864,2248599,285.05,286.54,4554463,13016168143.0,20296,2023-11-13 16:50:00
914,SBER,6789,5001,4502846466.0,3624911296.0,1582789,1223779,284.49,296.21,2806568,8127757762.0,11790,6031,4425,4367728984.0,3407382814.0,1538175,1143099,283.96,298.08,2681274,7775111798.0,10456,2023-11-13 16:55:00
915,SBER,4088,3111,2179033192.0,2108089895.0,768452,742644,283.56,283.86,1511096,4287123087.0,7199,3474,2808,2117310686.0,2017842073.0,746237,710493,283.73,284.01,1456730,4135152759.0,6282,2023-11-13 17:00:00
916,SBER,10781,10045,4701936122.0,4276344834.0,1657410,1485208,283.69,287.93,3142618,8978280957.0,20826,10125,9713,4615017113.0,4154903773.0,1627510,1462936,283.56,284.01,3090446,8769920887.0,19838,2023-11-13 17:05:00
917,SBER,2318,2227,1291505960.0,1460039514.0,455347,501560,283.63,291.1,956907,2751545474.0,4545,1943,1987,1241749619.0,1448590194.0,437962,489062,283.53,296.2,927024,2690339814.0,3930,2023-11-13 17:10:00
918,SBER,5226,4105,2912043737.0,2494535505.0,1027509,879234,283.41,283.72,1906743,5406579242.0,9331,4719,3847,2852067790.0,2446337998.0,1006413,861653,283.39,283.91,1868066,5298405789.0,8566,2023-11-13 17:15:00
919,SBER,4502,1904,2276765368.0,1297468031.0,802826,450290,283.59,288.14,1253116,3574233399.0,6406,3938,1715,2250455704.0,1284502662.0,793810,445594,283.5,288.27,1239404,3534958366.0,5653,2023-11-13 17:20:00
920,SBER,12826,10655,7418795708.0,4496786678.0,2617109,1584572,283.47,283.79,4201681,11915582387.0,23481,12323,10361,7175776981.0,4380694040.0,2530983,1542343,283.52,284.03,4073326,11556471021.0,22684,2023-11-13 17:25:00
921,SBER,3740,2711,2609356310.0,2020846820.0,892259,711636,292.44,283.97,1603895,4630203131.0,6451,3102,2129,2487354799.0,1854683732.0,865978,652535,287.23,284.23,1518513,4342038532.0,5231,2023-11-13 17:30:00
922,SBER,4106,4709,2657675820.0,3213138643.0,935411,1111895,284.12,288.98,2047306,5870814463.0,8815,3473,4075,2550244595.0,3114251489.0,898602,1085139,283.8,286.99,1983741,5664496085.0,7548,2023-11-13 17:35:00
923,SBER,7015,7522,4254347906.0,4114804124.0,1489159,1449486,285.69,283.88,2938645,8369152031.0,14537,6625,6032,4100597287.0,3981386497.0,1440498,1400693,284.67,284.24,2841191,8081983784.0,12657,2023-11-13 17:40:00
924,SBER,6247,6935,3406786261.0,3941546075.0,1199972,1388320,283.91,283.91,2588292,7348332336.0,13182,5869,6669,3341694102.0,3869057464.0,1177442,1361239,283.81,284.23,2538681,7210751566.0,12538,2023-11-13 17:45:00
925,SBER,3083,2169,1628318070.0,1282761923.0,573288,451605,284.03,284.05,1024893,2911079994.0,5252,2587,1906,1540266842.0,1247834366.0,542737,438786,283.8,284.38,981523,2788101208.0,4493,2023-11-13 17:50:00
926,SBER,4150,4222,1869663144.0,1570505965.0,637883,552892,293.1,284.05,1190775,3440169109.0,8372,3534,2777,1537537980.0,1428127339.0,541305,501614,284.04,284.71,1042919,2965665319.0,6311,2023-11-13 17:55:00
927,SBER,10320,10670,4734797040.0,6412895814.0,1661992,2253841,284.89,284.53,3915833,11147692854.0,20990,9550,9456,4633160815.0,6280324823.0,1626617,2205422,284.83,284.77,3832039,10913485638.0,19006,2023-11-13 18:00:00
928,SBER,6193,5161,2612707694.0,2298416302.0,909777,791898,287.18,290.24,1701675,4911123996.0,11354,5628,4414,2414911030.0,2134144436.0,849373,735582,284.32,290.13,1584955,4549055466.0,10042,2023-11-13 18:05:00
929,SBER,12471,13612,4590143495.0,6631272629.0,1557227,2293335,294.76,289.15,3850562,11221416124.0,26083,11698,12937,4324058502.0,6339267661.0,1476589,2226911,292.84,284.67,3703500,10663326164.0,24635,2023-11-13 18:10:00
930,SBER,5497,5329,2418649366.0,2860928123.0,839902,969083,287.97,295.22,1808985,5279577490.0,10826,5081,4734,2256639632.0,2594771159.0,783022,891666,288.2,291.0,1674688,4851410791.0,9815,2023-11-13 18:15:00
931,SBER,6596,6573,2514440133.0,4137465827.0,866389,1434527,290.22,288.42,2300916,6651905961.0,13169,6290,6202,2422821749.0,4045836457.0,852382,1401610,284.24,288.66,2253992,6468658206.0,12492,2023-11-13 18:20:00
932,SBER,6983,7609,3003993520.0,4286877375.0,1010027,1509273,297.42,284.04,2519300,7290870896.0,14592,6527,7224,2853860335.0,4182694715.0,987810,1470501,288.91,284.44,2458311,7036555051.0,13751,2023-11-13 18:25:00
933,SBER,6301,7338,2464779057.0,3827037553.0,867902,1345444,283.99,284.44,2213346,6291816610.0,13639,6044,7064,2434964845.0,3807150728.0,857638,1338189,283.92,284.5,2195827,6242115573.0,13108,2023-11-13 18:30:00
934,SBER,2235,2263,1145407508.0,1260025493.0,403117,442924,284.14,284.48,846041,2405433002.0,4498,1972,1953,1024207338.0,1177089952.0,345815,413402,296.17,284.73,759217,2201297291.0,3925,2023-11-13 18:35:00
935,SBER,8894,13081,2347840607.0,6738162986.0,826219,2369236,284.17,284.4,3195455,9086003594.0,21975,8677,12904,2354758765.0,6719818472.0,829626,2362246,283.83,284.47,3191872,9074577237.0,21581,2023-11-13 18:40:00
936,SBER,4058,7194,3253256634.0,4365330847.0,1142176,1533582,284.83,284.65,2675758,7618587481.0,11252,2397,5496,2839721843.0,3831372134.0,1000635,1348194,283.79,284.19,2348829,6671093977.0,7893,2023-11-14 10:05:00
937,SBER,3896,3576,1832764031.0,2242396821.0,647591,787133,283.01,284.88,1434724,4075160852.0,7472,2379,2645,1402677079.0,1956103509.0,496699,684812,282.4,285.64,1181511,3358780588.0,5024,2023-11-14 10:10:00
938,SBER,4456,3394,2488284175.0,2037205305.0,861225,717970,288.92,283.75,1579195,4525489480.0,7850,3350,2407,2210900010.0,1807915330.0,782446,637619,282.56,283.54,1420065,4018815341.0,5757,2023-11-14 10:15:00
939,SBER,8287,12850,4704373773.0,9990277480.0,1620886,3457680,290.23,288.93,5078566,14694651253.0,21137,5674,10784,3846575864.0,9280778969.0,1367176,3223182,281.35,287.94,4590358,13127354833.0,16458,2023-11-14 10:20:00
940,SBER,7814,10188,5139939259.0,7763380764.0,1814709,2748904,283.24,282.42,4563613,12903320024.0,18002,5763,9126,4774191334.0,7510163656.0,1691846,2650199,282.19,283.38,4342045,12284354991.0,14889,2023-11-14 10:25:00
941,SBER,11741,12118,7045468793.0,8895547803.0,2484272,3133152,283.6,283.92,5617424,15941016596.0,23859,10106,10856,6616213881.0,8539908097.0,2337664,3023460,283.03,282.45,5361124,15156121978.0,20962,2023-11-14 10:30:00
942,SBER,11018,11547,6574632141.0,6114359911.0,2306044,2147280,285.1,284.75,4453324,12688992052.0,22565,10270,10281,6385092664.0,5936172923.0,2245978,2073815,284.29,286.24,4319793,12321265588.0,20551,2023-11-14 10:35:00
943,SBER,5258,5857,3046406632.0,3737227702.0,1073951,1283604,283.66,291.15,2357555,6783634334.0,11115,4154,5328,2881901552.0,3567773853.0,1018229,1234784,283.03,288.94,2253013,6449675406.0,9482,2023-11-14 10:40:00
944,SBER,4853,10288,4058153619.0,8283417664.0,1440699,2932472,281.68,282.47,4373171,12341571284.0,15141,3755,8859,3832074873.0,7969063962.0,1361100,2810180,281.54,283.58,4171280,11801138836.0,12614,2023-11-14 10:45:00
945,SBER,6427,2392,6853371613.0,1207749062.0,2427526,417424,282.32,289.33,2844950,8061120675.0,8819,4467,1858,6674534505.0,1080372640.0,2366066,382128,282.09,282.73,2748194,7754907145.0,6325,2023-11-14 10:50:00
946,SBER,3355,4888,3661106172.0,3238776783.0,1294421,1139598,282.84,284.2,2434019,6899882956.0,8243,2717,4402,3549716693.0,3125561865.0,1256035,1104500,282.61,282.98,2360535,6675278558.0,7119,2023-11-14 10:55:00
947,SBER,7084,9231,4633039647.0,3839720493.0,1640541,1355654,282.41,283.24,2996195,8472760140.0,16315,6515,8824,4550956414.0,3762124107.0,1611708,1323910,282.37,284.17,2935618,8313080521.0,15339,2023-11-14 11:00:00
948,SBER,2404,1710,1933038142.0,1463800247.0,684706,513104,282.32,285.28,1197810,3396838389.0,4114,1869,1292,1861746776.0,1400692152.0,659986,495341,282.09,282.77,1155327,3262438929.0,3161,2023-11-14 11:05:00
949,SBER,4601,2650,4576786760.0,2426902862.0,1614962,849918,283.4,285.55,2464880,7003689623.0,7251,3845,2182,4380119474.0,2336852613.0,1550395,821599,282.52,284.43,2371994,6716972087.0,6027,2023-11-14 11:10:00
950,SBER,5794,4519,6380422655.0,3420575441.0,2257291,1196724,282.66,285.83,3454015,9800998096.0,10313,5160,3791,6239738561.0,3338617280.0,2207719,1163583,282.63,286.93,3371302,9578355841.0,8951,2023-11-14 11:15:00
951,SBER,2836,2635,2269735195.0,2012194662.0,802920,706175,282.69,284.94,1509095,4281929857.0,5471,2145,2356,2160049511.0,1895909210.0,764576,669574,282.52,283.15,1434150,4055958722.0,4501,2023-11-14 11:20:00
952,SBER,1937,5994,1263053912.0,3313291451.0,447068,1150975,282.52,287.87,1598043,4576345364.0,7931,1456,5811,1232764246.0,3257661201.0,436508,1146159,282.42,284.22,1582667,4490425448.0,7267,2023-11-14 11:25:00
953,SBER,1473,1533,1157762469.0,1364284851.0,409822,482009,282.5,283.04,891831,2522047321.0,3006,1029,1297,1130613573.0,1348261701.0,400366,476254,282.4,283.1,876620,2478875275.0,2326,2023-11-14 11:30:00
954,SBER,1869,3002,1430529476.0,2581844403.0,505706,913220,282.88,282.72,1418926,4012373879.0,4871,1361,2783,1382543114.0,2504618181.0,489818,885136,282.26,282.96,1374954,3887161296.0,4144,2023-11-14 11:35:00
955,SBER,2250,1734,1279994346.0,1347617255.0,452913,476566,282.61,282.78,929479,2627611602.0,3984,1803,1603,1227342221.0,1291498506.0,434493,456282,282.48,283.05,890775,2518840727.0,3406,2023-11-14 11:40:00
956,SBER,8783,20025,4378084003.0,9856147737.0,1549023,3484558,282.64,282.85,5033581,14234231740.0,28808,8336,19813,4318152043.0,9783849522.0,1528339,3457736,282.54,282.96,4986075,14102001566.0,28149,2023-11-14 11:45:00
957,SBER,3517,3123,1773506877.0,1779475818.0,626962,628441,282.87,283.16,1255403,3552982695.0,6640,2901,2911,1691663435.0,1745403067.0,598389,616125,282.7,283.29,1214514,3437066503.0,5812,2023-11-14 11:50:00
958,SBER,20698,22329,10894059245.0,11746764340.0,3847951,4146077,283.11,283.32,7994028,22640823585.0,43027,20025,22029,10735237118.0,11693495120.0,3792803,4126255,283.04,283.39,7919058,22428732238.0,42054,2023-11-14 11:55:00
959,SBER,3875,4578,2488105595.0,3200606515.0,873781,1128098,284.75,283.72,2001879,5688712110.0,8453,3332,4216,2368412443.0,3068148643.0,834323,1081503,283.87,283.69,1915826,5436561087.0,7548,2023-11-14 12:00:00
960,SBER,24782,15611,20741487011.0,6430577455.0,7310707,2264679,283.71,283.95,9575386,27172064467.0,40393,24117,15053,20559909508.0,6316182985.0,7251030,2224002,283.54,284.0,9475032,26876092494.0,39170,2023-11-14 12:05:00
961,SBER,9707,8114,6629983917.0,2927098790.0,2339641,1032263,283.38,283.56,3371904,9557082708.0,17821,9247,7795,6568763887.0,2858108132.0,2318167,1007339,283.36,283.73,3325506,9426872019.0,17042,2023-11-14 12:10:00
962,SBER,7377,4697,4670542902.0,1750633667.0,1648654,617684,283.29,283.42,2266338,6421176569.0,12074,7038,4489,4628678647.0,1685007703.0,1634368,594211,283.21,283.57,2228579,6313686351.0,11527,2023-11-14 12:15:00
963,SBER,1710,1376,852737935.0,644849301.0,301221,227554,283.09,283.38,528775,1497587237.0,3086,1379,1101,797722512.0,615761041.0,281801,217071,283.08,283.67,498872,1413483553.0,2480,2023-11-14 12:20:00
964,SBER,5355,4497,3417678937.0,1894869599.0,1205670,667788,283.47,283.75,1873458,5312548536.0,9852,4946,4169,3353549890.0,1865380606.0,1183859,657364,283.27,283.77,1841223,5218930496.0,9115,2023-11-14 12:25:00
965,SBER,3163,3011,1839799678.0,1871942527.0,649862,662534,283.11,282.54,1312396,3711742205.0,6174,2822,2589,1798201639.0,1752834005.0,635314,617960,283.04,283.65,1253274,3551035644.0,5411,2023-11-14 12:30:00
966,SBER,19410,21616,10640144648.0,11514961024.0,3753596,4071266,283.47,282.83,7824862,22155105672.0,41026,18736,20901,10510979354.0,11351547216.0,3712650,4009880,283.11,283.09,7722530,21862526571.0,39637,2023-11-14 12:35:00
967,SBER,57121,58412,30962970458.0,32750597625.0,10967278,11584258,282.32,282.72,22551536,63713568083.0,115533,56705,57980,30815063765.0,32678358697.0,10915258,11562676,282.31,282.62,22477934,63493422462.0,114685,2023-11-14 12:40:00
968,SBER,2519,1836,1530881592.0,1198673429.0,541698,420893,282.61,284.79,962591,2729555022.0,4355,2148,1476,1460672939.0,1178955956.0,517414,411668,282.3,286.39,929082,2639628896.0,3624,2023-11-14 12:45:00
969,SBER,1680,2119,1033730545.0,1329170316.0,365447,469051,282.87,283.37,834498,2362900861.0,3799,1450,1771,986121479.0,1327630181.0,349035,456481,282.53,290.84,805516,2313751660.0,3221,2023-11-14 12:50:00
970,SBER,2507,3036,1552577336.0,1830233645.0,549355,646858,282.62,282.94,1196213,3382810982.0,5543,2293,2566,1437268496.0,1630296522.0,508811,576041,282.48,283.02,1084852,3067565019.0,4859,2023-11-14 12:55:00
971,SBER,6178,5781,6945834632.0,2700597936.0,2454891,903860,282.94,298.78,3358751,9646432569.0,11959,5917,5450,6849872002.0,2568140913.0,2421882,907016,282.83,283.14,3328898,9418012915.0,11367,2023-11-14 13:00:00
972,SBER,12798,3748,9745352716.0,1269163660.0,3431038,412896,284.04,307.38,3843934,11014516376.0,16546,12602,3419,9670955770.0,1291128133.0,3416489,410670,283.07,314.4,3827159,10962083903.0,16021,2023-11-14 13:05:00
973,SBER,9964,8633,5743100905.0,4218997365.0,2030591,1413225,282.83,298.54,3443816,9962098270.0,18597,9758,8296,5726655365.0,4174436588.0,2024846,1398033,282.82,298.59,3422879,9901091954.0,18054,2023-11-14 13:10:00
974,SBER,15934,9968,12693035446.0,4037692385.0,4487655,1419119,282.84,284.52,5906774,16730727831.0,25902,15773,9734,12673359940.0,4000499652.0,4481022,1404336,282.82,284.87,5885358,16673859592.0,25507,2023-11-14 13:15:00
975,SBER,3347,2520,1936070057.0,1262242286.0,684932,410167,282.67,307.74,1095099,3198312344.0,5867,3129,2199,1902814073.0,1186541721.0,673431,400405,282.56,296.34,1073836,3089355795.0,5328,2023-11-14 13:20:00
976,SBER,1995,1878,969333640.0,937135580.0,342865,311056,282.72,301.28,653921,1906469221.0,3873,1668,1742,939898702.0,911970539.0,332600,302112,282.59,301.87,634712,1851869241.0,3410,2023-11-14 13:25:00
977,SBER,1915,1404,984155292.0,717496352.0,348005,253387,282.8,283.16,601392,1701651645.0,3319,1668,1245,973119467.0,731997262.0,344276,258425,282.66,283.25,602701,1705116729.0,2913,2023-11-14 13:30:00
978,SBER,4821,12832,1980038503.0,1575699472.0,700337,556663,282.73,283.06,1257000,3555737976.0,17653,4466,12707,1973528941.0,1546767409.0,698391,546333,282.58,283.12,1244724,3520296351.0,17173,2023-11-14 13:35:00
979,SBER,2632,2292,1380778746.0,1268822841.0,489001,448499,282.37,282.9,937500,2649601588.0,4924,2304,2139,1363003934.0,1242841009.0,482650,439195,282.4,282.98,921845,2605844944.0,4443,2023-11-14 13:40:00
980,SBER,2326,1821,1290110833.0,1229499219.0,456971,423780,282.32,290.13,880751,2519610053.0,4147,1973,1633,1265693302.0,1197442206.0,448416,412122,282.26,290.56,860538,2463135508.0,3606,2023-11-14 13:45:00
981,SBER,5405,7894,2496214006.0,3339164197.0,881215,1180911,283.27,282.76,2062126,5835378203.0,13299,4975,7671,2446602562.0,3197822621.0,864174,1130779,283.11,282.8,1994953,5644425183.0,12646,2023-11-14 13:50:00
982,SBER,7596,8692,3394090435.0,3886883709.0,1201745,1374526,282.43,282.78,2576271,7280974145.0,16288,7306,8582,3364279340.0,3864216098.0,1191218,1366456,282.42,282.79,2557674,7228495438.0,15888,2023-11-14 13:55:00
983,SBER,5320,4866,2580449448.0,2357926879.0,913350,833854,282.53,282.77,1747204,4938376328.0,10186,5031,4811,2574065145.0,2368043995.0,911469,837213,282.41,282.85,1748682,4942109141.0,9842,2023-11-14 14:00:00
984,SBER,784,598,581558683.0,615902512.0,205850,217964,282.52,282.57,423814,1197461196.0,1382,496,360,574677999.0,558645211.0,203590,197412,282.27,282.98,401002,1133323211.0,856,2023-11-14 14:05:00
985,SBER,3046,9565,2388529849.0,12511467891.0,847029,4432103,281.99,282.29,5279132,14899997740.0,12611,2372,9204,2290550386.0,12400673542.0,812674,4391254,281.85,282.39,5203928,14691223928.0,11576,2023-11-14 14:10:00
986,SBER,8620,5949,4389451696.0,4283228563.0,1538803,1518676,285.25,282.04,3057479,8672680259.0,14569,8092,5420,4247097496.0,4124960168.0,1490193,1460945,285.0,282.35,2951138,8372057664.0,13512,2023-11-14 14:15:00
987,SBER,3556,3755,1935519045.0,2049661205.0,682814,726172,283.46,282.26,1408986,3985180250.0,7311,3310,3473,1879665613.0,1986227700.0,665720,703339,282.35,282.4,1369059,3865893313.0,6783,2023-11-14 14:20:00
988,SBER,8399,10598,4233867284.0,6421081299.0,1504574,2248732,281.4,285.54,3753306,10654948583.0,18997,7958,9700,4117504953.0,6268632803.0,1462840,2187451,281.47,286.57,3650291,10386137757.0,17658,2023-11-14 14:25:00
989,SBER,11945,13575,6830986089.0,8034451316.0,2404829,2859409,284.05,280.98,5264238,14865437406.0,25520,10824,12013,6555709818.0,7678876267.0,2334244,2713459,280.85,282.99,5047703,14234586086.0,22837,2023-11-14 14:30:00
990,SBER,6286,7757,3921803416.0,4774264229.0,1395058,1691003,281.12,282.33,3086061,8696067646.0,14043,5428,7063,3677709245.0,4555834795.0,1306988,1617225,281.39,281.71,2924213,8233544040.0,12491,2023-11-14 14:35:00
991,SBER,4245,5719,2171605511.0,3515542852.0,771500,1245267,281.48,282.31,2016767,5687148363.0,9964,3760,5319,2129106854.0,3406452429.0,754812,1210843,282.07,281.33,1965655,5535559284.0,9079,2023-11-14 14:40:00
992,SBER,12128,10319,6839376802.0,5950783564.0,2427213,2093348,281.78,284.27,4520561,12790160366.0,22447,11565,9835,6655035937.0,5762601095.0,2365079,2046115,281.39,281.64,4411194,12417637033.0,21400,2023-11-14 14:45:00
993,SBER,12911,13734,7361098182.0,7348840503.0,2614032,2596394,281.6,283.04,5210426,14709938685.0,26645,12444,13257,7197835718.0,7223508291.0,2556972,2550992,281.5,283.16,5107964,14421344010.0,25701,2023-11-14 14:50:00
994,SBER,3240,4270,2009861446.0,2323478613.0,711109,824561,282.64,281.78,1535670,4333340060.0,7510,2947,4056,1935139434.0,2286831421.0,687493,811339,281.48,281.86,1498832,4221970855.0,7003,2023-11-14 14:55:00
995,SBER,3672,4685,2198307752.0,2743842099.0,781588,968295,281.26,283.37,1749883,4942149852.0,8357,3329,4227,2098715579.0,2562891073.0,746370,903160,281.19,283.77,1649530,4661606652.0,7556,2023-11-14 15:00:00
996,SBER,8896,7915,4856820119.0,4020687148.0,1727506,1429250,281.15,281.31,3156756,8877507267.0,16811,8529,7713,4793072478.0,3997782087.0,1705610,1420939,281.02,281.35,3126549,8790854566.0,16242,2023-11-14 15:05:00
997,SBER,5822,7711,3699152759.0,4423061575.0,1314694,1568506,281.37,281.99,2883200,8122214334.0,13533,5217,6844,3563033798.0,4152386685.0,1267212,1477292,281.17,281.08,2744504,7715420483.0,12061,2023-11-14 15:10:00
998,SBER,2625,5307,2122393914.0,3373797293.0,747411,1201991,283.97,280.68,1949402,5496191208.0,7932,1876,4782,1944953932.0,3301779047.0,691070,1175600,281.44,280.86,1866670,5246732980.0,6658,2023-11-14 15:15:00
999,SBER,6652,7729,4320726337.0,5159653037.0,1536031,1836479,281.29,280.95,3372510,9480379375.0,14381,3138,7051,4159922421.0,5101543371.0,1480127,1815126,281.05,281.06,3295253,9261465792.0,10189,2023-11-14 15:20:00
1000,SBER,2516,7836,2064760508.0,11700488345.0,735509,4139434,280.73,282.66,4874943,13765248854.0,10352,1666,7481,1997922844.0,11594941322.0,712426,4105603,280.44,282.42,4818029,13592864167.0,9147,2023-11-14 15:25:00
1001,SBER,2331,8581,2402619222.0,7810011813.0,852558,2758629,281.81,283.11,3611187,10212631036.0,10912,2019,8099,2283596757.0,7727734706.0,813165,2729243,280.83,283.15,3542408,10011331463.0,10118,2023-11-14 15:30:00
1002,SBER,3949,3328,4413104497.0,1773228559.0,1568231,630053,281.41,281.44,2198284,6186333057.0,7277,3600,2929,4318332551.0,1710288348.0,1536085,607538,281.13,281.51,2143623,6028620899.0,6529,2023-11-14 15:35:00
1003,SBER,1858,3821,1730881578.0,1920803912.0,614682,648373,281.59,296.25,1263055,3651685491.0,5679,1534,3491,1631027849.0,1844414373.0,579955,619280,281.23,297.83,1199235,3475442223.0,5025,2023-11-14 15:40:00
1004,SBER,1813,2244,1480380684.0,1167989580.0,526463,414859,281.19,281.54,941322,2648370264.0,4057,1623,2078,1460736777.0,1122947882.0,519479,398724,281.19,281.64,918203,2583684659.0,3701,2023-11-14 15:45:00
1005,SBER,1195,788,970331911.0,613139658.0,345040,207885,281.22,294.94,552925,1583471570.0,1983,968,639,923322655.0,574358590.0,328548,198761,281.03,288.97,527309,1497681246.0,1607,2023-11-14 15:50:00
1006,SBER,1339,952,1060696117.0,799076231.0,374512,273686,283.22,291.97,648198,1859772348.0,2291,1107,831,989399841.0,799160940.0,349020,273605,283.48,292.09,622625,1788560781.0,1938,2023-11-14 15:55:00
1007,SBER,1542,1144,1147930103.0,915138489.0,407200,301269,281.91,303.76,708469,2063068592.0,2686,1222,969,1092220628.0,900405106.0,387921,290372,281.56,310.09,678293,1992625735.0,2191,2023-11-14 16:00:00
1008,SBER,1885,3150,1349881471.0,1781378287.0,479281,632323,281.65,281.72,1111604,3131259758.0,5035,1660,2954,1305359566.0,1739293411.0,463741,617021,281.48,281.89,1080762,3044652977.0,4614,2023-11-14 16:05:00
1009,SBER,2499,2653,2060485567.0,1337102244.0,731919,474558,281.52,281.76,1206477,3397587812.0,5152,2339,2369,2014671029.0,1282514394.0,715807,455063,281.45,281.83,1170870,3297185423.0,4708,2023-11-14 16:10:00
1010,SBER,4954,3900,4213794993.0,1754150863.0,1497283,601941,281.43,291.42,2099224,5967945857.0,8854,4769,3684,4162006513.0,1695048618.0,1478890,589532,281.43,287.52,2068422,5857055131.0,8453,2023-11-14 16:15:00
1011,SBER,4528,3719,3430615881.0,1786497893.0,1218607,634134,281.52,281.72,1852741,5217113775.0,8247,4319,3590,3383483894.0,1771568094.0,1202284,628647,281.42,281.81,1830931,5155051988.0,7909,2023-11-14 16:20:00
1012,SBER,7371,6610,7479875672.0,2244100207.0,2655948,796380,281.63,281.79,3452328,9723975880.0,13981,7223,6400,7448933677.0,2206880304.0,2645172,782987,281.6,281.85,3428159,9655813981.0,13623,2023-11-14 16:25:00
1013,SBER,7349,7300,5130830275.0,3586841822.0,1820115,1272978,281.9,281.77,3093093,8717672098.0,14649,7074,7076,5056289186.0,3521998874.0,1794756,1248887,281.73,282.01,3043643,8578288060.0,14150,2023-11-14 16:30:00
1014,SBER,9773,10138,7113988224.0,4810528176.0,2522728,1704832,282.0,282.17,4227560,11924516401.0,19911,9532,9883,7058029857.0,4773061952.0,2503406,1691376,281.94,282.2,4194782,11831091810.0,19415,2023-11-14 16:35:00
1015,SBER,26453,24085,21904349306.0,10928070662.0,7765768,3872434,282.06,282.2,11638202,32832419968.0,50538,26237,23852,21849807448.0,10817824890.0,7747078,3832183,282.04,282.29,11579261,32667632339.0,50089,2023-11-14 16:40:00
1016,SBER,3114,2918,1773951888.0,1553337023.0,627189,550724,282.84,282.05,1177913,3327288912.0,6032,2921,2729,1746164288.0,1528163922.0,617242,541692,282.9,282.11,1158934,3274328210.0,5650,2023-11-14 16:45:00
1017,SBER,6969,5759,4211921136.0,3199472429.0,1491243,1123660,282.44,284.74,2614903,7411393565.0,12728,6645,5553,4016200513.0,3181792236.0,1419500,1110132,282.93,286.61,2529632,7197992750.0,12198,2023-11-14 16:50:00
1018,SBER,5384,9532,3086457007.0,5645031057.0,1093588,1992830,282.23,283.27,3086418,8731488064.0,14916,5161,9266,3006192253.0,5521184058.0,1065836,1955553,282.05,282.33,3021389,8527376311.0,14427,2023-11-14 16:55:00
1019,SBER,4874,5147,4176698667.0,2996291224.0,1465772,1046893,284.95,286.21,2512665,7172989892.0,10021,4621,4936,4071836487.0,2920365513.0,1443762,1027223,282.03,284.3,2470985,6992202001.0,9557,2023-11-14 17:00:00
1020,SBER,9616,6845,9527640728.0,2978198303.0,3375702,1054104,282.24,282.53,4429806,12505839031.0,16461,9404,6625,9445459018.0,2940093151.0,3346896,1040634,282.22,282.53,4387530,12385552170.0,16029,2023-11-14 17:05:00
1021,SBER,19224,13455,16753814565.0,5579361949.0,5937529,1975846,282.17,282.38,7913375,22333176515.0,32679,19032,13292,16721954851.0,5550725536.0,5926591,1965552,282.15,282.4,7892143,22272680387.0,32324,2023-11-14 17:10:00
1022,SBER,9591,6994,11291914802.0,2296130930.0,4000869,785622,282.24,292.27,4786491,13588045733.0,16585,9450,6868,11289482052.0,2198209320.0,4000167,778351,282.23,282.42,4778518,13487691372.0,16318,2023-11-14 17:15:00
1023,SBER,2162,3746,2378883356.0,2553149118.0,834331,905145,285.12,282.07,1739476,4932032474.0,5908,1919,3458,2310053548.0,2476556279.0,818625,877198,282.19,282.33,1695823,4786609827.0,5377,2023-11-14 17:20:00
1024,SBER,1394,3008,807623365.0,1654148878.0,276687,585784,291.89,282.38,862471,2461772244.0,4402,1101,2816,730571588.0,1601069854.0,258901,566850,282.18,282.45,825751,2331641442.0,3917,2023-11-14 17:25:00
1025,SBER,2854,3272,1413130726.0,1254467410.0,497434,444597,284.08,282.16,942031,2667598136.0,6126,2717,3109,1382809369.0,1226460871.0,490083,434415,282.16,282.32,924498,2609270240.0,5826,2023-11-14 17:30:00
1026,SBER,1453,1948,666596398.0,1061952169.0,235462,376302,283.1,282.21,611764,1728548568.0,3401,1018,1784,627027607.0,1038307502.0,222288,367694,282.08,282.38,589982,1665335109.0,2802,2023-11-14 17:35:00
1027,SBER,1723,1719,792441830.0,712920959.0,280790,252933,282.22,281.86,533723,1505362789.0,3442,1396,1467,739029383.0,672784458.0,262111,238236,281.95,282.4,500347,1411813842.0,2863,2023-11-14 17:40:00
1028,SBER,535,890,275744420.0,387890426.0,94668,137856,291.28,281.37,232524,663634847.0,1425,369,679,253229492.0,364702355.0,86809,129121,291.71,282.45,215930,617931847.0,1048,2023-11-14 17:45:00
1029,SBER,1269,1121,456275401.0,456429376.0,161489,151774,282.54,300.73,313263,912704778.0,2390,997,887,417395235.0,434273703.0,147931,143648,282.16,302.32,291579,851668939.0,1884,2023-11-14 17:50:00
1030,SBER,4575,11615,2117893123.0,5611284171.0,751073,1984146,281.98,282.81,2735219,7729177295.0,16190,4272,11383,2080605030.0,5526614940.0,737896,1953039,281.96,282.98,2690935,7607219970.0,15655,2023-11-14 17:55:00
1031,SBER,5509,4710,1903683978.0,2686183712.0,675563,945426,281.79,284.12,1620989,4589867690.0,10219,5372,4570,1866213646.0,2623533695.0,662427,895478,281.72,292.98,1557905,4489747342.0,9942,2023-11-14 18:00:00
1032,SBER,2871,3624,1381695966.0,1897225617.0,490444,673166,281.72,281.84,1163610,3278921584.0,6495,2646,3479,1312822954.0,1887171720.0,466088,669336,281.67,281.95,1135424,3199994674.0,6125,2023-11-14 18:05:00
1033,SBER,3214,3948,1595354518.0,2158458312.0,566422,766022,281.65,281.77,1332444,3753812830.0,7162,3098,3797,1597539639.0,2142454010.0,567270,759942,281.62,281.92,1327212,3739993650.0,6895,2023-11-14 18:10:00
1034,SBER,3411,4987,1752574010.0,2455878881.0,622163,871667,281.69,281.75,1493830,4208452891.0,8398,3230,4808,1689824285.0,2402316144.0,600151,852398,281.57,281.83,1452549,4092140429.0,8038,2023-11-14 18:15:00
1035,SBER,2560,3334,1133473055.0,1508001585.0,402694,535475,281.47,281.62,938169,2641474640.0,5894,2358,3140,1111718549.0,1484807866.0,395057,524161,281.41,283.27,919218,2596526415.0,5498,2023-11-14 18:20:00
1036,SBER,9147,11243,4499043127.0,5806943774.0,1599552,2063291,281.27,281.44,3662843,10305986901.0,20390,8885,11056,4435509019.0,5745269086.0,1577220,2040911,281.22,281.51,3618131,10180778105.0,19941,2023-11-14 18:25:00
1037,SBER,4649,5183,2457410552.0,2595441388.0,870574,921148,282.27,281.76,1791722,5052851941.0,9832,4388,4914,2414342585.0,2511184999.0,856577,891166,281.86,281.79,1747743,4925527584.0,9302,2023-11-14 18:30:00
1038,SBER,1594,1647,811128954.0,930834656.0,288155,325827,281.49,285.68,613982,1741963610.0,3241,1383,1574,735588740.0,820145029.0,261323,291000,281.49,281.84,552323,1555733770.0,2957,2023-11-14 18:35:00
1039,SBER,20341,20797,11308926875.0,11300396667.0,4014575,4003372,281.7,282.27,8017947,22609323542.0,41138,20200,20720,11294687027.0,11290006588.0,4009607,3999316,281.69,282.3,8008923,22584693615.0,40920,2023-11-14 18:40:00
1040,SBER,19943,19197,686278034.0,686278034.0,2475294,2275482,27.73,27.73,4750776,1317333425.0,39140,18214,17412,653138552.0,653138552.0,2336725,2162176,27.95,28.0,4498901,1258467813.0,35626,2023-11-29 10:05:00
1041,SBER,16181,10461,554897117.0,554897117.0,1992551,1003127,27.85,27.78,2995678,833603117.0,26642,15201,9355,546314421.0,546314421.0,1951817,937718,27.99,28.03,2889535,809191955.0,24556,2023-11-29 10:10:00
1042,SBER,10775,11112,330940873.0,330940873.0,1184297,1029224,27.94,27.91,2213521,618206422.0,21887,10096,10378,323135222.0,323135222.0,1154383,993478,27.99,28.02,2147861,601478437.0,20474,2023-11-29 10:15:00
1043,SBER,10030,9141,470759315.0,470759315.0,1686854,1090062,27.91,27.81,2776916,773899520.0,19171,9445,8472,460978905.0,460978905.0,1648655,1054650,27.96,28.01,2703305,756381750.0,17917,2023-11-29 10:20:00
1044,SBER,5534,5238,277489460.0,277489460.0,993993,842164,27.92,27.99,1836157,513185639.0,10772,5175,4642,272398398.0,272398398.0,974207,823406,27.96,28.01,1797613,503045891.0,9817,2023-11-29 10:25:00
1045,SBER,6672,6959,331185648.0,331185648.0,1187441,1177185,27.89,27.98,2364626,660571589.0,13631,6262,6387,326838935.0,326838935.0,1169395,1160090,27.95,28.0,2329485,651684322.0,12649,2023-11-29 10:30:00
1046,SBER,6851,9257,386729343.0,386729343.0,1388586,1636829,27.85,27.82,3025415,842032427.0,16108,5813,8361,374773154.0,374773154.0,1342310,1601657,27.92,27.97,2943967,822800406.0,14174,2023-11-29 10:35:00
1047,SBER,6135,10386,427251725.0,427251725.0,1544945,1823017,27.65,27.62,3367962,930833925.0,16521,4724,8908,390204834.0,390204834.0,1400888,1719623,27.85,27.91,3120511,870210451.0,13632,2023-11-29 10:40:00
1048,SBER,9583,13715,631378059.0,631378059.0,2275453,2205482,27.75,27.79,4480935,1244319929.0,23298,8358,12306,588664609.0,588664609.0,2115810,2131463,27.82,27.88,4247273,1182859073.0,20664,2023-11-29 10:45:00
1049,SBER,3208,4126,178166017.0,178166017.0,643493,700156,27.69,27.72,1343649,372215321.0,7334,2705,3518,199695631.0,199695631.0,717878,679070,27.82,27.89,1396948,389108084.0,6223,2023-11-29 10:50:00
1050,SBER,2790,3267,173539035.0,173539035.0,626400,541273,27.7,27.73,1167673,323650097.0,6057,2220,2684,168217864.0,168217864.0,603998,518652,27.85,27.9,1122650,312944237.0,4904,2023-11-29 10:55:00
1051,SBER,4206,4560,195800150.0,195800150.0,707660,671764,27.67,27.67,1379424,381673769.0,8766,3845,3877,187312608.0,187312608.0,672661,650560,27.85,27.89,1323221,368730217.0,7722,2023-11-29 11:00:00
1052,SBER,3507,4772,210351924.0,210351924.0,763609,844598,27.55,27.83,1608207,445372399.0,8279,2986,4209,202453632.0,202453632.0,726965,809640,27.85,27.9,1536605,428366410.0,7195,2023-11-29 11:05:00
1053,SBER,2237,2433,146957394.0,146957394.0,529815,453453,27.74,27.87,983268,273324320.0,4670,1916,2067,144134851.0,144134851.0,517402,439334,27.86,27.91,956736,266768764.0,3983,2023-11-29 11:10:00
1054,SBER,3285,2164,198017466.0,198017466.0,714764,452661,27.7,27.9,1167425,324293412.0,5449,2831,1843,189971710.0,189971710.0,681768,436870,27.86,27.92,1118638,311950439.0,4674,2023-11-29 11:15:00
1055,SBER,8732,4149,406102580.0,406102580.0,1459935,845526,27.82,27.91,2305461,642106368.0,12881,8332,3644,406782265.0,406782265.0,1458521,827395,27.89,27.94,2285916,637942884.0,11976,2023-11-29 11:20:00
1056,SBER,1773,2067,117837285.0,117837285.0,423759,447938,27.81,27.83,871697,242502577.0,3840,1344,1647,112246813.0,112246813.0,402519,426471,27.89,27.94,828990,231402895.0,2991,2023-11-29 11:25:00
1057,SBER,2399,2510,156007559.0,156007559.0,560837,481548,27.82,27.82,1042385,289992237.0,4909,1998,2096,149294933.0,149294933.0,535553,470251,27.88,27.93,1005804,280624160.0,4094,2023-11-29 11:30:00
1058,SBER,3662,4560,196861569.0,196861569.0,708445,686050,27.79,27.75,1394495,387212683.0,8222,3313,4256,194405801.0,194405801.0,697447,673278,27.87,27.92,1370725,382404613.0,7569,2023-11-29 11:35:00
1059,SBER,2956,3127,168639504.0,168639504.0,606287,716718,27.82,27.64,1323005,366752792.0,6083,2410,2763,164917883.0,164917883.0,592361,688192,27.84,27.9,1280553,356947020.0,5173,2023-11-29 11:40:00
1060,SBER,4535,6515,281666204.0,281666204.0,1018175,1359712,27.66,27.6,2377887,656879613.0,11050,3327,5752,265697022.0,265697022.0,956360,1281706,27.78,27.85,2238066,622636215.0,9079,2023-11-29 11:45:00
1061,SBER,11765,14616,785479044.0,785479044.0,2849960,3400214,27.56,27.32,6250174,1714250046.0,26381,9486,12328,745600923.0,745600923.0,2691118,3162440,27.71,27.77,5853558,1623778005.0,21814,2023-11-29 11:50:00
1062,SBER,18366,22443,936898326.0,936898326.0,3419810,4059889,27.4,27.61,7479699,2057670894.0,40809,15974,20177,896741419.0,896741419.0,3245067,3905332,27.63,27.7,7150399,1978469566.0,36151,2023-11-29 11:55:00
1063,SBER,9286,7536,469851949.0,469851949.0,1707103,1263343,27.52,27.63,2970446,818862918.0,16822,8205,6755,457441607.0,457441607.0,1652416,1232435,27.68,27.74,2884851,799266765.0,14960,2023-11-29 12:00:00
1064,SBER,6029,5587,348023145.0,348023145.0,1261200,1086674,27.59,27.7,2347874,649028682.0,11616,5260,5026,337237857.0,337237857.0,1217839,1067638,27.69,27.75,2285477,633499137.0,10286,2023-11-29 12:05:00
1065,SBER,3805,3996,223799322.0,223799322.0,810856,828811,27.6,27.52,1639667,451876440.0,7801,3192,3483,217826650.0,217826650.0,786485,795823,27.7,27.76,1582308,438738744.0,6675,2023-11-29 12:10:00
1066,SBER,4402,4799,260356315.0,260356315.0,942596,925583,27.62,27.58,1868179,515617449.0,9201,3890,4185,253972048.0,253972048.0,917256,905688,27.69,27.75,1822944,505295361.0,8075,2023-11-29 12:15:00
1067,SBER,8028,8154,444732212.0,444732212.0,1611426,1722460,27.6,27.62,3333886,920481987.0,16182,7204,7486,435393829.0,435393829.0,1574376,1681604,27.66,27.72,3255980,901551695.0,14690,2023-11-29 12:20:00
1068,SBER,14798,13495,624740271.0,624740271.0,2261530,2071729,27.62,27.74,4333259,1199379632.0,28293,14358,12860,618782214.0,618782214.0,2233680,2052197,27.7,27.75,4285877,1188318995.0,27218,2023-11-29 12:25:00
1069,SBER,3742,3413,199643382.0,199643382.0,722502,640415,27.63,27.67,1362917,376818807.0,7155,3439,2886,197498222.0,197498222.0,712932,614608,27.7,27.76,1327540,368090462.0,6325,2023-11-29 12:30:00
1070,SBER,4293,5231,245467915.0,245467915.0,890823,1162622,27.56,27.6,2053445,566345629.0,9524,3826,4624,239380417.0,239380417.0,865451,1140213,27.66,27.73,2005664,555616901.0,8450,2023-11-29 12:35:00
1071,SBER,6560,8756,271160241.0,271160241.0,986137,1140393,27.5,27.65,2126530,586427556.0,15316,6107,8029,266621007.0,266621007.0,964023,1124019,27.66,27.72,2088042,578183368.0,14136,2023-11-29 12:40:00
1072,SBER,8577,10819,510156157.0,510156157.0,1856402,2246107,27.48,27.49,4102509,1127502070.0,19396,7513,9683,494396506.0,494396506.0,1790216,2173248,27.62,27.68,3963464,1095897006.0,17196,2023-11-29 12:45:00
1073,SBER,12298,11357,613786869.0,613786869.0,2231516,2071872,27.51,27.69,4303388,1187467291.0,23655,11642,10553,599764216.0,599764216.0,2168637,2040635,27.66,27.72,4209272,1165366877.0,22195,2023-11-29 12:50:00
1074,SBER,7722,7678,390722293.0,390722293.0,1419252,1152220,27.53,27.66,2571472,709436262.0,15400,7173,6956,381289001.0,381289001.0,1376869,1125579,27.69,27.76,2502448,693736847.0,14129,2023-11-29 12:55:00
1075,SBER,3994,4485,235525480.0,235525480.0,853785,760717,27.59,27.71,1614502,446289831.0,8479,3665,4014,230728893.0,230728893.0,833803,763374,27.67,27.75,1597177,442537034.0,7679,2023-11-29 13:00:00
1076,SBER,5408,3985,334585084.0,334585084.0,1209876,671291,27.65,27.72,1881167,520679676.0,9393,5006,3544,326368980.0,326368980.0,1178631,666098,27.69,27.74,1844729,511168490.0,8550,2023-11-29 13:05:00
1077,SBER,4607,4817,324609804.0,324609804.0,1178662,909347,27.54,27.67,2088009,576270500.0,9424,4102,4022,301138356.0,301138356.0,1086696,885530,27.71,27.77,1972226,547019380.0,8124,2023-11-29 13:10:00
1078,SBER,7286,28843,420555891.0,420555891.0,1521554,2566144,27.64,27.77,4087698,1133055699.0,36129,6909,28156,429379775.0,429379775.0,1548612,2543898,27.73,27.78,4092510,1136028101.0,35065,2023-11-29 13:15:00
1079,SBER,3771,3877,243884772.0,243884772.0,880702,683508,27.69,27.76,1564210,433647967.0,7648,3292,3175,228653091.0,228653091.0,823945,662980,27.75,27.8,1486925,412959226.0,6467,2023-11-29 13:20:00
1080,SBER,3883,3425,254495766.0,254495766.0,919120,690129,27.69,27.73,1609249,445891195.0,7308,3507,2943,252048644.0,252048644.0,909083,668835,27.73,27.79,1577918,437912551.0,6450,2023-11-29 13:25:00
1081,SBER,1762,1885,120479060.0,120479060.0,435814,364654,27.64,27.53,800468,220865845.0,3647,1417,1594,118012376.0,118012376.0,425954,363088,27.71,27.78,789042,218895121.0,3011,2023-11-29 13:30:00
1082,SBER,2992,2655,168791009.0,168791009.0,614126,515429,27.48,27.75,1129555,311842901.0,5647,2651,2377,166012303.0,166012303.0,598638,505294,27.73,27.79,1103932,306441575.0,5028,2023-11-29 13:35:00
1083,SBER,3204,3090,207798611.0,207798611.0,750984,531415,27.67,27.71,1282399,355032218.0,6294,2885,2761,209410963.0,209410963.0,755336,516872,27.72,27.79,1272208,353059314.0,5646,2023-11-29 13:40:00
1084,SBER,4126,9407,214635273.0,214635273.0,775326,1075346,27.68,27.75,1850672,513021967.0,13533,3763,9044,212255031.0,212255031.0,765339,1067228,27.73,27.77,1832567,508623002.0,12807,2023-11-29 13:45:00
1085,SBER,6458,5602,349368463.0,349368463.0,1260622,802440,27.71,27.73,2063062,571869075.0,12060,6130,5327,346769470.0,346769470.0,1250433,793882,27.73,27.79,2044315,567387948.0,11457,2023-11-29 13:50:00
1086,SBER,10369,14656,586920484.0,586920484.0,2118501,1917702,27.7,27.72,4036203,1118538488.0,25025,9919,14302,584335610.0,584335610.0,2108781,1895915,27.71,27.77,4004696,1110748088.0,24221,2023-11-29 13:55:00
1087,SBER,22122,26441,801525109.0,801525109.0,2891435,2577479,27.72,27.77,5468914,1517374520.0,48563,21838,26047,799103824.0,799103824.0,2880454,2568039,27.74,27.78,5448493,1512517344.0,47885,2023-11-29 14:00:00
1088,SBER,2899,27109,364314043.0,364314043.0,1314087,3008582,27.72,27.77,4322669,1199900717.0,30008,2554,26830,362853615.0,362853615.0,1308225,2978322,27.74,27.78,4286547,1190145193.0,29384,2023-11-29 14:05:00
1089,SBER,1364,1508,115485869.0,115485869.0,416711,366171,27.71,27.74,782882,217064651.0,2872,980,1129,111474592.0,111474592.0,401862,348658,27.74,27.81,750520,208437103.0,2109,2023-11-29 14:10:00
1090,SBER,1846,2816,130655673.0,130655673.0,473223,502700,27.61,27.81,975923,270462576.0,4662,1505,2272,125775798.0,125775798.0,453219,490745,27.75,27.82,943964,262292308.0,3777,2023-11-29 14:15:00
1091,SBER,2022,2889,107249089.0,107249089.0,387604,534512,27.67,27.73,922116,255476532.0,4911,1854,2514,106556781.0,106556781.0,383950,527397,27.75,27.79,911347,253132961.0,4368,2023-11-29 14:20:00
1092,SBER,2928,4554,208562165.0,208562165.0,752950,664324,27.7,27.71,1417274,392679084.0,7482,2723,4280,206252426.0,206252426.0,744211,636643,27.71,27.78,1380854,383130757.0,7003,2023-11-29 14:25:00
1093,SBER,6181,7376,377823981.0,377823981.0,1363244,1196022,27.72,27.71,2559266,709276092.0,13557,5947,7040,372422580.0,372422580.0,1343475,1202803,27.72,27.78,2546278,706503862.0,12987,2023-11-29 14:30:00
1094,SBER,1764,1857,111828795.0,111828795.0,404674,388882,27.63,27.72,793556,219625702.0,3621,1519,1605,109064647.0,109064647.0,393520,378498,27.72,27.76,772018,214144289.0,3124,2023-11-29 14:35:00
1095,SBER,3159,3965,156278893.0,156278893.0,564179,679137,27.7,27.73,1243316,344587448.0,7124,2998,3754,154640091.0,154640091.0,557856,668674,27.72,27.76,1226530,340258338.0,6752,2023-11-29 14:40:00
1096,SBER,1303,1497,69790249.0,69790249.0,252804,301702,27.61,27.75,554506,153523145.0,2800,1146,1363,68231286.0,68231286.0,246163,298302,27.72,27.77,544465,151057939.0,2509,2023-11-29 14:45:00
1097,SBER,2895,4011,142050844.0,142050844.0,512948,666345,27.69,27.69,1179293,326546415.0,6906,2765,3813,141641667.0,141641667.0,511046,658319,27.72,27.75,1169365,324356003.0,6578,2023-11-29 14:50:00
1098,SBER,3281,3833,201580188.0,201580188.0,728775,734261,27.66,27.65,1463036,404602927.0,7114,3057,3555,198993417.0,198993417.0,718039,727759,27.71,27.77,1445798,401069973.0,6612,2023-11-29 14:55:00
1099,SBER,6605,7501,406544921.0,406544921.0,1468531,1370042,27.68,27.79,2838573,787308160.0,14106,6418,7146,402249493.0,402249493.0,1450305,1335769,27.74,27.8,2786074,773577987.0,13564,2023-11-29 15:00:00
1100,SBER,11085,11206,609072090.0,609072090.0,2196922,2127435,27.72,27.78,4324357,1200018013.0,22291,10738,10911,602789154.0,602789154.0,2171519,2122458,27.76,27.8,4293977,1192788531.0,21649,2023-11-29 15:05:00
1101,SBER,1625,1620,92073157.0,92073157.0,333503,300465,27.61,27.73,633968,175386203.0,3245,1455,1389,93213476.0,93213476.0,335768,296708,27.76,27.8,632476,175706863.0,2844,2023-11-29 15:10:00
1102,SBER,4302,4764,212471192.0,212471192.0,766746,882412,27.71,27.75,1649158,457376349.0,9066,4084,4504,208345467.0,208345467.0,750764,870539,27.75,27.79,1621303,450284436.0,8588,2023-11-29 15:15:00
1103,SBER,1703,2211,102402173.0,102402173.0,373531,421417,27.41,27.77,794948,219438760.0,3914,1531,1949,100740187.0,100740187.0,363793,405253,27.69,27.79,769046,213368331.0,3480,2023-11-29 15:20:00
1104,SBER,1082,1203,67095677.0,67095677.0,242894,244176,27.62,27.75,487070,134864787.0,2285,968,1043,65642311.0,65642311.0,236606,245116,27.74,27.8,481722,133787759.0,2011,2023-11-29 15:25:00
1105,SBER,4825,6117,310084320.0,310084320.0,1124556,1204259,27.57,27.82,2328815,645117383.0,10942,4324,5434,301462649.0,301462649.0,1085218,1200701,27.78,27.85,2285919,635810805.0,9758,2023-11-29 15:30:00
1106,SBER,4139,4428,254187466.0,254187466.0,923631,899471,27.52,27.83,1823102,504554850.0,8567,3545,3625,246272520.0,246272520.0,885423,853392,27.81,27.87,1738815,484109580.0,7170,2023-11-29 15:35:00
1107,SBER,4317,4526,246318613.0,246318613.0,890413,772792,27.66,27.69,1663205,460286087.0,8843,4004,4042,239039441.0,239039441.0,858991,727703,27.83,27.88,1586694,441935285.0,8046,2023-11-29 15:40:00
1108,SBER,2333,3507,145430053.0,145430053.0,525589,626861,27.67,27.76,1152450,319439749.0,5840,2156,3020,142718270.0,142718270.0,513408,600192,27.8,27.87,1113600,310013899.0,5176,2023-11-29 15:45:00
1109,SBER,4545,6061,302570550.0,302570550.0,1098288,915111,27.55,27.86,2013399,557486963.0,10606,4261,5398,298851372.0,298851372.0,1073825,890310,27.83,27.89,1964135,547153085.0,9659,2023-11-29 15:50:00
1110,SBER,3409,3675,187039447.0,187039447.0,678375,571975,27.57,27.77,1250350,345850014.0,7084,3139,3022,185819887.0,185819887.0,667187,549351,27.85,27.91,1216538,339147304.0,6161,2023-11-29 15:55:00
1111,SBER,2402,3690,150288825.0,150288825.0,544110,596489,27.62,27.84,1140599,316367761.0,6092,2199,3025,144989803.0,144989803.0,520293,572863,27.87,27.91,1093156,304861293.0,5224,2023-11-29 16:00:00
1112,SBER,2542,3162,146274099.0,146274099.0,528598,581275,27.67,27.81,1109873,307922829.0,5704,2278,2784,138996822.0,138996822.0,498822,560468,27.87,27.91,1059290,295448113.0,5062,2023-11-29 16:05:00
1113,SBER,3641,4735,200150892.0,200150892.0,719950,835339,27.8,27.75,1555289,431947244.0,8376,3385,4448,196396073.0,196396073.0,705326,823701,27.84,27.9,1529027,426216064.0,7833,2023-11-29 16:10:00
1114,SBER,5555,11131,213487737.0,213487737.0,767638,1226102,27.81,27.86,1993740,555038523.0,16686,5368,10841,209736811.0,209736811.0,753267,1213297,27.84,27.88,1966564,548015861.0,16209,2023-11-29 16:15:00
1115,SBER,4924,4981,243470497.0,243470497.0,876573,834218,27.78,27.41,1710791,472129954.0,9905,4707,4696,240068066.0,240068066.0,862845,808754,27.82,27.88,1671599,465556662.0,9403,2023-11-29 16:20:00
1116,SBER,2837,3209,151691601.0,151691601.0,546436,566499,27.76,27.85,1112935,309450708.0,6046,2657,3035,148204773.0,148204773.0,532979,560147,27.81,27.87,1093126,304297416.0,5692,2023-11-29 16:25:00
1117,SBER,1324,1478,69408878.0,69408878.0,249989,270715,27.76,27.77,520704,144582824.0,2802,1212,1293,69955528.0,69955528.0,251569,255486,27.81,27.86,507055,141137086.0,2505,2023-11-29 16:30:00
1118,SBER,1461,5051,86684818.0,86684818.0,312601,470855,27.73,27.69,783456,217081956.0,6512,1299,4803,83758931.0,83758931.0,301507,451318,27.78,27.86,752825,209485550.0,6102,2023-11-29 16:35:00
1119,SBER,1866,1739,102779358.0,102779358.0,370118,314917,27.77,27.72,685035,190085520.0,3605,1485,1541,99272911.0,99272911.0,357253,308806,27.79,27.85,666059,185261468.0,3026,2023-11-29 16:40:00
1120,SBER,3430,4621,159889302.0,159889302.0,577247,778262,27.7,27.31,1355509,372406376.0,8051,3079,4318,156116112.0,156116112.0,562359,750383,27.76,27.82,1312742,364861244.0,7397,2023-11-29 16:45:00
1121,SBER,2285,2429,115906766.0,115906766.0,420278,364921,27.58,27.8,785199,217351105.0,4714,2077,2206,114161153.0,114161153.0,411410,369967,27.75,27.82,781377,217098967.0,4283,2023-11-29 16:50:00
1122,SBER,1641,1860,95953040.0,95953040.0,347377,341609,27.62,27.85,688986,191098144.0,3501,1481,1633,93120399.0,93120399.0,335182,325816,27.78,27.85,660998,183874203.0,3114,2023-11-29 16:55:00
1123,SBER,1978,2062,103774473.0,103774473.0,374821,352527,27.69,27.84,727348,201900493.0,4040,1855,1829,103121505.0,103121505.0,370989,346333,27.8,27.86,717322,199607107.0,3684,2023-11-29 17:00:00
1124,SBER,5255,6368,156925714.0,156925714.0,564663,678740,27.79,27.83,1243403,345842864.0,11623,5133,6186,156547826.0,156547826.0,563170,675445,27.8,27.84,1238615,344573151.0,11319,2023-11-29 17:05:00
1125,SBER,7605,12897,246505543.0,246505543.0,887780,1304807,27.77,27.81,2192587,609394449.0,20502,7423,12713,244434161.0,244434161.0,879969,1288311,27.78,27.82,2168280,602862975.0,20136,2023-11-29 17:10:00
1126,SBER,2558,2378,117151672.0,117151672.0,422185,332352,27.75,27.76,754537,209421549.0,4936,2414,2196,115577581.0,115577581.0,416095,327054,27.78,27.83,743149,206606429.0,4610,2023-11-29 17:15:00
1127,SBER,5200,7509,162601503.0,162601503.0,585688,780141,27.76,27.75,1365829,379085488.0,12709,5089,7311,162628392.0,162628392.0,585638,773141,27.77,27.81,1358779,377666137.0,12400,2023-11-29 17:20:00
1128,SBER,4328,4689,169072828.0,169072828.0,610722,592892,27.68,27.62,1203614,332810218.0,9017,4051,4391,165464922.0,165464922.0,596530,577633,27.74,27.81,1174163,326097496.0,8442,2023-11-29 17:25:00
1129,SBER,4860,3491,163260251.0,163260251.0,588929,342608,27.72,27.74,931537,258309310.0,8351,4707,3323,162204637.0,162204637.0,584655,337038,27.74,27.8,921693,255900112.0,8030,2023-11-29 17:30:00
1130,SBER,7499,9942,236709971.0,236709971.0,853532,1010715,27.73,27.72,1864247,516928611.0,17441,7359,9735,236653588.0,236653588.0,852567,1017016,27.76,27.81,1869583,519459427.0,17094,2023-11-29 17:35:00
1131,SBER,5169,4458,192698348.0,192698348.0,694900,518697,27.73,27.72,1213597,336458503.0,9627,4990,4281,189812812.0,189812812.0,683816,514237,27.76,27.82,1198053,332857683.0,9271,2023-11-29 17:40:00
1132,SBER,3792,5087,134078533.0,134078533.0,483611,597072,27.72,27.81,1080683,300120192.0,8879,3627,4903,131889293.0,131889293.0,474910,587271,27.77,27.82,1062181,295241218.0,8530,2023-11-29 17:45:00
1133,SBER,1231,1234,53354041.0,53354041.0,192578,162037,27.71,27.73,354615,98291423.0,2465,1143,1028,52976346.0,52976346.0,190845,154032,27.76,27.82,344877,95827309.0,2171,2023-11-29 17:50:00
1134,SBER,2684,2585,113462859.0,113462859.0,409136,337147,27.73,27.65,746283,206669682.0,5269,2481,2372,112442094.0,112442094.0,405124,332001,27.75,27.82,737125,204790648.0,4853,2023-11-29 17:55:00
1135,SBER,7558,6901,321687226.0,321687226.0,1161230,828863,27.7,27.77,1990093,551884174.0,14459,7407,6658,320910220.0,320910220.0,1156204,823406,27.76,27.81,1979610,549894847.0,14065,2023-11-29 18:00:00
1136,SBER,3112,4020,119196680.0,119196680.0,431028,514053,27.65,27.61,945081,261138031.0,7132,2799,3601,114985250.0,114985250.0,414749,499076,27.72,27.78,913825,253646294.0,6400,2023-11-29 18:05:00
1137,SBER,2010,1797,93101989.0,93101989.0,335942,252245,27.71,27.73,588187,163061776.0,3807,1848,1598,90294234.0,90294234.0,325590,245563,27.73,27.79,571153,158539034.0,3446,2023-11-29 18:10:00
1138,SBER,5918,7345,235992716.0,235992716.0,858411,873294,27.49,27.79,1731705,478690284.0,13263,5607,6882,229507671.0,229507671.0,826653,851203,27.76,27.82,1677856,466334909.0,12489,2023-11-29 18:15:00
1139,SBER,2825,3954,134658946.0,134658946.0,485464,574559,27.74,27.7,1060023,293817821.0,6779,2645,3697,132733718.0,132733718.0,478287,567389,27.75,27.82,1045676,290600359.0,6342,2023-11-29 18:20:00
1140,SBER,3411,4138,120388079.0,120388079.0,434772,574988,27.69,27.7,1009760,279679816.0,7549,3203,3941,117678573.0,117678573.0,424184,566810,27.74,27.79,990994,275212224.0,7144,2023-11-29 18:25:00
1141,SBER,3821,5005,141353803.0,141353803.0,511366,741873,27.64,27.59,1253239,346025894.0,8826,3399,4645,135926695.0,135926695.0,490754,712675,27.7,27.76,1203429,333739529.0,8044,2023-11-29 18:30:00
1142,SBER,5086,5974,171249147.0,171249147.0,627616,848313,27.29,27.32,1475929,402970619.0,11060,4222,5255,152389675.0,152389675.0,551315,794778,27.64,27.7,1346093,372550160.0,9477,2023-11-29 18:35:00
1143,SBER,1583,1952,38221519.0,38221519.0,144579,148114,26.44,27.54,292693,79011758.0,3535,1392,1599,36275662.0,36275662.0,131012,137113,27.69,27.74,268125,74315928.0,2991,2023-11-29 18:40:00
1144,SBER,14482,15988,463103102.0,463103102.0,1695699,2075657,27.31,27.0,3771356,1023579177.0,30470,11797,13808,418727425.0,418727425.0,1517623,1898610,27.59,27.64,3416233,943508629.0,25605,2023-11-30 10:05:00
1145,SBER,11327,10118,366782780.0,366782780.0,1340881,1292884,27.35,27.51,2633765,722513543.0,21445,10085,9102,350347906.0,350347906.0,1269371,1259832,27.6,27.66,2529203,698849531.0,19187,2023-11-30 10:10:00
1146,SBER,7395,7628,356633961.0,356633961.0,1295688,1304564,27.52,27.44,2600252,714648519.0,15023,6536,6801,336190153.0,336190153.0,1218514,1278483,27.59,27.65,2496997,689686082.0,13337,2023-11-30 10:15:00
1147,SBER,13588,15756,604885058.0,604885058.0,2211631,3025210,27.35,27.02,5236841,1422369406.0,29344,11163,13765,546294822.0,546294822.0,1985882,2767249,27.51,27.56,4753131,1308897350.0,24928,2023-11-30 10:20:00
1148,SBER,13841,13508,872880340.0,872880340.0,3207536,3174562,27.21,27.37,6382098,1741741191.0,27349,12092,12077,844000777.0,844000777.0,3070173,3095734,27.49,27.55,6165907,1696751589.0,24169,2023-11-30 10:25:00
1149,SBER,8000,7891,529544436.0,529544436.0,1930306,2005701,27.43,27.46,3936007,1080235024.0,15891,6991,6799,504511138.0,504511138.0,1834780,1937933,27.5,27.55,3772713,1038409070.0,13790,2023-11-30 10:30:00
1150,SBER,12536,17723,808172797.0,808172797.0,2956337,2981000,27.34,27.31,5937337,1622241093.0,30259,10813,16089,783211779.0,783211779.0,2854792,2876497,27.43,27.5,5731289,1574294594.0,26902,2023-11-30 10:35:00
1151,SBER,10612,9994,610382294.0,610382294.0,2229949,1847829,27.37,27.5,4077778,1118521363.0,20606,9776,8990,601601199.0,601601199.0,2187990,1803483,27.5,27.55,3991473,1098462348.0,18766,2023-11-30 10:40:00
1152,SBER,5514,7024,356505034.0,356505034.0,1299595,1429339,27.43,27.41,2728934,748268472.0,12538,4854,6269,350246723.0,350246723.0,1274010,1388440,27.49,27.56,2662450,732958146.0,11123,2023-11-30 10:45:00
1153,SBER,7737,7583,426634612.0,426634612.0,1553808,1378761,27.46,27.51,2932569,805965088.0,15320,7270,6825,421072604.0,421072604.0,1531638,1360263,27.49,27.55,2891901,795814540.0,14095,2023-11-30 10:50:00
1154,SBER,5110,6597,278800644.0,278800644.0,1015989,1501844,27.44,27.18,2517833,686938393.0,11707,4579,5967,270319783.0,270319783.0,983234,1460428,27.49,27.55,2443662,672649686.0,10546,2023-11-30 10:55:00
1155,SBER,10468,25097,428288653.0,428288653.0,1559971,6731277,27.45,27.47,8291248,2277516114.0,35565,9969,22631,420624955.0,420624955.0,1531028,6669651,27.47,27.52,8200679,2255955956.0,32600,2023-11-30 11:00:00
1156,SBER,14458,21144,638758560.0,638758560.0,2333045,5514924,27.38,27.28,7847969,2143328793.0,35602,13318,19850,613002611.0,613002611.0,2235411,5414172,27.42,27.47,7649583,2100299995.0,33168,2023-11-30 11:05:00
1157,SBER,8454,11113,593473365.0,593473365.0,2174784,2248312,27.29,27.23,4423096,1205610991.0,19567,7499,9986,571825861.0,571825861.0,2086706,2168842,27.4,27.46,4255548,1167448634.0,17485,2023-11-30 11:10:00
1158,SBER,14808,13819,947683454.0,947683454.0,3489985,3530263,27.15,27.14,7020248,1905958995.0,28627,12862,12342,902111752.0,902111752.0,3297232,3336027,27.36,27.42,6633259,1816770251.0,25204,2023-11-30 11:15:00
1159,SBER,13749,12202,795498602.0,795498602.0,2919708,2612794,27.25,27.42,5532502,1511910133.0,25951,12636,10792,779237586.0,779237586.0,2841882,2544636,27.42,27.48,5386518,1478471601.0,23428,2023-11-30 11:20:00
1160,SBER,6506,7423,371272312.0,371272312.0,1357816,1450803,27.34,27.38,2808619,768437136.0,13929,5799,6861,360767014.0,360767014.0,1315069,1428881,27.43,27.49,2743950,753523371.0,12660,2023-11-30 11:25:00
1161,SBER,12293,10088,647403751.0,647403751.0,2365302,1669783,27.37,27.45,4035085,1105730944.0,22381,11507,8940,634630716.0,634630716.0,2310398,1588929,27.47,27.52,3899327,1071966689.0,20447,2023-11-30 11:30:00
1162,SBER,5120,3810,303161228.0,303161228.0,1111005,685438,27.29,27.37,1796443,490741875.0,8930,4612,3156,298590090.0,298590090.0,1086916,662894,27.47,27.53,1749810,481072281.0,7768,2023-11-30 11:35:00
1163,SBER,4800,3897,272118727.0,272118727.0,995443,754507,27.34,27.53,1749950,479836502.0,8697,4212,3389,267130542.0,267130542.0,971902,762644,27.49,27.54,1734546,477162698.0,7601,2023-11-30 11:40:00
1164,SBER,8794,5813,427855201.0,427855201.0,1561648,980879,27.4,27.48,2542527,697358892.0,14607,8249,5370,422998017.0,422998017.0,1538401,961124,27.5,27.55,2499525,687775321.0,13619,2023-11-30 11:45:00
1165,SBER,4974,5761,284059319.0,284059319.0,1037954,1125848,27.37,27.47,2163802,593293939.0,10735,4492,5341,280253205.0,280253205.0,1020190,1100562,27.47,27.54,2120752,583335975.0,9833,2023-11-30 11:50:00
1166,SBER,1736,1838,95665882.0,95665882.0,351091,319033,27.25,27.48,670124,183330756.0,3574,1349,1558,92937984.0,92937984.0,338440,310065,27.46,27.52,648505,178274555.0,2907,2023-11-30 11:55:00
1167,SBER,14517,10801,621545588.0,621545588.0,2265106,1146919,27.44,27.51,3412025,937060793.0,25318,14069,10376,620070440.0,620070440.0,2254188,1134799,27.51,27.54,3388987,932573006.0,24445,2023-11-30 12:00:00
1168,SBER,7194,6801,372211867.0,372211867.0,1362857,1050672,27.31,27.52,2413529,661366646.0,13995,6634,6268,362979403.0,362979403.0,1319090,1026208,27.52,27.56,2345298,645780715.0,12902,2023-11-30 12:05:00
1169,SBER,3471,3697,177901272.0,177901272.0,649146,584431,27.41,27.54,1233577,338861439.0,7168,3105,3215,179837837.0,179837837.0,653342,565839,27.53,27.59,1219181,335959689.0,6320,2023-11-30 12:10:00
1170,SBER,3440,3755,191895171.0,191895171.0,698978,618790,27.45,27.5,1317768,362043528.0,7195,3153,2712,184252810.0,184252810.0,668977,561915,27.54,27.58,1230892,339241048.0,5865,2023-11-30 12:15:00
1171,SBER,5235,3943,272768942.0,272768942.0,994256,670837,27.43,27.53,1665093,457418020.0,9178,4929,3414,269897820.0,269897820.0,980007,647149,27.54,27.59,1627156,448421147.0,8343,2023-11-30 12:20:00
1172,SBER,2453,3307,146019152.0,146019152.0,532270,687233,27.43,27.45,1219503,334646443.0,5760,2230,2873,144988414.0,144988414.0,527180,674911,27.5,27.57,1202091,331092917.0,5103,2023-11-30 12:25:00
1173,SBER,4080,4768,216844357.0,216844357.0,792359,873321,27.37,27.46,1665680,456623181.0,8848,3824,4295,213736051.0,213736051.0,778073,858107,27.47,27.53,1636180,449998126.0,8119,2023-11-30 12:30:00
1174,SBER,6594,6754,375730326.0,375730326.0,1371456,1342440,27.4,27.24,2713896,741473456.0,13348,6164,6190,371331425.0,371331425.0,1353266,1315693,27.44,27.5,2668959,733169356.0,12354,2023-11-30 12:35:00
1175,SBER,5928,5545,331299745.0,331299745.0,1211803,990395,27.34,27.51,2202198,603764019.0,11473,5583,5054,326029799.0,326029799.0,1187512,979039,27.45,27.51,2166551,595364219.0,10637,2023-11-30 12:40:00
1176,SBER,2822,3156,153308345.0,153308345.0,559475,582977,27.4,27.53,1142452,313826107.0,5978,2592,2783,150601829.0,150601829.0,548085,574441,27.48,27.54,1122526,308784141.0,5375,2023-11-30 12:45:00
1177,SBER,2744,3380,163594477.0,163594477.0,597163,683636,27.4,27.49,1280799,351533168.0,6124,2527,2968,161019768.0,161019768.0,585601,675319,27.5,27.56,1260920,347128124.0,5495,2023-11-30 12:50:00
1178,SBER,4811,5490,270206377.0,270206377.0,984353,1111327,27.45,27.49,2095680,575693503.0,10301,4535,5085,267971805.0,267971805.0,975588,1092078,27.47,27.52,2067666,568561170.0,9620,2023-11-30 12:55:00
1179,SBER,8168,7172,347846212.0,347846212.0,1272189,1234945,27.34,27.48,2507134,687242616.0,15340,7902,6574,343103921.0,343103921.0,1249035,1212995,27.47,27.52,2462030,676902632.0,14476,2023-11-30 13:00:00
1180,SBER,6981,8855,289717607.0,289717607.0,1059059,1545713,27.36,27.53,2604772,715266640.0,15836,6738,8418,288193657.0,288193657.0,1048656,1534130,27.48,27.53,2582786,710583708.0,15156,2023-11-30 13:05:00
1181,SBER,2537,3256,140247157.0,140247157.0,510647,610083,27.46,27.51,1120730,308073533.0,5793,2325,2817,136109625.0,136109625.0,494678,602576,27.51,27.57,1097254,302228354.0,5142,2023-11-30 13:10:00
1182,SBER,6461,5026,322080946.0,322080946.0,1174534,1027154,27.42,27.55,2201688,605056966.0,11487,6163,4707,322719449.0,322719449.0,1173551,1020986,27.5,27.56,2194537,604092637.0,10870,2023-11-30 13:15:00
1183,SBER,5480,3450,254745022.0,254745022.0,927656,655462,27.46,27.52,1583118,435114162.0,8930,5224,3203,253501400.0,253501400.0,921308,651983,27.52,27.56,1573291,433205155.0,8427,2023-11-30 13:20:00
1184,SBER,3493,2885,148397334.0,148397334.0,540400,499374,27.46,27.47,1039774,285589021.0,6378,3188,2680,145661005.0,145661005.0,529524,491491,27.51,27.56,1021015,281108282.0,5868,2023-11-30 13:25:00
1185,SBER,4910,3979,242392976.0,242392976.0,882851,700683,27.46,27.54,1583534,435393054.0,8889,4535,3725,240535649.0,240535649.0,874219,690586,27.51,27.56,1564805,430876613.0,8260,2023-11-30 13:30:00
1186,SBER,3986,3685,213250271.0,213250271.0,776975,684536,27.45,27.48,1461511,401347242.0,7671,3688,3482,211746808.0,211746808.0,769925,678471,27.5,27.55,1448396,398693033.0,7170,2023-11-30 13:35:00
1187,SBER,2561,2579,156865700.0,156865700.0,571483,492257,27.45,27.42,1063740,291859667.0,5140,2260,2358,155941606.0,155941606.0,567403,472965,27.48,27.55,1040368,286238638.0,4618,2023-11-30 13:40:00
1188,SBER,1632,1585,92168409.0,92168409.0,336188,336974,27.42,27.44,673162,184650193.0,3217,1254,1392,88964518.0,88964518.0,323621,330813,27.49,27.55,654434,180092988.0,2646,2023-11-30 13:45:00
1189,SBER,3542,3978,193612264.0,193612264.0,712481,805122,27.17,27.55,1517603,415421092.0,7520,3097,3673,189741056.0,189741056.0,689531,796794,27.52,27.57,1486325,409387938.0,6770,2023-11-30 13:50:00
1190,SBER,8297,9173,450106932.0,450106932.0,1658241,1686197,27.14,27.51,3344438,914005833.0,17470,7513,8168,432933687.0,432933687.0,1570140,1624429,27.57,27.62,3194569,881569314.0,15681,2023-11-30 13:55:00
1191,SBER,3016,3013,182672381.0,182672381.0,669837,595570,27.27,27.53,1265407,346659015.0,6029,2516,2411,178515786.0,178515786.0,647248,565200,27.58,27.63,1212448,334675394.0,4927,2023-11-30 14:00:00
1192,SBER,780,1171,61122963.0,61122963.0,227619,255610,26.85,27.44,483229,131274692.0,1951,454,720,64050490.0,64050490.0,232669,227227,27.53,27.64,459896,126847932.0,1174,2023-11-30 14:05:00
1193,SBER,5540,8891,218798034.0,218798034.0,795192,1566439,27.52,27.44,2361631,648563760.0,14431,4942,8402,212251018.0,212251018.0,770180,1522806,27.56,27.59,2292986,632459066.0,13344,2023-11-30 14:10:00
1194,SBER,2285,2773,105472595.0,105472595.0,385417,534711,27.37,27.47,920128,252334911.0,5058,2005,2526,102426081.0,102426081.0,371850,523991,27.54,27.59,895841,246971640.0,4531,2023-11-30 14:15:00
1195,SBER,1687,2204,83513583.0,83513583.0,303883,347009,27.48,27.33,650892,178350367.0,3891,1469,1833,79601092.0,79601092.0,289116,316433,27.53,27.58,605549,166870196.0,3302,2023-11-30 14:20:00
1196,SBER,5551,3810,289085028.0,289085028.0,1051988,682652,27.48,27.51,1734640,476862783.0,9361,5350,3625,285898725.0,285898725.0,1037955,678174,27.54,27.57,1716129,472904289.0,8975,2023-11-30 14:25:00
1197,SBER,1773,1480,96530358.0,96530358.0,352255,327455,27.4,27.45,679710,186405350.0,3253,1542,1251,92983226.0,92983226.0,337688,316796,27.54,27.58,654484,180370829.0,2793,2023-11-30 14:30:00
1198,SBER,2097,1711,92727763.0,92727763.0,339486,334500,27.31,27.26,673986,183921166.0,3808,1954,1559,90881379.0,90881379.0,330134,328649,27.53,27.58,658783,181524230.0,3513,2023-11-30 14:35:00
1199,SBER,2980,3846,139219734.0,139219734.0,506623,761675,27.48,27.49,1268298,348624609.0,6826,2789,3678,137183850.0,137183850.0,498723,757550,27.51,27.56,1256273,345996507.0,6467,2023-11-30 14:40:00
1200,SBER,1531,1564,82658699.0,82658699.0,300767,315896,27.48,27.55,616663,169694054.0,3095,1389,1427,82058609.0,82058609.0,298244,314901,27.51,27.57,613145,168882155.0,2816,2023-11-30 14:45:00
1201,SBER,1188,1229,54695585.0,54695585.0,199477,218618,27.42,27.48,418095,114778012.0,2417,1062,1125,53964726.0,53964726.0,196155,214577,27.51,27.56,410732,113106711.0,2187,2023-11-30 14:50:00
1202,SBER,2449,3060,142549258.0,142549258.0,520920,577677,27.36,27.38,1098597,300716734.0,5509,2149,2807,133091222.0,133091222.0,484119,562194,27.49,27.55,1046313,288000600.0,4956,2023-11-30 14:55:00
1203,SBER,2372,1734,123611803.0,123611803.0,450115,290361,27.46,27.51,740476,203487678.0,4106,2130,1550,119023688.0,119023688.0,432714,285717,27.51,27.57,718431,197781743.0,3680,2023-11-30 15:00:00
1204,SBER,10565,12381,407505397.0,407505397.0,1481600,1584159,27.5,27.56,3065759,844095780.0,22946,10421,12180,406886480.0,406886480.0,1477953,1576659,27.53,27.57,3054612,841540003.0,22601,2023-11-30 15:05:00
1205,SBER,5114,3721,262527596.0,262527596.0,953413,681259,27.54,27.58,1634672,450420013.0,8835,4876,3481,258741837.0,258741837.0,939030,675641,27.55,27.59,1614671,445178502.0,8357,2023-11-30 15:10:00
1206,SBER,3320,3722,208963754.0,208963754.0,759131,646445,27.53,27.48,1405576,386608681.0,7042,3166,3481,204529804.0,204529804.0,742462,639069,27.55,27.6,1381531,380925211.0,6647,2023-11-30 15:15:00
1207,SBER,8386,4303,391156818.0,391156818.0,1420366,763335,27.54,27.54,2183701,601370073.0,12689,8190,4032,390042622.0,390042622.0,1414796,755601,27.57,27.61,2170397,598685956.0,12222,2023-11-30 15:20:00
1208,SBER,7460,8359,368098938.0,368098938.0,1338347,1137356,27.5,27.46,2475703,680465239.0,15819,7256,8129,366330434.0,366330434.0,1329813,1123490,27.55,27.6,2453303,676358903.0,15385,2023-11-30 15:25:00
1209,SBER,2540,1784,148885804.0,148885804.0,541363,312270,27.5,27.53,853633,234867662.0,4324,2405,1634,147627382.0,147627382.0,536234,312783,27.53,27.58,849017,233893455.0,4039,2023-11-30 15:30:00
1210,SBER,7962,6899,349515819.0,349515819.0,1272474,1076292,27.47,27.59,2348766,646459893.0,14861,7653,6600,344824675.0,344824675.0,1251176,1071006,27.56,27.61,2322182,640507852.0,14253,2023-11-30 15:35:00
1211,SBER,12615,11221,724008836.0,724008836.0,2626581,2387180,27.56,27.62,5013761,1383238233.0,23836,11972,10371,704004228.0,704004228.0,2551075,2321803,27.6,27.66,4872878,1346127441.0,22343,2023-11-30 15:40:00
1212,SBER,4746,4939,288231909.0,288231909.0,1049557,1009869,27.46,27.6,2059426,566958966.0,9685,4509,4521,284998171.0,284998171.0,1032599,993405,27.6,27.66,2026004,559814760.0,9030,2023-11-30 15:45:00
1213,SBER,4294,4858,253151064.0,253151064.0,918605,920615,27.56,27.58,1839220,507029559.0,9152,4074,4617,250299909.0,250299909.0,907554,910109,27.58,27.64,1817663,501896722.0,8691,2023-11-30 15:50:00
1214,SBER,6748,5991,326382051.0,326382051.0,1184043,917569,27.57,27.59,2101612,579497627.0,12739,6597,5805,324189414.0,324189414.0,1175824,911591,27.57,27.62,2087415,575984335.0,12402,2023-11-30 15:55:00
1215,SBER,5026,4875,281263707.0,281263707.0,1021838,1029717,27.53,27.57,2051555,565148066.0,9901,4760,4586,277062313.0,277062313.0,1005560,1017340,27.55,27.61,2022900,557950160.0,9346,2023-11-30 16:00:00
1216,SBER,4042,4956,240700054.0,240700054.0,876748,939749,27.45,27.39,1816497,498106459.0,8998,3831,4446,238964504.0,238964504.0,868532,912822,27.51,27.57,1781354,490648422.0,8277,2023-11-30 16:05:00
1217,SBER,8210,12755,499358780.0,499358780.0,1826571,2425842,27.34,27.42,4252413,1164443845.0,20965,7670,11978,492871070.0,492871070.0,1794707,2390857,27.46,27.53,4185564,1151109894.0,19648,2023-11-30 16:10:00
1218,SBER,5710,5296,240692078.0,240692078.0,878027,907380,27.41,27.47,1785407,489990745.0,11006,5444,4933,237928215.0,237928215.0,866268,860818,27.47,27.52,1727086,474786580.0,10377,2023-11-30 16:15:00
1219,SBER,7057,8390,362031836.0,362031836.0,1321905,1381481,27.39,27.41,2703386,740690041.0,15447,6596,7751,353795690.0,353795690.0,1289781,1333329,27.43,27.49,2623110,720369690.0,14347,2023-11-30 16:20:00
1220,SBER,5019,6434,242162935.0,242162935.0,883885,1085909,27.4,27.43,1969794,540024281.0,11453,4788,6094,241357154.0,241357154.0,879856,1064181,27.43,27.49,1944037,533891990.0,10882,2023-11-30 16:25:00
1221,SBER,6585,9451,299723734.0,299723734.0,1095192,1577419,27.37,27.42,2672611,732322609.0,16036,6135,8907,293778627.0,293778627.0,1071724,1555018,27.41,27.46,2626742,720737359.0,15042,2023-11-30 16:30:00
1222,SBER,3178,7262,155138868.0,155138868.0,567166,902695,27.35,27.38,1469861,402287040.0,10440,2896,6857,153387233.0,153387233.0,559759,891430,27.4,27.46,1451189,398144373.0,9753,2023-11-30 16:35:00
1223,SBER,4994,7094,286899562.0,286899562.0,1052277,1329948,27.26,27.24,2382225,649155850.0,12088,4222,6108,276365439.0,276365439.0,1010224,1239191,27.36,27.41,2249415,616078224.0,10330,2023-11-30 16:40:00
1224,SBER,13297,14299,747935982.0,747935982.0,2755246,2644419,27.15,27.13,5399665,1465265109.0,27596,11538,12615,714174436.0,714174436.0,2615055,2502389,27.31,27.36,5117444,1398923816.0,24153,2023-11-30 16:45:00
1225,SBER,5861,12192,452758270.0,452758270.0,1673559,2572153,27.05,27.31,4245712,1155108759.0,18053,5023,11429,436102254.0,436102254.0,1597019,2520490,27.31,27.36,4117509,1125792277.0,16452,2023-11-30 16:50:00
1226,SBER,8103,11293,897507971.0,897507971.0,3311255,2359645,27.1,27.18,5670900,1538829237.0,19396,6694,10059,809150958.0,809150958.0,2964814,2325439,27.29,27.33,5290253,1444775364.0,16753,2023-11-30 16:55:00
1227,SBER,8090,9108,780942092.0,780942092.0,2872994,1661956,27.18,27.28,4534950,1234337842.0,17198,7148,7834,769713694.0,769713694.0,2819665,1586252,27.3,27.36,4405917,1203681088.0,14982,2023-11-30 17:00:00
1228,SBER,6033,12086,602801335.0,602801335.0,2222877,2599571,27.12,27.29,4822448,1312196585.0,18119,5119,11125,635714024.0,635714024.0,2331019,2532174,27.27,27.34,4863193,1328097759.0,16244,2023-11-30 17:05:00
1229,SBER,5752,5618,402887637.0,402887637.0,1486082,1218459,27.11,27.34,2704541,736009912.0,11370,5126,4705,398195977.0,398195977.0,1457348,1167095,27.32,27.38,2624443,717796983.0,9831,2023-11-30 17:10:00
1230,SBER,4770,4645,308567347.0,308567347.0,1132336,915916,27.25,27.18,2048252,557524996.0,9415,4282,4016,301212845.0,301212845.0,1102072,891733,27.33,27.39,1993805,545454971.0,8298,2023-11-30 17:15:00
1231,SBER,5717,5554,325251739.0,325251739.0,1192257,989785,27.28,27.37,2182042,596166353.0,11271,5279,5022,319726631.0,319726631.0,1169178,971566,27.35,27.4,2140744,585975187.0,10301,2023-11-30 17:20:00
1232,SBER,3203,3132,141862842.0,141862842.0,520152,425159,27.27,27.21,945311,257546253.0,6335,2843,2663,139877699.0,139877699.0,511581,408622,27.34,27.4,920203,251842452.0,5506,2023-11-30 17:25:00
1233,SBER,3986,4682,183521574.0,183521574.0,678666,622989,27.04,27.37,1301655,354063847.0,8668,3624,4057,175466775.0,175466775.0,641326,591527,27.36,27.41,1232853,337576607.0,7681,2023-11-30 17:30:00
1234,SBER,4900,5879,243489767.0,243489767.0,896636,808139,27.16,27.37,1704775,464689068.0,10779,4532,5203,236250949.0,236250949.0,863421,772831,27.36,27.41,1636252,448102582.0,9735,2023-11-30 17:35:00
1235,SBER,4241,4318,195715305.0,195715305.0,719602,574168,27.2,27.38,1293770,352928095.0,8559,3927,3840,187075458.0,187075458.0,683323,543575,27.38,27.43,1226898,336157119.0,7767,2023-11-30 17:40:00
1236,SBER,5240,5839,251030966.0,251030966.0,919270,904613,27.31,27.35,1823883,498399909.0,11079,4834,5144,242573011.0,242573011.0,885471,876669,27.39,27.45,1762140,483220953.0,9978,2023-11-30 17:45:00
1237,SBER,8604,9158,389930265.0,389930265.0,1427179,1335329,27.32,27.06,2762508,751331654.0,17762,8101,8523,381213233.0,381213233.0,1392793,1300690,27.37,27.43,2693483,738015764.0,16624,2023-11-30 17:50:00
1238,SBER,6526,7026,298909009.0,298909009.0,1096196,1002994,27.27,27.38,2099190,573539309.0,13552,6158,6536,296700004.0,296700004.0,1083688,985775,27.38,27.44,2069463,567148922.0,12694,2023-11-30 17:55:00
1239,SBER,4157,3966,197349191.0,197349191.0,722538,475650,27.31,27.4,1198188,327689858.0,8123,3837,3497,190330672.0,190330672.0,694783,455501,27.39,27.45,1150284,315371677.0,7334,2023-11-30 18:00:00
1240,SBER,7060,5040,381571191.0,381571191.0,1394942,546757,27.35,27.34,1941699,531056511.0,12100,6592,4239,374355105.0,374355105.0,1364381,516786,27.44,27.49,1881167,516405579.0,10831,2023-11-30 18:05:00
1241,SBER,2994,3161,126095206.0,126095206.0,462453,293041,27.27,27.29,755494,206072510.0,6155,2647,2431,118093175.0,118093175.0,430286,265233,27.45,27.5,695519,191019956.0,5078,2023-11-30 18:10:00
1242,SBER,3294,4049,169630344.0,169630344.0,620430,492525,27.34,27.4,1112955,304584488.0,7343,2906,3247,155616449.0,155616449.0,566783,456167,27.46,27.51,1022950,281102058.0,6153,2023-11-30 18:15:00
1243,SBER,5535,5969,243165440.0,243165440.0,897767,687076,27.09,27.42,1584843,431551342.0,11504,5141,5122,235511451.0,235511451.0,857293,653880,27.47,27.54,1511173,415563855.0,10263,2023-11-30 18:20:00
1244,SBER,8507,9074,351454831.0,351454831.0,1282464,1022860,27.4,27.36,2305324,631313020.0,17581,8147,8103,344597230.0,344597230.0,1253318,980632,27.49,27.55,2233950,614720496.0,16250,2023-11-30 18:25:00
1245,SBER,6269,5507,291093025.0,291093025.0,1063867,650473,27.36,27.09,1714340,467328014.0,11776,5895,4750,284472225.0,284472225.0,1036313,616244,27.45,27.56,1652557,454300781.0,10645,2023-11-30 18:30:00
1246,SBER,7636,7024,318116684.0,318116684.0,1162226,841116,27.37,27.37,2003342,548370830.0,14660,7325,6254,309756943.0,309756943.0,1127099,805592,27.48,27.55,1932691,531678082.0,13579,2023-11-30 18:35:00
1247,SBER,7733,5263,355932969.0,355932969.0,1303100,600287,27.31,27.42,1903387,520549366.0,12996,7610,4626,353239559.0,353239559.0,1284753,564714,27.49,27.55,1849467,508828479.0,12236,2023-11-30 18:40:00
0,YNDX,6590,12042,1343320058.0,5207511832.0,502197,1976836,2674.9,2634.3,2479033,6550831890.0,18632,5563,10923,1245466644.0,5078986337.0,476912,1940829,2611.5,2616.9,2417741,6324452981.0,16486,2023-11-01 10:05:00
1,YNDX,6459,5341,1659522243.0,1553023418.0,634984,594894,2613.5,2610.6,1229878,3212545661.0,11800,6124,5053,1614481533.0,1526027662.0,618686,584574,2609.5,2610.5,1203260,3140509196.0,11177,2023-11-01 10:10:00
2,YNDX,14903,1691,6528121240.0,227114995.0,2497813,86626,2613.5,2621.8,2584439,6755236235.0,16594,14702,1519,6514528473.0,204949595.0,2492681,78116,2613.5,2623.7,2570797,6719478069.0,16221,2023-11-01 10:15:00
3,YNDX,14526,3405,6274798360.0,490234500.0,2390091,186933,2625.3,2622.5,2577024,6765032861.0,17931,14226,2723,6249910340.0,472165676.0,2380696,179949,2625.2,2623.9,2560645,6722076017.0,16949,2023-11-01 10:20:00
4,YNDX,13880,10425,4324874148.0,1973896656.0,1652086,752559,2617.8,2622.9,2404645,6298770804.0,24305,13436,10201,4293257616.0,1950442403.0,1640160,743203,2617.6,2624.4,2383363,6243700020.0,23637,2023-11-01 10:25:00
5,YNDX,17337,15361,4347493965.0,2843759629.0,1656878,1082828,2623.9,2626.2,2739706,7191253595.0,32698,17165,15171,4335501026.0,2829700043.0,1652608,1077487,2623.4,2626.2,2730095,7165201069.0,32336,2023-11-01 10:30:00
6,YNDX,30745,10871,9709194488.0,1801971092.0,3662176,681913,2651.2,2642.5,4344089,11511165580.0,41616,30089,9903,9580941720.0,1698194140.0,3616722,642374,2649.1,2643.6,4259096,11279135860.0,39992,2023-11-01 10:35:00
7,YNDX,8245,3310,1797084464.0,630247306.0,680716,238441,2640.0,2643.2,919157,2427331771.0,11555,7968,2992,1781371657.0,614178745.0,674349,232147,2641.6,2645.6,906496,2395550403.0,10960,2023-11-01 10:40:00
8,YNDX,11157,6280,3169210976.0,930078937.0,1199654,351291,2641.8,2647.6,1550945,4099289914.0,17437,10657,5838,3103359544.0,879540137.0,1175503,332040,2640.0,2648.9,1507543,3982899681.0,16495,2023-11-01 10:45:00
9,YNDX,5582,6496,1170472813.0,1163636388.0,441707,438847,2649.9,2651.6,880554,2334109201.0,12078,5113,5942,1114741807.0,1081011479.0,421263,407108,2646.2,2655.3,828371,2195753286.0,11055,2023-11-01 10:50:00
10,YNDX,3836,2579,653731619.0,516533520.0,247239,195039,2644.1,2648.4,442278,1170265140.0,6415,3560,2331,640273119.0,492536106.0,242335,185747,2642.1,2651.7,428082,1132809226.0,5891,2023-11-01 10:55:00
11,YNDX,1863,1933,373509844.0,368711896.0,141395,139347,2641.6,2646.0,280742,742221740.0,3796,1614,1751,356945523.0,349363926.0,135227,131816,2639.6,2650.4,267043,706309450.0,3365,2023-11-01 11:00:00
12,YNDX,8707,8161,1432845447.0,1718481362.0,543535,644822,2636.2,2665.0,1188357,3151326810.0,16868,8205,7854,1375268343.0,1639924039.0,521907,620492,2635.1,2642.9,1142399,3015192383.0,16059,2023-11-01 11:05:00
13,YNDX,7608,5368,1852506049.0,1076571963.0,675995,405784,2740.4,2653.1,1081779,2929078013.0,12976,7080,4777,1754471972.0,1004207355.0,641011,378391,2737.0,2653.9,1019402,2758679328.0,11857,2023-11-01 11:10:00
14,YNDX,5802,4876,1072370145.0,1033799223.0,394703,389332,2716.9,2655.3,784035,2106169369.0,10678,5444,4513,1046830372.0,962413366.0,384221,362106,2724.6,2657.8,746327,2009243738.0,9957,2023-11-01 11:15:00
15,YNDX,3125,2333,739484377.0,496774065.0,278178,186620,2658.3,2662.0,464798,1236258442.0,5458,2853,2051,694394562.0,467606277.0,261710,175508,2653.3,2664.3,437218,1162000839.0,4904,2023-11-01 11:20:00
16,YNDX,6057,3876,1449312031.0,835705640.0,464803,313081,3118.1,2669.3,777884,2285017672.0,9933,5215,3104,1362765620.0,768683409.0,446346,287737,3053.2,2671.5,734083,2131449029.0,8319,2023-11-01 11:25:00
17,YNDX,5703,6095,1252143942.0,959742607.0,446645,359435,2803.4,2670.1,806080,2211886550.0,11798,5330,5191,1183068819.0,885711197.0,423013,331522,2796.8,2671.7,754535,2068780017.0,10521,2023-11-01 11:30:00
18,YNDX,6495,4317,1524257846.0,833798711.0,559884,311896,2722.5,2673.3,871780,2358056558.0,10812,5967,3883,1481350416.0,730567943.0,544308,273185,2721.5,2674.3,817493,2211918359.0,9850,2023-11-01 11:35:00
19,YNDX,2828,3086,670740615.0,529347764.0,246042,198490,2726.1,2666.9,444532,1200088380.0,5914,2514,2837,650484504.0,501886057.0,238680,187991,2725.3,2669.7,426671,1152370562.0,5351,2023-11-01 11:40:00
20,YNDX,2811,1981,581578792.0,379010339.0,218431,142148,2662.5,2666.3,360579,960589131.0,4792,2541,1671,560170524.0,360564402.0,210559,135004,2660.4,2670.8,345563,920734926.0,4212,2023-11-01 11:45:00
21,YNDX,3088,2601,616402109.0,501310033.0,231950,188266,2657.5,2662.8,420216,1117712142.0,5689,2765,2401,584452930.0,474855738.0,220055,178049,2655.9,2667.0,398104,1059308669.0,5166,2023-11-01 11:50:00
22,YNDX,3483,2487,781551423.0,410977384.0,293585,154070,2662.1,2667.5,447655,1192528808.0,5970,3275,2291,761580806.0,397053981.0,286346,148819,2659.7,2668.0,435165,1158634788.0,5566,2023-11-01 11:55:00
23,YNDX,2667,4253,480936829.0,1037344533.0,180891,389745,2658.7,2661.6,570636,1518281362.0,6920,2456,4065,460352203.0,980836903.0,173358,368128,2655.5,2664.4,541486,1441189107.0,6521,2023-11-01 12:00:00
24,YNDX,3230,5355,671532638.0,1119782313.0,253164,421059,2652.6,2659.4,674223,1791314951.0,8585,2897,5141,646183119.0,1104786553.0,243852,415138,2649.9,2661.3,658990,1750969672.0,8038,2023-11-01 12:05:00
25,YNDX,970,1562,185986362.0,335640049.0,70003,125988,2656.8,2664.1,195991,521626411.0,2532,824,1464,179149658.0,337858274.0,67526,126839,2653.0,2663.7,194365,517007932.0,2288,2023-11-01 12:10:00
26,YNDX,1105,1838,221658944.0,452004351.0,83459,169715,2655.9,2663.3,253174,673663296.0,2943,874,1643,210222993.0,432937387.0,79240,162559,2653.0,2663.3,241799,643160381.0,2517,2023-11-01 12:15:00
27,YNDX,1361,1793,317650368.0,504617037.0,119832,189770,2650.8,2659.1,309602,822267406.0,3154,1138,1644,300908654.0,452677609.0,113619,170155,2648.4,2660.4,283774,753586263.0,2782,2023-11-01 12:20:00
28,YNDX,1174,807,264769756.0,183707450.0,100041,69090,2646.6,2659.0,169131,448477206.0,1981,1041,691,224544171.0,182861331.0,84785,68736,2648.4,2660.3,153521,407405502.0,1732,2023-11-01 12:25:00
29,YNDX,5267,1818,720333924.0,516807066.0,271393,194224,2654.2,2660.9,465617,1237140990.0,7085,5143,1689,708808908.0,511641851.0,267159,192259,2653.1,2661.2,459418,1220450760.0,6832,2023-11-01 12:30:00
30,YNDX,1755,1706,350561980.0,446452315.0,132377,168134,2648.2,2655.3,300511,797014296.0,3461,1536,1589,339726183.0,433109649.0,128349,162917,2646.9,2658.5,291266,772835833.0,3125,2023-11-01 12:35:00
31,YNDX,2689,2583,471630433.0,603677978.0,177894,227034,2651.2,2659.0,404928,1075308411.0,5272,2526,2467,455073447.0,604099519.0,171777,227143,2649.2,2659.6,398920,1059172967.0,4993,2023-11-01 12:40:00
32,YNDX,4542,5517,687417276.0,1255411534.0,258871,471927,2655.4,2660.2,730798,1942828810.0,10059,4414,5372,680169097.0,1245674764.0,256346,468247,2653.3,2660.3,724593,1925843861.0,9786,2023-11-01 12:45:00
33,YNDX,1677,2975,305461260.0,495431679.0,114887,186128,2658.8,2661.8,301015,800892939.0,4652,1538,2813,297416457.0,472425741.0,112096,177449,2653.2,2662.3,289545,769842198.0,4351,2023-11-01 12:50:00
34,YNDX,2292,1707,409889951.0,349640717.0,154639,131513,2650.6,2658.6,286152,759530669.0,3999,2167,1583,401136525.0,351832882.0,151322,132193,2650.9,2661.5,283515,752969407.0,3750,2023-11-01 12:55:00
35,YNDX,1752,1609,320211655.0,384404973.0,120951,144801,2647.4,2654.7,265752,704616629.0,3361,1576,1449,309167804.0,375187787.0,116793,141220,2647.1,2656.8,258013,684355592.0,3025,2023-11-01 13:00:00
36,YNDX,3505,4056,657368773.0,1018591065.0,248291,384382,2647.6,2649.9,632673,1675959838.0,7561,3295,3817,631298260.0,997159556.0,238636,375745,2645.4,2653.8,614381,1628457817.0,7112,2023-11-01 13:05:00
37,YNDX,3574,4836,591181897.0,1192178054.0,223000,448950,2651.0,2655.5,671950,1783359951.0,8410,3414,4686,596032702.0,1179875376.0,224922,444127,2650.0,2656.6,669049,1775908078.0,8100,2023-11-01 13:10:00
38,YNDX,2364,5652,499334143.0,1963974333.0,188840,740831,2644.2,2651.0,929671,2463308476.0,8016,2185,5522,493007662.0,1943027152.0,186532,732245,2643.0,2653.5,918777,2436034814.0,7707,2023-11-01 13:15:00
39,YNDX,1894,4146,405663166.0,1555215836.0,150234,577976,2700.2,2690.8,728210,1960879003.0,6040,1649,3999,369520386.0,1518655994.0,136626,573299,2704.6,2649.0,709925,1888176380.0,5648,2023-11-01 13:20:00
40,YNDX,1397,2166,228203258.0,672305517.0,86373,253804,2642.1,2648.9,340177,900508775.0,3563,1153,2055,214727778.0,670289694.0,81327,252966,2640.3,2649.7,334293,885017473.0,3208,2023-11-01 13:25:00
41,YNDX,998,1579,204354055.0,326570794.0,77451,123464,2638.5,2645.1,200915,530924850.0,2577,853,1470,208198115.0,318325981.0,78918,120204,2638.2,2648.2,199122,526524097.0,2323,2023-11-01 13:30:00
42,YNDX,960,1119,171949891.0,239773885.0,65176,90608,2638.2,2646.3,155784,411723776.0,2079,818,1022,162843291.0,234309977.0,61751,88489,2637.1,2647.9,150240,397153268.0,1840,2023-11-01 13:35:00
43,YNDX,1915,1741,354845595.0,445463703.0,134311,168104,2642.0,2649.9,302415,800309298.0,3656,1684,1627,342834337.0,458443321.0,129821,172923,2640.8,2651.1,302744,801277659.0,3311,2023-11-01 13:40:00
44,YNDX,4064,5111,716589750.0,1081548987.0,271020,408098,2644.0,2650.2,679118,1798138737.0,9175,3763,4977,701165940.0,1071559438.0,265398,404279,2641.9,2650.5,669677,1772725379.0,8740,2023-11-01 13:45:00
45,YNDX,2869,3106,439067888.0,577977725.0,165773,217654,2648.6,2655.5,383427,1017045613.0,5975,2250,2964,432277085.0,567405428.0,163414,213615,2645.3,2656.2,377029,999682514.0,5214,2023-11-01 13:50:00
46,YNDX,2615,1721,402752536.0,315240146.0,151819,118577,2652.8,2658.5,270396,717992683.0,4336,2536,1579,396788068.0,308446355.0,149770,115993,2649.3,2659.2,265763,705234423.0,4115,2023-11-01 13:55:00
47,YNDX,3626,4615,712426843.0,827283015.0,269231,311544,2646.2,2655.4,580775,1539709858.0,8241,3501,4139,708858718.0,819735730.0,267963,308646,2645.4,2655.9,576609,1528594448.0,7640,2023-11-01 14:00:00
48,YNDX,4698,2025,1608966376.0,415459063.0,607174,156202,2649.9,2659.8,763376,2024425439.0,6723,4474,1890,1603435538.0,405575954.0,605314,152428,2648.9,2660.8,757742,2009011492.0,6364,2023-11-01 14:05:00
49,YNDX,2619,887,952142002.0,183828495.0,359070,69194,2651.7,2656.7,428264,1135970498.0,3506,2497,787,943862279.0,176190387.0,356057,66183,2650.9,2662.2,422240,1120052666.0,3284,2023-11-01 14:10:00
50,YNDX,4670,2308,1413553596.0,568434042.0,532011,213100,2657.0,2667.5,745111,1981987638.0,6978,4046,2064,1382990065.0,548266836.0,520935,205554,2654.8,2667.3,726489,1931256901.0,6110,2023-11-01 14:15:00
51,YNDX,1984,1594,574021026.0,246066950.0,216239,92365,2654.6,2664.1,308604,820087976.0,3578,1854,1476,569583241.0,230477928.0,214588,86502,2654.3,2664.4,301090,800061169.0,3330,2023-11-01 14:20:00
52,YNDX,3330,2535,1024714417.0,464483580.0,386004,174542,2654.7,2661.2,560546,1489197997.0,5865,3171,2432,1020840779.0,457497087.0,384684,171858,2653.7,2662.1,556542,1478337867.0,5603,2023-11-01 14:25:00
53,YNDX,2240,2554,572855595.0,448258299.0,215931,168399,2653.0,2661.9,384330,1021113894.0,4794,2114,2437,566788305.0,435532198.0,213684,163646,2652.5,2661.4,377330,1002320504.0,4551,2023-11-01 14:30:00
54,YNDX,6445,3569,1681524457.0,820076706.0,631577,297616,2662.4,2755.5,929193,2501601164.0,10014,6102,3247,1613388682.0,739985776.0,606518,274758,2660.1,2693.2,881276,2353374458.0,9349,2023-11-01 14:35:00
55,YNDX,2284,2618,595850188.0,444807268.0,224335,167186,2656.1,2660.6,391521,1040657456.0,4902,2120,2492,589519798.0,440784623.0,221980,165491,2655.7,2663.5,387471,1030304421.0,4612,2023-11-01 14:40:00
56,YNDX,2043,2439,372456481.0,443560166.0,140574,166869,2649.5,2658.1,307443,816016648.0,4482,1913,2342,386976870.0,426834634.0,146322,160498,2644.7,2659.4,306820,813811505.0,4255,2023-11-01 14:45:00
57,YNDX,2013,3074,306257546.0,486190033.0,115518,182878,2651.2,2658.5,298396,792447580.0,5087,1851,3002,300719647.0,493779469.0,113468,185678,2650.3,2659.3,299146,794499116.0,4853,2023-11-01 14:50:00
58,YNDX,930,941,192603888.0,186452327.0,72592,70018,2653.2,2662.9,142610,379056215.0,1871,798,858,185884059.0,179902929.0,70141,67531,2650.1,2664.0,137672,365786989.0,1656,2023-11-01 14:55:00
59,YNDX,1959,3168,303182338.0,664912278.0,114274,240683,2653.1,2762.6,354957,968094617.0,5127,1834,3100,295193944.0,638085473.0,111349,236563,2651.1,2697.3,347912,933279417.0,4934,2023-11-01 15:00:00
60,YNDX,1952,2740,338504901.0,595508413.0,127819,224259,2648.3,2655.4,352078,934013315.0,4692,1796,2653,335161677.0,587626537.0,126566,221140,2648.1,2657.3,347706,922788214.0,4449,2023-11-01 15:05:00
61,YNDX,2063,4639,370303331.0,1199103692.0,139932,451694,2646.3,2654.7,591626,1569407024.0,6702,1877,4553,359745062.0,1191762503.0,135975,448905,2645.7,2654.8,584880,1551507565.0,6430,2023-11-01 15:10:00
62,YNDX,2430,4840,459164313.0,1260048874.0,173636,469892,2644.4,2681.6,643528,1719213188.0,7270,2275,4747,448679905.0,1229980823.0,169680,463398,2644.3,2654.3,633078,1678660728.0,7022,2023-11-01 15:15:00
63,YNDX,1316,1506,248981124.0,444212219.0,94230,155317,2642.3,2860.0,249547,693193343.0,2822,1143,1425,230537759.0,440348404.0,87319,153246,2640.2,2873.5,240565,670886164.0,2568,2023-11-01 15:20:00
64,YNDX,2844,2525,426527182.0,619683499.0,161471,234242,2641.5,2645.5,395713,1046210682.0,5369,2692,2458,418047349.0,613146910.0,158316,231497,2640.6,2648.6,389813,1031194259.0,5150,2023-11-01 15:25:00
65,YNDX,1187,2155,163850764.0,677685698.0,61960,255909,2644.5,2648.2,317869,841536462.0,3342,1060,2099,157285223.0,674310352.0,59570,254596,2640.3,2648.6,314166,831595576.0,3159,2023-11-01 15:30:00
66,YNDX,963,1041,164425311.0,267041065.0,62243,100821,2641.7,2648.7,163064,431466377.0,2004,823,939,157218271.0,258298299.0,59561,97462,2639.6,2650.2,157023,415516571.0,1762,2023-11-01 15:35:00
67,YNDX,1066,1008,204313251.0,246556832.0,74710,93072,2734.8,2649.1,167782,450870084.0,2074,895,947,183376538.0,231607944.0,69508,87428,2638.2,2649.1,156936,414984483.0,1842,2023-11-01 15:40:00
68,YNDX,2610,2440,346203959.0,440784178.0,131056,166411,2641.6,2648.8,297467,786988138.0,5050,2463,2393,341766754.0,440062503.0,129413,166158,2640.9,2648.5,295571,781829257.0,4856,2023-11-01 15:45:00
69,YNDX,2557,2238,352427258.0,500822035.0,133166,188201,2646.5,2661.1,321367,853249293.0,4795,2392,2173,334501260.0,528094250.0,126624,186678,2641.7,2828.9,313302,862595511.0,4565,2023-11-01 15:50:00
70,YNDX,1446,2052,216017103.0,584270914.0,81474,220526,2651.4,2649.4,302000,800288017.0,3498,1201,1970,193692384.0,575901829.0,73306,217359,2642.2,2649.5,290665,769594214.0,3171,2023-11-01 15:55:00
71,YNDX,2016,2019,382915331.0,461720017.0,144828,174236,2643.9,2650.0,319064,844635348.0,4035,1912,1952,379942757.0,451163087.0,143766,170202,2642.8,2650.8,313968,831105844.0,3864,2023-11-01 16:00:00
72,YNDX,2174,2423,337615359.0,563094901.0,127764,212572,2642.5,2649.0,340336,900710260.0,4597,2070,2360,332208178.0,560250391.0,125798,211480,2640.8,2649.2,337278,892458570.0,4430,2023-11-01 16:05:00
73,YNDX,4066,4696,531665211.0,1150801001.0,201350,434771,2640.5,2646.9,636121,1682466213.0,8762,3936,4598,540078601.0,1150482479.0,201162,434398,2684.8,2648.5,635560,1690561080.0,8534,2023-11-01 16:10:00
74,YNDX,2056,3411,254255759.0,922167096.0,96288,348374,2640.6,2647.1,444662,1176422855.0,5467,1977,3360,252102694.0,921534451.0,95488,348117,2640.2,2647.2,443605,1173637145.0,5337,2023-11-01 16:15:00
75,YNDX,3632,5007,503067529.0,1082955998.0,190407,409176,2642.1,2646.7,599583,1586023527.0,8639,3524,4931,498974269.0,1076351280.0,188896,406650,2641.5,2646.9,595546,1575325550.0,8455,2023-11-01 16:20:00
76,YNDX,3502,6536,496401298.0,1562435531.0,185577,590780,2674.9,2644.7,776357,2058836830.0,10038,3389,6423,485153473.0,1550610940.0,183840,586097,2639.0,2645.7,769937,2035764414.0,9812,2023-11-01 16:25:00
77,YNDX,3403,4639,456399817.0,1176473624.0,172936,444884,2639.1,2644.5,617820,1632873442.0,8042,3278,4558,449897804.0,1187148699.0,170498,448569,2638.7,2646.5,619067,1637046503.0,7836,2023-11-01 16:30:00
78,YNDX,3708,5260,490575055.0,1139692074.0,185781,430683,2640.6,2646.2,616464,1630267130.0,8968,3595,4845,486818100.0,1126376407.0,184392,425493,2640.1,2647.2,609885,1613194508.0,8440,2023-11-01 16:35:00
79,YNDX,3529,5555,593682285.0,1246691198.0,223076,472760,2661.3,2637.0,695836,1840373484.0,9084,3251,5222,570595771.0,1206430751.0,216872,456964,2631.0,2640.1,673836,1777026523.0,8473,2023-11-01 16:40:00
80,YNDX,2535,4776,389796021.0,948128414.0,148043,359262,2633.0,2639.1,507305,1337924436.0,7311,2422,4720,375090343.0,953430475.0,142505,361169,2632.1,2639.8,503674,1328520818.0,7142,2023-11-01 16:45:00
81,YNDX,3017,3082,467437189.0,661508074.0,177384,250348,2635.2,2642.4,427732,1128945263.0,6099,2889,3006,455905707.0,658975212.0,173044,249368,2634.6,2642.6,422412,1114880919.0,5895,2023-11-01 16:50:00
82,YNDX,3049,4827,444952477.0,1081795069.0,168904,409589,2634.4,2641.2,578493,1526747547.0,7876,2942,4763,444183657.0,1078657859.0,168623,408377,2634.2,2641.3,577000,1522841517.0,7705,2023-11-01 16:55:00
83,YNDX,1581,1742,209825379.0,472299576.0,79637,178787,2634.8,2641.7,258424,682124956.0,3323,1513,1696,207249214.0,468783717.0,78706,177453,2633.2,2641.7,256159,676032931.0,3209,2023-11-01 17:00:00
84,YNDX,4106,3288,589785899.0,957667420.0,223917,362831,2633.9,2639.4,586748,1547453319.0,7394,3851,3141,577945974.0,953826636.0,219448,361190,2633.6,2640.8,580638,1531772610.0,6992,2023-11-01 17:05:00
85,YNDX,2977,2731,419743797.0,636064807.0,159099,240563,2638.3,2644.1,399662,1055808604.0,5708,2874,2663,408757233.0,633022418.0,154977,239390,2637.5,2644.3,394367,1041779652.0,5537,2023-11-01 17:10:00
86,YNDX,1451,1325,256377713.0,248981428.0,97023,93946,2642.4,2650.3,190969,505359141.0,2776,1366,1271,242531326.0,244150960.0,91862,92108,2640.2,2650.7,183970,486682286.0,2637,2023-11-01 17:15:00
87,YNDX,2473,1484,378458499.0,307974859.0,143084,116130,2645.0,2652.0,259214,686433359.0,3957,1881,1350,355930916.0,291233924.0,134667,109737,2643.0,2653.9,244404,647164841.0,3231,2023-11-01 17:20:00
88,YNDX,1076,2391,255487958.0,355235303.0,96557,133999,2646.0,2651.0,230556,610723262.0,3467,970,2297,255630316.0,346430815.0,96755,130605,2642.0,2652.5,227360,602061132.0,3267,2023-11-01 17:25:00
89,YNDX,1488,1558,317575363.0,304487120.0,120130,114825,2643.6,2651.7,234955,622062484.0,3046,1408,1462,317275691.0,288978229.0,120032,108893,2643.3,2653.8,228925,606253920.0,2870,2023-11-01 17:30:00
90,YNDX,1851,1363,289046409.0,243024650.0,109300,91708,2644.5,2650.0,201008,532071059.0,3214,1754,1314,285143344.0,237799890.0,107880,89645,2643.2,2652.7,197525,522943235.0,3068,2023-11-01 17:35:00
91,YNDX,2929,1792,623800969.0,341051902.0,232784,128315,2679.7,2657.9,361099,964852871.0,4721,2828,1616,614697284.0,326661970.0,232065,122822,2648.8,2659.6,354887,941359254.0,4444,2023-11-01 17:40:00
92,YNDX,4444,1955,967410995.0,249819468.0,365006,94107,2650.4,2654.6,459113,1217230464.0,6399,4335,1878,960221337.0,248427547.0,362309,93480,2650.3,2657.5,455789,1208648884.0,6213,2023-11-01 17:45:00
93,YNDX,1686,2860,410467915.0,493458250.0,150029,185067,2735.9,2666.4,335096,903926165.0,4546,1586,2796,391068803.0,482020457.0,147685,181577,2648.0,2654.6,329262,873089260.0,4382,2023-11-01 17:50:00
94,YNDX,868,917,191218825.0,174771134.0,65343,65791,2926.4,2656.5,131134,365989960.0,1785,783,876,167633831.0,172596703.0,63393,64968,2644.4,2656.6,128361,340230534.0,1659,2023-11-01 17:55:00
95,YNDX,1522,1746,240712369.0,327336559.0,90786,123302,2651.4,2654.8,214088,568048928.0,3268,1443,1647,236960059.0,312707306.0,89519,117757,2647.0,2655.5,207276,549667365.0,3090,2023-11-01 18:00:00
96,YNDX,622,944,108709457.0,208137163.0,41067,78564,2647.1,2649.3,119631,316846621.0,1566,546,849,117564320.0,178495373.0,44432,67183,2645.9,2656.9,111615,296059694.0,1395,2023-11-01 18:05:00
97,YNDX,2528,4135,382885539.0,784640916.0,144755,293532,2645.1,2673.1,438287,1167526455.0,6663,2432,4040,378103318.0,767203856.0,142956,289343,2644.9,2651.5,432299,1145307174.0,6472,2023-11-01 18:10:00
98,YNDX,3846,2345,1122330687.0,333892328.0,423763,125913,2648.5,2651.8,549676,1456223016.0,6191,3744,2273,1107175416.0,322293298.0,418508,121512,2645.5,2652.4,540020,1429468714.0,6017,2023-11-01 18:15:00
99,YNDX,3113,1977,874044511.0,268087824.0,329510,101145,2652.6,2650.5,430655,1142132336.0,5090,3037,1920,871672765.0,264210341.0,329572,99617,2644.9,2652.3,429189,1135883106.0,4957,2023-11-01 18:20:00
100,YNDX,2404,1579,515959929.0,223207424.0,195202,84351,2643.2,2646.2,279553,739167354.0,3983,2315,1513,508825971.0,229190158.0,192552,83999,2642.5,2728.5,276551,738016130.0,3828,2023-11-01 18:25:00
101,YNDX,3794,2647,796383927.0,413100509.0,301342,156254,2642.8,2643.8,457596,1209484436.0,6441,3671,2590,791137485.0,413019304.0,299468,155880,2641.8,2649.6,455348,1204156790.0,6261,2023-11-01 18:30:00
102,YNDX,1126,953,194890861.0,166425519.0,73832,62901,2639.7,2645.8,136733,361316380.0,2079,1007,881,161505863.0,167745702.0,61151,63317,2641.1,2649.3,124468,329251565.0,1888,2023-11-01 18:35:00
103,YNDX,726,601,86098480.0,93208785.0,32580,35212,2642.7,2647.1,67792,179307266.0,1327,700,560,85302544.0,88104803.0,32284,33231,2642.3,2651.3,65515,173407347.0,1260,2023-11-01 18:40:00
104,YNDX,11147,3121,4214050928.0,635943997.0,1593773,215525,2644.1,2950.7,1809298,4849994926.0,14268,10269,2327,4141808639.0,512640293.0,1566146,193332,2644.6,2651.6,1759478,4654448933.0,12596,2023-11-02 10:05:00
105,YNDX,4768,5040,934931912.0,686917545.0,353033,259102,2648.3,2651.1,612135,1621849457.0,9808,4509,4769,915580042.0,659994634.0,345793,248823,2647.8,2652.5,594616,1575574676.0,9278,2023-11-02 10:10:00
106,YNDX,7726,5242,1135271911.0,915465501.0,428743,345485,2647.9,2649.8,774228,2050737413.0,12968,7507,5067,1121718827.0,890506416.0,423642,335746,2647.8,2652.3,759388,2012225244.0,12574,2023-11-02 10:15:00
107,YNDX,6398,4076,1321075256.0,657550112.0,496292,246954,2661.9,2662.6,743246,1978625368.0,10474,5939,3568,1265573384.0,608845291.0,476365,228538,2656.7,2664.1,704903,1874418676.0,9507,2023-11-02 10:20:00
108,YNDX,3814,1878,1156272039.0,500347769.0,435854,188130,2652.9,2659.6,623984,1656619808.0,5692,3519,1611,1135757481.0,479279984.0,428398,180008,2651.2,2662.5,608406,1615037465.0,5130,2023-11-02 10:25:00
109,YNDX,5734,2463,1652592522.0,453954297.0,623458,170881,2650.7,2656.6,794339,2106546819.0,8197,5561,2322,1645706991.0,429991730.0,620895,161877,2650.5,2656.3,782772,2075698722.0,7883,2023-11-02 10:30:00
110,YNDX,12514,5609,4068064575.0,821714334.0,1532340,308747,2654.8,2661.4,1841087,4889778910.0,18123,12260,5408,4033037916.0,809976375.0,1519447,304303,2654.3,2661.7,1823750,4843014292.0,17668,2023-11-02 10:35:00
111,YNDX,3825,2547,773299755.0,373255582.0,291144,140045,2656.1,2665.3,431189,1146555337.0,6372,3707,2358,766462949.0,352659266.0,288732,132431,2654.6,2663.0,421163,1119122215.0,6065,2023-11-02 10:40:00
112,YNDX,4002,3755,833511859.0,622444084.0,314065,234295,2653.9,2656.7,548360,1455955943.0,7757,3886,3616,826201523.0,597263967.0,311348,224542,2653.6,2659.9,535890,1423465490.0,7502,2023-11-02 10:45:00
113,YNDX,1224,2956,245729138.0,612162604.0,92674,230306,2651.5,2658.0,322980,857891742.0,4180,1121,2866,237833106.0,609130232.0,89771,229172,2649.3,2658.0,318943,846963338.0,3987,2023-11-02 10:50:00
114,YNDX,5145,6328,1002695044.0,1983510636.0,379400,742208,2642.8,2672.4,1121608,2986205680.0,11473,4595,6025,930360810.0,1872715721.0,352016,707467,2643.0,2647.1,1059483,2803076532.0,10620,2023-11-02 10:55:00
115,YNDX,2677,6996,486026026.0,2325293857.0,183998,877969,2641.5,2648.5,1061967,2811319884.0,9673,2513,6858,487645706.0,2323604350.0,184654,877332,2640.9,2648.5,1061986,2811250057.0,9371,2023-11-02 11:00:00
116,YNDX,2808,9625,476528359.0,4013738215.0,180535,1516387,2639.5,2646.9,1696922,4490266575.0,12433,2707,9561,457671108.0,4003230240.0,173348,1512095,2640.2,2647.5,1685443,4460901349.0,12268,2023-11-02 11:05:00
117,YNDX,8223,22234,1847486776.0,7560648920.0,703429,2869255,2626.4,2635.1,3572684,9408135696.0,30457,7480,21851,1776015931.0,7502848448.0,676367,2845527,2625.8,2636.7,3521894,9278864380.0,29331,2023-11-02 11:10:00
118,YNDX,5665,19403,925976749.0,5045560189.0,352540,1916622,2626.6,2632.5,2269162,5971536938.0,25068,5240,19198,877594199.0,5010823368.0,334189,1902665,2626.0,2633.6,2236854,5888417568.0,24438,2023-11-02 11:15:00
119,YNDX,3405,7425,611423961.0,2395404962.0,232253,908669,2632.6,2636.2,1140922,3006828923.0,10830,3157,7264,592561751.0,2372992150.0,225381,899604,2629.2,2637.8,1124985,2965553902.0,10421,2023-11-02 11:20:00
120,YNDX,2983,5532,443828991.0,1601495440.0,168927,607504,2627.3,2636.2,776431,2045324432.0,8515,2809,5452,441228192.0,1587402235.0,167916,602036,2627.7,2636.7,769952,2028630427.0,8261,2023-11-02 11:25:00
121,YNDX,1772,2143,264700111.0,743945668.0,100679,282405,2629.1,2634.3,383084,1008645780.0,3915,1659,2074,252838017.0,741321937.0,96237,281344,2627.2,2634.9,377581,994159954.0,3733,2023-11-02 11:30:00
122,YNDX,1386,2544,250115112.0,903172764.0,95121,342603,2629.4,2636.2,437724,1153287876.0,3930,1259,2462,245163614.0,893990275.0,93333,339115,2626.8,2636.2,432448,1139153889.0,3721,2023-11-02 11:35:00
123,YNDX,1036,1843,188363819.0,798193214.0,71641,302767,2629.3,2636.3,374408,986557034.0,2879,941,1786,180656650.0,811661990.0,68756,305203,2627.5,2659.4,373959,992318640.0,2727,2023-11-02 11:40:00
124,YNDX,1426,1894,362248456.0,610996487.0,137798,231836,2628.8,2635.5,369634,973244944.0,3320,1327,1768,352029467.0,591424553.0,133973,224241,2627.6,2637.5,358214,943454021.0,3095,2023-11-02 11:45:00
125,YNDX,1588,1085,605350540.0,209908686.0,230642,79740,2624.6,2632.4,310382,815259226.0,2673,1428,985,558088890.0,202838454.0,212510,76922,2626.2,2636.9,289432,760927344.0,2413,2023-11-02 11:50:00
126,YNDX,2737,1439,1038555368.0,241828365.0,395121,91732,2628.4,2636.2,486853,1280383733.0,4176,2575,1298,1037920377.0,230411060.0,394966,87415,2627.9,2635.8,482381,1268331438.0,3873,2023-11-02 11:55:00
127,YNDX,555,611,126465356.0,125861231.0,48202,47717,2623.7,2637.7,95919,252326587.0,1166,457,543,119465952.0,123971075.0,45550,46947,2622.7,2640.7,92497,243437027.0,1000,2023-11-02 12:00:00
128,YNDX,1996,828,522856136.0,205918784.0,199056,78104,2626.7,2636.5,277160,728774920.0,2824,1865,728,516257076.0,198223357.0,196560,75145,2626.5,2637.9,271705,714480433.0,2593,2023-11-02 12:05:00
129,YNDX,2249,672,621785695.0,134155110.0,236482,50850,2629.3,2638.3,287332,755940806.0,2921,2150,570,615241712.0,129569364.0,234024,49109,2629.0,2638.4,283133,744811077.0,2720,2023-11-02 12:10:00
130,YNDX,811,443,160080280.0,91185444.0,60828,34542,2631.7,2639.8,95370,251265724.0,1254,774,358,153509016.0,88652995.0,58402,33572,2628.5,2640.7,91974,242162011.0,1132,2023-11-02 12:15:00
131,YNDX,923,373,183679085.0,102461276.0,69825,38822,2630.6,2639.3,108647,286140361.0,1296,750,293,176081378.0,98286382.0,66992,37205,2628.4,2641.8,104197,274367760.0,1043,2023-11-02 12:20:00
132,YNDX,2045,1142,458763291.0,206213225.0,174143,78039,2634.4,2642.4,252182,664976516.0,3187,1903,947,450439279.0,201932784.0,171171,76398,2631.5,2643.2,247569,652372063.0,2850,2023-11-02 12:25:00
133,YNDX,1732,662,571295449.0,164097267.0,216683,62069,2636.5,2643.8,278752,735392716.0,2394,1618,538,561165701.0,155156689.0,212988,58638,2634.7,2646.0,271626,716322391.0,2156,2023-11-02 12:30:00
134,YNDX,2011,449,605668280.0,113073432.0,229866,42745,2634.9,2645.3,272611,718741713.0,2460,1964,352,603525471.0,106087292.0,229062,40088,2634.8,2646.4,269150,709612763.0,2316,2023-11-02 12:35:00
135,YNDX,2659,1253,960267065.0,243293066.0,364185,90855,2636.8,2677.8,455040,1203560132.0,3912,2539,1124,945983433.0,234225918.0,358893,88510,2635.8,2646.3,447403,1180209351.0,3663,2023-11-02 12:40:00
136,YNDX,945,1068,176055996.0,160024736.0,66746,60459,2637.7,2646.8,127205,336080732.0,2013,882,942,173024876.0,156107262.0,65653,58947,2635.4,2648.3,124600,329132139.0,1824,2023-11-02 12:45:00
137,YNDX,2051,1586,728989851.0,256880992.0,276590,97125,2635.6,2644.8,373715,985870844.0,3637,1997,1496,725829198.0,247287297.0,275402,93459,2635.5,2645.9,368861,973116495.0,3493,2023-11-02 12:50:00
138,YNDX,1495,428,507886727.0,95810759.0,192758,36243,2634.8,2643.6,229001,603697486.0,1923,1422,327,505830255.0,97211279.0,191977,35635,2634.8,2728.0,227612,603041534.0,1749,2023-11-02 12:55:00
139,YNDX,5277,845,2103947190.0,230243890.0,797862,86993,2637.0,2646.7,884855,2334191080.0,6122,5209,735,2096063845.0,225047510.0,794985,85012,2636.6,2647.2,879997,2321111355.0,5944,2023-11-02 13:00:00
140,YNDX,10045,832,4314198353.0,208511367.0,1635037,78656,2638.6,2650.9,1713693,4522709721.0,10877,9986,717,4307703688.0,198769501.0,1632634,74983,2638.5,2650.9,1707617,4506473190.0,10703,2023-11-02 13:05:00
141,YNDX,7235,588,3447015733.0,136928096.0,1306034,51694,2639.3,2648.8,1357728,3583943830.0,7823,7175,459,3443550922.0,177804013.0,1304784,66830,2639.2,2660.5,1371614,3621354935.0,7634,2023-11-02 13:10:00
142,YNDX,4352,1138,1712647177.0,238746408.0,649388,72201,2637.3,3306.7,721589,1951393585.0,5490,4285,1046,1710734597.0,187627143.0,648691,70934,2637.2,2645.1,719625,1898361740.0,5331,2023-11-02 13:15:00
143,YNDX,9512,2331,3296096356.0,372486130.0,1250082,140899,2636.7,2643.6,1390981,3668582486.0,11843,9442,2177,3294771607.0,370203774.0,1249586,140023,2636.7,2643.9,1389609,3664975381.0,11619,2023-11-02 13:20:00
144,YNDX,3096,2000,1059336311.0,293465598.0,402051,111258,2634.8,2637.7,513309,1352801909.0,5096,2988,1754,1053164672.0,282339736.0,399718,106837,2634.8,2642.7,506555,1335504409.0,4742,2023-11-02 13:25:00
145,YNDX,967,4420,249582982.0,612904886.0,94936,232438,2629.0,2636.9,327374,862487869.0,5387,838,4212,241424204.0,604339700.0,91851,229027,2628.4,2638.7,320878,845763904.0,5050,2023-11-02 13:30:00
146,YNDX,1307,2085,280767239.0,387925396.0,106742,128940,2630.3,3008.6,235682,668692635.0,3392,1202,1943,277294020.0,384999356.0,105455,127701,2629.5,3014.8,233156,662293376.0,3145,2023-11-02 13:35:00
147,YNDX,2420,4606,564010857.0,649134660.0,214283,245999,2632.1,2638.8,460282,1213145517.0,7026,2337,4447,555442142.0,644133150.0,211101,244091,2631.2,2638.9,455192,1199575292.0,6784,2023-11-02 13:40:00
148,YNDX,1791,2014,369718377.0,329415055.0,140488,124671,2631.7,2642.3,265159,699133433.0,3805,1721,1879,364552937.0,319496477.0,138575,120986,2630.7,2640.8,259561,684049415.0,3600,2023-11-02 13:45:00
149,YNDX,2576,2966,628615349.0,611683200.0,239471,232218,2625.0,2634.1,471689,1240298549.0,5542,2309,2622,602238678.0,590574624.0,229397,223927,2625.3,2637.4,453324,1192813303.0,4931,2023-11-02 13:50:00
150,YNDX,2836,2672,700448747.0,504946120.0,255551,191867,2740.9,2631.8,447418,1205394867.0,5508,2524,2296,642934669.0,470881587.0,245121,178846,2622.9,2632.9,423967,1113816257.0,4820,2023-11-02 13:55:00
151,YNDX,2408,1857,701210791.0,364369424.0,244610,138267,2866.6,2635.3,382877,1065580216.0,4265,2254,1590,638499358.0,356212084.0,243224,135143,2625.1,2635.8,378367,994711442.0,3844,2023-11-02 14:00:00
152,YNDX,1324,1839,453915041.0,220398200.0,172904,83693,2625.2,2633.4,256597,674313242.0,3163,1270,1687,448610563.0,216030391.0,170891,81984,2625.1,2635.0,252875,664640954.0,2957,2023-11-02 14:05:00
153,YNDX,838,1410,214394796.0,212474833.0,81668,80667,2625.2,2634.0,162335,426869629.0,2248,727,1232,203905017.0,201822761.0,77702,76551,2624.2,2636.4,154253,405727778.0,1959,2023-11-02 14:10:00
154,YNDX,558,2360,167300930.0,307671005.0,63732,116929,2625.1,2631.3,180661,474971935.0,2918,484,2146,162557605.0,279621943.0,61955,106202,2623.8,2632.9,168157,442179549.0,2630,2023-11-02 14:15:00
155,YNDX,480,1315,140092686.0,188836115.0,53388,71786,2624.0,2630.5,125174,328928801.0,1795,398,1048,138476364.0,162773990.0,52782,61777,2623.6,2634.9,114559,301250354.0,1446,2023-11-02 14:20:00
156,YNDX,684,1205,177880730.0,185480922.0,67737,70433,2626.0,2633.4,138170,363361652.0,1889,569,930,171470221.0,171435010.0,65357,65077,2623.6,2634.3,130434,342905231.0,1499,2023-11-02 14:25:00
157,YNDX,1872,2323,309452934.0,332589516.0,117832,123916,2626.2,2684.0,241748,642042451.0,4195,1786,2125,306403042.0,314286245.0,116700,119418,2625.6,2631.8,236118,620689287.0,3911,2023-11-02 14:30:00
158,YNDX,1295,1528,264266577.0,280244140.0,100659,106400,2625.4,2633.9,207059,544510718.0,2823,1178,1378,261558600.0,272255818.0,99640,103357,2625.0,2634.1,202997,533814419.0,2556,2023-11-02 14:35:00
159,YNDX,1112,2438,225330223.0,328723261.0,85846,124847,2624.8,2633.0,210693,554053484.0,3550,1024,2278,222687685.0,322661505.0,84850,122534,2624.5,2633.2,207384,545349191.0,3302,2023-11-02 14:40:00
160,YNDX,898,1616,195533401.0,212020428.0,74504,80533,2624.5,2632.7,155037,407553830.0,2514,818,1439,193672885.0,206099256.0,73818,78253,2623.7,2633.8,152071,399772141.0,2257,2023-11-02 14:45:00
161,YNDX,669,1227,170577108.0,166025674.0,65007,62978,2624.0,2636.2,127985,336602783.0,1896,593,1074,166079062.0,163998699.0,63310,62197,2623.3,2636.8,125507,330077761.0,1667,2023-11-02 14:50:00
162,YNDX,980,2180,241987382.0,338002525.0,92304,128423,2621.6,2631.9,220727,579989908.0,3160,862,1978,234146699.0,328139726.0,89326,124648,2621.3,2632.5,213974,562286426.0,2840,2023-11-02 14:55:00
163,YNDX,2119,1974,342250143.0,275803952.0,130401,104863,2624.6,2630.1,235264,618054096.0,4093,2037,1794,345324209.0,274053912.0,131615,104121,2623.7,2632.1,235736,619378121.0,3831,2023-11-02 15:00:00
164,YNDX,2359,3190,596092393.0,575654568.0,227530,219125,2619.8,2627.1,446655,1171746961.0,5549,2088,2887,560067997.0,555236730.0,213832,211094,2619.2,2630.3,424926,1115304727.0,4975,2023-11-02 15:05:00
165,YNDX,1327,1067,308218550.0,210690945.0,117519,80146,2622.7,2628.8,197665,518909495.0,2394,1099,986,305188398.0,207438206.0,116434,76281,2621.1,2719.4,192715,512626604.0,2085,2023-11-02 15:10:00
166,YNDX,960,1674,210552911.0,232061146.0,80375,88339,2619.6,2626.9,168714,442614058.0,2634,842,1134,198758665.0,220847765.0,75923,83975,2617.9,2629.9,159898,419606430.0,1976,2023-11-02 15:15:00
167,YNDX,2192,1946,464449004.0,306251197.0,177490,116556,2616.8,2627.5,294046,770700202.0,4138,1562,1406,429023290.0,301347403.0,163882,114512,2617.9,2631.6,278394,730370693.0,2968,2023-11-02 15:20:00
168,YNDX,859,1127,186506618.0,191999293.0,71174,72962,2620.4,2631.5,144136,378505911.0,1986,760,1050,179671812.0,174270680.0,68580,66242,2619.9,2630.8,134822,353942493.0,1810,2023-11-02 15:25:00
169,YNDX,872,633,182999355.0,116959330.0,69763,44446,2623.2,2631.5,114209,299958686.0,1505,783,568,179356156.0,116224831.0,68415,44145,2621.6,2632.8,112560,295580987.0,1351,2023-11-02 15:30:00
170,YNDX,2126,2911,421913926.0,461811954.0,160964,175654,2621.2,2629.1,336618,883725880.0,5037,1988,2829,415964961.0,458514407.0,158706,174389,2621.0,2629.3,333095,874479369.0,4817,2023-11-02 15:35:00
171,YNDX,1485,1429,329011533.0,235052599.0,125442,89336,2622.8,2631.1,214778,564064133.0,2914,1396,1366,325785009.0,230871545.0,124233,87731,2622.4,2631.6,211964,556656555.0,2762,2023-11-02 15:40:00
172,YNDX,865,707,192373919.0,152725418.0,69432,58083,2770.7,2629.4,127515,345099338.0,1572,759,612,175523182.0,147020907.0,66999,55864,2619.8,2631.8,122863,322544089.0,1371,2023-11-02 15:45:00
173,YNDX,906,602,164211604.0,124662200.0,62651,47483,2621.1,2625.4,110134,288873804.0,1508,791,534,159882097.0,117681979.0,61024,44704,2620.0,2632.5,105728,277564077.0,1325,2023-11-02 15:50:00
174,YNDX,1063,1202,216543607.0,199279973.0,82534,75842,2623.7,2627.6,158376,415823580.0,2265,990,1131,210605601.0,191457288.0,80352,72785,2621.0,2630.4,153137,402062889.0,2121,2023-11-02 15:55:00
175,YNDX,3226,1823,983560484.0,336343614.0,371188,127613,2649.8,2635.7,498801,1319904098.0,5049,3115,1624,964149903.0,325917599.0,363053,123606,2655.7,2636.7,486659,1290067502.0,4739,2023-11-02 16:00:00
176,YNDX,2583,1042,954668703.0,175537539.0,363281,66621,2627.9,2634.9,429902,1130206242.0,3625,2534,961,948570535.0,162902682.0,361011,61760,2627.5,2637.7,422771,1111473217.0,3495,2023-11-02 16:05:00
177,YNDX,965,419,250493608.0,76445123.0,95207,28992,2631.0,2636.8,124199,326938731.0,1384,903,376,246643375.0,76633257.0,93854,29030,2627.9,2639.8,122884,323276632.0,1279,2023-11-02 16:10:00
178,YNDX,1050,654,273231480.0,125380438.0,103817,47555,2631.9,2636.5,151372,398611918.0,1704,955,592,270806435.0,116892163.0,103109,44309,2626.4,2638.1,147418,387698598.0,1547,2023-11-02 16:15:00
179,YNDX,1283,670,318591841.0,112443771.0,120945,42630,2634.2,2637.7,163575,431035612.0,1953,1260,626,315915911.0,111113523.0,120251,42119,2627.1,2638.1,162370,427029435.0,1886,2023-11-02 16:20:00
180,YNDX,2033,617,815395601.0,108773469.0,310307,41252,2627.7,2636.8,351559,924169071.0,2650,1958,552,804223664.0,104698724.0,306071,39662,2627.6,2639.8,345733,908922389.0,2510,2023-11-02 16:25:00
181,YNDX,1616,878,349506127.0,189987174.0,132204,71962,2643.7,2640.1,204166,539493301.0,2494,1460,810,337127284.0,177974748.0,128340,67389,2626.8,2641.0,195729,515102033.0,2270,2023-11-02 16:30:00
182,YNDX,1635,1397,326411223.0,226890344.0,123745,85881,2637.8,2641.9,209626,553301568.0,3032,1559,1283,321902692.0,222901044.0,122247,84318,2633.2,2643.6,206565,544803736.0,2842,2023-11-02 16:35:00
183,YNDX,1554,1740,342567553.0,325168962.0,130356,123336,2627.9,2636.4,253692,667736516.0,3294,1495,1650,352739094.0,313263865.0,134240,118744,2627.7,2638.1,252984,666002960.0,3145,2023-11-02 16:40:00
184,YNDX,3940,2217,1081656695.0,338345570.0,411436,128353,2629.0,2636.1,539789,1420002265.0,6157,3858,2169,1072342903.0,341228787.0,407893,129432,2629.0,2636.4,537325,1413571690.0,6027,2023-11-02 16:45:00
185,YNDX,2776,1515,631487202.0,226332955.0,239122,85753,2640.9,2639.4,324875,857820157.0,4291,2710,1490,622665769.0,228227509.0,236705,86453,2630.6,2639.9,323158,850893278.0,4200,2023-11-02 16:50:00
186,YNDX,2016,1678,584378711.0,226187507.0,221901,85704,2633.5,2639.2,307605,810566218.0,3694,1977,1426,570118896.0,220608344.0,216505,83556,2633.3,2640.2,300061,790727240.0,3403,2023-11-02 16:55:00
187,YNDX,2396,2263,463065772.0,327622276.0,176001,124175,2631.0,2638.4,300176,790688048.0,4659,2314,2209,467392749.0,315982723.0,177691,119757,2630.4,2638.5,297448,783375473.0,4523,2023-11-02 17:00:00
188,YNDX,2512,1759,571806504.0,245153527.0,217332,92942,2631.0,2637.7,310274,816960031.0,4271,2451,1686,568826949.0,244051629.0,216220,92498,2630.8,2638.5,308718,812878578.0,4137,2023-11-02 17:05:00
189,YNDX,4627,2592,857889516.0,374109019.0,326031,141895,2631.3,2636.5,467926,1231998535.0,7219,4566,2535,856112875.0,362756741.0,325388,137556,2631.1,2637.2,462944,1218869617.0,7101,2023-11-02 17:10:00
190,YNDX,3610,7839,923173564.0,1044403678.0,351209,396552,2628.6,2633.7,747761,1967577243.0,11449,3511,7786,916985749.0,1046123651.0,348879,397160,2628.4,2634.0,746039,1963109400.0,11297,2023-11-02 17:15:00
191,YNDX,2958,2792,482802389.0,439210622.0,183736,166761,2627.7,2633.8,350497,922013012.0,5750,2888,2712,481032152.0,435413570.0,183084,165235,2627.4,2635.1,348319,916445723.0,5600,2023-11-02 17:20:00
192,YNDX,2245,2836,363893130.0,505063847.0,138547,192316,2626.5,2626.2,330863,868956978.0,5081,2144,2763,348189215.0,495130575.0,132663,188046,2624.6,2633.0,320709,843319790.0,4907,2023-11-02 17:25:00
193,YNDX,1347,1488,209698154.0,271920726.0,79823,103201,2627.0,2634.9,183024,481618881.0,2835,1289,1446,204064645.0,271461739.0,77701,103020,2626.3,2635.0,180721,475526384.0,2735,2023-11-02 17:30:00
194,YNDX,6866,2994,945606816.0,601773140.0,359744,228546,2628.6,2633.1,588290,1547379956.0,9860,6816,2943,936373199.0,626495421.0,356260,224708,2628.3,2788.0,580968,1562868620.0,9759,2023-11-02 17:35:00
195,YNDX,1963,6881,289186805.0,1019474717.0,110188,387975,2624.5,2627.7,498163,1308661522.0,8844,1838,6781,286173369.0,990476656.0,109061,376667,2624.0,2629.6,485728,1276650026.0,8619,2023-11-02 17:40:00
196,YNDX,4382,9266,832083337.0,1973944748.0,319000,721156,2608.4,2737.2,1040156,2806028086.0,13648,3766,8240,741986153.0,1907578030.0,284521,686347,2607.8,2779.3,970868,2649564183.0,12006,2023-11-02 17:45:00
197,YNDX,3848,6021,677453992.0,1201497679.0,258956,459921,2616.1,2612.4,718877,1878951671.0,9869,3445,5613,649613772.0,1170179880.0,249160,447677,2607.2,2613.9,696837,1819793652.0,9058,2023-11-02 17:50:00
198,YNDX,2215,2330,440812614.0,318686097.0,168668,121848,2613.5,2615.4,290516,759498711.0,4545,2001,2143,398821006.0,309313676.0,152801,118118,2610.1,2618.7,270919,708134683.0,4144,2023-11-02 17:55:00
199,YNDX,1098,1147,156776790.0,169249046.0,59940,64630,2615.6,2618.7,124570,326025836.0,2245,964,1069,140700919.0,161560189.0,53888,61667,2611.0,2619.9,115555,302261108.0,2033,2023-11-02 18:00:00
200,YNDX,1285,1290,166390980.0,205278554.0,63394,78436,2624.7,2617.1,141830,371669534.0,2575,1123,1167,165474282.0,188222749.0,63350,71795,2612.1,2621.7,135145,353697031.0,2290,2023-11-02 18:05:00
201,YNDX,3475,5168,604153088.0,953951776.0,231726,366576,2607.2,2602.3,598302,1558104864.0,8643,3138,4988,553236957.0,912315757.0,212394,349197,2604.8,2612.6,561591,1465552714.0,8126,2023-11-02 18:10:00
202,YNDX,4970,3049,1445546977.0,473927608.0,537430,180883,2689.7,2620.1,718313,1919474586.0,8019,4811,2743,1392854783.0,437847962.0,532292,166894,2616.7,2623.5,699186,1830702745.0,7554,2023-11-02 18:15:00
203,YNDX,1705,2250,234287355.0,384620874.0,89488,146588,2618.1,2623.8,236076,618908229.0,3955,1620,2164,231501048.0,374543867.0,88488,142756,2616.2,2623.7,231244,606044916.0,3784,2023-11-02 18:20:00
204,YNDX,1008,1832,149368747.0,308091596.0,57121,117826,2615.0,2614.8,174947,457460344.0,2840,953,1756,141755436.0,289429039.0,54159,110332,2617.4,2623.3,164491,431184475.0,2709,2023-11-02 18:25:00
205,YNDX,3487,3193,1038282809.0,546507189.0,396899,208527,2616.0,2620.8,605426,1584789998.0,6680,3389,3062,1030366501.0,535075773.0,394082,204121,2614.6,2621.4,598203,1565442274.0,6451,2023-11-02 18:30:00
206,YNDX,1209,5214,169955025.0,2960702697.0,65077,1130822,2611.6,2618.2,1195899,3130657722.0,6423,876,5005,133241851.0,2916882906.0,51139,1113766,2605.5,2618.9,1164905,3050124758.0,5881,2023-11-02 18:35:00
207,YNDX,5421,10003,1072766018.0,2533038812.0,411349,970504,2607.9,2610.0,1381853,3605804830.0,15424,5178,9717,1037878450.0,2511594822.0,398325,961834,2605.6,2611.3,1360159,3549473273.0,14895,2023-11-02 18:40:00
208,YNDX,4194,3029,1062891577.0,697146172.0,405198,242713,2623.1,2872.3,647911,1760037750.0,7223,3342,2222,976335678.0,491136658.0,371852,186639,2625.6,2631.5,558491,1467472337.0,5564,2023-11-03 10:05:00
209,YNDX,2752,2199,568790406.0,407907144.0,216737,155103,2624.3,2629.9,371840,976697551.0,4951,2508,1981,530631877.0,382209985.0,202271,145257,2623.4,2631.3,347528,912841863.0,4489,2023-11-03 10:10:00
210,YNDX,2142,2534,307984308.0,461658898.0,117292,175430,2625.8,2631.6,292722,769643206.0,4676,2000,2414,303065308.0,451957511.0,115434,171764,2625.4,2631.3,287198,755022820.0,4414,2023-11-03 10:15:00
211,YNDX,812,605,111761875.0,78476076.0,42557,29696,2626.2,2642.6,72253,190237952.0,1417,694,494,96654054.0,67227457.0,36840,25514,2623.6,2634.9,62354,163881512.0,1188,2023-11-03 10:20:00
212,YNDX,1442,1437,273696601.0,200922562.0,104344,76336,2623.0,2632.1,180680,474619163.0,2879,1334,1343,255324577.0,196202704.0,97295,74513,2624.2,2633.1,171808,451527282.0,2677,2023-11-03 10:25:00
213,YNDX,2459,1585,563975629.0,280496217.0,214143,106166,2633.6,2642.1,320309,844471846.0,4044,2226,1397,559192674.0,252809815.0,212782,95855,2628.0,2637.4,308637,812002490.0,3623,2023-11-03 10:30:00
214,YNDX,12605,4408,2834326656.0,1025077419.0,1077204,388655,2631.2,2637.5,1465859,3859404076.0,17013,12214,4124,2805800566.0,1001590006.0,1066552,379659,2630.7,2638.1,1446211,3807390572.0,16338,2023-11-03 10:35:00
215,YNDX,3595,3573,778170619.0,1048514971.0,295890,397379,2629.9,2638.6,693269,1826685590.0,7168,3346,3487,767013977.0,1032281010.0,291698,391962,2629.5,2633.6,683660,1799294988.0,6833,2023-11-03 10:40:00
216,YNDX,1066,2522,188416011.0,932745281.0,71780,354733,2624.9,2629.4,426513,1121161292.0,3588,917,2430,177701349.0,924922002.0,67768,351693,2622.2,2629.9,419461,1102623352.0,3347,2023-11-03 10:45:00
217,YNDX,670,3647,146461361.0,1232354621.0,55893,468853,2620.4,2628.4,524746,1378815982.0,4317,573,3547,125216839.0,1210791489.0,47831,460545,2617.9,2629.0,508376,1336008328.0,4120,2023-11-03 10:50:00
218,YNDX,1960,17968,299837795.0,7101626415.0,114832,2708245,2611.1,2622.2,2823077,7401464211.0,19928,1681,17817,269473252.0,7073652133.0,103193,2696447,2611.4,2623.3,2799640,7343125386.0,19498,2023-11-03 10:55:00
219,YNDX,1101,3052,171404977.0,1070351202.0,65512,408626,2616.4,2619.4,474138,1241756179.0,4153,908,2969,159786091.0,1056137704.0,61201,403143,2610.8,2619.8,464344,1215923796.0,3877,2023-11-03 11:00:00
220,YNDX,2143,4967,499786515.0,1374314955.0,191019,524535,2616.4,2620.1,715554,1874101470.0,7110,1974,4774,482854443.0,1364262286.0,184956,520608,2610.6,2620.5,705564,1847116729.0,6748,2023-11-03 11:05:00
221,YNDX,689,830,187857544.0,232474377.0,71972,88598,2610.1,2623.9,160570,420331921.0,1519,602,741,191659565.0,226277991.0,73442,86212,2609.7,2624.7,159654,417937556.0,1343,2023-11-03 11:10:00
222,YNDX,604,2031,101813658.0,710252091.0,39195,271337,2597.6,2617.6,310532,812065750.0,2635,504,1961,83408570.0,708954122.0,31981,269916,2608.1,2626.6,301897,792362692.0,2465,2023-11-03 11:15:00
223,YNDX,1097,19317,318277487.0,9056952804.0,122461,3465034,2599.0,2613.8,3587495,9375230291.0,20414,811,19169,275761692.0,9027637387.0,105985,3452384,2601.9,2614.9,3558369,9303399079.0,19980,2023-11-03 11:20:00
224,YNDX,906,11747,163888707.0,5495495064.0,63034,2102111,2600.0,2614.3,2165145,5659383771.0,12653,719,11678,148636829.0,5489355098.0,57088,2099612,2603.6,2614.5,2156700,5637991928.0,12397,2023-11-03 11:25:00
225,YNDX,2548,14194,340767272.0,6172997836.0,130635,2360974,2608.5,2614.6,2491609,6513765108.0,16742,2441,14114,338264909.0,6167487693.0,129692,2358758,2608.2,2614.7,2488450,6505752602.0,16555,2023-11-03 11:30:00
226,YNDX,3147,13327,666002602.0,5124408484.0,256392,1963783,2597.6,2609.5,2220175,5790411087.0,16474,2818,12839,589980208.0,5091995460.0,226879,1950644,2600.4,2610.4,2177523,5681975669.0,15657,2023-11-03 11:35:00
227,YNDX,3968,5788,622767846.0,1849197553.0,239489,709219,2600.4,2607.4,948708,2471965399.0,9756,3654,5610,595289292.0,1815597800.0,229044,696041,2599.0,2608.5,925085,2410887093.0,9264,2023-11-03 11:40:00
228,YNDX,2185,2629,423258730.0,769347577.0,163237,294635,2592.9,2611.2,457872,1192606307.0,4814,1983,2513,409425603.0,763824217.0,158070,292499,2590.2,2611.4,450569,1173249821.0,4496,2023-11-03 11:45:00
229,YNDX,3563,11174,597108558.0,4092027712.0,229601,1572159,2600.6,2602.8,1801760,4689136271.0,14737,3126,10887,566743931.0,4043497715.0,218171,1551011,2597.7,2607.0,1769182,4610241646.0,14013,2023-11-03 11:50:00
230,YNDX,1916,6195,334206295.0,2190534557.0,128461,839597,2601.6,2609.0,968058,2524740853.0,8111,1765,6058,335189685.0,2179474699.0,128944,835308,2599.5,2609.2,964252,2514664384.0,7823,2023-11-03 11:55:00
231,YNDX,1671,7186,297922416.0,1808496982.0,104914,692893,2839.7,2610.1,797807,2106419398.0,8857,1514,7062,262972504.0,1794940396.0,101068,687693,2601.9,2610.1,788761,2057912901.0,8576,2023-11-03 12:00:00
232,YNDX,1601,1793,269588367.0,350125110.0,103520,134069,2604.2,2611.5,237589,619713477.0,3394,1456,1619,254621896.0,341661556.0,97828,130813,2602.8,2611.8,228641,596283453.0,3075,2023-11-03 12:05:00
233,YNDX,2557,3905,401808095.0,755882507.0,153935,289470,2610.2,2611.3,443405,1157690602.0,6462,2335,3740,393218795.0,741968419.0,150962,284097,2604.8,2611.7,435059,1135187215.0,6075,2023-11-03 12:10:00
234,YNDX,3105,5786,458774555.0,1845533191.0,176067,706830,2605.7,2611.0,882897,2304307746.0,8891,2982,5628,453621568.0,1838570107.0,174131,704078,2605.1,2611.3,878209,2292191675.0,8610,2023-11-03 12:15:00
235,YNDX,5182,14454,1132319917.0,4194911039.0,436475,1613131,2594.2,2600.5,2049606,5327230956.0,19636,4635,13753,1048220024.0,4093319626.0,404112,1573500,2593.9,2601.4,1977612,5141539651.0,18388,2023-11-03 12:20:00
236,YNDX,3324,9098,715279032.0,1810459308.0,275344,696001,2597.8,2601.2,971345,2525738341.0,12422,3080,8805,695223510.0,1760797438.0,267940,676927,2594.7,2601.2,944867,2456020948.0,11885,2023-11-03 12:25:00
237,YNDX,2661,2836,604905033.0,481499288.0,232952,184837,2596.7,2605.0,417789,1086404321.0,5497,2461,2709,589207831.0,477624805.0,226936,183347,2596.4,2605.0,410283,1066832637.0,5170,2023-11-03 12:30:00
238,YNDX,2569,1692,495045396.0,278365125.0,190628,106802,2596.9,2606.4,297430,773410521.0,4261,2416,1510,488653128.0,270919973.0,188177,103906,2596.8,2607.4,292083,759573101.0,3926,2023-11-03 12:35:00
239,YNDX,3245,2461,803006029.0,531690418.0,309112,204186,2597.8,2604.0,513298,1334696447.0,5706,2991,2245,781257638.0,516581525.0,300806,198168,2597.2,2606.8,498974,1297839164.0,5236,2023-11-03 12:40:00
240,YNDX,4612,2359,1533746069.0,419068100.0,589743,160670,2600.7,2608.3,750413,1952814170.0,6971,4500,2236,1517702468.0,400860386.0,583656,153673,2600.3,2608.5,737329,1918562854.0,6736,2023-11-03 12:45:00
241,YNDX,4245,2141,1154605038.0,342150272.0,443806,131213,2601.6,2607.6,575019,1496755310.0,6386,4155,2082,1143750414.0,321806272.0,439702,123400,2601.2,2607.8,563102,1465556686.0,6237,2023-11-03 12:50:00
242,YNDX,12637,5050,4029903712.0,742226367.0,1546689,284066,2605.5,2612.9,1830755,4772130079.0,17687,12509,4936,3979543172.0,735738607.0,1527750,281563,2604.8,2613.1,1809313,4715281779.0,17445,2023-11-03 12:55:00
243,YNDX,10976,2639,3256040789.0,390308930.0,1248578,149364,2607.8,2613.1,1397942,3646349720.0,13615,10867,2554,3249506057.0,372200804.0,1246110,142416,2607.7,2613.5,1388526,3621706861.0,13421,2023-11-03 13:00:00
244,YNDX,2837,978,1035235946.0,179709072.0,397062,68737,2607.2,2614.4,465799,1214945019.0,3815,2730,893,1031872498.0,173938536.0,395773,66501,2607.2,2615.6,462274,1205811034.0,3623,2023-11-03 13:05:00
245,YNDX,1574,1041,429967282.0,176177865.0,164987,67371,2606.1,2615.0,232358,606145147.0,2615,1500,958,420651012.0,170624593.0,161411,65242,2606.1,2615.3,226653,591275606.0,2458,2023-11-03 13:10:00
246,YNDX,3078,1419,1027974563.0,249906960.0,394768,95669,2604.0,2612.2,490437,1277881523.0,4497,2984,1289,994405401.0,218498306.0,381910,83620,2603.8,2613.0,465530,1212903707.0,4273,2023-11-03 13:15:00
247,YNDX,4420,1848,1113918173.0,363084973.0,427837,138973,2603.6,2612.6,566810,1477003146.0,6268,4327,1770,1110357528.0,379455727.0,426574,145181,2603.0,2613.7,571755,1489813255.0,6097,2023-11-03 13:20:00
248,YNDX,881,709,195556234.0,151354011.0,75269,58029,2598.1,2608.2,133298,346910246.0,1590,760,619,178455960.0,143064091.0,68686,54760,2598.1,2612.6,123446,321520052.0,1379,2023-11-03 13:25:00
249,YNDX,4252,12350,623113415.0,2472674402.0,239285,946524,2604.1,2612.4,1185809,3095787818.0,16602,4129,12285,620653655.0,2466566083.0,238399,944156,2603.4,2612.5,1182555,3087219738.0,16414,2023-11-03 13:30:00
250,YNDX,2187,2813,397452725.0,506762619.0,152896,194357,2599.5,2607.4,347253,904215345.0,5000,1881,2667,385203501.0,486661117.0,148215,186608,2599.0,2607.9,334823,871864618.0,4548,2023-11-03 13:35:00
251,YNDX,2655,2269,569809252.0,401182741.0,219057,153796,2601.2,2608.5,372853,970991994.0,4924,2366,2161,561926761.0,395873890.0,216075,151739,2600.6,2608.9,367814,957800652.0,4527,2023-11-03 13:40:00
252,YNDX,1811,668,268975682.0,160430198.0,103478,61497,2599.4,2608.7,164975,429405880.0,2479,1555,607,254324462.0,155235681.0,97862,59482,2598.8,2609.8,157344,409560143.0,2162,2023-11-03 13:45:00
253,YNDX,4878,2150,1695334440.0,403976938.0,651373,154776,2602.7,2610.1,806149,2099311378.0,7028,4629,2060,1685846994.0,400029572.0,647906,153219,2602.0,2610.8,801125,2085876566.0,6689,2023-11-03 13:50:00
254,YNDX,1656,1325,365487275.0,245412953.0,140738,94123,2596.9,2607.4,234861,610900229.0,2981,1410,1275,353864869.0,241825485.0,136224,92689,2597.7,2609.0,228913,595690355.0,2685,2023-11-03 13:55:00
255,YNDX,1440,1301,280139381.0,218822867.0,107796,83940,2598.8,2606.9,191736,498962248.0,2741,1179,1014,276081682.0,214724083.0,106231,82324,2598.9,2608.3,188555,490805765.0,2193,2023-11-03 14:00:00
256,YNDX,2042,827,574911982.0,163188159.0,220993,62662,2601.5,2604.3,283655,738100141.0,2869,1799,783,574975807.0,157645673.0,221044,60376,2601.2,2611.1,281420,732621481.0,2582,2023-11-03 14:05:00
257,YNDX,3832,1376,1067797134.0,337194543.0,410571,129356,2600.8,2606.7,539927,1404991677.0,5208,3548,1296,1058176188.0,302322080.0,406880,115882,2600.7,2608.9,522762,1360498268.0,4844,2023-11-03 14:10:00
258,YNDX,5586,4081,1186366618.0,867563115.0,457148,334129,2595.1,2596.5,791277,2053929734.0,9667,5245,3943,1167346430.0,808356835.0,449793,310562,2595.3,2602.9,760355,1975703265.0,9188,2023-11-03 14:15:00
259,YNDX,3212,1586,771823090.0,338141661.0,296940,129779,2599.3,2605.5,426719,1109964751.0,4798,2951,1511,763254360.0,374548518.0,293728,143727,2598.5,2606.0,437455,1137802878.0,4462,2023-11-03 14:20:00
260,YNDX,5755,3803,1234698552.0,556544311.0,474636,213533,2601.4,2606.4,688169,1791242863.0,9558,5526,3767,1231056786.0,555555228.0,473332,213106,2600.8,2606.9,686438,1786612014.0,9293,2023-11-03 14:25:00
261,YNDX,6142,3401,1907125466.0,796144422.0,732546,305011,2603.4,2610.2,1037557,2703269889.0,9543,5869,3311,1873577533.0,788806622.0,719732,302201,2603.2,2610.2,1021933,2662384156.0,9180,2023-11-03 14:30:00
262,YNDX,7520,1261,1803769353.0,349061258.0,692593,133539,2604.4,2613.9,826132,2152830611.0,8781,7311,1201,1796798166.0,347325642.0,689940,132858,2604.3,2614.3,822798,2144123808.0,8512,2023-11-03 14:35:00
263,YNDX,1527,715,246065718.0,157063791.0,94472,60069,2604.6,2614.7,154541,403129509.0,2242,1305,675,228914224.0,151354467.0,87909,57859,2604.0,2615.9,145768,380268691.0,1980,2023-11-03 14:40:00
264,YNDX,1044,806,152520094.0,179210873.0,58552,68539,2604.9,2614.7,127091,331730968.0,1850,792,616,146917870.0,161527142.0,56440,61753,2603.1,2615.7,118193,308445012.0,1408,2023-11-03 14:45:00
265,YNDX,928,911,144110144.0,222542692.0,55340,85153,2604.1,2613.4,140493,366652836.0,1839,682,868,133801387.0,221018757.0,51435,84533,2601.4,2614.6,135968,354820145.0,1550,2023-11-03 14:50:00
266,YNDX,4115,2239,668323192.0,383942896.0,256257,146827,2608.0,2614.9,403084,1052266089.0,6354,3915,2151,683630992.0,373911584.0,262178,142962,2607.5,2615.5,405140,1057542577.0,6066,2023-11-03 14:55:00
267,YNDX,12862,1769,4761212793.0,332813792.0,1823904,119995,2610.5,2773.6,1943899,5094026585.0,14631,12596,1677,4738070803.0,312124400.0,1815354,117445,2610.0,2657.6,1932799,5050195203.0,14273,2023-11-03 15:00:00
268,YNDX,10676,1371,4753389982.0,295743102.0,1820672,107775,2610.8,2744.1,1928447,5049133084.0,12047,10413,1274,4755030884.0,282492479.0,1821445,104311,2610.6,2708.2,1925756,5037523363.0,11687,2023-11-03 15:05:00
269,YNDX,3482,803,1297467488.0,158516161.0,496833,54368,2611.5,2915.6,551201,1455983649.0,4285,3231,723,1292951584.0,157640575.0,495178,53283,2611.1,2958.6,548461,1450592160.0,3954,2023-11-03 15:10:00
270,YNDX,4660,1801,1574664477.0,314788835.0,602995,118801,2611.4,2649.7,721796,1889453312.0,6461,4471,1733,1570874323.0,303313137.0,601621,114381,2611.1,2651.8,716002,1874187460.0,6204,2023-11-03 15:15:00
271,YNDX,5174,1451,1729198545.0,300719368.0,662176,113362,2611.4,2652.7,775538,2029917913.0,6625,4938,1378,1724825175.0,291696251.0,660535,109868,2611.3,2655.0,770403,2016521427.0,6316,2023-11-03 15:20:00
272,YNDX,3063,1081,867306410.0,184340937.0,332172,67816,2611.0,2718.3,399988,1051647347.0,4144,2839,1027,871614479.0,190498578.0,333941,69952,2610.1,2723.3,403893,1062113057.0,3866,2023-11-03 15:25:00
273,YNDX,1528,617,316054719.0,121732161.0,120962,41429,2612.8,2938.3,162391,437786880.0,2145,1276,581,307375851.0,124948273.0,117810,41430,2609.1,3015.9,159240,432324124.0,1857,2023-11-03 15:30:00
274,YNDX,951,811,342387252.0,129692893.0,131197,45030,2609.7,2880.1,176227,472080146.0,1762,871,753,341041812.0,121782168.0,130723,41994,2608.9,2900.0,172717,462823981.0,1624,2023-11-03 15:35:00
275,YNDX,2840,508,930707600.0,96283607.0,356465,33775,2610.9,2850.7,390240,1026991208.0,3348,2777,476,926003032.0,94621157.0,354706,33138,2610.6,2855.4,387844,1020624189.0,3253,2023-11-03 15:40:00
276,YNDX,1767,544,600444411.0,128201463.0,230107,46015,2609.4,2786.1,276122,728645874.0,2311,1692,504,597065982.0,123337480.0,228825,44090,2609.3,2797.4,272915,720403462.0,2196,2023-11-03 15:45:00
277,YNDX,778,6319,358570603.0,1382186986.0,137562,512465,2606.6,2697.1,650027,1740757589.0,7097,703,6275,355958782.0,1342221075.0,136578,511646,2606.3,2623.3,648224,1698179858.0,6978,2023-11-03 15:50:00
278,YNDX,2194,1158,813049912.0,240881213.0,311551,85439,2609.7,2819.3,396990,1053931126.0,3352,2109,1120,806859123.0,241167489.0,309206,84659,2609.5,2848.7,393865,1048026613.0,3229,2023-11-03 15:55:00
279,YNDX,4455,537,1620084795.0,79641029.0,620582,25166,2610.6,3164.6,645748,1699725824.0,4992,4440,518,1620499056.0,79506907.0,620774,25127,2610.4,3164.2,645901,1700005964.0,4958,2023-11-03 16:00:00
280,YNDX,1532,906,550333723.0,138643931.0,210954,49447,2608.8,2803.9,260401,688977655.0,2438,1435,873,557889802.0,135627871.0,213877,48251,2608.5,2810.9,262128,693517674.0,2308,2023-11-03 16:05:00
281,YNDX,1043,851,369764992.0,140284073.0,141794,52110,2607.8,2692.1,193904,510049065.0,1894,957,804,363073253.0,138765444.0,139248,51208,2607.4,2709.8,190456,501838697.0,1761,2023-11-03 16:10:00
282,YNDX,1836,10651,465474995.0,1531778400.0,178401,581214,2609.2,2635.5,759615,1997253395.0,12487,1814,10628,463074692.0,1530055724.0,177518,580540,2608.6,2635.6,758058,1993130417.0,12442,2023-11-03 16:15:00
283,YNDX,13813,6310,3593514832.0,792119006.0,1375298,299880,2612.9,2641.5,1675178,4385633839.0,20123,13806,6287,3591526541.0,789094888.0,1374551,298572,2612.9,2642.9,1673123,4380621430.0,20093,2023-11-03 16:20:00
284,YNDX,2356,802,768555128.0,136612896.0,294421,50838,2610.4,2687.2,345259,905168025.0,3158,2302,761,765908355.0,128533481.0,293408,47772,2610.4,2690.6,341180,894441837.0,3063,2023-11-03 16:25:00
285,YNDX,1269,3214,394633920.0,754698506.0,151326,288631,2607.8,2614.8,439957,1149332426.0,4483,1222,3181,393155449.0,752067895.0,150769,287567,2607.7,2615.3,438336,1145223345.0,4403,2023-11-03 16:30:00
286,YNDX,10535,4757,2215198599.0,841998599.0,848885,320721,2609.5,2625.3,1169606,3057197199.0,15292,10473,4725,2214308451.0,836489455.0,848547,318591,2609.5,2625.6,1167138,3050797906.0,15198,2023-11-03 16:35:00
287,YNDX,739,1489,302082857.0,276414367.0,115911,101823,2606.2,2714.7,217734,578497224.0,2228,688,1457,300988754.0,274399934.0,115508,101015,2605.8,2716.4,216523,575388688.0,2145,2023-11-03 16:40:00
288,YNDX,1236,2255,394569054.0,368322754.0,151385,140861,2606.4,2614.8,292246,762891808.0,3491,1185,2229,390432810.0,354213598.0,149824,135431,2605.9,2615.5,285255,744646409.0,3414,2023-11-03 16:45:00
289,YNDX,1275,857,420236551.0,130283659.0,161138,49758,2607.9,2618.3,210896,550520211.0,2132,1184,814,433278204.0,128940929.0,166313,49220,2605.2,2619.7,215533,562219133.0,1998,2023-11-03 16:50:00
290,YNDX,1441,988,425417751.0,175145259.0,163160,66912,2607.4,2617.5,230072,600563011.0,2429,1372,937,421388899.0,168006746.0,161677,64153,2606.4,2618.8,225830,589395646.0,2309,2023-11-03 16:55:00
291,YNDX,442,279,277781570.0,50943073.0,106583,19447,2606.2,2619.6,126030,328724643.0,721,359,245,275734181.0,50870601.0,105818,19409,2605.7,2621.0,125227,326604782.0,604,2023-11-03 17:00:00
292,YNDX,1303,748,415262047.0,133347195.0,159238,51020,2607.8,2613.6,210258,548609243.0,2051,1250,717,411327608.0,130475187.0,157778,49824,2607.0,2618.7,207602,541802795.0,1967,2023-11-03 17:05:00
293,YNDX,1136,498,408843955.0,89316052.0,156809,34128,2607.3,2617.1,190937,498160007.0,1634,1090,474,405102178.0,87317035.0,155384,33337,2607.1,2619.2,188721,492419214.0,1564,2023-11-03 17:10:00
294,YNDX,689,712,325852283.0,148916761.0,124964,56916,2607.6,2616.4,181880,474769044.0,1401,609,663,321711777.0,138160119.0,123482,52790,2605.3,2617.2,176272,459871896.0,1272,2023-11-03 17:15:00
295,YNDX,335,301,255038346.0,35442205.0,97894,13532,2605.3,2619.1,111426,290480552.0,636,315,288,252644728.0,32228781.0,97004,12295,2604.5,2621.3,109299,284873510.0,603,2023-11-03 17:20:00
296,YNDX,5384,10470,1065320607.0,1516654515.0,408876,581000,2605.5,2610.4,989876,2581975123.0,15854,5258,10413,1054982931.0,1504296445.0,404955,576237,2605.2,2610.6,981192,2559279376.0,15671,2023-11-03 17:25:00
297,YNDX,2615,1162,508869222.0,186930474.0,195244,71534,2606.3,2613.2,266778,695799697.0,3777,2546,1123,504952734.0,187384785.0,193760,71698,2606.1,2613.5,265458,692337519.0,3669,2023-11-03 17:30:00
298,YNDX,808,508,280987702.0,43648567.0,107837,16694,2605.7,2614.6,124531,324636269.0,1316,729,467,279596066.0,44290652.0,107328,16919,2605.1,2617.8,124247,323886719.0,1196,2023-11-03 17:35:00
299,YNDX,1280,711,363040569.0,112475529.0,139283,43015,2606.5,2614.8,182298,475516099.0,1991,1229,670,359763414.0,116085328.0,138090,44145,2605.3,2629.6,182235,475848742.0,1899,2023-11-03 17:40:00
300,YNDX,975,612,326415398.0,98561497.0,125285,37603,2605.4,2621.1,162888,424976895.0,1587,911,573,324051376.0,93105677.0,124387,35605,2605.2,2615.0,159992,417157053.0,1484,2023-11-03 17:45:00
301,YNDX,1965,1658,438038365.0,221594705.0,168002,84793,2607.3,2613.4,252795,659633070.0,3623,1916,1609,436112836.0,213275957.0,167358,81612,2605.9,2613.3,248970,649388793.0,3525,2023-11-03 17:50:00
302,YNDX,2271,2019,511228109.0,277973454.0,196189,106311,2605.8,2614.7,302500,789201563.0,4290,2191,1958,506837884.0,275093698.0,194535,105200,2605.4,2615.0,299735,781931582.0,4149,2023-11-03 17:55:00
303,YNDX,972,405,329997106.0,65253115.0,126638,24936,2605.8,2616.8,151574,395250221.0,1377,881,375,328307427.0,89193673.0,126011,33922,2605.4,2629.4,159933,417501100.0,1256,2023-11-03 18:00:00
304,YNDX,2181,943,513924352.0,168624224.0,196925,64479,2609.7,2615.2,261404,682548576.0,3124,2057,896,504568849.0,164996555.0,193588,63035,2606.4,2617.5,256623,669565404.0,2953,2023-11-03 18:05:00
305,YNDX,713,499,273386752.0,110984312.0,104857,42246,2607.2,2627.1,147103,384371064.0,1212,614,447,263129897.0,53601089.0,100971,20449,2606.0,2621.2,121420,316730986.0,1061,2023-11-03 18:10:00
306,YNDX,1968,831,399662155.0,109128087.0,153166,41718,2609.3,2615.9,194884,508790242.0,2799,1705,784,395168353.0,104507945.0,151474,39927,2608.8,2617.5,191401,499676299.0,2489,2023-11-03 18:15:00
307,YNDX,1644,399,358264796.0,57085832.0,137287,21795,2609.6,2619.2,159082,415350628.0,2043,1407,361,347961966.0,101002297.0,133393,38366,2608.5,2632.6,171759,448964264.0,1768,2023-11-03 18:20:00
308,YNDX,3470,2814,587409356.0,631591605.0,224962,241848,2611.1,2611.5,466810,1219000961.0,6284,3225,2760,580892809.0,626310077.0,222561,239407,2610.0,2616.1,461968,1207202886.0,5985,2023-11-03 18:25:00
309,YNDX,5303,15748,814990925.0,3363281672.0,312800,1287668,2605.5,2611.9,1600468,4178272597.0,21051,4925,15638,799863370.0,3333790298.0,307109,1276245,2604.5,2612.2,1583354,4133653668.0,20563,2023-11-03 18:30:00
310,YNDX,2504,2374,196323919.0,753210336.0,75233,288164,2609.5,2613.8,363397,949534256.0,4878,2214,2307,189131922.0,747686394.0,72548,285995,2607.0,2614.3,358543,936818316.0,4521,2023-11-03 18:35:00
311,YNDX,5209,5596,1059025253.0,1310598430.0,406650,501523,2604.3,2613.2,908173,2369623684.0,10805,4849,5475,1043640314.0,1266394241.0,400886,484552,2603.3,2613.5,885438,2310034555.0,10324,2023-11-03 18:40:00
312,YNDX,5490,8593,1438409774.0,3509995039.0,550163,1316222,2614.5,2666.7,1866385,4948404814.0,14083,4746,7817,1389188380.0,3355395248.0,531889,1279340,2611.8,2622.8,1811229,4744583628.0,12563,2023-11-06 10:05:00
313,YNDX,3428,4853,444802992.0,989034426.0,169983,377386,2616.7,2620.8,547369,1433837418.0,8281,3295,4690,437083221.0,977695778.0,167162,373049,2614.7,2620.8,540211,1414778999.0,7985,2023-11-06 10:10:00
314,YNDX,2069,1909,271725577.0,344216967.0,103825,131273,2617.1,2622.1,235098,615942545.0,3978,1912,1760,259025167.0,337281496.0,99042,128630,2615.3,2622.1,227672,596306664.0,3672,2023-11-06 10:15:00
315,YNDX,2053,1372,266139432.0,223410257.0,101654,85199,2618.1,2622.2,186853,489549689.0,3425,1758,1231,241755175.0,205335522.0,92446,78301,2615.1,2622.4,170747,447090698.0,2989,2023-11-06 10:20:00
316,YNDX,2640,2042,438432996.0,462297999.0,167601,176259,2615.9,2622.8,343860,900730995.0,4682,2509,1907,431339260.0,451858806.0,164950,172247,2615.0,2623.3,337197,883198066.0,4416,2023-11-06 10:25:00
317,YNDX,4000,1398,686672762.0,320135064.0,262156,121856,2619.3,2627.2,384012,1006807827.0,5398,3830,1256,661087555.0,308411652.0,252430,117400,2618.9,2627.0,369830,969499207.0,5086,2023-11-06 10:30:00
318,YNDX,1619,1712,375422629.0,357002810.0,143261,135672,2620.6,2631.4,278933,732425440.0,3331,1494,1497,363637440.0,338860952.0,138805,128808,2619.8,2630.7,267613,702498393.0,2991,2023-11-06 10:35:00
319,YNDX,1096,835,215058944.0,170782927.0,82059,64922,2620.8,2630.6,146981,385841872.0,1931,985,773,208481240.0,165758086.0,79591,63012,2619.4,2630.6,142603,374239326.0,1758,2023-11-06 10:40:00
320,YNDX,2712,3242,867169925.0,1259893548.0,330411,479976,2624.5,2624.9,810387,2127063474.0,5954,2575,3109,848827885.0,1241169845.0,323527,472383,2623.7,2627.5,795910,2089997730.0,5684,2023-11-06 10:45:00
321,YNDX,962,3679,190669439.0,1310185185.0,72794,498629,2619.3,2627.6,571423,1500854624.0,4641,894,3578,183989166.0,1301930484.0,70253,495485,2619.0,2627.6,565738,1485919651.0,4472,2023-11-06 10:50:00
322,YNDX,1183,2718,186745826.0,519495205.0,71229,197802,2621.8,2626.3,269031,706241031.0,3901,1125,2665,181792923.0,516517885.0,69363,196661,2620.9,2626.4,266024,698310808.0,3790,2023-11-06 10:55:00
323,YNDX,1434,3439,224258905.0,1018964653.0,85623,388103,2619.1,2625.5,473726,1243223558.0,4873,1372,3364,219017600.0,1010707061.0,83605,384975,2619.7,2625.4,468580,1229724661.0,4736,2023-11-06 11:00:00
324,YNDX,1537,3845,246871661.0,946321237.0,94236,360390,2619.7,2625.8,454626,1193192899.0,5382,1451,3770,241380422.0,945509825.0,92161,360043,2619.1,2626.1,452204,1186890247.0,5221,2023-11-06 11:05:00
325,YNDX,2844,2413,578875284.0,558550348.0,219748,212588,2634.3,2627.4,432336,1137425632.0,5257,2775,2333,555585636.0,551957105.0,211899,210037,2621.9,2627.9,421936,1107542741.0,5108,2023-11-06 11:10:00
326,YNDX,11619,1593,4614842480.0,325245234.0,1755958,123346,2628.1,2636.9,1879304,4940087715.0,13212,11465,1433,4594171384.0,282555739.0,1748671,107159,2627.2,2636.8,1855830,4876727124.0,12898,2023-11-06 11:15:00
327,YNDX,5996,677,2643768214.0,94815238.0,1006525,35988,2626.6,2634.6,1042513,2738583452.0,6673,5930,597,2639067479.0,89752386.0,1004740,34049,2626.6,2636.0,1038789,2728819866.0,6527,2023-11-06 11:20:00
328,YNDX,2726,366,988047874.0,81935985.0,376345,31140,2625.4,2631.2,407485,1069983859.0,3092,2639,297,985300555.0,79241379.0,375313,30078,2625.3,2634.5,405391,1064541934.0,2936,2023-11-06 11:25:00
329,YNDX,2876,1575,772767074.0,278368878.0,293852,105634,2629.8,2635.2,399486,1051135952.0,4451,2657,1495,761108705.0,268205635.0,289584,101765,2628.3,2635.5,391349,1029314340.0,4152,2023-11-06 11:30:00
330,YNDX,6746,3619,1975625629.0,552914102.0,750883,209641,2631.1,2637.4,960524,2528539731.0,10365,6583,3504,1962497540.0,540387684.0,746094,204894,2630.4,2637.4,950988,2502885224.0,10087,2023-11-06 11:35:00
331,YNDX,1708,1047,411264120.0,211507618.0,156379,80281,2629.9,2634.6,236660,622771739.0,2755,1617,929,398224835.0,200787831.0,151458,76120,2629.3,2637.8,227578,599012667.0,2546,2023-11-06 11:40:00
332,YNDX,2431,1037,448416007.0,205199947.0,170513,77889,2629.8,2634.5,248402,653615954.0,3468,2344,970,442117273.0,194558435.0,168304,73817,2626.9,2635.7,242121,636675708.0,3314,2023-11-06 11:45:00
333,YNDX,893,612,162135607.0,139340773.0,61675,52840,2628.9,2637.0,114515,301476381.0,1505,799,540,157835162.0,136070063.0,60051,51587,2628.4,2637.7,111638,293905225.0,1339,2023-11-06 11:50:00
334,YNDX,812,859,146440321.0,168836666.0,55729,64131,2627.7,2632.7,119860,315276987.0,1671,741,813,142958226.0,166543664.0,54428,63193,2626.6,2635.5,117621,309501890.0,1554,2023-11-06 11:55:00
335,YNDX,816,1184,140131392.0,192973125.0,53321,73313,2628.1,2632.2,126634,333104517.0,2000,656,1062,134313568.0,188264604.0,51128,71449,2627.0,2635.0,122577,322578173.0,1718,2023-11-06 12:00:00
336,YNDX,9178,2072,1414893972.0,341707106.0,537923,129687,2630.3,2634.9,667610,1756601079.0,11250,9102,2011,1410098999.0,337698524.0,536144,128067,2630.1,2636.9,664211,1747797523.0,11113,2023-11-06 12:05:00
337,YNDX,685,1455,116266092.0,211281848.0,44231,80195,2628.6,2634.6,124426,327547940.0,2140,600,1409,114204499.0,209899621.0,43449,79656,2628.5,2635.1,123105,324104121.0,2009,2023-11-06 12:10:00
338,YNDX,714,2677,127685747.0,513727796.0,48631,194937,2625.6,2635.4,243568,641413543.0,3391,632,2617,126439523.0,502670712.0,48166,190901,2625.1,2633.1,239067,629110236.0,3249,2023-11-06 12:15:00
339,YNDX,484,1810,84016143.0,370872902.0,31994,140781,2626.0,2634.4,172775,454889045.0,2294,468,1772,82797751.0,365903467.0,31541,138948,2625.1,2633.4,170489,448701218.0,2240,2023-11-06 12:20:00
340,YNDX,736,1018,157076696.0,166134581.0,59828,63050,2625.5,2635.0,122878,323211278.0,1754,634,946,150412268.0,162895949.0,57226,61810,2628.4,2635.4,119036,313308218.0,1580,2023-11-06 12:25:00
341,YNDX,1070,393,140243313.0,99502404.0,53330,37713,2629.7,2638.4,91043,239745717.0,1463,986,336,133765989.0,96471315.0,50882,36559,2628.9,2638.8,87441,230237304.0,1322,2023-11-06 12:30:00
342,YNDX,1030,537,286422683.0,143998011.0,108827,54567,2631.9,2638.9,163394,430420695.0,1567,905,469,269816753.0,135313950.0,102585,51264,2630.2,2639.6,153849,405130703.0,1374,2023-11-06 12:35:00
343,YNDX,1332,283,377343390.0,96654876.0,143372,36580,2631.9,2642.3,179952,473998266.0,1615,1269,226,374552275.0,66586945.0,142354,25214,2631.1,2640.9,167568,441139221.0,1495,2023-11-06 12:40:00
344,YNDX,590,401,116827476.0,101776499.0,44452,38632,2628.2,2634.5,83084,218603976.0,991,523,354,117374722.0,94416873.0,44661,35769,2628.1,2639.6,80430,211791595.0,877,2023-11-06 12:45:00
345,YNDX,1343,506,202501195.0,103656777.0,77018,39085,2629.3,2652.1,116103,306157972.0,1849,1282,460,199686122.0,94575111.0,75990,35859,2627.8,2637.4,111849,294261233.0,1742,2023-11-06 12:50:00
346,YNDX,1494,6303,254836907.0,1081435896.0,96874,410347,2630.6,2635.4,507221,1336272803.0,7797,1419,6265,254995842.0,1080297493.0,96947,409905,2630.3,2635.5,506852,1335293336.0,7684,2023-11-06 12:55:00
347,YNDX,1043,3024,159132740.0,532844573.0,60483,202095,2631.0,2636.6,262578,691977313.0,4067,990,2989,157272542.0,531843764.0,59781,201712,2630.8,2636.6,261493,689116307.0,3979,2023-11-06 13:00:00
348,YNDX,406,318,83184692.0,78356300.0,31647,29800,2628.5,2629.4,61447,161540993.0,724,369,269,79983540.0,75229608.0,30440,28508,2627.6,2638.9,58948,155213148.0,638,2023-11-06 13:05:00
349,YNDX,523,593,119173021.0,119916540.0,45359,45543,2627.3,2633.0,90902,239089561.0,1116,445,553,115796665.0,116168743.0,44080,44049,2627.0,2637.3,88129,231965408.0,998,2023-11-06 13:10:00
350,YNDX,1205,898,209361981.0,174200853.0,79611,66098,2629.8,2635.5,145709,383562834.0,2103,1076,851,201038747.0,169168829.0,76503,64190,2627.9,2635.4,140693,370207576.0,1927,2023-11-06 13:15:00
351,YNDX,8629,1710,1358661736.0,293118653.0,516110,111131,2632.5,2637.6,627241,1651780389.0,10339,8582,1661,1350615552.0,284674661.0,513117,107917,2632.2,2637.9,621034,1635290213.0,10243,2023-11-06 13:20:00
352,YNDX,1035,1361,194057863.0,195802096.0,73780,74282,2630.2,2635.9,148062,389859959.0,2396,960,1308,190920114.0,191506070.0,72596,72627,2629.9,2636.8,145223,382426184.0,2268,2023-11-06 13:25:00
353,YNDX,895,3110,164156225.0,502410075.0,62425,188748,2629.7,2661.8,251173,666566301.0,4005,822,3075,161113447.0,493326109.0,61291,187303,2628.7,2633.8,248594,654439556.0,3897,2023-11-06 13:30:00
354,YNDX,2087,5440,515503731.0,696335374.0,195883,264224,2631.7,2635.4,460107,1211839105.0,7527,2028,5367,513452153.0,692145840.0,195129,262660,2631.3,2635.1,457789,1205597994.0,7395,2023-11-06 13:35:00
355,YNDX,2889,1700,587096424.0,243879992.0,223108,92534,2631.4,2635.6,315642,830976416.0,4589,2822,1660,582033176.0,240025654.0,221220,91058,2631.0,2636.0,312278,822058830.0,4482,2023-11-06 13:40:00
356,YNDX,1118,3371,171463005.0,458436103.0,65148,173963,2631.9,2635.3,239111,629899109.0,4489,1071,3337,169552649.0,456590569.0,64473,173251,2629.8,2635.4,237724,626143219.0,4408,2023-11-06 13:45:00
357,YNDX,664,981,98822194.0,165194559.0,37577,62666,2629.9,2636.1,100243,264016753.0,1645,592,951,97399841.0,169142270.0,37047,62150,2629.1,2721.5,99197,266542111.0,1543,2023-11-06 13:50:00
358,YNDX,9225,507,1403142224.0,57861944.0,533054,21919,2632.3,2639.8,554973,1461004168.0,9732,9180,478,1403708407.0,57425795.0,533288,21764,2632.2,2638.6,555052,1461134203.0,9658,2023-11-06 13:55:00
359,YNDX,794,361,93052770.0,62547943.0,35343,23761,2632.8,2632.4,59104,155600714.0,1155,747,335,93226093.0,61582247.0,35438,23351,2630.7,2637.2,58789,154808340.0,1082,2023-11-06 14:00:00
360,YNDX,308,184,56798824.0,33084879.0,21595,12613,2630.2,2623.1,34208,89883704.0,492,259,134,52710580.0,30236121.0,20073,11444,2625.9,2642.1,31517,82946702.0,393,2023-11-06 14:05:00
361,YNDX,570,527,117365479.0,97250752.0,44615,36850,2630.6,2639.1,81465,214616231.0,1097,438,409,104652423.0,90889461.0,39800,34427,2629.5,2640.1,74227,195541885.0,847,2023-11-06 14:10:00
362,YNDX,522,722,71432945.0,115821368.0,27169,43938,2629.2,2636.0,71107,187254313.0,1244,469,675,73339324.0,115756926.0,27893,43895,2629.3,2637.1,71788,189096250.0,1144,2023-11-06 14:15:00
363,YNDX,509,675,70887816.0,86835114.0,26954,32944,2630.0,2635.8,59898,157722930.0,1184,447,648,69391228.0,85794411.0,26401,32535,2628.4,2637.0,58936,155185640.0,1095,2023-11-06 14:20:00
364,YNDX,504,368,80565865.0,84916248.0,30599,32172,2633.0,2639.4,62771,165482113.0,872,437,312,78615039.0,78717205.0,29903,29817,2629.0,2640.0,59720,157332244.0,749,2023-11-06 14:25:00
365,YNDX,570,383,100757297.0,91628300.0,38327,34738,2628.9,2637.7,73065,192385597.0,953,533,341,99966002.0,86507915.0,38036,32785,2628.2,2638.6,70821,186473917.0,874,2023-11-06 14:30:00
366,YNDX,3717,523,516201984.0,103314694.0,196174,39215,2631.3,2634.6,235389,619516678.0,4240,3664,492,510272945.0,105877151.0,193910,40142,2631.5,2637.6,234052,616150096.0,4156,2023-11-06 14:35:00
367,YNDX,1007,634,205475706.0,162319564.0,78099,61696,2631.0,2631.0,139795,367795271.0,1641,860,575,196352849.0,144236664.0,74715,54728,2628.0,2635.5,129443,340589514.0,1435,2023-11-06 14:40:00
368,YNDX,873,789,111231982.0,186663497.0,42379,70912,2624.7,2632.3,113291,297895479.0,1662,718,720,102255045.0,180694742.0,38974,68644,2623.7,2632.3,107618,282949788.0,1438,2023-11-06 14:45:00
369,YNDX,953,762,212244739.0,226154879.0,80999,86145,2620.3,2625.3,167144,438399618.0,1715,757,650,200185122.0,189468149.0,76410,72031,2619.9,2630.4,148441,389653271.0,1407,2023-11-06 14:50:00
370,YNDX,495,232,86101915.0,63120949.0,32799,24074,2625.1,2622.0,56873,149222865.0,727,416,181,77856936.0,60252177.0,29723,22907,2619.4,2630.3,52630,138109113.0,597,2023-11-06 14:55:00
371,YNDX,451,170,76669565.0,48330690.0,29190,18372,2626.6,2630.7,47562,125000256.0,621,329,147,66259145.0,45604847.0,25290,17328,2620.0,2631.9,42618,111863992.0,476,2023-11-06 15:00:00
372,YNDX,2333,1237,357859772.0,271845843.0,136183,103433,2627.8,2628.2,239616,629705615.0,3570,2124,1142,343279280.0,268477453.0,130804,102107,2624.4,2629.4,232911,611756734.0,3266,2023-11-06 15:05:00
373,YNDX,510,477,100972313.0,107758362.0,38461,40962,2625.3,2630.7,79423,208730675.0,987,453,442,89396603.0,107470751.0,34121,40844,2620.0,2631.2,74965,196867355.0,895,2023-11-06 15:10:00
374,YNDX,501,395,99213257.0,88697670.0,37728,33665,2629.7,2634.7,71393,187910928.0,896,449,347,95822744.0,82215231.0,36507,31201,2624.8,2635.0,67708,178037976.0,796,2023-11-06 15:15:00
375,YNDX,960,658,194385001.0,207596711.0,74175,69558,2620.6,2984.5,143733,401981713.0,1618,812,597,185388125.0,171718573.0,70695,65273,2622.4,2630.8,135968,357106699.0,1409,2023-11-06 15:20:00
376,YNDX,728,583,104863021.0,144803469.0,39955,55107,2624.5,2627.7,95062,249666490.0,1311,472,550,82960256.0,143589922.0,31641,54617,2621.9,2629.0,86258,226550179.0,1022,2023-11-06 15:25:00
377,YNDX,588,765,99402727.0,204430544.0,37893,76087,2623.2,2686.8,113980,303833272.0,1353,571,722,100321945.0,220569143.0,38275,74500,2621.1,2960.7,112775,320891089.0,1293,2023-11-06 15:30:00
378,YNDX,885,1304,180989134.0,262959612.0,69322,100167,2610.8,2625.2,169489,443948747.0,2189,818,1202,176724849.0,259899863.0,67534,98966,2616.8,2626.2,166500,436624713.0,2020,2023-11-06 15:35:00
379,YNDX,734,2055,121755854.0,313657437.0,46429,119511,2622.4,2624.5,165940,435413291.0,2789,670,2014,115961245.0,310972481.0,44339,118518,2615.3,2623.8,162857,426933726.0,2684,2023-11-06 15:40:00
380,YNDX,984,273,131971779.0,58432224.0,50346,22240,2621.3,2627.3,72586,190404003.0,1257,906,259,130018475.0,57998881.0,49605,22073,2621.1,2627.6,71678,188017357.0,1165,2023-11-06 15:45:00
381,YNDX,2331,849,315434608.0,117971593.0,120090,44865,2626.7,2629.5,164955,433406202.0,3180,2324,837,309236632.0,117304061.0,117906,44614,2622.7,2629.3,162520,426540694.0,3161,2023-11-06 15:50:00
382,YNDX,363,187,51606756.0,40784216.0,19702,15505,2619.4,2630.4,35207,92390972.0,550,338,167,50429265.0,37671682.0,19250,14316,2619.7,2631.4,33566,88100947.0,505,2023-11-06 15:55:00
383,YNDX,271,248,53204117.0,53800045.0,20297,20470,2621.3,2628.2,40767,107004162.0,519,245,200,50638278.0,51431925.0,19346,19543,2617.5,2631.7,38889,102070204.0,445,2023-11-06 16:00:00
384,YNDX,837,587,166428605.0,137885876.0,63529,52439,2619.7,2629.5,115968,304314481.0,1424,768,545,164290715.0,137250706.0,62725,52200,2619.2,2629.3,114925,301541422.0,1313,2023-11-06 16:05:00
385,YNDX,3235,1079,784206849.0,213453612.0,297502,81068,2636.0,2633.0,378570,997660461.0,4314,3156,994,756641521.0,203346885.0,288162,77183,2625.8,2634.6,365345,959988406.0,4150,2023-11-06 16:10:00
386,YNDX,2603,468,533996755.0,87432545.0,203266,33183,2627.1,2634.9,236449,621429301.0,3071,2556,424,532143567.0,82731341.0,202581,31397,2626.8,2635.0,233978,614874909.0,2980,2023-11-06 16:15:00
387,YNDX,4412,1209,876706510.0,184896328.0,333271,70171,2630.6,2634.9,403442,1061602838.0,5621,4357,1138,860342771.0,182126954.0,327308,69114,2628.5,2635.2,396422,1042469725.0,5495,2023-11-06 16:20:00
388,YNDX,6386,908,1416480923.0,125934151.0,538650,47801,2629.7,2634.6,586451,1542415075.0,7294,6338,875,1415124852.0,125284238.0,538159,47542,2629.6,2635.2,585701,1540409090.0,7213,2023-11-06 16:25:00
389,YNDX,2384,1919,391824655.0,275190616.0,148916,99554,2631.2,2764.2,248470,667015271.0,4303,2349,1877,386758164.0,259414746.0,147032,98447,2630.4,2635.1,245479,646172911.0,4226,2023-11-06 16:30:00
390,YNDX,1198,394,347479807.0,98392886.0,132290,32467,2626.7,3030.6,164757,445872693.0,1592,1161,365,346486126.0,94407952.0,131916,30932,2626.6,3052.1,162848,440894078.0,1526,2023-11-06 16:35:00
391,YNDX,286,168,57430396.0,36963237.0,21874,14041,2625.5,2632.5,35915,94393633.0,454,199,131,49061751.0,34390351.0,18696,13055,2624.2,2634.3,31751,83452102.0,330,2023-11-06 16:40:00
392,YNDX,409,202,56363443.0,52434943.0,21472,18247,2625.0,2873.6,39719,108798386.0,611,362,188,55209918.0,61137850.0,21061,18331,2621.4,3335.2,39392,116347769.0,550,2023-11-06 16:45:00
393,YNDX,810,131,112716776.0,33303965.0,42888,11346,2628.2,2935.3,54234,146020741.0,941,766,109,110628174.0,34151633.0,42101,11299,2627.7,3022.5,53400,144779808.0,875,2023-11-06 16:50:00
394,YNDX,647,219,95019401.0,37827995.0,36164,14364,2627.5,2633.5,50528,132847396.0,866,607,206,93570410.0,36996636.0,35612,14039,2627.5,2635.3,49651,130567046.0,813,2023-11-06 16:55:00
395,YNDX,412,133,65467880.0,31579642.0,24891,11436,2630.2,2761.4,36327,97047523.0,545,390,121,64067495.0,33555434.0,24383,11431,2627.5,2935.5,35814,97622929.0,511,2023-11-06 17:00:00
396,YNDX,537,184,87558815.0,31474787.0,33307,11496,2628.8,2737.9,44803,119033602.0,721,510,170,88343664.0,34077298.0,33619,12376,2627.8,2753.5,45995,122420962.0,680,2023-11-06 17:05:00
397,YNDX,301,117,46604874.0,27536372.0,17729,10415,2628.7,2643.9,28144,74141246.0,418,269,99,47110265.0,30410014.0,17929,11083,2627.6,2743.8,29012,77520280.0,368,2023-11-06 17:10:00
398,YNDX,1288,305,357682786.0,49643659.0,135967,18844,2630.7,2634.5,154811,407326445.0,1593,1268,288,355981916.0,48481685.0,135359,18394,2629.9,2635.7,153753,404463601.0,1556,2023-11-06 17:15:00
399,YNDX,5164,361,824521998.0,67811753.0,313553,25730,2629.6,2635.5,339283,892333752.0,5525,5127,341,821013882.0,65314459.0,312271,24777,2629.2,2636.1,337048,886328342.0,5468,2023-11-06 17:20:00
400,YNDX,1898,1531,315554766.0,189607563.0,120001,71992,2629.6,2633.7,191993,505162330.0,3429,1846,1507,315440214.0,189346975.0,119981,71892,2629.1,2633.8,191873,504787190.0,3353,2023-11-06 17:25:00
401,YNDX,373,141,39057666.0,12188839.0,14845,4633,2631.0,2630.9,19478,51246505.0,514,339,114,37932009.0,11186195.0,14422,4245,2630.1,2635.1,18667,49118204.0,453,2023-11-06 17:30:00
402,YNDX,218,109,11793169.0,10628902.0,4486,4043,2628.9,2629.0,8529,22422071.0,327,155,83,11305401.0,8453135.0,4304,3206,2626.7,2636.7,7510,19758537.0,238,2023-11-06 17:35:00
403,YNDX,303,681,27742978.0,85824689.0,10543,32621,2631.4,2631.0,43164,113567667.0,984,255,663,24890104.0,84859015.0,9470,32236,2628.3,2632.4,41706,109749120.0,918,2023-11-06 17:40:00
404,YNDX,1944,2272,249806109.0,298076819.0,94887,113071,2632.7,2636.2,207958,547882928.0,4216,1736,2209,237538837.0,294025873.0,90245,111495,2632.2,2637.1,201740,531564711.0,3945,2023-11-06 17:45:00
405,YNDX,440,204,35221780.0,44440343.0,13268,16850,2654.6,2637.4,30118,79662124.0,644,381,145,32081992.0,12959162.0,12197,4913,2630.3,2637.7,17110,45041154.0,526,2023-11-06 17:50:00
406,YNDX,328,115,23627178.0,13841412.0,8948,5236,2640.5,2643.5,14184,37468590.0,443,257,72,21307876.0,8950255.0,8093,3346,2632.9,2674.9,11439,30258132.0,329,2023-11-06 17:55:00
407,YNDX,581,257,75293454.0,38125051.0,28525,14483,2639.6,2632.4,43008,113418505.0,838,549,216,72285644.0,27281968.0,27464,10339,2632.0,2638.7,37803,99567613.0,765,2023-11-06 18:00:00
408,YNDX,1557,548,312113438.0,73193965.0,118299,27754,2638.3,2637.2,146053,385307404.0,2105,1301,483,289426551.0,68701947.0,109900,26026,2633.5,2639.7,135926,358128498.0,1784,2023-11-06 18:05:00
409,YNDX,2712,3544,478546608.0,450329157.0,181634,170746,2634.7,2637.4,352380,928875765.0,6256,2616,3468,476333626.0,439597615.0,180836,166628,2634.1,2638.2,347464,915931241.0,6084,2023-11-06 18:10:00
410,YNDX,651,1167,99506572.0,151266838.0,37806,57440,2632.0,2633.5,95246,250773410.0,1818,567,1131,88720509.0,143756030.0,33710,54532,2631.9,2636.2,88242,232476539.0,1698,2023-11-06 18:15:00
411,YNDX,781,436,154599596.0,52267307.0,58682,19832,2634.5,2635.5,78514,206866903.0,1217,723,406,152558121.0,74869696.0,57947,28322,2632.7,2643.5,86269,227427817.0,1129,2023-11-06 18:20:00
412,YNDX,933,723,181594687.0,103644006.0,63613,39281,2854.7,2638.5,102894,285238693.0,1656,851,635,167064334.0,81979274.0,63444,31061,2633.3,2639.3,94505,249043608.0,1486,2023-11-06 18:25:00
413,YNDX,1155,281,202651281.0,38600182.0,76908,14654,2635.0,2634.1,91562,241251463.0,1436,1094,227,201569745.0,21815080.0,76543,8267,2633.4,2638.8,84810,223384825.0,1321,2023-11-06 18:30:00
414,YNDX,357,202,40178004.0,24404665.0,15152,9395,2651.7,2597.6,24547,64582670.0,559,332,191,34544395.0,18115424.0,13128,6861,2631.4,2640.3,19989,52659819.0,523,2023-11-06 18:35:00
415,YNDX,352,279,47357212.0,34662188.0,17906,13112,2644.8,2643.5,31018,82019401.0,631,314,227,52086534.0,29924515.0,19826,11322,2627.2,2643.0,31148,82011050.0,541,2023-11-06 18:40:00
416,YNDX,6047,3034,1150264666.0,679455026.0,436972,235356,2632.4,2886.9,672328,1829719693.0,9081,5321,2324,1104020443.0,550566650.0,419544,208535,2631.5,2640.2,628079,1654587094.0,7645,2023-11-07 10:05:00
417,YNDX,5262,4060,952183012.0,623620499.0,361693,236214,2632.6,2640.1,597907,1575803511.0,9322,5052,3861,934572153.0,619835355.0,355108,234819,2631.8,2639.6,589927,1554407508.0,8913,2023-11-07 10:10:00
418,YNDX,1341,1022,149780824.0,109500365.0,56870,41476,2633.7,2640.1,98346,259281190.0,2363,1183,924,146557279.0,94189331.0,55630,35657,2634.5,2641.5,91287,240746610.0,2107,2023-11-07 10:15:00
419,YNDX,9825,3076,2687809596.0,511722313.0,1017341,193352,2642.0,2646.6,1210693,3199531909.0,12901,9533,2784,2642174113.0,499045596.0,1001370,188451,2638.6,2648.1,1189821,3141219709.0,12317,2023-11-07 10:20:00
420,YNDX,5017,2590,917995211.0,509545398.0,347947,173355,2638.3,2939.3,521302,1427540609.0,7607,4768,2410,891691227.0,420689978.0,338095,159065,2637.4,2644.8,497160,1312381206.0,7178,2023-11-07 10:25:00
421,YNDX,1056,1195,248414564.0,254477953.0,94415,96307,2631.1,2642.4,190722,502892518.0,2251,882,1072,221556680.0,231057263.0,84251,87461,2629.7,2641.8,171712,452613944.0,1954,2023-11-07 10:30:00
422,YNDX,1718,1273,357300847.0,250438610.0,135832,94943,2630.5,2637.8,230775,607739458.0,2991,1599,1191,349225368.0,242856678.0,132805,92021,2629.6,2639.1,224826,592082047.0,2790,2023-11-07 10:35:00
423,YNDX,844,868,196258937.0,172385434.0,74602,65293,2630.7,2640.2,139895,368644371.0,1712,711,788,186451446.0,175934667.0,70895,66608,2630.0,2641.3,137503,362386114.0,1499,2023-11-07 10:40:00
424,YNDX,1632,527,315623305.0,128718089.0,119875,48676,2632.9,2644.4,168551,444341394.0,2159,1564,439,310868761.0,121619037.0,118108,46023,2632.1,2642.6,164131,432487798.0,2003,2023-11-07 10:45:00
425,YNDX,929,1575,155283212.0,270920318.0,58984,102777,2632.6,2636.0,161761,426203531.0,2504,785,1489,143179965.0,258463710.0,54453,97836,2629.4,2641.8,152289,401643675.0,2274,2023-11-07 10:50:00
426,YNDX,687,3050,123718911.0,441939844.0,47023,167538,2631.0,2637.8,214561,565658755.0,3737,626,2993,115089991.0,437409252.0,43783,165857,2628.6,2637.3,209640,552499244.0,3619,2023-11-07 10:55:00
427,YNDX,2503,2784,526083675.0,628644009.0,200584,238951,2622.8,2630.8,439535,1154727685.0,5287,2225,2611,504369506.0,597368012.0,192294,226840,2622.9,2633.4,419134,1101737518.0,4836,2023-11-07 11:00:00
428,YNDX,2096,1599,634739672.0,344877482.0,241512,130960,2628.2,2633.5,372472,979617154.0,3695,1957,1464,618940242.0,332612276.0,235697,126227,2626.0,2635.0,361924,951552518.0,3421,2023-11-07 11:05:00
429,YNDX,1939,854,399273778.0,147204549.0,151964,55918,2627.4,2632.5,207882,546478327.0,2793,1833,786,396292319.0,141649701.0,150858,53743,2626.9,2635.7,204601,537942021.0,2619,2023-11-07 11:10:00
430,YNDX,3027,2178,761427436.0,352540035.0,289617,133746,2629.1,2635.9,423363,1113967471.0,5205,2955,2102,755457006.0,341903043.0,287480,129707,2627.9,2636.0,417187,1097360049.0,5057,2023-11-07 11:15:00
431,YNDX,2214,5927,451275685.0,804864356.0,171719,305766,2628.0,2632.3,477485,1256140042.0,8141,2121,5859,445860214.0,802574052.0,169682,304873,2627.6,2632.5,474555,1248434266.0,7980,2023-11-07 11:20:00
432,YNDX,3678,8220,526137112.0,2619425705.0,200524,996300,2623.8,2629.2,1196824,3145562818.0,11898,3515,8138,507808034.0,2608573213.0,193560,991965,2623.5,2629.7,1185525,3116381247.0,11653,2023-11-07 11:25:00
433,YNDX,1434,5546,203206910.0,1671260349.0,77377,635208,2626.2,2631.0,712585,1874467259.0,6980,1378,5498,204146785.0,1668924247.0,77771,634315,2625.0,2631.1,712086,1873071033.0,6876,2023-11-07 11:30:00
434,YNDX,6934,13792,1239222119.0,3063530120.0,472074,1164418,2625.1,2631.0,1636492,4302752239.0,20726,6839,13711,1233719263.0,3059373034.0,469992,1162835,2625.0,2631.0,1632827,4293092297.0,20550,2023-11-07 11:35:00
435,YNDX,3778,1851,880979657.0,325060129.0,335514,122699,2625.8,2649.2,458213,1206039786.0,5629,3721,1797,878731239.0,304726637.0,334702,115798,2625.4,2631.5,450500,1183457876.0,5518,2023-11-07 11:40:00
436,YNDX,1615,1474,314013440.0,422836316.0,119627,160586,2624.9,2633.1,280213,736849756.0,3089,1529,1422,310139702.0,422209761.0,118160,160346,2624.7,2633.1,278506,732349464.0,2951,2023-11-07 11:45:00
437,YNDX,594,1102,89285739.0,195650530.0,33982,74285,2627.4,2633.8,108267,284936269.0,1696,420,1055,86604957.0,190552884.0,33018,72342,2623.0,2634.1,105360,277157841.0,1475,2023-11-07 11:50:00
438,YNDX,378,263,50220316.0,48932859.0,19138,18576,2624.1,2634.2,37714,99153176.0,641,297,213,47059738.0,46113641.0,17937,17490,2623.6,2636.6,35427,93173379.0,510,2023-11-07 11:55:00
439,YNDX,2827,1194,567680671.0,311120796.0,215981,118132,2628.4,2633.7,334113,878801468.0,4021,2693,1098,565364282.0,308348972.0,215103,117041,2628.3,2634.5,332144,873713254.0,3791,2023-11-07 12:00:00
440,YNDX,874,862,156835036.0,191744555.0,59688,72747,2627.6,2635.8,132435,348579592.0,1736,811,809,153698722.0,181757798.0,58523,68949,2626.3,2636.1,127472,335456520.0,1620,2023-11-07 12:05:00
441,YNDX,915,2119,152362658.0,444142864.0,57900,168617,2631.5,2634.0,226517,596505522.0,3034,769,2070,147743485.0,441854690.0,56263,167740,2625.9,2634.2,224003,589598175.0,2839,2023-11-07 12:10:00
442,YNDX,1085,2648,169370424.0,717264015.0,64434,272355,2628.6,2633.6,336789,886634440.0,3733,1005,2561,171003597.0,707627286.0,65083,268676,2627.5,2633.8,333759,878630883.0,3566,2023-11-07 12:15:00
443,YNDX,853,4550,174159628.0,641871509.0,66334,243901,2625.5,2631.7,310235,816031137.0,5403,769,4505,172558609.0,634903056.0,65732,241224,2625.2,2632.0,306956,807461665.0,5274,2023-11-07 12:20:00
444,YNDX,1673,1008,260391320.0,267968457.0,99224,101855,2624.3,2630.9,201079,528359777.0,2681,1586,921,257136112.0,262518913.0,97988,99738,2624.2,2632.1,197726,519655025.0,2507,2023-11-07 12:25:00
445,YNDX,1317,1315,173683838.0,233517658.0,66193,88785,2623.9,2630.1,154978,407201496.0,2632,1289,1247,170773482.0,238021730.0,65088,90487,2623.7,2630.5,155575,408795212.0,2536,2023-11-07 12:30:00
446,YNDX,3071,3298,725801951.0,667810765.0,276755,254196,2622.5,2627.1,530951,1393612716.0,6369,2906,3179,712723935.0,661843129.0,271868,251802,2621.6,2628.4,523670,1374567065.0,6085,2023-11-07 12:35:00
447,YNDX,1046,1667,208635431.0,343022943.0,79524,130290,2623.6,2632.8,209814,551658374.0,2713,977,1601,208100884.0,337461296.0,78603,128169,2647.5,2632.9,206772,545562180.0,2578,2023-11-07 12:40:00
448,YNDX,914,1824,175654179.0,397677103.0,66953,139215,2623.5,2856.6,206168,573331282.0,2738,781,1767,170737183.0,398864203.0,65158,132071,2620.4,3020.1,197229,569601387.0,2548,2023-11-07 12:45:00
449,YNDX,3431,1107,782912153.0,251702934.0,298514,95758,2622.7,2628.5,394272,1034615088.0,4538,3360,1063,779732337.0,248228399.0,297365,94394,2622.1,2629.7,391759,1027960736.0,4423,2023-11-07 12:50:00
450,YNDX,3306,4253,612964905.0,1016990046.0,234271,386252,2616.5,2633.0,620523,1629954951.0,7559,2952,4067,585562152.0,989690321.0,223805,377386,2616.4,2622.5,601191,1575252473.0,7019,2023-11-07 12:55:00
451,YNDX,774,1135,142683071.0,226834760.0,54519,86372,2617.1,2626.3,140891,369517832.0,1909,623,1051,132576953.0,220226213.0,50697,83840,2615.1,2626.7,134537,352803166.0,1674,2023-11-07 13:00:00
452,YNDX,2308,1571,390434824.0,333293060.0,149007,125007,2620.2,2666.2,274014,723727884.0,3879,2179,1279,365742204.0,319133354.0,139742,119422,2617.3,2672.3,259164,684875559.0,3458,2023-11-07 13:05:00
453,YNDX,689,733,98644889.0,105199383.0,37642,40021,2620.6,2628.6,77663,203844272.0,1422,598,681,95999209.0,102626607.0,36705,39053,2615.4,2627.9,75758,198625817.0,1279,2023-11-07 13:10:00
454,YNDX,1235,1127,244780366.0,260111763.0,93439,99025,2619.7,2626.7,192464,504892129.0,2362,1116,1030,234790691.0,250368987.0,89716,95304,2617.0,2627.1,185020,485159678.0,2146,2023-11-07 13:15:00
455,YNDX,1903,797,285695334.0,161705363.0,108927,61520,2622.8,2628.5,170447,447400697.0,2700,1801,737,275910468.0,158674907.0,105344,60341,2619.1,2629.6,165685,434585376.0,2538,2023-11-07 13:20:00
456,YNDX,616,975,110066701.0,284748169.0,41911,108367,2626.2,2627.6,150278,394814870.0,1591,569,919,109444881.0,287729455.0,41770,109480,2620.2,2628.1,151250,397174336.0,1488,2023-11-07 13:25:00
457,YNDX,424,322,81625344.0,81741878.0,31098,30934,2624.8,2642.5,62032,163367222.0,746,343,261,77889777.0,72702518.0,29749,27592,2618.2,2634.9,57341,150592295.0,604,2023-11-07 13:30:00
458,YNDX,1059,705,179714038.0,118236751.0,68356,44830,2629.1,2637.4,113186,297950789.0,1764,1019,627,177937184.0,110011554.0,67868,41775,2621.8,2633.4,109643,287948738.0,1646,2023-11-07 13:35:00
459,YNDX,578,396,156618271.0,75574241.0,44978,28682,3482.1,2634.9,73660,232192512.0,974,515,331,116110695.0,70262080.0,44275,26649,2622.5,2636.6,70924,186372776.0,846,2023-11-07 13:40:00
460,YNDX,343,381,61786264.0,62647100.0,23558,23800,2622.7,2632.2,47358,124433364.0,724,274,343,59843251.0,59588010.0,22835,22588,2620.7,2638.0,45423,119431262.0,617,2023-11-07 13:45:00
461,YNDX,422,389,74939067.0,67574253.0,28550,25621,2624.8,2637.5,54171,142513320.0,811,350,325,72875370.0,64782202.0,27783,24558,2623.0,2637.9,52341,137657572.0,675,2023-11-07 13:50:00
462,YNDX,869,663,176045734.0,136255072.0,66900,51842,2631.5,2628.3,118742,312300806.0,1532,692,589,160753485.0,126363614.0,61257,47942,2624.2,2635.8,109199,287117099.0,1281,2023-11-07 13:55:00
463,YNDX,1282,1075,198226064.0,223826335.0,75484,85073,2626.1,2631.0,160557,422052399.0,2357,1225,1022,192011318.0,222068601.0,73139,84358,2625.3,2632.5,157497,414079919.0,2247,2023-11-07 14:00:00
464,YNDX,279,255,50055911.0,70696649.0,18984,26841,2636.7,2633.9,45825,120752560.0,534,207,206,46891547.0,67658692.0,17883,25666,2622.1,2636.1,43549,114550239.0,413,2023-11-07 14:05:00
465,YNDX,1370,2661,196133155.0,355604244.0,74668,135137,2626.7,2631.4,209805,551737399.0,4031,1326,2616,192765641.0,350047678.0,73391,133015,2626.6,2631.6,206406,542813319.0,3942,2023-11-07 14:10:00
466,YNDX,998,1550,140803191.0,420324635.0,53620,159823,2625.9,2629.9,213443,561127826.0,2548,964,1454,140210297.0,406400372.0,53406,154522,2625.4,2630.0,207928,546610669.0,2418,2023-11-07 14:15:00
467,YNDX,279,429,53222641.0,73478639.0,20293,27898,2622.7,2633.8,48191,126701280.0,708,216,349,52220945.0,70313352.0,19921,26659,2621.4,2637.5,46580,122534297.0,565,2023-11-07 14:20:00
468,YNDX,273,359,62581401.0,73711513.0,23831,27981,2626.1,2634.3,51812,136292914.0,632,187,293,59721427.0,68080173.0,22780,25814,2621.7,2637.3,48594,127801601.0,480,2023-11-07 14:25:00
469,YNDX,474,687,84903341.0,110327738.0,32362,41899,2623.6,2633.2,74261,195231080.0,1161,452,597,84721010.0,100339870.0,32302,38081,2622.8,2634.9,70383,185060881.0,1049,2023-11-07 14:30:00
470,YNDX,329,3034,102164985.0,737112451.0,41142,280173,2483.2,2630.9,321315,839277437.0,3363,223,2960,70748469.0,729700807.0,26989,277288,2621.4,2631.6,304277,800449276.0,3183,2023-11-07 14:35:00
471,YNDX,477,709,101043430.0,135076950.0,38563,51364,2620.2,2629.8,89927,236120380.0,1186,446,662,96365011.0,130034770.0,36775,49397,2620.4,2632.4,86172,226399781.0,1108,2023-11-07 14:40:00
472,YNDX,1502,1047,197525416.0,180749523.0,75296,68736,2623.3,2629.6,144032,378274939.0,2549,1418,1023,196910973.0,179795810.0,75081,68370,2622.6,2629.7,143451,376706783.0,2441,2023-11-07 14:45:00
473,YNDX,647,2364,132374626.0,562888342.0,50519,214132,2620.3,2628.7,264651,695262968.0,3011,621,2014,130828791.0,558656881.0,49948,212518,2619.3,2628.8,262466,689485672.0,2635,2023-11-07 14:50:00
474,YNDX,1774,1996,228041426.0,607409975.0,86942,231161,2622.9,2627.6,318103,835451401.0,3770,1718,1961,225257270.0,606826655.0,85903,230906,2622.2,2628.0,316809,832083925.0,3679,2023-11-07 14:55:00
475,YNDX,2945,4496,381041892.0,768028088.0,145163,292161,2624.9,2628.8,437324,1149069980.0,7441,2883,4462,380295662.0,765417218.0,144884,291134,2624.8,2629.1,436018,1145712881.0,7345,2023-11-07 15:00:00
476,YNDX,2314,3216,469592460.0,729821006.0,178970,277559,2623.9,2629.4,456529,1199413467.0,5530,2305,3205,463840531.0,729208566.0,176791,277326,2623.7,2629.4,454117,1193049097.0,5510,2023-11-07 15:05:00
477,YNDX,457,390,79730712.0,63137415.0,30382,23962,2624.3,2634.9,54344,142868128.0,847,384,340,76523269.0,62543843.0,29186,23722,2621.9,2636.5,52908,139067112.0,724,2023-11-07 15:10:00
478,YNDX,1899,390,313819200.0,66452733.0,119554,25257,2624.9,2631.1,144811,380271933.0,2289,1860,369,311799776.0,65343851.0,118789,24815,2624.8,2633.2,143604,377143627.0,2229,2023-11-07 15:15:00
479,YNDX,990,498,133229558.0,106842589.0,50788,40597,2623.2,2631.8,91385,240072147.0,1488,966,450,131100340.0,100703482.0,49999,38260,2622.1,2632.1,88259,231803822.0,1416,2023-11-07 15:20:00
480,YNDX,364,374,81947475.0,94694013.0,31256,35983,2621.8,2631.6,67239,176641489.0,738,313,350,79450028.0,94867856.0,30331,36041,2619.4,2632.2,66372,174317884.0,663,2023-11-07 15:25:00
481,YNDX,1118,924,173463447.0,193811624.0,66125,73678,2623.3,2630.5,139803,367275072.0,2042,1048,894,171368566.0,195709432.0,65358,74368,2622.0,2631.6,139726,367077999.0,1942,2023-11-07 15:30:00
482,YNDX,9180,1634,1918403900.0,256428269.0,730544,97498,2626.0,2630.1,828042,2174832169.0,10814,9105,1590,1915193753.0,253907362.0,729346,96505,2625.9,2631.0,825851,2169101115.0,10695,2023-11-07 15:35:00
483,YNDX,377,670,77954649.0,99577095.0,29697,37806,2625.0,2633.9,67503,177531744.0,1047,315,638,72146295.0,94277124.0,27522,35784,2621.4,2634.6,63306,166423419.0,953,2023-11-07 15:40:00
484,YNDX,603,347,80445090.0,76343056.0,30627,28862,2626.6,2645.1,59489,156788146.0,950,366,318,63166443.0,93566636.0,24075,35339,2623.7,2647.7,59414,156733080.0,684,2023-11-07 15:45:00
485,YNDX,636,958,91519025.0,250771183.0,34827,95233,2627.8,2633.2,130060,342290208.0,1594,573,919,91815684.0,230252243.0,34997,87456,2623.5,2632.8,122453,322067928.0,1492,2023-11-07 15:50:00
486,YNDX,909,998,140717959.0,224825395.0,53573,85496,2626.7,2629.7,139069,365543354.0,1907,870,988,138475723.0,224727806.0,52756,85417,2624.8,2630.9,138173,363203530.0,1858,2023-11-07 15:55:00
487,YNDX,548,611,84971327.0,139682290.0,32357,53059,2626.1,2632.6,85416,224653617.0,1159,483,568,84213184.0,139516806.0,32097,52980,2623.7,2633.4,85077,223729990.0,1051,2023-11-07 16:00:00
488,YNDX,995,626,135141153.0,65184509.0,50550,24735,2673.4,2635.3,75285,200325662.0,1621,946,600,130750436.0,63365351.0,49798,24037,2625.6,2636.2,73835,194115787.0,1546,2023-11-07 16:05:00
489,YNDX,448,669,62308381.0,76265680.0,23742,28975,2624.4,2632.1,52717,138574062.0,1117,410,649,62076030.0,75139519.0,23660,28523,2623.7,2634.3,52183,137215550.0,1059,2023-11-07 16:10:00
490,YNDX,403,610,50334276.0,58920171.0,19169,22360,2625.8,2635.1,41529,109254448.0,1013,371,569,45659365.0,59804129.0,17407,22671,2623.0,2637.9,40078,105463495.0,940,2023-11-07 16:15:00
491,YNDX,1938,1294,248991719.0,167391237.0,94755,63507,2627.7,2635.8,158262,416382956.0,3232,1880,1246,246990726.0,161817372.0,94027,61442,2626.8,2633.7,155469,408808098.0,3126,2023-11-07 16:20:00
492,YNDX,606,299,99242037.0,50913340.0,37746,19315,2629.2,2635.9,57061,150155378.0,905,539,268,97016492.0,50393178.0,36946,19116,2625.9,2636.2,56062,147409670.0,807,2023-11-07 16:25:00
493,YNDX,299,224,45747256.0,39224618.0,17435,14873,2623.9,2637.3,32308,84971875.0,523,273,210,44639734.0,38127853.0,17020,14448,2622.8,2639.0,31468,82767587.0,483,2023-11-07 16:30:00
494,YNDX,293,293,55103849.0,66761133.0,20997,25317,2624.4,2637.0,46314,121864982.0,586,231,249,55025222.0,65993423.0,21007,25018,2619.4,2637.8,46025,121018645.0,480,2023-11-07 16:35:00
495,YNDX,437,222,52413676.0,43565221.0,19979,16522,2623.4,2636.8,36501,95978897.0,659,365,189,50105694.0,41484985.0,19111,15723,2621.8,2638.5,34834,91590679.0,554,2023-11-07 16:40:00
496,YNDX,434,312,90186925.0,58926325.0,35840,22376,2516.4,2633.5,58216,149113251.0,746,396,288,66420117.0,58586200.0,25319,22225,2623.3,2636.0,47544,125006317.0,684,2023-11-07 16:45:00
497,YNDX,498,399,82147122.0,69824335.0,31295,26543,2624.9,2630.6,57838,151971457.0,897,465,345,79122366.0,67939165.0,30175,25757,2622.1,2637.7,55932,147061532.0,810,2023-11-07 16:50:00
498,YNDX,673,663,119448087.0,99554744.0,45435,37789,2629.0,2634.5,83224,219002832.0,1336,572,623,101561566.0,98346073.0,38702,37325,2624.2,2634.9,76027,199907639.0,1195,2023-11-07 16:55:00
499,YNDX,768,847,165522212.0,162866209.0,64441,61719,2568.6,2638.8,126160,328388421.0,1615,653,787,137921010.0,155204816.0,52522,58821,2626.0,2638.6,111343,293125826.0,1440,2023-11-07 17:00:00
500,YNDX,633,725,82411991.0,155740680.0,31348,58700,2628.9,2653.2,90048,238152671.0,1358,598,698,81021635.0,153720246.0,30830,58324,2628.0,2635.6,89154,234741881.0,1296,2023-11-07 17:05:00
501,YNDX,750,3518,138607171.0,1138742744.0,52790,429957,2625.6,2648.5,482747,1277349916.0,4268,671,3457,134599671.0,1127919275.0,51291,426215,2624.2,2646.4,477506,1262518946.0,4128,2023-11-07 17:10:00
502,YNDX,802,4843,135085430.0,1751707555.0,51462,665601,2625.0,2631.8,717063,1886792985.0,5645,714,4795,128480963.0,1745045646.0,48966,663001,2623.9,2632.0,711967,1873526609.0,5509,2023-11-07 17:15:00
503,YNDX,477,570,60291586.0,83129748.0,22956,31030,2626.4,2679.0,53986,143421334.0,1047,428,532,60529647.0,83742872.0,23078,31004,2622.8,2701.0,54082,144272519.0,960,2023-11-07 17:20:00
504,YNDX,5826,5059,729852286.0,644595681.0,277510,244478,2630.0,2636.6,521988,1374447967.0,10885,5718,5000,720889364.0,638631080.0,274200,241697,2629.1,2642.3,515897,1359520444.0,10718,2023-11-07 17:25:00
505,YNDX,621,4593,88013233.0,981013886.0,33501,372469,2627.2,2633.8,405970,1069027119.0,5214,608,4556,88298807.0,982223566.0,33640,372911,2624.8,2633.9,406551,1070522373.0,5164,2023-11-07 17:30:00
506,YNDX,372,433,26565745.0,60367145.0,10104,22880,2629.2,2638.4,32984,86932891.0,805,325,404,25057945.0,59298569.0,9545,22475,2625.2,2638.4,32020,84356515.0,729,2023-11-07 17:35:00
507,YNDX,399,574,52615905.0,104815254.0,20006,39785,2630.0,2634.5,59791,157431160.0,973,325,518,45702711.0,99495454.0,17422,37739,2623.3,2636.4,55161,145198165.0,843,2023-11-07 17:40:00
508,YNDX,390,357,44386040.0,45047292.0,12332,17100,3599.3,2634.3,29432,89433332.0,747,334,267,28625550.0,43332150.0,10906,16437,2624.8,2636.3,27343,71957701.0,601,2023-11-07 17:45:00
509,YNDX,1086,863,118790404.0,129361112.0,45158,49036,2630.6,2638.1,94194,248151517.0,1949,816,753,99949084.0,126497919.0,38048,47948,2626.9,2638.2,85996,226447004.0,1569,2023-11-07 17:50:00
510,YNDX,551,1600,51067516.0,286283136.0,19390,108693,2633.7,2633.9,128083,337350652.0,2151,469,1535,47565820.0,283134326.0,18112,107494,2626.2,2634.0,125606,330700147.0,2004,2023-11-07 17:55:00
511,YNDX,755,463,116095226.0,64210929.0,45539,24313,2549.4,2641.0,69852,180306156.0,1218,520,393,89421665.0,60704455.0,34011,22982,2629.2,2641.4,56993,150126121.0,913,2023-11-07 18:00:00
512,YNDX,1619,1132,432807434.0,200049477.0,164492,75852,2631.2,2637.4,240344,632856911.0,2751,1510,1010,418264153.0,197158151.0,159032,74711,2630.1,2638.9,233743,615422305.0,2520,2023-11-07 18:05:00
513,YNDX,2219,1090,679320670.0,159123529.0,257212,60383,2641.1,2635.2,317595,838444200.0,3309,2141,1038,672561923.0,152980239.0,255627,57994,2631.0,2637.9,313621,825542162.0,3179,2023-11-07 18:10:00
514,YNDX,871,674,209088970.0,72433202.0,79338,27432,2635.4,2640.5,106770,281522173.0,1545,754,556,193080731.0,56575335.0,73333,21430,2632.9,2640.0,94763,249656067.0,1310,2023-11-07 18:15:00
515,YNDX,1180,591,353515015.0,81528249.0,134177,30952,2634.7,2634.0,165129,435043265.0,1771,1063,498,342745864.0,68216825.0,130152,25822,2633.4,2641.8,155974,410962690.0,1561,2023-11-07 18:20:00
516,YNDX,1887,907,251335279.0,266459724.0,95506,101084,2631.6,2636.0,196590,517795003.0,2794,1780,846,243412690.0,253798837.0,92531,96267,2630.6,2636.4,188798,497211527.0,2626,2023-11-07 18:25:00
517,YNDX,1620,2937,204081094.0,796993388.0,77494,302528,2633.5,2634.4,380022,1001074483.0,4557,1532,2897,201117584.0,790268456.0,76482,299833,2629.6,2635.7,376315,991386041.0,4429,2023-11-07 18:30:00
518,YNDX,494,447,55047670.0,84127845.0,20886,31930,2635.6,2634.8,52816,139175515.0,941,448,421,47151008.0,81011533.0,17939,30717,2628.4,2637.4,48656,128162541.0,869,2023-11-07 18:35:00
519,YNDX,343,1665,32766517.0,351774447.0,12413,133554,2639.7,2633.9,145967,384540964.0,2008,315,1641,31404399.0,345880828.0,11945,131261,2629.1,2635.1,143206,377285227.0,1956,2023-11-07 18:40:00
520,YNDX,6194,4443,1695972796.0,790177324.0,644747,275486,2630.4,2868.3,920233,2486150120.0,10637,5453,3801,1660307776.0,644917139.0,630702,244480,2632.5,2637.9,875182,2305224916.0,9254,2023-11-08 10:05:00
521,YNDX,5357,2105,1104601987.0,282067841.0,419048,106849,2636.0,2639.9,525897,1386669829.0,7462,5164,1907,1089022401.0,272306478.0,413461,103105,2633.9,2641.1,516566,1361328879.0,7071,2023-11-08 10:10:00
522,YNDX,4410,6526,718602289.0,1664761287.0,268959,632154,2671.8,2633.5,901113,2383363577.0,10936,4099,6304,670392394.0,1630699558.0,255086,619111,2628.1,2633.9,874197,2301091952.0,10403,2023-11-08 10:15:00
523,YNDX,1330,2670,169247790.0,542933071.0,64332,205934,2630.8,2636.4,270266,712180861.0,4000,1191,2556,161258397.0,532644637.0,61349,202009,2628.5,2636.7,263358,693903035.0,3747,2023-11-08 10:20:00
524,YNDX,702,1026,131576037.0,211379567.0,50106,80156,2626.0,2637.1,130262,342955604.0,1728,547,938,122674847.0,204361338.0,46692,77468,2627.3,2638.0,124160,327036185.0,1485,2023-11-08 10:25:00
525,YNDX,2801,3473,411115594.0,934870637.0,156065,354526,2634.3,2637.0,510591,1345986232.0,6274,2637,3384,394307028.0,928615425.0,149777,352067,2632.6,2637.6,501844,1322922454.0,6021,2023-11-08 10:30:00
526,YNDX,1472,1604,287148464.0,432105868.0,109272,163825,2627.8,2637.6,273097,719254332.0,3076,1275,1445,268134528.0,411595992.0,102048,156045,2627.5,2637.7,258093,679730521.0,2720,2023-11-08 10:35:00
527,YNDX,1646,1774,346836366.0,483763818.0,131698,183185,2633.6,2640.8,314883,830600184.0,3420,1476,1619,338505138.0,470859435.0,128720,178409,2629.8,2639.2,307129,809364573.0,3095,2023-11-08 10:40:00
528,YNDX,822,1536,121505383.0,416005914.0,46106,157658,2635.3,2638.7,203764,537511297.0,2358,712,1472,113641153.0,411595137.0,43173,155956,2632.2,2639.2,199129,525236291.0,2184,2023-11-08 10:45:00
529,YNDX,524,478,127022136.0,143440761.0,47907,54279,2651.4,2642.7,102186,270462897.0,1002,448,395,117440841.0,136486424.0,44631,51606,2631.4,2644.8,96237,253927265.0,843,2023-11-08 10:50:00
530,YNDX,2132,1832,485319379.0,494737736.0,183636,186816,2642.8,2648.3,370452,980057116.0,3964,1713,1584,434873400.0,471649043.0,164900,178130,2637.2,2647.8,343030,906522444.0,3297,2023-11-08 10:55:00
531,YNDX,3870,5517,935211237.0,1331742299.0,353251,502069,2647.4,2652.5,855320,2266953537.0,9387,3489,5127,878017180.0,1264710005.0,331956,476722,2645.0,2652.9,808678,2142727186.0,8616,2023-11-08 11:00:00
532,YNDX,2887,2152,548030362.0,515495495.0,206315,193963,2656.3,2657.7,400278,1063525858.0,5039,2618,1827,519722748.0,484583495.0,196346,182343,2647.0,2657.5,378689,1004306243.0,4445,2023-11-08 11:05:00
533,YNDX,3779,3680,556389863.0,852003709.0,210309,321780,2645.6,2647.8,532089,1408393573.0,7459,3587,3535,538320415.0,833447447.0,203611,314473,2643.9,2650.3,518084,1371767863.0,7122,2023-11-08 11:10:00
534,YNDX,2234,2109,325784364.0,316855372.0,123192,119794,2644.5,2645.0,242986,642639737.0,4343,2121,1987,312552225.0,306993239.0,118217,113706,2643.9,2699.9,231923,619545465.0,4108,2023-11-08 11:15:00
535,YNDX,1102,1221,214709230.0,215792049.0,81077,81223,2648.2,2656.8,162300,430501280.0,2323,959,1125,201675164.0,205179564.0,76325,77258,2642.3,2655.8,153583,406854728.0,2084,2023-11-08 11:20:00
536,YNDX,1346,2573,246077673.0,467380599.0,92876,176009,2649.5,2655.4,268885,713458272.0,3919,1216,2428,237614250.0,456240666.0,89754,171777,2647.4,2656.0,261531,693854916.0,3644,2023-11-08 11:25:00
537,YNDX,1883,3451,347857969.0,737272354.0,131154,277409,2652.3,2657.7,408563,1085130323.0,5334,1723,3239,332979205.0,713444140.0,125713,268422,2648.7,2657.9,394135,1046423346.0,4962,2023-11-08 11:30:00
538,YNDX,2305,2430,361758678.0,567311347.0,136363,213364,2652.9,2658.9,349727,929070025.0,4735,2164,2268,348439548.0,560932066.0,131430,210905,2651.1,2659.6,342335,909371614.0,4432,2023-11-08 11:35:00
539,YNDX,1992,2560,392611391.0,498252950.0,147822,187245,2656.0,2661.0,335067,890864341.0,4552,1761,2333,370842403.0,477308108.0,139810,179315,2652.5,2661.8,319125,848150512.0,4094,2023-11-08 11:40:00
540,YNDX,4332,5450,685899237.0,1138995482.0,258209,427886,2656.4,2661.9,686095,1824894720.0,9782,4143,5190,668296377.0,1117770960.0,251670,419846,2655.4,2662.3,671516,1786067338.0,9333,2023-11-08 11:45:00
541,YNDX,1176,1718,221887374.0,308256755.0,83609,115971,2653.9,2658.1,199580,530144130.0,2894,1036,1495,213614824.0,287334588.0,80574,107886,2651.2,2663.3,188460,500949413.0,2531,2023-11-08 11:50:00
542,YNDX,934,1264,144948714.0,188514312.0,54550,70864,2657.2,2660.2,125414,333463026.0,2198,827,1158,133436527.0,183006307.0,50348,68765,2650.3,2661.3,119113,316442835.0,1985,2023-11-08 11:55:00
543,YNDX,1049,1162,182052835.0,201670136.0,68518,75678,2657.0,2664.8,144196,383722971.0,2211,944,1035,173519084.0,186416614.0,65433,69981,2651.9,2663.8,135414,359935698.0,1979,2023-11-08 12:00:00
544,YNDX,2302,1905,435398808.0,307472795.0,163998,115515,2654.9,2661.8,279513,742871604.0,4207,2171,1773,429046537.0,299780332.0,161702,112612,2653.3,2662.1,274314,728826870.0,3944,2023-11-08 12:05:00
545,YNDX,2283,2463,506220140.0,566389342.0,191296,213968,2646.3,2647.1,405264,1072609482.0,4746,2025,2243,487539764.0,523780620.0,184283,197279,2645.6,2655.0,381562,1011320385.0,4268,2023-11-08 12:10:00
546,YNDX,2239,1391,357668833.0,290216783.0,135333,109548,2642.9,2649.2,244881,647885616.0,3630,2011,1222,343590851.0,287410902.0,130063,108380,2641.7,2651.9,238443,631001753.0,3233,2023-11-08 12:15:00
547,YNDX,1832,4487,370281350.0,1138168268.0,139784,428766,2649.0,2654.5,568550,1508449619.0,6319,1698,4345,361406205.0,1129537935.0,136552,425412,2646.7,2655.2,561964,1490944141.0,6043,2023-11-08 12:20:00
548,YNDX,4259,8679,548044595.0,1900416019.0,206779,715908,2650.4,2654.6,922687,2448460615.0,12938,4170,8592,544181928.0,1892809303.0,205340,712940,2650.2,2654.9,918280,2436991231.0,12762,2023-11-08 12:25:00
549,YNDX,910,848,144975059.0,184811803.0,54817,65385,2644.7,2826.5,120202,329786862.0,1758,840,765,139524546.0,165849673.0,52758,62452,2644.6,2655.6,115210,305374219.0,1605,2023-11-08 12:30:00
550,YNDX,582,520,103707501.0,102803751.0,39239,38741,2643.0,2653.6,77980,206511252.0,1102,497,434,95952539.0,96007894.0,36322,36152,2641.7,2655.7,72474,191960434.0,931,2023-11-08 12:35:00
551,YNDX,650,561,128191206.0,127094231.0,48526,48013,2641.7,2647.1,96539,255285437.0,1211,504,473,123622148.0,124951614.0,46823,47109,2640.2,2652.4,93932,248573762.0,977,2023-11-08 12:40:00
552,YNDX,1563,2125,201652881.0,530278158.0,76237,192959,2645.1,2748.1,269196,731931039.0,3688,1429,2019,192398001.0,509217684.0,72853,192239,2640.9,2648.9,265092,701615685.0,3448,2023-11-08 12:45:00
553,YNDX,766,5428,156434721.0,802837526.0,59253,297422,2640.1,2699.3,356675,959272248.0,6194,647,5312,151029167.0,785612015.0,57249,292521,2638.1,2685.7,349770,936641182.0,5959,2023-11-08 12:50:00
554,YNDX,687,1368,145139842.0,320830250.0,54909,121266,2643.3,2645.7,176175,465970092.0,2055,571,1292,131120781.0,317536901.0,49733,120007,2636.5,2646.0,169740,448657682.0,1863,2023-11-08 12:55:00
555,YNDX,1071,2313,165002452.0,430748165.0,62455,162636,2641.9,2648.5,225091,595750618.0,3384,955,2227,157034726.0,427280052.0,59480,161312,2640.1,2648.8,220792,584314778.0,3182,2023-11-08 13:00:00
556,YNDX,3664,9263,519048529.0,2479700480.0,196582,937485,2640.4,2645.1,1134067,2998749009.0,12927,3527,9128,508102798.0,2465213840.0,192478,931868,2639.8,2645.5,1124346,2973316639.0,12655,2023-11-08 13:05:00
557,YNDX,1314,1257,278245153.0,277514735.0,104985,104647,2650.3,2651.9,209632,555759889.0,2571,1217,1144,255744536.0,265939560.0,96827,100271,2641.3,2652.2,197098,521684096.0,2361,2023-11-08 13:10:00
558,YNDX,1298,7188,229225501.0,2789586007.0,86865,1053445,2638.9,2648.1,1140310,3018811508.0,8486,1232,6947,225913316.0,2777521383.0,85622,1048811,2638.5,2648.3,1134433,3003434700.0,8179,2023-11-08 13:15:00
559,YNDX,3314,6826,614710838.0,2191355851.0,233336,829610,2634.4,2641.4,1062946,2806066689.0,10140,2992,6595,592695741.0,2163774049.0,225007,818395,2634.1,2643.9,1043402,2756469790.0,9587,2023-11-08 13:20:00
560,YNDX,4520,6631,645168252.0,1802691423.0,244607,682171,2637.6,2642.6,926778,2447859676.0,11151,4392,6552,633708946.0,1791550815.0,240334,677914,2636.8,2642.7,918248,2425259761.0,10944,2023-11-08 13:25:00
561,YNDX,674,929,104440393.0,204215958.0,39637,77224,2634.9,2644.5,116861,308656352.0,1603,567,804,100816373.0,195250596.0,38300,73721,2632.3,2648.5,112021,296066969.0,1371,2023-11-08 13:30:00
562,YNDX,2179,1749,379414434.0,469128134.0,144102,177700,2633.0,2640.0,321802,848542568.0,3928,2058,1605,361231710.0,451889503.0,137264,171087,2631.7,2641.3,308351,813121214.0,3663,2023-11-08 13:35:00
563,YNDX,1021,671,154768915.0,153211762.0,58714,57917,2636.0,2645.4,116631,307980678.0,1692,899,570,149510640.0,144261492.0,56740,54495,2635.0,2647.2,111235,293772132.0,1469,2023-11-08 13:40:00
564,YNDX,776,1402,124073293.0,380987263.0,47112,144209,2633.6,2641.9,191321,505060556.0,2178,686,1340,116668104.0,376340480.0,44318,142386,2632.5,2643.1,186704,493008585.0,2026,2023-11-08 13:45:00
565,YNDX,1075,650,150334456.0,137601770.0,57045,52041,2635.4,2644.1,109086,287936227.0,1725,1006,599,146831284.0,136982869.0,55725,51795,2634.9,2644.7,107520,283814153.0,1605,2023-11-08 13:50:00
566,YNDX,1114,3671,244678588.0,964464381.0,93065,365669,2629.1,2637.5,458734,1209142969.0,4785,1011,3473,237051682.0,940633676.0,90209,356603,2627.8,2637.8,446812,1177685359.0,4484,2023-11-08 13:55:00
567,YNDX,937,1405,189601475.0,363294330.0,72081,137854,2630.4,2635.4,209935,552895805.0,2342,837,1349,185798302.0,358968462.0,70662,136007,2629.4,2639.3,206669,544766765.0,2186,2023-11-08 14:00:00
568,YNDX,576,588,105201157.0,177974340.0,39922,67360,2635.2,2642.1,107282,283175497.0,1164,489,531,88118386.0,170796429.0,33503,64576,2630.2,2644.9,98079,258914815.0,1020,2023-11-08 14:05:00
569,YNDX,838,915,166485894.0,197770630.0,63191,74813,2634.6,2643.5,138004,364256524.0,1753,715,832,155836633.0,187317565.0,59207,70827,2632.1,2644.7,130034,343154198.0,1547,2023-11-08 14:10:00
570,YNDX,990,1258,176129264.0,228401426.0,66736,86338,2639.2,2645.4,153074,404530690.0,2248,899,1177,174152809.0,228119924.0,66116,86212,2634.0,2646.0,152328,402272734.0,2076,2023-11-08 14:15:00
571,YNDX,1516,1504,247711315.0,273327639.0,93656,103231,2644.9,2647.7,196887,521038955.0,3020,1435,1403,240866601.0,266758745.0,91282,100744,2638.7,2647.9,192026,507625346.0,2838,2023-11-08 14:20:00
572,YNDX,1969,2177,309294431.0,354773465.0,117217,134116,2638.6,2645.3,251333,664067896.0,4146,1881,2099,310661810.0,346232285.0,117746,130828,2638.4,2646.5,248574,656894095.0,3980,2023-11-08 14:25:00
573,YNDX,1980,6651,318615759.0,2029846998.0,120924,768707,2634.8,2640.6,889631,2348462758.0,8631,1821,6574,305161049.0,2014934116.0,115888,763048,2633.2,2640.6,878936,2320095166.0,8395,2023-11-08 14:30:00
574,YNDX,2734,7414,393293100.0,1773105090.0,149240,671245,2635.3,2641.5,820485,2166398190.0,10148,2641,7309,384998973.0,1765402097.0,146114,668359,2634.9,2641.4,814473,2150401070.0,9950,2023-11-08 14:35:00
575,YNDX,2810,4106,387805771.0,1252587110.0,146988,474268,2638.3,2641.1,621256,1640392881.0,6916,2699,4040,383431566.0,1247480978.0,145414,472097,2636.8,2642.4,617511,1630912544.0,6739,2023-11-08 14:40:00
576,YNDX,3360,8965,570494362.0,2956254094.0,216775,1120745,2631.7,2637.8,1337520,3526748457.0,12325,3224,8858,561278405.0,2949293993.0,213303,1117694,2631.4,2638.7,1330997,3510572398.0,12082,2023-11-08 14:45:00
577,YNDX,1395,3465,182602361.0,1279258705.0,69390,485088,2631.5,2637.2,554478,1461861066.0,4860,1291,3380,178390447.0,1276127366.0,67848,483865,2629.3,2637.4,551713,1454517813.0,4671,2023-11-08 14:50:00
578,YNDX,1458,2135,223861991.0,678556836.0,85104,257273,2630.5,2637.5,342377,902418828.0,3593,1356,2050,213566233.0,674629024.0,81217,255777,2629.6,2637.6,336994,888195258.0,3406,2023-11-08 14:55:00
579,YNDX,723,2850,114556161.0,951373027.0,43526,360786,2631.9,2636.9,404312,1065929189.0,3573,648,2776,112054115.0,945807382.0,42614,358599,2629.5,2637.5,401213,1057861498.0,3424,2023-11-08 15:00:00
580,YNDX,1712,5475,249794710.0,1615779574.0,95051,613386,2628.0,2634.2,708437,1865574285.0,7187,1573,5381,241855130.0,1607674365.0,92053,610250,2627.3,2634.5,702303,1849529495.0,6954,2023-11-08 15:05:00
581,YNDX,541,1762,75277017.0,585014058.0,28644,221980,2628.0,2635.4,250624,660291076.0,2303,447,1714,75432132.0,580269535.0,28721,220138,2626.4,2635.9,248859,655701667.0,2161,2023-11-08 15:10:00
582,YNDX,2622,3294,853364338.0,755487570.0,323944,286595,2634.3,2636.1,610539,1608851908.0,5916,2519,3198,839059148.0,741227901.0,318739,281089,2632.4,2637.0,599828,1580287049.0,5717,2023-11-08 15:15:00
583,YNDX,1815,4560,271699558.0,1126435461.0,103261,427204,2631.2,2636.8,530465,1398135019.0,6375,1747,4501,268556955.0,1122378349.0,102109,425656,2630.1,2636.8,527765,1390935304.0,6248,2023-11-08 15:20:00
584,YNDX,2953,7076,441762584.0,1879197480.0,167914,713060,2630.9,2635.4,880974,2320960064.0,10029,2874,7007,436948256.0,1876245563.0,166087,711920,2630.8,2635.5,878007,2313193819.0,9881,2023-11-08 15:25:00
585,YNDX,807,986,154601501.0,213211430.0,58767,80776,2630.8,2639.5,139543,367812931.0,1793,736,936,147313619.0,212062017.0,56023,80352,2629.5,2639.2,136375,359375637.0,1672,2023-11-08 15:30:00
586,YNDX,925,2123,148382760.0,676076450.0,56421,256198,2629.9,2638.9,312619,824459210.0,3048,831,2043,145689570.0,658881936.0,55412,249792,2629.2,2637.7,305204,804571507.0,2874,2023-11-08 15:35:00
587,YNDX,736,2710,125757102.0,816586550.0,47867,309853,2627.2,2635.4,357720,942343652.0,3446,703,2641,127771210.0,813784951.0,48636,308710,2627.1,2636.1,357346,941556162.0,3344,2023-11-08 15:40:00
588,YNDX,2309,4238,352839901.0,1310378478.0,133884,497046,2635.4,2636.3,630930,1663218379.0,6547,2243,4166,339730355.0,1308936803.0,129142,496440,2630.7,2636.6,625582,1648667159.0,6409,2023-11-08 15:45:00
589,YNDX,1945,572,666265799.0,119873160.0,252998,45340,2633.5,2643.9,298338,786138960.0,2517,1931,529,660893548.0,113623210.0,251014,42983,2632.9,2643.4,293997,774516758.0,2460,2023-11-08 15:50:00
590,YNDX,829,627,129294724.0,113431375.0,48934,42967,2642.2,2640.0,91901,242726099.0,1456,725,567,125877073.0,110255204.0,47814,41702,2632.6,2643.9,89516,236132277.0,1292,2023-11-08 15:55:00
591,YNDX,2770,1053,1004965619.0,204498475.0,380500,77264,2641.2,2646.7,457764,1209464095.0,3823,2691,968,991846436.0,197162756.0,375980,74496,2638.0,2646.6,450476,1189009192.0,3659,2023-11-08 16:00:00
592,YNDX,3801,1704,1289346672.0,315890910.0,488674,119416,2638.5,2645.3,608090,1605237583.0,5505,3699,1614,1277418380.0,300325845.0,484241,113509,2638.0,2645.8,597750,1577744226.0,5313,2023-11-08 16:05:00
593,YNDX,3892,1302,1481885989.0,182269062.0,561767,68949,2637.9,2643.5,630716,1664155052.0,5194,3848,1245,1478889189.0,176507070.0,560756,66703,2637.3,2646.2,627459,1655396260.0,5093,2023-11-08 16:10:00
594,YNDX,3755,2002,1227251309.0,267226311.0,465065,101012,2638.9,2645.5,566077,1494477621.0,5757,3721,1934,1222539610.0,261772345.0,463435,98944,2638.0,2645.7,562379,1484311955.0,5655,2023-11-08 16:15:00
595,YNDX,1058,1025,251413406.0,141501878.0,95031,53447,2645.6,2647.5,148478,392915284.0,2083,982,946,239779814.0,137390306.0,90866,51868,2638.8,2648.8,142734,377170120.0,1928,2023-11-08 16:20:00
596,YNDX,523,861,110281469.0,125613851.0,41695,47507,2645.0,2644.1,89202,235895320.0,1384,461,771,107747690.0,126945552.0,40838,45909,2638.4,2765.2,86747,234693242.0,1232,2023-11-08 16:25:00
597,YNDX,2305,2249,366052046.0,304758321.0,138673,115232,2639.7,2644.7,253905,670810367.0,4554,2237,2199,362610039.0,297621775.0,137376,112503,2639.5,2645.5,249879,660231814.0,4436,2023-11-08 16:30:00
598,YNDX,3689,1691,1305749836.0,309623815.0,494052,116927,2642.9,2648.0,610979,1615373652.0,5380,3601,1570,1290423362.0,301311051.0,488653,113712,2640.8,2649.8,602365,1591734414.0,5171,2023-11-08 16:35:00
599,YNDX,905,947,164341808.0,155593609.0,62316,58840,2637.2,2644.4,121156,319935418.0,1852,840,860,158521434.0,146291104.0,60127,55289,2636.4,2645.9,115416,304812538.0,1700,2023-11-08 16:40:00
600,YNDX,3721,1836,1316480461.0,304187944.0,499252,115063,2636.9,2643.7,614315,1620668406.0,5557,3651,1719,1313716311.0,297102485.0,498214,112375,2636.9,2643.8,610589,1610818796.0,5370,2023-11-08 16:45:00
601,YNDX,2179,930,671086203.0,156411956.0,254455,59097,2637.3,2646.7,313552,827498159.0,3109,2092,860,668762192.0,158884593.0,253605,60028,2637.0,2646.8,313633,827646785.0,2952,2023-11-08 16:50:00
602,YNDX,3076,893,500924696.0,137024755.0,190026,51981,2636.1,2636.1,242007,637949452.0,3969,3043,831,497886370.0,133223553.0,188893,50376,2635.8,2644.6,239269,631109923.0,3874,2023-11-08 16:55:00
603,YNDX,965,4487,219265920.0,666707191.0,83359,253405,2630.4,2631.0,336764,885973111.0,5452,859,4382,215402523.0,648667263.0,81909,245782,2629.8,2639.2,327691,864069786.0,5241,2023-11-08 17:00:00
604,YNDX,2450,9175,391728558.0,1790999705.0,149011,680517,2628.9,2631.8,829528,2182728264.0,11625,2290,8972,380638530.0,1774512875.0,144850,673789,2627.8,2633.6,818639,2155151406.0,11262,2023-11-08 17:05:00
605,YNDX,1121,1981,181508968.0,435914807.0,69042,165834,2629.0,2628.6,234876,617423775.0,3102,1049,1902,168166083.0,429320414.0,63978,162954,2628.5,2634.6,226932,597486497.0,2951,2023-11-08 17:10:00
606,YNDX,1333,2387,256017828.0,502385136.0,96914,190507,2641.7,2637.1,287421,758402964.0,3720,1242,2308,251665899.0,501415923.0,95684,190136,2630.2,2637.1,285820,753081822.0,3550,2023-11-08 17:15:00
607,YNDX,7630,15451,941660932.0,2477107351.0,357890,940262,2631.1,2634.5,1298152,3418768284.0,23081,7590,15402,941674207.0,2474783193.0,357944,939375,2630.8,2634.5,1297319,3416457400.0,22992,2023-11-08 17:20:00
608,YNDX,1054,2234,122235977.0,494287113.0,46463,187372,2630.8,2638.0,233835,616523091.0,3288,994,2168,120072074.0,491714085.0,45671,186385,2629.1,2638.2,232056,611786159.0,3162,2023-11-08 17:25:00
609,YNDX,510,2169,51363129.0,861642917.0,19525,326884,2630.6,2635.9,346409,913006047.0,2679,436,2097,46940726.0,854477325.0,17857,324159,2628.7,2636.0,342016,901418052.0,2533,2023-11-08 17:30:00
610,YNDX,566,683,91244561.0,157411104.0,34665,59677,2632.2,2637.7,94342,248655665.0,1249,527,645,89122650.0,154739777.0,33918,58606,2627.6,2640.3,92524,243862427.0,1172,2023-11-08 17:35:00
611,YNDX,638,541,73499600.0,113937710.0,27911,43190,2633.4,2638.1,71101,187437310.0,1179,573,485,71456246.0,112774996.0,27175,42712,2629.5,2640.4,69887,184231243.0,1058,2023-11-08 17:40:00
612,YNDX,1137,1485,212977349.0,433902319.0,82378,164196,2585.4,2642.6,246574,646879669.0,2622,1036,1370,186000467.0,432501649.0,70656,163638,2632.5,2643.0,234294,618502116.0,2406,2023-11-08 17:45:00
613,YNDX,875,1141,170235023.0,299576876.0,66094,113309,2575.7,2643.9,179403,469811900.0,2016,843,1037,143334267.0,294066473.0,54400,111196,2634.8,2644.6,165596,437400740.0,1880,2023-11-08 17:50:00
614,YNDX,570,522,87206034.0,91423549.0,33068,34596,2637.2,2642.6,67664,178629584.0,1092,513,450,82122501.0,88257337.0,31152,33335,2636.2,2647.6,64487,170379839.0,963,2023-11-08 17:55:00
615,YNDX,466,488,52884633.0,67902731.0,20042,25797,2638.7,2632.2,45839,120787364.0,954,415,405,51856240.0,60076418.0,19672,22692,2636.0,2647.5,42364,111932659.0,820,2023-11-08 18:00:00
616,YNDX,994,619,132773650.0,137155834.0,50433,51972,2632.7,2639.0,102405,269929484.0,1613,906,560,127569124.0,133718266.0,48465,50577,2632.2,2643.9,99042,261287391.0,1466,2023-11-08 18:05:00
617,YNDX,1015,3347,159936919.0,1162387400.0,60722,440201,2633.9,2640.6,500923,1322324320.0,4362,917,3304,154268453.0,1159279519.0,58595,438844,2632.8,2641.7,497439,1313547972.0,4221,2023-11-08 18:10:00
618,YNDX,882,533,138354884.0,117536061.0,52457,44424,2637.5,2645.8,96881,255890946.0,1415,805,477,133751857.0,111088619.0,50758,41977,2635.1,2646.4,92735,244840476.0,1282,2023-11-08 18:15:00
619,YNDX,1975,625,487531562.0,135558077.0,184527,51270,2642.1,2644.0,235797,623089640.0,2600,1888,564,477081367.0,121572964.0,180905,45925,2637.2,2647.2,226830,598654332.0,2452,2023-11-08 18:20:00
620,YNDX,1180,403,302755278.0,79111048.0,114781,27184,2637.7,2910.2,141965,381866327.0,1583,1150,361,301051942.0,76683683.0,114163,26238,2637.0,2922.6,140401,377735625.0,1511,2023-11-08 18:25:00
621,YNDX,1175,711,269938641.0,141993860.0,99665,53649,2708.5,2646.7,153314,411932501.0,1886,1020,636,242261336.0,163724712.0,90309,54293,2682.6,3015.6,144602,405986048.0,1656,2023-11-08 18:30:00
622,YNDX,778,1072,109253403.0,164916189.0,41245,62447,2648.9,2640.9,103692,274169592.0,1850,663,990,101484187.0,160390548.0,38471,60587,2637.9,2647.3,99058,261874736.0,1653,2023-11-08 18:35:00
623,YNDX,1890,485,271385245.0,86953833.0,102660,32860,2643.5,2646.2,135520,358339078.0,2375,1813,432,272438136.0,88755209.0,103175,33533,2640.5,2646.8,136708,361193345.0,2245,2023-11-08 18:40:00
624,YNDX,3115,4325,431232203.0,1206039183.0,165705,438696,2602.4,2749.1,604401,1637271386.0,7440,2304,3699,386873530.0,1052467192.0,148209,402129,2610.3,2617.2,550338,1439340722.0,6003,2023-11-09 10:05:00
625,YNDX,2842,2014,470897985.0,399879825.0,179970,152561,2616.5,2621.1,332531,870777811.0,4856,2553,1815,435557999.0,383393438.0,166737,146342,2612.2,2619.8,313079,818951438.0,4368,2023-11-09 10:10:00
626,YNDX,1714,4550,334644312.0,886756747.0,128088,338532,2612.6,2619.4,466620,1221401059.0,6264,1552,4428,323425350.0,863890012.0,123816,329737,2612.1,2619.9,453553,1187315362.0,5980,2023-11-09 10:15:00
627,YNDX,1847,5420,243175547.0,1157660103.0,93081,442683,2612.5,2615.1,535764,1400835650.0,7267,1644,5279,225043435.0,1135705759.0,86250,434095,2609.2,2616.3,520345,1360749195.0,6923,2023-11-09 10:20:00
628,YNDX,20040,2945,7306053071.0,969042187.0,2795208,366178,2613.8,2646.4,3161386,8275095259.0,22985,19871,2843,7287095885.0,955172637.0,2788225,364356,2613.5,2621.5,3152581,8242268523.0,22714,2023-11-09 10:25:00
629,YNDX,677,465,74129658.0,64817725.0,28329,24659,2616.7,2628.6,52988,138947383.0,1142,516,360,61169735.0,52565607.0,23415,20002,2612.4,2628.0,43417,113735342.0,876,2023-11-09 10:30:00
630,YNDX,1292,874,417754090.0,226370443.0,159880,86303,2612.9,2623.0,246183,644124534.0,2166,1194,753,408078437.0,208841433.0,156250,79614,2611.7,2623.2,235864,616919870.0,1947,2023-11-09 10:35:00
631,YNDX,2567,9670,790536035.0,4081833047.0,302825,1559818,2610.5,2616.9,1862643,4872369083.0,12237,2396,9555,774789897.0,4066605272.0,296801,1553958,2610.5,2616.9,1850759,4841395169.0,11951,2023-11-09 10:40:00
632,YNDX,938,525,245221450.0,186188214.0,94142,71246,2604.8,2613.3,165388,431409664.0,1463,762,413,232998029.0,182145179.0,89425,69570,2605.5,2618.2,158995,415143208.0,1175,2023-11-09 10:45:00
633,YNDX,1566,1327,423787188.0,330914466.0,162780,126753,2603.4,2610.7,289533,754701655.0,2893,1213,1204,392869000.0,311090107.0,150947,119011,2602.7,2614.0,269958,703959107.0,2417,2023-11-09 10:50:00
634,YNDX,2473,3612,618783072.0,1470397834.0,237746,561824,2602.7,2617.2,799570,2089180906.0,6085,2073,3349,581879067.0,1420012054.0,223648,544655,2601.8,2607.2,768303,2001891121.0,5422,2023-11-09 10:55:00
635,YNDX,5987,14721,1268148175.0,7174762755.0,489519,2759606,2590.6,2599.9,3249125,8442910931.0,20708,4596,13929,1116848691.0,7057230818.0,431685,2710318,2587.2,2603.8,3142003,8174079510.0,18525,2023-11-09 11:00:00
636,YNDX,3647,5651,1042016042.0,1349367327.0,386340,519765,2697.1,2596.1,906105,2391383369.0,9298,3109,5343,1010543109.0,1311182450.0,376317,504579,2685.4,2598.6,880896,2321725559.0,8452,2023-11-09 11:05:00
637,YNDX,14150,10322,4972570672.0,2185038375.0,1912179,838937,2600.5,2604.5,2751116,7157609048.0,24472,13879,10107,4945469388.0,2170319044.0,1901894,833139,2600.3,2605.0,2735033,7115788433.0,23986,2023-11-09 11:10:00
638,YNDX,2641,2273,576806313.0,434990540.0,221997,166958,2598.3,2605.4,388955,1011796854.0,4914,2489,2093,548709328.0,419325754.0,211178,160922,2598.3,2605.8,372100,968035082.0,4582,2023-11-09 11:15:00
639,YNDX,2205,2502,498627258.0,491808861.0,191812,188793,2599.6,2605.0,380605,990436119.0,4707,2015,2373,475881904.0,480541822.0,183055,184425,2599.7,2605.6,367480,956423727.0,4388,2023-11-09 11:20:00
640,YNDX,2151,2295,408745572.0,393180964.0,157502,150978,2595.2,2604.2,308480,801926537.0,4446,2009,2197,388018912.0,386858333.0,149491,148562,2595.6,2604.0,298053,774877245.0,4206,2023-11-09 11:25:00
641,YNDX,5849,4153,1734002508.0,903753183.0,667214,347020,2598.9,2604.3,1014234,2637755691.0,10002,5604,3956,1717598238.0,885213771.0,661291,339666,2597.3,2606.1,1000957,2602812009.0,9560,2023-11-09 11:30:00
642,YNDX,4991,7540,1205752698.0,2135753498.0,463729,821137,2600.1,2601.0,1284866,3341506196.0,12531,4787,7354,1189383962.0,2109172361.0,457633,810593,2599.0,2602.0,1268226,3298556324.0,12141,2023-11-09 11:35:00
643,YNDX,5359,5530,1213990981.0,1332917399.0,466964,512081,2599.8,2602.9,979045,2546908380.0,10889,5155,5384,1192019418.0,1315336074.0,458870,505282,2597.7,2603.2,964152,2507355492.0,10539,2023-11-09 11:40:00
644,YNDX,2238,2090,494422980.0,391878027.0,190481,150381,2595.7,2605.9,340862,886301007.0,4328,2094,2006,485585879.0,386134556.0,187160,148149,2594.5,2606.4,335309,871720436.0,4100,2023-11-09 11:45:00
645,YNDX,1182,1504,229698423.0,250624265.0,88526,96202,2594.7,2605.2,184728,480322688.0,2686,1083,1408,215955051.0,246882471.0,83189,94737,2596.0,2606.0,177926,462837523.0,2491,2023-11-09 11:50:00
646,YNDX,14715,2695,3917786751.0,465776150.0,1496434,178656,2618.1,2607.1,1675090,4383562901.0,17410,14562,2621,3879836184.0,461954680.0,1491441,177172,2601.4,2607.4,1668613,4341790864.0,17183,2023-11-09 11:55:00
647,YNDX,3328,819,915027892.0,142155190.0,351798,54493,2601.0,2608.7,406291,1057183082.0,4147,3228,764,909865386.0,140421568.0,349823,53809,2600.9,2609.6,403632,1050286954.0,3992,2023-11-09 12:00:00
648,YNDX,728,835,170743090.0,109991848.0,60586,42154,2818.2,2609.3,102740,280734939.0,1563,568,728,150809079.0,106259611.0,58057,40717,2597.6,2609.7,98774,257068690.0,1296,2023-11-09 12:05:00
649,YNDX,1375,1604,388132157.0,250769206.0,149245,96202,2600.6,2606.7,245447,638901364.0,2979,1310,1496,384727760.0,248684323.0,147986,95381,2599.8,2607.3,243367,633412083.0,2806,2023-11-09 12:10:00
650,YNDX,3276,2326,653204319.0,343701440.0,251112,131801,2601.2,2607.7,382913,996905760.0,5602,3174,2200,648495034.0,341086304.0,249327,130799,2601.0,2607.7,380126,989581339.0,5374,2023-11-09 12:15:00
651,YNDX,4166,3905,1141719214.0,634760322.0,434204,243335,2629.5,2608.6,677539,1776479536.0,8071,4036,3704,1139754715.0,628576799.0,432826,240956,2633.3,2608.7,673782,1768331515.0,7740,2023-11-09 12:20:00
652,YNDX,4347,5323,1149763396.0,907755983.0,441987,346461,2601.4,2620.1,788448,2057519380.0,9670,4202,5105,1143781304.0,885926191.0,439826,339820,2600.5,2607.0,779646,2029707495.0,9307,2023-11-09 12:25:00
653,YNDX,2528,2401,612955846.0,445475829.0,235894,170967,2598.4,2605.6,406861,1058431675.0,4929,2446,2313,605110716.0,442220859.0,232879,169695,2598.4,2606.0,402574,1047331575.0,4759,2023-11-09 12:30:00
654,YNDX,724,918,180233186.0,174416665.0,69440,66911,2595.5,2606.7,136351,354649852.0,1642,635,778,178329302.0,170963426.0,68720,65569,2595.0,2607.4,134289,349292728.0,1413,2023-11-09 12:35:00
655,YNDX,1426,2329,368131517.0,363265963.0,141766,139456,2596.8,2604.9,281222,731397480.0,3755,1319,2126,365199291.0,354693696.0,140674,136152,2596.1,2605.1,276826,719892987.0,3445,2023-11-09 12:40:00
656,YNDX,1116,1925,229040162.0,304214220.0,88212,116813,2596.5,2604.3,205025,533254382.0,3041,975,1736,223281207.0,301168448.0,86004,115622,2596.2,2604.8,201626,524449656.0,2711,2023-11-09 12:45:00
657,YNDX,6450,2437,1561305291.0,407709084.0,600663,156534,2599.3,2604.6,757197,1969014375.0,8887,6351,2296,1555572888.0,401271796.0,598490,153972,2599.2,2606.1,752462,1956844684.0,8647,2023-11-09 12:50:00
658,YNDX,4345,1814,1120940479.0,310358719.0,431284,119173,2599.1,2604.3,550457,1431299199.0,6159,4219,1645,1114382143.0,294515206.0,428867,113049,2598.4,2605.2,541916,1408897350.0,5864,2023-11-09 12:55:00
659,YNDX,1570,2034,341676181.0,320638281.0,131462,123007,2599.0,2606.7,254469,662314462.0,3604,1489,1906,332353862.0,310229188.0,127964,119050,2597.2,2605.9,247014,642583051.0,3395,2023-11-09 13:00:00
660,YNDX,3443,4748,825988163.0,1048705510.0,317232,404003,2603.7,2595.8,721235,1874693673.0,8191,3286,4542,823849055.0,1018040104.0,316441,391455,2603.5,2600.7,707896,1841889159.0,7828,2023-11-09 13:05:00
661,YNDX,2241,6135,471531749.0,1444760307.0,181818,555557,2593.4,2600.6,737375,1916292057.0,8376,2079,5954,459622337.0,1441292914.0,177233,554225,2593.3,2600.6,731458,1900915252.0,8033,2023-11-09 13:10:00
662,YNDX,2672,2901,602463074.0,628200643.0,232178,241223,2594.8,2604.2,473401,1230663718.0,5573,2620,2774,600827459.0,612715540.0,231580,235272,2594.5,2604.3,466852,1213542999.0,5394,2023-11-09 13:15:00
663,YNDX,2850,10540,500231392.0,2376264204.0,192754,913601,2595.2,2601.0,1106355,2876495597.0,13390,2796,10442,498216008.0,2368786873.0,192006,910719,2594.8,2601.0,1102725,2867002881.0,13238,2023-11-09 13:20:00
664,YNDX,1299,5390,281453876.0,1549556770.0,108470,595519,2594.8,2602.0,703989,1831010647.0,6689,1202,5253,280239094.0,1541684938.0,108023,592431,2594.3,2602.3,700454,1821924032.0,6455,2023-11-09 13:25:00
665,YNDX,1431,3156,242057146.0,579247377.0,93368,222786,2592.5,2600.0,316154,821304523.0,4587,1341,3062,235947114.0,577503929.0,91019,222073,2592.3,2600.5,313092,813451043.0,4403,2023-11-09 13:30:00
666,YNDX,968,1325,197303257.0,246542943.0,76083,94680,2593.3,2604.0,170763,443846200.0,2293,860,1197,192335507.0,245071397.0,74176,94110,2593.0,2604.1,168286,437406904.0,2057,2023-11-09 13:35:00
667,YNDX,522,817,141829527.0,154790382.0,54671,59431,2594.2,2604.5,114102,296619909.0,1339,464,696,141116539.0,153320302.0,54423,58845,2593.0,2605.5,113268,294436841.0,1160,2023-11-09 13:40:00
668,YNDX,1164,2152,305752582.0,611349127.0,117303,234809,2606.5,2603.6,352112,917101709.0,3316,1043,1982,287143942.0,605720977.0,110659,232639,2594.9,2603.7,343298,892864920.0,3025,2023-11-09 13:45:00
669,YNDX,3087,7580,522357779.0,2073634793.0,201300,797373,2594.9,2600.6,998673,2595992572.0,10667,3023,7453,521097496.0,2066540341.0,200318,794580,2601.4,2600.8,994898,2587637837.0,10476,2023-11-09 13:50:00
670,YNDX,2230,6956,457834416.0,1929424613.0,176450,741821,2594.7,2600.9,918271,2387259029.0,9186,2141,6821,448657698.0,1921369037.0,172943,738692,2594.3,2601.0,911635,2370026736.0,8962,2023-11-09 13:55:00
671,YNDX,1561,13421,296480309.0,3620227446.0,114278,1392556,2594.4,2599.7,1506834,3916707755.0,14982,1503,13306,299995739.0,3620938366.0,115649,1392799,2594.0,2599.8,1508448,3920934105.0,14809,2023-11-09 14:00:00
672,YNDX,825,4529,170271834.0,1347409770.0,65701,518242,2591.6,2600.0,583943,1517681605.0,5354,752,4374,174037602.0,1346606268.0,67169,517918,2591.0,2600.0,585087,1520643871.0,5126,2023-11-09 14:05:00
673,YNDX,4562,10457,852136021.0,3181610705.0,328430,1226038,2594.6,2595.0,1554468,4033746727.0,15019,4398,10314,838190884.0,3149687756.0,323090,1213347,2594.3,2595.9,1536437,3987878641.0,14712,2023-11-09 14:10:00
674,YNDX,2453,7027,455818926.0,2071134471.0,175943,797270,2590.7,2597.8,973213,2526953398.0,9480,2336,6906,447387695.0,2071651704.0,172719,797294,2590.3,2598.4,970013,2519039400.0,9242,2023-11-09 14:15:00
675,YNDX,925,966,154312918.0,195498666.0,59517,75201,2592.8,2599.7,134718,349811585.0,1891,877,921,153761720.0,193127338.0,59335,74257,2591.4,2600.8,133592,346889059.0,1798,2023-11-09 14:20:00
676,YNDX,2407,2917,376729631.0,853041650.0,145075,327901,2596.8,2601.5,472976,1229771282.0,5324,2058,2855,375378183.0,848691593.0,144720,326217,2593.8,2601.6,470937,1224069776.0,4913,2023-11-09 14:25:00
677,YNDX,1385,3611,196919730.0,845797158.0,75817,325090,2597.3,2601.7,400907,1042716889.0,4996,1276,3581,197437018.0,846609103.0,76129,325400,2593.5,2601.7,401529,1044046122.0,4857,2023-11-09 14:30:00
678,YNDX,4927,4106,742646879.0,1266449242.0,284942,486067,2606.3,2605.5,771009,2009096121.0,9033,4835,4029,718888811.0,1249537159.0,276339,479474,2601.5,2606.1,755813,1968425970.0,8864,2023-11-09 14:35:00
679,YNDX,2713,1340,535028440.0,198734229.0,205958,76347,2597.8,2603.0,282305,733762670.0,4053,2648,1293,534811369.0,195486390.0,205907,75032,2597.3,2605.4,280939,730297759.0,3941,2023-11-09 14:40:00
680,YNDX,637,669,80240088.0,137680414.0,30869,52815,2599.4,2606.8,83684,217920503.0,1306,576,643,79345797.0,135952035.0,30544,52128,2597.8,2608.0,82672,215297833.0,1219,2023-11-09 14:45:00
681,YNDX,2920,2612,481313661.0,491303088.0,184891,188302,2603.2,2609.1,373193,972616749.0,5532,2773,2513,471514331.0,484302139.0,181207,185525,2602.1,2610.4,366732,955816470.0,5286,2023-11-09 14:50:00
682,YNDX,1300,3152,236729102.0,929664726.0,90956,356398,2602.7,2608.5,447354,1166393828.0,4452,1240,3113,228573162.0,924147476.0,87864,354276,2601.4,2608.6,442140,1152720638.0,4353,2023-11-09 14:55:00
683,YNDX,1178,6511,214844114.0,1341864223.0,82337,514253,2609.3,2609.3,596590,1556708337.0,7689,1077,6439,209627585.0,1339155714.0,80537,513213,2602.9,2609.4,593750,1548783299.0,7516,2023-11-09 15:00:00
684,YNDX,9067,5512,1131474862.0,1158304325.0,433557,442583,2609.7,2617.1,876140,2289779188.0,14579,8872,5428,1117207298.0,1153288026.0,428214,440655,2609.0,2617.2,868869,2270495325.0,14300,2023-11-09 15:05:00
685,YNDX,713,981,128331444.0,222157191.0,49246,84997,2605.9,2613.7,134243,350488635.0,1694,655,925,123994249.0,222153376.0,47615,84949,2604.1,2615.1,132564,346147625.0,1580,2023-11-09 15:10:00
686,YNDX,1927,2136,401011618.0,529643332.0,153716,202544,2608.8,2615.0,356260,930654951.0,4063,1818,2041,382189168.0,517481759.0,146572,197849,2607.5,2615.5,344421,899670928.0,3859,2023-11-09 15:15:00
687,YNDX,2167,4444,443761734.0,1321857050.0,170491,506320,2602.8,2610.7,676811,1765618784.0,6611,2068,4363,436331762.0,1301813857.0,167672,498564,2602.3,2611.1,666236,1738145620.0,6431,2023-11-09 15:20:00
688,YNDX,1031,987,194598428.0,214885544.0,74738,82250,2603.7,2612.6,156988,409483972.0,2018,960,927,191451552.0,212258939.0,73555,81208,2602.8,2613.8,154763,403710491.0,1887,2023-11-09 15:25:00
689,YNDX,1301,3449,173110349.0,954041600.0,66498,365694,2603.2,2608.9,432192,1127151950.0,4750,1236,3421,166686610.0,953584071.0,64045,365516,2602.6,2608.9,429561,1120270681.0,4657,2023-11-09 15:30:00
690,YNDX,1214,4915,184612078.0,1338607125.0,70921,513063,2603.1,2609.1,583984,1523219204.0,6129,1177,4880,182210933.0,1338007382.0,70007,512802,2602.8,2609.2,582809,1520218316.0,6057,2023-11-09 15:35:00
691,YNDX,1135,2141,190314488.0,738733045.0,73182,283294,2600.6,2607.7,356476,929047534.0,3276,1083,2118,192917344.0,739779955.0,74177,283618,2600.8,2608.4,357795,932697299.0,3201,2023-11-09 15:40:00
692,YNDX,557,1652,85434552.0,374130112.0,32845,143412,2601.1,2608.8,176257,459564665.0,2209,519,1616,85751641.0,371630392.0,32979,142457,2600.2,2608.7,175436,457382033.0,2135,2023-11-09 15:45:00
693,YNDX,687,914,81290310.0,217517381.0,31242,83341,2602.0,2610.0,114583,298807691.0,1601,668,883,80901273.0,216009751.0,31115,82763,2600.1,2610.0,113878,296911025.0,1551,2023-11-09 15:50:00
694,YNDX,1704,6564,274672122.0,2002378171.0,105531,766902,2602.8,2611.0,872433,2277050294.0,8268,1516,6508,249164769.0,1996541993.0,95764,765196,2601.9,2609.2,860960,2245706763.0,8024,2023-11-09 15:55:00
695,YNDX,667,5810,125337978.0,1481751929.0,48172,567865,2601.9,2609.3,616037,1607089907.0,6477,595,5758,120596954.0,1483257628.0,46352,568429,2601.8,2609.4,614781,1603854583.0,6353,2023-11-09 16:00:00
696,YNDX,1195,2508,192008954.0,656632397.0,73793,251562,2602.0,2610.2,325355,848641352.0,3703,1116,2449,188371454.0,651196631.0,72419,249476,2601.1,2610.3,321895,839568085.0,3565,2023-11-09 16:05:00
697,YNDX,1574,2700,250130547.0,869227327.0,96101,333083,2602.8,2609.6,429184,1119357874.0,4274,1545,2671,250848094.0,867563587.0,96406,332450,2602.0,2609.6,428856,1118411682.0,4216,2023-11-09 16:10:00
698,YNDX,644,1687,129517445.0,616380807.0,49759,236186,2602.9,2609.7,285945,745898253.0,2331,572,1626,127686235.0,616389130.0,49094,236179,2600.9,2609.8,285273,744075365.0,2198,2023-11-09 16:15:00
699,YNDX,1120,2879,246935199.0,916241753.0,94843,351160,2603.6,2609.2,446003,1163176952.0,3999,1002,2774,233658375.0,903784708.0,89839,346319,2600.9,2609.7,436158,1137443083.0,3776,2023-11-09 16:20:00
700,YNDX,433,3308,89593778.0,710292277.0,34407,272246,2603.9,2609.0,306653,799886055.0,3741,355,3242,91398795.0,708288913.0,35157,271458,2599.7,2609.2,306615,799687708.0,3597,2023-11-09 16:25:00
701,YNDX,2816,2695,487747660.0,652611395.0,187280,250166,2604.4,2608.7,437446,1140359055.0,5511,2669,2604,481651789.0,648038100.0,185011,248272,2603.4,2610.2,433283,1129689889.0,5273,2023-11-09 16:30:00
702,YNDX,1834,4057,299001046.0,1083710549.0,114951,415550,2601.1,2607.9,530501,1382711595.0,5891,1687,3991,295644714.0,1070949157.0,113690,410611,2600.4,2608.2,524301,1366593871.0,5678,2023-11-09 16:35:00
703,YNDX,9248,14466,1881239778.0,5161150285.0,702034,1987134,2679.7,2597.3,2689168,7042390063.0,23714,8506,14108,1778968557.0,5079219268.0,664446,1952747,2677.4,2601.1,2617193,6858187825.0,22614,2023-11-09 16:40:00
704,YNDX,1700,2674,398941895.0,736146035.0,151434,282722,2634.4,2603.8,434156,1135087930.0,4374,1526,2506,391686905.0,727145951.0,148448,279233,2638.5,2604.1,427681,1118832856.0,4032,2023-11-09 16:45:00
705,YNDX,2880,2690,600953355.0,620366913.0,231453,238242,2596.4,2603.9,469695,1221320269.0,5570,2742,2570,587189856.0,614744747.0,226305,236067,2594.7,2604.1,462372,1201934604.0,5312,2023-11-09 16:50:00
706,YNDX,1687,5339,304575386.0,1236293543.0,117104,474880,2600.9,2603.4,591984,1540868929.0,7026,1575,5233,291763337.0,1229335593.0,112364,472179,2596.6,2603.5,584543,1521098930.0,6808,2023-11-09 16:55:00
707,YNDX,1161,1599,244050482.0,347475774.0,93893,133338,2599.2,2606.0,227231,591526256.0,2760,1059,1504,240632957.0,344085486.0,92640,131996,2597.5,2606.8,224636,584718443.0,2563,2023-11-09 17:00:00
708,YNDX,337,375,92169572.0,78434977.0,36873,30093,2499.6,2606.4,66966,170604549.0,712,272,319,68498935.0,77239361.0,26412,29615,2593.5,2608.1,56027,145738296.0,591,2023-11-09 17:05:00
709,YNDX,5352,1214,711724417.0,269576682.0,273909,103750,2598.4,2598.3,377659,981301100.0,6566,5274,1162,708589917.0,259261490.0,272713,99589,2598.3,2603.3,372302,967851407.0,6436,2023-11-09 17:10:00
710,YNDX,1456,3047,190467939.0,775117766.0,73424,297993,2594.1,2601.1,371417,965585706.0,4503,1352,2976,187389035.0,769809439.0,72259,295941,2593.3,2601.2,368200,957198474.0,4328,2023-11-09 17:15:00
711,YNDX,2903,4059,422362230.0,571346328.0,162377,219493,2601.1,2603.0,381870,993708559.0,6962,2881,4029,418113684.0,570831959.0,160972,219291,2597.4,2603.1,380263,988945644.0,6910,2023-11-09 17:20:00
712,YNDX,5166,2775,1429839093.0,365158884.0,550614,140319,2596.8,2602.3,690933,1794997977.0,7941,5109,2716,1428659831.0,360615308.0,550177,138536,2596.7,2603.0,688713,1789275140.0,7825,2023-11-09 17:25:00
713,YNDX,1791,12710,373862901.0,1852130389.0,143736,711837,2601.0,2601.9,855573,2225993290.0,14501,1712,12656,368527183.0,1850805640.0,141927,711304,2596.6,2602.0,853231,2219332824.0,14368,2023-11-09 17:30:00
714,YNDX,3528,831,1361703980.0,101681385.0,524387,39024,2596.8,2605.6,563411,1463385366.0,4359,3491,763,1360188758.0,98136954.0,523816,37654,2596.7,2606.3,561470,1458325713.0,4254,2023-11-09 17:35:00
715,YNDX,1500,1220,540589671.0,147665561.0,208105,56706,2597.7,2604.1,264811,688255232.0,2720,1404,1124,540426598.0,147346992.0,208091,56573,2597.1,2604.5,264664,687773590.0,2528,2023-11-09 17:40:00
716,YNDX,4325,856,1457747081.0,119140064.0,561206,45774,2597.5,2602.8,606980,1576887145.0,5181,4272,808,1454119582.0,116323474.0,559814,44649,2597.5,2605.3,604463,1570443057.0,5080,2023-11-09 17:45:00
717,YNDX,829,330,199086516.0,29177851.0,76670,11184,2596.7,2608.9,87854,228264367.0,1159,765,279,196939348.0,27756366.0,75856,10635,2596.2,2609.9,86491,224695715.0,1044,2023-11-09 17:50:00
718,YNDX,2799,757,950360433.0,93917327.0,365747,36005,2598.4,2608.5,401752,1044277760.0,3556,2747,698,943429845.0,89562283.0,363109,34328,2598.2,2609.0,397437,1032992128.0,3445,2023-11-09 17:55:00
719,YNDX,6084,2463,1008639241.0,307230022.0,387785,117896,2601.0,2605.9,505681,1315869263.0,8547,6015,2408,1004469231.0,304600866.0,386174,116883,2601.1,2606.0,503057,1309070098.0,8423,2023-11-09 18:00:00
720,YNDX,2955,1354,707273565.0,160788495.0,272092,61702,2599.4,2605.9,333794,868062061.0,4309,2931,1326,712832599.0,159318898.0,274264,61105,2599.1,2607.3,335369,872151498.0,4257,2023-11-09 18:05:00
721,YNDX,7191,2650,1910343100.0,395383547.0,723754,151599,2639.5,2608.1,875353,2305726647.0,9841,7091,2511,1860989229.0,379010628.0,715237,145259,2601.9,2609.2,860496,2239999858.0,9602,2023-11-09 18:10:00
722,YNDX,10112,2500,2334413412.0,330431324.0,896668,126694,2603.4,2608.1,1023362,2664844736.0,12612,9971,2407,2329142804.0,326938313.0,894682,125305,2603.3,2609.1,1019987,2656081117.0,12378,2023-11-09 18:15:00
723,YNDX,1472,1560,444754223.0,179118286.0,172379,68975,2580.1,2596.9,241354,623872510.0,3032,1407,1500,420259865.0,173944200.0,161600,66719,2600.6,2607.1,228319,594204065.0,2907,2023-11-09 18:20:00
724,YNDX,6742,3883,1809328756.0,471922821.0,687745,180945,2630.8,2608.1,868690,2281251578.0,10625,6650,3763,1815409743.0,458657115.0,687718,175859,2639.8,2608.1,863577,2274066858.0,10413,2023-11-09 18:25:00
725,YNDX,4371,1517,1306070054.0,223139996.0,487408,85584,2679.6,2607.3,572992,1529210050.0,5888,4272,1356,1273960003.0,199232991.0,481497,76249,2645.8,2612.9,557746,1473192995.0,5628,2023-11-09 18:30:00
726,YNDX,2862,1076,1005670594.0,146610217.0,376559,56141,2670.7,2611.5,432700,1152280811.0,3938,2808,971,1003581663.0,138463182.0,375067,52944,2675.7,2615.3,428011,1142044846.0,3779,2023-11-09 18:35:00
727,YNDX,5271,1451,1809562177.0,189220396.0,693495,72468,2609.3,2611.1,765963,1998782573.0,6722,5221,1337,1805496120.0,179847425.0,691974,68763,2609.2,2615.5,760737,1985343545.0,6558,2023-11-09 18:40:00
728,YNDX,2423,3673,336404524.0,671038554.0,129642,233882,2594.9,2869.1,363524,1007443079.0,6096,1783,3001,298816063.0,567517548.0,114547,216779,2608.7,2618.0,331326,866333612.0,4784,2023-11-10 10:05:00
729,YNDX,4393,7349,619617037.0,1115062185.0,237079,425763,2613.5,2619.0,662842,1734679222.0,11742,4215,7155,611792596.0,1042327795.0,234163,398131,2612.7,2618.1,632294,1654120391.0,11370,2023-11-10 10:10:00
730,YNDX,2105,2160,417407232.0,331709704.0,160181,126923,2605.8,2613.5,287104,749116936.0,4265,1925,2021,409694657.0,324140431.0,157277,123959,2604.9,2614.9,281236,733835088.0,3946,2023-11-10 10:15:00
731,YNDX,966,2013,146465757.0,350188860.0,56271,133868,2602.9,2615.9,190139,496654617.0,2979,806,1916,136970435.0,343816471.0,52591,131452,2604.4,2615.5,184043,480786907.0,2722,2023-11-10 10:20:00
732,YNDX,1887,2466,424245127.0,584470190.0,162590,223126,2609.3,2619.5,385716,1008715317.0,4353,1724,2338,411988525.0,568591020.0,157914,217100,2608.9,2619.0,375014,980579546.0,4062,2023-11-10 10:25:00
733,YNDX,1065,1931,204977941.0,487973319.0,78566,186278,2609.0,2619.6,264844,692951261.0,2996,951,1827,197197895.0,477831929.0,75582,182512,2609.1,2618.1,258094,675029824.0,2778,2023-11-10 10:30:00
734,YNDX,2899,3606,477651082.0,701780510.0,183078,268247,2609.0,2616.2,451325,1179431592.0,6505,2758,3506,470060275.0,692071727.0,180181,264482,2608.8,2616.7,444663,1162132002.0,6264,2023-11-10 10:35:00
735,YNDX,1753,4207,207332763.0,1579073637.0,79559,604517,2606.0,2612.1,684076,1786406401.0,5960,1636,4132,202185029.0,1572957046.0,77602,601970,2605.4,2613.0,679572,1775142076.0,5768,2023-11-10 10:40:00
736,YNDX,4751,7842,991821351.0,2429256076.0,372808,934129,2660.4,2600.6,1306937,3421077427.0,12593,4268,7534,918747369.0,2373005744.0,346371,910590,2652.5,2606.0,1256961,3291753113.0,11802,2023-11-10 10:45:00
737,YNDX,5556,14228,1364425267.0,6497359874.0,517267,2501239,2637.8,2597.7,3018506,7861785141.0,19784,5020,13974,1293370889.0,6447587282.0,490842,2480504,2635.0,2599.3,2971346,7740958171.0,18994,2023-11-10 10:50:00
738,YNDX,1702,1982,374339209.0,368101451.0,144174,141224,2596.4,2606.5,285398,742440660.0,3684,1562,1877,361808214.0,362037401.0,139370,138876,2596.0,2606.9,278246,723845616.0,3439,2023-11-10 10:55:00
739,YNDX,957,903,204536946.0,186628491.0,78712,71581,2598.5,2607.2,150293,391165437.0,1860,785,822,197523460.0,181944847.0,76099,69759,2595.6,2608.2,145858,379468308.0,1607,2023-11-10 11:00:00
740,YNDX,2250,6304,396156897.0,1938719693.0,152440,744770,2598.8,2603.1,897210,2334876590.0,8554,2103,6217,386561101.0,1928055582.0,148763,740278,2598.5,2604.5,889041,2314616683.0,8320,2023-11-10 11:05:00
741,YNDX,1147,13861,206922837.0,2041250230.0,79645,783763,2598.1,2604.4,863408,2248173067.0,15008,1021,13768,203338598.0,2040310018.0,78302,783278,2596.9,2604.8,861580,2243648616.0,14789,2023-11-10 11:10:00
742,YNDX,595,612,117930823.0,119230177.0,45473,45725,2593.4,2607.5,91198,237161001.0,1207,502,564,112461416.0,117765314.0,43312,45149,2596.5,2608.4,88461,230226731.0,1066,2023-11-10 11:15:00
743,YNDX,676,3870,112998318.0,802874938.0,43522,308306,2596.3,2604.1,351828,915873256.0,4546,642,3811,114974316.0,795697760.0,44304,305556,2595.1,2604.1,349860,910672076.0,4453,2023-11-10 11:20:00
744,YNDX,1218,3668,253474967.0,812782190.0,97390,312044,2602.7,2604.7,409434,1066257157.0,4886,1100,3578,214130438.0,807452808.0,82412,310025,2598.3,2604.5,392437,1021583246.0,4678,2023-11-10 11:25:00
745,YNDX,1779,3822,311399227.0,1373758806.0,119812,527138,2599.1,2606.1,646950,1685158033.0,5601,1637,3751,289431610.0,1370432966.0,111314,525834,2600.1,2606.2,637148,1659864577.0,5388,2023-11-10 11:30:00
746,YNDX,689,1817,130542869.0,551459511.0,50263,211636,2597.2,2605.7,261899,682002380.0,2506,583,1737,127936367.0,545369183.0,49266,209264,2596.8,2606.1,258530,673305551.0,2320,2023-11-10 11:35:00
747,YNDX,946,922,192907384.0,211432299.0,74174,81323,2600.7,2599.9,155497,404339683.0,1868,818,823,181882986.0,186985895.0,70076,71747,2595.5,2606.2,141823,368868881.0,1641,2023-11-10 11:40:00
748,YNDX,1250,2131,236056997.0,453974904.0,90938,174606,2595.8,2600.0,265544,690031902.0,3381,1080,2047,223514782.0,455221945.0,86150,174836,2594.5,2603.7,260986,678736727.0,3127,2023-11-10 11:45:00
749,YNDX,1223,2248,211112904.0,624233307.0,81260,239558,2598.0,2605.8,320818,835346212.0,3471,1117,2176,207479222.0,621636511.0,79884,238556,2597.3,2605.8,318440,829115733.0,3293,2023-11-10 11:50:00
750,YNDX,1761,2129,293447417.0,481383007.0,112750,184439,2602.6,2610.0,297189,774830424.0,3890,1650,1973,292882159.0,475305978.0,112576,182049,2601.6,2610.9,294625,768188137.0,3623,2023-11-10 11:55:00
751,YNDX,2287,3830,370967783.0,879315578.0,142616,337171,2601.2,2607.9,479787,1250283362.0,6117,2121,3739,364156267.0,873050420.0,140009,334688,2600.9,2608.6,474697,1237206687.0,5860,2023-11-10 12:00:00
752,YNDX,1565,2997,251110742.0,584110547.0,96493,223841,2602.4,2609.5,320334,835221290.0,4562,1485,2928,246015817.0,580466572.0,94555,222458,2601.8,2609.3,317013,826482390.0,4413,2023-11-10 12:05:00
753,YNDX,1336,1776,231998258.0,623129927.0,89265,239066,2599.0,2606.5,328331,855128185.0,3112,1228,1669,221879811.0,615978345.0,85396,236276,2598.2,2607.0,321672,837858156.0,2897,2023-11-10 12:10:00
754,YNDX,6325,15715,874529150.0,3886423657.0,336321,1492453,2600.3,2604.1,1828774,4760952807.0,22040,6239,15623,872300584.0,3882232975.0,335485,1490737,2600.1,2604.2,1826222,4754533559.0,21862,2023-11-10 12:15:00
755,YNDX,3357,12242,651554447.0,4632142550.0,250746,1778832,2598.5,2604.0,2029578,5283696997.0,15599,3032,12104,622367159.0,4599005016.0,239791,1768552,2595.5,2600.4,2008343,5221372176.0,15136,2023-11-10 12:20:00
756,YNDX,2741,7496,550867266.0,2515654414.0,212595,968229,2591.2,2598.2,1180824,3066521681.0,10237,2476,7381,520585458.0,2488089810.0,201018,957466,2589.7,2598.6,1158484,3008675268.0,9857,2023-11-10 12:25:00
757,YNDX,2522,8432,515893512.0,2132829141.0,199050,820312,2591.8,2600.0,1019362,2648722654.0,10954,2273,8290,480746203.0,2117062325.0,185587,812119,2590.4,2606.8,997706,2597808528.0,10563,2023-11-10 12:30:00
758,YNDX,4529,3740,1397894464.0,666387359.0,539230,256439,2592.4,2598.6,795669,2064281824.0,8269,4337,3620,1391764095.0,646458326.0,536857,248731,2592.4,2599.0,785588,2038222422.0,7957,2023-11-10 12:35:00
759,YNDX,4397,2276,1085425220.0,426249375.0,418705,164043,2592.3,2598.4,582748,1511674595.0,6673,4239,2180,1077933629.0,416847179.0,415840,160388,2592.2,2599.0,576228,1494780808.0,6419,2023-11-10 12:40:00
760,YNDX,1464,1417,316099813.0,255524317.0,121998,98265,2591.0,2600.4,220263,571624130.0,2881,1303,1327,307064192.0,251584622.0,118529,96744,2590.6,2600.5,215273,558648814.0,2630,2023-11-10 12:45:00
761,YNDX,2483,2350,626256568.0,457541622.0,241286,175920,2595.5,2600.9,417206,1083798190.0,4833,2368,2236,619892696.0,446598030.0,238993,171696,2593.8,2601.1,410689,1066490726.0,4604,2023-11-10 12:50:00
762,YNDX,3581,5778,806220183.0,847449012.0,310955,326298,2592.7,2597.2,637253,1653669195.0,9359,3433,5670,803863878.0,839966245.0,310076,323254,2592.5,2598.5,633330,1643830124.0,9103,2023-11-10 12:55:00
763,YNDX,2300,2222,446656796.0,404686131.0,172350,155846,2591.6,2596.7,328196,851342928.0,4522,2139,2121,442995117.0,401202984.0,171017,154460,2590.4,2597.5,325477,844198101.0,4260,2023-11-10 13:00:00
764,YNDX,1310,1303,258596962.0,231275289.0,99819,89025,2590.7,2597.9,188844,489872252.0,2613,1186,1231,255295494.0,229377514.0,98569,88287,2590.0,2598.1,186856,484673008.0,2417,2023-11-10 13:05:00
765,YNDX,837,1094,161222265.0,219361606.0,62291,84505,2588.2,2595.8,146796,380583871.0,1931,694,957,158349880.0,215049140.0,61220,82782,2586.6,2597.8,144002,373399020.0,1651,2023-11-10 13:10:00
766,YNDX,485,771,101673317.0,148821765.0,39292,57298,2587.6,2597.3,96590,250495083.0,1256,365,682,99499450.0,147338142.0,38464,56713,2586.8,2598.0,95177,246837592.0,1047,2023-11-10 13:15:00
767,YNDX,1732,1341,400429522.0,268432525.0,154511,103314,2591.6,2598.2,257825,668862047.0,3073,1577,1249,390696166.0,264102453.0,150796,101617,2590.9,2599.0,252413,654798619.0,2826,2023-11-10 13:20:00
768,YNDX,1786,754,364514508.0,169510671.0,140677,65270,2591.1,2597.1,205947,534025180.0,2540,1674,678,367974453.0,164797376.0,142051,63388,2590.4,2599.8,205439,532771829.0,2352,2023-11-10 13:25:00
769,YNDX,827,1133,140014451.0,178834838.0,54069,68818,2589.6,2598.7,122887,318849290.0,1960,726,1090,135729337.0,177431581.0,52422,68267,2589.2,2599.1,120689,313160918.0,1816,2023-11-10 13:30:00
770,YNDX,1609,973,363603617.0,224267426.0,140277,86352,2592.0,2597.1,226629,587871043.0,2582,1458,914,358701278.0,223007755.0,138422,85754,2591.4,2600.6,224176,581709034.0,2372,2023-11-10 13:35:00
771,YNDX,1558,2372,304992156.0,417891248.0,117729,160911,2590.6,2597.0,278640,722883404.0,3930,1468,2277,305503388.0,415014556.0,118055,159744,2587.8,2598.0,277799,720517944.0,3745,2023-11-10 13:40:00
772,YNDX,956,1779,182821937.0,329981783.0,70639,127792,2588.1,2582.2,198431,512803720.0,2735,864,1661,178147146.0,313631510.0,68857,120823,2587.2,2595.8,189680,491778657.0,2525,2023-11-10 13:45:00
773,YNDX,1302,1237,226109747.0,242389854.0,87403,93741,2587.0,2585.7,181144,468499601.0,2539,1134,1134,213574454.0,229459781.0,82590,88411,2586.0,2595.4,171001,443034236.0,2268,2023-11-10 13:50:00
774,YNDX,845,1166,132295513.0,183800183.0,51148,70841,2586.5,2594.5,121989,316095697.0,2011,710,1097,127872559.0,182757249.0,49444,70414,2586.2,2595.5,119858,310629808.0,1807,2023-11-10 13:55:00
775,YNDX,3201,1094,937078281.0,230807194.0,361776,88923,2590.2,2595.6,450699,1167885476.0,4295,3054,1038,934212611.0,225617615.0,360687,86912,2590.1,2595.9,447599,1159830226.0,4092,2023-11-10 14:00:00
776,YNDX,683,488,121857277.0,138439868.0,47062,53239,2589.3,2600.3,100301,260297145.0,1171,599,428,114087562.0,135254467.0,44086,52013,2587.8,2600.4,96099,249342029.0,1027,2023-11-10 14:05:00
777,YNDX,896,1463,255907334.0,334570861.0,98774,128843,2590.8,2596.7,227617,590478195.0,2359,766,1389,246411675.0,325869669.0,95176,125407,2589.0,2598.5,220583,572281345.0,2155,2023-11-10 14:10:00
778,YNDX,723,1401,112852897.0,324616775.0,43582,124993,2589.4,2597.1,168575,437469672.0,2124,662,1338,112054756.0,318090615.0,43288,122433,2588.6,2598.1,165721,430145371.0,2000,2023-11-10 14:15:00
779,YNDX,999,489,149620800.0,140540356.0,57711,54073,2592.6,2599.1,111784,290161157.0,1488,912,445,147195638.0,133161923.0,56822,51228,2590.5,2599.4,108050,280357561.0,1357,2023-11-10 14:20:00
780,YNDX,4341,701,1251974755.0,157462490.0,482627,60517,2594.1,2602.0,543144,1409437246.0,5042,4227,631,1238757313.0,154624741.0,477619,59405,2593.6,2602.9,537024,1393382055.0,4858,2023-11-10 14:25:00
781,YNDX,1591,782,426841942.0,183887718.0,164400,70608,2596.4,2604.3,235008,610729660.0,2373,1439,668,416479829.0,177531295.0,160464,68159,2595.5,2604.7,228623,594011124.0,2107,2023-11-10 14:30:00
782,YNDX,1746,1265,389209508.0,236108805.0,149910,90728,2596.3,2602.4,240638,625318314.0,3011,1670,1187,385971578.0,227751219.0,148680,87518,2596.0,2602.3,236198,613722798.0,2857,2023-11-10 14:35:00
783,YNDX,1798,1783,360683382.0,306060447.0,139029,117725,2594.3,2599.8,256754,666743830.0,3581,1720,1730,358390704.0,299927333.0,138200,115347,2593.3,2600.2,253547,658318037.0,3450,2023-11-10 14:40:00
784,YNDX,1837,3028,262896144.0,591421682.0,101423,227638,2592.1,2598.1,329061,854317826.0,4865,1754,2961,259194528.0,586380277.0,100010,225690,2591.7,2598.2,325700,845574806.0,4715,2023-11-10 14:45:00
785,YNDX,786,2021,138692270.0,358789050.0,53549,138135,2590.0,2597.4,191684,497481321.0,2807,698,1949,136924152.0,356118040.0,52889,137044,2588.9,2598.6,189933,493042192.0,2647,2023-11-10 14:50:00
786,YNDX,1061,1445,206300458.0,275466038.0,79633,106111,2590.6,2596.0,185744,481766496.0,2506,1023,1395,205321148.0,273822188.0,79266,105418,2590.3,2597.5,184684,479143336.0,2418,2023-11-10 14:55:00
787,YNDX,1012,2428,195599562.0,491484371.0,75576,189348,2588.1,2595.7,264924,687083934.0,3440,933,2341,194971637.0,481884077.0,75352,185583,2587.5,2596.6,260935,676855715.0,3274,2023-11-10 15:00:00
788,YNDX,1735,1543,363594480.0,295715487.0,140404,113812,2589.6,2598.3,254216,659309967.0,3278,1630,1501,354588888.0,293192994.0,136934,112839,2589.5,2598.3,249773,647781882.0,3131,2023-11-10 15:05:00
789,YNDX,863,581,178625711.0,122769394.0,68946,47255,2590.8,2598.0,116201,301395106.0,1444,788,517,176545669.0,121211930.0,68131,46578,2591.3,2602.3,114709,297757600.0,1305,2023-11-10 15:10:00
790,YNDX,1742,833,456589050.0,179184700.0,176134,68944,2592.3,2599.0,245078,635773751.0,2575,1673,780,454761471.0,178017836.0,175441,68450,2592.1,2600.7,243891,632779307.0,2453,2023-11-10 15:15:00
791,YNDX,1126,994,269011190.0,159231963.0,103719,61210,2593.7,2601.4,164929,428243154.0,2120,1049,940,264140510.0,156138235.0,101858,60017,2593.2,2601.6,161875,420278746.0,1989,2023-11-10 15:20:00
792,YNDX,686,804,162084236.0,118067008.0,62490,45383,2593.8,2601.6,107873,280151245.0,1490,633,776,160508921.0,116837281.0,61907,44906,2592.7,2601.8,106813,277346202.0,1409,2023-11-10 15:25:00
793,YNDX,3123,1088,770422533.0,234005522.0,296827,89922,2595.5,2602.3,386749,1004428056.0,4211,3032,1027,769451591.0,231147074.0,296534,88806,2594.8,2602.8,385340,1000598665.0,4059,2023-11-10 15:30:00
794,YNDX,1699,1327,435473971.0,315748585.0,167864,121366,2594.2,2601.6,289230,751222556.0,3026,1578,1251,432754244.0,311242945.0,166831,119608,2594.0,2602.2,286439,743997190.0,2829,2023-11-10 15:35:00
795,YNDX,821,641,182784806.0,126568492.0,70501,48660,2592.7,2601.1,119161,309353298.0,1462,732,563,177560666.0,122970574.0,68500,47241,2592.1,2603.0,115741,300531240.0,1295,2023-11-10 15:40:00
796,YNDX,1143,575,266996066.0,134576154.0,102942,51717,2593.7,2602.2,154659,401572221.0,1718,1056,500,264676717.0,132041110.0,102070,50715,2593.1,2603.6,152785,396717828.0,1556,2023-11-10 15:45:00
797,YNDX,1652,618,496844021.0,149318502.0,191589,57452,2593.3,2599.0,249041,646162524.0,2270,1551,547,494316167.0,145853919.0,190625,56023,2593.1,2603.5,246648,640170086.0,2098,2023-11-10 15:50:00
798,YNDX,2045,872,731248014.0,156282240.0,281936,60082,2593.7,2601.1,342018,887530255.0,2917,1975,823,729513639.0,156191814.0,281274,59993,2593.6,2603.5,341267,885705454.0,2798,2023-11-10 15:55:00
799,YNDX,646,586,138621169.0,97148792.0,53504,37351,2590.9,2601.0,90855,235769961.0,1232,602,542,138985985.0,97196583.0,53644,37353,2590.9,2602.1,90997,236182568.0,1144,2023-11-10 16:00:00
800,YNDX,959,596,321534058.0,95384065.0,123938,36657,2594.3,2602.1,160595,416918123.0,1555,904,569,319382188.0,93214897.0,123135,35812,2593.8,2602.9,158947,412597086.0,1473,2023-11-10 16:05:00
801,YNDX,1600,1428,359730538.0,220554423.0,138663,84634,2594.3,2606.0,223297,580284961.0,3028,1523,1378,327492197.0,214618511.0,126252,82389,2594.0,2604.9,208641,542110709.0,2901,2023-11-10 16:10:00
802,YNDX,957,1112,194646442.0,181577687.0,74932,69751,2597.6,2603.2,144683,376224130.0,2069,845,1046,188201756.0,176612951.0,72510,67812,2595.5,2604.4,140322,364814708.0,1891,2023-11-10 16:15:00
803,YNDX,983,1148,152997242.0,207861517.0,58924,79866,2596.5,2602.6,138790,360858760.0,2131,923,1116,153751639.0,206044830.0,59238,79152,2595.5,2603.2,138390,359796469.0,2039,2023-11-10 16:20:00
804,YNDX,2539,2381,563615163.0,434021149.0,217104,166914,2596.1,2600.3,384018,997636313.0,4920,2474,2321,562479405.0,415892920.0,216674,159904,2596.0,2600.9,376578,978372326.0,4795,2023-11-10 16:25:00
805,YNDX,1419,1348,329680079.0,229484579.0,127129,88271,2593.3,2599.8,215400,559164658.0,2767,1360,1305,327508771.0,228249657.0,126305,87791,2593.0,2599.9,214096,555758429.0,2665,2023-11-10 16:30:00
806,YNDX,1863,1698,393957607.0,262390762.0,151766,100883,2595.8,2600.9,252649,656348369.0,3561,1772,1630,383783268.0,263381110.0,147969,101276,2593.7,2600.6,249245,647164379.0,3402,2023-11-10 16:35:00
807,YNDX,1227,1150,319333184.0,159688334.0,123064,61386,2594.9,2601.4,184450,479021519.0,2377,1168,1134,319112307.0,159175981.0,122987,61151,2594.7,2603.0,184138,478288289.0,2302,2023-11-10 16:40:00
808,YNDX,470,370,101054558.0,89106574.0,38984,34253,2592.2,2601.4,73237,190161133.0,840,404,300,97804406.0,85841797.0,37768,32970,2589.6,2603.6,70738,183646203.0,704,2023-11-10 16:45:00
809,YNDX,1600,1355,338365587.0,230992126.0,130411,88779,2594.6,2601.9,219190,569357713.0,2955,1534,1294,326532507.0,227548675.0,125883,87442,2593.9,2602.3,213325,554081183.0,2828,2023-11-10 16:50:00
810,YNDX,915,1046,220851368.0,168314727.0,85116,64689,2594.7,2601.9,149805,389166095.0,1961,846,1002,214866499.0,166342370.0,82825,63915,2594.2,2602.6,146740,381208869.0,1848,2023-11-10 16:55:00
811,YNDX,1043,564,162290819.0,114615888.0,62584,44020,2593.2,2603.7,106604,276906707.0,1607,944,508,160698544.0,105865382.0,61976,40644,2592.9,2604.7,102620,266563926.0,1452,2023-11-10 17:00:00
812,YNDX,782,809,131560457.0,96431413.0,50693,37066,2595.2,2601.6,87759,227991870.0,1591,748,770,130014225.0,97214659.0,50127,37363,2593.7,2601.9,87490,227228884.0,1518,2023-11-10 17:05:00
813,YNDX,350,314,55602563.0,22169027.0,21409,8504,2597.2,2606.9,29913,77771590.0,664,300,275,54411126.0,21049207.0,20987,8067,2592.6,2609.3,29054,75460334.0,575,2023-11-10 17:10:00
814,YNDX,1014,564,137369228.0,59920376.0,52911,23030,2596.2,2601.8,75941,197289605.0,1578,953,520,133152820.0,56728603.0,51301,21785,2595.5,2604.0,73086,189881424.0,1473,2023-11-10 17:15:00
815,YNDX,975,345,108946192.0,33912349.0,41968,13020,2595.9,2604.6,54988,142858541.0,1320,904,311,106623438.0,31750944.0,41074,12170,2595.9,2609.0,53244,138374382.0,1215,2023-11-10 17:20:00
816,YNDX,503,484,69899631.0,53777066.0,26937,20669,2594.9,2601.8,47606,123676698.0,987,451,437,69242151.0,51792994.0,26695,19894,2593.8,2603.4,46589,121035146.0,888,2023-11-10 17:25:00
817,YNDX,2714,1157,488957406.0,127152154.0,188320,48930,2596.4,2598.7,237250,616109560.0,3871,2637,1084,485989567.0,122448434.0,187285,47076,2594.9,2601.1,234361,608438002.0,3721,2023-11-10 17:30:00
818,YNDX,2195,2037,417836439.0,251782224.0,160271,96691,2607.1,2604.0,256962,669618663.0,4232,2097,1977,397219853.0,245161850.0,152946,94141,2597.1,2604.2,247087,642381704.0,4074,2023-11-10 17:35:00
819,YNDX,2864,1720,392904558.0,223395466.0,151399,85934,2595.2,2599.6,237333,616300025.0,4584,2783,1660,391647262.0,217661134.0,150924,83665,2595.0,2601.6,234589,609308397.0,4443,2023-11-10 17:40:00
820,YNDX,1658,2069,239334358.0,260604282.0,92176,100110,2596.5,2603.2,192286,499938640.0,3727,1577,2019,228918655.0,258685446.0,88199,99366,2595.5,2603.4,187565,487604101.0,3596,2023-11-10 17:45:00
821,YNDX,1323,1424,178682947.0,192223521.0,68818,73858,2596.5,2602.6,142676,370906468.0,2747,1251,1381,175385095.0,188901182.0,67570,72566,2595.6,2603.2,140136,364286277.0,2632,2023-11-10 17:50:00
822,YNDX,1063,992,132353918.0,156610498.0,51004,60182,2595.0,2602.3,111186,288964416.0,2055,996,940,126183625.0,151425888.0,48646,58170,2593.9,2603.2,106816,277609513.0,1936,2023-11-10 17:55:00
823,YNDX,944,1214,118731939.0,163781677.0,45757,62958,2594.8,2601.4,108715,282513617.0,2158,899,1166,115779800.0,160065603.0,44639,61524,2593.7,2601.7,106163,275845404.0,2065,2023-11-10 18:00:00
824,YNDX,1734,831,359993209.0,141725451.0,138361,54399,2601.8,2605.3,192760,501718661.0,2565,1616,750,341713917.0,127778469.0,131553,49004,2597.5,2607.5,180557,469492386.0,2366,2023-11-10 18:05:00
825,YNDX,1112,633,188956302.0,69379699.0,72687,26613,2599.6,2607.0,99300,258336002.0,1745,993,556,176989252.0,65145328.0,68098,24981,2599.0,2607.8,93079,242134581.0,1549,2023-11-10 18:10:00
826,YNDX,1391,1059,196308698.0,122071689.0,75475,46879,2601.0,2604.0,122354,318380388.0,2450,1316,975,193661570.0,112486754.0,74484,43158,2600.0,2606.4,117642,306148324.0,2291,2023-11-10 18:15:00
827,YNDX,5200,1117,1155704054.0,161590342.0,444562,62104,2599.6,2601.9,506666,1317294397.0,6317,5128,1088,1151484458.0,159878392.0,442990,61401,2599.3,2603.8,504391,1311362850.0,6216,2023-11-10 18:20:00
828,YNDX,859,1039,167766795.0,128501140.0,64551,49410,2599.0,2600.7,113961,296267936.0,1898,797,991,170659214.0,127695283.0,65698,49080,2597.6,2601.8,114778,298354497.0,1788,2023-11-10 18:25:00
829,YNDX,3290,4159,549168319.0,751132346.0,211348,288917,2598.4,2599.8,500265,1300300665.0,7449,3202,4122,544060338.0,747204292.0,209414,287217,2598.0,2601.5,496631,1291264630.0,7324,2023-11-10 18:30:00
830,YNDX,553,1583,67419493.0,306475964.0,25914,117800,2601.7,2601.7,143714,373895457.0,2136,475,1538,64938575.0,305624959.0,24994,117466,2598.2,2601.8,142460,370563535.0,2013,2023-11-10 18:35:00
831,YNDX,653,328,103796715.0,82493440.0,39935,31762,2599.1,2597.2,71697,186290156.0,981,586,284,96379690.0,46258971.0,37102,17764,2597.7,2604.1,54866,142638661.0,870,2023-11-10 18:40:00
832,YNDX,2978,4399,628002923.0,1134078086.0,242070,414362,2594.3,2736.9,656432,1762081010.0,7377,2217,3578,567085001.0,1003674513.0,218996,386364,2589.5,2597.7,605360,1570759514.0,5795,2023-11-13 10:05:00
833,YNDX,1746,4355,303532818.0,1335214283.0,117164,514597,2590.7,2594.7,631761,1638747101.0,6101,1397,4058,281824015.0,1318556476.0,108910,508007,2587.7,2595.5,616917,1600380491.0,5455,2023-11-13 10:10:00
834,YNDX,1176,1470,223283220.0,211394036.0,86160,81421,2591.5,2596.3,167581,434677256.0,2646,984,1263,217508596.0,196717835.0,83983,75697,2589.9,2598.8,159680,414226432.0,2247,2023-11-13 10:15:00
835,YNDX,3099,3609,504197735.0,523982904.0,194668,201836,2590.0,2596.1,396504,1028180640.0,6708,2844,3394,486014080.0,501031408.0,187660,192938,2589.9,2596.9,380598,987045488.0,6238,2023-11-13 10:20:00
836,YNDX,8862,6909,2051868392.0,1626171217.0,794750,629495,2581.8,2583.3,1424245,3678039610.0,15771,7970,6225,1959340015.0,1528047626.0,758998,590069,2581.5,2589.6,1349067,3487387641.0,14195,2023-11-13 10:25:00
837,YNDX,3163,4518,596333824.0,727569386.0,230980,281106,2581.8,2588.2,512086,1323903211.0,7681,2850,4273,579047961.0,707385897.0,224295,273282,2581.6,2588.5,497577,1286433859.0,7123,2023-11-13 10:30:00
838,YNDX,1585,2088,323213333.0,435612659.0,125179,168574,2582.0,2584.1,293753,758825993.0,3673,1273,1948,293624447.0,426845976.0,113833,164922,2579.4,2588.2,278755,720470424.0,3221,2023-11-13 10:35:00
839,YNDX,939,1806,208898739.0,275563306.0,80965,106481,2580.1,2587.9,187446,484462045.0,2745,737,1689,204309635.0,273408968.0,79257,105539,2577.8,2590.6,184796,477718603.0,2426,2023-11-13 10:40:00
840,YNDX,1179,786,229494702.0,177118665.0,74339,68378,3087.1,2590.3,142717,406613368.0,1965,987,698,182731388.0,173228774.0,70809,66883,2580.6,2590.0,137692,355960162.0,1685,2023-11-13 10:45:00
841,YNDX,872,1089,152285806.0,232289037.0,58898,89669,2585.6,2590.5,148567,384574844.0,1961,752,970,152911322.0,220125559.0,59245,84979,2581.0,2590.4,144224,373036882.0,1722,2023-11-13 10:50:00
842,YNDX,442,770,97356286.0,155044470.0,37704,59892,2582.1,2588.7,97596,252400757.0,1212,345,690,91097254.0,151249543.0,35295,58397,2581.0,2590.0,93692,242346798.0,1035,2023-11-13 10:55:00
843,YNDX,1307,2051,211715269.0,310722595.0,81897,120032,2585.1,2588.7,201929,522437865.0,3358,1211,1970,208990949.0,308414531.0,80888,119128,2583.7,2588.9,200016,517405481.0,3181,2023-11-13 11:00:00
844,YNDX,1119,915,219408053.0,263751283.0,84885,101870,2584.8,2589.1,186755,483159336.0,2034,968,810,210102399.0,252396376.0,81379,97393,2581.8,2591.5,178772,462498776.0,1778,2023-11-13 11:05:00
845,YNDX,878,1145,166277196.0,244582474.0,64220,94458,2589.2,2589.3,158678,410859671.0,2023,752,1058,156206607.0,239789638.0,60507,92575,2581.6,2590.2,153082,395996246.0,1810,2023-11-13 11:10:00
846,YNDX,836,1119,187528381.0,198271013.0,72382,76544,2590.8,2590.3,148926,385799395.0,1955,697,1005,181242020.0,190934930.0,70140,73649,2584.0,2592.5,143789,372176950.0,1702,2023-11-13 11:15:00
847,YNDX,501,624,119865311.0,131452498.0,46381,50692,2584.4,2593.2,97073,251317809.0,1125,427,547,116530501.0,130130926.0,45103,50181,2583.7,2593.2,95284,246661427.0,974,2023-11-13 11:20:00
848,YNDX,850,1373,190860220.0,356351084.0,73826,138915,2585.3,2565.2,212741,547211305.0,2223,706,1289,174348659.0,331096485.0,67492,127745,2583.2,2591.9,195237,505445145.0,1995,2023-11-13 11:25:00
849,YNDX,1006,3992,158233764.0,711611230.0,61196,274853,2585.7,2589.1,336049,869844994.0,4998,898,3921,155001797.0,708740191.0,60036,273730,2581.8,2589.2,333766,863741989.0,4819,2023-11-13 11:30:00
850,YNDX,640,1323,100969879.0,253253842.0,39082,97800,2583.5,2589.5,136882,354223722.0,1963,519,1248,98715325.0,250709164.0,38237,96787,2581.7,2590.3,135024,349424489.0,1767,2023-11-13 11:35:00
851,YNDX,658,1035,94318933.0,282455172.0,36530,109077,2582.0,2589.5,145607,376774105.0,1693,588,957,91180406.0,279411185.0,35333,107889,2580.6,2589.8,143222,370591591.0,1545,2023-11-13 11:40:00
852,YNDX,1019,1217,161643628.0,309347016.0,62554,119492,2584.1,2588.9,182046,470990644.0,2236,882,1155,158376811.0,303153137.0,61349,117042,2581.6,2590.1,178391,461529949.0,2037,2023-11-13 11:45:00
853,YNDX,1287,1470,265859364.0,342329489.0,102876,132242,2584.3,2588.7,235118,608188853.0,2757,1114,1362,251312056.0,330218697.0,97304,127487,2582.8,2590.2,224791,581530753.0,2476,2023-11-13 11:50:00
854,YNDX,2128,2261,463647412.0,401810181.0,179181,154897,2587.6,2594.0,334078,865457593.0,4389,1952,2153,457447906.0,395189699.0,176935,152346,2585.4,2594.0,329281,852637606.0,4105,2023-11-13 11:55:00
855,YNDX,5733,5381,1230085985.0,1270497450.0,474497,489088,2592.4,2597.7,963585,2500583435.0,11114,5453,5217,1208437364.0,1257410682.0,466400,484032,2591.0,2597.8,950432,2465848046.0,10670,2023-11-13 12:00:00
856,YNDX,4415,2558,1125028417.0,475352907.0,433717,182899,2593.9,2599.0,616616,1600381324.0,6973,4294,2395,1120676318.0,457584643.0,432148,176004,2593.3,2599.9,608152,1578260962.0,6689,2023-11-13 12:05:00
857,YNDX,4475,2080,1098064988.0,389331318.0,424304,144825,2587.9,2688.3,569129,1487396307.0,6555,4242,1973,1088064821.0,364485469.0,420544,140421,2587.3,2595.7,560965,1452550290.0,6215,2023-11-13 12:10:00
858,YNDX,1439,2939,243289044.0,830152345.0,94199,320615,2582.7,2589.2,414814,1073441389.0,4378,1250,2854,233753947.0,833956098.0,90556,321987,2581.3,2590.0,412543,1067710045.0,4104,2023-11-13 12:15:00
859,YNDX,2992,2213,509941618.0,498795457.0,197345,192566,2584.0,2590.3,389911,1008737076.0,5205,2871,2148,501091954.0,488810373.0,193958,188667,2583.5,2590.9,382625,989902328.0,5019,2023-11-13 12:20:00
860,YNDX,1229,2248,199790849.0,366776938.0,77355,141826,2582.8,2586.1,219181,566567787.0,3477,1026,2149,189803590.0,360462903.0,73566,139308,2580.0,2587.5,212874,550266493.0,3175,2023-11-13 12:25:00
861,YNDX,1534,4141,218175563.0,1276647919.0,83739,493340,2605.4,2587.8,577079,1494823482.0,5675,1395,4051,210402482.0,1268326873.0,81527,490105,2580.8,2587.9,571632,1478729356.0,5446,2023-11-13 12:30:00
862,YNDX,2215,2881,444208940.0,836599621.0,170638,318423,2603.2,2627.3,489061,1280808562.0,5096,1883,2738,423901094.0,812950994.0,163791,309069,2588.1,2630.3,472860,1236852089.0,4621,2023-11-13 12:35:00
863,YNDX,1708,1265,253722190.0,303392433.0,98399,117354,2578.5,2585.3,215753,557114624.0,2973,1577,1198,245120758.0,297633194.0,95085,115101,2577.9,2585.8,210186,542753953.0,2775,2023-11-13 12:40:00
864,YNDX,597,452,90719909.0,127357424.0,35150,44579,2580.9,2856.9,79729,218077333.0,1049,483,414,86579215.0,119799222.0,33602,41215,2576.6,2906.7,74817,206378437.0,897,2023-11-13 12:45:00
865,YNDX,639,861,104507640.0,187312064.0,40555,72476,2576.9,2584.5,113031,291819704.0,1500,494,802,97736908.0,184485403.0,37934,71368,2576.5,2585.0,109302,282222311.0,1296,2023-11-13 12:50:00
866,YNDX,1975,2837,303323836.0,515309028.0,117713,199529,2576.8,2582.6,317242,818632865.0,4812,1824,2708,290152333.0,508709084.0,112581,196894,2577.3,2583.7,309475,798861417.0,4532,2023-11-13 12:55:00
867,YNDX,1380,1731,245896452.0,455556713.0,95445,176514,2576.3,2580.9,271959,701453166.0,3111,1194,1612,236944751.0,438175975.0,92041,169652,2574.3,2582.8,261693,675120726.0,2806,2023-11-13 13:00:00
868,YNDX,1315,3167,225591532.0,580341689.0,87604,221418,2575.1,2621.0,309022,805933221.0,4482,1076,3081,217447561.0,573852514.0,84500,217663,2573.3,2636.4,302163,791300075.0,4157,2023-11-13 13:05:00
869,YNDX,761,1854,139704636.0,371478004.0,54140,143902,2580.4,2581.5,198042,511182640.0,2615,483,1802,126856332.0,365938468.0,49293,141720,2573.5,2582.1,191013,492794801.0,2285,2023-11-13 13:10:00
870,YNDX,1052,1153,190113318.0,259137278.0,73868,100735,2573.7,2572.5,174603,449250596.0,2205,936,1074,185180272.0,248715348.0,71967,96351,2573.1,2581.3,168318,433895620.0,2010,2023-11-13 13:15:00
871,YNDX,1096,1165,184184127.0,284673810.0,71639,110671,2571.0,2572.3,182310,468857937.0,2261,871,1064,182020888.0,276431026.0,70794,107163,2571.1,2579.5,177957,458451915.0,1935,2023-11-13 13:20:00
872,YNDX,2684,2564,491592396.0,447378335.0,190163,173321,2585.1,2581.2,363484,938970731.0,5248,2504,2479,473888610.0,440929507.0,184077,170808,2574.4,2581.4,354885,914818117.0,4983,2023-11-13 13:25:00
873,YNDX,2283,4363,521759236.0,691027638.0,202527,267675,2576.2,2581.6,470202,1212786875.0,6646,2228,4307,518707065.0,685572895.0,201365,265573,2576.0,2581.5,466938,1204279960.0,6535,2023-11-13 13:30:00
874,YNDX,2004,4682,472412896.0,808462495.0,183360,313138,2576.4,2581.8,496498,1280875391.0,6686,1901,4627,467214540.0,805350407.0,181378,311965,2575.9,2581.5,493343,1272564948.0,6528,2023-11-13 13:35:00
875,YNDX,5812,1774,2515103839.0,303005825.0,974524,117114,2580.9,2587.3,1091638,2818109664.0,7586,5685,1701,2505955445.0,295847439.0,971356,114365,2579.9,2586.9,1085721,2801802884.0,7386,2023-11-13 13:40:00
876,YNDX,5300,1680,2289368153.0,290587253.0,887166,112315,2580.5,2587.3,999481,2579955406.0,6980,5167,1602,2286315317.0,284405028.0,886006,109906,2580.5,2587.7,995912,2570720345.0,6769,2023-11-13 13:45:00
877,YNDX,4568,1075,1350424445.0,212158873.0,523349,82055,2580.4,2585.6,605404,1562583318.0,5643,4488,990,1346306543.0,204638192.0,521834,79072,2580.0,2588.0,600906,1550944736.0,5478,2023-11-13 13:50:00
878,YNDX,2611,690,1013320622.0,124777755.0,393300,48291,2576.5,2583.9,441591,1138098378.0,3301,2531,634,1008195504.0,122368682.0,391309,47327,2576.5,2585.6,438636,1130564187.0,3165,2023-11-13 13:55:00
879,YNDX,6253,3238,2619413549.0,446165774.0,1015414,172632,2579.7,2584.5,1188046,3065579323.0,9491,6190,3192,2616652357.0,444115223.0,1014370,171834,2579.6,2584.6,1186204,3060767580.0,9382,2023-11-13 14:00:00
880,YNDX,4106,481,1909072499.0,112313996.0,739789,43403,2580.6,2587.7,783192,2021386496.0,4587,4029,436,1907401406.0,108964605.0,739165,42090,2580.5,2588.8,781255,2016366012.0,4465,2023-11-13 14:05:00
881,YNDX,3221,2817,1186754126.0,411281627.0,459744,158974,2581.3,2587.1,618718,1598035753.0,6038,3115,2767,1180901804.0,407644948.0,457525,157551,2581.1,2587.4,615076,1588546753.0,5882,2023-11-13 14:10:00
882,YNDX,3761,1577,1260069483.0,303836420.0,464958,117217,2710.1,2592.1,582175,1563905904.0,5338,3541,1412,1183225619.0,292815091.0,457918,112947,2583.9,2592.5,570865,1476040710.0,4953,2023-11-13 14:15:00
883,YNDX,994,1259,197619061.0,247841492.0,76457,95684,2584.7,2590.2,172141,445460554.0,2253,892,1180,200317584.0,243928287.0,77577,94120,2582.2,2591.7,171697,444245871.0,2072,2023-11-13 14:20:00
884,YNDX,1247,1760,207862581.0,263778541.0,80411,101859,2585.0,2589.6,182270,471641122.0,3007,1151,1694,204422221.0,255190960.0,79107,98522,2584.1,2590.2,177629,459613182.0,2845,2023-11-13 14:25:00
885,YNDX,5471,756,1192809360.0,152967667.0,461299,59105,2585.8,2588.1,520404,1345777027.0,6227,5398,682,1187240848.0,140030698.0,459222,54030,2585.3,2591.7,513252,1327271546.0,6080,2023-11-13 14:30:00
886,YNDX,299,340,69424742.0,78000396.0,26914,30120,2579.5,2589.7,57034,147425139.0,639,235,296,67859728.0,75876922.0,26323,29280,2578.0,2591.4,55603,143736650.0,531,2023-11-13 14:35:00
887,YNDX,1310,613,447371359.0,131025841.0,173001,50536,2585.9,2592.7,223537,578397200.0,1923,1218,571,444755781.0,128470455.0,172012,49549,2585.6,2592.8,221561,573226236.0,1789,2023-11-13 14:40:00
888,YNDX,909,380,284026087.0,74792630.0,109832,28851,2586.0,2592.4,138683,358818718.0,1289,865,368,283748206.0,75248165.0,109740,29026,2585.6,2592.4,138766,358996371.0,1233,2023-11-13 14:45:00
889,YNDX,849,408,229133614.0,92347885.0,88616,35608,2585.7,2593.5,124224,321481499.0,1257,769,364,226686225.0,90601637.0,87688,34933,2585.1,2593.6,122621,317287863.0,1133,2023-11-13 14:50:00
890,YNDX,2115,2420,371513005.0,336948795.0,143632,130022,2586.6,2591.5,273654,708461801.0,4535,2031,2376,369304964.0,334964945.0,142805,129188,2586.1,2592.8,271993,704269909.0,4407,2023-11-13 14:55:00
891,YNDX,1174,1432,192450749.0,218774420.0,74452,84468,2584.9,2590.0,158920,411225170.0,2606,1115,1379,190664261.0,218149170.0,73761,84209,2584.9,2590.6,157970,408813431.0,2494,2023-11-13 15:00:00
892,YNDX,3115,1131,823445482.0,250030274.0,318156,96498,2588.2,2591.0,414654,1073475757.0,4246,3059,1079,814732901.0,230956491.0,315039,89094,2586.1,2592.3,404133,1045689392.0,4138,2023-11-13 15:05:00
893,YNDX,3153,1813,717357547.0,278256825.0,277369,107417,2586.3,2590.4,384786,995614372.0,4966,2846,1764,712537335.0,275981788.0,275511,106483,2586.2,2591.8,381994,988519124.0,4610,2023-11-13 15:10:00
894,YNDX,1641,1005,523122615.0,184790402.0,202202,71263,2587.1,2593.1,273465,707913018.0,2646,1508,911,515290184.0,177109633.0,199218,68291,2586.6,2593.5,267509,692399818.0,2419,2023-11-13 15:15:00
895,YNDX,1025,551,260846752.0,107264235.0,100854,41394,2586.4,2591.3,142248,368110987.0,1576,980,519,255285693.0,102628010.0,98719,39570,2586.0,2593.6,138289,357913704.0,1499,2023-11-13 15:20:00
896,YNDX,2093,497,443711960.0,100064014.0,171567,38636,2586.2,2589.9,210203,543775974.0,2590,2065,472,443217742.0,95380811.0,171376,36794,2586.2,2592.3,208170,538598554.0,2537,2023-11-13 15:25:00
897,YNDX,727,457,136147183.0,95943301.0,52693,37055,2583.8,2589.2,89748,232090485.0,1184,648,418,133696472.0,91806121.0,51748,35423,2583.6,2591.7,87171,225502593.0,1066,2023-11-13 15:30:00
898,YNDX,9139,540,1972892608.0,98660413.0,763082,38088,2585.4,2590.3,801170,2071553021.0,9679,9072,492,1971659523.0,101168515.0,762610,39046,2585.4,2591.0,801656,2072828038.0,9564,2023-11-13 15:35:00
899,YNDX,540,659,96479492.0,132404722.0,37351,51139,2583.0,2589.1,88490,228884214.0,1199,472,603,93950292.0,112382788.0,36371,43370,2583.1,2591.3,79741,206333081.0,1075,2023-11-13 15:40:00
900,YNDX,657,23028,110607446.0,2941389095.0,42811,1136729,2583.6,2587.6,1179540,3051996542.0,23685,615,22986,109008827.0,2937117190.0,42207,1135041,2582.7,2587.7,1177248,3046126017.0,23601,2023-11-13 15:45:00
901,YNDX,255,242,47655313.0,57281371.0,18444,22127,2583.8,2588.8,40571,104936684.0,497,219,205,47015717.0,39250703.0,18222,15146,2580.2,2591.5,33368,86266421.0,424,2023-11-13 15:50:00
902,YNDX,2407,955,511546009.0,192743187.0,197516,74374,2589.9,2591.5,271890,704289196.0,3362,2326,902,498121814.0,188299394.0,192611,72629,2586.2,2592.6,265240,686421208.0,3228,2023-11-13 15:55:00
903,YNDX,4338,687,880564398.0,144023902.0,340589,56384,2585.4,2554.3,396973,1024588300.0,5025,4299,650,877437927.0,128806802.0,339384,49701,2585.4,2591.6,389085,1006244730.0,4949,2023-11-13 16:00:00
904,YNDX,803,433,111558203.0,99353043.0,43144,38380,2585.7,2588.7,81524,210911246.0,1236,744,384,107426200.0,92166122.0,41582,35572,2583.5,2591.0,77154,199592323.0,1128,2023-11-13 16:05:00
905,YNDX,633,686,101499324.0,120922036.0,39289,46711,2583.4,2588.7,86000,222421361.0,1319,610,664,99990997.0,120456255.0,38707,46506,2583.3,2590.1,85213,220447253.0,1274,2023-11-13 16:10:00
906,YNDX,1352,652,232626836.0,148746390.0,89958,57398,2585.9,2591.5,147356,381373226.0,2004,1278,574,224488578.0,144911870.0,86852,55882,2584.7,2593.2,142734,369400448.0,1852,2023-11-13 16:15:00
907,YNDX,597,357,99898213.0,59473121.0,38647,22942,2584.9,2592.3,61589,159371334.0,954,585,339,99004837.0,59599293.0,38306,22981,2584.6,2593.4,61287,158604131.0,924,2023-11-13 16:20:00
908,YNDX,648,375,112612815.0,120123866.0,43446,41077,2592.0,2924.4,84523,232736682.0,1023,572,315,106539053.0,90714488.0,41244,35011,2583.1,2591.0,76255,197253541.0,887,2023-11-13 16:25:00
909,YNDX,351,304,56378080.0,71018287.0,21832,27425,2582.4,2589.5,49257,127396367.0,655,284,254,54741168.0,68406853.0,21205,26400,2581.5,2591.2,47605,123148022.0,538,2023-11-13 16:30:00
910,YNDX,306,262,78201838.0,75411854.0,30271,29107,2583.4,2590.8,59378,153613692.0,568,220,215,75287820.0,71668098.0,29178,27650,2580.3,2592.0,56828,146955918.0,435,2023-11-13 16:35:00
911,YNDX,755,267,132301041.0,74450397.0,47340,28758,2794.7,2588.9,76098,206751438.0,1022,688,235,176674982.0,69616883.0,46036,26869,3837.8,2591.0,72905,246291865.0,923,2023-11-13 16:40:00
912,YNDX,704,883,165682372.0,240424440.0,64164,92800,2582.2,2590.8,156964,406106812.0,1587,602,825,149511876.0,228400092.0,57915,88139,2581.6,2591.4,146054,377911968.0,1427,2023-11-13 16:45:00
913,YNDX,549,1712,103948065.0,396159403.0,40260,152966,2581.9,2589.9,193226,500107468.0,2261,498,1674,101223676.0,384958460.0,39220,148635,2580.9,2590.0,187855,486182136.0,2172,2023-11-13 16:50:00
914,YNDX,421,4454,79627678.0,858603991.0,30830,331731,2582.8,2588.3,362561,938231670.0,4875,399,4424,77563698.0,856415366.0,30038,330878,2582.2,2588.3,360916,933979064.0,4823,2023-11-13 16:55:00
915,YNDX,527,530,121298354.0,117386296.0,46940,45289,2584.1,2591.9,92229,238684651.0,1057,476,503,107942119.0,114717412.0,41804,44246,2582.1,2592.7,86050,222659531.0,979,2023-11-13 17:00:00
916,YNDX,328,300,47273004.0,78993780.0,18301,30529,2583.1,2587.5,48830,126266784.0,628,287,251,44704248.0,55084832.0,17321,21255,2580.9,2591.6,38576,99789081.0,538,2023-11-13 17:05:00
917,YNDX,288,178,34979815.0,20175734.0,13545,7833,2582.5,2575.7,21378,55155549.0,466,230,130,34533772.0,33123940.0,13372,12765,2582.5,2594.9,26137,67657713.0,360,2023-11-13 17:10:00
918,YNDX,879,411,140775625.0,68624441.0,54498,26541,2583.1,2585.6,81039,209400067.0,1290,799,381,130481246.0,65984457.0,50517,25469,2582.9,2590.8,75986,196465703.0,1180,2023-11-13 17:15:00
919,YNDX,1272,1363,228818339.0,261730909.0,88592,101076,2582.8,2589.4,189668,490549248.0,2635,1213,1312,224033244.0,244039081.0,86784,94216,2581.5,2590.2,181000,468072325.0,2525,2023-11-13 17:20:00
920,YNDX,683,303,98724661.0,29520136.0,38137,11417,2588.7,2585.6,49554,128244798.0,986,637,279,95185865.0,28572121.0,36842,11026,2583.6,2591.3,47868,123757987.0,916,2023-11-13 17:25:00
921,YNDX,2272,454,288033799.0,52445671.0,111418,20271,2585.2,2587.2,131689,340479470.0,2726,2223,412,287350794.0,44758647.0,111161,17286,2585.0,2589.3,128447,332109441.0,2635,2023-11-13 17:30:00
922,YNDX,297,302,39357584.0,22567237.0,15224,8722,2585.2,2587.4,23946,61924821.0,599,229,279,27331735.0,19050373.0,10592,7357,2580.4,2589.4,17949,46382108.0,508,2023-11-13 17:35:00
923,YNDX,344,422,46189746.0,37932529.0,17835,14678,2589.8,2584.3,32513,84122276.0,766,273,376,39484305.0,29157974.0,15280,11263,2584.1,2588.8,26543,68642279.0,649,2023-11-13 17:40:00
924,YNDX,418,622,52477538.0,123817307.0,20296,47826,2585.6,2588.9,68122,176294845.0,1040,328,591,42914984.0,117078261.0,16613,45212,2583.2,2589.5,61825,159993245.0,919,2023-11-13 17:45:00
925,YNDX,925,1829,110087585.0,246237565.0,42542,95111,2587.7,2588.9,137653,356325150.0,2754,763,1766,110115765.0,235246954.0,42620,90827,2583.7,2590.1,133447,345362719.0,2529,2023-11-13 17:50:00
926,YNDX,2114,5174,208300278.0,1002739124.0,80524,387461,2586.8,2588.0,467985,1211039402.0,7288,2041,5132,206659935.0,1000111524.0,79924,386353,2585.7,2588.6,466277,1206771459.0,7173,2023-11-13 17:55:00
927,YNDX,699,1117,89846404.0,143115460.0,34742,55331,2586.1,2586.5,90073,232961865.0,1816,657,1065,96587127.0,140418742.0,37368,54226,2584.8,2589.5,91594,237005870.0,1722,2023-11-13 18:00:00
928,YNDX,1259,2393,147857410.0,689741399.0,57170,266460,2586.3,2588.5,323630,837598809.0,3652,1191,2358,143286876.0,690378992.0,55472,266690,2583.0,2588.7,322162,833665868.0,3549,2023-11-13 18:05:00
929,YNDX,2186,1641,372726610.0,364877300.0,143027,140814,2606.0,2591.2,283841,737603911.0,3827,2057,1546,344591655.0,346719787.0,133271,133769,2585.6,2591.9,267040,691311442.0,3603,2023-11-13 18:10:00
930,YNDX,1041,4654,159174202.0,1233076163.0,61639,476521,2582.4,2587.7,538160,1392250365.0,5695,945,4622,156486504.0,1229515156.0,60625,475119,2581.2,2587.8,535744,1386001661.0,5567,2023-11-13 18:15:00
931,YNDX,728,851,84897294.0,137462996.0,32883,53281,2581.8,2580.0,86164,222360290.0,1579,645,820,79638919.0,136809832.0,30862,52875,2580.5,2587.4,83737,216448751.0,1465,2023-11-13 18:20:00
932,YNDX,757,713,108380120.0,96169250.0,41996,37196,2580.7,2585.5,79192,204549371.0,1470,692,645,97232036.0,84912392.0,37700,32824,2579.1,2586.9,70524,182144429.0,1337,2023-11-13 18:25:00
933,YNDX,451,455,64725243.0,67782319.0,25036,26134,2585.3,2593.6,51170,132507562.0,906,379,395,57092140.0,49251354.0,22120,19035,2581.0,2587.4,41155,106343494.0,774,2023-11-13 18:30:00
934,YNDX,539,10273,108199288.0,2065745439.0,41867,798705,2584.4,2586.4,840572,2173944727.0,10812,478,10229,103930411.0,2054161720.0,40287,794187,2579.8,2586.5,834474,2158092131.0,10707,2023-11-13 18:35:00
935,YNDX,384,613,53659184.0,164648372.0,20760,63633,2584.7,2587.5,84393,218307556.0,997,353,575,48846384.0,166461907.0,18923,64325,2581.3,2587.8,83248,215308292.0,928,2023-11-13 18:40:00
936,YNDX,4010,1138,1776132837.0,377466698.0,689495,123419,2576.0,3058.4,812914,2153599536.0,5148,3508,561,1741366824.0,266363273.0,675818,102950,2576.7,2587.3,778768,2007730097.0,4069,2023-11-14 10:05:00
937,YNDX,4437,13314,1512771852.0,5372743899.0,592879,2099570,2551.6,2559.0,2692449,6885515751.0,17751,3282,12017,1398854295.0,5211506059.0,548697,2032810,2549.4,2563.7,2581507,6610360355.0,15299,2023-11-14 10:10:00
938,YNDX,1626,1833,300360327.0,414359727.0,117595,159299,2554.2,2601.1,276894,714720054.0,3459,938,1550,231981138.0,380728248.0,91126,149055,2545.7,2554.3,240181,612709387.0,2488,2023-11-14 10:15:00
939,YNDX,3148,2135,883578980.0,490167210.0,345867,192099,2554.7,2551.6,537966,1373746190.0,5283,2661,1858,837878991.0,452981712.0,328654,177321,2549.4,2554.6,505975,1290860704.0,4519,2023-11-14 10:20:00
940,YNDX,3428,2284,1203767052.0,624229392.0,472755,244906,2546.3,2548.9,717661,1827996445.0,5712,3021,2051,1161474752.0,592631351.0,456472,231991,2544.5,2554.5,688463,1754106103.0,5072,2023-11-14 10:25:00
941,YNDX,6709,5696,1686557332.0,1235359082.0,660423,482638,2553.8,2559.6,1143061,2921916414.0,12405,6263,5405,1616142403.0,1195520591.0,632509,467012,2555.1,2559.9,1099521,2811662994.0,11668,2023-11-14 10:30:00
942,YNDX,13932,13085,2252274562.0,2825398097.0,880792,1103269,2557.1,2560.9,1984061,5077672660.0,27017,13533,12940,2232801953.0,2809811567.0,873243,1096860,2556.9,2561.7,1970103,5042613520.0,26473,2023-11-14 10:35:00
943,YNDX,2224,1017,483971747.0,217947583.0,189157,84984,2558.6,2564.6,274141,701919330.0,3241,2044,909,471251638.0,205368499.0,184226,80037,2558.0,2565.9,264263,676620138.0,2953,2023-11-14 10:40:00
944,YNDX,2852,2238,1041087814.0,956043425.0,407535,373864,2554.6,2557.2,781399,1997131240.0,5090,2623,2118,1028218866.0,937661737.0,402497,366471,2554.6,2558.6,768968,1965880604.0,4741,2023-11-14 10:45:00
945,YNDX,1375,3045,374552348.0,1131225295.0,146862,442127,2550.4,2558.6,588989,1505777644.0,4420,1129,2914,366765202.0,1115606874.0,143869,435975,2549.3,2558.9,579844,1482372077.0,4043,2023-11-14 10:50:00
946,YNDX,7858,1794,2534498836.0,385680549.0,991555,150377,2556.1,2564.8,1141932,2920179386.0,9652,7703,1702,2530373287.0,378859656.0,990093,147879,2555.7,2562.0,1137972,2909232943.0,9405,2023-11-14 10:55:00
947,YNDX,3039,653,1071361888.0,213376839.0,418996,83258,2557.0,2562.8,502254,1284738728.0,3692,2869,553,1061078987.0,203457026.0,415229,79311,2555.4,2565.3,494540,1264536014.0,3422,2023-11-14 11:00:00
948,YNDX,1186,5307,334311993.0,2118598675.0,131116,828331,2549.7,2557.7,959447,2452910669.0,6493,1028,5215,328399417.0,2108411873.0,128812,824144,2549.4,2558.3,952956,2436811290.0,6243,2023-11-14 11:05:00
949,YNDX,644,1386,159303630.0,645067092.0,62544,252253,2547.1,2557.2,314797,804370722.0,2030,479,1298,155051378.0,609982128.0,60892,238412,2546.3,2558.5,299304,765033507.0,1777,2023-11-14 11:10:00
950,YNDX,694,497,151187783.0,131012345.0,59331,51173,2548.2,2560.2,110504,282200128.0,1191,570,436,141098823.0,118906765.0,55377,46500,2548.0,2557.1,101877,260005588.0,1006,2023-11-14 11:15:00
951,YNDX,751,361,209339257.0,110881285.0,82025,43364,2552.1,2557.0,125389,320220542.0,1112,585,315,204355411.0,107809428.0,80177,42144,2548.8,2558.1,122321,312164839.0,900,2023-11-14 11:20:00
952,YNDX,518,402,132060832.0,117179836.0,51756,45925,2551.6,2551.5,97681,249240668.0,920,361,335,126804310.0,106944320.0,49785,41826,2547.0,2556.9,91611,233748630.0,696,2023-11-14 11:25:00
953,YNDX,422,355,127576227.0,110703343.0,50008,43265,2551.1,2558.7,93273,238279570.0,777,313,282,117592453.0,101219617.0,46183,39590,2546.2,2556.7,85773,218812071.0,595,2023-11-14 11:30:00
954,YNDX,550,503,176728605.0,148297801.0,69285,58237,2550.7,2546.5,127522,325026407.0,1053,374,404,166045408.0,138691557.0,65155,54259,2548.5,2556.1,119414,304736966.0,778,2023-11-14 11:35:00
955,YNDX,1569,523,291676995.0,135860164.0,113694,53160,2565.5,2555.7,166854,427537160.0,2092,1466,461,283084897.0,134297987.0,110499,52430,2561.9,2561.5,162929,417382885.0,1927,2023-11-14 11:40:00
956,YNDX,512,1139,93807575.0,217742650.0,36795,73562,2549.5,2960.0,110357,311550225.0,1651,396,1088,88480264.0,181286883.0,34733,70963,2547.4,2554.7,105696,269767147.0,1484,2023-11-14 11:45:00
957,YNDX,1006,1937,291304646.0,390987490.0,112258,152992,2595.0,2555.6,265250,682292137.0,2943,896,1656,278223383.0,383003822.0,107614,149844,2585.4,2556.0,257458,661227205.0,2552,2023-11-14 11:50:00
958,YNDX,674,369,167211740.0,116710791.0,64621,45641,2587.6,2557.1,110262,283922532.0,1043,481,284,146676308.0,111987351.0,56971,43752,2574.6,2559.6,100723,258663659.0,765,2023-11-14 11:55:00
959,YNDX,1627,1574,403615191.0,299575417.0,150252,116975,2686.3,2561.0,267227,703190609.0,3201,1421,880,393652607.0,283321026.0,146160,110607,2693.3,2561.5,256767,676973633.0,2301,2023-11-14 12:00:00
960,YNDX,1680,2265,439264948.0,350728759.0,169927,136898,2585.0,2562.0,306825,789993707.0,3945,1577,1236,435534162.0,344424429.0,168609,134428,2583.1,2562.1,303037,779958591.0,2813,2023-11-14 12:05:00
961,YNDX,1083,1982,223144329.0,412769904.0,87375,161314,2553.9,2558.8,248689,635914233.0,3065,1036,1924,215089852.0,407058565.0,84246,159040,2553.1,2559.5,243286,622148418.0,2960,2023-11-14 12:10:00
962,YNDX,751,692,182844261.0,169891572.0,71642,66529,2552.2,2553.6,138171,352735833.0,1443,608,564,179136304.0,154830858.0,70209,60459,2551.5,2560.9,130668,333967162.0,1172,2023-11-14 12:15:00
963,YNDX,1368,422,286884665.0,94449499.0,112437,36924,2551.5,2557.9,149361,381334164.0,1790,1286,395,286889780.0,93873709.0,112445,36680,2551.4,2559.3,149125,380763490.0,1681,2023-11-14 12:20:00
964,YNDX,652,395,171944748.0,122383877.0,67378,47797,2551.9,2560.5,115175,294328625.0,1047,550,343,168409094.0,121048216.0,66017,47262,2551.0,2561.2,113279,289457311.0,893,2023-11-14 12:25:00
965,YNDX,1150,1044,292197790.0,237889542.0,108936,92912,2682.3,2560.4,201848,530087332.0,2194,1104,978,280086822.0,232522373.0,105003,90809,2667.4,2560.6,195812,512609195.0,2082,2023-11-14 12:30:00
966,YNDX,1163,1233,229663478.0,291751548.0,89974,114048,2552.6,2558.1,204022,521415026.0,2396,1093,1198,224573938.0,289135950.0,87996,112961,2552.1,2559.6,200957,513709889.0,2291,2023-11-14 12:35:00
967,YNDX,1004,3932,225307796.0,914189780.0,88247,357404,2553.1,2557.9,445651,1139497577.0,4936,892,3883,222135602.0,911803090.0,87037,356383,2552.2,2558.5,443420,1133938693.0,4775,2023-11-14 12:40:00
968,YNDX,878,698,190951113.0,169952898.0,74834,66390,2551.7,2559.9,141224,360904011.0,1576,700,620,188435235.0,164687802.0,73857,64342,2551.4,2559.6,138199,353123037.0,1320,2023-11-14 12:45:00
969,YNDX,1208,739,273665642.0,193335550.0,107200,75524,2552.9,2559.9,182724,467001193.0,1947,1016,691,268758328.0,192182692.0,105307,75036,2552.1,2561.2,180343,460941020.0,1707,2023-11-14 12:50:00
970,YNDX,778,383,137331270.0,122137445.0,53810,41319,2552.2,2956.0,95129,259468715.0,1161,696,349,136025577.0,102797446.0,53313,40140,2551.5,2561.0,93453,238823023.0,1045,2023-11-14 12:55:00
971,YNDX,1403,632,311244971.0,178366463.0,87340,69571,3563.6,2563.8,156911,489611435.0,2035,980,552,234185544.0,166770024.0,81841,64987,2861.5,2566.2,146828,400955568.0,1532,2023-11-14 13:00:00
972,YNDX,2375,622,269178444.0,126272981.0,105224,49255,2558.1,2563.7,154479,395451426.0,2997,1619,537,267118445.0,122011714.0,104447,47539,2557.5,2566.6,151986,389130159.0,2156,2023-11-14 13:05:00
973,YNDX,1577,889,291688453.0,216586405.0,113960,72832,2559.6,2973.8,186792,508274858.0,2466,1085,787,290248858.0,206510090.0,113515,68859,2556.9,2999.0,182374,496758948.0,1872,2023-11-14 13:10:00
974,YNDX,952,1217,239215214.0,190532305.0,93494,74424,2558.6,2560.1,167918,429747519.0,2169,895,1090,236946925.0,186207154.0,92631,72609,2558.0,2564.5,165240,423154079.0,1985,2023-11-14 13:15:00
975,YNDX,690,753,150469634.0,172744179.0,58840,67418,2557.3,2562.3,126258,323213813.0,1443,623,697,147096203.0,161958196.0,57533,63157,2556.7,2564.4,120690,309054400.0,1320,2023-11-14 13:20:00
976,YNDX,451,355,102786401.0,87153197.0,40193,34040,2557.3,2560.3,74233,189939599.0,806,388,299,98488004.0,80109204.0,38532,31220,2556.0,2566.0,69752,178597208.0,687,2023-11-14 13:25:00
977,YNDX,1419,992,438649944.0,217677698.0,170643,84761,2570.6,2568.1,255404,656327643.0,2411,1335,902,424597396.0,209778322.0,165831,81667,2560.4,2568.7,247498,634375718.0,2237,2023-11-14 13:30:00
978,YNDX,1707,4072,380646397.0,552909825.0,148561,215413,2562.2,2566.7,363974,933556222.0,5779,1635,4023,383151067.0,549783603.0,149576,214157,2561.6,2567.2,363733,932934671.0,5658,2023-11-14 13:35:00
979,YNDX,887,1034,209811375.0,171630538.0,81938,66882,2560.6,2566.2,148820,381441913.0,1921,868,980,209856431.0,168943784.0,81995,65813,2559.4,2567.0,147808,378800215.0,1848,2023-11-14 13:40:00
980,YNDX,1165,1075,264183370.0,226652371.0,103296,88405,2557.5,2563.8,191701,490835742.0,2240,1087,1022,260251219.0,218029928.0,101764,84946,2557.4,2566.7,186710,478281147.0,2109,2023-11-14 13:45:00
981,YNDX,1336,958,327501113.0,202872061.0,128054,79120,2557.5,2564.1,207174,530373175.0,2294,1229,876,317943592.0,199832353.0,124351,77902,2556.8,2565.2,202253,517775946.0,2105,2023-11-14 13:50:00
982,YNDX,1853,3017,395659524.0,498034148.0,154695,194313,2557.7,2563.1,349008,893693673.0,4870,1797,2936,395658004.0,493047203.0,154702,192321,2557.5,2563.7,347023,888705208.0,4733,2023-11-14 13:55:00
983,YNDX,2204,3068,463819265.0,570946260.0,181291,222543,2558.4,2565.6,403834,1034765525.0,5272,2151,3015,460667750.0,568706076.0,180084,221652,2558.1,2565.8,401736,1029373827.0,5166,2023-11-14 14:00:00
984,YNDX,672,379,190314654.0,107175495.0,74351,41744,2559.7,2567.4,116095,297490150.0,1051,595,321,189231289.0,102608585.0,73984,39943,2557.7,2568.9,113927,291839874.0,916,2023-11-14 14:05:00
985,YNDX,2670,6224,807283878.0,1415855184.0,315707,552586,2557.1,2562.2,868293,2223139062.0,8894,2591,6146,798075562.0,1399318036.0,312163,546017,2556.6,2562.8,858180,2197393599.0,8737,2023-11-14 14:10:00
986,YNDX,1954,4289,417341511.0,648199607.0,163226,253227,2556.8,2559.8,416453,1065541118.0,6243,1851,4185,413839307.0,638713707.0,161933,249323,2555.6,2561.8,411256,1052553015.0,6036,2023-11-14 14:15:00
987,YNDX,1331,1459,293132162.0,306822450.0,114833,120034,2552.7,2556.1,234867,599954613.0,2790,1237,1363,289668714.0,300346732.0,113469,117227,2552.8,2562.1,230696,590015446.0,2600,2023-11-14 14:20:00
988,YNDX,3270,5294,728533975.0,1283336139.0,285444,503395,2552.3,2549.4,788839,2011870114.0,8564,2988,5035,701490657.0,1258135235.0,274882,492710,2552.0,2553.5,767592,1959625892.0,8023,2023-11-14 14:25:00
989,YNDX,7027,14151,1134639778.0,3178559224.0,446424,1236665,2541.6,2570.3,1683089,4313199003.0,21178,6827,13975,1108296371.0,3155749922.0,436162,1227091,2541.0,2571.7,1663253,4264046293.0,20802,2023-11-14 14:30:00
990,YNDX,3643,5566,767821575.0,1458219857.0,302687,573646,2536.7,2542.0,876333,2226041432.0,9209,3311,5260,728974217.0,1410297563.0,287284,554143,2537.5,2545.0,841427,2139271780.0,8571,2023-11-14 14:35:00
991,YNDX,3793,6888,651223849.0,1483305040.0,257005,585028,2533.9,2535.4,842033,2134528890.0,10681,3453,6725,621996974.0,1467422655.0,245808,578527,2530.4,2536.5,824335,2089419629.0,10178,2023-11-14 14:40:00
992,YNDX,2745,2960,527627330.0,604033887.0,208131,238126,2535.1,2536.6,446257,1131661217.0,5705,2446,2822,509467462.0,588247315.0,201376,231776,2529.9,2538.0,433152,1097714778.0,5268,2023-11-14 14:45:00
993,YNDX,3865,6300,713887076.0,1073703259.0,281286,422357,2537.9,2542.2,703643,1787590335.0,10165,3690,6115,704714500.0,1062668671.0,277828,417891,2536.5,2542.9,695719,1767383171.0,9805,2023-11-14 14:50:00
994,YNDX,1964,2466,442609655.0,523308061.0,149702,205748,2956.6,2543.4,355450,965917717.0,4430,1780,2359,372846369.0,513400695.0,146919,201697,2537.8,2545.4,348616,886247064.0,4139,2023-11-14 14:55:00
995,YNDX,1429,1547,312737089.0,321688302.0,122977,126414,2543.1,2544.7,249391,634425391.0,2976,1318,1407,290484810.0,297663529.0,114307,116751,2541.3,2549.6,231058,588148340.0,2725,2023-11-14 15:00:00
996,YNDX,976,587,167916971.0,123849704.0,66093,48672,2540.6,2544.6,114765,291766675.0,1563,852,490,160820244.0,112989286.0,63330,44325,2539.4,2549.1,107655,273809530.0,1342,2023-11-14 15:05:00
997,YNDX,495,388,133819262.0,120005197.0,52706,47083,2539.0,2548.8,99789,253824460.0,883,424,288,130184682.0,115076868.0,51277,45126,2538.9,2550.1,96403,245261550.0,712,2023-11-14 15:10:00
998,YNDX,534,551,123807519.0,142307922.0,48711,55827,2541.7,2549.1,104538,266115441.0,1085,419,469,118591460.0,137784170.0,46706,54033,2539.1,2550.0,100739,256375631.0,888,2023-11-14 15:15:00
999,YNDX,596,381,128309529.0,121826540.0,50490,47649,2541.3,2556.7,98139,250136069.0,977,536,312,125708721.0,111310804.0,49519,43596,2538.6,2553.2,93115,237019526.0,848,2023-11-14 15:20:00
1000,YNDX,491,260,105559349.0,76747838.0,41471,30073,2545.4,2552.1,71544,182307187.0,751,409,199,101398884.0,73121810.0,39908,28639,2540.8,2553.2,68547,174520695.0,608,2023-11-14 15:25:00
1001,YNDX,731,276,132602882.0,73347736.0,52127,28760,2543.8,2550.3,80887,205950618.0,1007,659,226,128961643.0,69986271.0,50717,27428,2542.8,2551.6,78145,198947915.0,885,2023-11-14 15:30:00
1002,YNDX,3677,771,633257819.0,154203428.0,248848,60460,2544.8,2550.5,309308,787461247.0,4448,3582,529,626450279.0,152151757.0,246169,59605,2544.8,2552.7,305774,778602037.0,4111,2023-11-14 15:35:00
1003,YNDX,1769,374,266179888.0,88144988.0,104625,34562,2544.1,2550.3,139187,354324877.0,2143,1699,278,264020118.0,82544372.0,103822,32337,2543.0,2552.6,136159,346564490.0,1977,2023-11-14 15:40:00
1004,YNDX,463,301,103521407.0,54285998.0,40716,21260,2542.5,2553.4,61976,157807405.0,764,384,142,100562819.0,51936620.0,39539,20342,2543.4,2553.2,59881,152499440.0,526,2023-11-14 15:45:00
1005,YNDX,1633,363,386923183.0,149239967.0,151833,52833,2548.3,2824.7,204666,536163150.0,1996,1531,298,375791864.0,156315371.0,147569,49523,2546.6,3156.4,197092,532107235.0,1829,2023-11-14 15:50:00
1006,YNDX,1057,1485,262583555.0,327852206.0,103119,128329,2546.4,2554.8,231448,590435761.0,2542,981,1396,268813255.0,324036247.0,105600,126822,2545.6,2555.0,232422,592849503.0,2377,2023-11-14 15:55:00
1007,YNDX,974,894,229623659.0,166303867.0,74733,65065,3072.6,2556.0,139798,395927527.0,1868,880,848,183748853.0,163693263.0,72147,64037,2546.9,2556.2,136184,347442117.0,1728,2023-11-14 16:00:00
1008,YNDX,297,245,72655865.0,74872161.0,28488,29295,2550.4,2555.8,57783,147528026.0,542,221,142,68794642.0,62775987.0,27027,24530,2545.4,2559.2,51557,131570629.0,363,2023-11-14 16:05:00
1009,YNDX,256,339,71779846.0,73907360.0,28154,28919,2549.5,2555.7,57073,145687207.0,595,196,196,70143797.0,69184501.0,27541,27028,2546.9,2559.7,54569,139328298.0,392,2023-11-14 16:10:00
1010,YNDX,820,547,223543340.0,120099141.0,87614,45235,2551.5,2655.0,132849,343642481.0,1367,749,490,218759856.0,129487881.0,85765,44981,2550.7,2878.7,130746,348247738.0,1239,2023-11-14 16:15:00
1011,YNDX,3638,4122,941122243.0,1126004410.0,367242,436766,2562.7,2578.0,804008,2067126653.0,7760,3450,3960,895197594.0,1097164732.0,349762,427270,2559.4,2567.8,777032,1992362326.0,7410,2023-11-14 16:20:00
1012,YNDX,15202,16025,3713174359.0,4690051302.0,1429277,1802731,2597.9,2601.6,3232008,8403225662.0,31227,14250,15056,3529941091.0,4519821750.0,1361972,1739364,2591.8,2598.5,3101336,8049762842.0,29306,2023-11-14 16:25:00
1013,YNDX,11007,13569,2385855299.0,3739632923.0,921439,1438627,2589.3,2599.4,2360066,6125488222.0,24576,10349,13140,2273573179.0,3679455335.0,879833,1415326,2584.1,2599.7,2295159,5953028514.0,23489,2023-11-14 16:30:00
1014,YNDX,21205,9724,5966686640.0,2198829998.0,2290951,839270,2604.5,2619.9,3130221,8165516639.0,30929,20448,8754,5801215356.0,2013009206.0,2230875,771300,2600.4,2609.9,3002175,7814224562.0,29202,2023-11-14 16:35:00
1015,YNDX,22172,14326,4572767463.0,4019153815.0,1741902,1529602,2625.2,2627.6,3271504,8591921279.0,36498,14531,12301,4179725293.0,3750845481.0,1597633,1428376,2616.2,2626.0,3026009,7930570774.0,26832,2023-11-14 16:40:00
1016,YNDX,15172,18671,3851020908.0,5249658644.0,1467219,1990310,2624.7,2637.6,3457529,9100679552.0,33843,13713,16938,3609193180.0,4965406245.0,1380369,1893263,2614.7,2622.7,3273632,8574599426.0,30651,2023-11-14 16:45:00
1017,YNDX,15635,12762,3607733632.0,3025836010.0,1370050,1143406,2633.3,2646.3,2513456,6633569642.0,28397,14171,11691,3460407916.0,2873579517.0,1320787,1094127,2620.0,2626.4,2414914,6333987433.0,25862,2023-11-14 16:50:00
1018,YNDX,13311,7207,3104258192.0,1371568558.0,1173131,521821,2646.1,2628.4,1694952,4475826750.0,20518,12847,6576,3039433978.0,1264874161.0,1149295,481130,2644.6,2629.0,1630425,4304308140.0,19423,2023-11-14 16:55:00
1019,YNDX,5786,8406,1553360092.0,2070297895.0,594088,792205,2614.7,2613.3,1386293,3623657987.0,14192,5144,7519,1430759535.0,1964980866.0,547718,750315,2612.2,2618.9,1298033,3395740402.0,12663,2023-11-14 17:00:00
1020,YNDX,7009,6036,1956550918.0,1123954978.0,746955,430120,2619.4,2613.1,1177075,3080505897.0,13045,6633,5609,1900884367.0,1046294953.0,727183,399423,2614.0,2619.5,1126606,2947179321.0,12242,2023-11-14 17:05:00
1021,YNDX,5924,2962,1479306705.0,447584548.0,566074,171217,2613.3,2614.1,737291,1926891254.0,8886,5691,2716,1449550246.0,434897941.0,554960,166070,2612.0,2618.8,721030,1884448188.0,8407,2023-11-14 17:10:00
1022,YNDX,3973,2526,927253447.0,468368268.0,354300,178771,2617.1,2619.9,533071,1395621715.0,6499,3780,2214,919382659.0,413704989.0,351582,157704,2615.0,2623.3,509286,1333087649.0,5994,2023-11-14 17:15:00
1023,YNDX,1292,1739,271250670.0,301796394.0,103635,109668,2617.4,2751.9,213303,573047064.0,3031,1059,1479,239226425.0,264681281.0,91664,101095,2609.8,2618.1,192759,503907706.0,2538,2023-11-14 17:20:00
1024,YNDX,1187,3236,250405286.0,1002471270.0,96067,384121,2606.6,2609.8,480188,1252876556.0,4423,976,3082,232013318.0,969664892.0,89017,370994,2606.4,2613.7,460011,1201678210.0,4058,2023-11-14 17:25:00
1025,YNDX,2620,4691,412159639.0,1501188995.0,157880,575137,2610.6,2610.1,733017,1913348634.0,7311,2334,4487,388398429.0,1491097335.0,149120,571102,2604.6,2610.9,720222,1879495764.0,6821,2023-11-14 17:30:00
1026,YNDX,3061,834,729077690.0,188987607.0,279055,70012,2612.7,2699.4,349067,918065297.0,3895,2756,654,678209424.0,151633205.0,259449,57779,2614.0,2624.4,317228,829842629.0,3410,2023-11-14 17:35:00
1027,YNDX,2925,2311,952469795.0,770656188.0,363374,294229,2621.2,2619.2,657603,1723125983.0,5236,2717,2026,911200995.0,742895957.0,347448,283366,2622.6,2621.7,630814,1654096953.0,4743,2023-11-14 17:40:00
1028,YNDX,2633,3333,565872064.0,1222286297.0,215649,466118,2624.0,2622.3,681767,1788158361.0,5966,2320,3088,521806806.0,1198028087.0,199336,456798,2617.7,2622.7,656134,1719834893.0,5408,2023-11-14 17:45:00
1029,YNDX,8105,3246,1544457330.0,636877755.0,585766,238593,2636.6,2669.3,824359,2181335086.0,11351,7474,2630,1385725055.0,560995322.0,527071,212249,2629.1,2643.1,739320,1946720377.0,10104,2023-11-14 17:50:00
1030,YNDX,14285,9249,3352353629.0,1755139862.0,1253478,662832,2674.4,2647.9,1916310,5107493491.0,23534,13322,7829,3174539509.0,1573613258.0,1186747,592735,2675.0,2654.8,1779482,4748152767.0,21151,2023-11-14 17:55:00
1031,YNDX,12634,10292,2657744241.0,2081179839.0,994394,780599,2672.7,2666.1,1774993,4738924081.0,22926,11177,8593,2424694523.0,1857383787.0,911527,695967,2660.0,2668.8,1607494,4282078310.0,19770,2023-11-14 18:00:00
1032,YNDX,13188,9866,3010687951.0,1736138341.0,1121575,651995,2684.3,2662.8,1773570,4746826293.0,23054,12318,8705,2866131072.0,1608149224.0,1075790,602382,2664.2,2669.7,1678172,4474280297.0,21023,2023-11-14 18:05:00
1033,YNDX,14803,15177,2982534194.0,3732602850.0,1093415,1378243,2727.7,2708.2,2471658,6715137044.0,29980,12551,13580,2574206043.0,3282146302.0,970606,1233876,2652.2,2660.0,2204482,5856352346.0,26131,2023-11-14 18:10:00
1034,YNDX,11438,8355,2546081062.0,1789682002.0,944288,668511,2696.3,2677.1,1612799,4335763064.0,19793,10396,7096,2350476453.0,1627793224.0,874171,613005,2688.8,2655.4,1487176,3978269677.0,17492,2023-11-14 18:15:00
1035,YNDX,10603,6457,2570019564.0,1091774234.0,960442,410631,2675.9,2658.8,1371073,3661793799.0,17060,10098,5686,2459294510.0,985266396.0,924562,369802,2660.0,2664.3,1294364,3444560907.0,15784,2023-11-14 18:20:00
1036,YNDX,9537,16377,1877264885.0,4000667607.0,707177,1509181,2654.6,2650.9,2216358,5877932492.0,25914,8873,15751,1768969603.0,3881486445.0,667695,1462523,2649.4,2654.0,2130218,5650456048.0,24624,2023-11-14 18:25:00
1037,YNDX,5693,5030,1269063226.0,1230103030.0,478046,462479,2654.7,2659.8,940525,2499166256.0,10723,5161,4292,1107689124.0,1074686792.0,416941,398674,2656.7,2695.7,815615,2182375916.0,9453,2023-11-14 18:30:00
1038,YNDX,6833,5835,1487343296.0,1124279291.0,558650,422551,2662.4,2660.7,981201,2611622588.0,12668,6357,5176,1413504987.0,1031290015.0,531998,387081,2657.0,2664.3,919079,2444795002.0,11533,2023-11-14 18:35:00
1039,YNDX,6782,7877,1196326194.0,2102775123.0,450475,787836,2655.7,2669.1,1238311,3299101317.0,14659,6449,7499,1158535533.0,2029836004.0,436701,764023,2652.9,2656.8,1200724,3188371537.0,13948,2023-11-14 18:40:00
1040,YNDX,8017,17646,1049726435.0,1049726435.0,406001,2059977,2585.5,2603.7,2465978,6413222569.0,25663,7325,17102,991903212.0,991903212.0,382116,2017005,2595.8,2603.8,2399121,6243757678.0,24427,2023-11-29 10:05:00
1041,YNDX,4586,25704,774114031.0,774114031.0,301126,1338967,2570.7,2605.9,1640093,4263368337.0,30290,4455,25483,767915824.0,767915824.0,295213,1328981,2601.2,2606.7,1624194,4232198390.0,29938,2023-11-29 10:10:00
1042,YNDX,2536,5611,479952133.0,479952133.0,185309,473624,2590.0,2584.6,658933,1704098178.0,8147,2358,5468,459298341.0,459298341.0,177028,466057,2594.5,2601.9,643085,1671952089.0,7826,2023-11-29 10:15:00
1043,YNDX,6828,10014,1562452617.0,1562452617.0,604781,795571,2583.5,2603.2,1400352,3633502051.0,16842,6707,9893,1555429485.0,1555429485.0,600266,790981,2591.2,2604.7,1391247,3615731306.0,16600,2023-11-29 10:20:00
1044,YNDX,1641,3751,469287886.0,469287886.0,181136,269580,2590.8,2606.2,450716,1171880014.0,5392,1505,3628,466819530.0,466819530.0,180108,262275,2591.9,2607.9,442383,1150816242.0,5133,2023-11-29 10:25:00
1045,YNDX,736,698,187220998.0,187220998.0,72428,71409,2584.9,2592.3,143837,372334557.0,1434,659,617,169476062.0,169476062.0,65466,66431,2588.8,2612.8,131897,343043888.0,1276,2023-11-29 10:30:00
1046,YNDX,3471,1671,785730575.0,785730575.0,303005,150191,2593.1,2604.0,453196,1176834967.0,5142,3380,1579,775245189.0,775245189.0,298849,148883,2594.1,2606.5,447732,1163308479.0,4959,2023-11-29 10:35:00
1047,YNDX,8690,6888,1964347842.0,1964347842.0,756698,424095,2595.9,2600.5,1180793,3067225659.0,15578,8597,6699,1962402594.0,1962402594.0,755907,412745,2596.1,2603.0,1168652,3036784381.0,15296,2023-11-29 10:40:00
1048,YNDX,1191,1674,348348072.0,348348072.0,134759,152813,2585.0,2594.2,287572,744770437.0,2865,1109,1571,344254897.0,344254897.0,133023,149438,2587.9,2606.2,282461,733718259.0,2680,2023-11-29 10:45:00
1049,YNDX,3025,2464,599498337.0,599498337.0,231357,227527,2591.2,2585.1,458884,1187673128.0,5489,2920,2355,589299188.0,589299188.0,227336,220720,2592.2,2603.7,448056,1163991820.0,5275,2023-11-29 10:50:00
1050,YNDX,1329,6964,302605514.0,302605514.0,117182,910727,2582.4,2598.3,1027909,2668946470.0,8293,1227,6900,292590525.0,292590525.0,113226,909285,2584.1,2599.5,1022511,2656239186.0,8127,2023-11-29 10:55:00
1051,YNDX,3338,13100,430152753.0,430152753.0,166521,1345050,2583.2,2595.0,1511571,3920555242.0,16438,3246,13011,428504439.0,428504439.0,165258,1340996,2592.9,2598.1,1506254,3912606381.0,16257,2023-11-29 11:00:00
1052,YNDX,12599,5625,1736816377.0,1736816377.0,670681,532930,2589.6,2604.6,1203611,3124909558.0,18224,12499,5530,1720132531.0,1720132531.0,662680,526939,2595.7,2604.7,1189619,3092627505.0,18029,2023-11-29 11:05:00
1053,YNDX,2639,2573,605102322.0,605102322.0,234109,270703,2584.7,2608.4,504812,1311211192.0,5212,2534,2445,591368963.0,591368963.0,227731,265702,2596.8,2610.7,493433,1285042090.0,4979,2023-11-29 11:10:00
1054,YNDX,4176,4889,870973625.0,870973625.0,337058,495188,2584.0,2607.5,832246,2162161321.0,9065,3956,4748,829163997.0,829163997.0,318746,487361,2601.3,2611.8,806107,2102059725.0,8704,2023-11-29 11:15:00
1055,YNDX,3206,4387,789762324.0,789762324.0,305700,485758,2583.5,2616.2,791458,2060579967.0,7593,3086,4256,777978997.0,777978997.0,298468,479931,2606.6,2618.8,778399,2034818169.0,7342,2023-11-29 11:20:00
1056,YNDX,4125,3191,963000841.0,963000841.0,370348,295892,2600.3,2616.8,666240,1737287848.0,7316,3986,2887,946000706.0,946000706.0,362472,287190,2609.9,2621.3,649662,1698814653.0,6873,2023-11-29 11:25:00
1057,YNDX,5260,4860,1253693496.0,1253693496.0,481913,507861,2601.5,2618.8,989774,2583704477.0,10120,5015,4641,1219050987.0,1219050987.0,467724,495095,2606.3,2619.0,962819,2515716367.0,9656,2023-11-29 11:30:00
1058,YNDX,1987,2686,471728271.0,471728271.0,182022,304343,2591.6,2607.8,486365,1265381001.0,4673,1875,2611,464870754.0,464870754.0,178532,300029,2603.9,2619.2,478561,1250710079.0,4486,2023-11-29 11:35:00
1059,YNDX,1571,2329,394653011.0,394653011.0,152530,298622,2587.4,2617.8,451152,1176371555.0,3900,1467,2254,394937934.0,394937934.0,151846,295807,2600.9,2618.3,447653,1169448252.0,3721,2023-11-29 11:40:00
1060,YNDX,2703,4468,610159409.0,610159409.0,236428,386869,2580.7,2616.0,623297,1622209169.0,7171,2639,4372,603631451.0,603631451.0,231764,383793,2604.5,2616.3,615557,1607765900.0,7011,2023-11-29 11:45:00
1061,YNDX,3576,5750,842491960.0,842491960.0,324835,456493,2593.6,2607.1,781328,2032592139.0,9326,3460,5580,842253628.0,842253628.0,323844,450598,2600.8,2612.9,774442,2019608133.0,9040,2023-11-29 11:50:00
1062,YNDX,6492,9997,1253647638.0,1253647638.0,483806,1061523,2591.2,2593.4,1545329,4006551492.0,16489,6224,9776,1228136133.0,1228136133.0,472693,1046983,2598.2,2608.3,1519676,3959016070.0,16000,2023-11-29 11:55:00
1063,YNDX,4942,5016,1180613555.0,1180613555.0,454709,547975,2596.4,2612.2,1002684,2612043620.0,9958,4659,4901,1144763779.0,1144763779.0,440012,544223,2601.7,2613.4,984235,2567061373.0,9560,2023-11-29 12:00:00
1064,YNDX,2389,2596,566419803.0,566419803.0,218331,280407,2594.3,2639.9,498738,1306674389.0,4985,2300,2446,569088021.0,569088021.0,218320,230634,2606.7,2621.6,448954,1173712929.0,4746,2023-11-29 12:05:00
1065,YNDX,3975,9948,765614812.0,765614812.0,294410,693920,2600.5,2613.9,988330,2579443809.0,13923,3875,9846,756043649.0,756043649.0,289901,690605,2607.9,2616.3,980506,2562870171.0,13721,2023-11-29 12:10:00
1066,YNDX,1990,1972,475320116.0,475320116.0,183349,184928,2592.4,2589.8,368277,954241789.0,3962,1864,1879,474493938.0,474493938.0,182175,180599,2604.6,2618.5,362774,947390870.0,3743,2023-11-29 12:15:00
1067,YNDX,2825,1565,668280094.0,668280094.0,257683,190744,2593.4,2620.0,448427,1168023606.0,4390,2716,1494,662604125.0,662604125.0,254435,187814,2604.2,2621.3,442249,1154914542.0,4210,2023-11-29 12:20:00
1068,YNDX,3448,3001,830917168.0,830917168.0,319419,256526,2601.3,2619.2,575945,1502803096.0,6449,3252,2885,798715803.0,798715803.0,305982,251508,2610.3,2623.3,557490,1458484994.0,6137,2023-11-29 12:25:00
1069,YNDX,1328,2241,379422229.0,379422229.0,146826,301251,2584.2,2623.6,448077,1169769491.0,3569,1217,2116,369774334.0,369774334.0,141782,289265,2608.0,2624.5,431047,1128951399.0,3333,2023-11-29 12:30:00
1070,YNDX,3163,2385,769086623.0,769086623.0,298955,235602,2572.6,2625.7,534557,1387716077.0,5548,3013,2202,759637850.0,759637850.0,290694,224513,2613.2,2628.2,515207,1349705440.0,5215,2023-11-29 12:35:00
1071,YNDX,2550,1924,697738977.0,697738977.0,268110,214710,2602.4,2628.1,482820,1262018719.0,4474,2298,1746,648130898.0,648130898.0,247692,207912,2616.7,2631.3,455604,1195216959.0,4044,2023-11-29 12:40:00
1072,YNDX,2239,2738,634192353.0,634192353.0,244227,349063,2596.7,2627.0,593290,1551175337.0,4977,2068,2522,621245474.0,621245474.0,237693,323517,2613.6,2630.7,561210,1472310949.0,4590,2023-11-29 12:45:00
1073,YNDX,1322,1425,333898060.0,333898060.0,128532,163875,2597.8,2627.6,292407,764493039.0,2747,1129,1310,305886747.0,305886747.0,116944,154299,2615.7,2629.8,271243,711661354.0,2439,2023-11-29 12:50:00
1074,YNDX,2405,1811,618023310.0,618023310.0,240717,184424,2567.4,2583.7,425141,1094518744.0,4216,2230,1649,603537777.0,603537777.0,230587,162049,2617.4,2630.5,392636,1029815017.0,3879,2023-11-29 12:55:00
1075,YNDX,3162,7165,780582070.0,780582070.0,299592,612583,2605.5,2615.4,912175,2382748164.0,10327,2978,7034,753098781.0,753098781.0,288153,605390,2613.5,2625.0,893543,2342256495.0,10012,2023-11-29 13:00:00
1076,YNDX,2556,3717,699480034.0,699480034.0,268575,419698,2604.4,2627.2,688273,1802090193.0,6273,2456,3612,669990064.0,669990064.0,256442,418212,2612.6,2627.6,674654,1768886828.0,6068,2023-11-29 13:05:00
1077,YNDX,1280,6856,242633300.0,242633300.0,93640,342089,2591.1,2629.8,435729,1142244063.0,8136,1177,6784,234512184.0,234512184.0,89691,334398,2614.7,2631.8,424089,1114581245.0,7961,2023-11-29 13:10:00
1078,YNDX,5453,3358,870973574.0,870973574.0,334726,236664,2602.0,2626.4,571390,1492546581.0,8811,5367,3266,862148058.0,862148058.0,329135,231535,2619.4,2629.1,560670,1470877017.0,8633,2023-11-29 13:15:00
1079,YNDX,1216,665,312528920.0,312528920.0,120738,80287,2588.5,2622.7,201025,523096597.0,1881,1129,622,306695472.0,306695472.0,117268,89700,2615.3,2633.6,206968,542924907.0,1751,2023-11-29 13:20:00
1080,YNDX,2091,1961,555556214.0,555556214.0,213377,240386,2603.6,2596.5,453763,1179708875.0,4052,1946,1872,540997272.0,540997272.0,206905,239386,2614.7,2630.8,446291,1170769591.0,3818,2023-11-29 13:25:00
1081,YNDX,1660,1522,383389423.0,383389423.0,147513,140172,2599.0,2627.8,287685,751737580.0,3182,1520,1443,376382577.0,376382577.0,143920,128150,2615.2,2631.9,272070,713660277.0,2963,2023-11-29 13:30:00
1082,YNDX,1204,598,293195884.0,293195884.0,113094,85147,2592.5,2637.1,198241,517738214.0,1802,1105,523,293517986.0,293517986.0,112284,80686,2614.1,2637.2,192970,506304938.0,1628,2023-11-29 13:35:00
1083,YNDX,916,541,247183425.0,247183425.0,95370,78671,2591.8,2618.4,174041,453175025.0,1457,824,468,236568404.0,236568404.0,90517,69548,2613.5,2633.9,160065,419752588.0,1292,2023-11-29 13:40:00
1084,YNDX,1716,1367,515355998.0,515355998.0,198059,181099,2602.0,2625.2,379158,990784934.0,3083,1578,1285,492356709.0,492356709.0,188402,183171,2613.3,2631.2,371573,974322050.0,2863,2023-11-29 13:45:00
1085,YNDX,1237,2011,281847542.0,281847542.0,108823,234960,2590.0,2624.1,343783,898410624.0,3248,1101,1925,270413799.0,270413799.0,103431,229061,2614.4,2625.4,332492,871797003.0,3026,2023-11-29 13:50:00
1086,YNDX,3396,4653,776530250.0,776530250.0,298399,607860,2602.3,2591.6,906259,2351890369.0,8049,3221,4564,759274267.0,759274267.0,290982,599251,2609.4,2622.2,890233,2330636528.0,7785,2023-11-29 13:55:00
1087,YNDX,1760,953,362064746.0,362064746.0,139669,138118,2592.3,2620.0,277787,723937412.0,2713,1646,912,366547070.0,366547070.0,140554,136150,2607.9,2627.0,276704,724216264.0,2558,2023-11-29 14:00:00
1088,YNDX,573,4191,187095258.0,187095258.0,72634,727394,2575.9,2621.5,800028,2093935655.0,4764,539,4156,185151977.0,185151977.0,71049,725543,2606.0,2622.0,796592,2087523458.0,4695,2023-11-29 14:05:00
1089,YNDX,864,1117,235460676.0,235460676.0,91144,179549,2583.4,2624.6,270693,706697371.0,1981,782,1064,232759180.0,232759180.0,89254,176684,2607.8,2624.7,265938,696503731.0,1846,2023-11-29 14:10:00
1090,YNDX,455,245,109694156.0,109694156.0,42861,39235,2559.3,2629.5,82096,212861045.0,700,400,206,107792904.0,107792904.0,41332,37984,2608.0,2631.4,79316,207742535.0,606,2023-11-29 14:15:00
1091,YNDX,693,812,212957095.0,212957095.0,82468,92876,2582.3,2619.1,175344,456209971.0,1505,594,765,210234828.0,210234828.0,80608,90649,2608.1,2628.6,171257,448514757.0,1359,2023-11-29 14:20:00
1092,YNDX,1227,1480,341932968.0,341932968.0,132019,147645,2590.0,2612.9,279664,727713851.0,2707,1091,1396,338569556.0,338569556.0,129803,143869,2608.3,2626.5,273672,716442003.0,2487,2023-11-29 14:25:00
1093,YNDX,898,614,264467613.0,264467613.0,102293,83917,2585.4,2619.3,186210,484268963.0,1512,856,583,259987272.0,259987272.0,99710,82798,2607.4,2630.0,182508,477742811.0,1439,2023-11-29 14:30:00
1094,YNDX,1063,653,280837828.0,280837828.0,108481,81061,2588.8,2628.7,189542,493926786.0,1716,973,608,279525145.0,279525145.0,107110,82884,2609.7,2629.6,189994,497478568.0,1581,2023-11-29 14:35:00
1095,YNDX,1179,742,258191988.0,258191988.0,99735,72224,2588.8,2619.3,171959,447364827.0,1921,1106,707,259130540.0,259130540.0,99258,71580,2610.7,2629.8,170838,447373302.0,1813,2023-11-29 14:40:00
1096,YNDX,758,969,214468241.0,214468241.0,82994,87115,2584.1,2626.8,170109,443301422.0,1727,704,926,213435125.0,213435125.0,81800,86539,2609.2,2628.2,168339,440881189.0,1630,2023-11-29 14:45:00
1097,YNDX,856,560,220774612.0,220774612.0,85399,66316,2585.2,2623.0,151715,394723795.0,1416,781,525,213261574.0,213261574.0,81715,64358,2609.8,2630.4,146073,382546244.0,1306,2023-11-29 14:50:00
1098,YNDX,2148,1564,356718201.0,356718201.0,137206,113926,2599.9,2612.5,251132,654348590.0,3712,2040,1539,332645910.0,332645910.0,127164,111377,2615.9,2625.2,238541,625029703.0,3579,2023-11-29 14:55:00
1099,YNDX,3812,8253,930436655.0,930436655.0,357477,1546913,2602.8,2611.7,1904390,4970554412.0,12065,3442,8077,882000388.0,882000388.0,337901,1502210,2610.2,2617.0,1840111,4813275146.0,11519,2023-11-29 15:00:00
1100,YNDX,7616,13091,1318199778.0,1318199778.0,509397,1670742,2587.8,2609.3,2180139,5677616455.0,20707,7238,12912,1240449650.0,1240449650.0,477013,1637499,2600.5,2610.1,2114512,5514548386.0,20150,2023-11-29 15:05:00
1101,YNDX,1125,1125,233175807.0,233175807.0,90557,99489,2574.9,2613.0,190046,493139462.0,2250,1006,1054,248852344.0,248852344.0,95653,95181,2601.6,2615.3,190834,497782932.0,2060,2023-11-29 15:10:00
1102,YNDX,3200,1698,463843630.0,463843630.0,179119,118051,2589.6,2616.1,297170,772681288.0,4898,3139,1645,459632130.0,459632130.0,176306,115289,2607.0,2616.0,291595,761229553.0,4784,2023-11-29 15:15:00
1103,YNDX,8433,1784,1216657176.0,1216657176.0,468162,218012,2598.8,2619.0,686174,1787620228.0,10217,8348,1734,1199957852.0,1199957852.0,459928,217856,2609.0,2619.7,677784,1770671041.0,10082,2023-11-29 15:20:00
1104,YNDX,3739,8236,606298716.0,606298716.0,233485,936302,2596.7,2614.5,1169787,3054258360.0,11975,3675,8180,600019084.0,600019084.0,230233,936371,2606.1,2614.8,1166604,3048484607.0,11855,2023-11-29 15:25:00
1105,YNDX,3379,2369,628143669.0,628143669.0,242039,270431,2595.2,2619.0,512470,1336412745.0,5748,3330,2341,620474539.0,620474539.0,238118,257810,2605.7,2620.2,495928,1295977358.0,5671,2023-11-29 15:30:00
1106,YNDX,3774,2426,682792133.0,682792133.0,262923,307562,2596.9,2605.8,570485,1484245704.0,6200,3660,2329,666945438.0,666945438.0,256000,304513,2605.3,2617.4,560513,1463967724.0,5989,2023-11-29 15:35:00
1107,YNDX,1038,1659,255787894.0,255787894.0,99436,180148,2572.4,2619.4,279584,727669822.0,2697,971,1630,249458856.0,249458856.0,95824,179359,2603.3,2619.5,275183,719286859.0,2601,2023-11-29 15:40:00
1108,YNDX,1027,1449,276604451.0,276604451.0,107126,175953,2582.0,2617.1,283079,737088783.0,2476,983,1398,275814584.0,275814584.0,105946,175807,2603.4,2619.9,281753,736415439.0,2381,2023-11-29 15:45:00
1109,YNDX,6029,2613,1005226429.0,1005226429.0,386312,346924,2602.1,2614.2,733236,1912163732.0,8642,5948,2567,1000535840.0,1000535840.0,383716,344823,2607.5,2618.5,728539,1903465484.0,8515,2023-11-29 15:50:00
1110,YNDX,2211,1403,446296862.0,446296862.0,172095,120522,2593.3,2620.8,292617,762159520.0,3614,2169,1370,445337950.0,445337950.0,170896,119637,2605.9,2621.4,290533,758948705.0,3539,2023-11-29 15:55:00
1111,YNDX,359,355,90011763.0,90011763.0,35385,34695,2543.8,2618.1,70080,180845316.0,714,322,328,90600546.0,90600546.0,34805,33014,2603.1,2621.1,67819,177132646.0,650,2023-11-29 16:00:00
1112,YNDX,1547,1331,334099389.0,334099389.0,129140,191657,2587.1,2590.4,320797,830573475.0,2878,1468,1278,331048732.0,331048732.0,127167,187128,2603.3,2616.8,314295,820726616.0,2746,2023-11-29 16:05:00
1113,YNDX,3102,636,487221379.0,487221379.0,187964,64001,2592.1,2619.9,251965,654896046.0,3738,3041,620,477802235.0,477802235.0,183259,63273,2607.3,2620.1,246532,643583112.0,3661,2023-11-29 16:10:00
1114,YNDX,2419,1228,467903986.0,467903986.0,180254,102197,2595.8,2610.3,282451,734669510.0,3647,2344,1159,466192321.0,466192321.0,178760,102664,2607.9,2621.2,281424,735294969.0,3503,2023-11-29 16:15:00
1115,YNDX,4714,3743,931918336.0,931918336.0,358130,307083,2602.2,2617.4,665213,1735673957.0,8457,4659,3687,930497262.0,930497262.0,356759,305061,2608.2,2619.9,661820,1729716066.0,8346,2023-11-29 16:20:00
1116,YNDX,1678,1583,405171335.0,405171335.0,156446,179345,2589.8,2618.5,335791,874789960.0,3261,1620,1528,403143043.0,403143043.0,154768,177981,2604.8,2622.3,332749,869856008.0,3148,2023-11-29 16:25:00
1117,YNDX,7844,5990,1097762792.0,1097762792.0,421200,321383,2606.3,2616.0,742583,1938507374.0,13834,7807,5950,1098852418.0,1098852418.0,420815,321275,2611.2,2617.1,742090,1939673414.0,13757,2023-11-29 16:30:00
1118,YNDX,2030,1376,410944922.0,410944922.0,158542,122804,2592.0,2615.2,281346,732105372.0,3406,1984,1309,407132130.0,407132130.0,156126,121546,2607.7,2620.9,277672,725686668.0,3293,2023-11-29 16:35:00
1119,YNDX,1746,2602,444543315.0,444543315.0,171453,255916,2592.8,2607.8,427369,1111920774.0,4348,1636,2503,442150505.0,442150505.0,169730,253249,2605.0,2619.0,422979,1105417126.0,4139,2023-11-29 16:40:00
1120,YNDX,1407,1303,338316987.0,338316987.0,131196,147137,2578.7,2613.2,278333,722813938.0,2710,1266,1225,333451769.0,333451769.0,128019,146408,2604.7,2620.9,274427,717166461.0,2491,2023-11-29 16:45:00
1121,YNDX,944,758,244907800.0,244907800.0,95556,87437,2563.0,2600.9,182993,472321904.0,1702,864,694,240536492.0,240536492.0,92349,86232,2604.6,2624.4,178581,466841914.0,1558,2023-11-29 16:50:00
1122,YNDX,624,676,171205194.0,171205194.0,66598,70118,2570.7,2599.5,136716,353478268.0,1300,556,619,170186866.0,170186866.0,65343,68149,2604.5,2623.5,133492,348972874.0,1175,2023-11-29 16:55:00
1123,YNDX,1581,621,285819870.0,285819870.0,110334,53052,2590.5,2622.0,163386,424919605.0,2202,1492,556,283705219.0,283705219.0,108702,52551,2609.9,2625.5,161253,421679512.0,2048,2023-11-29 17:00:00
1124,YNDX,430,236,73523679.0,73523679.0,29052,16472,2530.8,2619.6,45524,116674280.0,666,389,192,74959334.0,74959334.0,28720,16851,2610.0,2623.6,45571,119169274.0,581,2023-11-29 17:05:00
1125,YNDX,2616,2167,732608856.0,732608856.0,281560,224237,2602.0,2625.3,505797,1321304776.0,4783,2529,2058,739192213.0,739192213.0,282912,222284,2612.8,2627.0,505196,1323132364.0,4587,2023-11-29 17:10:00
1126,YNDX,793,693,173439139.0,173439139.0,67272,66802,2578.2,2616.2,134074,348206264.0,1486,738,644,173625617.0,173625617.0,66517,64826,2610.2,2626.5,131343,343891612.0,1382,2023-11-29 17:15:00
1127,YNDX,623,762,158698318.0,158698318.0,61636,81193,2574.8,2623.6,142829,371719197.0,1385,572,731,139915289.0,139915289.0,53622,79911,2609.3,2624.1,133533,349612982.0,1303,2023-11-29 17:20:00
1128,YNDX,1586,1462,293571142.0,293571142.0,113263,157396,2591.9,2622.0,270659,706265879.0,3048,1564,1415,303691653.0,303691653.0,116321,155011,2610.8,2624.6,271332,710532444.0,2979,2023-11-29 17:25:00
1129,YNDX,840,3101,204991692.0,204991692.0,79465,262198,2579.6,2607.8,341663,888744453.0,3941,735,3003,192818206.0,192818206.0,73942,259517,2607.7,2621.8,333459,873227700.0,3738,2023-11-29 17:30:00
1130,YNDX,1392,767,267534758.0,267534758.0,103964,70669,2573.3,2622.9,174633,452890790.0,2159,1327,718,266644589.0,266644589.0,102085,69754,2612.0,2628.4,171839,449988453.0,2045,2023-11-29 17:35:00
1131,YNDX,940,633,188151760.0,188151760.0,72829,47200,2583.5,2614.0,120029,311533782.0,1573,864,576,183802650.0,183802650.0,70345,49443,2612.9,2628.6,119788,313770144.0,1440,2023-11-29 17:40:00
1132,YNDX,747,349,131956555.0,131956555.0,51363,27770,2569.1,2615.0,79133,204574542.0,1096,707,298,131615426.0,131615426.0,50354,25048,2613.8,2631.2,75402,197520603.0,1005,2023-11-29 17:45:00
1133,YNDX,1901,2042,510669928.0,510669928.0,196661,196505,2596.7,2553.4,393166,1012429508.0,3943,1730,1936,499554453.0,499554453.0,191484,189231,2608.9,2624.2,380715,996128251.0,3666,2023-11-29 17:50:00
1134,YNDX,4264,7715,777856340.0,777856340.0,299526,792083,2597.0,2608.2,1091609,2843779247.0,11979,4116,7623,752360885.0,752360885.0,288837,788103,2604.8,2617.1,1076940,2814916293.0,11739,2023-11-29 17:55:00
1135,YNDX,2529,3453,605374941.0,605374941.0,234681,475215,2579.6,2600.7,709896,1841284219.0,5982,1943,3139,503876213.0,503876213.0,194270,425226,2593.7,2610.5,619496,1613912709.0,5082,2023-11-29 18:00:00
1136,YNDX,1309,1483,338209269.0,338209269.0,132773,159363,2547.3,2606.2,292136,753547567.0,2792,1115,1382,309695771.0,309695771.0,119460,151328,2592.5,2611.2,270788,704836575.0,2497,2023-11-29 18:05:00
1137,YNDX,1399,852,253334695.0,253334695.0,98927,88848,2560.8,2600.9,187775,484423145.0,2251,1127,781,233675996.0,233675996.0,90216,80726,2590.2,2611.0,170942,444449310.0,1908,2023-11-29 18:10:00
1138,YNDX,827,1318,235708786.0,235708786.0,91652,117752,2571.8,2590.8,209404,540784604.0,2145,704,1222,238946985.0,238946985.0,92200,115489,2591.6,2608.9,207689,540247380.0,1926,2023-11-29 18:15:00
1139,YNDX,1327,1150,385560193.0,385560193.0,150583,117054,2560.4,2605.9,267637,690596921.0,2477,1242,1095,377856362.0,377856362.0,145942,115212,2589.1,2610.8,261154,678654873.0,2337,2023-11-29 18:20:00
1140,YNDX,6848,8824,1511673892.0,1511673892.0,587849,1042355,2571.5,2572.3,1630204,4192896641.0,15672,6047,8150,1393331280.0,1393331280.0,538891,1014419,2585.6,2598.5,1553310,4029267031.0,14197,2023-11-29 18:25:00
1141,YNDX,1213,1456,310695778.0,310695778.0,124055,133473,2504.5,2591.0,257528,656518798.0,2669,980,1351,301930398.0,301930398.0,117123,131424,2577.9,2597.1,248547,643246489.0,2331,2023-11-29 18:30:00
1142,YNDX,2255,3209,612245904.0,612245904.0,238965,304823,2562.1,2546.3,543788,1388426413.0,5464,1760,2941,498079876.0,498079876.0,193656,258405,2572.0,2585.1,452061,1166091911.0,4701,2023-11-29 18:35:00
1143,YNDX,1694,1365,384351216.0,384351216.0,152117,118648,2526.7,2573.3,270765,689673194.0,3059,1277,1215,327407497.0,327407497.0,127568,97230,2566.5,2581.7,224798,578429499.0,2492,2023-11-29 18:40:00
1144,YNDX,16232,13547,2830220789.0,2830220789.0,1099965,1044499,2573.0,2592.0,2144464,5537583519.0,29779,15716,12513,2788490792.0,2788490792.0,1082358,995772,2576.3,2583.5,2078130,5361079470.0,28229,2023-11-30 10:05:00
1145,YNDX,5749,7943,971809679.0,971809679.0,378653,629264,2566.5,2573.6,1007917,2591302408.0,13692,5535,7755,952149675.0,952149675.0,369842,618045,2574.5,2578.6,987887,2545840054.0,13290,2023-11-30 10:10:00
1146,YNDX,7346,5600,1933672458.0,1933672458.0,755820,457460,2558.4,2592.8,1213280,3119760189.0,12946,7136,5244,1906861830.0,1906861830.0,738491,439126,2582.1,2596.0,1177617,3046823332.0,12380,2023-11-30 10:15:00
1147,YNDX,5791,4491,1565948124.0,1565948124.0,608916,373541,2571.7,2588.1,982457,2532706813.0,10282,5618,3954,1559158005.0,1559158005.0,603724,364252,2582.6,2596.5,967976,2504932226.0,9572,2023-11-30 10:20:00
1148,YNDX,33643,15461,6469131230.0,6469131230.0,2508910,1073127,2578.5,2590.0,3582037,9248557494.0,49104,31287,14668,6399008263.0,6399008263.0,2472188,1040215,2588.4,2595.3,3512403,9098696535.0,45955,2023-11-30 10:25:00
1149,YNDX,11997,9482,3115723107.0,3115723107.0,1207042,914281,2581.3,2598.1,2121323,5491074839.0,21479,11773,9202,3077439641.0,3077439641.0,1188271,894303,2589.8,2600.4,2082574,5403029337.0,20975,2023-11-30 10:30:00
1150,YNDX,5880,6343,1702193067.0,1702193067.0,657863,672476,2587.5,2599.8,1330339,3450526676.0,12223,5609,6099,1687994627.0,1687994627.0,651975,660560,2589.0,2602.1,1312535,3406837526.0,11708,2023-11-30 10:35:00
1151,YNDX,11082,4643,2122945866.0,2122945866.0,824101,441371,2576.1,2602.7,1265472,3271695321.0,15725,10767,4365,2091694476.0,2091694476.0,806394,428260,2593.9,2606.9,1234654,3208113019.0,15132,2023-11-30 10:40:00
1152,YNDX,3933,1619,689978852.0,689978852.0,267534,162351,2579.0,2603.8,429885,1112714760.0,5552,3647,1479,665220076.0,665220076.0,256609,156550,2592.3,2606.2,413159,1073226843.0,5126,2023-11-30 10:45:00
1153,YNDX,11184,8487,2798517391.0,2798517391.0,1082384,1027565,2585.5,2591.8,2109949,5461734050.0,19671,10909,8286,2780894147.0,2780894147.0,1074993,1019800,2586.9,2596.7,2094793,5429006503.0,19195,2023-11-30 10:50:00
1154,YNDX,3760,5264,912540029.0,912540029.0,355430,653094,2567.4,2597.7,1008524,2609077317.0,9024,3432,5147,898597514.0,898597514.0,347622,651776,2585.0,2598.0,999398,2591891315.0,8579,2023-11-30 10:55:00
1155,YNDX,11074,7561,2356895574.0,2356895574.0,915404,846143,2574.7,2589.1,1761547,4547615203.0,18635,9113,7245,2282388455.0,2282388455.0,880455,831533,2592.3,2603.3,1711988,4447097494.0,16358,2023-11-30 11:00:00
1156,YNDX,7448,15942,1528291212.0,1528291212.0,593837,1868421,2573.6,2585.0,2462258,6358201978.0,23390,7002,15768,1498695787.0,1498695787.0,580918,1849673,2579.9,2591.3,2430591,6291816347.0,22770,2023-11-30 11:05:00
1157,YNDX,10187,19450,2290525335.0,2290525335.0,891106,2017842,2570.4,2588.5,2908948,7513632489.0,29637,9825,19272,2272204910.0,2272204910.0,880438,2010269,2580.8,2589.8,2890707,7478352040.0,29097,2023-11-30 11:10:00
1158,YNDX,9231,11262,2341365575.0,2341365575.0,908885,1088198,2576.1,2586.9,1997083,5156383181.0,20493,8979,11136,2326866318.0,2326866318.0,901669,1082502,2580.6,2591.0,1984171,5131591871.0,20115,2023-11-30 11:15:00
1159,YNDX,8426,13971,1533456029.0,1533456029.0,596351,1171149,2571.4,2588.1,1767500,4564466621.0,22397,8110,13826,1507513009.0,1507513009.0,584451,1155618,2579.4,2589.2,1740069,4499584987.0,21936,2023-11-30 11:20:00
1160,YNDX,5495,10342,1126486588.0,1126486588.0,437994,1354530,2571.9,2586.0,1792524,4629351779.0,15837,5054,10230,1102893323.0,1102893323.0,428420,1333770,2574.3,2586.8,1762190,4553085443.0,15284,2023-11-30 11:25:00
1161,YNDX,3342,9005,767804938.0,767804938.0,300908,1101837,2551.6,2579.3,1402745,3609781945.0,12347,2890,8887,734718183.0,734718183.0,285949,1077610,2569.4,2580.8,1363559,3515810806.0,11777,2023-11-30 11:30:00
1162,YNDX,3625,4213,832042304.0,832042304.0,326822,534090,2545.9,2571.5,860912,2205462378.0,7838,3212,4051,804421338.0,804421338.0,313193,510964,2568.5,2582.6,824157,2124052468.0,7263,2023-11-30 11:35:00
1163,YNDX,1911,3396,435308327.0,435308327.0,170056,329018,2559.8,2576.9,499074,1283169485.0,5307,1667,3318,422860910.0,422860910.0,164778,322364,2566.2,2582.3,487142,1255289032.0,4985,2023-11-30 11:40:00
1164,YNDX,3194,5607,742147486.0,742147486.0,289715,560548,2561.6,2580.7,850263,2188775969.0,8801,2899,5499,732177053.0,732177053.0,285105,546777,2568.1,2581.6,831882,2143733717.0,8398,2023-11-30 11:45:00
1165,YNDX,3324,2794,669151770.0,669151770.0,260746,323381,2566.3,2579.7,584127,1503389012.0,6118,2938,2621,634920337.0,634920337.0,247246,309871,2568.0,2581.1,557117,1434728123.0,5559,2023-11-30 11:50:00
1166,YNDX,968,706,219826130.0,219826130.0,87435,91795,2514.2,2584.4,179230,457064135.0,1674,756,646,204019079.0,204019079.0,79376,86590,2570.3,2585.2,165966,427875811.0,1402,2023-11-30 11:55:00
1167,YNDX,826,867,143051408.0,143051408.0,56393,104825,2536.7,2583.5,161218,413868690.0,1693,614,821,133964148.0,133964148.0,52075,99059,2572.5,2583.1,151134,389840863.0,1435,2023-11-30 12:00:00
1168,YNDX,3300,10235,490788343.0,490788343.0,191538,1241114,2562.4,2576.6,1432652,3688684692.0,13535,3047,10099,483370344.0,483370344.0,188034,1235596,2570.7,2577.0,1423630,3667521863.0,13146,2023-11-30 12:05:00
1169,YNDX,6151,5966,1184438068.0,1184438068.0,462231,631601,2562.4,2575.2,1093832,2810956363.0,12117,5727,5856,1169673121.0,1169673121.0,454746,627340,2572.1,2577.7,1082086,2786789804.0,11583,2023-11-30 12:10:00
1170,YNDX,10642,11164,1978787124.0,1978787124.0,773246,1490943,2559.1,2566.4,2264189,5805191641.0,21806,9207,10717,1905228020.0,1905228020.0,742870,1469612,2564.7,2571.2,2212482,5683869358.0,19924,2023-11-30 12:15:00
1171,YNDX,9753,7970,1602578532.0,1602578532.0,624771,762544,2565.1,2571.7,1387315,3563622203.0,17723,9479,7880,1597357477.0,1597357477.0,622534,758897,2565.9,2572.9,1381431,3549895002.0,17359,2023-11-30 12:20:00
1172,YNDX,13119,11387,2834077320.0,2834077320.0,1106946,880566,2560.3,2578.5,1987512,5104656283.0,24506,12937,11269,2828716125.0,2828716125.0,1101276,877470,2568.6,2578.8,1978746,5091512981.0,24206,2023-11-30 12:25:00
1173,YNDX,10159,7237,2446226108.0,2446226108.0,953272,605834,2566.1,2576.1,1559106,4006918249.0,17396,9964,7148,2427655148.0,2427655148.0,945678,603577,2567.1,2577.0,1549255,3983049934.0,17112,2023-11-30 12:30:00
1174,YNDX,16977,7513,3540782605.0,3540782605.0,1379995,800571,2565.8,2574.7,2180566,5602021684.0,24490,16761,7415,3530453170.0,3530453170.0,1375893,795382,2565.9,2575.2,2171275,5578692259.0,24176,2023-11-30 12:35:00
1175,YNDX,22766,9587,3085760985.0,3085760985.0,1202869,884583,2565.3,2574.4,2087452,5363011935.0,32353,22571,9481,3079744836.0,3079744836.0,1200351,881585,2565.7,2574.8,2081936,5349681761.0,32052,2023-11-30 12:40:00
1176,YNDX,6878,6214,1782155143.0,1782155143.0,704438,623901,2529.9,2578.9,1328339,3391115347.0,13092,6644,6069,1778204009.0,1778204009.0,692607,613295,2567.4,2579.2,1305902,3359987493.0,12713,2023-11-30 12:45:00
1177,YNDX,9362,4962,2496852877.0,2496852877.0,972132,485043,2568.4,2585.7,1457175,3751024050.0,14324,9155,4794,2492279338.0,2492279338.0,968184,482683,2574.2,2588.7,1450867,3741814483.0,13949,2023-11-30 12:50:00
1178,YNDX,2837,1744,782199176.0,782199176.0,303722,169066,2575.4,2589.3,472788,1219963959.0,4581,2662,1559,775733450.0,775733450.0,300967,156877,2577.5,2592.4,457844,1182421869.0,4221,2023-11-30 12:55:00
1179,YNDX,3173,2976,833122001.0,833122001.0,324245,296956,2569.4,2566.0,621201,1595123408.0,6149,2984,2851,829668200.0,829668200.0,321735,289802,2578.7,2593.5,611537,1581260037.0,5835,2023-11-30 13:00:00
1180,YNDX,15917,7370,3777289300.0,3777289300.0,1465366,709386,2577.7,2587.9,2174752,5613137517.0,23287,15741,7281,3774455624.0,3774455624.0,1464064,706349,2578.1,2588.4,2170413,5602778970.0,23022,2023-11-30 13:05:00
1181,YNDX,7970,5241,2011323621.0,2011323621.0,782199,479205,2571.4,2587.2,1261404,3251134509.0,13211,7766,5175,2003061381.0,2003061381.0,777860,475135,2575.1,2589.8,1252995,3233557999.0,12941,2023-11-30 13:10:00
1182,YNDX,5503,7998,1403880637.0,1403880637.0,547551,699332,2563.9,2583.5,1246883,3210631725.0,13501,5322,7815,1401010837.0,1401010837.0,544871,696422,2571.3,2584.7,1241293,3201038693.0,13137,2023-11-30 13:15:00
1183,YNDX,5140,6927,1209756893.0,1209756893.0,470583,524272,2570.8,2582.7,994855,2563805537.0,12067,4920,6846,1192598838.0,1192598838.0,463882,519311,2570.9,2583.7,983193,2534323197.0,11766,2023-11-30 13:20:00
1184,YNDX,2578,3311,643574445.0,643574445.0,250740,375310,2566.7,2581.3,626050,1612376059.0,5889,2377,3234,640894098.0,640894098.0,249209,373360,2571.7,2585.1,622569,1606085433.0,5611,2023-11-30 13:25:00
1185,YNDX,4308,4720,1242849413.0,1242849413.0,485880,524915,2557.9,2586.7,1010795,2600621514.0,9028,4122,4598,1240041462.0,1240041462.0,481976,522295,2572.8,2587.9,1004271,2591676887.0,8720,2023-11-30 13:30:00
1186,YNDX,5804,8855,1642627444.0,1642627444.0,639818,643508,2567.3,2585.5,1283326,3306428487.0,14659,5651,8769,1630811633.0,1630811633.0,633389,636907,2574.7,2587.1,1270296,3278534554.0,14420,2023-11-30 13:35:00
1187,YNDX,4039,3650,1214007275.0,1214007275.0,471915,372090,2572.5,2587.8,844005,2176915299.0,7689,3902,3605,1211437413.0,1211437413.0,470764,370503,2573.3,2589.4,841267,2170806614.0,7507,2023-11-30 13:40:00
1188,YNDX,5524,7706,1228669666.0,1228669666.0,478094,509530,2569.9,2581.0,987624,2543783960.0,13230,5379,7615,1221112234.0,1221112234.0,474285,507268,2574.6,2582.4,981553,2531065260.0,12994,2023-11-30 13:45:00
1189,YNDX,7133,6389,1411406961.0,1411406961.0,548138,403401,2574.9,2585.7,951539,2454481715.0,13522,6924,6304,1396754153.0,1396754153.0,541864,399344,2577.7,2585.9,941208,2429401167.0,13228,2023-11-30 13:50:00
1190,YNDX,1175,753,242566678.0,242566678.0,94917,60227,2555.6,2563.3,155144,396943768.0,1928,1032,706,239131903.0,239131903.0,92746,60679,2578.4,2589.1,153425,396236071.0,1738,2023-11-30 13:55:00
1191,YNDX,1965,1502,478403968.0,478403968.0,185877,106189,2573.8,2584.3,292066,752830256.0,3467,1741,1449,448518539.0,448518539.0,173849,104879,2579.9,2588.4,278728,719985874.0,3190,2023-11-30 14:00:00
1192,YNDX,2334,3467,588011573.0,588011573.0,228440,422137,2574.0,2584.2,650577,1678895099.0,5801,2174,3379,572192854.0,572192854.0,221812,412055,2579.6,2586.8,633867,1638094536.0,5553,2023-11-30 14:05:00
1193,YNDX,3433,5053,769904368.0,769904368.0,298502,479155,2579.2,2582.3,777657,2007204949.0,8486,3251,4965,761865340.0,761865340.0,295303,477140,2579.9,2585.5,772443,1995525927.0,8216,2023-11-30 14:10:00
1194,YNDX,6833,11947,1206649668.0,1206649668.0,469486,1255043,2570.2,2580.6,1724529,4445464881.0,18780,6639,11866,1198298914.0,1198298914.0,465043,1252176,2576.7,2583.2,1717219,4432965782.0,18505,2023-11-30 14:15:00
1195,YNDX,3786,7340,705853523.0,705853523.0,274671,846347,2569.8,2581.5,1121018,2890711471.0,11126,3642,7265,702670876.0,702670876.0,272963,843956,2574.2,2582.7,1116919,2882392841.0,10907,2023-11-30 14:20:00
1196,YNDX,6406,16098,1223970434.0,1223970434.0,476585,1386941,2568.2,2583.0,1863526,4806480288.0,22504,6245,16043,1217523323.0,1217523323.0,473098,1385215,2573.5,2583.5,1858313,4796263829.0,22288,2023-11-30 14:25:00
1197,YNDX,3302,7207,816316661.0,816316661.0,317651,831050,2569.9,2582.1,1148701,2962193346.0,10509,3181,7156,812931972.0,812931972.0,316275,829284,2570.3,2585.3,1145559,2956842143.0,10337,2023-11-30 14:30:00
1198,YNDX,3163,6306,805874838.0,805874838.0,313765,777073,2568.4,2585.0,1090838,2814645041.0,9469,2999,6271,803434811.0,803434811.0,312759,777218,2568.9,2585.4,1089977,2812826659.0,9270,2023-11-30 14:35:00
1199,YNDX,1929,4341,483961881.0,483961881.0,188256,559891,2570.8,2585.1,748147,1931325261.0,6270,1836,4280,483616433.0,483616433.0,188110,559993,2570.9,2585.3,748103,1931371958.0,6116,2023-11-30 14:40:00
1200,YNDX,3860,14632,772111252.0,772111252.0,303090,918062,2547.5,2584.3,1221152,3144650307.0,18492,3778,14550,759685986.0,759685986.0,295058,914309,2574.7,2584.6,1209367,3122796144.0,18328,2023-11-30 14:45:00
1201,YNDX,1268,1202,325266686.0,325266686.0,126664,118546,2567.9,2591.1,245210,632433516.0,2470,1228,1157,323654043.0,323654043.0,125833,117463,2572.1,2591.5,243296,628064993.0,2385,2023-11-30 14:50:00
1202,YNDX,1235,1031,365958292.0,365958292.0,143739,103802,2546.0,2591.4,247541,634946848.0,2266,1167,961,365223658.0,365223658.0,141860,102189,2574.5,2592.1,244049,630108905.0,2128,2023-11-30 14:55:00
1203,YNDX,1525,548,414055718.0,414055718.0,160653,51632,2577.3,2586.8,212285,547618976.0,2073,1496,509,412538847.0,412538847.0,160016,49545,2578.1,2591.1,209561,540913572.0,2005,2023-11-30 15:00:00
1204,YNDX,570,478,162720527.0,162720527.0,63455,60301,2564.3,2587.4,123756,318745155.0,1048,533,453,158714641.0,158714641.0,61736,53580,2570.9,2589.5,115316,297458519.0,986,2023-11-30 15:05:00
1205,YNDX,814,847,184312464.0,184312464.0,72252,75061,2551.0,2586.0,147313,378422764.0,1661,753,816,182865858.0,182865858.0,71147,73722,2570.3,2588.0,144869,373654747.0,1569,2023-11-30 15:10:00
1206,YNDX,288,1022,98376332.0,98376332.0,38337,64934,2566.1,2584.5,103271,266199435.0,1310,249,1000,93976959.0,93976959.0,36574,64374,2569.5,2585.6,100948,260423510.0,1249,2023-11-30 15:15:00
1207,YNDX,958,1086,219332456.0,219332456.0,85383,95877,2568.8,2583.9,181260,467069999.0,2044,877,1014,215127976.0,215127976.0,83671,88011,2571.1,2585.2,171682,442657620.0,1891,2023-11-30 15:20:00
1208,YNDX,3313,1118,515350086.0,515350086.0,201320,118040,2559.9,2577.7,319360,819617105.0,4431,3262,1069,507354265.0,507354265.0,197765,113980,2565.4,2582.5,311745,801705271.0,4331,2023-11-30 15:25:00
1209,YNDX,1756,710,308118430.0,308118430.0,120197,80915,2563.4,2582.7,201112,517097475.0,2466,1692,674,306585944.0,306585944.0,119589,78263,2563.7,2585.0,197852,508895341.0,2366,2023-11-30 15:30:00
1210,YNDX,3479,5489,977295466.0,977295466.0,383641,657741,2547.4,2573.3,1041382,2669869702.0,8968,3264,5347,950140183.0,950140183.0,370876,644058,2561.9,2575.9,1014934,2609191099.0,8611,2023-11-30 15:35:00
1211,YNDX,2534,10562,756288060.0,756288060.0,295652,1459085,2558.0,2574.4,1754737,4512495425.0,13096,2373,10459,739174538.0,739174538.0,288759,1451868,2559.8,2574.6,1740627,4477092233.0,12832,2023-11-30 15:40:00
1212,YNDX,1926,13393,476553903.0,476553903.0,186380,1961592,2556.9,2573.6,2147972,5524974818.0,15319,1872,13352,474627290.0,474627290.0,185463,1962109,2559.1,2573.7,2147572,5524503841.0,15224,2023-11-30 15:45:00
1213,YNDX,3058,9992,736595432.0,736595432.0,287484,1298350,2562.2,2574.1,1585834,4078645063.0,13050,2978,9916,722027015.0,722027015.0,281807,1294360,2562.1,2574.1,1576167,4053888188.0,12894,2023-11-30 15:50:00
1214,YNDX,6916,6801,1713104513.0,1713104513.0,667129,498205,2567.9,2578.9,1165334,2997906694.0,13717,6844,6709,1711501491.0,1711501491.0,666316,493833,2568.6,2580.1,1160149,2985616187.0,13553,2023-11-30 15:55:00
1215,YNDX,8867,1588,1649059847.0,1649059847.0,641902,154298,2569.0,2581.3,796200,2047343640.0,10455,8853,1550,1652031577.0,1652031577.0,643000,153013,2569.3,2582.1,796013,2047129698.0,10403,2023-11-30 16:00:00
1216,YNDX,2722,2219,779929926.0,779929926.0,304226,222112,2563.7,2577.9,526338,1352520565.0,4941,2667,2170,782075331.0,782075331.0,305022,217649,2564.0,2579.9,522671,1343598402.0,4837,2023-11-30 16:05:00
1217,YNDX,5703,8052,1437686320.0,1437686320.0,562418,894404,2556.3,2565.4,1456822,3732227282.0,13755,5349,7839,1402613442.0,1402613442.0,548303,881934,2558.1,2568.7,1430237,3668068386.0,13188,2023-11-30 16:10:00
1218,YNDX,4257,7521,943739801.0,943739801.0,370258,685283,2548.9,2559.6,1055541,2697773603.0,11778,3934,7365,910643321.0,910643321.0,357016,670707,2550.7,2563.7,1027723,2630117294.0,11299,2023-11-30 16:15:00
1219,YNDX,4914,13282,969273012.0,969273012.0,380868,1706394,2544.9,2559.1,2087262,5336042972.0,18196,4652,13109,939562051.0,939562051.0,368827,1691193,2547.4,2559.9,2060020,5268821039.0,17761,2023-11-30 16:20:00
1220,YNDX,3919,4274,922522427.0,922522427.0,363746,517303,2536.2,2539.6,881049,2236240393.0,8193,3278,3974,852052443.0,852052443.0,335241,485504,2541.6,2556.1,820745,2093052201.0,7252,2023-11-30 16:25:00
1221,YNDX,3684,5204,792764870.0,792764870.0,313021,629650,2532.6,2548.9,942671,2397702614.0,8888,3425,5115,785356797.0,785356797.0,309345,625819,2538.8,2553.7,935164,2383519912.0,8540,2023-11-30 16:30:00
1222,YNDX,5008,7240,1545187360.0,1545187360.0,616876,656074,2504.9,2557.4,1272950,3223027368.0,12248,4666,6815,1521498129.0,1521498129.0,606783,619896,2507.5,2560.5,1226679,3108713055.0,11481,2023-11-30 16:35:00
1223,YNDX,2685,2893,840461775.0,840461775.0,330793,179069,2540.7,2555.4,509862,1298050498.0,5578,2544,2822,834342808.0,834342808.0,327744,178161,2545.7,2560.2,505905,1290479468.0,5366,2023-11-30 16:40:00
1224,YNDX,2941,2172,726012841.0,726012841.0,285123,157762,2546.3,2562.3,442885,1130250981.0,5113,2889,2116,722802307.0,722802307.0,283609,157737,2548.6,2563.5,441346,1127165932.0,5005,2023-11-30 16:45:00
1225,YNDX,1502,13467,404104550.0,404104550.0,159258,2127949,2537.4,2554.1,2287207,5839009945.0,14969,1287,13349,385494352.0,385494352.0,151679,2120074,2541.5,2554.5,2271753,5801316380.0,14636,2023-11-30 16:50:00
1226,YNDX,2158,9399,494503325.0,494503325.0,195095,1141605,2534.7,2539.3,1336700,3393369398.0,11557,1868,9213,476422212.0,476422212.0,187732,1122049,2537.8,2550.4,1309781,3338051523.0,11081,2023-11-30 16:55:00
1227,YNDX,1804,4031,543249780.0,543249780.0,214751,599468,2529.7,2553.5,814219,2073981924.0,5835,1589,3946,522010227.0,522010227.0,205603,601649,2538.9,2554.5,807252,2058946154.0,5535,2023-11-30 17:00:00
1228,YNDX,4341,8162,721452687.0,721452687.0,284250,733759,2538.1,2552.8,1018009,2594576472.0,12503,4196,8072,716336119.0,716336119.0,282022,731323,2540.0,2553.3,1013345,2583622810.0,12268,2023-11-30 17:05:00
1229,YNDX,3079,5735,722083399.0,722083399.0,284666,707778,2536.6,2535.8,992444,2516873390.0,8814,2939,5661,709982919.0,709982919.0,279661,702781,2538.7,2550.5,982442,2502420256.0,8600,2023-11-30 17:10:00
1230,YNDX,3974,6945,875529033.0,875529033.0,344668,693673,2540.2,2556.7,1038341,2649009002.0,10919,3754,6835,862030989.0,862030989.0,338985,688203,2543.0,2556.6,1027188,2621502421.0,10589,2023-11-30 17:15:00
1231,YNDX,1590,1854,328661873.0,328661873.0,129153,143679,2544.7,2555.7,272832,695867729.0,3444,1489,1787,330720937.0,330720937.0,129904,142082,2545.9,2561.6,271986,694676988.0,3276,2023-11-30 17:20:00
1232,YNDX,2679,5350,693646913.0,693646913.0,273225,719605,2538.7,2556.5,992830,2533311909.0,8029,2591,5270,685226633.0,685226633.0,269753,713462,2540.2,2556.6,983215,2509264296.0,7861,2023-11-30 17:25:00
1233,YNDX,4680,7533,918390012.0,918390012.0,361555,918040,2540.1,2543.9,1279595,3253752050.0,12213,4509,7444,889051932.0,889051932.0,349881,913655,2541.0,2554.6,1263536,3223070122.0,11953,2023-11-30 17:30:00
1234,YNDX,3381,5617,885533847.0,885533847.0,349277,632611,2535.3,2557.1,981888,2503176614.0,8998,3285,5543,881509055.0,881509055.0,346848,629940,2541.5,2557.3,976788,2492470735.0,8828,2023-11-30 17:35:00
1235,YNDX,2954,3370,569134378.0,569134378.0,223624,362114,2545.1,2557.0,585738,1495052265.0,6324,2836,3247,557953458.0,557953458.0,219099,350748,2546.6,2559.0,569847,1455516395.0,6083,2023-11-30 17:40:00
1236,YNDX,2392,5007,527328571.0,527328571.0,207635,573615,2539.7,2553.8,781250,1992213072.0,7399,2302,4925,518416127.0,518416127.0,204011,567413,2541.1,2554.7,771424,1967999372.0,7227,2023-11-30 17:45:00
1237,YNDX,3136,8085,638897255.0,638897255.0,251965,944324,2535.7,2553.3,1196289,3050066450.0,11221,2981,8030,634175131.0,634175131.0,249669,964008,2540.1,2560.9,1213677,3102941589.0,11011,2023-11-30 17:50:00
1238,YNDX,3663,12275,777030670.0,777030670.0,306287,1063367,2536.9,2552.9,1369654,3491687298.0,15938,3518,12186,764091477.0,764091477.0,300808,1051755,2540.1,2552.9,1352563,3449167705.0,15704,2023-11-30 17:55:00
1239,YNDX,2623,1900,485381380.0,485381380.0,190967,211668,2541.7,2548.5,402635,1024820837.0,4523,2533,1839,471674833.0,471674833.0,185394,206679,2544.2,2558.4,392073,1000437142.0,4372,2023-11-30 18:00:00
1240,YNDX,15708,6668,2092858634.0,2092858634.0,821513,848390,2547.6,2555.7,1669903,4261075477.0,22376,15319,6612,2083750660.0,2083750660.0,817504,846424,2548.9,2555.8,1663928,4247061765.0,21931,2023-11-30 18:05:00
1241,YNDX,1596,966,395807091.0,395807091.0,155646,89650,2543.0,2557.5,245296,625085457.0,2562,1458,911,387922139.0,387922139.0,152289,88261,2547.3,2564.7,240550,614287021.0,2369,2023-11-30 18:10:00
1242,YNDX,1439,984,387466065.0,387466065.0,152805,94033,2535.7,2553.0,246838,627529040.0,2423,1283,911,380221154.0,380221154.0,149265,90163,2547.3,2563.4,239428,611345076.0,2194,2023-11-30 18:15:00
1243,YNDX,1334,1070,339303375.0,339303375.0,134113,96243,2530.0,2561.3,230356,585814022.0,2404,1171,1016,333102908.0,333102908.0,130842,91664,2545.8,2561.9,222506,567939524.0,2187,2023-11-30 18:20:00
1244,YNDX,1187,1483,347122818.0,347122818.0,136928,111514,2535.1,2560.2,248442,632623718.0,2670,1098,1438,343388413.0,343388413.0,134812,110619,2547.2,2561.6,245431,626746250.0,2536,2023-11-30 18:25:00
1245,YNDX,2813,5674,669333949.0,669333949.0,263907,743206,2536.2,2555.1,1007113,2568297731.0,8487,2604,5613,658721253.0,658721253.0,259125,732849,2542.1,2556.2,991974,2532010558.0,8217,2023-11-30 18:30:00
1246,YNDX,2386,6978,414700520.0,414700520.0,163315,898628,2539.3,2552.4,1061943,2708340948.0,9364,2284,6938,409135246.0,409135246.0,160980,896357,2541.5,2553.2,1057337,2697747983.0,9222,2023-11-30 18:35:00
1247,YNDX,3473,9712,654778629.0,654778629.0,258470,1008949,2533.3,2549.7,1267419,3227270555.0,13185,3389,9639,646414136.0,646414136.0,254430,1002960,2540.6,2552.6,1257390,3206532031.0,13028,2023-11-30 18:40:00
0,MTLR,37083,33567,5915852597.0,5623253838.0,22259198,20843285,265.77,269.79,43102483,11539106435.0,70650,32450,31006,5412431998.0,5060205734.0,20392792,18997327,265.41,266.36,39390119,10472637732.0,63456,2023-11-01 10:05:00
1,MTLR,38750,47708,5990062461.0,9142518251.0,22375303,34175994,267.71,267.51,56551297,15132580712.0,86458,37220,46182,5808316408.0,8946031588.0,21760427,33468858,266.92,267.29,55229285,14754347996.0,83402,2023-11-01 10:10:00
2,MTLR,25204,25977,4493067611.0,5261935281.0,16733691,19511626,268.5,269.68,36245317,9755002892.0,51181,23976,24797,4391043662.0,5206484017.0,16392909,19279372,267.86,270.05,35672281,9597527680.0,48773,2023-11-01 10:15:00
3,MTLR,23538,32304,3889605047.0,7084484701.0,14525242,26413129,267.78,268.22,40938371,10974089748.0,55842,22115,31501,3796536980.0,7021595541.0,14209482,26125526,267.18,268.76,40335008,10818132522.0,53616,2023-11-01 10:20:00
4,MTLR,18110,28393,3144107507.0,5319348750.0,11726666,19861811,268.12,267.82,31588477,8463456257.0,46503,17204,27518,3059036093.0,5240803540.0,11427083,19532218,267.7,268.32,30959301,8299839633.0,44722,2023-11-01 10:25:00
5,MTLR,15989,13771,2871459009.0,2785600366.0,10682066,10380063,268.81,268.36,21062129,5657059376.0,29760,15214,12917,2776555899.0,2746308070.0,10367889,10225607,267.8,268.57,20593496,5522863970.0,28131,2023-11-01 10:30:00
6,MTLR,23059,16029,4342085560.0,2854205951.0,16089662,10609745,269.87,269.02,26699407,7196291512.0,39088,22282,15361,4254812565.0,2758671727.0,15854128,10248111,268.37,269.19,26102239,7013484292.0,37643,2023-11-01 10:35:00
7,MTLR,28420,16602,5655334461.0,2678312014.0,20673507,9940312,273.55,269.44,30613819,8333646475.0,45022,27055,15276,5447688783.0,2574842928.0,20239019,9541388,269.17,269.86,29780407,8022531712.0,42331,2023-11-01 10:40:00
8,MTLR,17405,20138,2999331351.0,3919950633.0,11135210,14585429,269.36,268.76,25720639,6919281985.0,37543,16125,18943,2898641617.0,3786069297.0,10777025,14041037,268.96,269.64,24818062,6684710914.0,35068,2023-11-01 10:45:00
9,MTLR,8400,15865,1208504514.0,3067290414.0,4493383,11464278,268.95,267.55,15957661,4275794928.0,24265,7272,15043,1131122453.0,2974524275.0,4216046,11067195,268.29,268.77,15283241,4105646729.0,22315,2023-11-01 10:50:00
10,MTLR,19377,12793,2837805004.0,2107516880.0,10572210,7843073,268.42,268.71,18415283,4945321885.0,32170,18876,12321,2805215831.0,2084704344.0,10459647,7752910,268.19,268.89,18212557,4889920175.0,31197,2023-11-01 10:55:00
11,MTLR,18658,20215,2921067948.0,4231931378.0,10898184,15822579,268.03,267.46,26720763,7152999326.0,38873,17692,19478,2835498946.0,4156986534.0,10585166,15500512,267.87,268.18,26085678,6992485480.0,37170,2023-11-01 11:00:00
12,MTLR,16366,11939,3046976576.0,2781219427.0,11392231,10424666,267.46,266.79,21816897,5828196004.0,28305,15517,11029,2961082026.0,2695778874.0,11108701,10086254,266.56,267.27,21194955,5656860900.0,26546,2023-11-01 11:05:00
13,MTLR,24633,14363,5114148732.0,2318903946.0,19129020,8683497,267.35,267.05,27812517,7433052678.0,38996,23802,13617,5028273242.0,2232997247.0,18832648,8347289,267.0,267.51,27179937,7261270489.0,37419,2023-11-01 11:10:00
14,MTLR,16371,8057,3688116305.0,1782710689.0,13790638,6659477,267.44,267.7,20450115,5470826994.0,24428,16010,7779,3648430063.0,1754207578.0,13655593,6551371,267.17,267.76,20206964,5402637641.0,23789,2023-11-01 11:15:00
15,MTLR,19071,8074,4942930655.0,1313711160.0,18416665,4892877,268.39,268.49,23309542,6256641815.0,27145,18578,7450,4899093752.0,1275241384.0,18278345,4741343,268.03,268.96,23019688,6174335136.0,26028,2023-11-01 11:20:00
16,MTLR,23165,21886,4620447494.0,3800864417.0,17238041,14185983,268.04,267.93,31424024,8421311911.0,45051,22625,21467,4578582773.0,3765057828.0,17110351,14040261,267.59,268.16,31150612,8343640602.0,44092,2023-11-01 11:25:00
17,MTLR,10057,22080,1388167928.0,4963022302.0,5187326,18519220,267.61,267.99,23706546,6351190231.0,32137,9715,21800,1362646251.0,4944458523.0,5096295,18442426,267.38,268.1,23538721,6307104775.0,31515,2023-11-01 11:30:00
18,MTLR,12091,10258,2128258770.0,2585324740.0,7956779,9658690,267.48,267.67,17615469,4713583510.0,22349,11745,10006,2113847818.0,2548378513.0,7906975,9511435,267.34,267.93,17418410,4662226332.0,21751,2023-11-01 11:35:00
19,MTLR,18289,9771,3463491319.0,1733999842.0,12927318,6473740,267.92,267.85,19401058,5197491162.0,28060,17970,9543,3426747070.0,1717918524.0,12802353,6406531,267.67,268.15,19208884,5144665595.0,27513,2023-11-01 11:40:00
20,MTLR,16198,7713,2864972792.0,1504491777.0,10687944,5606517,268.06,268.35,16294461,4369464569.0,23911,15943,7488,2844130023.0,1492856919.0,10620542,5560604,267.8,268.47,16181146,4336986943.0,23431,2023-11-01 11:45:00
21,MTLR,6165,3559,1105579995.0,705559919.0,4091128,2625262,270.24,268.76,6716390,1811139915.0,9724,5567,3078,1054196459.0,693517446.0,3931193,2577521,268.16,269.06,6508714,1747713906.0,8645,2023-11-01 11:50:00
22,MTLR,14363,10361,2812729280.0,1640910012.0,10443361,6103770,269.33,268.84,16547131,4453639293.0,24724,13772,9716,2776231306.0,1591933562.0,10330823,5914178,268.73,269.17,16245001,4368164868.0,23488,2023-11-01 11:55:00
23,MTLR,13960,11039,2680009307.0,1917233731.0,9970902,7133949,268.78,268.75,17104851,4597243038.0,24999,13413,10401,2636050007.0,1877958848.0,9817033,6981831,268.52,268.98,16798864,4514008855.0,23814,2023-11-01 12:00:00
24,MTLR,9913,8088,1850595819.0,1002435920.0,6854159,3727149,270.0,268.96,10581308,2853031740.0,18001,9314,7482,1801180052.0,968051890.0,6698926,3594611,268.88,269.31,10293537,2769231942.0,16796,2023-11-01 12:05:00
25,MTLR,17390,13995,3426417997.0,2256705473.0,12653031,8376759,270.8,269.4,21029790,5683123471.0,31385,16703,13023,3300007165.0,2182781715.0,12231394,8082588,269.8,270.06,20313982,5482788881.0,29726,2023-11-01 12:10:00
26,MTLR,20848,11840,3669831233.0,1721412730.0,13513994,6355015,271.56,270.87,19869009,5391243963.0,32688,19696,9822,3504978268.0,1596215237.0,12957878,5886849,270.49,271.15,18844727,5101193506.0,29518,2023-11-01 12:15:00
27,MTLR,8988,17912,1473726445.0,3681025849.0,5435148,13607539,271.15,270.51,19042687,5154752295.0,26900,8272,17109,1392701792.0,3594055277.0,5153545,13255507,270.24,271.14,18409052,4986757069.0,25381,2023-11-01 12:20:00
28,MTLR,19462,17521,3043520281.0,3040591495.0,11244574,11231439,270.67,270.72,22476013,6084111776.0,36983,18822,17099,3009803897.0,3011224677.0,11131809,11113261,270.38,270.96,22245070,6021028574.0,35921,2023-11-01 12:25:00
29,MTLR,6012,10620,533987749.0,2533732899.0,1973549,9384518,270.57,269.99,11358067,3067720649.0,16632,5400,10073,494990183.0,2498865128.0,1832280,9238426,270.15,270.49,11070706,2993855312.0,15473,2023-11-01 12:30:00
30,MTLR,9649,8140,1618637396.0,2110703337.0,6004983,7830811,269.55,269.54,13835794,3729340733.0,17789,9155,7766,1567360941.0,2070712627.0,5820471,7664495,269.28,270.17,13484966,3638073568.0,16921,2023-11-01 12:35:00
31,MTLR,17083,12491,3934684428.0,2380055511.0,14559357,8801482,270.25,270.42,23360839,6314739939.0,29574,16719,12001,3896676837.0,2333676188.0,14441947,8626391,269.82,270.53,23068338,6230353026.0,28720,2023-11-01 12:40:00
32,MTLR,23046,10010,6214770245.0,1406029860.0,23001612,5184188,270.19,271.22,28185800,7620800105.0,33056,22804,9730,6182097331.0,1371913816.0,22885773,5062769,270.13,270.98,27948542,7554011148.0,32534,2023-11-01 12:45:00
33,MTLR,24575,10094,6803576730.0,1423946827.0,25065172,5255036,271.44,270.97,30320208,8227523557.0,34669,24130,9636,6752931981.0,1360648259.0,24899168,5020507,271.21,271.02,29919675,8113580241.0,33766,2023-11-01 12:50:00
34,MTLR,9676,7173,2697880187.0,1637385512.0,9955255,5779585,271.0,283.31,15734840,4335265699.0,16849,9368,6687,2663210208.0,1629815036.0,9841261,5729061,270.62,284.48,15570322,4293025245.0,16055,2023-11-01 12:55:00
35,MTLR,4322,6665,1128647948.0,1641065290.0,4171951,6066742,270.53,270.5,10238693,2769713239.0,10987,4011,6398,1116421407.0,1617183766.0,4062129,5968422,274.84,270.96,10030551,2733605173.0,10409,2023-11-01 13:00:00
36,MTLR,9455,13513,1717904574.0,2501809553.0,6366279,9283740,269.84,269.48,15650019,4219714128.0,22968,8697,13070,1671718532.0,2428321591.0,6201359,8986853,269.57,270.21,15188212,4100040123.0,21767,2023-11-01 13:05:00
37,MTLR,14371,15064,2500018418.0,4168658291.0,9293088,15476312,269.02,269.36,24769400,6668676709.0,29435,13486,14661,2441123721.0,4102020512.0,9079576,15208993,268.86,269.71,24288569,6543144234.0,28147,2023-11-01 13:10:00
38,MTLR,21118,24139,3779914474.0,5662939713.0,14038875,21047508,269.25,269.06,35086383,9442854187.0,45257,20298,23623,3707113749.0,5611587244.0,13792774,20828266,268.77,269.42,34621040,9318700994.0,43921,2023-11-01 13:15:00
39,MTLR,9723,16576,1300233136.0,3559365495.0,4836726,13212431,268.83,269.4,18049157,4859598631.0,26299,9356,16232,1283307824.0,3531100018.0,4779012,13104573,268.53,269.46,17883585,4814407843.0,25588,2023-11-01 13:20:00
40,MTLR,6225,5977,988730897.0,1146971290.0,3662507,4251722,269.96,269.77,7914229,2135702188.0,12202,5903,5746,961407122.0,1126539943.0,3573426,4173439,269.04,269.93,7746865,2087947065.0,11649,2023-11-01 13:25:00
41,MTLR,3355,5292,445782535.0,742090134.0,1656342,2757018,269.14,269.16,4413360,1187872670.0,8647,3084,5076,435343757.0,721748429.0,1619044,2673452,268.89,269.97,4292496,1157092187.0,8160,2023-11-01 13:30:00
42,MTLR,10948,18809,2506138502.0,3203697598.0,9293214,11890962,269.67,269.42,21184176,5709836100.0,29757,10783,18615,2483038187.0,3196796950.0,9228704,11862745,269.06,269.48,21091449,5679835138.0,29398,2023-11-01 13:35:00
43,MTLR,26983,16556,6725150732.0,2288447088.0,24951441,8477092,269.53,269.96,33428533,9013597821.0,43539,26770,16026,6707882271.0,2268465320.0,24900473,8400242,269.39,270.05,33300715,8976347591.0,42796,2023-11-01 13:40:00
44,MTLR,36082,42773,5165619698.0,8390613987.0,19186188,31113382,269.24,269.68,50299570,13556233685.0,78855,35890,42621,5147522054.0,8378583726.0,19120195,31063519,269.22,269.72,50183714,13526105781.0,78511,2023-11-01 13:45:00
45,MTLR,1143,878,162950421.0,98468591.0,605802,366163,268.98,268.92,971965,261419013.0,2021,1020,819,161609081.0,97762406.0,601619,361813,268.62,270.2,963432,259371487.0,1839,2023-11-01 13:50:00
46,MTLR,1672,1953,319560598.0,458478884.0,1185676,1702545,269.52,269.29,2888221,778039483.0,3625,1525,1869,309356876.0,447004305.0,1149753,1654618,269.06,270.16,2804371,756361181.0,3394,2023-11-01 13:55:00
47,MTLR,23788,29202,3443854884.0,7347491920.0,12795462,27268396,269.15,269.45,40063858,10791346804.0,52990,23493,29064,3422664452.0,7337578040.0,12724798,27221489,268.98,269.55,39946287,10760242493.0,52557,2023-11-01 14:00:00
48,MTLR,15611,11881,7958671272.0,4060078712.0,29487402,15053108,269.9,269.72,44540510,12018749984.0,27492,15243,11517,7917917038.0,4033567613.0,29356838,14949149,269.71,269.82,44305987,11951484652.0,26760,2023-11-01 14:05:00
49,MTLR,4639,8671,696437269.0,2008024648.0,2584043,7439539,269.51,269.91,10023582,2704461918.0,13310,4426,8477,698887046.0,1999191603.0,2586892,7404292,270.16,270.0,9991184,2698078650.0,12903,2023-11-01 14:10:00
50,MTLR,6411,9594,1385326804.0,3370550812.0,5138421,12500443,269.6,269.63,17638864,4755877616.0,16005,6204,9391,1362718252.0,3355953129.0,5060753,12434223,269.27,269.9,17494976,4718671381.0,15595,2023-11-01 14:15:00
51,MTLR,8532,1438,2759385852.0,157479254.0,10203330,583518,270.44,269.88,10786848,2916865107.0,9970,8283,1016,2740039218.0,135821605.0,10141994,499531,270.17,271.9,10641525,2875860824.0,9299,2023-11-01 14:20:00
52,MTLR,2562,3571,351614234.0,598998130.0,1298282,2217986,270.83,270.06,3516268,950612364.0,6133,2313,3158,337313634.0,578174039.0,1250545,2136198,269.73,270.66,3386743,915487673.0,5471,2023-11-01 14:25:00
53,MTLR,2639,4135,344527138.0,817126930.0,1275708,3028650,270.07,269.8,4304358,1161654068.0,6774,2408,3995,331310566.0,814350362.0,1229091,3012857,269.56,270.29,4241948,1145660929.0,6403,2023-11-01 14:30:00
54,MTLR,6044,9164,1075531809.0,1821056195.0,3970533,6739499,270.88,270.21,10710032,2896588005.0,15208,5710,8900,1021944092.0,1795373518.0,3785891,6635616,269.93,270.57,10421507,2817317610.0,14610,2023-11-01 14:35:00
55,MTLR,5903,4880,1340007037.0,907531195.0,4907386,3326868,273.06,272.79,8234254,2247538232.0,10783,5326,4011,1267170871.0,857746154.0,4687303,3131178,270.34,273.94,7818481,2124917025.0,9337,2023-11-01 14:40:00
56,MTLR,6154,5157,1160372239.0,878864323.0,4282431,3245125,270.96,270.83,7527556,2039236562.0,11311,5556,4801,1127721469.0,839045688.0,4167319,3084101,270.61,272.06,7251420,1966767158.0,10357,2023-11-01 14:45:00
57,MTLR,6275,3120,1233321901.0,656781415.0,4553483,2399140,270.85,273.76,6952623,1890103317.0,9395,6050,2829,1221101989.0,639258031.0,4511936,2332421,270.64,274.07,6844357,1860360021.0,8879,2023-11-01 14:50:00
58,MTLR,2553,1719,441163325.0,181887178.0,1626125,644442,271.3,282.24,2270567,623050503.0,4272,2341,1529,427191365.0,176262834.0,1578586,618835,270.62,284.83,2197421,603454199.0,3870,2023-11-01 14:55:00
59,MTLR,8764,8241,1620073631.0,1852853231.0,5977492,6846469,271.03,270.63,12823961,3472926862.0,17005,8206,7798,1586431579.0,1818676945.0,5863331,6706608,270.57,271.18,12569939,3405108525.0,16004,2023-11-01 15:00:00
60,MTLR,11670,18344,1699871822.0,4041961735.0,6195872,14953967,274.36,270.29,21149839,5741833558.0,30014,11103,18047,1639513062.0,4010015765.0,6070077,14828715,270.1,270.42,20898792,5649528827.0,29150,2023-11-01 15:05:00
61,MTLR,3806,4246,658777532.0,1015018614.0,2437032,3750045,270.32,270.67,6187077,1673796146.0,8052,3617,4026,645387614.0,1006261564.0,2390452,3716657,269.99,270.74,6107109,1651649178.0,7643,2023-11-01 15:10:00
62,MTLR,14567,13924,1978849444.0,2991575373.0,7321564,11054418,270.28,270.62,18375982,4970424817.0,28491,14288,13656,1965324612.0,2967935819.0,7276666,10962807,270.09,270.73,18239473,4933260431.0,27944,2023-11-01 15:15:00
63,MTLR,13789,14913,2415310385.0,3765692584.0,8948791,13930062,269.9,270.33,22878853,6181002969.0,28702,13487,14672,2400331693.0,3741478822.0,8898280,13836793,269.75,270.4,22735073,6141810516.0,28159,2023-11-01 15:20:00
64,MTLR,5927,4493,913654086.0,823561612.0,3381907,3040308,270.16,270.88,6422215,1737215698.0,10420,5758,4311,897719180.0,818608560.0,3324994,3019763,269.99,271.08,6344757,1716327741.0,10069,2023-11-01 15:25:00
65,MTLR,8762,5652,1433859151.0,846742139.0,5299910,3128141,270.54,270.69,8428051,2280601290.0,14414,8618,5465,1427034085.0,836863810.0,5280712,3088623,270.24,270.95,8369335,2263897896.0,14083,2023-11-01 15:30:00
66,MTLR,8496,5630,1772351812.0,862918767.0,6535033,3170647,271.21,272.16,9705680,2635270579.0,14126,8256,5365,1744167421.0,843972300.0,6444066,3098546,270.66,272.38,9542612,2588139722.0,13621,2023-11-01 15:35:00
67,MTLR,9554,4227,1827981648.0,552351900.0,6746692,2040006,270.94,270.76,8786698,2380333548.0,13781,9398,4114,1799666114.0,537273019.0,6646696,1980595,270.76,271.27,8627291,2336939133.0,13512,2023-11-01 15:40:00
68,MTLR,5974,3881,1179394286.0,530879943.0,4348067,1953881,271.25,271.71,6301948,1710274229.0,9855,5598,3511,1121922314.0,494219768.0,4144812,1819872,270.68,271.57,5964684,1616142083.0,9109,2023-11-01 15:45:00
69,MTLR,4995,6796,717966487.0,1036378341.0,2633289,3817897,272.65,271.45,6451186,1754344829.0,11791,3946,6163,656217766.0,997828042.0,2423772,3660038,270.74,272.63,6083810,1654045808.0,10109,2023-11-01 15:50:00
70,MTLR,3169,4326,535725643.0,821549952.0,1931092,3026639,277.42,271.44,4957731,1357275595.0,7495,2801,3918,522600004.0,774864595.0,1837338,2848689,284.43,272.01,4686027,1297464600.0,6719,2023-11-01 15:55:00
71,MTLR,15975,10116,3046570455.0,1871001473.0,11234087,6896802,271.19,271.29,18130889,4917571928.0,26091,15673,9854,3013175601.0,1825804068.0,11118630,6722484,271.0,271.6,17841114,4838979670.0,25527,2023-11-01 16:00:00
72,MTLR,25418,20978,4923120158.0,3930251114.0,18129632,14471418,271.55,271.59,32601050,8853371272.0,46396,23633,20149,4816631289.0,3872302181.0,17757394,14229744,271.25,272.13,31987138,8688933471.0,43782,2023-11-01 16:05:00
73,MTLR,11617,18589,1941595036.0,5007650178.0,7165730,18454785,270.96,271.35,25620515,6949245215.0,30206,10409,17851,1918497476.0,4978113649.0,7088017,18340419,270.67,271.43,25428436,6896611126.0,28260,2023-11-01 16:10:00
74,MTLR,15242,15706,2494261647.0,4207238790.0,9214906,15480356,270.68,271.78,24695262,6701500438.0,30948,14941,15365,2447322614.0,4185249495.0,9043187,15431141,270.63,271.22,24474328,6632572109.0,30306,2023-11-01 16:15:00
75,MTLR,4723,3420,714402348.0,815472854.0,2637278,3004712,270.89,271.4,5641990,1529875202.0,8143,4596,3297,706836423.0,802612696.0,2610302,2955552,270.79,271.56,5565854,1509449119.0,7893,2023-11-01 16:20:00
76,MTLR,9849,3905,1545225123.0,988700311.0,5706950,3572605,270.76,276.74,9279555,2533925434.0,13754,9492,3722,1513288461.0,938093878.0,5591864,3437503,270.62,272.9,9029367,2451382340.0,13214,2023-11-01 16:25:00
77,MTLR,7447,12032,1094364807.0,3383191189.0,4049837,12494296,270.22,270.78,16544133,4477555997.0,19479,6907,11759,1062965802.0,3393787995.0,3937626,12444003,269.95,272.72,16381629,4456753797.0,18666,2023-11-01 16:30:00
78,MTLR,4419,8454,652515266.0,2170025223.0,2411165,8015097,270.62,270.74,10426262,2822540489.0,12873,4211,8232,638868423.0,2156485922.0,2367032,7961931,269.9,270.85,10328963,2795354345.0,12443,2023-11-01 16:35:00
79,MTLR,9645,19586,1498063687.0,4078170723.0,5547806,15077880,270.03,270.47,20625686,5576234410.0,29231,9271,19294,1477398728.0,4037144677.0,5474107,14918585,269.89,270.61,20392692,5514543406.0,28565,2023-11-01 16:40:00
80,MTLR,10500,11806,2333179533.0,2131274651.0,8612104,7873402,270.92,270.69,16485506,4464454184.0,22306,10276,11511,2293563094.0,2098736024.0,8491377,7748809,270.1,270.85,16240186,4392299119.0,21787,2023-11-01 16:45:00
81,MTLR,2859,6596,550526092.0,1379757568.0,2041854,5110947,269.62,269.96,7152801,1930283661.0,9455,2657,6427,539665351.0,1374453329.0,2002414,5079557,269.51,270.59,7081971,1914118681.0,9084,2023-11-01 16:50:00
82,MTLR,2446,6942,428462897.0,1334791986.0,1586031,4938260,270.15,270.3,6524291,1763254884.0,9388,2290,6831,419858362.0,1332787254.0,1556443,4930568,269.76,270.31,6487011,1752645616.0,9121,2023-11-01 16:55:00
83,MTLR,7866,2553,2081354920.0,314824135.0,7699383,1163830,270.33,270.51,8863213,2396179055.0,10419,7776,2412,2066742731.0,302213298.0,7649846,1116562,270.17,270.66,8766408,2368956029.0,10188,2023-11-01 17:00:00
84,MTLR,3488,3156,715859448.0,501570428.0,2648964,1858952,270.24,269.81,4507916,1217429876.0,6644,3251,3055,700845171.0,491665458.0,2596747,1817810,269.89,270.47,4414557,1192510629.0,6306,2023-11-01 17:05:00
85,MTLR,2956,2751,459737427.0,510948780.0,1703376,1894868,269.9,269.65,3598244,970686207.0,5707,2624,2558,412050108.0,496185793.0,1527613,1836797,269.73,270.14,3364410,908235901.0,5182,2023-11-01 17:10:00
86,MTLR,1498,2190,258741519.0,386869692.0,951016,1427980,272.07,270.92,2378996,645611212.0,3688,1360,1980,254967610.0,378813922.0,944585,1397987,269.93,270.97,2342572,633781532.0,3340,2023-11-01 17:15:00
87,MTLR,6005,3194,1553131604.0,402872261.0,5741971,1488205,270.49,270.71,7230176,1956003865.0,9199,5887,3071,1534766106.0,391103172.0,5677617,1444655,270.32,270.72,7122272,1925869278.0,8958,2023-11-01 17:20:00
88,MTLR,6084,3963,1481644612.0,539963659.0,5482456,1996595,270.25,270.44,7479051,2021608271.0,10047,6000,3882,1478151927.0,540875024.0,5470305,1998109,270.21,270.69,7468414,2019026951.0,9882,2023-11-01 17:25:00
89,MTLR,12695,6539,2486544896.0,1111762957.0,9199002,4113384,270.31,270.28,13312386,3598307853.0,19234,12535,6430,2491223440.0,1106212572.0,9221088,4088557,270.17,270.56,13309645,3597436013.0,18965,2023-11-01 17:30:00
90,MTLR,1941,2490,190138697.0,467530010.0,703411,1732853,270.31,269.8,2436264,657668708.0,4431,1769,2378,187345769.0,464954690.0,694428,1719362,269.78,270.42,2413790,652300459.0,4147,2023-11-01 17:35:00
91,MTLR,1242,974,118037143.0,303467082.0,435995,1122071,270.73,270.45,1558066,421504226.0,2216,1129,930,97000458.0,306752432.0,359278,1132898,269.99,270.77,1492176,403752890.0,2059,2023-11-01 17:40:00
92,MTLR,3890,5205,867557258.0,997588589.0,3203744,3687581,270.79,270.53,6891325,1865145848.0,9095,3603,4994,875975020.0,986381927.0,3244577,3644586,269.98,270.64,6889163,1862356948.0,8597,2023-11-01 17:45:00
93,MTLR,3625,2611,651601148.0,402010814.0,2409066,1482021,270.48,271.26,3891087,1053611963.0,6236,3519,2496,646370132.0,391852911.0,2391222,1447783,270.31,270.66,3839005,1038223043.0,6015,2023-11-01 17:50:00
94,MTLR,4626,9851,485405188.0,1786011351.0,1794535,6605998,270.49,270.36,8400533,2271416540.0,14477,4533,9768,477320192.0,1785680974.0,1767473,6600833,270.06,270.52,8368306,2263001167.0,14301,2023-11-01 17:55:00
95,MTLR,1005,2189,97436398.0,549754167.0,360724,2033451,270.11,270.36,2394175,647190566.0,3194,917,2099,80672333.0,546250793.0,298748,2018977,270.03,270.56,2317725,626923126.0,3016,2023-11-01 18:00:00
96,MTLR,5634,7806,779208706.0,1899994338.0,2884202,7067670,270.16,268.83,9951872,2679203045.0,13440,5136,7425,771209557.0,1858199833.0,2859947,6877889,269.66,270.17,9737836,2629409391.0,12561,2023-11-01 18:05:00
97,MTLR,5228,5939,775823364.0,1552875284.0,2875982,5760694,269.76,269.56,8636676,2328698649.0,11167,4954,5804,740829227.0,1547741763.0,2748286,5731310,269.56,270.05,8479596,2288570991.0,10758,2023-11-01 18:10:00
98,MTLR,3123,6160,444159362.0,1488843919.0,1647946,5514537,269.52,269.99,7162483,1933003282.0,9283,2966,6004,413039171.0,1466139347.0,1532022,5428065,269.6,270.1,6960087,1879178519.0,8970,2023-11-01 18:15:00
99,MTLR,3616,7720,496297192.0,2120013767.0,1839259,7858085,269.84,269.79,9697344,2616310959.0,11336,3378,7518,486498050.0,2146511191.0,1804065,7904773,269.67,271.55,9708838,2633009242.0,10896,2023-11-01 18:20:00
100,MTLR,2830,3090,603193307.0,606987789.0,2230975,2246343,270.37,270.21,4477318,1210181096.0,5920,2679,2973,592482771.0,594813894.0,2197059,2199836,269.67,270.39,4396895,1187296666.0,5652,2023-11-01 18:25:00
101,MTLR,4963,4583,839106194.0,925718001.0,3111723,3447531,269.66,268.52,6559254,1764824196.0,9546,4664,4405,822369330.0,900380983.0,3053530,3336899,269.32,269.83,6390429,1722750314.0,9069,2023-11-01 18:30:00
102,MTLR,2926,5498,450259788.0,799745806.0,1667367,2972059,270.04,269.09,4639426,1250005594.0,8424,2634,5300,431785551.0,809290184.0,1604348,2999605,269.13,269.8,4603953,1241075736.0,7934,2023-11-01 18:35:00
103,MTLR,2374,2585,385264690.0,517348152.0,1429327,1919045,269.54,269.59,3348372,902612843.0,4959,2252,2494,371315575.0,510374638.0,1379095,1890775,269.25,269.93,3269870,881690214.0,4746,2023-11-01 18:40:00
104,MTLR,14458,11903,2818835186.0,4140653701.0,10419140,15233210,270.54,271.82,25652350,6959488888.0,26361,11994,9985,2611935044.0,3944554316.0,9627517,14509488,271.3,271.86,24137005,6556489360.0,21979,2023-11-02 10:05:00
105,MTLR,52697,37574,10555561105.0,6043381094.0,38472654,22130615,274.37,273.08,60603269,16598942200.0,90271,50253,33057,10091231481.0,5661309364.0,36925765,20676962,273.28,273.8,57602727,15752540846.0,83310,2023-11-02 10:10:00
106,MTLR,22425,14893,4046155633.0,2819932322.0,14680128,10266663,275.62,274.67,24946791,6866087955.0,37318,20545,12234,3715912988.0,2496653132.0,13535802,9062977,274.52,275.48,22598779,6212566120.0,32779,2023-11-02 10:15:00
107,MTLR,10516,10826,2296630171.0,1784977951.0,8352397,6469767,274.97,275.9,14822164,4081608123.0,21342,9169,8833,2155720685.0,1640520685.0,7851038,5937303,274.58,276.31,13788341,3796241370.0,18002,2023-11-02 10:20:00
108,MTLR,11050,11811,2040211674.0,2550145861.0,7407837,9288610,275.41,274.55,16696447,4590357535.0,22861,10149,10839,1959758368.0,2385262698.0,7136592,8670516,274.61,275.1,15807108,4345021066.0,20988,2023-11-02 10:25:00
109,MTLR,6044,14303,1031424807.0,2877545652.0,3672967,10499692,280.82,274.06,14172659,3908970460.0,20347,4768,13273,891665788.0,2774633547.0,3219570,10091587,276.95,274.95,13311157,3666299335.0,18041,2023-11-02 10:30:00
110,MTLR,9316,4422,1760102496.0,669491961.0,6404765,2394741,274.81,279.57,8799506,2429594457.0,13738,8672,3692,1669669220.0,598610799.0,6088556,2172877,274.23,275.49,8261433,2268280019.0,12364,2023-11-02 10:35:00
111,MTLR,6980,10943,1348196293.0,1930507324.0,4875987,7025764,276.5,274.78,11901751,3278703618.0,17923,5755,7819,1205394055.0,1813618678.0,4391333,6587346,274.49,275.32,10978679,3019012734.0,13574,2023-11-02 10:40:00
112,MTLR,19324,9043,4411500146.0,1416436792.0,15988571,5143921,275.92,275.36,21132492,5827936939.0,28367,18676,7989,4344045254.0,1302367275.0,15790410,4722849,275.11,275.76,20513259,5646412530.0,26665,2023-11-02 10:45:00
113,MTLR,9433,7527,1982650246.0,1651028522.0,7146370,5874786,277.43,281.04,13021156,3633678769.0,16960,8103,6365,1798598593.0,1522118580.0,6520368,5419744,275.84,280.85,11940112,3320717173.0,14468,2023-11-02 10:50:00
114,MTLR,15526,14644,3272102028.0,3784576055.0,11846991,13721555,276.2,275.81,25568546,7056678083.0,30170,14394,13195,3120256191.0,3666129893.0,11324238,13275598,275.54,276.16,24599836,6786386084.0,27589,2023-11-02 10:55:00
115,MTLR,8305,6639,1488924555.0,1707240165.0,5388081,6189441,276.34,275.83,11577522,3196164721.0,14944,7631,5534,1441122800.0,1653772974.0,5231639,5984983,275.46,276.32,11216622,3094895775.0,13165,2023-11-02 11:00:00
116,MTLR,6158,8112,1012612634.0,1972156768.0,3683633,7181941,274.9,274.6,10865574,2984769402.0,14270,5099,7395,933442082.0,1907524550.0,3392535,6918281,275.15,275.72,10310816,2840966633.0,12494,2023-11-02 11:05:00
117,MTLR,10638,8953,2264988709.0,2081697664.0,8237305,7565948,274.97,275.14,15803253,4346686374.0,19591,10123,8489,2220955663.0,2047964910.0,8084295,7434551,274.72,275.47,15518846,4268920574.0,18612,2023-11-02 11:10:00
118,MTLR,17706,10735,3703363412.0,2457228258.0,13467292,8938036,274.99,274.92,22405328,6160591671.0,28441,17121,9973,3677094952.0,2386176094.0,13374451,8663811,274.93,275.42,22038262,6063271046.0,27094,2023-11-02 11:15:00
119,MTLR,7185,7932,1441250569.0,1915024159.0,5243977,6961426,274.84,275.09,12205403,3356274729.0,15117,6539,6997,1378372846.0,1916102671.0,5022422,6961788,274.44,275.23,11984210,3294475517.0,13536,2023-11-02 11:20:00
120,MTLR,8517,11612,1814665950.0,3148351335.0,6626865,11545471,273.83,272.69,18172336,4963017285.0,20129,6414,10501,1639641058.0,2999220567.0,6005317,10938268,273.03,274.2,16943585,4638861626.0,16915,2023-11-02 11:25:00
121,MTLR,5861,7742,878600182.0,2242458329.0,3213775,8208920,273.39,273.17,11422695,3121058511.0,13603,4861,7185,836031182.0,2188567023.0,3063022,7996439,272.94,273.69,11059461,3024598206.0,12046,2023-11-02 11:30:00
122,MTLR,34890,10842,7989900165.0,1231012781.0,29201588,4493729,273.61,273.94,33695317,9220912946.0,45732,34351,10182,7948754383.0,1194973344.0,29073192,4357014,273.4,274.26,33430206,9143727728.0,44533,2023-11-02 11:35:00
123,MTLR,3493,5647,703697313.0,1334347130.0,2572261,4879377,273.57,273.47,7451638,2038044444.0,9140,3068,5331,675137457.0,1300511191.0,2469506,4744319,273.39,274.12,7213825,1975648649.0,8399,2023-11-02 11:40:00
124,MTLR,6830,4824,1684810047.0,870099622.0,6160009,3178471,273.51,273.75,9338480,2554909669.0,11654,6405,4509,1646371396.0,852358937.0,6021132,3109017,273.43,274.16,9130149,2498730333.0,10914,2023-11-02 11:45:00
125,MTLR,3979,1787,892610498.0,271055252.0,3255612,989802,274.18,273.85,4245414,1163665750.0,5766,3697,1541,863416362.0,254350810.0,3154426,925939,273.72,274.69,4080365,1117767172.0,5238,2023-11-02 11:50:00
126,MTLR,23307,12087,6383720988.0,1884413938.0,23249550,6808606,274.57,276.77,30058156,8268134926.0,35394,22843,11383,6290016995.0,1823961978.0,22920188,6582835,274.43,277.08,29503023,8113978974.0,34226,2023-11-02 11:55:00
127,MTLR,18421,9903,5313143823.0,2030808515.0,19336867,7372479,274.77,275.46,26709346,7343952339.0,28324,17885,9209,5289490267.0,1966311998.0,19259469,7145332,274.64,275.19,26404801,7255802265.0,27094,2023-11-02 12:00:00
128,MTLR,10274,6466,2122965483.0,1474744462.0,7731501,5373893,274.59,274.43,13105394,3597709946.0,16740,9979,6213,2100975063.0,1445824885.0,7653758,5260552,274.5,274.84,12914310,3546799949.0,16192,2023-11-02 12:05:00
129,MTLR,4482,11185,584013095.0,3225173491.0,2132152,11752818,273.91,274.42,13884970,3809186586.0,15667,4191,11013,569299235.0,3200859281.0,2078412,11656383,273.91,274.6,13734795,3770158517.0,15204,2023-11-02 12:10:00
130,MTLR,1456,1865,217807144.0,550029305.0,762296,2006636,285.73,274.11,2768932,767836449.0,3321,1241,1678,180847853.0,521690840.0,660847,1899300,273.66,274.68,2560147,702538694.0,2919,2023-11-02 12:15:00
131,MTLR,878,612,95368514.0,52363769.0,347272,192414,274.62,272.14,539686,147732283.0,1490,719,498,84770384.0,48521268.0,310084,175776,273.38,276.04,485860,133291653.0,1217,2023-11-02 12:20:00
132,MTLR,10058,4032,2349622387.0,803421569.0,8528929,2868646,275.49,280.07,11397575,3153043956.0,14090,9389,3152,2233031565.0,736177420.0,8127760,2672865,274.74,275.43,10800625,2969208985.0,12541,2023-11-02 12:25:00
133,MTLR,5398,5687,1119904047.0,873786863.0,4069903,3187806,275.17,274.1,7257709,1993690911.0,11085,4897,4461,1028394136.0,814678638.0,3743788,2955709,274.69,275.63,6699497,1843072774.0,9358,2023-11-02 12:30:00
134,MTLR,4801,3813,700000134.0,728308076.0,2539618,2644726,275.63,275.38,5184344,1428308211.0,8614,3761,3188,666452316.0,679706232.0,2426217,2465712,274.69,275.66,4891929,1346158549.0,6949,2023-11-02 12:35:00
135,MTLR,3817,1790,532993380.0,241590689.0,1930070,879626,276.15,274.65,2809696,774584070.0,5607,3349,1320,485238423.0,225885477.0,1767266,817608,274.57,276.28,2584874,711123900.0,4669,2023-11-02 12:40:00
136,MTLR,7766,2164,1671691529.0,224736150.0,6062378,821738,275.75,273.49,6884116,1896427680.0,9930,7407,1695,1618804857.0,191038536.0,5879460,691280,275.33,276.35,6570740,1809843394.0,9102,2023-11-02 12:45:00
137,MTLR,4139,1708,813556487.0,173411420.0,2948753,630900,275.9,274.86,3579653,986967907.0,5847,3868,1288,803134811.0,145339231.0,2916745,524982,275.35,276.85,3441727,948474043.0,5156,2023-11-02 12:50:00
138,MTLR,4014,1752,724659205.0,196543213.0,2625664,713311,275.99,275.54,3338975,921202418.0,5766,3764,1292,700858065.0,168091984.0,2547866,607160,275.08,276.85,3155026,868950050.0,5056,2023-11-02 12:55:00
139,MTLR,4131,1828,1193212454.0,218152475.0,4329004,766118,275.63,284.75,5095122,1411364929.0,5959,3800,1577,1168137085.0,213460934.0,4245514,723805,275.15,294.91,4969319,1381598020.0,5377,2023-11-02 13:00:00
140,MTLR,3152,2530,601135634.0,352785256.0,2185338,1286873,275.08,274.14,3472211,953920890.0,5682,2769,2129,575985844.0,317779538.0,2095090,1151613,274.92,275.94,3246703,893765383.0,4898,2023-11-02 13:05:00
141,MTLR,1805,1400,283196410.0,202775641.0,1029634,706911,275.05,286.85,1736545,485972051.0,3205,1581,1211,273574574.0,192703939.0,996886,681966,274.43,282.57,1678852,466278514.0,2792,2023-11-02 13:10:00
142,MTLR,3751,3606,533867112.0,864944993.0,1945673,3128755,274.39,276.45,5074428,1398812106.0,7357,3271,3363,511802723.0,833537522.0,1866442,3012227,274.21,276.72,4878669,1345340246.0,6634,2023-11-02 13:15:00
143,MTLR,4942,5053,745596583.0,1131327418.0,2698759,4109878,276.27,275.27,6808637,1876924001.0,9995,4652,4791,706663159.0,1107234769.0,2576056,4020097,274.32,275.42,6596153,1813897929.0,9443,2023-11-02 13:20:00
144,MTLR,2065,2387,320565203.0,575564004.0,1166590,2092019,274.79,275.12,3258609,896129208.0,4452,1918,2196,315016205.0,565013335.0,1148323,2051542,274.33,275.41,3199865,880029541.0,4114,2023-11-02 13:25:00
145,MTLR,4902,6977,892381997.0,1453349572.0,3244884,5289687,275.01,274.75,8534571,2345731569.0,11879,4697,6750,870818412.0,1438426666.0,3171703,5223138,274.56,275.4,8394841,2309245078.0,11447,2023-11-02 13:30:00
146,MTLR,3550,8217,506916589.0,1979577212.0,1845655,7198642,274.65,274.99,9044297,2486493802.0,11767,3401,8056,498007098.0,1968344331.0,1814181,7154198,274.51,275.13,8968379,2466351430.0,11457,2023-11-02 13:35:00
147,MTLR,2657,2927,569276061.0,629132382.0,2055620,2280080,276.94,275.93,4335700,1198408444.0,5584,2487,2662,545898779.0,614257333.0,1985887,2228576,274.89,275.63,4214463,1160156113.0,5149,2023-11-02 13:40:00
148,MTLR,7844,11068,1434533108.0,2944172826.0,5204686,10673777,275.62,275.83,15878463,4378705934.0,18912,7358,10683,1394452778.0,2909009112.0,5074457,10535486,274.8,276.12,15609943,4303461890.0,18041,2023-11-02 13:45:00
149,MTLR,4728,10895,610830405.0,2960719177.0,2218815,10749157,275.3,275.44,12967972,3571549583.0,15623,4405,10689,590470022.0,2940669490.0,2147379,10668938,274.97,275.63,12816317,3531139513.0,15094,2023-11-02 13:50:00
150,MTLR,2267,1579,407697565.0,227686804.0,1477482,826033,275.94,275.64,2303515,635384370.0,3846,2087,1317,393256757.0,218030569.0,1429145,790216,275.17,275.91,2219361,611287326.0,3404,2023-11-02 13:55:00
151,MTLR,6406,4582,1289758813.0,706734801.0,4623104,2554117,278.98,276.7,7177221,1996493614.0,10988,5354,3176,1104635700.0,613299612.0,4007590,2213618,275.64,277.06,6221208,1717935312.0,8530,2023-11-02 14:00:00
152,MTLR,6116,7381,1253442643.0,2708585625.0,4527966,9804211,276.82,276.27,14332177,3962028268.0,13497,5108,6597,1208366947.0,2649098215.0,4379003,9567225,275.95,276.89,13946228,3857465162.0,11705,2023-11-02 14:05:00
153,MTLR,3493,1883,451515859.0,241005658.0,1630129,876170,276.98,275.07,2506299,692521517.0,5376,3110,1445,421134487.0,214321828.0,1525686,773093,276.03,277.23,2298779,635456315.0,4555,2023-11-02 14:10:00
154,MTLR,4831,1727,913163728.0,297244460.0,3304339,1075360,276.35,276.41,4379699,1210408189.0,6558,4548,1432,939113660.0,223479661.0,3401485,805123,276.09,277.57,4206608,1162593322.0,5980,2023-11-02 14:15:00
155,MTLR,2486,1176,358164090.0,140610817.0,1299807,509890,275.55,275.77,1809697,498774907.0,3662,2228,915,337163604.0,127342661.0,1229075,458621,274.32,277.66,1687696,464506266.0,3143,2023-11-02 14:20:00
156,MTLR,1562,2004,201143046.0,474237040.0,728125,1717713,276.25,276.09,2445838,675380087.0,3566,1231,1771,180872315.0,448144532.0,656847,1618773,275.36,276.84,2275620,629016848.0,3002,2023-11-02 14:25:00
157,MTLR,3396,4467,675711997.0,1146999151.0,2454000,4165941,275.35,275.33,6619941,1822711148.0,7863,2863,4095,639200745.0,1099989575.0,2323206,3980346,275.14,276.36,6303552,1739190321.0,6958,2023-11-02 14:30:00
158,MTLR,3904,3736,727662243.0,822381678.0,2637769,2980541,275.86,275.92,5618310,1550043921.0,7640,3602,3486,709078354.0,814009941.0,2574135,2944673,275.46,276.43,5518808,1523088296.0,7088,2023-11-02 14:35:00
159,MTLR,3505,2364,962563141.0,528277864.0,3482144,1912668,276.43,276.2,5394812,1490841006.0,5869,3279,2042,947576569.0,510691742.0,3432003,1844717,276.1,276.84,5276720,1458268312.0,5321,2023-11-02 14:40:00
160,MTLR,2229,3927,312900099.0,842941565.0,1133225,3049926,276.11,276.38,4183151,1155841664.0,6156,2006,3749,293208337.0,832975608.0,1063203,3011080,275.78,276.64,4074283,1126183945.0,5755,2023-11-02 14:45:00
161,MTLR,2339,1396,385831784.0,166337089.0,1385424,602133,278.49,276.25,1987557,552168874.0,3735,2069,1048,363194540.0,149048259.0,1315627,537240,276.06,277.43,1852867,512242800.0,3117,2023-11-02 14:50:00
162,MTLR,1379,1708,137364435.0,352697815.0,493154,1272348,278.54,277.2,1765502,490062250.0,3087,1240,1537,129170559.0,335966002.0,468606,1209962,275.65,277.67,1678568,465136561.0,2777,2023-11-02 14:55:00
163,MTLR,3111,8721,381639397.0,2116579293.0,1378515,7614101,276.85,277.98,8992616,2498218690.0,11832,2609,8542,354536058.0,2086767634.0,1285179,7546787,275.87,276.51,8831966,2441303692.0,11151,2023-11-02 15:00:00
164,MTLR,1221,2993,93164997.0,542291230.0,337759,1958499,275.83,276.89,2296258,635456228.0,4214,876,2859,69643740.0,554988600.0,252575,1949495,275.73,284.68,2202070,624632340.0,3735,2023-11-02 15:05:00
165,MTLR,6171,12759,731367424.0,2922171092.0,2654893,10607187,275.48,275.49,13262080,3653538517.0,18930,5593,12403,699645263.0,2878758214.0,2540743,10433929,275.37,275.9,12974672,3578403477.0,17996,2023-11-02 15:10:00
166,MTLR,3373,6448,463534976.0,1336885166.0,1679236,4850224,276.04,275.63,6529460,1800420143.0,9821,3078,6143,440428612.0,1319689718.0,1598617,4780421,275.51,276.06,6379038,1760118330.0,9221,2023-11-02 15:15:00
167,MTLR,2447,2324,265468422.0,393626462.0,961644,1409438,276.06,279.28,2371082,659094885.0,4771,1908,2118,240864626.0,361906514.0,875940,1311360,274.98,275.98,2187300,602771140.0,4026,2023-11-02 15:20:00
168,MTLR,2439,4529,276531981.0,972953908.0,1001810,3526267,276.03,275.92,4528077,1249485890.0,6968,2283,4360,261831413.0,966156531.0,955432,3499544,274.05,276.08,4454976,1227987944.0,6643,2023-11-02 15:25:00
169,MTLR,3919,1535,969879096.0,177807422.0,3517952,646479,275.69,275.04,4164431,1147686519.0,5454,3787,1384,961206743.0,168703178.0,3489666,609723,275.44,276.69,4099389,1129909922.0,5171,2023-11-02 15:30:00
170,MTLR,3191,4104,523416014.0,764595890.0,1896629,2773997,275.97,275.63,4670626,1288011905.0,7295,2991,3853,502830217.0,761161849.0,1828258,2755183,275.03,276.27,4583441,1263992067.0,6844,2023-11-02 15:35:00
171,MTLR,3742,3549,664603325.0,566618629.0,2380105,2053777,279.23,275.89,4433882,1231221954.0,7291,3453,3029,625933260.0,534974353.0,2269590,1913817,275.79,279.53,4183407,1160907614.0,6482,2023-11-02 15:40:00
172,MTLR,4658,2504,1011010036.0,331299317.0,3654098,1201879,276.68,275.65,4855977,1342309353.0,7162,4396,2192,984856944.0,308879394.0,3568664,1115477,275.97,276.9,4684141,1293736339.0,6588,2023-11-02 15:45:00
173,MTLR,9455,3997,2547038052.0,540546235.0,9210267,1956017,276.54,276.35,11166284,3087584287.0,13452,9130,3824,2526176055.0,533106917.0,9146380,1926480,276.19,276.73,11072860,3059282973.0,12954,2023-11-02 15:50:00
174,MTLR,4392,3201,1171115568.0,485688343.0,4236745,1759766,276.42,276.0,5996511,1656803911.0,7593,4078,2932,1146338364.0,475316964.0,4152586,1718282,276.05,276.62,5870868,1621655328.0,7010,2023-11-02 15:55:00
175,MTLR,3589,1252,949815372.0,135459167.0,3429420,491388,276.96,275.67,3920808,1085274539.0,4841,3402,1051,939448870.0,130335376.0,3400693,470998,276.25,276.72,3871691,1069784246.0,4453,2023-11-02 16:00:00
176,MTLR,2702,5470,545081610.0,1051345062.0,1966436,3810242,277.19,275.93,5776678,1596426672.0,8172,2442,5144,523690798.0,1039611150.0,1896408,3759802,276.15,276.51,5656210,1563301948.0,7586,2023-11-02 16:05:00
177,MTLR,3005,2888,721175458.0,681673624.0,2725924,2444434,264.56,278.87,5170358,1402849082.0,5893,2243,2306,633032066.0,647964363.0,2461211,2340867,257.2,276.81,4802078,1280996429.0,4549,2023-11-02 16:10:00
178,MTLR,6745,7868,1280162581.0,2171095999.0,4818670,7851073,265.67,276.53,12669743,3451258581.0,14613,5939,7027,1069701158.0,2094906146.0,3869770,7558997,276.42,277.14,11428767,3164607305.0,12966,2023-11-02 16:15:00
179,MTLR,3885,4006,783225840.0,786285794.0,3013346,2845426,259.92,276.33,5858772,1569511635.0,7891,3567,3574,753369877.0,751711707.0,2940376,2692633,256.22,279.17,5633009,1505081584.0,7141,2023-11-02 16:20:00
180,MTLR,8483,4726,2498718980.0,645231565.0,9240274,2233959,270.42,288.83,11474233,3143950545.0,13209,8080,4178,2436042686.0,575776765.0,9029848,2075308,269.78,277.44,11105156,3011819452.0,12258,2023-11-02 16:25:00
181,MTLR,2426,1305,518972454.0,177966390.0,1871005,600423,277.38,296.4,2471428,696938844.0,3731,2204,1029,502380228.0,174797172.0,1817301,582585,276.44,300.04,2399886,677177400.0,3233,2023-11-02 16:30:00
182,MTLR,9962,6387,2056399117.0,1109101555.0,7392030,4004369,278.19,276.97,11396399,3165500672.0,16349,9303,5506,1980571346.0,1053185199.0,7184692,3791843,275.67,277.75,10976535,3033756545.0,14809,2023-11-02 16:35:00
183,MTLR,7291,5719,1743911777.0,1213494308.0,6281637,4393257,277.62,276.22,10674894,2957406086.0,13010,5532,4311,1524097837.0,1085898328.0,5490800,3901057,277.57,278.36,9391857,2609996165.0,9843,2023-11-02 16:40:00
184,MTLR,3477,4206,588744956.0,907281565.0,2117370,3184747,278.05,284.88,5302117,1496026521.0,7683,2599,3481,537194839.0,851469904.0,1950151,2959670,275.46,287.69,4909821,1388664743.0,6080,2023-11-02 16:45:00
185,MTLR,10037,7320,1984609141.0,1633004510.0,6979200,5734390,284.36,284.77,12713590,3617613651.0,17357,8905,5374,1836008868.0,1512240386.0,6522356,5254287,281.49,287.81,11776643,3348249255.0,14279,2023-11-02 16:50:00
186,MTLR,9645,14746,2168314363.0,3255076926.0,7668687,11661935,282.75,279.12,19330622,5423391289.0,24391,8539,13417,2036558711.0,3111771547.0,7312170,11134609,278.52,279.47,18446779,5148330258.0,21956,2023-11-02 16:55:00
187,MTLR,7992,3449,1846668427.0,654358921.0,6577676,2320836,280.75,281.95,8898512,2501027348.0,11441,7132,2504,1746102054.0,571707488.0,6234527,1999500,280.07,285.93,8234027,2317809542.0,9636,2023-11-02 17:00:00
188,MTLR,4407,6045,934495823.0,1250420984.0,3338961,4506853,279.88,277.45,7845814,2184916807.0,10452,3354,5124,838898985.0,1160860693.0,3043185,4147582,275.66,279.89,7190767,1999759678.0,8478,2023-11-02 17:05:00
189,MTLR,8532,6876,1781983631.0,1766692773.0,6420733,6360778,277.54,277.75,12781511,3548676404.0,15408,7598,6222,1729241291.0,1665895035.0,6203461,5962952,278.75,279.37,12166413,3395136326.0,13820,2023-11-02 17:10:00
190,MTLR,10534,20418,1849928062.0,5322051899.0,6641963,19231217,278.52,276.74,25873180,7171979961.0,30952,8442,19345,1599125815.0,5127455096.0,5808798,18447127,275.29,277.95,24255925,6726580912.0,27787,2023-11-02 17:15:00
191,MTLR,10147,6460,1697339867.0,1027118509.0,6072720,3646591,279.5,281.67,9719311,2724458376.0,16607,9076,5534,1551318829.0,938272381.0,5594584,3334685,277.29,281.37,8929269,2489591210.0,14610,2023-11-02 17:20:00
192,MTLR,10119,6107,2364540861.0,1042204045.0,8471999,3752962,279.1,277.7,12224961,3406744906.0,16226,9482,5056,2263919607.0,953431192.0,8136269,3413951,278.25,279.28,11550220,3217350799.0,14538,2023-11-02 17:25:00
193,MTLR,4758,8815,600867194.0,1768570064.0,2158344,6362932,278.39,277.95,8521276,2369437259.0,13573,4095,8413,567481146.0,1718868476.0,2040246,6163103,278.14,278.9,8203349,2286349622.0,12508,2023-11-02 17:30:00
194,MTLR,12351,19876,2159030974.0,4905980807.0,7771587,17665412,277.81,277.72,25436999,7065011782.0,32227,11614,19400,2118336690.0,4846655205.0,7631501,17418622,277.58,278.25,25050123,6964991895.0,31014,2023-11-02 17:35:00
195,MTLR,23959,19542,4332047303.0,4792891029.0,15641080,17334531,276.97,276.49,32975611,9124938333.0,43501,23019,18952,4229810443.0,4668374852.0,15289085,16847441,276.66,277.1,32136526,8898185295.0,41971,2023-11-02 17:40:00
196,MTLR,19889,28343,3151785088.0,6193436112.0,11437416,22527817,275.57,274.92,33965233,9345221201.0,48232,17878,27418,2946785146.0,6020240039.0,10715189,21839739,275.01,275.66,32554928,8967025186.0,45296,2023-11-02 17:45:00
197,MTLR,47400,37453,9081673422.0,8500372507.0,32867885,30834478,276.31,275.68,63702363,17582045929.0,84853,45318,35800,8749495783.0,8178099666.0,31777609,29666796,275.34,275.67,61444405,16927595449.0,81118,2023-11-02 17:50:00
198,MTLR,21121,14059,4835985761.0,2663002677.0,17516340,9660944,276.08,275.65,27177284,7498988439.0,35180,19942,13117,4654140425.0,2524872370.0,16890800,9148583,275.54,275.99,26039383,7179012796.0,33059,2023-11-02 17:55:00
199,MTLR,16374,10915,2937149579.0,2115083295.0,10645248,7677348,275.91,275.5,18322596,5052232875.0,27289,15707,10425,2833730022.0,2029343442.0,10292675,7355701,275.32,275.89,17648376,4863073465.0,26132,2023-11-02 18:00:00
200,MTLR,8568,11670,1366856258.0,2538790720.0,4955194,9228382,275.84,275.11,14183576,3905646979.0,20238,8018,11252,1360218039.0,2506643483.0,4941360,9088534,275.27,275.8,14029894,3866861522.0,19270,2023-11-02 18:05:00
201,MTLR,21048,21095,4439233793.0,4280209562.0,16106914,15554497,275.61,275.18,31661411,8719443356.0,42143,20239,20540,4350174155.0,4223118076.0,15804801,15328833,275.24,275.5,31133634,8573292232.0,40779,2023-11-02 18:10:00
202,MTLR,25805,46261,5949683930.0,8792771298.0,21510137,31823415,276.6,276.3,53333552,14742455229.0,72066,25083,45554,5811005842.0,8741505081.0,21041401,31620933,276.17,276.45,52662334,14552510923.0,70637,2023-11-02 18:15:00
203,MTLR,25332,24528,5849907494.0,4388814616.0,21099422,15841330,277.25,277.05,36940752,10238722110.0,49860,24623,23734,5756985149.0,4313145758.0,20795702,15547427,276.84,277.42,36343129,10070130907.0,48357,2023-11-02 18:20:00
204,MTLR,18255,26391,3706520659.0,5272644776.0,13361102,19035516,277.41,276.99,32396618,8979165436.0,44646,17565,25800,3628025618.0,5219093410.0,13088628,18808127,277.19,277.49,31896755,8847119029.0,43365,2023-11-02 18:25:00
205,MTLR,57432,55763,12287400748.0,10276705067.0,44279568,37099928,277.5,277.0,81379496,22564105816.0,113195,56652,54914,12185700661.0,10202786238.0,43963946,36802924,277.17,277.23,80766870,22388486900.0,111566,2023-11-02 18:30:00
206,MTLR,7235,8433,1614471339.0,1323584885.0,5785131,4785483,279.07,276.58,10570614,2938056225.0,15668,6684,7950,1731620327.0,1234606993.0,6472536,4444303,267.53,277.8,10916839,2966227321.0,14634,2023-11-02 18:35:00
207,MTLR,3853,10602,579449768.0,1718696156.0,2082067,6217140,278.31,276.44,8299207,2298145924.0,14455,3365,10233,487314081.0,1682159641.0,1764461,6068239,276.18,277.21,7832700,2169473723.0,13598,2023-11-02 18:40:00
208,MTLR,36493,24400,6526832463.0,4595984236.0,23161782,16431003,281.79,279.71,39592785,11122816700.0,60893,32672,20911,6027382174.0,4198202457.0,21538617,14981986,279.84,280.22,36520603,10225584631.0,53583,2023-11-03 10:05:00
209,MTLR,29774,30299,5859504785.0,6116201290.0,20832418,21771296,281.27,280.93,42603714,11975706075.0,60073,28225,28898,5695860873.0,5952535281.0,20276090,21153545,280.92,281.4,41429635,11648396154.0,57123,2023-11-03 10:10:00
210,MTLR,8961,17802,1421494130.0,3555621300.0,5026176,12610982,282.82,281.95,17637158,4977115430.0,26763,7991,16034,1336407501.0,3452380499.0,4740077,12269670,281.94,281.38,17009747,4788788000.0,24025,2023-11-03 10:15:00
211,MTLR,18340,11878,3660842630.0,1962086434.0,12847251,6972681,284.95,281.4,19819932,5622929064.0,30218,16710,10346,3451502209.0,1815904937.0,12270102,6440159,281.29,281.97,18710261,5267407146.0,27056,2023-11-03 10:20:00
212,MTLR,14204,9457,3078970323.0,1472220308.0,10910320,5242962,282.21,280.8,16153282,4551190632.0,23661,13050,8400,2956768768.0,1357492093.0,10502651,4809853,281.53,282.23,15312504,4314260861.0,21450,2023-11-03 10:25:00
213,MTLR,6921,10207,1134091427.0,1989790268.0,4008986,6959119,282.89,285.93,10968105,3123881696.0,17128,6070,9401,1071904263.0,1883796572.0,3809653,6671752,281.37,282.35,10481405,2955700835.0,15471,2023-11-03 10:30:00
214,MTLR,3758,7176,405027303.0,1406384993.0,1442853,5011587,280.71,280.63,6454440,1811412296.0,10934,2862,6640,378599618.0,1363948036.0,1324108,4838309,285.93,281.91,6162417,1742547654.0,9502,2023-11-03 10:35:00
215,MTLR,8257,9000,1217172712.0,2164219728.0,4336772,7734914,280.66,279.8,12071686,3381392440.0,17257,7059,8372,1147726227.0,2162772626.0,4097641,7691045,280.09,281.21,11788686,3310498854.0,15431,2023-11-03 10:40:00
216,MTLR,4119,5955,663073259.0,1773390389.0,2356976,6333461,281.32,280.0,8690437,2436463649.0,10074,3123,5214,591432323.0,1691900563.0,2110773,6014369,280.2,281.31,8125142,2283332887.0,8337,2023-11-03 10:45:00
217,MTLR,7564,6924,1241436138.0,1675560800.0,4427856,6019698,280.37,278.35,10447554,2916996938.0,14488,5943,5829,1155952209.0,1588730828.0,4136076,5661237,279.48,280.63,9797313,2744683038.0,11772,2023-11-03 10:50:00
218,MTLR,17810,8130,4096856693.0,2225429604.0,14629097,7962027,280.05,279.51,22591124,6322286297.0,25940,16333,7186,3982939562.0,2139441112.0,14247487,7630096,279.55,280.4,21877583,6122380674.0,23519,2023-11-03 10:55:00
219,MTLR,22268,8701,6589386310.0,2498736659.0,23525413,8919082,280.1,280.16,32444495,9088122969.0,30969,21542,8226,6519253907.0,2422194478.0,23299765,8636886,279.8,280.45,31936651,8941448386.0,29768,2023-11-03 11:00:00
220,MTLR,18636,26302,5475681030.0,7708156292.0,19571772,27666383,279.77,278.61,47238155,13183837323.0,44938,17070,25253,5344539416.0,7575856843.0,19133569,27117564,279.33,279.37,46251133,12920396259.0,42323,2023-11-03 11:05:00
221,MTLR,7187,22113,1622181749.0,5936304007.0,5801090,21248095,279.63,279.38,27049185,7558485756.0,29300,6410,21537,1510984392.0,5927085039.0,5421520,21203200,278.7,279.54,26624720,7438069431.0,27947,2023-11-03 11:10:00
222,MTLR,3356,11204,576805420.0,2852129767.0,2068265,10218879,278.88,279.1,12287144,3428935188.0,14560,2410,10737,511481991.0,2782581497.0,1842551,9954108,277.59,279.54,11796659,3294063489.0,13147,2023-11-03 11:15:00
223,MTLR,11642,16068,2419258386.0,4637256816.0,8726328,16791306,277.24,276.17,25517634,7056515202.0,27710,9414,14929,2197001244.0,4400918103.0,7950563,15835845,276.33,277.91,23786408,6597919348.0,24343,2023-11-03 11:20:00
224,MTLR,18498,10835,4163563012.0,2646261893.0,15036729,9574585,276.89,276.38,24611314,6809824905.0,29333,17171,9864,4051797760.0,2571343779.0,14658632,9276288,276.41,277.2,23934920,6623141540.0,27035,2023-11-03 11:25:00
225,MTLR,15751,6189,3250782673.0,1353013145.0,11736937,4904602,276.97,275.87,16641539,4603795818.0,21940,14934,5700,3188873235.0,1300645723.0,11529647,4692106,276.58,277.2,16221753,4489518959.0,20634,2023-11-03 11:30:00
226,MTLR,14804,14792,2684992986.0,3161560319.0,9695027,11493572,276.95,275.07,21188599,5846553305.0,29596,13515,13755,2569952364.0,3019801227.0,9302479,10932543,276.27,276.22,20235022,5589753592.0,27270,2023-11-03 11:35:00
227,MTLR,15127,9007,3200405917.0,1605569493.0,11553652,5780646,277.0,277.75,17334298,4805975410.0,24134,14015,8090,3050144166.0,1508197500.0,11052098,5429357,275.98,277.79,16481455,4558341666.0,22105,2023-11-03 11:40:00
228,MTLR,13976,8976,3227724565.0,1561713675.0,11613738,5631660,277.92,277.31,17245398,4789438241.0,22952,13212,8282,3148411631.0,1489086274.0,11373189,5361689,276.83,277.73,16734878,4637497905.0,21494,2023-11-03 11:45:00
229,MTLR,10579,17015,2148839451.0,3344861320.0,7715337,12028063,278.52,278.09,19743400,5493700772.0,27594,9585,16171,2060384644.0,3247946233.0,7443340,11680488,276.81,278.07,19123828,5308330878.0,25756,2023-11-03 11:50:00
230,MTLR,23363,28865,5526812932.0,5293651423.0,19720203,18998955,280.26,278.63,38719158,10820464356.0,52228,22689,27899,5381253965.0,5195015774.0,19296007,18626245,278.88,278.91,37922252,10576269740.0,50588,2023-11-03 11:55:00
231,MTLR,11257,11463,1977727790.0,2259034164.0,7109135,8108665,278.2,278.6,15217800,4236761954.0,22720,10797,11121,1922707757.0,2220219154.0,6911897,7963945,278.17,278.78,14875842,4142926912.0,21918,2023-11-03 12:00:00
232,MTLR,5634,8346,926741984.0,1703645093.0,3340681,6129951,277.41,277.92,9470632,2630387077.0,13980,5396,8104,894396023.0,1679439136.0,3226408,6037107,277.21,278.19,9263515,2573835160.0,13500,2023-11-03 12:05:00
233,MTLR,19817,12470,4588840196.0,2146968777.0,16389047,7667081,279.99,280.02,24056128,6735808974.0,32287,19402,11890,4478485028.0,2098357935.0,16064317,7473949,278.78,280.76,23538266,6576842963.0,31292,2023-11-03 12:10:00
234,MTLR,22638,24013,4892805069.0,4915895109.0,17473341,17582813,280.02,279.59,35056154,9808700179.0,46651,21672,23237,4775823427.0,4770052700.0,17101404,17040051,279.26,279.93,34141455,9545876128.0,44909,2023-11-03 12:15:00
235,MTLR,3082,3365,475307480.0,515262639.0,1713120,1854692,277.45,277.82,3567812,990570120.0,6447,2546,3031,437898119.0,482863083.0,1582213,1728327,276.76,279.38,3310540,920761202.0,5577,2023-11-03 12:20:00
236,MTLR,11400,9520,2525842923.0,2343605101.0,9065506,8405084,278.62,278.83,17470590,4869448025.0,20920,11066,9234,2497702094.0,2313984307.0,8970779,8295013,278.43,278.96,17265792,4811686401.0,20300,2023-11-03 12:25:00
237,MTLR,6945,18638,1101243903.0,3376132427.0,3949365,12111540,278.84,278.75,16060905,4477376331.0,25583,6633,18406,1075111406.0,3351530322.0,3863567,12020733,278.27,278.81,15884300,4426641729.0,25039,2023-11-03 12:30:00
238,MTLR,3988,8848,1065499731.0,1763618957.0,3785499,6319578,281.47,279.07,10105077,2829118689.0,12836,3766,8649,1037294710.0,1749871220.0,3725202,6266595,278.45,279.24,9991797,2787165930.0,12415,2023-11-03 12:35:00
239,MTLR,5166,9338,1461863629.0,1630036794.0,5234661,5842307,279.27,279.01,11076968,3091900424.0,14504,4955,9137,1455683857.0,1626149163.0,5225489,5826216,278.57,279.11,11051705,3081833021.0,14092,2023-11-03 12:40:00
240,MTLR,5604,7086,1373062518.0,1349895285.0,4915350,4837236,279.34,279.06,9752586,2722957803.0,12690,5355,6702,1360449830.0,1328087518.0,4875286,4753115,279.05,279.41,9628401,2688537348.0,12057,2023-11-03 12:45:00
241,MTLR,9735,5119,2512303771.0,819805436.0,9008270,2935871,278.89,279.24,11944141,3332109207.0,14854,9430,4892,2491055339.0,813524410.0,8934817,2910605,278.8,279.5,11845422,3304579750.0,14322,2023-11-03 12:50:00
242,MTLR,7164,4462,1603816165.0,730280809.0,5749809,2619394,278.93,278.8,8369203,2334096974.0,11626,6922,4286,1591612161.0,728355844.0,5711485,2606997,278.67,279.38,8318482,2319968006.0,11208,2023-11-03 12:55:00
243,MTLR,5268,4331,791575902.0,969459629.0,2844646,3478461,278.27,278.7,6323107,1761035532.0,9599,4909,4133,764761265.0,952493751.0,2748641,3414844,278.23,278.93,6163485,1717255017.0,9042,2023-11-03 13:00:00
244,MTLR,8320,9692,2011371428.0,2501508948.0,7237040,8993548,277.93,278.14,16230588,4512880377.0,18012,7933,9439,1984065336.0,2444798098.0,7141032,8780016,277.84,278.45,15921048,4428863435.0,17372,2023-11-03 13:05:00
245,MTLR,8243,7230,1757014037.0,1619750364.0,6316434,5817115,278.17,278.45,12133549,3376764401.0,15473,8044,7009,1735069159.0,1607173468.0,6242156,5770053,277.96,278.54,12012209,3342242627.0,15053,2023-11-03 13:10:00
246,MTLR,4844,6577,855717536.0,1873709880.0,3078489,6735615,277.97,278.18,9814104,2729427416.0,11421,4635,6377,840935242.0,1853369805.0,3027804,6657234,277.74,278.4,9685038,2694305047.0,11012,2023-11-03 13:15:00
247,MTLR,7213,8620,1194662839.0,2339520364.0,4269979,8410629,279.78,278.16,12680608,3534183203.0,15833,7034,8410,1174509869.0,2326545305.0,4214443,8357958,278.69,278.36,12572401,3501055174.0,15444,2023-11-03 13:20:00
248,MTLR,8227,8903,1277810809.0,2692131500.0,4607611,9693100,277.33,277.74,14300711,3969942310.0,17130,7832,8653,1246268807.0,2666000563.0,4494540,9589658,277.29,278.01,14084198,3912269371.0,16485,2023-11-03 13:25:00
249,MTLR,5687,4980,1056094194.0,1275548328.0,3804149,4589008,277.62,277.96,8393157,2331642522.0,10667,5538,4827,1049448599.0,1306955801.0,3783071,4700331,277.41,278.06,8483402,2356404400.0,10365,2023-11-03 13:30:00
250,MTLR,9995,13275,1437685104.0,3727013981.0,5189660,13472769,277.03,276.63,18662429,5164699085.0,23270,9642,13084,1421778388.0,3700422755.0,5135523,13348977,276.85,277.21,18484500,5122201143.0,22726,2023-11-03 13:35:00
251,MTLR,14165,13158,2384789104.0,3439795774.0,8605132,12409600,277.14,277.19,21014732,5824584878.0,27323,13760,12813,2355338748.0,3420907668.0,8508015,12336955,276.84,277.29,20844970,5776246417.0,26573,2023-11-03 13:40:00
252,MTLR,3578,3205,507545587.0,636511474.0,1824452,2290533,278.19,277.89,4114985,1144057061.0,6783,3373,3039,490837171.0,630505262.0,1770484,2268798,277.23,277.9,4039282,1121342434.0,6412,2023-11-03 13:45:00
253,MTLR,6708,6533,1300268370.0,1286217384.0,4673011,4622433,278.25,278.26,9295444,2586485755.0,13241,6500,6216,1280745998.0,1276722702.0,4610595,4486805,277.78,284.55,9097400,2557468701.0,12716,2023-11-03 13:50:00
254,MTLR,8527,8565,1675742044.0,1563139615.0,6032818,5623645,277.77,277.96,11656463,3238881659.0,17092,8340,8324,1664806743.0,1545645069.0,5997708,5555959,277.57,278.2,11553667,3210451812.0,16664,2023-11-03 13:55:00
255,MTLR,29874,48804,4456017782.0,11056021669.0,16074801,39823123,277.21,277.63,55897924,15512039451.0,78678,29578,48609,4440128440.0,11046641373.0,16021415,39783276,277.14,277.67,55804691,15486769814.0,78187,2023-11-03 14:00:00
256,MTLR,5617,28199,1678564889.0,13417355825.0,6054480,48339492,277.24,277.57,54393972,15095920715.0,33816,5436,28070,1679514230.0,13413002724.0,6024642,48313730,278.77,277.62,54338372,15092516954.0,33506,2023-11-03 14:05:00
257,MTLR,5033,6677,1058689316.0,1292353790.0,3813132,4603889,277.64,280.71,8417021,2351043106.0,11710,4851,6501,1044247284.0,1284004185.0,3768167,4619217,277.12,277.97,8387384,2328251470.0,11352,2023-11-03 14:10:00
258,MTLR,9303,8938,1746792508.0,1689642353.0,6302956,5901176,277.14,286.32,12204132,3436434862.0,18241,8759,8718,1711960694.0,1666273537.0,6181252,5854227,276.96,284.63,12035479,3378234231.0,17477,2023-11-03 14:15:00
259,MTLR,4554,3312,753738218.0,545684359.0,2717536,1967306,277.36,277.38,4684842,1299422577.0,7866,4212,3127,719411862.0,530294563.0,2600121,1910889,276.68,277.51,4511010,1249706426.0,7339,2023-11-03 14:20:00
260,MTLR,2234,4230,345629427.0,913570680.0,1247340,3301186,277.09,276.74,4548526,1259200107.0,6464,1979,4092,334523398.0,900663778.0,1210964,3248508,276.25,277.25,4459472,1235187176.0,6071,2023-11-03 14:25:00
261,MTLR,4419,7881,1068945443.0,2234706478.0,3858994,8062476,277.0,277.17,11921470,3303651921.0,12300,4141,7598,1039157041.0,2217096177.0,3755875,7989189,276.68,277.51,11745064,3256253218.0,11739,2023-11-03 14:30:00
262,MTLR,2728,15725,407966528.0,3450512531.0,1468876,12436636,277.74,277.45,13905512,3858479060.0,18453,2512,15080,385919119.0,3442197730.0,1394789,12404602,276.69,277.49,13799391,3828116849.0,17592,2023-11-03 14:35:00
263,MTLR,7016,4047,3247578779.0,561427053.0,11713902,2021218,277.24,277.77,13735120,3809005832.0,11063,6913,3370,3230613077.0,540253965.0,11661429,1938564,277.03,278.69,13599993,3770867043.0,10283,2023-11-03 14:40:00
264,MTLR,8026,12552,2226109745.0,3098554138.0,8039737,11160642,276.89,277.63,19200379,5324663883.0,20578,7771,11966,2207418981.0,3089506633.0,7974624,11126754,276.81,277.66,19101378,5296925614.0,19737,2023-11-03 14:45:00
265,MTLR,4817,2979,1844013403.0,575949961.0,6647103,2072680,277.42,277.88,8719783,2419963365.0,7796,4612,2718,1812584024.0,540794453.0,6541756,1944449,277.08,278.12,8486205,2353378477.0,7330,2023-11-03 14:50:00
266,MTLR,8173,7368,2212707984.0,1436311841.0,7954514,5168281,278.17,277.91,13122795,3649019825.0,15541,7911,7044,2189476661.0,1418815017.0,7884270,5101282,277.7,278.13,12985552,3608291678.0,14955,2023-11-03 14:55:00
267,MTLR,14860,8699,4011019016.0,1517506054.0,14401535,5452023,278.51,278.34,19853558,5528525070.0,23559,14262,8046,3932794021.0,1458558162.0,14135534,5225708,278.22,279.11,19361242,5391352183.0,22308,2023-11-03 15:00:00
268,MTLR,8919,6926,2224182541.0,1304616695.0,7994456,4692097,278.22,278.05,12686553,3528799237.0,15845,8660,6656,2202052208.0,1289045191.0,7920767,4624640,278.01,278.73,12545407,3491097400.0,15316,2023-11-03 15:05:00
269,MTLR,4027,4344,971429226.0,870202322.0,3493083,3122147,278.1,278.72,6615230,1841631549.0,8371,3767,4024,947044517.0,857363245.0,3408294,3074255,277.86,278.88,6482549,1804407763.0,7791,2023-11-03 15:10:00
270,MTLR,13809,14684,2849276761.0,3075583654.0,10253858,11053117,277.87,278.25,21306975,5924860416.0,28493,13463,14376,2821743871.0,3050959137.0,10156499,10958303,277.83,278.42,21114802,5872703008.0,27839,2023-11-03 15:15:00
271,MTLR,11251,7797,2224521171.0,1614270634.0,8011799,5801832,277.66,278.23,13813631,3838791806.0,19048,10971,7573,2211423633.0,1605367553.0,7965406,5768500,277.63,278.3,13733906,3816791187.0,18544,2023-11-03 15:20:00
272,MTLR,2639,2888,550009276.0,532639380.0,1975730,1913741,278.38,278.32,3889471,1082648656.0,5527,2525,2773,538719572.0,524145339.0,1939972,1881783,277.69,278.54,3821755,1062864912.0,5298,2023-11-03 15:25:00
273,MTLR,4910,5351,1162195952.0,1017513562.0,4172709,3658282,278.52,278.14,7830991,2179709515.0,10261,4733,5165,1141186013.0,1007932289.0,4106100,3618739,277.92,278.53,7724839,2149118302.0,9898,2023-11-03 15:30:00
274,MTLR,6513,8024,1617063507.0,1447845629.0,5808883,5197702,278.38,278.55,11006585,3064909137.0,14537,6291,7842,1607516504.0,1395454611.0,5779032,5005897,278.16,278.76,10784929,3002971115.0,14133,2023-11-03 15:35:00
275,MTLR,2349,2126,500709479.0,328919385.0,1798567,1180119,278.39,278.72,2978686,829628864.0,4475,2219,2026,495806908.0,361218823.0,1785224,1294105,277.73,279.13,3079329,857025731.0,4245,2023-11-03 15:40:00
276,MTLR,9135,10422,1920402929.0,2212610653.0,6900651,7944801,278.29,278.5,14845452,4133013582.0,19557,8898,10256,1906081304.0,2194383168.0,6855025,7877865,278.06,278.55,14732890,4100464472.0,19154,2023-11-03 15:45:00
277,MTLR,16945,18856,3213394464.0,4606790921.0,11592793,16567194,277.19,278.07,28159987,7820185385.0,35801,16242,18577,3168122175.0,4538374747.0,11435286,16346954,277.05,277.63,27782240,7706496923.0,34819,2023-11-03 15:50:00
278,MTLR,6013,20039,892179343.0,4927228772.0,3217592,17755350,277.28,277.51,20972942,5819408116.0,26052,5714,19854,876323939.0,4910100404.0,3163894,17688708,276.98,277.58,20852602,5786424344.0,25568,2023-11-03 15:55:00
279,MTLR,8866,7057,1717642146.0,1197257920.0,6193073,4307602,277.35,277.94,10500675,2914900067.0,15923,8536,6909,1700983464.0,1195031817.0,6135291,4298554,277.25,278.01,10433845,2896015281.0,15445,2023-11-03 16:00:00
280,MTLR,4848,8272,757085132.0,2283378740.0,2728148,8216135,277.51,277.91,10944283,3040463873.0,13120,4704,7986,746029436.0,2267355061.0,2690045,8155392,277.33,278.02,10845437,3013384498.0,12690,2023-11-03 16:05:00
281,MTLR,3155,6434,527141713.0,1635733350.0,1915505,5899973,275.2,277.24,7815478,2162875063.0,9589,2958,6304,516335918.0,1634241222.0,1865455,5885955,276.79,277.65,7751410,2150577141.0,9262,2023-11-03 16:10:00
282,MTLR,5017,5864,962569432.0,1581518087.0,3476156,5699627,276.91,277.48,9175783,2544087519.0,10881,4736,5572,968103079.0,1554087649.0,3511391,5597967,275.7,277.62,9109358,2522190729.0,10308,2023-11-03 16:15:00
283,MTLR,3997,3053,872545979.0,726235652.0,3146746,2599378,277.29,279.39,5746124,1598781631.0,7050,3768,2898,809085019.0,709098716.0,2923459,2555369,276.76,277.49,5478828,1518183735.0,6666,2023-11-03 16:20:00
284,MTLR,1886,3159,391769681.0,709404681.0,1414356,2559334,277.0,277.18,3973690,1101174362.0,5045,1693,3000,312381556.0,702304137.0,1129671,2530726,276.52,277.51,3660397,1014685694.0,4693,2023-11-03 16:25:00
285,MTLR,3272,3936,786893001.0,805343443.0,2838278,2901760,277.24,277.54,5740038,1592236444.0,7208,3111,3753,839754500.0,783983018.0,3033395,2822956,276.84,277.72,5856351,1623737519.0,6864,2023-11-03 16:30:00
286,MTLR,2452,5210,351992536.0,1252816111.0,1269419,4517088,277.29,277.35,5786507,1604808648.0,7662,2319,5110,338112742.0,1246279461.0,1222051,4492520,276.68,277.41,5714571,1584392203.0,7429,2023-11-03 16:35:00
287,MTLR,5690,3257,1114288685.0,585451649.0,4025336,2121202,276.82,276.0,6146538,1699740335.0,8947,5356,2994,1095959798.0,552617227.0,3959972,1991242,276.76,277.52,5951214,1648577026.0,8350,2023-11-03 16:40:00
288,MTLR,4643,5139,786309642.0,880444993.0,2843536,3184762,276.53,276.46,6028298,1666754635.0,9782,4122,4834,750924341.0,861344660.0,2719343,3109202,276.14,277.03,5828545,1612269001.0,8956,2023-11-03 16:45:00
289,MTLR,2756,2380,602644474.0,278243071.0,2172704,1003672,277.37,277.23,3176376,880887545.0,5136,2550,2169,593323922.0,275443714.0,2148982,992940,276.1,277.4,3141922,868767636.0,4719,2023-11-03 16:50:00
290,MTLR,3486,3025,694867316.0,480773655.0,2509340,1734540,276.91,277.18,4243880,1175640971.0,6511,3364,2798,692902950.0,476182793.0,2503448,1716118,276.78,277.48,4219566,1169085743.0,6162,2023-11-03 16:55:00
291,MTLR,6379,7741,1012614700.0,1493962623.0,3661886,5393592,276.53,276.99,9055478,2506577323.0,14120,6204,7590,991919162.0,1488301209.0,3585064,5369499,276.68,277.18,8954563,2480220372.0,13794,2023-11-03 17:00:00
292,MTLR,2372,3870,490370217.0,571057631.0,1765334,2060573,277.78,277.14,3825907,1061427849.0,6242,2198,3690,461949787.0,552191813.0,1669352,1991909,276.72,277.22,3661261,1014141600.0,5888,2023-11-03 17:05:00
293,MTLR,1128,1245,217265955.0,145806174.0,783933,526182,277.15,277.1,1310115,363072129.0,2373,1011,1147,211026834.0,143896921.0,762075,518434,276.91,277.56,1280509,354923756.0,2158,2023-11-03 17:10:00
294,MTLR,13928,9238,2390124319.0,1708707827.0,8634224,6179282,276.82,276.52,14813506,4098832146.0,23166,13500,8941,2363411529.0,1680571616.0,8543060,6066767,276.65,277.01,14609827,4043983145.0,22441,2023-11-03 17:15:00
295,MTLR,2745,3505,472999293.0,1034647916.0,1708474,3738643,276.85,276.74,5447117,1507647209.0,6250,2465,3364,456861074.0,1034383681.0,1652684,3734334,276.44,276.99,5387018,1491244755.0,5829,2023-11-03 17:20:00
296,MTLR,2132,3089,313972177.0,617211443.0,1132432,2227970,277.25,277.03,3360402,931183621.0,5221,1944,2974,295249784.0,615081845.0,1068054,2219967,276.44,277.07,3288021,910331629.0,4918,2023-11-03 17:25:00
297,MTLR,6418,7847,977747027.0,1534402654.0,3531119,5543372,276.89,276.8,9074491,2512149681.0,14265,6235,7691,974797922.0,1522724466.0,3525066,5498300,276.53,276.94,9023366,2497522388.0,13926,2023-11-03 17:30:00
298,MTLR,3754,7105,685664251.0,1247571686.0,2474693,4504209,277.07,276.98,6978902,1933235937.0,10859,3625,6961,679239799.0,1244434188.0,2454913,4491008,276.69,277.09,6945921,1923673988.0,10586,2023-11-03 17:35:00
299,MTLR,5264,2244,1305685796.0,311221620.0,4710328,1122325,277.2,277.3,5832653,1616907416.0,7508,5154,2117,1298233462.0,307910146.0,4685585,1109416,277.07,277.54,5795001,1606143608.0,7271,2023-11-03 17:40:00
300,MTLR,10970,4556,2269754468.0,472797018.0,8182204,1701609,277.4,277.85,9883813,2742551486.0,15526,10817,4292,2212253758.0,450341497.0,7978895,1619136,277.26,278.14,9598031,2662595255.0,15109,2023-11-03 17:45:00
301,MTLR,4266,1747,1006095603.0,236650252.0,3626338,851787,277.44,277.83,4478125,1242745855.0,6013,4119,1507,986719636.0,228710035.0,3559624,822542,277.2,278.05,4382166,1215429671.0,5626,2023-11-03 17:50:00
302,MTLR,5434,3020,1260798326.0,394034997.0,4541942,1418097,277.59,277.86,5960039,1654833323.0,8454,5274,2862,1260171739.0,386398262.0,4544231,1391398,277.31,277.71,5935629,1646570002.0,8136,2023-11-03 17:55:00
303,MTLR,3668,1998,809778002.0,249306015.0,2916003,895341,277.7,278.45,3811344,1059084017.0,5666,3403,1668,765198785.0,230259793.0,2758400,826995,277.41,278.43,3585395,995458578.0,5071,2023-11-03 18:00:00
304,MTLR,1055,1044,89025315.0,111357446.0,319305,400530,278.81,278.03,719835,200382762.0,2099,787,884,107951976.0,96646486.0,389471,346913,277.18,278.59,736384,204598462.0,1671,2023-11-03 18:05:00
305,MTLR,711,2294,60471361.0,412525402.0,217106,1483258,278.53,278.12,1700364,472996763.0,3005,584,2168,54765825.0,405346078.0,197303,1455750,277.57,278.44,1653053,460111903.0,2752,2023-11-03 18:10:00
306,MTLR,3689,5192,637700791.0,1096359811.0,2296427,3949967,277.69,277.56,6246394,1734060602.0,8881,3384,4995,620760966.0,1064107512.0,2236142,3825244,277.6,278.18,6061386,1684868478.0,8379,2023-11-03 18:15:00
307,MTLR,3419,3006,590245237.0,598953022.0,2126856,2162022,277.52,277.03,4288878,1189198259.0,6425,3182,2883,574217253.0,586538609.0,2070438,2110960,277.34,277.85,4181398,1160755863.0,6065,2023-11-03 18:20:00
308,MTLR,1842,1244,274702316.0,155634766.0,987872,560098,278.07,277.87,1547970,430337082.0,3086,1686,1082,263693020.0,148094979.0,951045,532632,277.27,278.04,1483677,411787999.0,2768,2023-11-03 18:25:00
309,MTLR,22138,12934,4636716452.0,1650304123.0,16677236,5932710,278.03,278.17,22609946,6287020575.0,35072,21969,12629,4616834127.0,1629765508.0,16613068,5853789,277.9,278.41,22466857,6246599636.0,34598,2023-11-03 18:30:00
310,MTLR,2628,1552,672545685.0,240724724.0,2417535,868480,278.19,277.18,3286015,913270410.0,4180,2481,1403,655954852.0,232368468.0,2361978,834340,277.71,278.51,3196318,888323321.0,3884,2023-11-03 18:35:00
311,MTLR,1684,752,401200895.0,93097709.0,1440675,335545,278.48,277.45,1776220,494298604.0,2436,1622,629,396895195.0,72540658.0,1428694,260345,277.8,278.63,1689039,469435853.0,2251,2023-11-03 18:40:00
312,MTLR,20217,22253,2681126273.0,4360263245.0,9647290,15655379,277.91,278.52,25302669,7041389518.0,42470,17927,21193,2484335819.0,4239483817.0,8933704,15219455,278.09,278.56,24153159,6723819636.0,39120,2023-11-06 10:05:00
313,MTLR,42285,47508,7486134375.0,10673143786.0,26981716,38387439,277.45,278.04,65369155,18159278162.0,89793,41214,45867,7366773534.0,10614981776.0,26551136,38168490,277.46,278.11,64719626,17981755310.0,87081,2023-11-06 10:10:00
314,MTLR,15581,17341,3746336234.0,2640656465.0,13388064,9426132,279.83,280.14,22814196,6386992699.0,32922,14502,15977,3595608958.0,2489015904.0,12867408,8872061,279.44,280.55,21739469,6084624863.0,30479,2023-11-06 10:15:00
315,MTLR,8473,11057,2056226561.0,2428493799.0,7361660,8683662,279.32,279.66,16045322,4484720361.0,19530,7711,10552,2019621894.0,2379674797.0,7233365,8501840,279.21,279.9,15735205,4399296692.0,18263,2023-11-06 10:20:00
316,MTLR,5623,9056,1242784276.0,2130684030.0,4456902,7623436,278.84,279.49,12080338,3373468307.0,14679,5226,8711,1207293228.0,2100631546.0,4329815,7506796,278.83,279.83,11836611,3307924774.0,13937,2023-11-06 10:25:00
317,MTLR,7645,8959,1727896955.0,1696367461.0,6195111,6074392,278.91,279.27,12269503,3424264416.0,16604,7296,8775,1706945976.0,1701702204.0,6121883,6086628,278.83,279.58,12208511,3408648181.0,16071,2023-11-06 10:30:00
318,MTLR,5465,7680,926805007.0,1948708486.0,3323139,6973491,278.89,279.45,10296630,2875513494.0,13145,5050,7384,914102188.0,1941452694.0,3279220,6941319,278.76,279.7,10220539,2855554882.0,12434,2023-11-06 10:35:00
319,MTLR,12002,19603,864414256.0,5358635339.0,3106307,19190236,278.28,279.24,22296543,6223049596.0,31605,11589,19350,842475336.0,5335000690.0,3026118,19103405,278.4,279.27,22129523,6177476026.0,30939,2023-11-06 10:40:00
320,MTLR,2056,5350,310881485.0,1937440427.0,1115211,6936233,278.76,279.32,8051444,2248321912.0,7406,1782,5149,296177552.0,1918641808.0,1064180,6867978,278.32,279.36,7932158,2214819360.0,6931,2023-11-06 10:45:00
321,MTLR,8730,10708,3782040586.0,2588763910.0,13540387,9258055,279.32,279.62,22798442,6370804497.0,19438,8380,10348,3738927473.0,2575791805.0,13392037,9208703,279.19,279.71,22600740,6314719279.0,18728,2023-11-06 10:50:00
322,MTLR,18315,8631,7079723181.0,1301959662.0,25317205,4649964,279.64,279.99,29967169,8381682844.0,26946,17836,8216,7055499609.0,1285822141.0,25242461,4590009,279.51,280.13,29832470,8341321750.0,26052,2023-11-06 10:55:00
323,MTLR,4664,3936,919462667.0,911288168.0,3299720,3267113,278.65,278.93,6566833,1830750836.0,8600,4125,3687,892344684.0,861513235.0,3201238,3080387,278.75,279.68,6281625,1753857919.0,7812,2023-11-06 11:00:00
324,MTLR,9090,5455,1667764763.0,1128423567.0,5980836,4039094,278.85,279.38,10019930,2796188330.0,14545,8855,5287,1654606775.0,1109890912.0,5934087,3972559,278.83,279.39,9906646,2764497688.0,14142,2023-11-06 11:05:00
325,MTLR,4169,4491,940068352.0,896959808.0,3373068,3213467,278.7,279.13,6586535,1837028160.0,8660,3912,4280,929982291.0,878342745.0,3337846,3144950,278.62,279.29,6482796,1808325036.0,8192,2023-11-06 11:10:00
326,MTLR,5086,4816,1567058373.0,926411163.0,5613583,3314526,279.15,279.5,8928109,2493469536.0,9902,4901,4607,1558454708.0,914810382.0,5591161,3272350,278.74,279.56,8863511,2473265090.0,9508,2023-11-06 11:15:00
327,MTLR,11824,2035,4648770740.0,281746281.0,16654264,1008470,279.13,279.38,17662734,4930517021.0,13859,11637,1881,4639499217.0,274088308.0,16621780,978586,279.12,280.09,17600366,4913587526.0,13518,2023-11-06 11:20:00
328,MTLR,8595,1812,3454850828.0,236593664.0,12373755,845076,279.21,279.97,13218831,3691444493.0,10407,8083,1687,3442675739.0,237535318.0,12331608,846645,279.17,280.56,13178253,3680211058.0,9770,2023-11-06 11:25:00
329,MTLR,8355,9638,2305695377.0,2069489564.0,8235037,7393450,279.99,279.91,15628487,4375184942.0,17993,7835,9264,2265647592.0,2040996243.0,8107501,7288840,279.45,280.02,15396341,4306643836.0,17099,2023-11-06 11:30:00
330,MTLR,11862,6361,3902461064.0,1070244205.0,13892146,3822929,280.91,279.95,17715075,4972705270.0,18223,11204,5644,3821624495.0,1012956419.0,13633165,3608460,280.32,280.72,17241625,4834580915.0,16848,2023-11-06 11:35:00
331,MTLR,11860,8408,3007271000.0,2237052287.0,10727232,7957845,280.34,281.11,18685077,5244323288.0,20268,11433,8078,2960720062.0,2201570758.0,10568676,7826988,280.14,281.28,18395664,5162290821.0,19511,2023-11-06 11:40:00
332,MTLR,4713,3244,1103839743.0,622995163.0,3931514,2214987,280.77,281.26,6146501,1726834907.0,7957,4277,2704,1051208407.0,593813616.0,3749805,2109034,280.34,281.56,5858839,1645022023.0,6981,2023-11-06 11:45:00
333,MTLR,7320,3759,1442150552.0,773929023.0,5127677,2750457,281.25,281.38,7878134,2216079575.0,11079,6775,3153,1399773485.0,740217737.0,4984659,2617121,280.82,282.84,7601780,2139991223.0,9928,2023-11-06 11:50:00
334,MTLR,5649,4195,1162098682.0,1232547960.0,4142183,4389599,280.55,280.79,8531782,2394646643.0,9844,5188,3729,1123170364.0,1161795180.0,4005870,4132895,280.38,281.11,8138765,2284965544.0,8917,2023-11-06 11:55:00
335,MTLR,5069,2609,1152051703.0,667438178.0,4107371,2374743,280.48,281.06,6482114,1819489882.0,7678,4824,2302,1129841164.0,648951867.0,4028796,2307885,280.44,281.19,6336681,1778793032.0,7126,2023-11-06 12:00:00
336,MTLR,7569,4229,2266204965.0,1074402498.0,8074885,3832264,280.65,280.36,11907149,3340607463.0,11798,7262,3966,2251314923.0,1051203554.0,8027401,3742166,280.45,280.91,11769567,3302518477.0,11228,2023-11-06 12:05:00
337,MTLR,8335,6052,2156513546.0,1976851918.0,7697657,7054264,280.15,280.24,14751921,4133365465.0,14387,7860,5767,2096593898.0,1975185576.0,7487468,7037925,280.01,280.65,14525393,4071779475.0,13627,2023-11-06 12:10:00
338,MTLR,8728,12851,1350156504.0,4499739996.0,4820611,16040149,280.08,280.53,20860760,5849896500.0,21579,8475,12673,1355519303.0,4488515063.0,4843290,15999270,279.88,280.54,20842560,5844034367.0,21148,2023-11-06 12:15:00
339,MTLR,5463,11400,809207570.0,4468277059.0,2890088,15943022,279.99,280.27,18833110,5277484630.0,16863,5233,11194,813956481.0,4452472940.0,2908807,15882253,279.82,280.34,18791060,5266429422.0,16427,2023-11-06 12:20:00
340,MTLR,4289,6692,544062123.0,2762367825.0,1944027,9892021,279.86,279.25,11836048,3306429949.0,10981,3783,6402,505561855.0,2726212255.0,1809872,9741594,279.34,279.85,11551466,3231774110.0,10185,2023-11-06 12:25:00
341,MTLR,1388,1484,288787266.0,366633326.0,1031923,1309223,279.85,280.04,2341146,655420593.0,2872,1255,1343,287366160.0,358997072.0,1027466,1280563,279.68,280.34,2308029,646363233.0,2598,2023-11-06 12:30:00
342,MTLR,2244,1328,525730599.0,325214281.0,1877856,1160141,279.96,280.32,3037997,850944881.0,3572,2104,1215,516545924.0,314293205.0,1846507,1121176,279.74,280.32,2967683,830839129.0,3319,2023-11-06 12:35:00
343,MTLR,2973,4683,501038706.0,1799451802.0,1789348,6415082,280.01,280.5,8204430,2300490509.0,7656,2797,4592,489234994.0,1789962931.0,1748793,6381103,279.76,280.51,8129896,2279197925.0,7389,2023-11-06 12:40:00
344,MTLR,1330,2711,175717501.0,1039336826.0,628874,3708840,279.42,280.23,4337714,1215054328.0,4041,1234,2613,178462664.0,1026397809.0,638779,3661549,279.38,280.32,4300328,1204860474.0,3847,2023-11-06 12:45:00
345,MTLR,2450,5243,349097097.0,2015909935.0,1250312,7201904,279.21,279.91,8452216,2365007033.0,7693,2259,5086,343870619.0,2007661327.0,1231548,7168741,279.22,280.06,8400289,2351531947.0,7345,2023-11-06 12:50:00
346,MTLR,3722,6947,645580388.0,2375317365.0,2314794,8500704,278.89,279.43,10815498,3020897754.0,10669,3317,6750,627441344.0,2369219793.0,2250101,8471260,278.85,279.68,10721361,2996661137.0,10067,2023-11-06 12:55:00
347,MTLR,2135,3009,349804529.0,899473501.0,1249179,3216964,280.03,279.6,4466143,1249278030.0,5144,1818,2836,331222713.0,883512350.0,1187981,3158444,278.81,279.73,4346425,1214735063.0,4654,2023-11-06 13:00:00
348,MTLR,2834,2748,550115174.0,806772482.0,1968494,2882280,279.46,279.91,4850774,1356887657.0,5582,2726,2571,543048940.0,801640714.0,1946032,2863439,279.05,279.96,4809471,1344689654.0,5297,2023-11-06 13:05:00
349,MTLR,2640,3930,533072900.0,1210401737.0,1910013,4327270,279.09,279.71,6237283,1743474637.0,6570,2552,3842,527867074.0,1201195173.0,1891873,4294000,279.02,279.74,6185873,1729062248.0,6394,2023-11-06 13:10:00
350,MTLR,3563,5129,662696960.0,1555789857.0,2370340,5559033,279.58,279.87,7929373,2218486818.0,8692,3416,4944,648144605.0,1547627542.0,2321861,5529406,279.15,279.89,7851267,2195772147.0,8360,2023-11-06 13:15:00
351,MTLR,2224,3025,536074571.0,805976707.0,1915211,2879300,279.9,279.92,4794511,1342051278.0,5249,1885,2881,512293009.0,789333506.0,1832351,2818768,279.58,280.03,4651119,1301626516.0,4766,2023-11-06 13:20:00
352,MTLR,2129,4902,371165786.0,1324526976.0,1328319,4732172,279.43,279.9,6060491,1695692763.0,7031,1860,4742,349571959.0,1318895441.0,1251125,4711612,279.41,279.92,5962737,1668467401.0,6602,2023-11-06 13:25:00
353,MTLR,4250,9376,617499685.0,3318367407.0,2211004,11859694,279.28,279.8,14070698,3935867092.0,13626,3994,9264,628232276.0,3310385931.0,2250297,11829873,279.18,279.83,14080170,3938618208.0,13258,2023-11-06 13:30:00
354,MTLR,4877,9720,672230229.0,3446674754.0,2407338,12323477,279.24,279.68,14730815,4118904984.0,14597,4588,9472,668507035.0,3444188223.0,2394584,12310092,279.17,279.79,14704676,4112695258.0,14060,2023-11-06 13:35:00
355,MTLR,2912,4982,429077300.0,1864084125.0,1535926,6660994,279.36,279.85,8196920,2293161426.0,7894,2861,4859,427385351.0,1861239850.0,1530770,6650358,279.2,279.87,8181128,2288625201.0,7720,2023-11-06 13:40:00
356,MTLR,6554,6357,1581128322.0,2027115150.0,5648657,7240526,279.91,279.97,12889183,3608243473.0,12911,6037,5948,1562413159.0,1995502623.0,5585362,7120534,279.73,280.25,12705896,3557915783.0,11985,2023-11-06 13:45:00
357,MTLR,7235,3440,1829722524.0,731562736.0,6528498,2608378,280.27,280.47,9136876,2561285260.0,10675,6916,3132,1800381912.0,719179305.0,6431174,2562789,279.95,280.62,8993963,2519561218.0,10048,2023-11-06 13:50:00
358,MTLR,2262,1608,361684291.0,226395291.0,1288719,807097,280.65,280.51,2095816,588079583.0,3870,1943,1231,343031607.0,194170957.0,1225333,690066,279.95,281.38,1915399,537202565.0,3174,2023-11-06 13:55:00
359,MTLR,1685,1509,313643161.0,336395543.0,1120886,1203106,279.82,279.61,2323992,650038705.0,3194,1484,1303,296637891.0,305070930.0,1060002,1086766,279.85,280.71,2146768,601708822.0,2787,2023-11-06 14:00:00
360,MTLR,1955,1397,557099200.0,251441119.0,1987377,895681,280.32,280.73,2883058,808540319.0,3352,1857,1234,552520861.0,245825084.0,1972310,875001,280.14,280.94,2847311,798345945.0,3091,2023-11-06 14:05:00
361,MTLR,1895,2257,309046439.0,631700353.0,1103390,2258934,280.09,279.65,3362324,940746793.0,4152,1806,2156,306954050.0,618394837.0,1096336,2203965,279.98,280.58,3300301,925348887.0,3962,2023-11-06 14:10:00
362,MTLR,2636,6588,619894252.0,2363492923.0,2214395,8428779,279.94,280.41,10643174,2983387176.0,9224,2493,6505,613598097.0,2361782290.0,2193001,8421419,279.8,280.45,10614420,2975380388.0,8998,2023-11-06 14:15:00
363,MTLR,2258,5914,280646840.0,2375161663.0,1002250,8471956,280.02,280.36,9474206,2655808504.0,8172,2141,5769,279486047.0,2364443758.0,998947,8432369,279.78,280.4,9431316,2643929806.0,7910,2023-11-06 14:20:00
364,MTLR,797,2702,90467781.0,986299654.0,323095,3517186,280.0,280.42,3840281,1076767435.0,3499,719,2632,86643429.0,987543898.0,309608,3521374,279.85,280.44,3830982,1074187328.0,3351,2023-11-06 14:25:00
365,MTLR,683,2151,110457167.0,423274826.0,394075,1508640,280.29,280.57,1902715,533731994.0,2834,590,2078,110661647.0,412556945.0,395739,1470534,279.63,280.55,1866273,523218592.0,2668,2023-11-06 14:30:00
366,MTLR,2597,1894,656770355.0,316603202.0,2334707,1126882,281.31,280.96,3461589,973373557.0,4491,2421,1708,646452340.0,308862695.0,2306345,1098471,280.29,281.18,3404816,955315036.0,4129,2023-11-06 14:35:00
367,MTLR,1402,1105,244590683.0,120797049.0,868897,431305,281.5,280.07,1300202,365387733.0,2507,1265,794,233418923.0,105202114.0,832979,373866,280.22,281.39,1206845,338621037.0,2059,2023-11-06 14:40:00
368,MTLR,696,495,85252115.0,74032483.0,304140,264020,280.31,280.4,568160,159284598.0,1191,589,377,78185521.0,63068740.0,279386,223634,279.85,282.02,503020,141254261.0,966,2023-11-06 14:45:00
369,MTLR,2649,825,743350501.0,114694765.0,2651299,407736,280.37,281.3,3059035,858045267.0,3474,2596,766,732775525.0,115733561.0,2613015,411122,280.43,281.51,3024137,848509087.0,3362,2023-11-06 14:50:00
370,MTLR,1871,1192,320924464.0,190383299.0,1144183,679748,280.48,280.08,1823931,511307763.0,3063,1795,1149,318055907.0,189015403.0,1134296,673121,280.4,280.8,1807417,507071311.0,2944,2023-11-06 14:55:00
371,MTLR,1911,1038,219670038.0,266643823.0,783573,952749,280.34,279.87,1736322,486313862.0,2949,1511,913,212195091.0,247578407.0,758000,880957,279.94,281.03,1638957,459773499.0,2424,2023-11-06 15:00:00
372,MTLR,2671,3507,394648541.0,1161858046.0,1409278,4142890,280.04,280.45,5552168,1556506588.0,6178,2410,3331,388270878.0,1156114661.0,1386678,4117962,280.0,280.75,5504640,1544385539.0,5741,2023-11-06 15:05:00
373,MTLR,1013,2214,154207342.0,687124658.0,551062,2449171,279.84,280.55,3000233,841332000.0,3227,919,2045,154367863.0,687839269.0,551810,2451013,279.75,280.63,3002823,842207133.0,2964,2023-11-06 15:10:00
374,MTLR,801,397,65798094.0,59916878.0,235291,214054,279.65,279.91,449345,125714973.0,1198,717,336,64669849.0,61849963.0,231469,220026,279.39,281.1,451495,126519813.0,1053,2023-11-06 15:15:00
375,MTLR,1042,1513,92130085.0,361062750.0,328233,1288283,280.69,280.27,1616516,453192836.0,2555,918,1389,86937118.0,351196513.0,310933,1251929,279.6,280.52,1562862,438133632.0,2307,2023-11-06 15:20:00
376,MTLR,902,1451,93727255.0,460310601.0,333037,1642254,281.43,280.29,1975291,554037856.0,2353,712,1396,82185891.0,443256634.0,294243,1582074,279.31,280.17,1876317,525442525.0,2108,2023-11-06 15:25:00
377,MTLR,1516,2102,269930718.0,497759474.0,964372,1777839,279.9,279.98,2742211,767690193.0,3618,1369,2001,265902323.0,504086439.0,951248,1797728,279.53,280.4,2748976,769988762.0,3370,2023-11-06 15:30:00
378,MTLR,5390,3126,1159545438.0,851160751.0,4147849,3033301,279.55,280.61,7181150,2010706189.0,8516,5199,2966,1136540958.0,825574443.0,4064037,2942478,279.66,280.57,7006515,1962115402.0,8165,2023-11-06 15:35:00
379,MTLR,545,638,94128667.0,122316558.0,336031,436609,280.12,280.15,772640,216445226.0,1183,456,583,90839470.0,111670752.0,325172,398064,279.36,280.53,723236,202510222.0,1039,2023-11-06 15:40:00
380,MTLR,976,564,156169545.0,75680953.0,558913,270416,279.42,279.87,829329,231850498.0,1540,846,453,138041545.0,70620579.0,494150,251727,279.35,280.54,745877,208662124.0,1299,2023-11-06 15:45:00
381,MTLR,3377,1752,1028080478.0,505535858.0,3673026,1804344,279.9,280.18,5477370,1533616337.0,5129,3276,1631,1018708097.0,503119484.0,3640460,1791524,279.83,280.83,5431984,1521827581.0,4907,2023-11-06 15:50:00
382,MTLR,2076,3585,314003709.0,1786497693.0,1122072,6370314,279.84,280.44,7492386,2100501403.0,5661,1945,3499,311391822.0,1778239780.0,1113539,6340288,279.64,280.47,7453827,2089631602.0,5444,2023-11-06 15:55:00
383,MTLR,978,1797,108079703.0,686651273.0,386845,2451445,279.39,280.1,2838290,794730977.0,2775,848,1685,105349107.0,673431408.0,377054,2403779,279.4,280.16,2780833,778780515.0,2533,2023-11-06 16:00:00
384,MTLR,1805,3184,276721180.0,1123008764.0,991312,4021224,279.15,279.27,5012536,1399729944.0,4989,1628,3138,269952241.0,1127519416.0,967312,4027985,279.07,279.92,4995297,1397471657.0,4766,2023-11-06 16:05:00
385,MTLR,2306,2861,343067772.0,897546121.0,1227780,3206061,279.42,279.95,4433841,1240613893.0,5167,2262,2834,344616479.0,901346777.0,1233752,3219340,279.32,279.98,4453092,1245963256.0,5096,2023-11-06 16:10:00
386,MTLR,957,1269,144846199.0,311867341.0,517864,1113898,279.7,279.98,1631762,456713541.0,2226,872,1181,140809988.0,310124000.0,503662,1106748,279.57,280.21,1610410,450933989.0,2053,2023-11-06 16:15:00
387,MTLR,436,293,70359425.0,75101930.0,251488,268313,279.77,279.9,519801,145461355.0,729,400,282,68847223.0,73873249.0,246219,263721,279.62,280.12,509940,142720473.0,682,2023-11-06 16:20:00
388,MTLR,1073,1335,166243972.0,349110920.0,592730,1246466,280.47,280.08,1839196,515354893.0,2408,987,1292,162445559.0,346780368.0,580866,1236844,279.66,280.38,1817710,509225927.0,2279,2023-11-06 16:25:00
389,MTLR,1602,3972,305499904.0,1222955005.0,1092667,4365128,279.59,280.16,5457795,1528454910.0,5574,1525,3910,306985032.0,1217285450.0,1098265,4344654,279.52,280.18,5442919,1524270482.0,5435,2023-11-06 16:30:00
390,MTLR,2012,4562,292367430.0,1836852674.0,1046522,6566365,279.37,279.74,7612887,2129220104.0,6574,1887,4475,326734931.0,1833430756.0,1171178,6549473,278.98,279.94,7720651,2160165687.0,6362,2023-11-06 16:35:00
391,MTLR,1842,4374,255225797.0,1516594288.0,911877,5419429,279.89,279.84,6331306,1771820085.0,6216,1713,4231,248966971.0,1511934580.0,891182,5402286,279.37,279.87,6293468,1760901552.0,5944,2023-11-06 16:40:00
392,MTLR,1425,4711,192012558.0,1539595653.0,686836,5500507,279.56,279.9,6187343,1731608211.0,6136,1356,4680,190729304.0,1540246724.0,682629,5502693,279.4,279.91,6185322,1730976029.0,6036,2023-11-06 16:45:00
393,MTLR,862,2371,104221243.0,866032354.0,372152,3093770,280.05,279.93,3465922,970253598.0,3233,805,2322,102987662.0,865836891.0,368589,3092842,279.41,279.95,3461431,968824554.0,3127,2023-11-06 16:50:00
394,MTLR,1716,3034,235408088.0,1273858860.0,842571,4553749,279.39,279.74,5396320,1509266949.0,4750,1545,2929,231418516.0,1260929942.0,828686,4506651,279.26,279.79,5335337,1492348459.0,4474,2023-11-06 16:55:00
395,MTLR,1180,1656,145844061.0,526867820.0,522250,1884566,279.26,279.57,2406816,672711881.0,2836,943,1558,134570853.0,516768167.0,482206,1848056,279.07,279.63,2330262,651339020.0,2501,2023-11-06 17:00:00
396,MTLR,996,963,171203145.0,167793074.0,612854,600422,279.35,279.46,1213276,338996219.0,1959,833,855,167722991.0,163509486.0,600781,584285,279.17,279.85,1185066,331232478.0,1688,2023-11-06 17:05:00
397,MTLR,559,1370,82206091.0,163270018.0,294443,584004,279.19,279.57,878447,245476109.0,1929,486,1341,80765431.0,168006051.0,289407,600376,279.07,279.83,889783,248771482.0,1827,2023-11-06 17:10:00
398,MTLR,7129,5534,2383820007.0,874484675.0,8431863,3117228,282.72,280.53,11549091,3258304683.0,12663,6852,4996,2265557286.0,837585412.0,8079366,2982062,280.41,280.87,11061428,3103142699.0,11848,2023-11-06 17:15:00
399,MTLR,4048,2619,1375035883.0,383558362.0,4908609,1367033,280.13,280.58,6275642,1758594246.0,6667,3821,2362,1352697380.0,362902944.0,4826831,1290913,280.25,281.12,6117744,1715600325.0,6183,2023-11-06 17:20:00
400,MTLR,4116,3038,1381479703.0,434081341.0,4917418,1548809,280.94,280.27,6466227,1815561045.0,7154,3826,2749,1341035377.0,414884890.0,4779553,1475532,280.58,281.18,6255085,1755920268.0,6575,2023-11-06 17:25:00
401,MTLR,907,1200,107764708.0,108202193.0,381637,385794,282.37,280.47,767431,215966901.0,2107,763,1064,102651973.0,104226302.0,365813,370632,280.61,281.21,736445,206878275.0,1827,2023-11-06 17:30:00
402,MTLR,437,741,32604808.0,41484064.0,115872,148077,281.39,280.15,263949,74088872.0,1178,322,647,39280403.0,41393957.0,142565,146815,275.53,281.95,289380,80674361.0,969,2023-11-06 17:35:00
403,MTLR,4294,1298,1995734285.0,117059769.0,7095277,417501,281.28,280.38,7512778,2112794054.0,5592,4053,1005,1974218718.0,112463475.0,7027933,399535,280.91,281.49,7427468,2086682193.0,5058,2023-11-06 17:40:00
404,MTLR,4634,2151,1725520220.0,358902611.0,6116287,1275976,282.12,281.28,7392263,2084422832.0,6785,4201,1499,1686415609.0,176250131.0,5992635,625196,281.41,281.91,6617831,1862665740.0,5700,2023-11-06 17:45:00
405,MTLR,1225,1182,127548498.0,106820917.0,452514,380863,281.87,280.47,833377,234369416.0,2407,867,814,103172458.0,76177508.0,367321,269795,280.88,282.35,637116,179349966.0,1681,2023-11-06 17:50:00
406,MTLR,1973,796,282397221.0,118503240.0,1004054,427282,281.26,277.34,1431336,400900462.0,2769,1627,636,272817866.0,246281126.0,970673,872529,281.06,282.26,1843202,519098993.0,2263,2023-11-06 17:55:00
407,MTLR,7547,3168,2626112238.0,377559161.0,9316412,1339332,281.88,281.9,10655744,3003671400.0,10715,7246,2857,2596560314.0,371236771.0,9221433,1316006,281.58,282.09,10537439,2967797085.0,10103,2023-11-06 18:00:00
408,MTLR,15850,8705,4787625481.0,1446712442.0,16934730,5133369,282.71,281.83,22068099,6234337923.0,24555,15133,7495,4663033872.0,1368146944.0,16518088,4834697,282.3,282.99,21352785,6031180816.0,22628,2023-11-06 18:05:00
409,MTLR,2630,2843,349190006.0,789612677.0,1235895,2802513,282.54,281.75,4038408,1138802683.0,5473,2270,2565,329826175.0,763633852.0,1168926,2701099,282.16,282.71,3870025,1093460027.0,4835,2023-11-06 18:10:00
410,MTLR,3521,3122,493923517.0,681846824.0,1743444,2413681,283.3,282.49,4157125,1175770341.0,6643,3263,2849,474100779.0,673180671.0,1679507,2380671,282.29,282.77,4060178,1147281450.0,6112,2023-11-06 18:15:00
411,MTLR,4208,6170,600620221.0,2390820039.0,2127409,8479409,282.32,281.96,10606818,2991440260.0,10378,3790,5887,578476022.0,2365195575.0,2052315,8372092,281.87,282.51,10424407,2943671597.0,9677,2023-11-06 18:20:00
412,MTLR,3915,5827,485007953.0,2329886211.0,1718890,8260020,282.16,282.07,9978910,2814894164.0,9742,3546,5143,474824360.0,2271486454.0,1685589,8049260,281.7,282.2,9734849,2746310815.0,8689,2023-11-06 18:25:00
413,MTLR,2519,1710,401658899.0,204431155.0,1417282,725549,283.4,281.76,2142831,606090055.0,4229,1820,1243,342852095.0,179189812.0,1217239,634351,281.66,282.48,1851590,522041908.0,3063,2023-11-06 18:30:00
414,MTLR,2321,3371,417806240.0,1070495544.0,1483827,3800644,281.57,281.66,5284471,1488301785.0,5692,2054,3245,360572465.0,1060495596.0,1280084,3756642,281.68,282.3,5036726,1421068062.0,5299,2023-11-06 18:35:00
415,MTLR,1638,1257,311290932.0,160037025.0,1099439,567754,283.14,281.88,1667193,471327957.0,2895,1502,1185,305405758.0,158054076.0,1083830,559678,281.78,282.4,1643508,463459834.0,2687,2023-11-06 18:40:00
416,MTLR,20206,17441,3303173130.0,3650122218.0,11642739,12864454,283.71,283.74,24507193,6953295349.0,37647,17528,15663,3055768008.0,3436231968.0,10774331,12084433,283.62,284.35,22858764,6491999977.0,33191,2023-11-07 10:05:00
417,MTLR,24793,28215,3558446617.0,6318130055.0,12572463,22363397,283.03,282.52,34935860,9876576673.0,53008,23555,27218,3414893668.0,6192124718.0,12078421,21887004,282.73,282.91,33965425,9607018386.0,50773,2023-11-07 10:10:00
418,MTLR,9544,18451,1229554329.0,5707353795.0,4342262,20068066,283.16,284.4,24410328,6936908124.0,27995,8898,17906,1187740230.0,5642924055.0,4199382,19888284,282.84,283.73,24087666,6830664285.0,26804,2023-11-07 10:15:00
419,MTLR,20755,11065,5365835154.0,2009187174.0,18904785,7067461,283.83,284.29,25972246,7375022328.0,31820,19947,10286,5259525954.0,1960032667.0,18556384,6845378,283.43,286.33,25401762,7219558622.0,30233,2023-11-07 10:20:00
420,MTLR,14263,12537,3040111444.0,3703813389.0,10662655,12967906,285.12,285.61,23630561,6743924833.0,26800,13146,11180,2917961881.0,3555798348.0,10265798,12484625,284.24,284.81,22750423,6473760230.0,24326,2023-11-07 10:25:00
421,MTLR,10495,11795,2158138269.0,3833629878.0,7600916,13493863,283.93,284.1,21094779,5991768148.0,22290,9772,11314,2109257618.0,3775488120.0,7440482,13277562,283.48,284.35,20718044,5884745739.0,21086,2023-11-07 10:30:00
422,MTLR,8217,11237,1724593431.0,3787251586.0,6082505,13348034,283.53,283.73,19430539,5511845017.0,19454,7692,10668,1685463165.0,3738771536.0,5950833,13167677,283.23,283.94,19118510,5424234702.0,18360,2023-11-07 10:35:00
423,MTLR,11401,16721,2661314053.0,4375708934.0,9368045,15361378,284.08,284.85,24729423,7037022987.0,28122,10776,16214,2602057339.0,4320540230.0,9174040,15162423,283.63,284.95,24336463,6922597569.0,26990,2023-11-07 10:40:00
424,MTLR,6889,6412,1798331477.0,1320788935.0,6335515,4649393,283.85,284.08,10984908,3119120412.0,13301,6520,6054,1768743161.0,1301309563.0,6236583,4578427,283.61,284.23,10815010,3070052724.0,12574,2023-11-07 10:45:00
425,MTLR,21151,11018,6304674854.0,2324833951.0,22165348,8175822,284.44,284.35,30341170,8629508806.0,32169,20315,10331,6208269977.0,2257982790.0,21858454,7933307,284.02,284.62,29791761,8466252767.0,30646,2023-11-07 10:50:00
426,MTLR,13006,10572,2996153816.0,2427544899.0,10555165,8539394,283.86,284.28,19094559,5423698715.0,23578,12340,10280,2971481011.0,2407732646.0,10470916,8456440,283.78,284.72,18927356,5379213657.0,22620,2023-11-07 10:55:00
427,MTLR,7475,5571,2057355679.0,1103581073.0,7238719,3880898,284.22,284.36,11119617,3160936753.0,13046,7146,5022,2032558835.0,1082404794.0,7160909,3803525,283.84,284.58,10964434,3114963629.0,12168,2023-11-07 11:00:00
428,MTLR,8466,6111,1844256021.0,1940858506.0,6496052,6837481,283.9,283.86,13333533,3785114527.0,14577,8161,5823,1825807119.0,1913604062.0,6434631,6729241,283.75,284.37,13163872,3739411182.0,13984,2023-11-07 11:05:00
429,MTLR,6697,5913,1293296715.0,1540228622.0,4545716,5426317,284.51,283.84,9972033,2833525337.0,12610,6130,5536,1258613160.0,1519304670.0,4434275,5342539,283.84,284.38,9776814,2777917830.0,11666,2023-11-07 11:10:00
430,MTLR,9257,3829,2524175989.0,825733182.0,8862484,2909360,284.82,283.82,11771844,3349909172.0,13086,8828,3277,2469145897.0,784476026.0,8686484,2753060,284.25,284.95,11439544,3253621924.0,12105,2023-11-07 11:15:00
431,MTLR,7729,3921,1658766914.0,951624080.0,5816324,3351489,285.19,283.94,9167813,2610390994.0,11650,7247,3293,1620195946.0,895259859.0,5702642,3141405,284.11,284.99,8844047,2515455805.0,10540,2023-11-07 11:20:00
432,MTLR,6258,2098,1383035084.0,523946403.0,4865773,1851120,284.24,283.04,6716893,1906981487.0,8356,5963,1802,1364767974.0,507488423.0,4804387,1781529,284.07,284.86,6585916,1872256398.0,7765,2023-11-07 11:25:00
433,MTLR,4082,8120,532246420.0,2543447620.0,1872188,8972654,284.29,283.47,10844842,3075694040.0,12202,3343,7813,504070346.0,2515409600.0,1743885,8854308,289.05,284.09,10598193,3019479947.0,11156,2023-11-07 11:30:00
434,MTLR,4100,4911,592955142.0,1562414932.0,2089036,5514307,283.84,283.34,7603343,2155370075.0,9011,3486,4565,558235659.0,1544834617.0,1970965,5439915,283.23,283.98,7410880,2103070276.0,8051,2023-11-07 11:35:00
435,MTLR,3569,5710,414371257.0,1842012139.0,1459488,6504812,283.92,283.18,7964300,2256383396.0,9279,3115,5394,380553126.0,1772598761.0,1345289,6245018,282.88,283.84,7590307,2153151887.0,8509,2023-11-07 11:40:00
436,MTLR,3630,9678,587923187.0,2268835673.0,2073858,8021695,283.49,282.84,10095553,2856758861.0,13308,3119,9242,536033821.0,2236784139.0,1897643,7892031,282.47,283.42,9789674,2772817960.0,12361,2023-11-07 11:45:00
437,MTLR,3721,1378,1091382320.0,169492083.0,3848150,598052,283.61,283.41,4446202,1260874404.0,5099,3467,1099,1068149790.0,154865398.0,3769882,544243,283.34,284.55,4314125,1223015188.0,4566,2023-11-07 11:50:00
438,MTLR,1338,664,213650241.0,78538422.0,751855,277562,284.16,282.96,1029417,292188664.0,2002,1162,524,199611494.0,73401148.0,704900,258044,283.18,284.45,962944,273012642.0,1686,2023-11-07 11:55:00
439,MTLR,932,490,200842940.0,59248802.0,704871,208873,284.94,283.66,913744,260091742.0,1422,821,339,197556157.0,52190446.0,698028,183227,283.02,284.84,881255,249746603.0,1160,2023-11-07 12:00:00
440,MTLR,1844,1279,489106288.0,185559422.0,1726663,656606,283.27,282.6,2383269,674665710.0,3123,1707,1160,489563493.0,177015599.0,1728467,622765,283.24,284.24,2351232,666579092.0,2867,2023-11-07 12:05:00
441,MTLR,5824,6959,1610138225.0,1325706561.0,5642098,4666024,285.38,284.12,10308122,2935844787.0,12783,5509,6606,1559013800.0,1292824849.0,5495750,4543893,283.68,284.52,10039643,2851838650.0,12115,2023-11-07 12:10:00
442,MTLR,3094,1809,554890288.0,320178667.0,1944937,1128520,285.3,283.72,3073457,875068956.0,4903,2604,1513,525827280.0,285078995.0,1853006,1000165,283.77,285.03,2853171,810906275.0,4117,2023-11-07 12:15:00
443,MTLR,4663,2583,1116283639.0,572673942.0,3917924,2013827,284.92,284.37,5931751,1688957581.0,7246,4165,2387,1071855385.0,557934011.0,3775805,1960375,283.87,284.61,5736180,1629789396.0,6552,2023-11-07 12:20:00
444,MTLR,8268,2705,2612184564.0,430328710.0,9173955,1518504,284.74,283.39,10692459,3042513275.0,10973,7858,2222,2572179429.0,403142200.0,9049233,1414577,284.24,284.99,10463810,2975321630.0,10080,2023-11-07 12:25:00
445,MTLR,1575,3641,287140057.0,1060726253.0,1010827,3735989,284.06,283.92,4746816,1347866310.0,5216,1323,3476,279055869.0,1036360769.0,984004,3643907,283.59,284.41,4627911,1315416639.0,4799,2023-11-07 12:30:00
446,MTLR,8380,8447,1937027274.0,2417557053.0,6825914,8526554,283.78,283.53,15352468,4354584327.0,16827,8080,8204,1913314915.0,2390583224.0,6747926,8413275,283.54,284.14,15161201,4303898139.0,16284,2023-11-07 12:35:00
447,MTLR,3609,6733,493099364.0,1999198826.0,1738874,7042307,283.57,283.88,8781181,2492298191.0,10342,3397,6554,484131593.0,1983977467.0,1708640,6983561,283.34,284.09,8692201,2468109060.0,9951,2023-11-07 12:40:00
448,MTLR,3094,1300,472676646.0,291360311.0,1666006,1027107,283.72,283.67,2693113,764036958.0,4394,2937,1160,463160583.0,285578106.0,1633431,1004448,283.55,284.31,2637879,748738689.0,4097,2023-11-07 12:45:00
449,MTLR,2196,1152,463789719.0,167501479.0,1632325,589889,284.13,283.95,2222214,631291198.0,3348,2045,1009,453124880.0,162853239.0,1597661,572731,283.62,284.35,2170392,615978120.0,3054,2023-11-07 12:50:00
450,MTLR,3025,813,662222579.0,153420672.0,2320737,540715,285.35,283.74,2861452,815643252.0,3838,2892,686,627886239.0,142126945.0,2212545,498310,283.78,285.22,2710855,770013184.0,3578,2023-11-07 12:55:00
451,MTLR,10769,2749,3154534210.0,366606730.0,11040937,1289990,285.71,284.19,12330927,3521140940.0,13518,10220,2153,3070514362.0,325076224.0,10805348,1140903,284.17,284.93,11946251,3395590587.0,12373,2023-11-07 13:00:00
452,MTLR,12777,6391,2737511157.0,1273137951.0,9589325,4461940,285.47,285.33,14051265,4010649108.0,19168,12042,5530,2640412631.0,1224546561.0,9278552,4287901,284.57,285.58,13566453,3864959193.0,17572,2023-11-07 13:05:00
453,MTLR,5501,6208,681308224.0,1489789926.0,2383950,5221215,285.79,285.33,7605165,2171098150.0,11709,4407,5469,642840109.0,1435476475.0,2257306,5024055,284.78,285.72,7281361,2078316584.0,9876,2023-11-07 13:10:00
454,MTLR,6087,4413,1119765248.0,899444880.0,3924864,3145283,285.3,285.97,7070147,2019210129.0,10500,5404,3360,993538407.0,840242359.0,3472673,2933480,286.1,286.43,6406153,1833780767.0,8764,2023-11-07 13:15:00
455,MTLR,3411,5246,560433624.0,1069797012.0,1939227,3716375,289.0,287.86,5655602,1630230637.0,8657,2793,4316,508918738.0,974921140.0,1826129,3397996,278.69,286.91,5224125,1483839879.0,7109,2023-11-07 13:20:00
456,MTLR,2582,3871,393341876.0,1042356831.0,1374065,3663352,286.26,284.54,5037417,1435698707.0,6453,2177,3451,367550342.0,1004502432.0,1288322,3508247,285.29,286.33,4796569,1372052774.0,5628,2023-11-07 13:25:00
457,MTLR,2726,1651,495778424.0,367566593.0,1733280,1289149,286.03,285.12,3022429,863345018.0,4377,2449,1428,440769430.0,358662261.0,1544834,1251085,285.32,286.68,2795919,799431692.0,3877,2023-11-07 13:30:00
458,MTLR,7302,3394,1491379988.0,772091112.0,5171972,2689016,288.36,287.13,7860988,2263471100.0,10696,6560,2451,1437640853.0,705644699.0,5021236,2453862,286.31,287.56,7475098,2143285552.0,9011,2023-11-07 13:35:00
459,MTLR,3237,5602,405015408.0,1367105478.0,1402603,4766763,288.76,286.8,6169366,1772120886.0,8839,2634,4720,366308522.0,1336164512.0,1280422,4650665,286.08,287.31,5931087,1702473035.0,7354,2023-11-07 13:40:00
460,MTLR,5345,3498,964402957.0,933291137.0,3357833,3261031,287.21,286.2,6618864,1897694095.0,8843,4927,3055,927102803.0,902024851.0,3235719,3141359,286.52,287.14,6377078,1829127654.0,7982,2023-11-07 13:45:00
461,MTLR,8210,2565,2273207301.0,454344680.0,7901039,1579501,287.71,287.65,9480540,2727551982.0,10775,7714,1933,2209809150.0,418276214.0,7705376,1451837,286.79,288.1,9157213,2628085364.0,9647,2023-11-07 13:50:00
462,MTLR,16997,10837,4190812961.0,2992108487.0,14555623,10421125,287.92,287.12,24976748,7182921448.0,27834,16202,10049,4094763743.0,2909062306.0,14262481,10106336,287.1,287.85,24368817,7003826049.0,26251,2023-11-07 13:55:00
463,MTLR,6577,6556,1237571737.0,1795565715.0,4290899,6245700,288.42,287.49,10536599,3033137452.0,13133,6038,6034,1191842053.0,1726083306.0,4155170,6001545,286.83,287.61,10156715,2917925359.0,12072,2023-11-07 14:00:00
464,MTLR,4077,1235,1141400015.0,279213335.0,3966318,973425,287.77,286.84,4939743,1420613351.0,5312,3635,909,1045350349.0,261540992.0,3636221,906672,287.48,288.46,4542893,1306891341.0,4544,2023-11-07 14:05:00
465,MTLR,1820,1281,205514058.0,174541319.0,706501,610163,290.89,286.06,1316664,380055377.0,3101,1527,973,171164614.0,149773117.0,596705,519714,286.85,288.18,1116419,320937732.0,2500,2023-11-07 14:10:00
466,MTLR,4495,3873,925663447.0,862295905.0,3183968,2994420,290.73,287.97,6178388,1787959353.0,8368,3817,2982,844461419.0,799085360.0,2940495,2770682,287.18,288.41,5711177,1643546780.0,6799,2023-11-07 14:15:00
467,MTLR,3064,3079,410543353.0,992232141.0,1415258,3463676,290.08,286.47,4878934,1402775495.0,6143,2545,2689,368876807.0,956811324.0,1280103,3323646,288.16,287.88,4603749,1325688131.0,5234,2023-11-07 14:20:00
468,MTLR,4965,4373,1248608582.0,1356604601.0,4346444,4742223,287.27,286.07,9088667,2605213183.0,9338,4323,3871,1187331712.0,1244767934.0,4138507,4329085,286.9,287.54,8467592,2432099647.0,8194,2023-11-07 14:25:00
469,MTLR,4857,1037,975185121.0,144850937.0,3390776,506047,287.6,286.24,3896823,1120036059.0,5894,4652,811,952671680.0,134204841.0,3319038,465469,287.03,288.32,3784507,1086876521.0,5463,2023-11-07 14:30:00
470,MTLR,2965,8709,459359589.0,2687239089.0,1599347,9345503,287.22,287.54,10944850,3146598678.0,11674,2700,8500,443137172.0,2669306686.0,1544460,9277388,286.92,287.72,10821848,3112443858.0,11200,2023-11-07 14:35:00
471,MTLR,4001,4380,873263704.0,1266731585.0,3043148,4411044,286.96,287.17,7454192,2139995289.0,8381,3721,4075,842363920.0,1214845128.0,2939147,4223182,286.6,287.66,7162329,2057209048.0,7796,2023-11-07 14:40:00
472,MTLR,6338,9627,1234866754.0,3487292277.0,4306385,12141930,286.75,287.21,16448315,4722159032.0,15965,6033,9352,1216875982.0,3469879513.0,4245688,12073750,286.61,287.39,16319438,4686755495.0,15385,2023-11-07 14:45:00
473,MTLR,5493,6874,1258722665.0,2115140582.0,4403620,7430087,285.84,284.67,11833707,3373863247.0,12367,4767,6370,1186496936.0,1997813138.0,4157336,6964821,285.4,286.84,11122157,3184310075.0,11137,2023-11-07 14:50:00
474,MTLR,16447,19790,4443257919.0,5042399549.0,15537165,17694423,285.98,284.97,33231588,9485657468.0,36237,15032,18753,4252561656.0,4920759938.0,14906523,17220967,285.28,285.74,32127490,9173321595.0,33785,2023-11-07 14:55:00
475,MTLR,10130,3352,2720569609.0,529947893.0,9486346,1854558,286.79,285.75,11340904,3250517502.0,13482,9580,2646,2609733876.0,469853131.0,9121299,1636220,286.11,287.16,10757519,3079587008.0,12226,2023-11-07 15:00:00
476,MTLR,5791,3292,1719715693.0,546519716.0,5995997,1909901,286.81,286.15,7905898,2266235409.0,9083,5339,2760,1685930418.0,507573053.0,5886718,1764871,286.4,287.6,7651589,2193503472.0,8099,2023-11-07 15:05:00
477,MTLR,5080,2766,1194232304.0,515674986.0,4170559,1803013,286.35,286.01,5973572,1709907290.0,7846,4575,2261,1144102890.0,472566717.0,3986816,1642166,286.97,287.77,5628982,1616669607.0,6836,2023-11-07 15:10:00
478,MTLR,9250,4174,2791064453.0,806920536.0,9678059,2812858,288.39,286.87,12490917,3597984989.0,13424,8791,3741,2741473934.0,768855576.0,9521510,2672602,287.92,287.68,12194112,3510329510.0,12532,2023-11-07 15:15:00
479,MTLR,1913,1327,242644740.0,164581816.0,822370,576052,295.06,285.71,1398422,407226557.0,3240,1638,1119,231778573.0,150353702.0,777569,521953,298.08,288.06,1299522,382132276.0,2757,2023-11-07 15:20:00
480,MTLR,4075,1833,1051241637.0,327547371.0,3644850,1143760,288.42,286.38,4788610,1378789008.0,5908,3765,1545,1023990999.0,310247908.0,3564796,1077147,287.25,288.03,4641943,1334238907.0,5310,2023-11-07 15:25:00
481,MTLR,5610,10365,963071779.0,3168373781.0,3332098,11012974,289.03,287.69,14345072,4131445560.0,15975,4973,9817,886020239.0,3125458913.0,3084102,10850761,287.29,288.04,13934863,4011479152.0,14790,2023-11-07 15:30:00
482,MTLR,11673,2393,2672457529.0,461719760.0,9210714,1604703,290.15,287.73,10815417,3134177289.0,14066,10926,1485,2551732959.0,412232926.0,8845701,1425702,288.47,289.14,10271403,2963965885.0,12411,2023-11-07 15:35:00
483,MTLR,5864,4978,1483955993.0,1393582224.0,5127182,4793724,289.43,290.71,9920906,2877538217.0,10842,4949,3828,1411319946.0,1266000947.0,4892261,4374244,288.48,289.42,9266505,2677320893.0,8777,2023-11-07 15:40:00
484,MTLR,3467,6808,603069211.0,2036324148.0,2093426,6971736,288.08,292.08,9065162,2639393360.0,10275,2792,6163,551717722.0,1992450635.0,1915061,6791643,288.09,293.37,8706704,2544168358.0,8955,2023-11-07 15:45:00
485,MTLR,9160,7048,2374095621.0,1347673411.0,8022217,4669470,295.94,288.61,12691687,3721769033.0,16208,6958,5782,2256715008.0,1253910623.0,7692938,4334129,293.35,289.31,12027067,3510625632.0,12740,2023-11-07 15:50:00
486,MTLR,5810,4082,1199069694.0,559487981.0,4136317,1781741,289.89,314.01,5918058,1758557676.0,9892,5147,3282,1154560304.0,486150661.0,3991564,1578894,289.25,307.91,5570458,1640710965.0,8429,2023-11-07 15:55:00
487,MTLR,3556,6206,662381986.0,1477558944.0,2287361,5035591,289.58,293.42,7322952,2139940931.0,9762,2959,5711,580943433.0,1474081140.0,2013917,4989307,288.46,295.45,7003224,2055024574.0,8670,2023-11-07 16:00:00
488,MTLR,3673,6689,653431026.0,1927710177.0,2258145,6683985,289.37,288.41,8942130,2581141204.0,10362,3012,5436,630633161.0,1859513214.0,2186134,6423285,288.47,289.5,8609419,2490146375.0,8448,2023-11-07 16:05:00
489,MTLR,11422,11488,2181288535.0,3098750831.0,7561637,10753162,288.47,288.17,18314799,5280039366.0,22910,10441,10399,2089477022.0,3023936766.0,7258195,10469948,287.88,288.82,17728143,5113413788.0,20840,2023-11-07 16:10:00
490,MTLR,12284,3648,2281172757.0,875541560.0,7923883,3042889,287.89,287.73,10966772,3156714317.0,15932,11813,3270,2252231166.0,843404537.0,7828082,2918742,287.71,288.96,10746824,3095635703.0,15083,2023-11-07 16:15:00
491,MTLR,3768,4607,671668431.0,1504641327.0,2328351,5218234,288.47,288.34,7546585,2176309758.0,8375,3364,4264,638720276.0,1477402049.0,2221297,5115299,287.54,288.82,7336596,2116122326.0,7628,2023-11-07 16:20:00
492,MTLR,2959,2358,539923117.0,417904082.0,1861091,1446253,290.11,288.96,3307344,957827200.0,5317,2524,1952,500932815.0,395704174.0,1740685,1367524,287.78,289.36,3108209,896636989.0,4476,2023-11-07 16:25:00
493,MTLR,2113,3154,353767591.0,601203509.0,1215436,2014702,291.06,298.41,3230138,954971100.0,5267,1711,2509,304664205.0,532828564.0,1056217,1836249,288.45,290.17,2892466,837492769.0,4220,2023-11-07 16:30:00
494,MTLR,2993,3258,620908874.0,771254264.0,2147862,2668789,289.08,288.99,4816651,1392163138.0,6251,2642,2881,603295526.0,747674555.0,2092146,2580423,288.36,289.75,4672569,1350970081.0,5523,2023-11-07 16:35:00
495,MTLR,5564,9133,1615078315.0,1709348202.0,5540983,5905464,291.48,289.45,11446447,3324426518.0,14697,4692,8382,1480280948.0,1666341150.0,5116824,5750359,289.3,289.78,10867183,3146622099.0,13074,2023-11-07 16:40:00
496,MTLR,6196,6984,1146366344.0,1622792388.0,3907303,5609316,293.39,289.3,9516619,2769158732.0,13180,5202,5940,1017562413.0,1541908585.0,3520152,5309525,289.07,290.4,8829677,2559470999.0,11142,2023-11-07 16:45:00
497,MTLR,7526,5653,1290012739.0,1344582902.0,4417192,4662658,292.04,288.37,9079850,2634595641.0,13179,6720,4806,1227654667.0,1277976612.0,4238741,4398675,289.63,290.54,8637416,2505631280.0,11526,2023-11-07 16:50:00
498,MTLR,5159,2714,744256366.0,497224986.0,2520453,1720874,295.29,288.94,4241327,1241481352.0,7873,4586,2090,708521096.0,460274826.0,2417542,1582086,293.07,290.93,3999628,1168795923.0,6676,2023-11-07 16:55:00
499,MTLR,11839,9284,2836252148.0,1904894264.0,9652541,6554236,293.83,290.64,16206777,4741146413.0,21123,10471,7558,2665128006.0,1767666108.0,9156651,6060082,291.06,291.69,15216733,4432794114.0,18029,2023-11-07 17:00:00
500,MTLR,15440,18074,3271169666.0,5062491981.0,11191471,17385265,292.29,291.19,28576736,8333661648.0,33514,13953,16569,3065717082.0,4873875726.0,10517273,16698883,291.49,291.87,27216156,7939592809.0,30522,2023-11-07 17:05:00
501,MTLR,11520,10624,2223942217.0,3211151838.0,7620256,11018651,291.85,291.43,18638907,5435094056.0,22144,10669,9816,2148246658.0,3087837336.0,7374930,10570258,291.29,292.13,17945188,5236083995.0,20485,2023-11-07 17:10:00
502,MTLR,5058,10397,923273255.0,2879133230.0,3157943,9871230,292.37,291.67,13029173,3802406486.0,15455,4307,9668,862992144.0,2832157534.0,2963690,9697142,291.19,292.06,12660832,3695149679.0,13975,2023-11-07 17:15:00
503,MTLR,5016,5834,1010253940.0,1173571914.0,3454437,3973047,292.45,295.38,7427484,2183825855.0,10850,4326,5081,918629572.0,1059143284.0,3151605,3618652,291.48,292.69,6770257,1977772857.0,9407,2023-11-07 17:20:00
504,MTLR,6901,3915,1780624058.0,576537188.0,6077361,1982256,292.99,290.85,8059617,2357161247.0,10816,6174,2966,1697784227.0,514731660.0,5812262,1757827,292.1,292.82,7570089,2212515888.0,9140,2023-11-07 17:25:00
505,MTLR,6807,9359,1730172419.0,2967075171.0,5911023,10174094,292.7,291.63,16085117,4697247591.0,16166,5981,8581,1651307117.0,2922254205.0,5659584,9928154,291.77,294.34,15587738,4573561322.0,14562,2023-11-07 17:30:00
506,MTLR,2925,2963,429138397.0,770434902.0,1463613,2642971,293.2,291.5,4106584,1199573300.0,5888,2485,2345,393735835.0,763058661.0,1349420,2604452,291.78,292.98,3953872,1156794497.0,4830,2023-11-07 17:35:00
507,MTLR,6198,13977,1088895172.0,3794618273.0,3725466,12903097,292.28,294.09,16628563,4883513445.0,20175,5447,13466,1019975273.0,3714943064.0,3498315,12714451,291.56,292.18,16212766,4734918337.0,18913,2023-11-07 17:40:00
508,MTLR,5131,5035,959374099.0,1419036215.0,3272775,4860103,293.14,291.98,8132878,2378410315.0,10166,4658,4590,912866186.0,1375214430.0,3127542,4700043,291.88,292.6,7827585,2288080616.0,9248,2023-11-07 17:45:00
509,MTLR,7939,3073,1919602976.0,494893553.0,6530292,1698219,293.95,291.42,8228511,2414496529.0,11012,7255,2403,1866617499.0,449997978.0,6389504,1534320,292.14,293.29,7923824,2316615477.0,9658,2023-11-07 17:50:00
510,MTLR,2278,1459,370452694.0,260917369.0,1259156,896840,294.21,290.93,2155996,631370064.0,3737,1799,1105,347191367.0,234520359.0,1189975,800390,291.76,293.01,1990365,581711727.0,2904,2023-11-07 17:55:00
511,MTLR,14216,12308,3316184644.0,3248822749.0,11237019,11037281,295.11,294.35,22274300,6565007394.0,26524,12614,10271,3089005406.0,3079424819.0,10546131,10476941,292.9,293.92,21023072,6168430225.0,22885,2023-11-07 18:00:00
512,MTLR,5595,3634,1209257675.0,661528638.0,4120707,2279202,293.46,290.25,6399909,1870786313.0,9229,4883,2930,1150546140.0,603140680.0,3926329,2004806,293.03,300.85,5931135,1753686820.0,7813,2023-11-07 18:05:00
513,MTLR,1929,3130,228780972.0,674606222.0,778054,2311242,294.04,291.88,3089296,903387194.0,5059,1305,2639,170028539.0,621934248.0,583600,2110957,291.34,294.62,2694557,791962787.0,3944,2023-11-07 18:10:00
514,MTLR,4471,2556,1049321417.0,515551636.0,3566953,1743838,294.18,295.64,5310791,1564873054.0,7027,3916,2133,1013698643.0,495948901.0,3460158,1681297,292.96,294.98,5141455,1509647544.0,6049,2023-11-07 18:15:00
515,MTLR,3031,4413,432759565.0,1127305960.0,1475484,3872344,293.3,291.12,5347828,1560065526.0,7444,2351,3897,377908879.0,1069916894.0,1295060,3650004,291.81,293.13,4945064,1447825773.0,6248,2023-11-07 18:20:00
516,MTLR,3056,7594,402722542.0,2721394015.0,1366640,9309106,294.68,292.34,10675746,3124116557.0,10650,2695,7289,356011063.0,2701617699.0,1219557,9219635,291.92,293.03,10439192,3057628762.0,9984,2023-11-07 18:25:00
517,MTLR,4427,5053,706214295.0,2068575589.0,2412594,7067276,292.72,292.7,9479870,2774789884.0,9480,4040,4789,681477206.0,2053500433.0,2331070,7008365,292.35,293.01,9339435,2734977640.0,8829,2023-11-07 18:30:00
518,MTLR,2856,2148,407755171.0,490912438.0,1369221,1668397,297.8,294.24,3037618,898667609.0,5004,2412,1550,371099392.0,466604736.0,1271192,1586178,291.93,294.17,2857370,837704128.0,3962,2023-11-07 18:35:00
519,MTLR,4036,3267,920146018.0,766393655.0,3130591,2568920,293.92,298.33,5699511,1686539674.0,7303,3727,2940,899182554.0,748303816.0,3071476,2507519,292.75,298.42,5578995,1647486371.0,6667,2023-11-07 18:40:00
520,MTLR,20571,11715,2950985963.0,1629933873.0,9966816,5372845,296.08,303.37,15339661,4580919836.0,32286,16031,7677,2405795912.0,1183068814.0,8165104,3911953,294.64,302.42,12077057,3588864727.0,23708,2023-11-08 10:05:00
521,MTLR,11801,10486,2106752319.0,2372875645.0,7081983,8040554,297.48,295.11,15122537,4479627964.0,22287,9480,8236,1887500607.0,2168350412.0,6397581,7313961,295.03,296.47,13711542,4055851020.0,17716,2023-11-08 10:10:00
522,MTLR,24341,17071,5380355279.0,3817428070.0,18107127,12920354,297.14,295.46,31027481,9197783350.0,41412,21764,14427,5014515557.0,3565594514.0,16964753,12033265,295.58,296.31,28998018,8580110071.0,36191,2023-11-08 10:15:00
523,MTLR,15721,10191,3069688388.0,2372040560.0,10408949,7676671,294.91,308.99,18085620,5441728948.0,25912,13506,7865,2722220996.0,2054402390.0,9170851,6764625,296.83,303.7,15935476,4776623387.0,21371,2023-11-08 10:20:00
524,MTLR,12145,13578,2508096318.0,3055747625.0,8420327,10240109,297.86,298.41,18660436,5563843943.0,25723,10666,12311,2330592834.0,2952601439.0,7858162,9676770,296.58,305.12,17534932,5283194273.0,22977,2023-11-08 10:25:00
525,MTLR,10503,12605,2197740953.0,3478321741.0,7505316,11574740,292.82,300.51,19080056,5676062695.0,23108,8852,11221,2051426700.0,3330447272.0,7048836,11068926,291.03,300.88,18117762,5381873972.0,20073,2023-11-08 10:30:00
526,MTLR,9419,8435,2003011885.0,2001557749.0,6709423,6662705,298.54,300.41,13372128,4004569634.0,17854,8070,6034,1815652034.0,1882798946.0,6118680,6255752,296.74,300.97,12374432,3698450980.0,14104,2023-11-08 10:35:00
527,MTLR,24700,16346,5646360336.0,3896519686.0,18738753,12594194,301.32,309.39,31332947,9542880023.0,41046,22092,12912,5205338417.0,3420920449.0,17401549,11142824,299.13,307.01,28544373,8626258866.0,35004,2023-11-08 10:40:00
528,MTLR,15604,12584,4577283901.0,2251225645.0,15247148,7256394,300.21,310.24,22503542,6828509546.0,28188,13744,9852,4349124194.0,2047425016.0,14548195,6599762,298.95,310.23,21147957,6396549211.0,23596,2023-11-08 10:45:00
529,MTLR,13691,7584,2812214013.0,1509912196.0,9368205,4703104,300.19,321.05,14071309,4322126209.0,21275,12065,5240,2617842443.0,1330464221.0,8750571,4071424,299.16,326.78,12821995,3948306665.0,17305,2023-11-08 10:50:00
530,MTLR,11880,17106,2195556526.0,4497426045.0,7309760,14818697,300.36,303.5,22128457,6692982572.0,28986,10103,15078,2060984135.0,4370978176.0,6889912,14350736,299.13,304.58,21240648,6431962312.0,25181,2023-11-08 10:55:00
531,MTLR,16411,15151,4213633082.0,3123584822.0,14040284,10471617,300.11,298.29,24511901,7337217904.0,31562,14806,12877,4027815410.0,2974119309.0,13467664,9939688,299.07,299.22,23407352,7001934720.0,27683,2023-11-08 11:00:00
532,MTLR,21398,5940,8012498309.0,1069330929.0,26780724,3540599,299.19,302.02,30321323,9081829238.0,27338,20354,5264,7929736063.0,996218938.0,26518373,3284129,299.03,303.34,29802502,8925955002.0,25618,2023-11-08 11:05:00
533,MTLR,10737,13483,2230797571.0,3194645459.0,7454776,10581726,299.24,301.9,18036502,5425443030.0,24220,8540,12243,2105545637.0,3066853658.0,7178130,10169544,293.33,301.57,17347674,5172399296.0,20783,2023-11-08 11:10:00
534,MTLR,8829,12462,1685871323.0,3650119057.0,5763549,12275368,292.51,297.35,18038917,5335990380.0,21291,7094,11541,1471431557.0,3528013343.0,4945768,11810674,297.51,298.71,16756442,4999444901.0,18635,2023-11-08 11:15:00
535,MTLR,7542,9642,1038157435.0,2698893381.0,3472971,9055255,298.92,298.05,12528226,3737050816.0,17184,6137,8864,967827723.0,2649814668.0,3251952,8879000,297.61,298.44,12130952,3617642391.0,15001,2023-11-08 11:20:00
536,MTLR,9736,8193,2158693644.0,2541132089.0,7216489,8517042,299.13,298.36,15733531,4699825734.0,17929,8579,7338,2102776218.0,2474076084.0,7057370,8283413,297.95,298.68,15340783,4576852303.0,15917,2023-11-08 11:25:00
537,MTLR,5181,3917,872301286.0,748009789.0,2911344,2507873,299.62,298.26,5419217,1620311075.0,9098,4155,3295,878511136.0,704195074.0,3060639,2355155,287.04,299.0,5415794,1582706210.0,7450,2023-11-08 11:30:00
538,MTLR,2811,3466,358405860.0,641166243.0,1200256,2122675,298.61,302.06,3322931,999572103.0,6277,2242,2900,350453892.0,604213654.0,1183686,1955259,296.07,309.02,3138945,954667546.0,5142,2023-11-08 11:35:00
539,MTLR,7438,8713,1685593004.0,2288831487.0,5648644,7656285,298.41,298.95,13304929,3974424491.0,16151,6642,7945,1625487309.0,2200156198.0,5467016,7337211,297.33,299.86,12804227,3825643507.0,14587,2023-11-08 11:40:00
540,MTLR,10634,8502,2844753635.0,1651224162.0,9515247,5534968,298.97,298.33,15050215,4495977797.0,19136,10155,7913,2803668984.0,1605587652.0,9397512,5371225,298.34,298.92,14768737,4409256637.0,18068,2023-11-08 11:45:00
541,MTLR,4183,7904,1076192821.0,1810931129.0,3601501,6072466,298.82,298.22,9673967,2887123951.0,12087,3659,7383,1034269688.0,1771391164.0,3469516,5927515,298.1,298.84,9397031,2805660852.0,11042,2023-11-08 11:50:00
542,MTLR,6937,6834,2232206215.0,1396559213.0,7479995,4664313,298.42,299.41,12144308,3628765428.0,13771,6045,6268,2154395579.0,1282136958.0,7227555,4294455,298.08,298.56,11522010,3436532538.0,12313,2023-11-08 11:55:00
543,MTLR,9748,5503,2754583614.0,1181381763.0,9235650,3971197,298.26,297.49,13206847,3935965378.0,15251,9095,4918,2716234317.0,1167613746.0,9117065,3911345,297.93,298.52,13028410,3883848063.0,14013,2023-11-08 12:00:00
544,MTLR,21706,2894,3790518346.0,489996387.0,12711876,1644153,298.19,298.02,14356029,4280514733.0,24600,21185,2314,3769649943.0,490687118.0,12650264,1637682,297.99,299.62,14287946,4260337061.0,23499,2023-11-08 12:05:00
545,MTLR,1835,3174,316174321.0,952934498.0,1043361,3203638,303.03,297.45,4246999,1269108820.0,5009,1456,2763,277075480.0,918748173.0,932020,3078964,297.28,298.4,4010984,1195823654.0,4219,2023-11-08 12:10:00
546,MTLR,2619,1579,437417000.0,210330473.0,1463136,705686,298.96,298.05,2168822,647747474.0,4198,2347,1164,411765914.0,172847041.0,1382383,578451,297.87,298.81,1960834,584612956.0,3511,2023-11-08 12:15:00
547,MTLR,8269,6002,1745553020.0,1755366072.0,5816899,5876588,300.08,298.7,11693487,3500919092.0,14271,7259,5080,1600650341.0,1689147982.0,5361934,5642162,298.52,299.38,11004096,3289798323.0,12339,2023-11-08 12:20:00
548,MTLR,2448,2920,358899246.0,591052575.0,1186248,1978272,302.55,298.77,3164520,949951822.0,5368,2000,2288,328736725.0,554675700.0,1102115,1851096,298.28,299.65,2953211,883412426.0,4288,2023-11-08 12:25:00
549,MTLR,5608,4684,1284312785.0,899070732.0,4298039,3022036,298.81,297.5,7320075,2183383517.0,10292,5094,4251,1239086571.0,865149301.0,4156411,2890425,298.11,299.32,7046836,2104235873.0,9345,2023-11-08 12:30:00
550,MTLR,5542,5147,1237490096.0,1327971309.0,4142417,4460599,298.74,297.71,8603016,2565461405.0,10689,5001,4662,1197957323.0,1265174417.0,4021642,4234918,297.88,298.75,8256560,2463131740.0,9663,2023-11-08 12:35:00
551,MTLR,2986,6096,464941362.0,1815110753.0,1513768,6098458,307.14,297.63,7612226,2280052116.0,9082,2294,5552,364011205.0,1720597657.0,1225469,5767482,297.04,298.33,6992951,2084608863.0,7846,2023-11-08 12:40:00
552,MTLR,2884,4065,462793028.0,772736488.0,1549865,2591420,298.6,298.19,4141285,1235529517.0,6949,2491,3336,437287696.0,726249818.0,1468097,2432853,297.86,298.52,3900950,1163537514.0,5827,2023-11-08 12:45:00
553,MTLR,2989,4122,481219884.0,880927105.0,1611983,2958735,298.53,297.74,4570718,1362146989.0,7111,2491,3682,445211492.0,863314726.0,1497201,2890336,297.36,298.69,4387537,1308526219.0,6173,2023-11-08 12:50:00
554,MTLR,3460,2109,1035574619.0,210247358.0,3472318,707812,298.24,297.04,4180130,1245821977.0,5569,3041,1778,1017619268.0,189206265.0,3415996,633212,297.9,298.8,4049208,1206825533.0,4819,2023-11-08 12:55:00
555,MTLR,24413,8611,5582736479.0,1416136226.0,18672792,4741069,298.98,298.7,23413861,6998872705.0,33024,23220,7668,5447744620.0,1352848858.0,18282990,4518852,297.97,299.38,22801842,6800593479.0,30888,2023-11-08 13:00:00
556,MTLR,9192,5465,2210873879.0,944629337.0,7374712,3158397,299.79,299.09,10533109,3155503217.0,14657,8127,4773,2147380981.0,880274723.0,7194745,2937412,298.47,299.68,10132157,3027655705.0,12900,2023-11-08 13:05:00
557,MTLR,7005,5641,1864336686.0,1285230181.0,6216910,4296872,299.88,299.11,10513782,3149566868.0,12646,6387,5078,1800983782.0,1243821308.0,6028009,4155192,298.77,299.34,10183201,3044805090.0,11465,2023-11-08 13:10:00
558,MTLR,7267,3944,2259794394.0,742884625.0,7557455,2490894,299.02,298.24,10048349,3002679020.0,11211,6758,3317,2272344389.0,697701235.0,7617554,2329657,298.3,299.49,9947211,2970045625.0,10075,2023-11-08 13:15:00
559,MTLR,3673,2964,577878616.0,618774483.0,1921010,2085502,300.82,296.7,4006512,1196653100.0,6637,3151,2579,533122838.0,589675819.0,1789276,1971393,297.95,299.12,3760669,1122798658.0,5730,2023-11-08 13:20:00
560,MTLR,2651,2255,475011283.0,323067310.0,1564746,1079130,303.57,299.38,2643876,798078594.0,4906,2369,1727,453266816.0,294021706.0,1519932,981299,298.22,299.62,2501231,747288522.0,4096,2023-11-08 13:25:00
561,MTLR,3252,1891,767096343.0,234606300.0,2546430,784710,301.24,298.97,3331140,1001702644.0,5143,2586,1378,648799092.0,191675143.0,2189490,638585,296.32,300.16,2828075,840474236.0,3964,2023-11-08 13:30:00
562,MTLR,15708,12088,3620685412.0,2808010108.0,11770458,9266471,307.61,303.03,21036929,6428695520.0,27796,12832,8249,3033907922.0,2368045521.0,10058346,7848556,301.63,301.72,17906902,5401953444.0,21081,2023-11-08 13:35:00
563,MTLR,8753,8622,2183005767.0,1698795220.0,7212016,5696495,302.69,298.22,12908511,3881800988.0,17375,7184,6976,2009386674.0,1476725013.0,6685352,4904025,300.57,301.13,11589377,3486111688.0,14160,2023-11-08 13:40:00
564,MTLR,15184,11931,3487276540.0,2771062275.0,11555606,9217088,301.78,300.64,20772694,6258338816.0,27115,13573,10390,3250388268.0,2607327186.0,10771855,8651012,301.75,301.39,19422867,5857715454.0,23963,2023-11-08 13:45:00
565,MTLR,5629,6158,1188184359.0,1536910357.0,3778305,5130640,314.48,299.56,8908945,2725094717.0,11787,4699,4865,1054152460.0,1406622439.0,3506983,4668052,300.59,301.33,8175035,2460774899.0,9564,2023-11-08 13:50:00
566,MTLR,10830,6286,2658256627.0,1218588233.0,8742442,3862419,304.06,315.5,12604861,3876844860.0,17116,9859,4968,2570748034.0,1085270628.0,8519890,3600848,301.73,301.39,12120738,3656018662.0,14827,2023-11-08 13:55:00
567,MTLR,7919,6956,1712521136.0,1433641219.0,5483763,4776315,312.29,300.16,10260078,3146162355.0,14875,5687,4218,1312091266.0,1179519008.0,4301709,3886491,305.02,303.49,8188200,2491610274.0,9905,2023-11-08 14:00:00
568,MTLR,3400,5547,500789482.0,1633381394.0,1620584,5412548,309.02,301.78,7033132,2134170877.0,8947,1874,4196,374040283.0,1469303926.0,1233529,4845550,303.23,303.23,6079079,1843344209.0,6070,2023-11-08 14:05:00
569,MTLR,8838,12914,2596349200.0,3065341701.0,8543896,10156316,303.88,301.82,18700212,5661690902.0,21752,7515,11627,2449451280.0,2851115281.0,8100211,9406930,302.39,303.09,17507141,5300566561.0,19142,2023-11-08 14:10:00
570,MTLR,7290,4180,1821849899.0,662710412.0,5950859,2204752,306.15,300.58,8155611,2484560312.0,11470,6179,2939,1682789077.0,554463964.0,5558691,1823547,302.73,304.06,7382238,2237253042.0,9118,2023-11-08 14:15:00
571,MTLR,7338,10510,1689113931.0,2227449956.0,5566250,7450054,303.46,298.98,13016304,3916563888.0,17848,5646,9313,1544312905.0,2043033149.0,5112133,6742820,302.09,302.99,11854953,3587346054.0,14959,2023-11-08 14:20:00
572,MTLR,8144,7781,1824489342.0,1644618647.0,6040084,5483181,302.06,299.94,11523265,3469107990.0,15925,6524,6712,1675858363.0,1530852425.0,5565903,5066551,301.09,302.15,10632454,3206710789.0,13236,2023-11-08 14:25:00
573,MTLR,4543,2468,962136824.0,495284988.0,3177693,1644911,302.78,301.1,4822604,1457421813.0,7011,3875,1893,899124651.0,443082550.0,2983350,1463774,301.38,302.7,4447124,1342207202.0,5768,2023-11-08 14:30:00
574,MTLR,5483,12097,1150844499.0,3062275044.0,3816850,10202239,301.52,300.16,14019089,4213119543.0,17580,4231,11281,1056770303.0,2994054527.0,3516715,9917075,300.5,301.91,13433790,4050824830.0,15512,2023-11-08 14:35:00
575,MTLR,8648,7490,1549547956.0,1738299666.0,5133736,5799075,301.84,299.75,10932811,3287847622.0,16138,7640,6629,1490475604.0,1672284544.0,4958478,5552038,300.59,301.2,10510516,3162760148.0,14269,2023-11-08 14:40:00
576,MTLR,4850,6454,911265685.0,2540917642.0,3018842,8456063,301.86,300.48,11474905,3452183327.0,11304,4003,5692,827059953.0,2504402399.0,2756439,8305110,300.05,301.55,11061549,3331462353.0,9695,2023-11-08 14:45:00
577,MTLR,7330,8601,1437205192.0,1833895431.0,4778831,6118623,300.74,299.72,10897454,3271100623.0,15931,6002,7962,1336624409.0,1734132741.0,4453968,5758438,300.1,301.15,10212406,3070757150.0,13964,2023-11-08 14:50:00
578,MTLR,10627,12867,2352561480.0,2871829567.0,7839093,9717628,300.11,295.53,17556721,5224391047.0,23494,7791,10933,2027611874.0,2544362135.0,6795547,8481307,298.37,300.0,15276854,4571974010.0,18724,2023-11-08 14:55:00
579,MTLR,23399,24324,5321341336.0,6873436880.0,17781325,23126092,299.27,297.22,40907417,12194778217.0,47723,20465,22172,4865059901.0,6504546066.0,16331074,21782469,297.9,298.61,38113543,11369605968.0,42637,2023-11-08 15:00:00
580,MTLR,8931,7194,1823888951.0,1703801704.0,6082609,5714944,299.85,298.13,11797553,3527690656.0,16125,7610,6136,1694449568.0,1588853551.0,5688748,5315642,297.86,298.9,11004390,3283303119.0,13746,2023-11-08 15:05:00
581,MTLR,7814,3845,1593144304.0,727771227.0,5320909,2445254,299.41,297.63,7766163,2320915532.0,11659,6926,3293,1521089047.0,682939845.0,5101469,2283404,298.17,299.09,7384873,2204028893.0,10219,2023-11-08 15:10:00
582,MTLR,10581,8831,2650961611.0,2195401863.0,8818804,7344075,300.6,298.94,16162879,4846363475.0,19412,9739,7837,2499320983.0,2110788796.0,8362444,7046497,298.87,299.55,15408941,4610109780.0,17576,2023-11-08 15:15:00
583,MTLR,5683,5064,1294791678.0,969177000.0,4282536,3240802,302.34,299.05,7523338,2263968678.0,10747,4942,4315,1207455672.0,907864060.0,4022837,3024531,300.15,300.17,7047368,2115319733.0,9257,2023-11-08 15:20:00
584,MTLR,16096,11214,4495384294.0,1949602558.0,14851562,6500633,302.69,299.91,21352195,6444986853.0,27310,14878,9112,4265295894.0,1769791620.0,14194342,5871777,300.49,301.41,20066119,6035087515.0,23990,2023-11-08 15:25:00
585,MTLR,3702,13363,808317172.0,2876318165.0,2676663,9598263,301.99,299.67,12274926,3684635337.0,17065,3026,12558,730123452.0,2761364790.0,2419345,9173275,301.79,301.02,11592620,3491488242.0,15584,2023-11-08 15:30:00
586,MTLR,4297,3824,1267114407.0,536198831.0,4186558,1787811,302.66,299.92,5974369,1803313239.0,8121,3695,3133,1216767217.0,510850099.0,4048872,1696167,300.52,301.18,5745039,1727617316.0,6828,2023-11-08 15:35:00
587,MTLR,6054,4272,1440821764.0,548526359.0,4779790,1830955,301.44,299.58,6610745,1989348123.0,10326,5005,3804,1379799916.0,496897023.0,4589146,1649239,300.67,301.29,6238385,1876696940.0,8809,2023-11-08 15:40:00
588,MTLR,3930,3253,1691624465.0,421897038.0,5619689,1407078,301.02,299.84,7026767,2113521503.0,7183,3333,2863,1663515228.0,373206167.0,5533773,1239557,300.61,301.08,6773330,2036721396.0,6196,2023-11-08 15:45:00
589,MTLR,6405,9080,2450675702.0,1644081812.0,8169502,5513988,299.98,298.17,13683490,4094757514.0,15485,5464,8528,2373758976.0,1592618490.0,7923873,5300308,299.57,300.48,13224181,3966377467.0,13992,2023-11-08 15:50:00
590,MTLR,7652,3707,2105020652.0,549545848.0,6978777,1827461,301.63,300.72,8806238,2654566500.0,11359,7002,2862,2025389421.0,511771425.0,6734938,1697537,300.73,301.48,8432475,2537160846.0,9864,2023-11-08 15:55:00
591,MTLR,4158,6161,772374028.0,1469574268.0,2548848,4908311,303.03,299.41,7457159,2241948296.0,10319,3302,5304,685931613.0,1365659648.0,2282575,4528843,300.51,301.55,6811418,2051591262.0,8606,2023-11-08 16:00:00
592,MTLR,9217,4419,2826647659.0,765538013.0,9458848,2540054,298.84,301.39,11998902,3592185672.0,13636,8804,3945,2741284678.0,740471475.0,9111702,2454387,300.85,301.69,11566089,3481756154.0,12749,2023-11-08 16:05:00
593,MTLR,8332,6563,1768413187.0,1429569857.0,5823665,4731665,303.66,302.13,10555330,3197983045.0,14895,7365,5336,1657617256.0,1312731459.0,5484939,4341402,302.21,302.38,9826341,2970348715.0,12701,2023-11-08 16:10:00
594,MTLR,8656,6554,1720606440.0,1814211585.0,5678727,6018070,302.99,301.46,11696797,3534818025.0,15210,7998,5834,1650066379.0,1750056711.0,5470915,5793421,301.61,302.08,11264336,3400123091.0,13832,2023-11-08 16:15:00
595,MTLR,4788,4564,929491099.0,1237362502.0,3066081,4106649,303.15,301.31,7172730,2166853602.0,9352,4262,3851,895753368.0,1183814355.0,2959968,3919146,302.62,302.06,6879114,2079567724.0,8113,2023-11-08 16:20:00
596,MTLR,9140,13418,1407008227.0,4441783094.0,4680129,14747439,300.63,301.19,19427568,5848791321.0,22558,8309,12903,1356277835.0,4406078132.0,4514922,14616075,300.4,301.45,19130997,5762355967.0,21212,2023-11-08 16:25:00
597,MTLR,7788,5535,2000236921.0,2133645823.0,6639172,7087568,301.28,301.04,13726740,4133882745.0,13323,7401,5158,1991834884.0,2112455846.0,6698141,6996111,297.37,301.95,13694252,4104290730.0,12559,2023-11-08 16:30:00
598,MTLR,19210,7806,5412163244.0,1519670083.0,17925020,5031853,301.93,302.01,22956873,6931833328.0,27016,18684,7116,5337232811.0,1465005229.0,17699370,4845395,301.55,302.35,22544765,6802238040.0,25800,2023-11-08 16:35:00
599,MTLR,9504,10283,1703814967.0,3131927258.0,5647513,10397323,301.69,301.22,16044836,4835742225.0,19787,8982,9793,1671283701.0,3064005071.0,5550648,10155625,301.1,301.71,15706273,4735288772.0,18775,2023-11-08 16:40:00
600,MTLR,12322,13753,2646321185.0,3133395738.0,8779648,10384292,301.42,301.74,19163940,5779716923.0,26075,11995,13393,2607806011.0,3123580873.0,8653273,10349319,301.37,301.82,19002592,5731386885.0,25388,2023-11-08 16:45:00
601,MTLR,7255,3836,2223686042.0,850156735.0,7351551,2814854,302.48,302.03,10166405,3073842778.0,11091,6841,3394,2156629521.0,809814532.0,7149887,2678111,301.63,302.38,9827998,2966444053.0,10235,2023-11-08 16:50:00
602,MTLR,11568,5910,3323643409.0,1334091720.0,10972475,4418624,302.91,301.92,15391099,4657735129.0,17478,10822,5044,3236947652.0,1271093351.0,10716470,4199591,302.05,302.67,14916061,4508041003.0,15866,2023-11-08 16:55:00
603,MTLR,2958,4903,569855946.0,1197426537.0,1887986,3982782,301.83,300.65,5870768,1767282484.0,7861,2252,4336,533358871.0,1125190862.0,1774391,3728488,300.59,301.78,5502879,1658549734.0,6588,2023-11-08 17:00:00
604,MTLR,11583,3531,3131608661.0,874125845.0,10442294,2903298,299.9,301.08,13345592,4005734506.0,15114,11087,3113,3063731873.0,842554330.0,10173616,2789717,301.14,302.02,12963333,3906286204.0,14200,2023-11-08 17:05:00
605,MTLR,8451,6052,1496339257.0,2076258552.0,4973047,6913425,300.89,300.32,11886472,3572597809.0,14503,7903,5673,1433058627.0,2046443221.0,4766328,6788765,300.66,301.45,11555093,3479501849.0,13576,2023-11-08 17:10:00
606,MTLR,2082,2457,293260656.0,818938717.0,963359,2720712,304.41,301.0,3684071,1112199374.0,4539,1553,1964,255384769.0,790307239.0,850768,2625519,300.18,301.01,3476287,1045692009.0,3517,2023-11-08 17:15:00
607,MTLR,7329,1546,1505764005.0,387824089.0,5009048,1287338,300.61,301.26,6296386,1893588094.0,8875,7035,1174,1483248969.0,350998221.0,4927981,1162873,300.99,301.84,6090854,1834247191.0,8209,2023-11-08 17:20:00
608,MTLR,4477,1705,1121096097.0,214561144.0,3720930,717448,301.29,299.06,4438378,1335657241.0,6182,4185,1478,1096246595.0,201462637.0,3643515,667839,300.88,301.66,4311354,1297709233.0,5663,2023-11-08 17:25:00
609,MTLR,2596,5810,484521823.0,2185479955.0,1608497,7275514,301.23,300.39,8884011,2670001778.0,8406,2120,5468,453843412.0,2162882874.0,1511826,7184228,300.2,301.06,8696054,2616726286.0,7588,2023-11-08 17:30:00
610,MTLR,2340,3426,518881197.0,1195243316.0,1717632,3970439,302.09,301.04,5688071,1714124513.0,5766,2055,3157,500724870.0,1209917476.0,1666159,4017029,300.53,301.2,5683188,1710642346.0,5212,2023-11-08 17:35:00
611,MTLR,4560,10952,894364938.0,3778333541.0,2957269,12557879,302.43,300.87,15515148,4672698480.0,15512,4110,10631,872098556.0,3742243307.0,2901904,12431137,300.53,301.04,15333041,4614341863.0,14741,2023-11-08 17:40:00
612,MTLR,3953,8667,712693124.0,3201739026.0,2355984,10637014,302.5,301.0,12992998,3914432150.0,12620,3613,8295,669194245.0,3181214679.0,2225735,10562960,300.66,301.17,12788695,3850408924.0,11908,2023-11-08 17:45:00
613,MTLR,1109,1208,115340695.0,247629459.0,381043,826462,302.7,299.63,1207505,362970154.0,2317,767,890,111739607.0,230570743.0,372038,764330,300.34,301.66,1136368,342310351.0,1657,2023-11-08 17:50:00
614,MTLR,1377,653,249668583.0,204544737.0,816137,685933,305.92,298.2,1502070,454213320.0,2030,1156,526,237829930.0,200455804.0,784090,665090,303.32,301.4,1449180,438285734.0,1682,2023-11-08 17:55:00
615,MTLR,860,2403,111194681.0,571333720.0,368940,1928111,301.39,296.32,2297051,682528402.0,3263,573,2224,101380102.0,563658887.0,321587,1872281,315.25,301.05,2193868,665038990.0,2797,2023-11-08 18:00:00
616,MTLR,1346,13942,167621258.0,3794480615.0,557321,12626145,300.76,300.53,13183466,3962101873.0,15288,849,13693,124060196.0,3769917247.0,413878,12519008,299.75,301.14,12932886,3893977443.0,14542,2023-11-08 18:05:00
617,MTLR,6575,11766,1708229345.0,2496863696.0,5670112,8325406,301.27,299.91,13995518,4205093042.0,18341,5680,11304,1635477778.0,2395586149.0,5455824,7971573,299.77,300.52,13427397,4031063927.0,16984,2023-11-08 18:10:00
618,MTLR,1063,1014,158674360.0,170877133.0,518102,582698,306.26,293.25,1100800,329551493.0,2077,697,767,142520162.0,138360661.0,475947,460781,299.45,300.27,936728,280880823.0,1464,2023-11-08 18:15:00
619,MTLR,6363,5550,1507542422.0,1177244865.0,5014939,3929388,300.61,299.6,8944327,2684787287.0,11913,5908,5255,1431627464.0,1162576721.0,4773277,3869957,299.93,300.41,8643234,2594204185.0,11163,2023-11-08 18:20:00
620,MTLR,2013,3276,375965536.0,871462677.0,1239541,2869579,303.31,303.69,4109120,1247428213.0,5289,1640,2988,371411818.0,836832252.0,1234869,2783686,300.77,300.62,4018555,1208244071.0,4628,2023-11-08 18:25:00
621,MTLR,4594,3769,1245073669.0,969044959.0,4126668,3230489,301.71,299.97,7357157,2214118628.0,8363,4240,3486,1230085493.0,940818572.0,4072095,3131346,302.08,300.45,7203441,2170904066.0,7726,2023-11-08 18:30:00
622,MTLR,3565,1611,1150188058.0,251352184.0,3813251,837826,301.63,300.01,4651077,1401540243.0,5176,3145,1289,1101708762.0,223743516.0,3663424,743630,300.73,300.88,4407054,1325452278.0,4434,2023-11-08 18:35:00
623,MTLR,2690,1257,678764180.0,179500870.0,2213933,598138,306.59,300.1,2812071,858265050.0,3947,2209,958,659666081.0,158146198.0,2153801,525308,306.28,301.05,2679109,817812280.0,3167,2023-11-08 18:40:00
624,MTLR,22291,19511,3836518175.0,3471052665.0,12668115,10531779,302.85,329.58,23199894,7307570841.0,41802,16976,15889,3200622952.0,2888098379.0,10573014,8841249,302.72,326.66,19414263,6088721331.0,32865,2023-11-09 10:05:00
625,MTLR,13726,14506,2512897659.0,4307780992.0,8241501,14110049,304.91,305.3,22351550,6820678652.0,28232,10223,12112,2077916433.0,3970674344.0,6903711,12740764,300.99,311.65,19644475,6048590777.0,22335,2023-11-09 10:10:00
626,MTLR,17809,38610,3804853595.0,11504677379.0,12676599,38555070,300.15,298.4,51231669,15309530975.0,56419,13472,35575,3280006408.0,10996578894.0,10977904,36711035,298.78,299.54,47688939,14276585303.0,49047,2023-11-09 10:15:00
627,MTLR,15552,15684,3346877458.0,4320275844.0,11186647,14342058,299.19,301.23,25528705,7667153303.0,31236,12639,13695,3013815140.0,3891049474.0,10128428,13010739,297.56,299.06,23139167,6904864615.0,26334,2023-11-09 10:20:00
628,MTLR,26681,14111,6403728849.0,4098721691.0,21348696,13758658,299.96,297.9,35107354,10502450540.0,40792,22631,11444,5852612380.0,3604750915.0,19708156,12058693,296.96,298.93,31766849,9457363295.0,34075,2023-11-09 10:25:00
629,MTLR,10574,6053,3684356321.0,1095337575.0,12315588,3652691,299.16,299.87,15968279,4779693896.0,16627,8811,4020,3470659714.0,908551357.0,11647409,3010648,297.98,301.78,14658057,4379211072.0,12831,2023-11-09 10:30:00
630,MTLR,15725,12533,5290119258.0,2683283988.0,17713615,9016070,298.65,297.61,26729685,7973403246.0,28258,14266,11327,5153270025.0,2580708141.0,17281057,8636163,298.2,298.83,25917220,7733978167.0,25593,2023-11-09 10:35:00
631,MTLR,20298,7206,4909415993.0,2565295368.0,16474333,8602822,298.0,298.19,25077155,7474711362.0,27504,19382,6539,4829039374.0,2521494076.0,16220649,8439115,297.71,298.79,24659764,7350533451.0,25921,2023-11-09 10:40:00
632,MTLR,10214,7673,3062864752.0,2463778926.0,10235972,8261283,299.23,298.23,18497255,5526643678.0,17887,9394,6891,2964014692.0,2373087931.0,9938106,7945013,298.25,298.69,17883119,5337102624.0,16285,2023-11-09 10:45:00
633,MTLR,2662,7329,412259028.0,2525439400.0,1329449,8489747,310.1,297.47,9819196,2937698428.0,9991,1835,6678,339923758.0,2442397591.0,1093005,8190858,311.0,298.19,9283863,2782321350.0,8513,2023-11-09 10:50:00
634,MTLR,7925,6829,1578192982.0,2484047902.0,5291510,8358614,298.25,297.18,13650124,4062240884.0,14754,7091,5971,1508617361.0,2418150112.0,5055854,8113727,298.39,298.03,13169581,3926767474.0,13062,2023-11-09 10:55:00
635,MTLR,14192,24078,2733984907.0,7282538147.0,9214355,24679484,296.71,295.08,33893839,10016523054.0,38270,11584,22530,2495823342.0,7037693147.0,8440004,23668990,295.71,297.34,32108994,9533516490.0,34114,2023-11-09 11:00:00
636,MTLR,12197,8248,2461380090.0,2302902775.0,8280633,7792260,297.25,295.54,16072893,4764282866.0,20445,10541,7058,2315891601.0,2192189285.0,7830464,7398204,295.75,296.31,15228668,4508080887.0,17599,2023-11-09 11:05:00
637,MTLR,14780,7873,3374641950.0,2076791098.0,11520140,7029576,292.93,295.44,18549716,5451433049.0,22653,13798,7115,3149941332.0,1997349877.0,10661722,6743979,295.44,296.17,17405701,5147291210.0,20913,2023-11-09 11:10:00
638,MTLR,16035,16298,2814733286.0,4780447264.0,9506207,16061425,296.09,297.64,25567632,7595180550.0,32333,13508,14724,2622818236.0,4221594823.0,9014823,14296426,290.95,295.29,23311249,6844413060.0,28232,2023-11-09 11:15:00
639,MTLR,14462,14830,2477946286.0,4087743575.0,8380724,13882741,295.67,294.45,22263465,6565689862.0,29292,11762,13190,2244057563.0,4110518075.0,7647338,13683569,293.44,300.4,21330907,6354575639.0,24952,2023-11-09 11:20:00
640,MTLR,13993,16943,3480351685.0,3813088445.0,11840158,13038813,293.94,292.44,24878971,7293440130.0,30936,11209,15294,3228899664.0,3561128345.0,11027368,12118427,292.81,293.86,23145795,6790028009.0,26503,2023-11-09 11:25:00
641,MTLR,12836,13794,2828713872.0,3496364020.0,9578015,11977819,295.33,291.9,21555834,6325077893.0,26630,10794,12341,2602897417.0,3323400405.0,8856922,11321629,293.88,293.54,20178551,5926297823.0,23135,2023-11-09 11:30:00
642,MTLR,9295,20614,1875758569.0,4886634496.0,6372232,16797250,294.36,290.92,23169482,6762393065.0,29909,6569,19088,1652091276.0,4705071220.0,5674615,16089487,291.14,292.43,21764102,6357162496.0,25657,2023-11-09 11:35:00
643,MTLR,13137,7061,2931468552.0,1328004503.0,9914032,4548509,295.69,291.96,14462541,4259473055.0,20198,11462,5508,2717942420.0,1155045057.0,9300291,3930053,292.24,293.9,13230344,3872987477.0,16970,2023-11-09 11:40:00
644,MTLR,17676,14746,5034582336.0,2924873370.0,17141189,9991029,293.71,292.75,27132218,7959455706.0,32422,16524,13621,4878903307.0,2812124204.0,16661284,9581599,292.83,293.49,26242883,7691027511.0,30145,2023-11-09 11:45:00
645,MTLR,7118,9043,1745094287.0,2251579493.0,5948080,7700944,293.39,292.38,13649024,3996673780.0,16161,6389,8447,1669422482.0,2209222126.0,5700967,7526831,292.83,293.51,13227798,3878644608.0,14836,2023-11-09 11:50:00
646,MTLR,19197,11854,5083100929.0,2280981293.0,17080352,7762003,297.6,293.87,24842355,7364082223.0,31051,17810,9839,4804559185.0,2093045637.0,16275047,7098314,295.21,294.87,23373361,6897604822.0,27649,2023-11-09 11:55:00
647,MTLR,20249,13736,4861363241.0,2795664542.0,16375900,9462533,296.86,295.45,25838433,7657027783.0,33985,18846,11976,4637364294.0,2593931531.0,15715957,8728327,295.07,297.19,24444284,7231295825.0,30822,2023-11-09 12:00:00
648,MTLR,14203,19058,2965804268.0,4802930052.0,10061442,16344874,294.77,293.85,26406316,7768734321.0,33261,12969,18195,2807767649.0,4682494499.0,9547864,15882854,294.07,294.81,25430718,7490262148.0,31164,2023-11-09 12:05:00
649,MTLR,9162,4869,1531935007.0,1130010147.0,5172358,3816144,296.18,296.11,8988502,2661945155.0,14031,8466,3834,1449534824.0,1068916103.0,4922706,3610546,294.46,296.05,8533252,2518450928.0,12300,2023-11-09 12:10:00
650,MTLR,11577,6227,2658439581.0,1125019466.0,8926358,3816756,297.82,294.76,12743114,3783459048.0,17804,10637,4908,2518838639.0,1000656979.0,8520393,3376850,295.62,296.33,11897243,3519495619.0,15545,2023-11-09 12:15:00
651,MTLR,6359,5809,1277546846.0,1415890635.0,4284541,4799692,298.18,295.0,9084233,2693437482.0,12168,5395,4918,1133292434.0,1324482497.0,3837069,4465929,295.35,296.57,8302998,2457774932.0,10313,2023-11-09 12:20:00
652,MTLR,6708,12171,1520599793.0,2858673094.0,5082098,9670493,299.21,295.61,14752591,4379272887.0,18879,5488,10847,1328450227.0,2609407884.0,4484957,8782655,296.2,297.11,13267612,3937858112.0,16335,2023-11-09 12:25:00
653,MTLR,11107,18798,2214788567.0,5523642274.0,7445570,18659174,297.46,296.03,26104744,7738430841.0,29905,9987,17985,2065525686.0,5422808218.0,6978653,18287592,295.98,296.53,25266245,7488333905.0,27972,2023-11-09 12:30:00
654,MTLR,6457,7904,1171463106.0,2010871993.0,3941079,6810034,297.24,295.28,10751113,3182335100.0,14361,5855,7228,1111993829.0,1956350460.0,3759197,6600368,295.81,296.4,10359565,3068344289.0,13083,2023-11-09 12:35:00
655,MTLR,6739,4723,1351336195.0,935243316.0,4527381,3162259,298.48,295.75,7689640,2286579512.0,11462,5918,3168,1235173359.0,857660138.0,4164148,2880382,296.62,297.76,7044530,2092833498.0,9086,2023-11-09 12:40:00
656,MTLR,9225,5965,2247061978.0,989949028.0,7574140,3345517,296.68,295.9,10919657,3237011006.0,15190,8571,5258,2195604254.0,918288990.0,7410884,3092890,296.27,296.9,10503774,3113893244.0,13829,2023-11-09 12:45:00
657,MTLR,18193,20839,5552403252.0,4425987204.0,18785130,14866724,295.57,297.71,33651854,9978390457.0,39032,16781,19201,5160913526.0,4257559433.0,17396253,14268424,296.67,298.39,31664677,9418472959.0,35982,2023-11-09 12:50:00
658,MTLR,11217,6446,3063794943.0,1235840865.0,10088414,4160691,303.69,297.03,14249105,4299635808.0,17663,10186,5001,2892438446.0,1072523097.0,9597284,3586503,301.38,299.04,13183787,3964961543.0,15187,2023-11-09 12:55:00
659,MTLR,16049,14083,3562678717.0,2921318074.0,11842063,9774479,300.85,298.87,21616542,6483996792.0,30132,14571,12220,3319807621.0,2757920788.0,11118972,9197388,298.57,299.86,20316360,6077728409.0,26791,2023-11-09 13:00:00
660,MTLR,5727,12578,1021312786.0,2890695344.0,3414867,9705032,299.08,297.86,13119899,3912008131.0,18305,4631,11600,888286361.0,2780762475.0,2986628,9294385,297.42,299.19,12281013,3669048836.0,16231,2023-11-09 13:05:00
661,MTLR,5675,9273,906659060.0,2629174117.0,3029942,8840139,299.23,297.41,11870081,3535833178.0,14948,4848,8572,825443053.0,2560324300.0,2775984,8580488,297.35,298.39,11356472,3385767354.0,13420,2023-11-09 13:10:00
662,MTLR,5232,6661,886727484.0,1938587053.0,2965374,6505110,299.03,298.01,9470484,2825314538.0,11893,4722,6070,832941866.0,1895309482.0,2800704,6350616,297.4,298.44,9151320,2728251349.0,10792,2023-11-09 13:15:00
663,MTLR,6103,15790,1009105864.0,6083527359.0,3368044,20397596,299.61,298.25,23765640,7092633224.0,21893,5638,15310,966780793.0,6040442529.0,3241007,20245654,298.3,298.36,23486661,7007223323.0,20948,2023-11-09 13:20:00
664,MTLR,4005,8585,642206306.0,2872658723.0,2162745,9702847,296.94,296.06,11865592,3514865029.0,12590,3272,8119,584756552.0,2764906761.0,1962459,9281241,297.97,297.9,11243700,3349663313.0,11391,2023-11-09 13:25:00
665,MTLR,10770,8542,2151402627.0,1961648076.0,7234220,6601806,297.39,297.14,13836026,4113050704.0,19312,9106,7557,2055806287.0,1807418985.0,7070902,6087688,290.74,296.9,13158590,3863225272.0,16663,2023-11-09 13:30:00
666,MTLR,13344,11279,2734785946.0,3330418817.0,9229279,11269576,296.32,295.52,20498855,6065204764.0,24623,12556,10506,2604755156.0,3201440162.0,8802381,10741059,295.91,298.06,19543440,5806195319.0,23062,2023-11-09 13:35:00
667,MTLR,8322,3936,1931401454.0,842192066.0,6497885,2838769,297.24,296.68,9336654,2773593521.0,12258,7758,3392,1858403141.0,832939970.0,6280138,2801624,295.92,297.31,9081762,2691343111.0,11150,2023-11-09 13:40:00
668,MTLR,11217,5308,3460077251.0,897915460.0,11641515,3016760,297.22,297.64,14658275,4357992712.0,16525,10740,4832,3403725714.0,874997681.0,11469781,2936334,296.76,297.99,14406115,4278723396.0,15572,2023-11-09 13:45:00
669,MTLR,5180,6923,1258689030.0,1426575519.0,4251381,4705896,296.07,303.15,8957277,2685264549.0,12103,4360,6335,1204522308.0,1310716305.0,4074027,4401393,295.66,297.8,8475420,2515238613.0,10695,2023-11-09 13:50:00
670,MTLR,3615,6076,553056398.0,2038466222.0,1858359,6895983,297.6,295.6,8754342,2591522621.0,9691,3081,5717,487638606.0,2002070914.0,1651462,6757389,295.28,296.28,8408851,2489709520.0,8798,2023-11-09 13:55:00
671,MTLR,4064,4962,741105531.0,1366107591.0,2491445,4595983,297.46,297.24,7087428,2107213122.0,9026,3756,4588,722906405.0,1379304861.0,2445931,4552148,295.55,303.0,6998079,2102211266.0,8344,2023-11-09 14:00:00
672,MTLR,1860,11405,181999208.0,6211176283.0,615095,20968293,295.89,296.22,21583388,6393175491.0,13265,1257,11059,169486789.0,6227335899.0,574165,20981394,295.19,296.8,21555559,6396822688.0,12316,2023-11-09 14:05:00
673,MTLR,7042,11652,956890271.0,3717121712.0,3221805,12612944,297.0,294.71,15834749,4674011983.0,18694,5574,10719,859059919.0,3627009828.0,2912744,12239000,294.93,296.35,15151744,4486069748.0,16293,2023-11-09 14:10:00
674,MTLR,5748,3939,983349377.0,972498533.0,3294938,3298501,298.44,294.83,6593439,1955847910.0,9687,5053,3395,906663445.0,934489541.0,3081162,3165479,294.26,295.21,6246641,1841152986.0,8448,2023-11-09 14:15:00
675,MTLR,3248,5451,451786758.0,1479951500.0,1517511,5010203,297.72,295.39,6527714,1931738258.0,8699,2825,4944,430392979.0,1443118962.0,1458996,4877710,294.99,295.86,6336706,1873511941.0,7769,2023-11-09 14:20:00
676,MTLR,9137,14787,2291974464.0,3468214253.0,7731701,11724668,296.44,295.8,19456369,5760188718.0,23924,8730,14284,2243441518.0,3438442713.0,7585705,11616935,295.75,295.99,19202640,5681884232.0,23014,2023-11-09 14:25:00
677,MTLR,7392,5303,2702501223.0,804940894.0,9128454,2722567,296.05,295.66,11851021,3507442117.0,12695,7152,5013,2690626580.0,776756509.0,9095756,2620679,295.81,296.4,11716435,3467383089.0,12165,2023-11-09 14:30:00
678,MTLR,12868,6744,4466348050.0,1073217060.0,15044303,3622350,296.88,296.28,18666653,5539565111.0,19612,12428,6166,4412754607.0,1019220031.0,14891393,3429599,296.33,297.18,18320992,5431974638.0,18594,2023-11-09 14:35:00
679,MTLR,3971,2605,1038274570.0,374825272.0,3503544,1265470,296.35,296.19,4769014,1413099842.0,6576,3722,2381,1027172310.0,357988770.0,3469305,1205365,296.07,297.0,4674670,1385161080.0,6103,2023-11-09 14:40:00
680,MTLR,8269,16608,1430652832.0,4644968772.0,4830743,15692323,296.16,296.0,20523066,6075621604.0,24877,7853,16338,1410609792.0,4623870091.0,4769781,15604633,295.74,296.31,20374414,6034479883.0,24191,2023-11-09 14:45:00
681,MTLR,10307,7061,3202958375.0,1322535805.0,10774325,4473345,297.28,295.65,15247670,4525494181.0,17368,9704,6394,3134721509.0,1282229278.0,10573906,4315696,296.46,297.11,14889602,4416950788.0,16098,2023-11-09 14:50:00
682,MTLR,13876,8697,4825590661.0,1292979069.0,16240936,4355591,297.13,296.86,20596527,6118569731.0,22573,13565,8085,4787581747.0,1271281785.0,16131112,4273865,296.79,297.45,20404977,6058863533.0,21650,2023-11-09 14:55:00
683,MTLR,10673,10215,3815784795.0,1738021112.0,12838226,5849316,297.22,297.13,18687542,5553805907.0,20888,10280,9647,3731323161.0,1683578952.0,12566037,5658531,296.94,297.53,18224568,5414902114.0,19927,2023-11-09 15:00:00
684,MTLR,6282,3529,1545082641.0,684546784.0,5197210,2303629,297.29,297.16,7500839,2229629425.0,9811,6003,3249,1529564918.0,669332246.0,5148340,2247208,297.1,297.85,7395548,2198897164.0,9252,2023-11-09 15:05:00
685,MTLR,2437,1807,476672719.0,263364425.0,1602809,891330,297.4,295.47,2494139,740037144.0,4244,2179,1565,462313278.0,255816503.0,1556991,859045,296.93,297.79,2416036,718129781.0,3744,2023-11-09 15:10:00
686,MTLR,6625,9010,1326434807.0,2174134781.0,4458482,7322493,297.51,296.91,11780975,3500569588.0,15635,6163,8528,1292627773.0,2150756738.0,4354549,7233123,296.85,297.35,11587672,3443384511.0,14691,2023-11-09 15:15:00
687,MTLR,7631,18069,1486676400.0,5326604046.0,5011479,17948422,296.65,296.77,22959901,6813280446.0,25700,7213,17749,1448299362.0,5299316378.0,4883970,17835611,296.54,297.12,22719581,6747615740.0,24962,2023-11-09 15:20:00
688,MTLR,6023,9171,1014297626.0,3430998287.0,3417861,11544315,296.76,297.2,14962176,4445295913.0,15194,5642,8973,1006144908.0,3403714347.0,3395430,11455351,296.32,297.13,14850781,4409859256.0,14615,2023-11-09 15:25:00
689,MTLR,6718,9969,1305607472.0,3310791365.0,4395880,11134555,297.01,297.34,15530435,4616398837.0,16687,6358,9673,1287309106.0,3293654534.0,4340857,11076132,296.56,297.37,15416989,4580963641.0,16031,2023-11-09 15:30:00
690,MTLR,6175,14159,1264467205.0,3959662357.0,4263636,13314157,296.57,297.4,17577793,5224129562.0,20334,5898,13989,1255420837.0,3944938480.0,4234223,13263205,296.49,297.43,17497428,5200359317.0,19887,2023-11-09 15:35:00
691,MTLR,5301,5280,1110733244.0,1391359422.0,3738047,4680393,297.14,297.27,8418440,2502092666.0,10581,5088,5085,1093067591.0,1383253195.0,3684489,4651442,296.67,297.38,8335931,2476320787.0,10173,2023-11-09 15:40:00
692,MTLR,8258,7822,2175176117.0,1316186215.0,7314346,4427319,297.38,297.29,11741665,3491362333.0,16080,7804,7390,2146285191.0,1295355573.0,7225275,4350266,297.05,297.76,11575541,3441640764.0,15194,2023-11-09 15:45:00
693,MTLR,4112,5457,1073117509.0,848118386.0,3606428,2852158,297.56,297.36,6458586,1921235895.0,9569,3789,5152,1060670125.0,831575045.0,3570414,2792882,297.07,297.75,6363296,1892245170.0,8941,2023-11-09 15:50:00
694,MTLR,7863,5065,2044764022.0,875600355.0,6837993,2945125,299.03,297.3,9783118,2920364377.0,12928,7161,4138,1949158111.0,810445128.0,6545129,2715223,297.8,298.48,9260352,2759603239.0,11299,2023-11-09 15:55:00
695,MTLR,6724,4784,1624723361.0,815385049.0,5440601,2738461,298.63,297.75,8179062,2440108410.0,11508,6235,3896,1571743622.0,777101055.0,5279282,2603842,297.72,298.44,7883124,2348844677.0,10131,2023-11-09 16:00:00
696,MTLR,2236,1217,280862333.0,140852667.0,936384,480913,299.94,292.89,1417297,421715000.0,3453,1951,899,245127039.0,118362381.0,823038,396114,297.83,298.81,1219152,363489420.0,2850,2023-11-09 16:05:00
697,MTLR,6652,17250,1376513305.0,5364629686.0,4620245,18001531,297.93,298.01,22621776,6741142992.0,23902,6194,16945,1341611269.0,5317546808.0,4509328,17847897,297.52,297.94,22357225,6659158078.0,23139,2023-11-09 16:10:00
698,MTLR,4981,2991,1029822546.0,904956777.0,3386425,3042713,304.1,297.42,6429138,1934779323.0,7972,4743,2754,999247923.0,888380687.0,3335524,2981275,299.58,297.99,6316799,1887628610.0,7497,2023-11-09 16:15:00
699,MTLR,4257,1465,791739723.0,432316956.0,2636346,1454214,300.32,297.29,4090560,1224056679.0,5722,3995,1172,756930063.0,419716675.0,2535091,1407362,298.58,298.23,3942453,1176646739.0,5167,2023-11-09 16:20:00
700,MTLR,2820,2825,419247361.0,556566784.0,1345319,1872997,311.63,297.15,3218316,975814145.0,5645,2399,2402,372389226.0,510946184.0,1225379,1710288,303.9,298.75,2935667,883335411.0,4801,2023-11-09 16:25:00
701,MTLR,3241,6904,450200793.0,2382376053.0,1476639,8010417,304.88,297.41,9487056,2832576847.0,10145,2827,6587,440328541.0,2347027315.0,1423833,7868772,309.26,298.27,9292605,2787355857.0,9414,2023-11-09 16:30:00
702,MTLR,2575,8361,357333986.0,2896710124.0,1169804,9721836,305.46,297.96,10891640,3254044110.0,10936,2301,8142,338864637.0,2895409733.0,1113702,9711798,304.27,298.13,10825500,3234274371.0,10443,2023-11-09 16:35:00
703,MTLR,2436,1638,328490204.0,425731826.0,1042027,1429779,315.24,297.76,2471806,754222030.0,4074,2168,1395,314471133.0,410406998.0,1010425,1375179,311.23,298.44,2385604,724878131.0,3563,2023-11-09 16:40:00
704,MTLR,5307,1691,1046720267.0,316750710.0,3504937,1064272,298.64,297.62,4569209,1363470978.0,6998,5010,1433,1018406104.0,300819262.0,3416733,1006266,298.06,298.95,4422999,1319225366.0,6443,2023-11-09 16:45:00
705,MTLR,1071,1020,113485958.0,152556103.0,355746,514152,319.01,296.71,869898,266042062.0,2091,892,861,106972370.0,129366689.0,336636,433024,317.77,298.75,769660,236339059.0,1753,2023-11-09 16:50:00
706,MTLR,823,1366,66889446.0,437709258.0,223758,1470931,298.94,297.57,1694689,504598704.0,2189,671,1160,62691401.0,432803358.0,210808,1450260,297.39,298.43,1661068,495494760.0,1831,2023-11-09 16:55:00
707,MTLR,2320,4148,276283171.0,1506633702.0,924678,5064107,298.79,297.51,5988785,1782916874.0,6468,2018,3868,258455666.0,1485439037.0,869059,4982246,297.4,298.15,5851305,1743894704.0,5886,2023-11-09 17:00:00
708,MTLR,4805,3696,1117266645.0,1017871201.0,3747087,3418596,298.17,297.75,7165683,2135137847.0,8501,4553,3517,1071327964.0,995689751.0,3600540,3339697,297.55,298.14,6940237,2067017716.0,8070,2023-11-09 17:05:00
709,MTLR,5409,2088,1645035037.0,299552821.0,5513799,1005406,298.35,297.94,6519205,1944587858.0,7497,5160,1933,1625607805.0,302321452.0,5459104,1013268,297.78,298.36,6472372,1927929257.0,7093,2023-11-09 17:10:00
710,MTLR,5577,2586,1280604182.0,339024535.0,4271701,1137468,299.79,298.05,5409169,1619628718.0,8163,4926,2227,1226721360.0,317003899.0,4116466,1061188,298.0,298.73,5177654,1543725259.0,7153,2023-11-09 17:15:00
711,MTLR,23977,9001,4855087139.0,1649794106.0,16254416,5522242,298.69,298.75,21776658,6504881245.0,32978,22634,7136,4467117881.0,1486817290.0,14904033,4923932,299.73,301.96,19827965,5953935171.0,29770,2023-11-09 17:20:00
712,MTLR,4928,12079,591740986.0,2790617505.0,1952507,9331237,303.07,299.06,11283744,3382358492.0,17007,4299,11389,547883038.0,2770608723.0,1834048,9254969,298.73,299.36,11089017,3318491762.0,15688,2023-11-09 17:25:00
713,MTLR,3446,2568,520238285.0,458849117.0,1732359,1541124,300.31,297.74,3273483,979087403.0,6014,2911,2209,470281961.0,440098034.0,1572950,1469494,298.98,299.49,3042444,910379995.0,5120,2023-11-09 17:30:00
714,MTLR,17214,6582,1958631739.0,1696873200.0,6511502,5660805,300.8,299.76,12172307,3655504940.0,23796,16341,5944,1894170017.0,1640568755.0,6323769,5458602,299.53,300.55,11782371,3534738772.0,22285,2023-11-09 17:35:00
715,MTLR,4428,3360,692076597.0,726125809.0,2297050,2432916,301.29,298.46,4729966,1418202406.0,7788,3925,2830,642946957.0,684654713.0,2145771,2271531,299.63,301.41,4417302,1327601671.0,6755,2023-11-09 17:40:00
716,MTLR,3929,9448,587697883.0,3367102721.0,1939217,11239626,303.06,299.57,13178843,3954800605.0,13377,3456,9112,555052000.0,3339297107.0,1850225,11140836,299.99,299.73,12991061,3894349108.0,12568,2023-11-09 17:45:00
717,MTLR,3545,9022,528026605.0,3147433618.0,1759639,10513628,300.08,299.37,12273267,3675460224.0,12567,3159,8778,509107855.0,3133031206.0,1702616,10451961,299.02,299.76,12154577,3642139062.0,11937,2023-11-09 17:50:00
718,MTLR,3322,3894,855194808.0,854581915.0,2855665,2856119,299.47,299.21,5711784,1709776723.0,7216,2840,3625,832140162.0,838444363.0,2783435,2798090,298.96,299.65,5581525,1670584526.0,6465,2023-11-09 17:55:00
719,MTLR,1258,2558,218337281.0,455173373.0,727477,1528585,300.13,297.77,2256062,673510654.0,3816,966,2386,219118461.0,441603894.0,733645,1474570,298.67,299.48,2208215,660722355.0,3352,2023-11-09 18:00:00
720,MTLR,5772,4322,1764799345.0,632162400.0,5875629,2112050,300.36,299.31,7987679,2396961745.0,10094,5294,3957,1727318907.0,602156388.0,5771066,2006342,299.31,300.13,7777408,2329475295.0,9251,2023-11-09 18:05:00
721,MTLR,21167,10994,5054645438.0,2000522194.0,16825063,6671576,300.42,299.86,23496639,7055167633.0,32161,20731,10354,5011372850.0,1930746985.0,16753241,6427410,299.13,300.39,23180651,6942119835.0,31085,2023-11-09 18:10:00
722,MTLR,2092,5386,360041833.0,1005397731.0,1196969,3351805,300.79,299.96,4548774,1365439564.0,7478,1758,5115,337087289.0,974901870.0,1124123,3243990,299.87,300.53,4368113,1311989160.0,6873,2023-11-09 18:15:00
723,MTLR,2660,3140,639383748.0,455381114.0,2131234,1523956,300.01,298.82,3655190,1094764862.0,5800,2333,2856,611546601.0,435707810.0,2040807,1450629,299.66,300.36,3491436,1047254412.0,5189,2023-11-09 18:20:00
724,MTLR,5114,3478,1841815722.0,410390576.0,6099907,1368041,301.94,299.98,7467948,2252206299.0,8592,4685,3165,1771159102.0,392024517.0,5901223,1303260,300.13,300.8,7204483,2163183620.0,7850,2023-11-09 18:25:00
725,MTLR,8674,5501,1956134133.0,1236480395.0,6503255,4126049,300.79,299.68,10629304,3192614529.0,14175,8204,5012,1904383396.0,1198418726.0,6330042,3983667,300.85,300.83,10313709,3102802122.0,13216,2023-11-09 18:30:00
726,MTLR,5256,3772,1207673156.0,420357304.0,3978958,1408439,303.51,298.46,5387397,1628030461.0,9028,4425,2869,1085020480.0,361164709.0,3609984,1197918,300.56,301.49,4807902,1446185189.0,7294,2023-11-09 18:35:00
727,MTLR,18117,16601,4617068867.0,2608409544.0,14914026,8406601,309.58,310.28,23320627,7225478411.0,34718,15949,12616,3968606817.0,2104857279.0,12941171,6910284,306.67,304.6,19851455,6073464097.0,28565,2023-11-09 18:40:00
728,MTLR,16763,15386,3030431742.0,3169170446.0,10200441,10203107,297.09,310.61,20403548,6199602188.0,32149,11314,12404,2226340831.0,2628347818.0,7284267,8533560,305.64,308.0,15817827,4854688649.0,23718,2023-11-10 10:05:00
729,MTLR,22885,26542,4368537070.0,6201603198.0,14079524,20105154,310.28,308.46,34184678,10570140268.0,49427,20543,24243,4120480278.0,5965130362.0,13525269,19308480,304.65,308.94,32833749,10085610640.0,44786,2023-11-10 10:10:00
730,MTLR,16612,18747,3326976254.0,5819573388.0,10748096,18863169,309.54,308.52,29611265,9146549642.0,35359,14590,17034,3110243399.0,5637838521.0,10068274,18217143,308.92,309.48,28285417,8748081920.0,31624,2023-11-10 10:15:00
731,MTLR,20848,14597,5684553487.0,3875503758.0,18414916,12389278,308.69,312.81,30804194,9560057245.0,35445,18737,12315,5225812515.0,3516816896.0,16850971,11332159,310.12,310.34,28183130,8742629411.0,31052,2023-11-10 10:20:00
732,MTLR,21540,14141,6609524068.0,3498911101.0,21268066,11230421,310.77,311.56,32498487,10108435169.0,35681,18549,11017,6089569058.0,3073705014.0,19737425,9824851,308.53,312.85,29562276,9163274073.0,29566,2023-11-10 10:25:00
733,MTLR,12267,16121,2713954153.0,3661717910.0,8679247,11831034,312.69,309.5,20510281,6375672064.0,28388,10026,14547,2578711469.0,3482233702.0,8445166,11074671,305.35,314.43,19519837,6060945172.0,24573,2023-11-10 10:30:00
734,MTLR,17002,17204,3923042968.0,3875284394.0,12579227,12445557,311.87,311.38,25024784,7798327363.0,34206,14977,15145,3662709215.0,3546033463.0,11778721,11401812,310.96,311.01,23180533,7208742679.0,30122,2023-11-10 10:35:00
735,MTLR,12568,6539,2651346536.0,1828501869.0,8458269,5770452,313.46,316.87,14228721,4479848406.0,19107,11114,5498,2472968099.0,1524619970.0,7972247,4903404,310.2,310.93,12875651,3997588070.0,16612,2023-11-10 10:40:00
736,MTLR,10351,16670,1951323539.0,5904463554.0,6283729,19012641,310.54,310.55,25296370,7855787093.0,27021,9574,16035,1895894067.0,5845552315.0,6119452,18807769,309.81,310.81,24927221,7741446383.0,25609,2023-11-10 10:45:00
737,MTLR,11404,16487,2121303709.0,4342022652.0,6837038,14084696,310.27,308.28,20921734,6463326361.0,27891,9926,15289,1985269762.0,4210298043.0,6430982,13583611,308.7,309.95,20014593,6195567805.0,25215,2023-11-10 10:50:00
738,MTLR,15495,14112,2907925340.0,4235020789.0,9403688,13773916,309.23,307.47,23177604,7142946130.0,29607,13660,12761,2728104203.0,4040854558.0,8846036,13064001,308.4,309.31,21910037,6768958762.0,26421,2023-11-10 10:55:00
739,MTLR,16257,8590,3834690381.0,2469117485.0,12382511,8005290,309.69,308.44,20387801,6303807866.0,24847,14769,7235,3619069288.0,2285680833.0,11733543,7391911,308.44,309.21,19125454,5904750122.0,22004,2023-11-10 11:00:00
740,MTLR,4336,7749,704936583.0,1632416019.0,2268771,5291039,310.71,308.52,7559810,2337352603.0,12085,3489,7021,633213027.0,1548353174.0,2051569,4999126,308.65,309.72,7050695,2181566201.0,10510,2023-11-10 11:05:00
741,MTLR,13620,9187,3665518529.0,2085334445.0,11797867,6615001,310.69,315.24,18412868,5750852975.0,22807,12516,8192,3510748784.0,2001638250.0,11341042,6376930,309.56,313.89,17717972,5512387034.0,20708,2023-11-10 11:10:00
742,MTLR,15387,12229,3946127548.0,3359326233.0,12693406,10831965,310.88,310.13,23525371,7305453782.0,27616,14056,11057,3814234938.0,3262249186.0,12303810,10501287,310.0,310.65,22805097,7076484125.0,25113,2023-11-10 11:15:00
743,MTLR,13239,12457,3031678101.0,4639495786.0,9768569,14961327,310.35,310.1,24729896,7671173888.0,25696,12716,11914,2994264346.0,4583242792.0,9664830,14768717,309.81,310.33,24433547,7577507139.0,24630,2023-11-10 11:20:00
744,MTLR,20574,7547,5855503400.0,1894107223.0,18894114,6117047,309.91,309.64,25011161,7749610624.0,28121,19697,6883,5747052472.0,1946053097.0,18572301,6163479,309.44,315.74,24735780,7693105570.0,26580,2023-11-10 11:25:00
745,MTLR,10132,5717,3347986428.0,1272192993.0,10783638,3975807,310.47,319.98,14759445,4620179421.0,15849,9594,5199,3257052393.0,1052111330.0,10506904,3383822,309.99,310.92,13890726,4309163723.0,14793,2023-11-10 11:30:00
746,MTLR,9500,3655,2901207636.0,591465927.0,9176223,1903922,316.17,310.66,11080145,3492673563.0,13155,8483,2868,2703505293.0,519801961.0,8700272,1667779,310.74,311.67,10368051,3223307255.0,11351,2023-11-10 11:35:00
747,MTLR,14586,12141,3234725207.0,3232982374.0,10175396,10202220,317.9,316.89,20377616,6467707581.0,26727,12076,9267,2804848449.0,2920995218.0,8943407,9163008,313.62,318.78,18106415,5725843667.0,21343,2023-11-10 11:40:00
748,MTLR,11059,9808,2371153236.0,2482216231.0,7552510,7948975,313.96,312.27,15501485,4853369468.0,20867,9227,8540,2179411711.0,2341671592.0,6987563,7419406,311.9,315.61,14406969,4521083304.0,17767,2023-11-10 11:45:00
749,MTLR,12434,5753,2785486248.0,1076738723.0,8859685,3455417,314.4,311.61,12315102,3862224971.0,18187,10841,3806,2429490795.0,904719290.0,7761389,2882494,313.02,313.87,10643883,3334210086.0,14647,2023-11-10 11:50:00
750,MTLR,12696,5815,2667900511.0,933757884.0,8402733,2999374,317.5,311.32,11402107,3601658395.0,18511,10471,3004,2197031960.0,674086793.0,6992183,2138543,314.21,315.21,9130726,2871118754.0,13475,2023-11-10 11:55:00
751,MTLR,11495,24209,2463670304.0,7241060689.0,7791528,23077336,316.2,313.77,30868864,9704730993.0,35704,9113,21856,2124466981.0,6925530590.0,6764813,22003740,314.05,314.74,28768553,9049997571.0,30969,2023-11-10 12:00:00
752,MTLR,20921,19014,4846379982.0,4894411090.0,15154020,15289860,319.81,320.11,30443880,9740791072.0,39935,18546,16170,4361118911.0,4648852249.0,13801063,14517716,316.0,320.22,28318779,9009971160.0,34716,2023-11-10 12:05:00
753,MTLR,14648,11626,3595750986.0,2823228443.0,11169095,8910149,321.94,316.86,20079244,6418979430.0,26274,11706,8116,3164503821.0,2350960664.0,9978262,7404623,317.14,317.5,17382885,5515464486.0,19822,2023-11-10 12:10:00
754,MTLR,10600,7657,2161836125.0,1741371228.0,6508388,5657425,332.16,307.8,12165813,3903207353.0,18257,8376,5479,1731133694.0,1496805984.0,5477649,4707699,316.04,317.95,10185348,3227939678.0,13855,2023-11-10 12:15:00
755,MTLR,9880,4354,1936423779.0,841266690.0,6074884,2562906,318.76,328.25,8637790,2777690470.0,14234,8470,3097,1746220951.0,723763603.0,5527208,2164301,315.93,334.41,7691509,2469984555.0,11567,2023-11-10 12:20:00
756,MTLR,11681,9323,2529951288.0,2814977607.0,8007112,8939910,315.96,314.88,16947022,5344928895.0,21004,10269,8198,2338033136.0,2680076818.0,7414447,8478673,315.33,316.1,15893120,5018109955.0,18467,2023-11-10 12:25:00
757,MTLR,9186,6911,2030984454.0,1749578257.0,6420746,5549950,316.32,315.24,11970696,3780562711.0,16097,8285,6238,1961081365.0,1635099956.0,6224750,5157814,315.05,317.01,11382564,3596181321.0,14523,2023-11-10 12:30:00
758,MTLR,12494,6135,2845758471.0,1279768417.0,8846872,4063679,321.67,314.93,12910551,4125526888.0,18629,11607,5209,2713918297.0,1237208447.0,8601276,3898452,315.53,317.36,12499728,3951126745.0,16816,2023-11-10 12:35:00
759,MTLR,13983,9093,3682961074.0,1790905237.0,11348870,5662767,324.52,316.26,17011637,5473866311.0,23076,11557,5694,3141395090.0,1440040424.0,9798055,4480961,320.61,321.37,14279016,4581435514.0,17251,2023-11-10 12:40:00
760,MTLR,12362,9864,2708368563.0,2244101891.0,8490648,7059229,318.98,317.9,15549877,4952470455.0,22226,10409,7921,2389071137.0,2021337132.0,7530586,6294479,317.25,321.13,13825065,4410408269.0,18330,2023-11-10 12:45:00
761,MTLR,11186,8020,2637832842.0,1868074869.0,8236245,5908730,320.27,316.16,14144975,4505907711.0,19206,9588,6440,2459907274.0,1661584216.0,7728682,5204640,318.28,319.25,12933322,4121491491.0,16028,2023-11-10 12:50:00
762,MTLR,7984,10626,1869786910.0,2680881318.0,5842793,8377012,320.02,320.03,14219805,4550668228.0,18610,6508,9262,1663722977.0,2481532801.0,5232888,7700262,317.94,322.27,12933150,4145255778.0,15770,2023-11-10 12:55:00
763,MTLR,11778,9265,2617961193.0,2481217705.0,8232031,7816274,318.02,317.44,16048305,5099178899.0,21043,10534,8241,2487099951.0,2376861200.0,7827200,7459506,317.75,318.64,15286706,4863961151.0,18775,2023-11-10 13:00:00
764,MTLR,10737,11668,2363740068.0,3123571177.0,7296472,9837862,323.96,317.51,17134334,5487311246.0,22405,9538,10765,2238305886.0,2930470669.0,7043967,9200639,317.76,318.51,16244606,5168776556.0,20303,2023-11-10 13:05:00
765,MTLR,6646,8220,982704160.0,2460209897.0,3075136,7689911,319.56,319.93,10765047,3442914057.0,14866,5561,7295,931143511.0,2394281024.0,2840091,7444390,327.86,321.62,10284481,3325424535.0,12856,2023-11-10 13:10:00
766,MTLR,7194,11929,1748093889.0,2078466112.0,5396910,6538399,323.91,317.89,11935309,3826560001.0,19123,6265,11213,1599544109.0,2065410688.0,5020834,6451930,318.58,320.12,11472764,3664954798.0,17478,2023-11-10 13:15:00
767,MTLR,13654,16451,3379166713.0,3504994207.0,10408764,11009011,324.65,318.38,21417775,6884160920.0,30105,12120,15035,3118846814.0,3219272274.0,9715919,10124614,321.0,317.96,19840533,6338119088.0,27155,2023-11-10 13:20:00
768,MTLR,17807,8160,4401729528.0,1454990413.0,13795309,4571896,319.07,318.25,18367205,5856719941.0,25967,16801,6720,4235395376.0,1200742856.0,13320623,3762343,317.96,319.15,17082966,5436138232.0,23521,2023-11-10 13:25:00
769,MTLR,9557,13053,1979505039.0,2184797430.0,6241028,6880844,317.18,317.52,13121872,4164302470.0,22610,8825,12455,1967212939.0,2084012804.0,6190977,6546899,317.75,318.32,12737876,4051225743.0,21280,2023-11-10 13:30:00
770,MTLR,20169,24183,3084609284.0,4646433897.0,9714505,14632398,317.53,317.54,24346903,7731043181.0,44352,18934,23366,2929837456.0,4539838616.0,9248315,14281971,316.8,317.87,23530286,7469676073.0,42300,2023-11-10 13:35:00
771,MTLR,15375,11537,3051975924.0,2149445015.0,9605160,6776015,317.74,317.21,16381175,5201420940.0,26912,14704,10974,3007176281.0,2140448225.0,9480710,6730318,317.19,318.03,16211028,5147624507.0,25678,2023-11-10 13:40:00
772,MTLR,22583,11114,4212104882.0,2436346244.0,13262636,7687881,317.59,316.91,20950517,6648451126.0,33697,21859,10405,4076962946.0,2339758924.0,12849443,7363050,317.29,317.77,20212493,6416721870.0,32264,2023-11-10 13:45:00
773,MTLR,14778,7176,4252107897.0,993006329.0,13368856,3131723,318.06,317.08,16500579,5245114227.0,21954,14317,6727,4199080146.0,949523690.0,13218213,2983544,317.67,318.25,16201757,5148603837.0,21044,2023-11-10 13:50:00
774,MTLR,14518,7252,3820229880.0,942364235.0,11989689,2965337,318.63,317.79,14955026,4762594116.0,21770,13900,6720,3751071787.0,916746369.0,11806951,2878338,317.7,318.5,14685289,4667818157.0,20620,2023-11-10 13:55:00
775,MTLR,6878,3876,2116526863.0,537126966.0,6533291,1691624,323.96,317.52,8224915,2653653830.0,10754,6285,3223,1997917584.0,485326095.0,6224314,1514886,320.99,320.37,7739200,2483243680.0,9508,2023-11-10 14:00:00
776,MTLR,5020,3918,1444172760.0,761976504.0,4379304,2324405,329.77,327.82,6703709,2206149264.0,8938,3689,2050,1200069030.0,531324041.0,3673696,1561755,326.67,340.21,5235451,1731393071.0,5739,2023-11-10 14:05:00
777,MTLR,8833,8954,1740000640.0,2663494967.0,5449730,8309669,319.28,320.53,13759399,4403495608.0,17787,7744,8063,1627001289.0,2529246135.0,5090534,7891673,319.61,320.5,12982207,4156247424.0,15807,2023-11-10 14:10:00
778,MTLR,6539,2919,1403284659.0,670167073.0,4354131,2105277,322.29,318.33,6459408,2073451733.0,9458,5791,2277,1309953992.0,682225046.0,4076504,2076515,321.34,328.54,6153019,1992179038.0,8068,2023-11-10 14:15:00
779,MTLR,10773,2925,2729904252.0,444594064.0,8517657,1404827,320.5,316.48,9922484,3174498316.0,13698,10082,2310,2712948245.0,382595889.0,8489230,1195826,319.58,319.94,9685056,3095544134.0,12392,2023-11-10 14:20:00
780,MTLR,9273,2428,1877712996.0,502445919.0,5852355,1531815,320.85,328.01,7384170,2380158916.0,11701,8649,1954,1820964012.0,400212666.0,5714198,1251945,318.67,319.67,6966143,2221176678.0,10603,2023-11-10 14:25:00
781,MTLR,12783,4963,2379730393.0,1433410725.0,7426202,4281980,320.45,334.75,11708182,3813141119.0,17746,11564,3864,2273707212.0,1344385065.0,7094451,4055558,320.49,331.49,11150009,3618092278.0,15428,2023-11-10 14:30:00
782,MTLR,9857,3562,1657794448.0,1055386759.0,5172672,3305681,320.49,319.26,8478353,2713181208.0,13419,9197,2438,1606843793.0,989673501.0,5008208,3083735,320.84,320.93,8091943,2596517295.0,11635,2023-11-10 14:35:00
783,MTLR,8153,6969,1239240535.0,1609271074.0,3879890,5051924,319.4,318.55,8931814,2848511610.0,15122,7306,6488,1161728137.0,1554469638.0,3644766,4868175,318.74,319.31,8512941,2716197776.0,13794,2023-11-10 14:40:00
784,MTLR,11645,4334,2171548011.0,724585459.0,6737939,2275426,322.29,318.44,9013365,2896133471.0,15979,10738,3497,2071292505.0,661212867.0,6484973,2064824,319.4,320.23,8549797,2732505373.0,14235,2023-11-10 14:45:00
785,MTLR,7706,5046,1682716909.0,861032977.0,5066112,2699103,332.15,319.01,7765215,2543749887.0,12752,6405,3563,1385718012.0,713940152.0,4304294,2227485,321.94,320.51,6531779,2099658164.0,9968,2023-11-10 14:50:00
786,MTLR,7363,4570,1215696193.0,905261402.0,3749857,2719971,324.2,332.82,6469828,2120957596.0,11933,5625,2777,944200645.0,660766468.0,2950913,1993998,319.97,331.38,4944911,1604967113.0,8402,2023-11-10 14:55:00
787,MTLR,6523,8057,903136366.0,1993249436.0,2746867,6272819,328.79,317.76,9019686,2896385803.0,14580,5157,7146,758819818.0,1864016239.0,2373218,5808044,319.74,320.94,8181262,2622836057.0,12303,2023-11-10 15:00:00
788,MTLR,16131,8502,3795769064.0,1705619841.0,11648094,5315068,325.87,320.9,16963162,5501388905.0,24633,14396,6438,3384037823.0,1471923399.0,10481225,4566031,322.87,322.36,15047256,4855961222.0,20834,2023-11-10 15:05:00
789,MTLR,12500,9250,2482599841.0,1724813057.0,7407244,5250052,335.16,328.53,12657296,4207412898.0,21750,10365,6955,2084830564.0,1352555198.0,6296583,4185795,331.11,323.13,10482378,3437385762.0,17320,2023-11-10 15:10:00
790,MTLR,14010,8824,2455794041.0,2330142586.0,7402499,7123243,331.75,327.12,14525742,4785936627.0,22834,12161,7263,2183340263.0,2147879691.0,6641681,6657974,328.73,322.6,13299655,4331219954.0,19424,2023-11-10 15:15:00
791,MTLR,11546,7062,2182028460.0,1423381760.0,6575434,4439066,331.85,320.65,11014500,3605410221.0,18608,9952,5084,1912189997.0,1072219279.0,5871461,3314835,325.68,323.46,9186296,2984409277.0,15036,2023-11-10 15:20:00
792,MTLR,6371,6587,1148123527.0,1266890379.0,3543300,3967981,324.03,319.28,7511281,2415013907.0,12958,5182,5278,1018728119.0,1149561826.0,3170891,3560381,321.28,322.88,6731272,2168289945.0,10460,2023-11-10 15:25:00
793,MTLR,5540,10052,938891010.0,2195347798.0,2708753,6904659,346.61,317.95,9613412,3134238809.0,15592,3874,8920,803005958.0,1942327204.0,2311779,6023096,347.35,322.48,8334875,2745333163.0,12794,2023-11-10 15:30:00
794,MTLR,30586,12981,6004817802.0,2833505803.0,18634697,8869679,322.24,319.46,27504376,8838323605.0,43567,28573,11353,5741140130.0,2648870489.0,17857412,8237793,321.5,321.55,26095205,8390010620.0,39926,2023-11-10 15:35:00
795,MTLR,12829,20843,2773836697.0,6833924147.0,8616502,21348506,321.92,320.11,29965008,9607760844.0,33672,10292,19190,2573925768.0,6414297286.0,8231297,19980764,312.7,321.02,28212061,8988223054.0,29482,2023-11-10 15:40:00
796,MTLR,13033,17118,3256243434.0,4664887986.0,10135932,14492125,321.26,321.89,24628057,7921131421.0,30151,11608,15936,3104101980.0,4413460812.0,9710514,13761967,319.66,320.7,23472481,7517562793.0,27544,2023-11-10 15:45:00
797,MTLR,6287,18636,1086743197.0,5497612637.0,3383722,17182617,321.17,319.95,20566339,6584355834.0,24923,5088,17697,926512732.0,5415258545.0,2910160,16876112,318.37,320.88,19786272,6341771277.0,22785,2023-11-10 15:50:00
798,MTLR,5973,7407,1600507681.0,1569683428.0,4937764,4856687,324.14,323.2,9794451,3170191109.0,13380,4748,6125,1400759878.0,1409601286.0,4376025,4391605,320.1,320.98,8767630,2810361165.0,10873,2023-11-10 15:55:00
799,MTLR,13585,22034,3587529826.0,4999580565.0,11164612,15597381,321.33,320.54,26761993,8587110391.0,35619,12643,21168,3421378455.0,4952753803.0,10670198,15411033,320.65,321.38,26081231,8374132259.0,33811,2023-11-10 16:00:00
800,MTLR,16414,6741,4282020129.0,1367896042.0,13309998,4255310,321.71,321.46,17565308,5649916172.0,23155,15440,5502,4177284072.0,1409574036.0,13000405,4228393,321.32,333.36,17228798,5586858109.0,20942,2023-11-10 16:05:00
801,MTLR,10496,8118,1552085666.0,2144930370.0,4823371,6629745,321.78,323.53,11453116,3697016037.0,18614,9568,7154,1510769394.0,2079655086.0,4712743,6428197,320.57,323.52,11140940,3590424480.0,16722,2023-11-10 16:10:00
802,MTLR,14016,7373,2586174052.0,1591176433.0,7851734,4964482,329.38,320.51,12816216,4177350485.0,21389,13137,6396,2438888739.0,1531774048.0,7521877,4754971,324.24,322.14,12276848,3970662788.0,19533,2023-11-10 16:15:00
803,MTLR,12038,8726,3013218003.0,1381487740.0,9345384,4305470,322.43,320.87,13650854,4394705744.0,20764,11099,7467,2917642724.0,1313591971.0,9069352,4051362,321.7,324.23,13120714,4231234696.0,18566,2023-11-10 16:20:00
804,MTLR,20261,9231,3370009875.0,2017213490.0,10432886,6282823,323.02,321.07,16715709,5387223366.0,29492,19299,8181,3253089569.0,1930700829.0,10083442,5992413,322.62,322.19,16075855,5183790399.0,27480,2023-11-10 16:25:00
805,MTLR,6286,19220,829175448.0,4945058082.0,2561090,15401653,323.76,321.07,17962743,5774233530.0,25506,5213,18287,723248303.0,4830484280.0,2254568,14999236,320.79,322.05,17253804,5553732584.0,23500,2023-11-10 16:30:00
806,MTLR,6967,9544,1239720510.0,2584731625.0,3841113,8027887,322.75,321.97,11869000,3824452135.0,16511,6418,8756,1172838810.0,2548115050.0,3651544,7908420,321.19,322.2,11559964,3720953861.0,15174,2023-11-10 16:35:00
807,MTLR,30754,11342,6771438858.0,1300890087.0,21029345,4040591,322.0,321.96,25069936,8072328946.0,42096,30122,10139,6697951189.0,1233671782.0,20815174,3825766,321.78,322.46,24640940,7931622971.0,40261,2023-11-10 16:40:00
808,MTLR,14155,5845,2865381362.0,1347274227.0,8880138,4114589,322.67,327.44,12994727,4212655590.0,20000,13521,4986,2828780210.0,1209479514.0,8789276,3753180,321.84,322.25,12542456,4038259725.0,18507,2023-11-10 16:45:00
809,MTLR,5680,6598,838869483.0,2018546524.0,2575028,6234392,325.77,323.78,8809420,2857416008.0,12278,4945,5800,771691083.0,1963449868.0,2407556,6016797,320.53,326.33,8424353,2735140951.0,10745,2023-11-10 16:50:00
810,MTLR,8837,10105,1421640742.0,2619106939.0,4355905,8172030,326.37,320.5,12527935,4040747682.0,18942,7651,9019,1262801356.0,2514884106.0,3947873,7785229,319.87,323.03,11733102,3777685462.0,16670,2023-11-10 16:55:00
811,MTLR,14212,5325,2696142406.0,1206784065.0,8390038,3759572,321.35,320.99,12149610,3902926471.0,19537,13711,4784,2670995591.0,1301677666.0,8290927,4048941,322.16,321.49,12339868,3972673257.0,18495,2023-11-10 17:00:00
812,MTLR,13663,13057,3409778027.0,2231168488.0,10601191,6963911,321.64,320.39,17565102,5640946515.0,26720,13033,12414,3342600524.0,2057124065.0,10421871,6390339,320.73,321.91,16812210,5399724589.0,25447,2023-11-10 17:05:00
813,MTLR,8018,11471,2188054567.0,1958571252.0,6816627,6102663,320.99,320.94,12919290,4146625820.0,19489,7551,10945,2156191459.0,1867027465.0,6722442,5808960,320.75,321.4,12531402,4023218925.0,18496,2023-11-10 17:10:00
814,MTLR,11601,18881,2349622185.0,4287480377.0,7564375,13421271,310.62,319.45,20985646,6637102562.0,30482,10185,17358,2094200530.0,4132788963.0,6553380,12902047,319.56,320.32,19455427,6226989494.0,27543,2023-11-10 17:15:00
815,MTLR,12133,15046,2473790545.0,3758144516.0,7743650,11940348,319.46,314.74,19683998,6231935061.0,27179,9036,12840,2065310560.0,3328894979.0,6735096,10446271,306.65,318.67,17181367,5394205539.0,21876,2023-11-10 17:20:00
816,MTLR,17643,51811,3919676864.0,5432330964.0,12201973,17167348,321.23,316.43,29369321,9352007828.0,69454,13755,26986,2973537077.0,4654934704.0,9409735,14539190,316.01,320.16,23948925,7628471782.0,40741,2023-11-10 17:25:00
817,MTLR,17636,13982,4132993662.0,2329846267.0,12884974,7209055,320.76,323.18,20094029,6462839929.0,31618,15087,8100,3697228257.0,1646196482.0,11679297,5041481,316.56,326.53,16720778,5343424740.0,23187,2023-11-10 17:30:00
818,MTLR,11295,7131,2606778402.0,1281343015.0,8112703,4070955,321.32,314.75,12183658,3888121418.0,18426,9940,5886,2384860908.0,1285405017.0,7489185,4027525,318.44,319.16,11516710,3670265925.0,15826,2023-11-10 17:35:00
819,MTLR,7018,8357,1491192508.0,1860024156.0,4659167,5863411,320.06,317.23,10522578,3351216664.0,15375,6270,7637,1531700035.0,1685495545.0,4513970,5262749,339.32,320.27,9776719,3217195580.0,13907,2023-11-10 17:40:00
820,MTLR,9608,8617,1693592806.0,2374463479.0,5236979,7455369,323.39,318.49,12692348,4068056285.0,18225,8377,7848,1559005673.0,2156193542.0,4917416,6784541,317.04,317.81,11701957,3715199215.0,16225,2023-11-10 17:45:00
821,MTLR,32629,7246,6184268939.0,1479381142.0,19430817,4678207,318.27,316.23,24109024,7663650082.0,39875,30797,6288,6003933353.0,1401968347.0,18896211,4400720,317.73,318.58,23296931,7405901701.0,37085,2023-11-10 17:50:00
822,MTLR,14840,10330,2754505645.0,2106294231.0,8646176,6621187,318.58,318.11,15267363,4860799876.0,25170,13854,9801,2664760507.0,2024367316.0,8375186,6352796,318.17,318.66,14727982,4689127824.0,23655,2023-11-10 17:55:00
823,MTLR,9397,9759,2541058041.0,1885544944.0,7978265,5863767,318.5,321.56,13842032,4426602986.0,19156,8134,9237,2461026624.0,1764964089.0,7736941,5476452,318.09,322.28,13213393,4225990714.0,17371,2023-11-10 18:00:00
824,MTLR,23455,4239,4041279771.0,691932936.0,12695794,2172221,318.32,318.54,14868015,4733212708.0,27694,22539,3889,3986542090.0,646040535.0,12530766,2026263,318.14,318.83,14557029,4632582626.0,26428,2023-11-10 18:05:00
825,MTLR,11325,2900,2315524367.0,428983641.0,7260432,1344417,318.92,319.09,8604849,2744508008.0,14225,10855,2578,2282799904.0,402822329.0,7170685,1262813,318.35,318.99,8433498,2685622234.0,13433,2023-11-10 18:10:00
826,MTLR,20506,6028,4277296577.0,1077637286.0,13357096,3330257,320.23,323.59,16687353,5354933864.0,26534,19393,5069,4057762703.0,978130279.0,12724528,3026561,318.89,323.18,15751089,5035892982.0,24462,2023-11-10 18:15:00
827,MTLR,13427,5906,2818313521.0,1450352988.0,8805081,4552848,320.08,318.56,13357929,4268666510.0,19333,12524,4990,2673810475.0,1314950083.0,8369754,4106608,319.46,320.2,12476362,3988760558.0,17514,2023-11-10 18:20:00
828,MTLR,8829,25651,1324476830.0,5056816546.0,4145448,15878524,319.5,318.47,20023972,6381293377.0,34480,7811,25108,1229683477.0,4973800178.0,3865616,15598762,318.11,318.86,19464378,6203483656.0,32919,2023-11-10 18:25:00
829,MTLR,6996,8077,1247597056.0,1559367999.0,3909702,4895208,319.1,318.55,8804910,2806965055.0,15073,6511,7775,1218779072.0,1534252728.0,3830493,4810491,318.18,318.94,8640984,2753031800.0,14286,2023-11-10 18:30:00
830,MTLR,6768,3188,1563567753.0,533519025.0,4889472,1677898,319.78,317.97,6567370,2097086779.0,9956,6342,2782,1532379390.0,513414001.0,4810145,1607349,318.57,319.42,6417494,2045793391.0,9124,2023-11-10 18:35:00
831,MTLR,4611,4511,1096958180.0,1067809041.0,3430754,3363892,319.74,317.43,6794646,2164767221.0,9122,4274,4268,1034272453.0,1055669139.0,3251223,3303377,318.12,319.57,6554600,2089941592.0,8542,2023-11-10 18:40:00
832,MTLR,32277,29245,4596757045.0,5122107688.0,13946564,15299692,329.6,334.79,29246256,9718864734.0,61522,25929,24845,3584865349.0,4504721269.0,11084298,13309722,323.42,338.45,24394020,8089586618.0,50774,2023-11-13 10:05:00
833,MTLR,16555,21409,3728082697.0,5916780525.0,11461165,18347519,325.28,322.48,29808684,9644863222.0,37964,13608,19096,3251205799.0,5374411440.0,10094114,16648459,322.09,322.82,26742573,8625617240.0,32704,2023-11-13 10:10:00
834,MTLR,19141,25211,4389483592.0,7337126730.0,13542133,22763721,324.14,322.32,36305854,11726610323.0,44352,15999,22995,3912503385.0,6788502620.0,12147583,21087236,322.08,321.92,33234819,10701006005.0,38994,2023-11-13 10:15:00
835,MTLR,22462,23850,3726572083.0,4486359289.0,11629218,14043239,320.45,319.47,25672457,8212931373.0,46312,19688,21748,3386783849.0,4084366119.0,10578477,12736596,320.16,320.68,23315073,7471149969.0,41436,2023-11-13 10:20:00
836,MTLR,25135,16399,5147774521.0,2373306287.0,15862264,7413787,324.53,320.12,23276051,7521080808.0,41534,23275,14948,4861722379.0,2171381931.0,15209948,6786306,319.64,319.97,21996254,7033104311.0,38223,2023-11-13 10:25:00
837,MTLR,10487,11969,2021315961.0,2056536112.0,6219167,6374154,325.01,322.64,12593321,4077852073.0,22456,8948,10671,1827331321.0,1917640399.0,5699402,5904751,320.62,324.76,11604153,3744971721.0,19619,2023-11-13 10:30:00
838,MTLR,7076,12721,1098237691.0,2573410612.0,3410657,7916976,322.0,325.05,11327633,3671648303.0,19797,5831,11893,968914725.0,2401058165.0,3023200,7467884,320.49,321.52,10491084,3369972890.0,17724,2023-11-13 10:35:00
839,MTLR,14041,23933,1938394774.0,4869702318.0,6046853,15112079,320.56,322.24,21158932,6808097092.0,37974,13002,23177,1839129982.0,4775372800.0,5745405,14884296,320.1,320.83,20629701,6614502782.0,36179,2023-11-13 10:40:00
840,MTLR,13225,14705,1954654833.0,3654174317.0,6090542,11379660,320.93,321.11,17470202,5608829150.0,27930,12366,14041,1876632668.0,3526097654.0,5861246,10992313,320.18,320.78,16853559,5402730323.0,26407,2023-11-13 10:45:00
841,MTLR,12270,10811,2017056147.0,2586749099.0,6038790,8121373,334.02,318.51,14160163,4603805247.0,23081,10689,9701,1849981572.0,2420232976.0,5513451,7540076,335.54,320.98,13053527,4270214548.0,20390,2023-11-13 10:50:00
842,MTLR,11126,6885,2304905621.0,1249739016.0,7153208,3902589,322.22,320.23,11055797,3554644637.0,18011,10117,5907,2186220717.0,1153913672.0,6856835,3584051,318.84,321.96,10440886,3340134390.0,16024,2023-11-13 10:55:00
843,MTLR,7775,8123,1643793528.0,1318247391.0,5119569,4163343,321.08,316.63,9282912,2962040919.0,15898,6168,7103,1522140538.0,1222917955.0,4756493,3830588,320.01,319.25,8587081,2745058493.0,13271,2023-11-13 11:00:00
844,MTLR,7000,12995,1146370339.0,2608988437.0,3563046,8293644,321.74,314.58,11856690,3755358777.0,19995,5614,11242,929577982.0,2291919803.0,2926299,7180421,317.66,319.19,10106720,3221497786.0,16856,2023-11-13 11:05:00
845,MTLR,11132,13915,1634627467.0,2735313204.0,5113208,8631148,319.69,316.91,13744356,4369940672.0,25047,9012,12370,1423264112.0,2571186422.0,4468869,8046814,318.48,319.53,12515683,3994450534.0,21382,2023-11-13 11:10:00
846,MTLR,16429,9867,3321152402.0,1368390460.0,10375942,4315531,320.08,317.09,14691473,4689542862.0,26296,15168,8631,3141803970.0,1232604698.0,9891437,3869357,317.63,318.56,13760794,4374408669.0,23799,2023-11-13 11:15:00
847,MTLR,16623,17013,3030100893.0,3056410940.0,9511392,9597630,318.58,318.45,19109022,6086511833.0,33636,15452,16147,2929988550.0,2979968587.0,9222698,9366452,317.69,318.15,18589150,5909957138.0,31599,2023-11-13 11:20:00
848,MTLR,31216,13488,6231042116.0,1885433634.0,19516031,5931710,319.28,317.86,25447741,8116475750.0,44704,30230,12563,6107181192.0,1796181005.0,19159461,5627101,318.76,319.2,24786562,7903362197.0,42793,2023-11-13 11:25:00
849,MTLR,12292,20814,1749761203.0,3778326990.0,5497391,11871262,318.29,318.28,17368653,5528088193.0,33106,11456,20154,1692836007.0,3715666984.0,5322634,11648698,318.04,318.98,16971332,5408502992.0,31610,2023-11-13 11:30:00
850,MTLR,17447,14083,3458211084.0,2637817671.0,10807428,8270627,319.98,318.94,19078055,6096028756.0,31530,16701,13303,3364004485.0,2577818862.0,10552695,8076273,318.78,319.18,18628968,5941823347.0,30004,2023-11-13 11:35:00
851,MTLR,21594,10408,4553939045.0,1443261127.0,14179724,4513038,321.16,319.8,18692762,5997200173.0,32002,20588,9297,4392379337.0,1329724950.0,13734614,4148739,319.8,320.51,17883353,5722104288.0,29885,2023-11-13 11:40:00
852,MTLR,14860,8276,2874873491.0,1368240239.0,8957537,4281071,320.94,319.6,13238608,4243113730.0,23136,14244,7600,2829574040.0,1310684511.0,8845802,4088176,319.88,320.6,12933978,4140258551.0,21844,2023-11-13 11:45:00
853,MTLR,24886,13280,5041654582.0,2073529705.0,15775840,6496515,319.58,319.18,22272355,7115184287.0,38166,24154,12728,4958103016.0,2116913276.0,15519549,6607894,319.47,320.36,22127443,7075016293.0,36882,2023-11-13 11:50:00
854,MTLR,11136,5490,2900692538.0,883374451.0,9030438,2698801,321.21,327.32,11729239,3784066989.0,16626,10545,5119,2830421701.0,744857084.0,8839321,2310280,320.21,322.41,11149601,3575278786.0,15664,2023-11-13 11:55:00
855,MTLR,11303,10582,2126132609.0,2354360289.0,6615754,7323694,321.37,321.47,13939448,4480492898.0,21885,10610,10056,2070991010.0,2223080377.0,6455364,6957999,320.82,319.5,13413363,4294071387.0,20666,2023-11-13 12:00:00
856,MTLR,6192,10813,981737810.0,2481670649.0,3065032,7769713,320.3,319.4,10834745,3463408459.0,17005,5704,10377,924195334.0,2439014104.0,2889605,7620666,319.83,320.05,10510271,3363209438.0,16081,2023-11-13 12:05:00
857,MTLR,35036,15919,4495724981.0,3135862717.0,14064511,9775717,319.65,320.78,23840228,7631587699.0,50955,34045,15001,4386558531.0,3056250604.0,13754094,9565539,318.93,319.51,23319633,7442809135.0,49046,2023-11-13 12:10:00
858,MTLR,35979,9068,6473938032.0,2094666468.0,20217998,6562805,320.21,319.17,26780803,8568604500.0,45047,35412,8445,6361349777.0,1993642516.0,19887250,6237077,319.87,319.64,26124327,8354992293.0,43857,2023-11-13 12:15:00
859,MTLR,14027,8410,2512711799.0,2148822541.0,7854298,6676305,319.92,321.86,14530603,4661534341.0,22437,13614,7914,2472555614.0,2031109933.0,7736104,6285113,319.61,323.16,14021217,4503665547.0,21528,2023-11-13 12:20:00
860,MTLR,10302,8602,1860100258.0,1780224496.0,5814497,5317299,319.91,334.8,11131796,3640324754.0,18904,9560,8193,1809435301.0,1678905036.0,5680138,5121235,318.55,327.83,10801373,3488340338.0,17753,2023-11-13 12:25:00
861,MTLR,7864,6352,1772756724.0,880407935.0,5557355,2721234,318.99,323.53,8278589,2653164659.0,14216,7524,6061,1742296845.0,867199360.0,5454543,2687129,319.42,322.72,8141672,2609496205.0,13585,2023-11-13 12:30:00
862,MTLR,28868,8841,6196975226.0,897547927.0,19412273,2801876,319.23,320.34,22214149,7094523153.0,37709,28579,8617,6177906982.0,880080523.0,19355422,2754457,319.18,319.51,22109879,7057987506.0,37196,2023-11-13 12:35:00
863,MTLR,7552,6924,1767347953.0,992558975.0,5538547,3121970,319.1,317.93,8660517,2759906929.0,14476,7303,6646,1746949546.0,985574968.0,5481721,3087636,318.69,319.2,8569357,2732524514.0,13949,2023-11-13 12:40:00
864,MTLR,8833,14479,1438677938.0,2849960744.0,4511597,8971528,318.88,317.67,13483125,4288638682.0,23312,8016,13736,1353425806.0,2744920124.0,4260505,8619118,317.67,318.47,12879623,4098345930.0,21752,2023-11-13 12:45:00
865,MTLR,5079,9224,883344141.0,1668267992.0,2769816,5195953,318.92,321.07,7965769,2551612133.0,14303,4717,8941,828772408.0,1632615938.0,2603849,5126273,318.29,318.48,7730122,2461388346.0,13658,2023-11-13 12:50:00
866,MTLR,9064,6554,1556383918.0,1394863379.0,4885547,4386903,318.57,317.96,9272450,2951247298.0,15618,8670,6190,1511612529.0,1355673073.0,4750116,4256034,318.23,318.53,9006150,2867285602.0,14860,2023-11-13 12:55:00
867,MTLR,24658,4936,4766946217.0,630361084.0,14948029,1980379,318.9,318.3,16928408,5397307301.0,29594,24407,4626,4733248263.0,605958599.0,14855893,1900810,318.61,318.79,16756703,5339206862.0,29033,2023-11-13 13:00:00
868,MTLR,5625,3166,1268070535.0,433325413.0,3966449,1359790,319.7,318.67,5326239,1701395948.0,8791,5348,2913,1261423202.0,411628346.0,3962353,1289524,318.35,319.21,5251877,1673051549.0,8261,2023-11-13 13:05:00
869,MTLR,5422,2793,1194849746.0,326366970.0,3709773,1023288,322.08,318.94,4733061,1521216717.0,8215,5220,2627,1184915151.0,315985744.0,3670882,990042,322.79,319.16,4660924,1500900895.0,7847,2023-11-13 13:10:00
870,MTLR,11896,8332,2481846243.0,1201127210.0,7778877,3768684,319.05,318.71,11547561,3682973454.0,20228,11503,7906,2423014527.0,1149605598.0,7605941,3602143,318.57,319.14,11208084,3572620126.0,19409,2023-11-13 13:15:00
871,MTLR,4588,2325,700005636.0,556897136.0,2179898,1750202,321.12,318.19,3930100,1256902773.0,6913,4266,2083,680373718.0,536971894.0,2119638,1684727,320.99,318.73,3804365,1217345612.0,6349,2023-11-13 13:20:00
872,MTLR,3073,3669,521035865.0,738252992.0,1636291,2320744,318.42,318.11,3957035,1259288857.0,6742,2825,3501,510930012.0,728155561.0,1606962,2286030,317.95,318.52,3892992,1239085573.0,6326,2023-11-13 13:25:00
873,MTLR,2415,7417,371075506.0,1743881005.0,1143864,5444690,324.41,320.29,6588554,2114956512.0,9832,2089,7184,335178929.0,1711806605.0,1034975,5335782,323.85,320.82,6370757,2046985535.0,9273,2023-11-13 13:30:00
874,MTLR,4290,13164,595169501.0,3290216856.0,1868598,10359457,318.51,317.61,12228055,3885386357.0,17454,3758,12726,556131974.0,3228729675.0,1756288,10147613,316.65,318.18,11903901,3784861649.0,16484,2023-11-13 13:35:00
875,MTLR,3085,8339,374014994.0,1871849233.0,1171680,5908204,319.21,316.82,7079884,2245864227.0,11424,2425,7833,319532690.0,1799480323.0,1008847,5663451,316.73,317.74,6672298,2119013013.0,10258,2023-11-13 13:40:00
876,MTLR,3676,8385,619887942.0,1921152349.0,1917785,6063526,323.23,316.84,7981311,2541040291.0,12061,3030,7803,541738676.0,1850611207.0,1676596,5827301,323.12,317.58,7503897,2392349883.0,10833,2023-11-13 13:45:00
877,MTLR,12952,8192,2681628765.0,1285364009.0,8424590,4050876,318.31,317.31,12475466,3966992775.0,21144,12548,7737,2658175918.0,1257349765.0,8334090,3954459,318.95,317.96,12288549,3915525683.0,20285,2023-11-13 13:50:00
878,MTLR,10589,5905,1825942284.0,1156324135.0,5753465,3658768,317.36,316.04,9412233,2982266419.0,16494,9971,5446,1793054876.0,1090434961.0,5654060,3430845,317.13,317.83,9084905,2883489838.0,15417,2023-11-13 13:55:00
879,MTLR,2423,2912,354219711.0,453059627.0,1113624,1427602,318.08,317.36,2541226,807279338.0,5335,1508,2080,272407959.0,318301195.0,862996,1002886,315.65,317.39,1865882,590709155.0,3588,2023-11-13 14:00:00
880,MTLR,4315,6497,646080300.0,1847064156.0,1955348,5915481,330.42,312.24,7870829,2493144456.0,10812,1741,5248,437262485.0,1763683982.0,1345886,5527797,324.89,319.06,6873683,2200946467.0,6989,2023-11-13 14:05:00
881,MTLR,7136,9713,1609255914.0,1767636449.0,5056897,5533603,318.23,319.44,10590500,3376892364.0,16849,5946,9006,1444795032.0,1666547095.0,4571974,5218066,316.01,319.38,9790040,3111342127.0,14952,2023-11-13 14:10:00
882,MTLR,6584,10716,1222839235.0,1735969403.0,3851979,5470651,317.46,317.32,9322630,2958808639.0,17300,5757,10197,1165598467.0,1683402110.0,3701400,5322976,314.91,316.25,9024376,2849000577.0,15954,2023-11-13 14:15:00
883,MTLR,13175,5018,3405264614.0,540557759.0,10745726,1713985,316.89,315.38,12459711,3945822374.0,18193,12519,4298,3308893780.0,496049501.0,10465933,1565529,316.16,316.86,12031462,3804943281.0,16817,2023-11-13 14:20:00
884,MTLR,29382,10780,6648507809.0,1489880476.0,20850204,4695644,318.87,317.29,25545848,8138388286.0,40162,28491,9495,6467049943.0,1352876145.0,20372686,4252404,317.44,318.14,24625090,7819926089.0,37986,2023-11-13 14:25:00
885,MTLR,11565,4957,2771427028.0,650641046.0,8710749,2052033,318.16,317.07,10762782,3422068075.0,16522,11094,4503,2723553381.0,616332896.0,8573025,1935819,317.69,318.38,10508844,3339886278.0,15597,2023-11-13 14:30:00
886,MTLR,6336,4553,1244924334.0,971237862.0,3870993,3067421,321.6,316.63,6938414,2216162196.0,10889,5891,4153,1199372063.0,944673987.0,3756719,2972801,319.26,317.77,6729520,2144046050.0,10044,2023-11-13 14:35:00
887,MTLR,9059,10123,1321832588.0,1935924813.0,4146764,6109371,318.76,316.88,10256135,3257757402.0,19182,8570,9654,1323589512.0,1899511276.0,4155699,5982739,318.5,317.5,10138438,3223100788.0,18224,2023-11-13 14:40:00
888,MTLR,8295,12618,1175948443.0,2791355263.0,3713762,8851783,316.65,315.34,12565545,3967303707.0,20913,7143,11937,1087398764.0,2722195508.0,3443071,8600328,315.82,316.52,12043399,3809594273.0,19080,2023-11-13 14:45:00
889,MTLR,13245,15212,1863455558.0,3385939832.0,5890531,10726357,316.35,315.67,16616888,5249395391.0,28457,12397,14574,1797609719.0,3301158145.0,5695318,10438041,315.63,316.26,16133359,5098767864.0,26971,2023-11-13 14:50:00
890,MTLR,15333,17105,2643929991.0,2794036126.0,8357015,8980040,316.37,311.14,17337055,5437966117.0,32438,13169,15258,2482827844.0,2540427599.0,7862776,8064697,315.77,315.01,15927473,5023255444.0,28427,2023-11-13 14:55:00
891,MTLR,16192,14485,3465933203.0,2226872123.0,10944260,7077231,316.69,314.65,18021491,5692805326.0,30677,15066,13191,3288750284.0,2149848540.0,10437228,6813504,315.1,315.53,17250732,5438598825.0,28257,2023-11-13 15:00:00
892,MTLR,27338,15585,5921664402.0,2288107919.0,18754354,7229751,315.75,316.49,25984105,8209772321.0,42923,26606,14952,5836833972.0,2204567224.0,18504735,6974713,315.42,316.08,25479448,8041401197.0,41558,2023-11-13 15:05:00
893,MTLR,26172,37681,4078118946.0,5333187111.0,12920506,16889719,315.63,315.77,29810225,9411306058.0,63853,25274,37247,4013174643.0,5294317134.0,12733019,16757107,315.18,315.94,29490126,9307491777.0,62521,2023-11-13 15:10:00
894,MTLR,16334,9551,3716766080.0,1239208360.0,11763406,3927466,315.96,315.52,15690872,4955974441.0,25885,15799,9014,3683882366.0,1449993891.0,11682028,4374330,315.35,331.48,16056358,5133876258.0,24813,2023-11-13 15:15:00
895,MTLR,13543,8342,2673003487.0,1448297988.0,8468645,4590796,315.64,315.48,13059441,4121301475.0,21885,13062,7907,2632030351.0,1409880398.0,8346949,4462576,315.33,315.93,12809525,4041910749.0,20969,2023-11-13 15:20:00
896,MTLR,13666,5282,2411455020.0,1127393051.0,7571591,3578425,318.49,315.05,11150016,3538848072.0,18948,13251,4702,2392242907.0,1093293925.0,7585519,3459979,315.37,315.98,11045498,3485536832.0,17953,2023-11-13 15:25:00
897,MTLR,7623,5306,1921875283.0,806805082.0,6061474,2554717,317.06,315.81,8616191,2728680365.0,12929,7195,4768,1868885922.0,773454715.0,5915026,2441628,315.96,316.78,8356654,2642340637.0,11963,2023-11-13 15:30:00
898,MTLR,5829,13931,971249062.0,2574144740.0,3077431,8158100,315.6,315.53,11235531,3545393802.0,19760,5339,13495,939324736.0,2539800545.0,2979268,8035762,315.29,316.06,11015030,3479125281.0,18834,2023-11-13 15:35:00
899,MTLR,4823,10895,651340960.0,2382592328.0,2066458,7632350,315.2,312.17,9698808,3033933289.0,15718,3234,10029,552082857.0,2268707870.0,1760263,7204014,313.64,314.92,8964277,2820790727.0,13263,2023-11-13 15:40:00
900,MTLR,5494,13455,847388449.0,2558139701.0,2684929,8008708,315.61,319.42,10693637,3405528151.0,18949,4207,12626,721928030.0,2417372537.0,2304989,7520421,313.2,321.44,9825410,3139300568.0,16833,2023-11-13 15:45:00
901,MTLR,10134,3451,1938678364.0,745313927.0,6350218,2190868,305.29,340.19,8541086,2683992291.0,13585,9298,2820,1774002047.0,633497590.0,5767092,2015546,307.61,314.31,7782638,2407499638.0,12118,2023-11-13 15:50:00
902,MTLR,6226,2102,1362000479.0,438535773.0,4407270,1401241,309.03,312.96,5808511,1800536252.0,8328,5635,1724,1312558752.0,415902009.0,4271750,1322162,307.26,314.56,5593912,1728460761.0,7359,2023-11-13 15:55:00
903,MTLR,7044,9936,1225788060.0,2097909242.0,3774180,6633573,324.78,316.26,10407753,3323697302.0,16980,5326,8827,1093378817.0,1840449426.0,3591364,5769957,304.45,318.97,9361321,2933828243.0,14153,2023-11-13 16:00:00
904,MTLR,10484,14299,1744116819.0,3403684264.0,5539974,10920908,314.82,311.67,16460882,5147801084.0,24783,9210,13402,1590832126.0,3302820059.0,5085231,10535943,312.83,313.48,15621174,4893652186.0,22612,2023-11-13 16:05:00
905,MTLR,9024,15950,1407749556.0,3132466246.0,4437563,10001401,317.23,313.2,14438964,4540215802.0,24974,6366,14446,1118079799.0,2909553837.0,3596117,9156589,310.91,317.76,12752706,4027633637.0,20812,2023-11-13 16:10:00
906,MTLR,20339,7972,3661518037.0,1335049802.0,11702370,4291364,312.89,311.1,15993734,4996567840.0,28311,18824,6952,3512764447.0,1212348866.0,11275175,3833365,311.55,316.26,15108540,4725113313.0,25776,2023-11-13 16:15:00
907,MTLR,17276,17412,3037052583.0,3563799195.0,9652648,11529992,314.63,309.09,21182640,6600851779.0,34688,13475,15000,2591787600.0,3192302180.0,8300524,10151948,312.24,314.45,18452472,5784089781.0,28475,2023-11-13 16:20:00
908,MTLR,29735,19332,4410718759.0,3428307629.0,14148876,10981331,311.74,312.19,25130207,7839026389.0,49067,27826,17892,4191205114.0,3272388227.0,13506265,10504773,310.32,311.51,24011038,7463593342.0,45718,2023-11-13 16:25:00
909,MTLR,9130,7502,1582251476.0,1492480881.0,5067389,4742406,312.24,314.71,9809795,3074732358.0,16632,7950,6489,1470932392.0,1384152850.0,4739412,4342051,310.36,318.78,9081463,2855085243.0,14439,2023-11-13 16:30:00
910,MTLR,20715,12425,4792513325.0,1821283853.0,15103968,5805363,317.3,313.72,20909331,6613797178.0,33140,18401,8203,4219203237.0,1448313325.0,13529543,4618091,311.85,313.62,18147634,5667516562.0,26604,2023-11-13 16:35:00
911,MTLR,16899,12077,2964666655.0,1903205226.0,9289069,6130437,319.16,310.45,15419506,4867871882.0,28976,14975,10105,2716761775.0,1708648637.0,8584451,5440851,316.47,314.04,14025302,4425410413.0,25080,2023-11-13 16:40:00
912,MTLR,18517,17281,3247929169.0,3954985743.0,10304716,12651351,315.19,312.61,22956067,7202914913.0,35798,17193,16081,3085199754.0,3788169708.0,9825518,12061497,314.0,314.07,21887015,6873369462.0,33274,2023-11-13 16:45:00
913,MTLR,5518,6928,990177119.0,1189389884.0,3142843,3794353,315.06,313.46,6937196,2179567003.0,12446,4890,6302,926134142.0,1131018193.0,2955642,3601046,313.34,314.08,6556688,2057152335.0,11192,2023-11-13 16:50:00
914,MTLR,9200,12192,1610220128.0,2544603942.0,5135332,8161617,313.56,311.78,13296949,4154824071.0,21392,8230,11401,1527356877.0,2486786884.0,4879138,7935586,313.04,313.37,12814724,4014143762.0,19631,2023-11-13 16:55:00
915,MTLR,31350,21510,4691956617.0,3131336706.0,14964818,9957431,313.53,314.47,24922249,7823293324.0,52860,30744,20844,4619269107.0,3092990236.0,14759937,9833166,312.96,314.55,24593103,7712259344.0,51588,2023-11-13 17:00:00
916,MTLR,21404,8721,4096561102.0,1495293614.0,13039744,4768143,314.16,313.6,17807887,5591854717.0,30125,20799,8164,4021056212.0,1455526669.0,12819441,4631407,313.67,314.27,17450848,5476582882.0,28963,2023-11-13 17:05:00
917,MTLR,4610,5991,680533268.0,1470520007.0,2174788,4706351,312.92,312.45,6881139,2151053276.0,10601,4126,5467,636688955.0,1409493001.0,2038001,4495218,312.41,313.55,6533219,2046181957.0,9593,2023-11-13 17:10:00
918,MTLR,7414,8390,1029705146.0,1768588139.0,3290104,5663519,312.97,312.28,8953623,2798293285.0,15804,6973,8061,992823915.0,1740989464.0,3179844,5562838,312.22,312.97,8742682,2733813380.0,15034,2023-11-13 17:15:00
919,MTLR,12279,8355,2267104373.0,1362190879.0,7232782,4351330,313.45,313.05,11584112,3629295253.0,20634,11810,7927,2229161650.0,1326145819.0,7123862,4230136,312.91,313.5,11353998,3555307470.0,19737,2023-11-13 17:20:00
920,MTLR,9544,5421,1991499154.0,763247965.0,6353607,2440017,313.44,312.8,8793624,2754747120.0,14965,9155,4953,1954209873.0,736435405.0,6246529,2349745,312.85,313.41,8596274,2690645278.0,14108,2023-11-13 17:25:00
921,MTLR,35979,12731,3909493594.0,2573203822.0,12484722,8172938,313.14,314.84,20657660,6482697416.0,48710,35651,12396,3867800340.0,2586375125.0,12361412,8182881,312.89,316.07,20544293,6454175465.0,48047,2023-11-13 17:30:00
922,MTLR,11870,12558,1707410392.0,2830125791.0,5458030,9024101,312.83,313.62,14482131,4537536184.0,24428,11418,12211,1694054043.0,2791420622.0,5411419,8894821,313.05,313.83,14306240,4485474666.0,23629,2023-11-13 17:35:00
923,MTLR,19219,16090,2668423736.0,3141662113.0,8514083,10028840,313.41,313.26,18542923,5810085850.0,35309,18555,15709,2641115088.0,3113091331.0,8446963,9940497,312.67,313.17,18387460,5754206419.0,34264,2023-11-13 17:40:00
924,MTLR,12252,12286,2159869524.0,2151904869.0,6896715,6869520,313.17,313.25,13766235,4311774394.0,24538,11294,11883,2128020589.0,2135249055.0,6803361,6809626,312.79,313.56,13612987,4263269644.0,23177,2023-11-13 17:45:00
925,MTLR,44345,17563,8146242674.0,2446602178.0,25541831,7793989,318.94,313.91,33335820,10592844852.0,61908,42661,15648,7878073762.0,2499871407.0,24753484,7837829,318.26,318.95,32591313,10377945170.0,58309,2023-11-13 17:50:00
926,MTLR,15976,9599,3558451142.0,1659820791.0,10589453,5274899,336.04,314.66,15864352,5218271934.0,25575,13844,6389,3123291291.0,1281003430.0,9313585,4023711,335.35,318.36,13337296,4404294722.0,20233,2023-11-13 17:55:00
927,MTLR,10909,11374,2405784780.0,2107377827.0,7396048,6657296,325.28,316.55,14053344,4513162607.0,22283,9300,8934,2068232718.0,1803501010.0,6499711,5645324,318.2,319.47,12145035,3871733729.0,18234,2023-11-13 18:00:00
928,MTLR,11189,14505,1809890539.0,3747213572.0,5520021,11833431,327.88,316.66,17353452,5557104112.0,25694,9855,13335,1685088309.0,3461091817.0,5066784,10868611,332.58,318.45,15935395,5146180126.0,23190,2023-11-13 18:05:00
929,MTLR,26503,20869,5099879742.0,2899150825.0,16027068,9123142,318.2,317.78,25150210,7999030567.0,47372,25218,19546,4875554118.0,2663403836.0,15339406,8360498,317.85,318.57,23699904,7538957955.0,44764,2023-11-13 18:10:00
930,MTLR,21198,19227,3424128916.0,3713320853.0,10747694,11727793,318.59,316.63,22475487,7137449769.0,40425,20294,18492,3332842940.0,3641186256.0,10525564,11485336,316.64,317.03,22010900,6974029196.0,38786,2023-11-13 18:15:00
931,MTLR,34947,18931,6911870829.0,3220602183.0,21750108,10108159,317.79,318.61,31858267,10132473013.0,53878,34215,18073,6816686835.0,3116055964.0,21480278,9804478,317.35,317.82,31284756,9932742800.0,52288,2023-11-13 18:20:00
932,MTLR,14356,17363,2471638350.0,2934676846.0,7782812,9246483,317.58,317.38,17029295,5406315197.0,31719,13516,16862,2407515061.0,2910836156.0,7594168,9165749,317.02,317.58,16759917,5318351218.0,30378,2023-11-13 18:25:00
933,MTLR,14275,8988,3097759233.0,1449872796.0,9747623,4573102,317.8,317.04,14320725,4547632030.0,23263,13795,8533,3075414901.0,1413289226.0,9690945,4446868,317.35,317.82,14137813,4488704127.0,22328,2023-11-13 18:30:00
934,MTLR,6442,9556,963679190.0,2349948998.0,3037277,7413948,317.28,316.96,10451225,3313628189.0,15998,6047,9145,917186486.0,2322484050.0,2899890,7318519,316.28,317.34,10218409,3239670537.0,15192,2023-11-13 18:35:00
935,MTLR,7293,7252,1246200546.0,1511824205.0,3921454,4771145,317.79,316.87,8692599,2758024751.0,14545,6952,6824,1198187531.0,1493104566.0,3781581,4699425,316.85,317.72,8481006,2691292098.0,13776,2023-11-13 18:40:00
936,MTLR,6491,9251,760515198.0,2932990349.0,2496923,9418762,304.58,311.4,11915685,3693505548.0,15742,2354,6708,485450519.0,2719676986.0,1564007,8686426,310.39,313.1,10250433,3205127506.0,9062,2023-11-14 10:05:00
937,MTLR,26729,28457,5580532413.0,6076037405.0,17861688,19850532,312.43,306.09,37712220,11656569818.0,55186,22396,25500,5059638380.0,5669121200.0,16281284,18332598,310.76,309.24,34613882,10728759580.0,47896,2023-11-14 10:10:00
938,MTLR,52831,20607,13005969740.0,5232293322.0,42095038,17084170,308.97,306.27,59179208,18238263062.0,73438,50336,18400,12583190494.0,4924161035.0,40815509,15949945,308.29,308.73,56765454,17507351530.0,68736,2023-11-14 10:15:00
939,MTLR,31925,36692,6366698084.0,11294933303.0,20654375,36711378,308.25,307.67,57365753,17661631387.0,68617,29642,35126,6144831846.0,11119472879.0,19967052,36053621,307.75,308.41,56020673,17264304725.0,64768,2023-11-14 10:20:00
940,MTLR,19603,27643,4240522580.0,6306097007.0,13713072,20473894,309.23,308.01,34186966,10546619587.0,47246,18352,26596,4064153006.0,6198695844.0,13194247,20097554,308.02,308.43,33291801,10262848850.0,44948,2023-11-14 10:25:00
941,MTLR,15985,33210,3695378139.0,6098495804.0,11844024,19666768,312.0,310.09,31510792,9793873943.0,49195,14335,31691,3530885224.0,5920395696.0,11388778,19048468,310.03,310.81,30437246,9451280921.0,46026,2023-11-14 10:30:00
942,MTLR,37440,33800,7959288769.0,5922288956.0,25497985,19023867,312.15,311.31,44521852,13881577725.0,71240,36072,31644,7722343600.0,5710861462.0,24825047,18340921,311.07,311.37,43165968,13433205062.0,67716,2023-11-14 10:35:00
943,MTLR,32056,21951,5875086456.0,5313281743.0,18917128,17161363,310.57,309.61,36078491,11188368200.0,54007,30455,20517,5631153155.0,5157408260.0,18183890,16612871,309.68,310.45,34796761,10788561416.0,50972,2023-11-14 10:40:00
944,MTLR,11814,12918,3281030193.0,3542727572.0,10551994,11405572,310.94,310.61,21957566,6823757766.0,24732,10835,12026,3202133080.0,3457229241.0,10318246,11112647,310.34,311.11,21430893,6659362321.0,22861,2023-11-14 10:45:00
945,MTLR,9780,27875,2695876570.0,6579334999.0,8591143,21254668,313.8,309.55,29845811,9275211569.0,37655,8819,27268,2567745347.0,6509607237.0,8300483,21003391,309.35,309.93,29303874,9077352585.0,36087,2023-11-14 10:50:00
946,MTLR,11952,14612,3710591659.0,3380855176.0,11916295,10892762,311.39,310.38,22809057,7091446836.0,26564,11256,13897,3597395374.0,3313311384.0,11591085,10664559,310.36,310.68,22255644,6910706758.0,25153,2023-11-14 10:55:00
947,MTLR,9095,7412,2639671106.0,1540502753.0,8390907,4951765,314.59,311.1,13342672,4180173859.0,16507,8231,6253,2483213871.0,1433677369.0,7952016,4591030,312.27,312.28,12543046,3916891240.0,14484,2023-11-14 11:00:00
948,MTLR,7086,12811,1424021599.0,4228255734.0,4537951,13537915,313.8,312.33,18075866,5652277333.0,19897,5989,11087,1254640864.0,4040570038.0,4018838,12907709,312.19,313.04,16926547,5295210902.0,17076,2023-11-14 11:05:00
949,MTLR,6271,20194,1127146706.0,4944951472.0,3576763,15782001,315.13,313.33,19358764,6072098179.0,26465,5296,19486,1066152447.0,4870639397.0,3398894,15556889,313.68,313.09,18955783,5936791845.0,24782,2023-11-14 11:10:00
950,MTLR,9323,6257,2412354174.0,1336558232.0,7711596,4298051,312.82,310.97,12009647,3748912406.0,15580,8708,5424,2344538541.0,1242164721.0,7508322,3970298,312.26,312.86,11478620,3586703263.0,14132,2023-11-14 11:15:00
951,MTLR,7741,6609,1995163361.0,1885209843.0,6375911,6038417,312.92,312.2,12414328,3880373205.0,14350,7250,5931,1950095941.0,1817039463.0,6243563,5809266,312.34,312.78,12052829,3767135404.0,13181,2023-11-14 11:20:00
952,MTLR,4766,10010,917281598.0,3213665813.0,2938438,10313005,312.17,311.61,13251443,4130947411.0,14776,4042,9112,869394941.0,3207226653.0,2791046,10274008,311.49,312.17,13065054,4076621595.0,13154,2023-11-14 11:25:00
953,MTLR,4626,11354,976572713.0,3950385737.0,3118924,12674892,313.11,311.67,15793816,4926958450.0,15980,4060,10662,895797385.0,3887253065.0,2876339,12450712,311.44,312.21,15327051,4783050450.0,14722,2023-11-14 11:30:00
954,MTLR,12139,4218,3019386538.0,1381231653.0,9666233,4425416,312.36,312.11,14091649,4400618192.0,16357,11707,3803,2988625417.0,1338620146.0,9579152,4283662,311.99,312.49,13862814,4327245563.0,15510,2023-11-14 11:35:00
955,MTLR,4588,7474,1010727826.0,1494086950.0,3235759,4786385,312.36,312.15,8022144,2504814777.0,12062,4266,7227,973720839.0,1474915245.0,3123076,4720769,311.78,312.43,7843845,2448636084.0,11493,2023-11-14 11:40:00
956,MTLR,8218,5186,2004136872.0,789966879.0,6339244,2528964,316.15,312.37,8868208,2794103751.0,13404,7588,4466,1918362209.0,735781739.0,6111827,2346689,313.88,313.54,8458516,2654143949.0,12054,2023-11-14 11:45:00
957,MTLR,22789,6285,4808268699.0,844360605.0,15276058,2696058,314.76,313.18,17972116,5652629305.0,29074,21707,5326,4686607302.0,735641084.0,14911270,2336260,314.3,314.88,17247530,5422248387.0,27033,2023-11-14 11:50:00
958,MTLR,19880,14636,3359353410.0,2587451676.0,10638319,8193698,315.78,315.79,18832017,5946805086.0,34516,18129,13360,3241329917.0,2491967139.0,10316192,7876358,314.2,316.39,18192550,5733297057.0,31489,2023-11-14 11:55:00
959,MTLR,21757,59626,3110001912.0,7727596696.0,9886635,24565749,314.57,314.57,34452384,10837598609.0,81383,20690,58942,3043992793.0,7613946068.0,9688705,24197640,314.18,314.66,33886345,10657938862.0,79632,2023-11-14 12:00:00
960,MTLR,10494,4222,1848733863.0,780084116.0,5872921,2491023,314.79,313.16,8363944,2628817980.0,14716,10104,3501,1802612624.0,725739859.0,5734310,2303947,314.36,315.0,8038257,2528352484.0,13605,2023-11-14 12:05:00
961,MTLR,14088,13537,2286687947.0,3104486920.0,7285511,9889691,313.87,313.91,17175202,5391174868.0,27625,13143,12881,2206907994.0,2997137646.0,7040798,9534240,313.45,314.36,16575038,5204045641.0,26024,2023-11-14 12:10:00
962,MTLR,16956,7814,3237588851.0,1189332758.0,10287777,3783777,314.7,314.32,14071554,4426921609.0,24770,16399,7328,3143055384.0,1156750532.0,10010486,3676988,313.98,314.59,13687474,4299805916.0,23727,2023-11-14 12:15:00
963,MTLR,6055,15426,733838096.0,3209297270.0,2336674,10211908,314.05,314.27,12548582,3943135366.0,21481,5613,15134,673136678.0,3172793035.0,2145413,10089554,313.76,314.46,12234967,3845929714.0,20747,2023-11-14 12:20:00
964,MTLR,5219,19899,793453012.0,3993559320.0,2530833,12722244,313.51,313.9,15253077,4787012332.0,25118,4836,19558,774449075.0,3928565138.0,2474811,12506655,312.93,314.12,14981466,4703014213.0,24394,2023-11-14 12:25:00
965,MTLR,7240,8672,1000447854.0,2399214507.0,3194546,7667888,313.17,312.89,10862434,3399662361.0,15912,6712,8291,1005045405.0,2348410836.0,3218611,7489263,312.26,313.57,10707874,3353456241.0,15003,2023-11-14 12:30:00
966,MTLR,9408,10460,1391898884.0,2498369861.0,4449104,7992298,312.85,312.6,12441402,3890268746.0,19868,8923,10149,1343406197.0,2456255742.0,4302031,7846924,312.27,313.02,12148955,3799661940.0,19072,2023-11-14 12:35:00
967,MTLR,10262,10557,1622694737.0,2634484055.0,5177320,8434677,313.42,312.34,13611997,4257178793.0,20819,9750,10113,1571613053.0,2603077486.0,5030487,8321959,312.42,312.8,13352446,4174690539.0,19863,2023-11-14 12:40:00
968,MTLR,23423,11292,4178800103.0,1405372639.0,13345559,4483242,313.12,313.47,17828801,5584172743.0,34715,23104,10965,4153399321.0,1382105781.0,13269653,4406195,313.0,313.67,17675848,5535505102.0,34069,2023-11-14 12:45:00
969,MTLR,12917,8166,2141018929.0,1420931675.0,6841157,4538709,312.96,313.07,11379866,3561950605.0,21083,12685,7941,2114892239.0,1402729861.0,6760095,4475068,312.85,313.45,11235163,3517622100.0,20626,2023-11-14 12:50:00
970,MTLR,5918,6009,786749121.0,1828589232.0,2512275,5843615,313.16,312.92,8355890,2615338353.0,11927,5668,5859,776105050.0,1818745643.0,2482839,5806384,312.59,313.23,8289223,2594850693.0,11527,2023-11-14 12:55:00
971,MTLR,3925,4833,547324085.0,1372367937.0,1739911,4384066,314.57,313.04,6123977,1919692023.0,8758,3680,4643,520148354.0,1354052443.0,1663655,4322102,312.65,313.29,5985757,1874200798.0,8323,2023-11-14 13:00:00
972,MTLR,7531,17048,906093220.0,3902126541.0,2901748,12486337,312.26,312.51,15388085,4808219761.0,24579,7246,16822,878599253.0,3888894428.0,2816733,12434240,311.92,312.76,15250973,4767493682.0,24068,2023-11-14 13:05:00
973,MTLR,27363,27470,4088204813.0,5524690700.0,13102441,17717343,312.02,311.82,30819784,9612895513.0,54833,26459,26940,4029508367.0,5444091423.0,12927645,17428504,311.7,312.37,30356149,9473599791.0,53399,2023-11-14 13:10:00
974,MTLR,17267,33665,2147325020.0,6101002226.0,6903266,19611744,311.06,311.09,26515010,8248327247.0,50932,16419,33296,2091422178.0,6055881632.0,6729391,19450027,310.79,311.36,26179418,8147303811.0,49715,2023-11-14 13:15:00
975,MTLR,5622,6290,793082764.0,1378317272.0,2545378,4438307,311.58,310.55,6983685,2171400036.0,11912,4653,5952,752835966.0,1336061858.0,2424702,4291442,310.49,311.33,6716144,2088897825.0,10605,2023-11-14 13:20:00
976,MTLR,22961,9523,4353193307.0,1246056803.0,13963956,3996181,311.74,311.81,17960137,5599250111.0,32484,22559,9125,4312597690.0,1210094542.0,13841937,3874325,311.56,312.34,17716262,5522692233.0,31684,2023-11-14 13:25:00
977,MTLR,10309,10611,1774219045.0,1509834222.0,5700197,4843200,311.26,311.74,10543397,3284053267.0,20920,10013,10445,1749925215.0,1500002042.0,5618952,4806733,311.43,312.06,10425685,3249927257.0,20458,2023-11-14 13:30:00
978,MTLR,9554,18427,1326902962.0,3846254581.0,4267577,12367740,310.93,310.99,16635317,5173157543.0,27981,9236,18144,1310897021.0,3817053753.0,4219086,12258529,310.71,311.38,16477615,5127950774.0,27380,2023-11-14 13:35:00
979,MTLR,8551,30238,1130264802.0,5497734839.0,3638558,17673065,310.64,311.08,21311623,6627999642.0,38789,8017,29921,1098830920.0,5452241755.0,3541442,17535443,310.28,310.93,21076885,6551072675.0,37938,2023-11-14 13:40:00
980,MTLR,19780,18829,2947727670.0,3763976110.0,9492951,12120736,310.52,310.54,21613687,6711703780.0,38609,19384,18506,2920513136.0,3749497947.0,9417655,12069834,310.11,310.65,21487489,6670011083.0,37890,2023-11-14 13:45:00
981,MTLR,8570,7327,1387948735.0,1507995615.0,4463771,4575067,310.94,329.61,9038838,2895944350.0,15897,8273,7094,1342195347.0,1392471874.0,4320270,4473731,310.67,311.26,8794001,2734667221.0,15367,2023-11-14 13:50:00
982,MTLR,19853,12775,4166986991.0,1896957503.0,13382707,6099989,311.37,310.98,19482696,6063944494.0,32628,19391,12353,4131327410.0,1920587401.0,13285641,6160687,310.96,311.75,19446328,6051914811.0,31744,2023-11-14 13:55:00
983,MTLR,4006,2243,1035736730.0,254911651.0,3325538,805013,311.45,316.66,4130551,1290648381.0,6249,3835,2043,1025479243.0,243319803.0,3297555,763691,310.98,318.61,4061246,1268799046.0,5878,2023-11-14 14:00:00
984,MTLR,3681,1592,1300658179.0,515748448.0,4180816,1661675,311.1,310.38,5842491,1816406627.0,5273,3445,1362,1294611829.0,508984602.0,4166655,1632278,310.71,311.82,5798933,1803596431.0,4807,2023-11-14 14:05:00
985,MTLR,7921,7189,1109196223.0,2032683614.0,3572669,6553604,310.47,310.16,10126273,3141879838.0,15110,7600,6827,1083647665.0,1998495840.0,3493744,6428926,310.17,310.86,9922670,3082143506.0,14427,2023-11-14 14:10:00
986,MTLR,10861,13628,1647409124.0,3597393268.0,5304124,11586765,310.59,310.47,16890889,5244802393.0,24489,10551,13296,1631517593.0,3577244475.0,5258785,11508812,310.25,310.83,16767597,5208762069.0,23847,2023-11-14 14:15:00
987,MTLR,6197,9743,851893934.0,1882390747.0,2732368,6066310,311.78,310.3,8798678,2734284681.0,15940,5918,9569,831609414.0,1863213063.0,2682641,5999734,310.0,310.55,8682375,2694822478.0,15487,2023-11-14 14:20:00
988,MTLR,3382,4268,485200580.0,996509281.0,1564561,3245858,310.12,307.01,4810419,1481709861.0,7650,2874,3867,449692611.0,946317842.0,1454682,3050780,309.13,310.19,4505462,1396010454.0,6741,2023-11-14 14:25:00
989,MTLR,18554,7215,3594700520.0,1068966089.0,11610496,3469967,309.61,308.06,15080463,4663666609.0,25769,17921,6003,3528731408.0,987591178.0,11404337,3185207,309.42,310.06,14589544,4516322586.0,23924,2023-11-14 14:30:00
990,MTLR,35863,24908,6332130541.0,3395815160.0,20470930,10989840,309.32,309.0,31460770,9727945701.0,60771,34785,24081,6214689801.0,3314743549.0,20126846,10707409,308.78,309.57,30834255,9529433350.0,58866,2023-11-14 14:35:00
991,MTLR,22850,34938,3617726164.0,4945851355.0,11702845,16002116,309.13,309.07,27704961,8563577520.0,57788,22330,34530,3572632420.0,4920462699.0,11573325,15903521,308.7,309.39,27476846,8493095119.0,56860,2023-11-14 14:40:00
992,MTLR,14868,12486,3309831932.0,1846915960.0,10655871,5959557,310.61,309.91,16615428,5156747892.0,27354,14172,11815,3246450890.0,1803188314.0,10481274,5813446,309.74,310.18,16294720,5049639204.0,25987,2023-11-14 14:45:00
993,MTLR,21779,22547,5382178729.0,3180120469.0,17309360,10233026,310.94,310.77,27542386,8562299199.0,44326,21097,21751,5289226643.0,3098415352.0,17035525,9963075,310.48,310.99,26998600,8387641996.0,42848,2023-11-14 14:50:00
994,MTLR,6472,7069,1415252421.0,964530992.0,4536539,3106883,311.97,310.45,7643422,2379783413.0,13541,5863,6290,1362753345.0,895593363.0,4381265,2872777,311.04,311.75,7254042,2258346708.0,12153,2023-11-14 14:55:00
995,MTLR,16327,38618,2378053698.0,6396894813.0,7658572,20592147,310.51,310.65,28250719,8774948512.0,54945,15717,38052,2314641076.0,6350985441.0,7458213,20426121,310.35,310.92,27884334,8665626517.0,53769,2023-11-14 15:00:00
996,MTLR,32494,10804,4740479118.0,2156593648.0,15266916,6943331,310.51,310.6,22210247,6897072767.0,43298,32094,10456,4682216104.0,2116155969.0,15089933,6807950,310.29,310.84,21897883,6798372074.0,42550,2023-11-14 15:05:00
997,MTLR,5669,6922,744587201.0,1462325624.0,2354242,4718346,316.27,309.92,7072588,2206912825.0,12591,5206,6663,737232608.0,1448587779.0,2333667,4664588,315.91,310.55,6998255,2185820387.0,11869,2023-11-14 15:10:00
998,MTLR,48758,12520,7283958036.0,3021988276.0,23487970,9739644,310.11,310.28,33227614,10305946313.0,61278,48424,12136,7255270386.0,3003257031.0,23401199,9671715,310.04,310.52,33072914,10258527417.0,60560,2023-11-14 15:15:00
999,MTLR,1773,7540,278887561.0,1778522229.0,898337,5732716,310.45,310.24,6631053,2057409791.0,9313,1522,7348,246906478.0,1773142596.0,797823,5712861,309.48,310.38,6510684,2020049074.0,8870,2023-11-14 15:20:00
1000,MTLR,8573,3759,2846103423.0,694465348.0,9066458,2237467,313.92,310.38,11303925,3540568771.0,12332,8250,3353,2772511476.0,663916707.0,8832595,2133732,313.9,311.15,10966327,3436428183.0,11603,2023-11-14 15:25:00
1001,MTLR,9513,2146,3758095172.0,339140824.0,11941606,1093053,314.71,310.27,13034659,4097235996.0,11659,9203,1711,3735505408.0,311531962.0,11914092,997747,313.54,312.24,12911839,4047037370.0,10914,2023-11-14 15:30:00
1002,MTLR,15299,5555,4559078243.0,865098907.0,14606779,2777289,312.12,311.49,17384068,5424177151.0,20854,14922,5013,4528729374.0,819791572.0,14499935,2626130,312.33,312.17,17126065,5348520947.0,19935,2023-11-14 15:35:00
1003,MTLR,5780,11094,1356119319.0,3197606646.0,4354129,10256931,311.46,311.75,14611060,4553725966.0,16874,5445,10824,1337173937.0,3151185552.0,4296753,10105088,311.21,311.84,14401841,4488359489.0,16269,2023-11-14 15:40:00
1004,MTLR,5836,5871,911804935.0,1993552518.0,2926006,6399431,311.62,311.52,9325437,2905357453.0,11707,5572,5704,887688132.0,1980068445.0,2853907,6353830,311.04,311.63,9207737,2867756578.0,11276,2023-11-14 15:45:00
1005,MTLR,7786,3134,1370437052.0,1255779220.0,4400184,4027745,311.45,311.78,8427929,2626216273.0,10920,7586,3002,1344027943.0,1252945989.0,4327371,4017974,310.59,311.84,8345345,2596973933.0,10588,2023-11-14 15:50:00
1006,MTLR,15850,8791,3939123697.0,1734681943.0,12627218,5570091,311.95,311.43,18197309,5673805641.0,24641,15530,8326,3897292315.0,1721667758.0,12504098,5524132,311.68,311.66,18028230,5618960073.0,23856,2023-11-14 15:55:00
1007,MTLR,13218,6131,4358274878.0,788667105.0,13962790,2524994,312.13,312.34,16487784,5146941983.0,19349,12310,5330,4313056391.0,761248456.0,13823413,2434113,312.01,312.74,16257526,5074304848.0,17640,2023-11-14 16:00:00
1008,MTLR,17216,6513,4584998872.0,605373592.0,14660240,1935980,312.75,312.7,16596220,5190372465.0,23729,16648,5992,4524302401.0,575232075.0,14486605,1836602,312.31,313.2,16323207,5099534476.0,22640,2023-11-14 16:05:00
1009,MTLR,11620,4925,2919886877.0,688408251.0,9333992,2208398,312.82,311.72,11542390,3608295129.0,16545,11234,4418,2879324019.0,631144137.0,9213314,2014556,312.52,313.29,11227870,3510468157.0,15652,2023-11-14 16:10:00
1010,MTLR,6338,3560,1359199350.0,547538981.0,4349141,1755252,312.52,311.94,6104393,1906738332.0,9898,6041,3308,1336595384.0,532202982.0,4278930,1700455,312.37,312.98,5979385,1868798367.0,9349,2023-11-14 16:15:00
1011,MTLR,7174,3152,1167167423.0,444942036.0,3728672,1422786,313.02,312.73,5151458,1612109459.0,10326,6989,2930,1149314141.0,439892456.0,3679825,1405273,312.33,313.03,5085098,1589206598.0,9919,2023-11-14 16:20:00
1012,MTLR,7845,6484,1232180105.0,1435674563.0,3944975,4607444,312.34,311.6,8552419,2667854669.0,14329,7607,6217,1216810766.0,1412235215.0,3897056,4514909,312.24,312.79,8411965,2629045982.0,13824,2023-11-14 16:25:00
1013,MTLR,8057,8672,1225972877.0,1962396071.0,3925945,6287986,312.27,312.09,10213931,3188368949.0,16729,7749,8436,1198340609.0,1929221502.0,3842743,6175316,311.85,312.41,10018059,3127562111.0,16185,2023-11-14 16:30:00
1014,MTLR,4372,5198,721970982.0,1187898620.0,2318101,3818324,311.45,311.1,6136425,1909869602.0,9570,4007,4978,702905503.0,1170920319.0,2258789,3752040,311.19,312.08,6010829,1873825822.0,8985,2023-11-14 16:35:00
1015,MTLR,12881,10132,1519532127.0,2030309838.0,4875562,6506998,311.66,312.02,11382560,3549841965.0,23013,12710,9965,1509629300.0,2023676117.0,4846377,6485083,311.5,312.05,11331460,3533305417.0,22675,2023-11-14 16:40:00
1016,MTLR,10951,16089,1625837124.0,2818793587.0,5209890,9037057,312.07,311.91,14246947,4444630712.0,27040,10702,15930,1602085810.0,2809847447.0,5139399,9004197,311.73,312.06,14143596,4411933257.0,26632,2023-11-14 16:45:00
1017,MTLR,11730,6685,3016892708.0,1060408558.0,9658679,3394783,312.35,312.36,13053462,4077301266.0,18415,11507,6405,2983447396.0,1040858217.0,9559293,3327567,312.1,312.8,12886860,4024305614.0,17912,2023-11-14 16:50:00
1018,MTLR,13332,6290,2400151257.0,904811936.0,7696635,2898554,311.84,312.16,10595189,3304963194.0,19622,13129,6179,2393506379.0,898781088.0,7677147,2876691,311.77,312.44,10553838,3292287467.0,19308,2023-11-14 16:55:00
1019,MTLR,11006,6153,1485622245.0,1143729262.0,4765350,3662772,311.76,312.26,8428122,2629351507.0,17159,10837,5997,1476849771.0,1145996005.0,4738257,3667825,311.69,312.45,8406082,2622845777.0,16834,2023-11-14 17:00:00
1020,MTLR,18988,9947,3983303649.0,1264482140.0,12970135,4041586,307.11,312.87,17011721,5247785790.0,28935,18707,9648,3797028345.0,1242961938.0,12152253,3969811,312.45,313.1,16122064,5039990283.0,28355,2023-11-14 17:05:00
1021,MTLR,21260,7913,5089705871.0,1072724538.0,16135076,3424673,315.44,313.23,19559749,6162430410.0,29173,20260,6376,4913428939.0,969479692.0,15673100,3080604,313.49,314.7,18753704,5882908632.0,26636,2023-11-14 17:10:00
1022,MTLR,16558,3097,3147499147.0,646360791.0,10004838,2074933,314.6,311.51,12079771,3793859939.0,19655,16026,2238,3075272596.0,591028452.0,9783825,1876691,314.32,314.93,11660516,3666301049.0,18264,2023-11-14 17:15:00
1023,MTLR,22424,5520,5134446802.0,1250827781.0,16203778,3957700,316.87,316.05,20161478,6385274584.0,27944,20692,3148,4693200619.0,1015428702.0,14869455,3185528,315.63,318.76,18054983,5708629321.0,23840,2023-11-14 17:20:00
1024,MTLR,16055,15151,3091572154.0,4609771892.0,9726436,14562279,317.85,316.56,24288715,7701344047.0,31206,14777,12655,2901788573.0,4408873069.0,9157993,13874456,316.86,317.77,23032449,7310661643.0,27432,2023-11-14 17:25:00
1025,MTLR,53957,5062,10959027735.0,1864670389.0,34559640,5894600,317.1,316.34,40454240,12823698125.0,59019,53184,4176,10859357303.0,1755378268.0,34286666,5531666,316.72,317.33,39818332,12614735572.0,57360,2023-11-14 17:30:00
1026,MTLR,14750,3475,3310484621.0,745135336.0,10417853,2357190,317.77,316.11,12775043,4055619958.0,18225,14010,2336,3205342666.0,707062306.0,10120095,2225204,316.73,317.75,12345299,3912404972.0,16346,2023-11-14 17:35:00
1027,MTLR,32568,3069,7119327597.0,615223147.0,22420053,1944675,317.54,316.36,24364728,7734550744.0,35637,31979,1929,7033189629.0,533813855.0,22186972,1679694,317.0,317.8,23866666,7567003484.0,33908,2023-11-14 17:40:00
1028,MTLR,17542,6915,4234555216.0,1587381298.0,13130653,5012467,322.49,316.69,18143120,5821936514.0,24457,15583,4168,3788630652.0,1247714784.0,11856287,3903280,319.55,319.66,15759567,5036345436.0,19751,2023-11-14 17:45:00
1029,MTLR,13847,7886,2712133662.0,1688948848.0,8369518,5323149,324.05,317.28,13692667,4401082511.0,21733,12113,5449,2304949272.0,1442480451.0,7218884,4499700,319.29,320.57,11718584,3747429724.0,17562,2023-11-14 17:50:00
1030,MTLR,38178,41658,6843329715.0,5908443678.0,21399549,18469609,319.79,319.9,39869158,12751773393.0,79836,36388,39293,6782619621.0,5666181084.0,21474569,17698732,315.84,320.15,39173301,12448800706.0,75681,2023-11-14 17:55:00
1031,MTLR,21848,19676,4615907778.0,3827059483.0,14409556,11936983,320.34,320.61,26346539,8442967262.0,41524,20220,17951,4500140539.0,3501875278.0,14093270,10897656,319.31,321.34,24990926,8002015817.0,38171,2023-11-14 18:00:00
1032,MTLR,15633,12223,2559371261.0,2623815832.0,7981802,8232381,320.65,318.72,16214183,5183187093.0,27856,14894,11286,2439443929.0,2498016158.0,7634525,7824302,319.53,319.26,15458827,4937460088.0,26180,2023-11-14 18:05:00
1033,MTLR,10657,21897,1647442724.0,5389074100.0,5127836,16921323,321.27,318.48,22049159,7036516825.0,32554,10104,21424,1584517763.0,5329411816.0,4959883,16715350,319.47,318.83,21675233,6913929579.0,31528,2023-11-14 18:10:00
1034,MTLR,3194,12007,492687751.0,2628702992.0,1512340,8264214,325.78,318.08,9776554,3121390744.0,15201,2840,11637,442693948.0,2591361124.0,1392547,8134602,317.9,318.56,9527149,3034055073.0,14477,2023-11-14 18:15:00
1035,MTLR,11833,7721,2847694562.0,1471051694.0,8859221,4622396,321.44,318.24,13481617,4318746256.0,19554,11428,7286,2794860452.0,1435650573.0,8711002,4497051,320.84,319.24,13208053,4230511025.0,18714,2023-11-14 18:20:00
1036,MTLR,10662,16786,1713397744.0,3776826756.0,5340026,11794050,320.86,320.23,17134076,5490224501.0,27448,9978,16211,1639490700.0,3638699604.0,5123299,11437527,320.01,318.14,16560826,5278190305.0,26189,2023-11-14 18:25:00
1037,MTLR,24998,21131,4455928284.0,4640669525.0,13965708,14685602,319.06,316.0,28651310,9096597810.0,46129,24004,20464,4332904198.0,4543011663.0,13602238,14307852,318.54,317.52,27910090,8875915861.0,44468,2023-11-14 18:30:00
1038,MTLR,10951,6443,2676595318.0,933691869.0,8416720,2827507,318.01,330.22,11244227,3610287188.0,17394,10500,6048,2639762844.0,894786819.0,8318401,2698927,317.34,331.53,11017328,3534549663.0,16548,2023-11-14 18:35:00
1039,MTLR,21876,15017,5236682877.0,1865797833.0,16418936,5876182,318.94,317.52,22295118,7102480710.0,36893,21360,14405,5109460543.0,1777809395.0,16058004,5576241,318.19,318.82,21634245,6887269939.0,35765,2023-11-14 18:40:00
1040,MTLR,26916,37594,4729509281.0,4729509281.0,15970681,22515457,296.14,297.56,38486138,11429130354.0,64510,22948,34054,4351740670.0,4351740670.0,14420704,21055307,301.77,302.74,35476011,10726063153.0,57002,2023-11-29 10:05:00
1041,MTLR,31047,31001,5402352675.0,5402352675.0,18361350,18884963,294.22,293.57,37246313,10946341526.0,62048,27825,28682,5055039627.0,5055039627.0,16875511,17743938,299.55,300.02,34619449,10378658017.0,56507,2023-11-29 10:10:00
1042,MTLR,24906,37361,4218027520.0,4218027520.0,14119017,25829384,298.75,299.79,39948401,11961484251.0,62267,23224,36103,4100088310.0,4100088310.0,13641950,25306183,300.55,300.93,38948133,11715434058.0,59327,2023-11-29 10:15:00
1043,MTLR,19962,16884,3886196791.0,3886196791.0,12948791,13347670,300.12,300.42,26296461,7896109402.0,36846,19157,16300,3852865805.0,3852865805.0,12814534,13171400,300.66,301.1,25985934,7818716010.0,35457,2023-11-29 10:20:00
1044,MTLR,31150,10546,6229983625.0,6229983625.0,20876344,6548642,298.42,301.12,27424986,8201926116.0,41696,29169,8667,5945681269.0,5945681269.0,19651462,5824556,302.56,303.62,25476018,7714143751.0,37836,2023-11-29 10:25:00
1045,MTLR,12477,41550,2197295660.0,2197295660.0,7347190,26529853,299.07,301.8,33877043,10204013107.0,54027,10925,40547,2131536320.0,2131536320.0,7117731,26161890,299.47,302.72,33279621,10051371160.0,51472,2023-11-29 10:30:00
1046,MTLR,11202,26400,1888529509.0,1888529509.0,6325722,17365059,298.55,300.88,23690781,7113284495.0,37602,9920,25680,1816632483.0,1816632483.0,6043985,17129754,300.57,301.26,23173739,6977200229.0,35600,2023-11-29 10:35:00
1047,MTLR,8363,10239,1540883916.0,1540883916.0,5210811,6708207,295.71,290.99,11919018,3492911878.0,18602,6414,9079,1419994345.0,1419994345.0,4837951,6094365,293.51,300.25,10932316,3249833639.0,15493,2023-11-29 10:40:00
1048,MTLR,12760,13694,2227097035.0,2227097035.0,7657448,8403907,290.84,284.23,16061355,4615772883.0,26454,9131,11790,1931138531.0,1931138531.0,6509367,7260231,296.67,298.09,13769598,4095311791.0,20921,2023-11-29 10:45:00
1049,MTLR,17712,5250,2937220825.0,2937220825.0,10004863,3161803,293.58,291.95,13166666,3860318494.0,22962,15993,4151,2776102661.0,2776102661.0,9341655,2666802,297.17,298.17,12008457,3571269210.0,20144,2023-11-29 10:50:00
1050,MTLR,6486,32091,953668914.0,953668914.0,3261062,17005552,292.44,296.98,20266614,6004061409.0,38577,5433,31219,905350603.0,905350603.0,3050376,16819085,296.8,297.74,19869461,5913050443.0,36652,2023-11-29 10:55:00
1051,MTLR,4419,4534,670278022.0,670278022.0,2308106,2345276,290.4,288.29,4653382,1346407815.0,8953,3523,3893,588453594.0,588453594.0,1982958,2076377,296.76,298.0,4059335,1207203756.0,7416,2023-11-29 11:00:00
1052,MTLR,9585,29727,1581787330.0,1581787330.0,5556932,17789687,284.65,296.97,23346619,6864787180.0,39312,8458,28502,1488283717.0,1488283717.0,5000470,17288397,297.63,297.88,22288867,6638197808.0,36960,2023-11-29 11:05:00
1053,MTLR,5476,4282,910131766.0,910131766.0,3093054,2625534,294.25,289.57,5718588,1670411376.0,9758,4442,3470,830962902.0,830962902.0,2790269,2259507,297.81,299.22,5049776,1507043485.0,7912,2023-11-29 11:10:00
1054,MTLR,6295,15741,1796485325.0,1796485325.0,6146502,8587435,292.28,296.86,14733937,4345784156.0,22036,5638,15170,1737591172.0,1737591172.0,5833062,8432410,297.89,298.04,14265472,4250754284.0,20808,2023-11-29 11:15:00
1055,MTLR,9966,9099,3075893119.0,3075893119.0,10401049,7107357,295.73,297.05,17508406,5187100214.0,19065,9288,8496,3030313492.0,3030313492.0,10156887,6926927,298.35,298.81,17083814,5100174941.0,17784,2023-11-29 11:20:00
1056,MTLR,16717,13855,3252210087.0,3252210087.0,10944489,15436209,297.16,296.94,26380698,7835861830.0,30572,15921,13279,3193492540.0,3193492540.0,10706865,15139213,298.27,298.67,25846078,7715100652.0,29200,2023-11-29 11:25:00
1057,MTLR,5007,17393,860905015.0,860905015.0,2921441,15289380,294.69,296.68,18210821,5396992276.0,22400,4326,16810,809645202.0,809645202.0,2729106,14996720,296.67,298.04,17725826,5279207626.0,21136,2023-11-29 11:30:00
1058,MTLR,3453,7551,559504446.0,559504446.0,1912165,8295398,292.6,295.62,10207563,3011776563.0,11004,2249,7011,483071218.0,483071218.0,1629010,8057651,296.54,297.42,9686661,2879557753.0,9260,2023-11-29 11:35:00
1059,MTLR,7425,12536,1196512688.0,1196512688.0,4075902,14115550,293.56,295.92,18191452,5373541848.0,19961,5561,11856,1123893944.0,1123893944.0,3789976,13812400,296.54,297.15,17602376,5228231128.0,17417,2023-11-29 11:40:00
1060,MTLR,9516,7580,1478904458.0,1478904458.0,4996661,10513443,295.98,296.49,15510104,4596002116.0,17096,7967,7230,1457718978.0,1457718978.0,4911613,10367177,296.79,297.28,15278790,4539636336.0,15197,2023-11-29 11:45:00
1061,MTLR,6074,9707,1251439475.0,1251439475.0,4284379,10701878,292.09,287.51,14986257,4328370605.0,15781,4198,7997,1028309878.0,1028309878.0,3486182,9411847,294.97,296.02,12898029,3814378180.0,12195,2023-11-29 11:50:00
1062,MTLR,7890,9395,1788874001.0,1788874001.0,6181491,8552028,289.39,287.71,14733519,4249355468.0,17285,5659,8151,1508957077.0,1508957077.0,5141995,7674026,293.46,294.83,12816021,3771475964.0,13810,2023-11-29 11:55:00
1063,MTLR,6880,7616,1868669752.0,1868669752.0,6464262,6822997,289.08,292.21,13287259,3862392884.0,14496,5629,6858,1738267514.0,1738267514.0,5918188,6510317,293.72,294.36,12428505,3654624539.0,12487,2023-11-29 12:00:00
1064,MTLR,9016,20513,3163015544.0,3163015544.0,10848465,12442963,291.56,292.97,23291428,6808407571.0,29529,7993,19862,3108730281.0,3108730281.0,10579936,12222976,293.83,294.21,22802912,6704856317.0,27855,2023-11-29 12:05:00
1065,MTLR,12298,7842,4151438845.0,4151438845.0,14193854,5548307,292.48,293.15,19742161,5777935867.0,20140,11613,7107,4099826048.0,4099826048.0,13919058,5214347,294.55,295.15,19133405,5638828140.0,18720,2023-11-29 12:10:00
1066,MTLR,13264,10348,3667214006.0,3667214006.0,12458719,7518618,294.35,293.79,19977337,5876089274.0,23612,12883,9995,3653582482.0,3653582482.0,12394544,7360959,294.77,295.06,19755503,5825530433.0,22878,2023-11-29 12:15:00
1067,MTLR,7746,9308,1219591296.0,1219591296.0,4176418,12708761,292.02,292.62,16885179,4938390528.0,17054,6954,8870,1158640139.0,1158640139.0,3944633,12497874,293.73,294.53,16442507,4839622042.0,15824,2023-11-29 12:20:00
1068,MTLR,10974,6871,3520315295.0,3520315295.0,12039062,4541310,292.41,294.85,16580372,4859323980.0,17845,10212,6027,3462182251.0,3462182251.0,11733117,4297560,295.08,295.73,16030677,4733103124.0,16239,2023-11-29 12:25:00
1069,MTLR,7067,8620,1536332377.0,1536332377.0,5232427,11008078,293.62,294.04,16240505,4773158457.0,15687,6511,8299,1502663100.0,1502663100.0,5111262,10901646,293.99,295.74,16012908,4726739292.0,14810,2023-11-29 12:30:00
1070,MTLR,9659,6820,3046640406.0,3046640406.0,10408710,5625088,292.7,295.52,16033798,4708944361.0,16479,9020,5746,2999800155.0,2999800155.0,10108273,5107947,296.77,297.77,15216220,4520796933.0,14766,2023-11-29 12:35:00
1071,MTLR,6406,3621,2070615586.0,2070615586.0,7072687,2598476,292.76,295.44,9671163,2838319870.0,10027,6043,3181,2025184682.0,2025184682.0,6818079,2474490,297.03,297.72,9292569,2761884633.0,9224,2023-11-29 12:40:00
1072,MTLR,6710,3812,1823487622.0,1823487622.0,6171820,3670251,295.45,289.95,9842071,2887671174.0,10522,6227,3341,1758370797.0,1758370797.0,5922837,3416893,296.88,297.45,9339730,2774740647.0,9568,2023-11-29 12:45:00
1073,MTLR,18259,7032,5351517440.0,5351517440.0,18035731,4267467,296.72,297.2,22303198,6619804295.0,25291,17970,6699,5336593356.0,5336593356.0,17958186,4175458,297.17,297.68,22133644,6579548008.0,24669,2023-11-29 12:50:00
1074,MTLR,6603,6709,1521557180.0,1521557180.0,5153819,7213139,295.23,293.61,12366958,3639414074.0,13312,5927,6126,1469366677.0,1469366677.0,4954715,6955407,296.56,297.07,11910122,3535617796.0,12053,2023-11-29 12:55:00
1075,MTLR,6728,10491,1569067243.0,1569067243.0,5316001,9576746,295.16,296.14,14892747,4405156494.0,17219,6496,10201,1553608310.0,1553608310.0,5248482,9510785,296.01,296.8,14759267,4376453705.0,16697,2023-11-29 13:00:00
1076,MTLR,5164,4500,1375313697.0,1375313697.0,4667750,3932675,294.64,296.04,8600425,2539540289.0,9664,4906,4171,1361060029.0,1361060029.0,4588481,3841578,296.63,297.22,8430059,2502834777.0,9077,2023-11-29 13:05:00
1077,MTLR,4647,8002,1013628984.0,1013628984.0,3426501,9335152,295.82,295.65,12761653,3773527698.0,12649,4415,7791,1000213378.0,1000213378.0,3374140,9265506,296.44,297.14,12639646,3753397569.0,12206,2023-11-29 13:10:00
1078,MTLR,9707,14941,1891180655.0,1891180655.0,6417328,17259151,294.7,294.84,23676479,6979872835.0,24648,9096,14499,1845543030.0,1845543030.0,6245321,17004173,295.51,296.09,23249494,6880272083.0,23595,2023-11-29 13:15:00
1079,MTLR,3554,8680,949316266.0,949316266.0,3232269,9068173,293.7,295.25,12300442,3626724870.0,12234,3267,8468,924197558.0,924197558.0,3129334,9016549,295.33,295.77,12145883,3591049683.0,11735,2023-11-29 13:20:00
1080,MTLR,13566,12346,4739873589.0,4739873589.0,16085127,10745569,294.67,296.27,26830696,7923484524.0,25912,13070,11912,4721753543.0,4721753543.0,15958992,10649723,295.87,296.5,26608715,7879381187.0,24982,2023-11-29 13:25:00
1081,MTLR,8525,9650,3004183087.0,3004183087.0,10178442,8725335,295.15,296.21,18903777,5588745452.0,18175,7899,9307,2992584901.0,2992584901.0,10099454,8657907,296.31,296.73,18757361,5561617721.0,17206,2023-11-29 13:30:00
1082,MTLR,8047,10497,2266858755.0,2266858755.0,7653893,9353936,296.17,296.39,17007829,5039243251.0,18544,7777,10383,2261681393.0,2261681393.0,7634784,9328115,296.23,296.73,16962899,5029659536.0,18160,2023-11-29 13:35:00
1083,MTLR,5554,7674,893885514.0,893885514.0,3030929,9039336,294.92,296.37,12070265,3572917158.0,13228,5265,7574,887236889.0,887236889.0,2997690,9022354,295.97,296.6,12020044,3563283164.0,12839,2023-11-29 13:40:00
1084,MTLR,6830,8068,1339395707.0,1339395707.0,4527541,9976496,295.83,296.47,14504037,4297163995.0,14898,6440,7842,1329989032.0,1329989032.0,4493043,9863264,296.01,296.69,14356307,4256353671.0,14282,2023-11-29 13:45:00
1085,MTLR,5776,5730,1402926315.0,1402926315.0,4744632,5424130,295.69,296.33,10168762,3010263205.0,11506,5512,5495,1396355341.0,1396355341.0,4721209,5416464,295.76,296.46,10137673,3002131919.0,11007,2023-11-29 13:50:00
1086,MTLR,7287,10311,1263988692.0,1263988692.0,4324470,13427111,292.29,291.87,17751581,5183021307.0,17598,6272,9699,1193731507.0,1193731507.0,4058270,13069493,294.15,295.04,17127763,5049733757.0,15971,2023-11-29 13:55:00
1087,MTLR,10828,6229,3770390307.0,3770390307.0,12929193,5355539,291.62,288.6,18284732,5315977175.0,17057,9589,5471,3680326810.0,3680326810.0,12550024,4954931,293.25,293.81,17504955,5136123538.0,15060,2023-11-29 14:00:00
1088,MTLR,10823,7179,4397587496.0,4397587496.0,15057577,11561755,292.05,290.69,26619332,7758500211.0,18002,9739,6492,4340162012.0,4340162012.0,14763053,11274271,293.99,293.85,26037324,7653143704.0,16231,2023-11-29 14:05:00
1089,MTLR,5555,4202,1965300786.0,1965300786.0,6739864,5275225,291.59,292.02,12015089,3505762590.0,9757,5020,3862,1940391956.0,1940391956.0,6623794,5191786,292.94,293.55,11815580,3464454121.0,8882,2023-11-29 14:10:00
1090,MTLR,8571,6997,2594994989.0,2594994989.0,8879871,6351944,292.23,293.78,15231815,4461095123.0,15568,8003,6510,2539510306.0,2539510306.0,8655396,6251751,293.4,294.11,14907147,4378212705.0,14513,2023-11-29 14:15:00
1091,MTLR,8109,3861,2144025318.0,2144025318.0,7322328,3146584,292.81,293.23,10468912,3066710986.0,11970,7760,3602,2127950601.0,2127950601.0,7247269,3119073,293.62,294.26,10366342,3045770277.0,11362,2023-11-29 14:20:00
1092,MTLR,6853,10560,1310404070.0,1310404070.0,4483481,14123926,292.27,293.06,18607407,5449572895.0,17413,6466,10214,1271265388.0,1271265388.0,4337813,13973505,293.07,293.74,18311318,5375886946.0,16680,2023-11-29 14:25:00
1093,MTLR,5674,7275,1027406550.0,1027406550.0,3529272,8163781,291.11,293.14,11693053,3420504543.0,12949,5329,6996,1005925682.0,1005925682.0,3434686,8036331,292.87,293.54,11471017,3364891617.0,12325,2023-11-29 14:30:00
1094,MTLR,6133,5078,1898876055.0,1898876055.0,6504321,3797890,291.94,293.92,10302211,3015144248.0,11211,5777,4664,1892284452.0,1892284452.0,6439112,3705369,293.87,294.36,10144481,2982984041.0,10441,2023-11-29 14:35:00
1095,MTLR,17172,23190,5122911595.0,5122911595.0,17433279,15860583,293.86,294.58,33293862,9795085256.0,40362,16750,22711,5100285824.0,5100285824.0,17328883,15782900,294.32,294.75,33111783,9752284417.0,39461,2023-11-29 14:40:00
1096,MTLR,7363,7467,2255483150.0,2255483150.0,7687017,8049270,293.41,293.94,15736287,4621501561.0,14830,6863,7167,2221903212.0,2221903212.0,7556193,7881966,294.05,294.28,15438159,4541412860.0,14030,2023-11-29 14:45:00
1097,MTLR,1724,1839,276644454.0,276644454.0,964284,2020147,286.89,293.9,2984431,870366955.0,3563,1508,1754,264489297.0,264489297.0,902025,2005064,293.22,294.11,2907089,854198655.0,3262,2023-11-29 14:50:00
1098,MTLR,5976,8713,1036579580.0,1036579580.0,3546176,10098922,292.31,293.11,13645098,3996684558.0,14689,5575,8521,1012358046.0,1012358046.0,3453224,10059052,293.16,293.83,13512276,3968031742.0,14096,2023-11-29 14:55:00
1099,MTLR,5283,7210,1045942361.0,1045942361.0,3579189,7356008,292.23,293.54,10935197,3205250321.0,12493,4930,7005,1033937404.0,1033937404.0,3527083,7328435,293.14,293.78,10855518,3186893230.0,11935,2023-11-29 15:00:00
1100,MTLR,5308,6657,1234518872.0,1234518872.0,4221639,6517415,292.43,293.75,10739054,3149000601.0,11965,5096,6450,1230615569.0,1230615569.0,4193377,6500042,293.47,294.0,10693419,3141596569.0,11546,2023-11-29 15:05:00
1101,MTLR,15305,8301,5403835323.0,5403835323.0,18416507,4621707,293.42,294.5,23038214,6764947750.0,23606,14953,7839,5380939357.0,5380939357.0,18281504,4520706,294.34,294.94,22802210,6714275061.0,22792,2023-11-29 15:10:00
1102,MTLR,24814,17425,8712923911.0,8712923911.0,29664523,11578775,293.72,295.47,41243298,12134150536.0,42239,23804,16047,8542229733.0,8542229733.0,28876810,11224333,295.82,296.59,40101143,11871275114.0,39851,2023-11-29 15:15:00
1103,MTLR,8020,7268,2313432515.0,2313432515.0,7826186,7524036,295.6,295.8,15350222,4539067169.0,15288,7320,6540,2305265876.0,2305265876.0,7770664,7341049,296.66,297.16,15111713,4486720367.0,13860,2023-11-29 15:20:00
1104,MTLR,4959,6006,830878245.0,830878245.0,2823681,6917069,294.25,294.29,9740750,2866523023.0,10965,4501,5724,809193371.0,809193371.0,2737541,6820616,295.59,296.56,9558157,2831909291.0,10225,2023-11-29 15:25:00
1105,MTLR,65553,18527,10632261517.0,10632261517.0,35910034,15317696,296.08,296.64,51227730,15176034778.0,84080,65336,18261,10614421401.0,10614421401.0,35829163,15280546,296.25,296.78,51109709,15149418814.0,83597,2023-11-29 15:30:00
1106,MTLR,8108,5374,3094962640.0,3094962640.0,10474649,3631649,295.47,296.39,14106298,4171332423.0,13482,7723,4876,3049835091.0,3049835091.0,10273497,3443512,296.86,297.78,13717009,4075246475.0,12599,2023-11-29 15:35:00
1107,MTLR,16547,7317,3605126565.0,3605126565.0,12179313,6260367,296.0,296.56,18439680,5461690069.0,23864,16141,7064,3598036296.0,3598036296.0,12132173,6180847,296.57,297.18,18313020,5434883020.0,23205,2023-11-29 15:40:00
1108,MTLR,33882,10506,6868588878.0,6868588878.0,23210561,7012753,295.93,296.34,30223314,8946724611.0,44388,33279,9858,6797460304.0,6797460304.0,22886785,6808413,297.0,297.78,29695198,8824861455.0,43137,2023-11-29 15:45:00
1109,MTLR,8517,5722,2542453388.0,2542453388.0,8564834,4198623,296.85,296.74,12763457,3788334091.0,14239,8224,5405,2514913138.0,2514913138.0,8457977,4067938,297.34,298.07,12525915,3727429804.0,13629,2023-11-29 15:50:00
1110,MTLR,14113,8202,5951600606.0,5951600606.0,20166049,4959099,295.13,298.07,25125148,7429766001.0,22315,13487,7350,5876616848.0,5876616848.0,19713770,4645593,298.1,299.06,24359363,7265942516.0,20837,2023-11-29 15:55:00
1111,MTLR,6912,5678,2025927477.0,2025927477.0,6863902,5992143,295.16,297.71,12856045,3809831903.0,12590,6374,5071,2021940248.0,2021940248.0,6766259,5800778,298.83,299.39,12567037,3758619458.0,11445,2023-11-29 16:00:00
1112,MTLR,10873,7022,4000315012.0,4000315012.0,13506091,5474399,296.19,296.84,18980490,5625309754.0,17895,9878,6022,3857595053.0,3857595053.0,12936747,4955132,298.19,300.21,17891879,5345179603.0,15900,2023-11-29 16:05:00
1113,MTLR,5163,8147,914217510.0,914217510.0,3085289,11140077,296.32,296.73,14225366,4219798031.0,13310,4498,7614,851475610.0,851475610.0,2852825,10887123,298.47,299.38,13739948,4110861754.0,12112,2023-11-29 16:10:00
1114,MTLR,8224,10263,1888622392.0,1888622392.0,6375630,12436766,296.23,295.53,18812396,5564079530.0,18487,6600,9315,1760745817.0,1760745817.0,5918743,11817989,297.49,298.37,17736732,5286932636.0,15915,2023-11-29 16:15:00
1115,MTLR,12059,11793,2413097760.0,2413097760.0,8211276,13373104,293.88,294.88,21584380,6356541041.0,23852,9677,11115,2330251101.0,2330251101.0,7852296,12977339,296.76,297.11,20829635,6185976279.0,20792,2023-11-29 16:20:00
1116,MTLR,7318,27199,1427816220.0,1427816220.0,4858178,17787206,293.9,296.72,22645384,6705555768.0,34517,6053,26827,1405113228.0,1405113228.0,4740712,17707958,296.39,296.94,22448670,6663268998.0,32880,2023-11-29 16:25:00
1117,MTLR,16639,68605,2972615907.0,2972615907.0,10050054,40194701,295.78,296.74,50244755,14899991051.0,85244,16106,68461,2954982667.0,2954982667.0,9975824,40195624,296.21,296.79,50171448,14884599746.0,84567,2023-11-29 16:30:00
1118,MTLR,8503,11323,1530385839.0,1530385839.0,5189463,15270871,294.9,294.76,20460334,6031554810.0,19826,7757,10885,1478379513.0,1478379513.0,4999938,15032416,295.68,296.48,20032354,5935131016.0,18642,2023-11-29 16:35:00
1119,MTLR,7675,7728,1391484129.0,1391484129.0,4731100,9089295,294.11,295.41,13820395,4076587407.0,15403,7209,7424,1381258496.0,1381258496.0,4680667,9003638,295.1,295.78,13684305,4044346751.0,14633,2023-11-29 16:40:00
1120,MTLR,13856,10937,2474740927.0,2474740927.0,8404096,13229790,294.47,295.92,21633886,6389653640.0,24793,13581,10741,2459280375.0,2459280375.0,8324788,13182695,295.42,295.95,21507483,6360753147.0,24322,2023-11-29 16:45:00
1121,MTLR,5353,5785,1198344230.0,1198344230.0,4060119,3929605,295.15,296.06,7989724,2361740663.0,11138,5208,5599,1189242867.0,1189242867.0,4019304,3915008,295.88,296.58,7934312,2350350705.0,10807,2023-11-29 16:50:00
1122,MTLR,6768,5276,2158214358.0,2158214358.0,7301233,3113457,295.6,295.43,10414690,3078032465.0,12044,6486,4962,2146805113.0,2146805113.0,7241871,3040472,296.44,297.19,10282343,3050397630.0,11448,2023-11-29 16:55:00
1123,MTLR,13510,9235,3754812172.0,3754812172.0,12690446,4986407,295.88,296.26,17676853,5232088128.0,22745,13365,9051,3743155560.0,3743155560.0,12632538,4860735,296.31,297.0,17493273,5186779822.0,22416,2023-11-29 17:00:00
1124,MTLR,6693,8731,1050947481.0,1050947481.0,3560307,11595392,295.18,296.02,15155699,4483390849.0,15424,6450,8580,1047627886.0,1047627886.0,3548008,11538990,295.27,296.37,15086998,4467485540.0,15030,2023-11-29 17:05:00
1125,MTLR,3237,5655,613648216.0,613648216.0,2088235,9230967,293.86,295.14,11319202,3338107342.0,8892,2949,5515,597126678.0,597126678.0,2023693,9152948,295.07,295.76,11176641,3304226196.0,8464,2023-11-29 17:10:00
1126,MTLR,3097,5243,567275665.0,567275665.0,1930571,7469271,293.84,295.71,9399842,2776029166.0,8340,2948,5096,564273210.0,564273210.0,1911131,7420767,295.26,295.88,9331898,2759966754.0,8044,2023-11-29 17:15:00
1127,MTLR,10559,14059,1769994864.0,1769994864.0,6054447,17322024,292.35,292.46,23376471,6836074950.0,24618,8830,13476,1737338064.0,1737338064.0,6014527,16898462,288.86,294.58,22912989,6715202600.0,22306,2023-11-29 17:20:00
1128,MTLR,7655,10690,2546275269.0,2546275269.0,8701029,6915862,292.64,292.87,15616891,4571718468.0,18345,6659,10237,2456432072.0,2456432072.0,8365175,6744764,293.65,294.29,15109939,4441335884.0,16896,2023-11-29 17:25:00
1129,MTLR,6599,10241,1565558938.0,1565558938.0,5359171,9247394,292.13,293.75,14606565,4281987965.0,16840,6119,10033,1546862167.0,1546862167.0,5270344,9197698,293.5,294.3,14468042,4253718171.0,16152,2023-11-29 17:30:00
1130,MTLR,7796,7455,2197503813.0,2197503813.0,7515895,7401829,292.38,293.52,14917724,4370094469.0,15251,7317,7120,2170865417.0,2170865417.0,7380789,7311658,294.12,294.71,14692447,4325647928.0,14437,2023-11-29 17:35:00
1131,MTLR,6275,6950,2406527479.0,2406527479.0,8191603,5417990,293.78,294.64,13609593,4002904865.0,13225,6040,6756,2382383738.0,2382383738.0,8096244,5360789,294.26,294.76,13457033,3962546717.0,12796,2023-11-29 17:40:00
1132,MTLR,4292,7211,711838328.0,711838328.0,2431302,9813529,292.78,293.41,12244831,3591192873.0,11503,3944,6982,700217921.0,700217921.0,2383511,9703780,293.78,294.4,12087291,3557047814.0,10926,2023-11-29 17:45:00
1133,MTLR,3258,3024,997113416.0,997113416.0,3417204,3326964,291.79,294.51,6744168,1976943799.0,6282,3030,2778,990059062.0,990059062.0,3362750,3299242,294.42,294.81,6661992,1962719396.0,5808,2023-11-29 17:50:00
1134,MTLR,10157,13600,3456394106.0,3456394106.0,11748091,6518988,294.21,294.62,18267079,5376989447.0,23757,9544,12837,3428674907.0,3428674907.0,11630904,6448718,294.79,295.57,18079622,5334748997.0,22381,2023-11-29 17:55:00
1135,MTLR,15710,12088,4381230897.0,4381230897.0,14876823,6238650,294.5,295.42,21115473,6224231676.0,27798,13894,11238,4399963200.0,4399963200.0,14907749,6158872,295.15,295.78,21066621,6221604438.0,25132,2023-11-29 18:00:00
1136,MTLR,10120,6737,2494900359.0,2494900359.0,8454985,4417216,295.08,294.67,12872201,3796520955.0,16857,9187,6226,2485213346.0,2485213346.0,8416580,4356395,295.28,295.77,12772975,3773703638.0,15413,2023-11-29 18:05:00
1137,MTLR,11826,19259,1831205509.0,1831205509.0,6254711,19778786,292.77,292.99,26033497,7626254261.0,31085,10156,18896,1774437406.0,1774437406.0,6040041,19587133,293.78,294.55,25627174,7543900808.0,29052,2023-11-29 18:10:00
1138,MTLR,30653,84749,5759177232.0,5759177232.0,19628927,49663153,293.4,294.27,69292080,20373780289.0,115402,29792,84443,5748100444.0,5748100444.0,19556978,49577786,293.92,294.41,69134764,20344420887.0,114235,2023-11-29 18:15:00
1139,MTLR,4095,5243,1048139176.0,1048139176.0,3572723,4947472,293.37,293.26,8520195,2499037209.0,9338,3565,5043,1071406180.0,1071406180.0,3660448,4873352,292.7,294.48,8533800,2506511819.0,8608,2023-11-29 18:20:00
1140,MTLR,1981,2434,315467133.0,315467133.0,1078278,3171840,292.57,294.05,4250118,1248143643.0,4415,1509,2307,296951538.0,296951538.0,1011882,3128619,293.46,294.32,4140501,1217772366.0,3816,2023-11-29 18:25:00
1141,MTLR,5117,7579,809030931.0,809030931.0,2772990,11767321,291.75,293.0,14540311,4256858890.0,12696,4341,7327,755007698.0,755007698.0,2575513,11665504,293.15,293.86,14241017,4183059198.0,11668,2023-11-29 18:30:00
1142,MTLR,5227,3138,1701807035.0,1701807035.0,5825801,2673136,292.12,293.29,8498937,2485815332.0,8365,4707,2918,1694874265.0,1694874265.0,5772622,2632599,293.61,294.24,8405221,2469485865.0,7625,2023-11-29 18:35:00
1143,MTLR,4730,2655,1616254349.0,1616254349.0,5517053,1634573,292.96,293.08,7151626,2095313154.0,7385,4120,2443,1609728409.0,1609728409.0,5480059,1598242,293.74,294.3,7078301,2080087612.0,6563,2023-11-29 18:40:00
1144,MTLR,46186,50576,9506774902.0,9506774902.0,33231386,34780560,286.08,289.0,68011946,19558404512.0,96762,41825,45804,9176141348.0,9176141348.0,31605494,32201238,290.33,290.42,63806732,18528009655.0,87629,2023-11-30 10:05:00
1145,MTLR,44297,72876,9450835356.0,9450835356.0,33153081,73253494,285.07,285.19,106406575,30341779702.0,117173,40828,70464,9065027503.0,9065027503.0,31611948,72069262,286.76,287.35,103681210,29774284699.0,111292,2023-11-30 10:10:00
1146,MTLR,43564,33265,13030171228.0,13030171228.0,45893036,32174864,283.92,283.33,78067900,22146235821.0,76829,40825,31673,12845430516.0,12845430516.0,45063412,31459166,285.05,285.02,76522578,21812001412.0,72498,2023-11-30 10:15:00
1147,MTLR,23020,24089,7488689603.0,7488689603.0,26378485,25397695,283.89,284.07,51776180,14703480678.0,47109,21579,22758,7397139084.0,7397139084.0,25949739,24884254,285.06,285.27,50833993,14495859735.0,44337,2023-11-30 10:20:00
1148,MTLR,19513,18681,7256103714.0,7256103714.0,25553309,19530112,283.96,285.35,45083421,12828991174.0,38194,18297,17391,7168679235.0,7168679235.0,25067017,19149064,285.98,286.0,44216081,12645316628.0,35688,2023-11-30 10:25:00
1149,MTLR,22032,23396,6894426823.0,6894426823.0,24163801,25522831,285.32,285.75,49686632,14187578499.0,45428,20821,22233,6812092341.0,6812092341.0,23758717,25078798,286.72,287.12,48837515,14012688346.0,43054,2023-11-30 10:30:00
1150,MTLR,17042,18924,5188850407.0,5188850407.0,18247273,20901245,284.36,285.42,39148518,11154424537.0,35966,15705,17993,5117631980.0,5117631980.0,17888289,20587957,286.09,286.73,38476246,11020737250.0,33698,2023-11-30 10:35:00
1151,MTLR,19887,22748,6703567480.0,6703567480.0,23458066,28150885,285.77,287.04,51608951,14783914744.0,42635,18562,21654,6608519331.0,6608519331.0,22978573,27719868,287.59,288.29,50698441,14599962384.0,40216,2023-11-30 10:40:00
1152,MTLR,15620,17575,4126118059.0,4126118059.0,14402407,25833970,286.49,287.59,40236377,11555759124.0,33195,14941,16691,4062012904.0,4062012904.0,14124604,25594174,287.58,288.06,39718778,11434782323.0,31632,2023-11-30 10:45:00
1153,MTLR,22279,13816,9305689834.0,9305689834.0,32382004,10535784,287.37,286.59,42917788,12325134049.0,36095,21210,12763,9158971542.0,9158971542.0,31785181,10230163,288.15,289.02,42015344,12115687888.0,33973,2023-11-30 10:50:00
1154,MTLR,21670,19556,7684348120.0,7684348120.0,26721226,20543443,287.57,287.83,47264669,13597269125.0,41226,21045,18748,7631701250.0,7631701250.0,26470621,20259055,288.31,288.69,46729676,13480258023.0,39793,2023-11-30 10:55:00
1155,MTLR,14240,17110,2603317675.0,2603317675.0,9120323,26674926,285.44,286.56,35795249,10247163909.0,31350,12392,16349,2534304720.0,2534304720.0,8839894,26389463,286.69,287.44,35229357,10119767896.0,28741,2023-11-30 11:00:00
1156,MTLR,17270,16973,4923210877.0,4923210877.0,17242219,17122121,285.53,285.7,34364340,9814935583.0,34243,16339,15951,4865684798.0,4865684798.0,16991797,16894895,286.35,286.76,33886692,9710526822.0,32290,2023-11-30 11:05:00
1157,MTLR,18749,11291,7562674904.0,7562674904.0,26388695,6575604,286.59,286.31,32964299,9445318709.0,30040,18071,10523,7520843194.0,7520843194.0,26185443,6379724,287.21,288.02,32565167,9358350123.0,28594,2023-11-30 11:10:00
1158,MTLR,13139,13193,3220559535.0,3220559535.0,11253912,20443205,286.17,286.78,31697117,9083187359.0,26332,12655,12765,3193098305.0,3193098305.0,11129803,20287164,286.9,287.42,31416967,9024123285.0,25420,2023-11-30 11:15:00
1159,MTLR,13280,12722,3668430103.0,3668430103.0,12818346,11990007,286.19,287.34,24808353,7113603784.0,26002,12727,12264,3631708958.0,3631708958.0,12633486,11839851,287.47,288.1,24473337,7042750558.0,24991,2023-11-30 11:20:00
1160,MTLR,10515,10447,3649966049.0,3649966049.0,12719885,10392208,286.95,288.07,23112093,6643623980.0,20962,10108,9865,3626327325.0,3626327325.0,12579644,10219310,288.27,289.01,22798954,6579812634.0,19973,2023-11-30 11:25:00
1161,MTLR,8902,7747,2737434028.0,2737434028.0,9540291,9608943,286.93,287.87,19149234,5503530358.0,16649,8521,7560,2699221866.0,2699221866.0,9381318,9501143,287.72,288.33,18882461,5438693348.0,16081,2023-11-30 11:30:00
1162,MTLR,21875,17185,10443277437.0,10443277437.0,36276266,12896887,287.88,288.61,49173153,14165403617.0,39060,20792,16151,10363857316.0,10363857316.0,35827606,12542766,289.27,289.62,48370372,13996554995.0,36943,2023-11-30 11:35:00
1163,MTLR,15276,8823,5621855189.0,5621855189.0,19452523,10715617,289.0,289.1,30168140,8719738054.0,24099,14505,8152,5555220055.0,5555220055.0,19166571,10469161,289.84,290.43,29635732,8595803049.0,22657,2023-11-30 11:40:00
1164,MTLR,11802,11534,4199320130.0,4199320130.0,14579692,10787403,288.03,289.38,25367095,7320985446.0,23336,10934,9913,4137530332.0,4137530332.0,14235177,10412885,290.66,291.39,24648062,7171699024.0,20847,2023-11-30 11:45:00
1165,MTLR,11448,13396,2497281907.0,2497281907.0,8626456,21315097,289.49,290.29,29941553,8684940017.0,24844,10667,12786,2473376933.0,2473376933.0,8518018,21118216,290.37,290.99,29636234,8618590834.0,23453,2023-11-30 11:50:00
1166,MTLR,6734,10307,1179460068.0,1179460068.0,4094718,22235206,288.04,289.91,26329924,7625588012.0,17041,6093,9867,1130060890.0,1130060890.0,3902888,22161971,289.54,290.35,26064859,7564689552.0,15960,2023-11-30 11:55:00
1167,MTLR,8179,9429,2571606405.0,2571606405.0,8905570,14215807,288.76,289.69,23121377,6689807660.0,17608,7644,8865,2513266279.0,2513266279.0,8658921,14070597,290.25,290.37,22729518,6598919357.0,16509,2023-11-30 12:00:00
1168,MTLR,13716,16567,4580130308.0,4580130308.0,15776158,16056211,290.32,290.3,31832369,9241218216.0,30283,12998,16137,4561759026.0,4561759026.0,15695872,15858244,290.63,290.99,31554116,9176350229.0,29135,2023-11-30 12:05:00
1169,MTLR,8854,8208,3162986008.0,3162986008.0,10928583,7169047,289.42,290.4,18097630,5244877240.0,17062,8208,7319,3083882921.0,3083882921.0,10595017,6905057,291.07,291.42,17500074,5096172387.0,15527,2023-11-30 12:10:00
1170,MTLR,20709,14225,5126679418.0,5126679418.0,17661123,16627113,290.28,290.41,34288236,9955318820.0,34934,20053,13270,5078957062.0,5078957062.0,17463263,16408409,290.84,291.4,33871672,9860366561.0,33323,2023-11-30 12:15:00
1171,MTLR,10239,10476,3617279315.0,3617279315.0,12451544,12996178,290.51,291.02,25447722,7399463560.0,20715,9913,10108,3594281926.0,3594281926.0,12356001,12898009,290.89,291.51,25254010,7354197406.0,20021,2023-11-30 12:20:00
1172,MTLR,15072,18497,3394968686.0,3394968686.0,11780823,26392605,288.18,288.32,38173428,11004496511.0,33569,13584,17222,3329164207.0,3329164207.0,11480584,25902818,289.98,290.5,37383402,10853952429.0,30806,2023-11-30 12:25:00
1173,MTLR,17964,15839,4124349631.0,4124349631.0,14274675,18998109,288.93,288.4,33272784,9603378003.0,33803,16696,13893,4086945949.0,4086945949.0,14116138,18692499,289.52,289.78,32808637,9503710214.0,30589,2023-11-30 12:30:00
1174,MTLR,13550,15466,3419259303.0,3419259303.0,11892525,20314461,287.51,288.37,32206986,9277353365.0,29016,12443,14725,3369226917.0,3369226917.0,11665470,20091211,288.82,289.28,31756681,9181125018.0,27168,2023-11-30 12:35:00
1175,MTLR,16464,14479,5712770793.0,5712770793.0,19758210,9473049,289.13,288.8,29231259,8448559209.0,30943,16036,13980,5711563067.0,5711563067.0,19725398,9308989,289.55,290.13,29034387,8412414063.0,30016,2023-11-30 12:40:00
1176,MTLR,22173,16855,5551729778.0,5551729778.0,19202281,13151809,289.12,289.78,32354090,9362869304.0,39028,21731,16559,5533607966.0,5533607966.0,19106576,13104482,289.62,289.95,32211058,9333311116.0,38290,2023-11-30 12:45:00
1177,MTLR,18022,29260,5639768271.0,5639768271.0,19481899,24937811,289.49,290.18,44419710,12876329060.0,47282,17564,28766,5611693862.0,5611693862.0,19330128,24823485,290.31,290.54,44153613,12823821922.0,46330,2023-11-30 12:50:00
1178,MTLR,6842,7555,1897007854.0,1897007854.0,6558640,7270955,289.24,289.94,13829595,4005139611.0,14397,6580,7302,1882002180.0,1882002180.0,6490158,7203139,289.98,290.54,13693297,3974830992.0,13882,2023-11-30 12:55:00
1179,MTLR,7425,8294,1923434731.0,1923434731.0,6645170,11157652,289.45,289.37,17802822,5152150822.0,15719,7148,8054,1910950390.0,1910950390.0,6594719,11102283,289.77,290.15,17697002,5132261028.0,15202,2023-11-30 13:00:00
1180,MTLR,5998,4663,1004802819.0,1004802819.0,3496870,7723147,287.34,289.74,11220017,3242501736.0,10661,5565,4516,988498966.0,988498966.0,3415288,7668588,289.43,290.18,11083876,3213751465.0,10081,2023-11-30 13:05:00
1181,MTLR,6776,6106,1982515177.0,1982515177.0,6856752,5316388,289.13,290.29,12173140,3525808889.0,12882,6119,5350,1953463861.0,1953463861.0,6721203,5185619,290.64,291.15,11906822,3463246925.0,11469,2023-11-30 13:10:00
1182,MTLR,15088,10682,6983766961.0,6983766961.0,24134350,6326462,289.37,289.83,30460812,8817394289.0,25770,14065,8688,6944055460.0,6944055460.0,23855391,6042579,291.09,292.16,29897970,8709483778.0,22753,2023-11-30 13:15:00
1183,MTLR,11647,11130,5244437008.0,5244437008.0,18059502,7965501,290.4,290.85,26025003,7561178356.0,22777,10721,9263,5157701900.0,5157701900.0,17640837,7604169,292.37,293.5,25245006,7389500064.0,19984,2023-11-30 13:20:00
1184,MTLR,16408,9992,3834948826.0,3834948826.0,13174705,10835591,291.08,291.51,24010296,6993639942.0,26400,14957,7930,3740508597.0,3740508597.0,12767572,10479516,292.97,293.46,23247088,6815819556.0,22887,2023-11-30 13:25:00
1185,MTLR,17020,11030,2610261560.0,2610261560.0,8930258,17568699,292.29,292.4,26498957,7747405745.0,28050,16354,9335,2577626144.0,2577626144.0,8810917,17449230,292.55,293.0,26260147,7690176281.0,25689,2023-11-30 13:30:00
1186,MTLR,8730,8372,2984784084.0,2984784084.0,10304267,10700393,289.66,292.51,21004660,6114748015.0,17102,7864,7073,2911351515.0,2911351515.0,9919473,10375642,293.5,293.44,20295115,5956018116.0,14937,2023-11-30 13:35:00
1187,MTLR,11418,5685,4865575990.0,4865575990.0,16702719,3618741,291.3,291.96,20321460,5922111372.0,17103,10050,4639,4799058942.0,4799058942.0,16310776,3190850,294.23,295.11,19501626,5740695999.0,14689,2023-11-30 13:40:00
1188,MTLR,17282,10862,6694934056.0,6694934056.0,22856185,8049855,292.92,293.68,30906040,9059031192.0,28144,15863,9740,6627786811.0,6627786811.0,22502213,7690659,294.54,295.31,30192872,8898945590.0,25603,2023-11-30 13:45:00
1189,MTLR,21142,14880,7598653188.0,7598653188.0,25868916,15406282,293.74,292.43,41275198,12103908377.0,36022,19777,13034,7457648701.0,7457648701.0,25260780,14754186,295.23,295.65,40014966,11819716373.0,32811,2023-11-30 13:50:00
1190,MTLR,10451,13853,2286998317.0,2286998317.0,7797804,20965944,293.29,293.64,28763748,8443441817.0,24304,9228,13066,2216040437.0,2216040437.0,7521442,20614743,294.63,295.15,28136185,8300428293.0,22294,2023-11-30 13:55:00
1191,MTLR,12032,13326,3935475471.0,3935475471.0,13414321,20245274,293.38,293.68,33659595,9881140740.0,25358,11036,12598,3890277709.0,3890277709.0,13219375,20044856,294.29,294.85,33264231,9800491967.0,23634,2023-11-30 14:00:00
1192,MTLR,6837,3672,5202104527.0,5202104527.0,17700625,7301446,293.89,292.5,25002071,7337750736.0,10509,5871,2724,5124440035.0,5124440035.0,17375069,6857244,294.93,294.9,24232313,7146661764.0,8595,2023-11-30 14:05:00
1193,MTLR,9400,13487,1659692214.0,1659692214.0,5683482,26541231,292.02,293.8,32224713,9457391252.0,22887,8591,13025,1626221525.0,1626221525.0,5540555,26432891,293.51,294.4,31973446,9407936053.0,21616,2023-11-30 14:10:00
1194,MTLR,12088,15128,2927743025.0,2927743025.0,10101811,26271406,289.82,291.86,36373217,10595197049.0,27216,11069,14336,2867872961.0,2867872961.0,9790187,25852971,292.93,293.8,35643158,10463401164.0,25405,2023-11-30 14:15:00
1195,MTLR,15904,24303,5038243471.0,5038243471.0,17221890,28605513,292.55,292.21,45827403,13397054109.0,40207,15204,23869,4993552911.0,4993552911.0,17044894,28386001,292.96,293.08,45430895,13312828414.0,39073,2023-11-30 14:20:00
1196,MTLR,12946,10071,3344990920.0,3344990920.0,11469455,11450286,291.64,292.82,22919741,6697849760.0,23017,12424,9712,3307767606.0,3307767606.0,11298358,11318434,292.77,293.33,22616792,6627840703.0,22136,2023-11-30 14:25:00
1197,MTLR,9843,8944,4181302011.0,4181302011.0,14287276,6868203,292.66,291.98,21155479,6186689303.0,18787,9260,8461,4170122697.0,4170122697.0,14212303,6680610,293.42,294.02,20892913,6134349306.0,17721,2023-11-30 14:30:00
1198,MTLR,5760,9597,1033181775.0,1033181775.0,3589266,15673717,287.85,289.78,19262983,5575146175.0,15357,4776,8974,996565400.0,996565400.0,3416561,15294190,291.69,292.63,18710751,5472081144.0,13750,2023-11-30 14:35:00
1199,MTLR,9851,13753,1780466422.0,1780466422.0,6138335,24021059,290.06,291.34,30159394,8778758099.0,23604,9113,13315,1733786202.0,1733786202.0,5947588,23757835,291.51,292.29,29705423,8677922560.0,22428,2023-11-30 14:40:00
1200,MTLR,7030,6711,2076115475.0,2076115475.0,7149211,6630047,290.4,291.05,13779258,4005778432.0,13741,6404,6269,2028895061.0,2028895061.0,6956122,6475676,291.67,292.26,13431798,3921482577.0,12673,2023-11-30 14:45:00
1201,MTLR,7954,7089,2534475413.0,2534475413.0,8729351,7054873,290.34,292.05,15784224,4594819736.0,15043,7398,6724,2448687456.0,2448687456.0,8395088,6968459,291.68,292.26,15363547,4485277063.0,14122,2023-11-30 14:50:00
1202,MTLR,12959,10162,4075145113.0,4075145113.0,13948084,12851710,292.17,291.53,26799794,7821816652.0,23121,12356,9501,4034882752.0,4034882752.0,13766391,12528920,293.1,293.57,26295311,7712982907.0,21857,2023-11-30 14:55:00
1203,MTLR,16503,15554,5134272727.0,5134272727.0,17533625,15219011,292.82,293.02,32752636,9593774839.0,32057,16039,15242,5115730110.0,5115730110.0,17458152,15104038,293.03,293.42,32562190,9547507358.0,31281,2023-11-30 15:00:00
1204,MTLR,8264,7466,2792326342.0,2792326342.0,9602319,4362701,290.8,292.44,13965020,4068169483.0,15730,7647,7022,2759545587.0,2759545587.0,9396654,4247157,293.67,294.27,13643811,4009347261.0,14669,2023-11-30 15:05:00
1205,MTLR,13321,12255,4685841332.0,4685841332.0,15948974,18640064,293.8,293.29,34589038,10152869010.0,25576,12686,11796,4656444795.0,4656444795.0,15830493,18338572,294.14,294.37,34169065,10054775725.0,24482,2023-11-30 15:10:00
1206,MTLR,31638,19910,4773012572.0,4773012572.0,16289085,28549071,293.02,293.7,44838156,13157845227.0,51548,30976,19614,4754899952.0,4754899952.0,16202581,28444761,293.47,293.95,44647342,13116232090.0,50590,2023-11-30 15:15:00
1207,MTLR,6788,11854,1227850516.0,1227850516.0,4229526,16679372,290.3,292.9,20908898,6113265536.0,18642,6334,11493,1213035613.0,1213035613.0,4145018,16546500,292.65,293.59,20691518,6070932041.0,17827,2023-11-30 15:20:00
1208,MTLR,9002,6296,3082761980.0,3082761980.0,10530540,6194248,292.74,292.95,16724788,4897371456.0,15298,8652,6039,3064646475.0,3064646475.0,10456654,6143608,293.08,293.79,16600262,4869558816.0,14691,2023-11-30 15:25:00
1209,MTLR,4061,4448,1004637947.0,1004637947.0,3444399,7704099,291.67,290.44,11148498,3242182848.0,8509,3463,4131,984994780.0,984994780.0,3368510,7623734,292.41,293.01,10992244,3218853042.0,7594,2023-11-30 15:30:00
1210,MTLR,6368,7385,2418273967.0,2418273967.0,8305410,7586792,291.17,291.8,15892202,4632079373.0,13753,5877,7090,2380075604.0,2380075604.0,8151592,7544978,291.98,292.56,15696570,4587420028.0,12967,2023-11-30 15:35:00
1211,MTLR,10930,9584,3988613355.0,3988613355.0,13677008,9177208,291.63,292.58,22854216,6673665317.0,20514,10325,9207,3970688615.0,3970688615.0,13564567,9088842,292.73,293.51,22653409,6638331642.0,19532,2023-11-30 15:40:00
1212,MTLR,9879,12724,2005863104.0,2005863104.0,6863378,14463713,292.26,293.02,21327091,6244074937.0,22603,9556,12455,2002830753.0,2002830753.0,6847166,14405100,292.51,293.22,21252266,6226712438.0,22011,2023-11-30 15:45:00
1213,MTLR,4563,4885,995354312.0,995354312.0,3402920,6981774,292.5,293.2,10384694,3042381205.0,9448,4311,4690,980491798.0,980491798.0,3350050,6952231,292.68,293.41,10302281,3020369456.0,9001,2023-11-30 15:50:00
1214,MTLR,23078,9572,4609181193.0,4609181193.0,15772698,10143796,292.23,292.42,25916494,7575392979.0,32650,22726,9244,4612578983.0,4612578983.0,15773182,10059662,292.43,292.99,25832844,7559976921.0,31970,2023-11-30 15:55:00
1215,MTLR,3590,4610,581205963.0,581205963.0,2006527,7215291,289.66,290.56,9221818,2677665085.0,8200,3067,4118,568633757.0,568633757.0,1952065,7054038,291.3,292.31,9006103,2630634074.0,7185,2023-11-30 16:00:00
1216,MTLR,16679,20419,4358280401.0,4358280401.0,14974822,21715633,291.04,290.86,36690455,10674577779.0,37098,16087,19828,4323016640.0,4323016640.0,14814990,21452842,291.8,292.03,36267832,10587910266.0,35915,2023-11-30 16:05:00
1217,MTLR,9532,9289,3141704892.0,3141704892.0,10867551,14993506,289.09,289.05,25861057,7475540943.0,18821,8549,8580,3069732115.0,3069732115.0,10569074,14728471,290.44,290.98,25297545,7355363315.0,17129,2023-11-30 16:10:00
1218,MTLR,8240,9808,1634270919.0,1634270919.0,5672597,15235591,288.1,288.23,20908188,6025681206.0,18048,7331,9260,1565433125.0,1565433125.0,5409008,15033752,289.41,290.21,20442760,5928330142.0,16591,2023-11-30 16:15:00
1219,MTLR,13358,11526,4536352461.0,4536352461.0,15704163,14157191,288.86,289.32,29861354,8632282113.0,24884,12379,10819,4481359474.0,4481359474.0,15424757,13951222,290.53,290.65,29375979,8536234832.0,23198,2023-11-30 16:20:00
1220,MTLR,10285,8018,4699450608.0,4699450608.0,16183363,5127908,290.39,290.22,21311271,6187666395.0,18303,9757,7520,4678068409.0,4678068409.0,16085731,5004164,290.82,291.71,21089895,6137812428.0,17277,2023-11-30 16:25:00
1221,MTLR,13350,10730,5082070810.0,5082070810.0,17522076,8818528,290.04,289.89,26340604,7638471067.0,24080,12718,10115,5065586173.0,5065586173.0,17417306,8604942,290.84,291.22,26022248,7571516376.0,22833,2023-11-30 16:30:00
1222,MTLR,18864,13061,8252337763.0,8252337763.0,28402943,7676374,290.55,291.1,36079317,10486893742.0,31925,18451,12850,8231606756.0,8231606756.0,28303277,7651639,290.84,291.44,35954916,10461630811.0,31301,2023-11-30 16:35:00
1223,MTLR,9523,5551,3678097097.0,3678097097.0,12693904,4087540,289.75,288.03,16781444,4855413930.0,15074,9178,5174,3663234307.0,3663234307.0,12614635,4028820,290.4,291.07,16643455,4835894668.0,14352,2023-11-30 16:40:00
1224,MTLR,7656,7086,1546260628.0,1546260628.0,5338077,9658600,289.67,290.62,14996677,4353218185.0,14742,7340,6917,1545561392.0,1545561392.0,5325751,9651901,290.21,290.87,14977652,4352978180.0,14257,2023-11-30 16:45:00
1225,MTLR,3953,24065,797880078.0,797880078.0,2757590,32820513,289.34,290.61,35578103,10335720873.0,28018,3650,23871,789024119.0,789024119.0,2717904,32770335,290.31,290.84,35488239,10319860683.0,27521,2023-11-30 16:50:00
1226,MTLR,2133,5969,333123451.0,333123451.0,1166765,18409304,285.51,290.64,19576069,5683683275.0,8102,1819,5808,316994403.0,316994403.0,1093717,18384475,289.83,290.67,19478192,5660765998.0,7627,2023-11-30 16:55:00
1227,MTLR,4343,1873,3182412469.0,3182412469.0,10983894,2340379,289.73,289.11,13324273,3859048163.0,6216,3811,1486,3169068755.0,3169068755.0,10890327,2231775,291.0,291.7,13122102,3820074663.0,5297,2023-11-30 17:00:00
1228,MTLR,7927,2278,5768321872.0,5768321872.0,19850994,2621755,290.58,290.35,22472749,6529541286.0,10205,7620,2011,5756362383.0,5756362383.0,19787299,2552569,290.91,291.56,22339868,6500591619.0,9631,2023-11-30 17:05:00
1229,MTLR,14576,11902,7109504095.0,7109504095.0,24417013,6114504,291.17,291.62,30531517,8892597350.0,26478,14192,11700,7108046361.0,7108046361.0,24401027,6076181,291.3,291.89,30477208,8881605216.0,25892,2023-11-30 17:10:00
1230,MTLR,13489,18801,6767391847.0,6767391847.0,23240669,9888973,291.19,291.94,33129642,9654347618.0,32290,12978,18528,6735110169.0,6735110169.0,23091402,9865195,291.67,291.98,32956597,9615559217.0,31506,2023-11-30 17:15:00
1231,MTLR,11442,7756,5696349387.0,5696349387.0,19529249,4713682,291.68,291.82,24242931,7071874688.0,19198,10877,7283,5657220921.0,5657220921.0,19345943,4586261,292.42,293.09,23932204,7001399530.0,18160,2023-11-30 17:20:00
1232,MTLR,8173,6396,3084330578.0,3084330578.0,10555377,5135962,292.2,290.78,15691339,4577788341.0,14569,7766,5912,3062740798.0,3062740798.0,10470940,5026791,292.5,292.99,15497731,4535526698.0,13678,2023-11-30 17:25:00
1233,MTLR,2731,5165,388340825.0,388340825.0,1339171,6664770,289.99,292.34,8003941,2336743116.0,7896,2546,5041,398232158.0,398232158.0,1364452,6658201,291.86,292.61,8022653,2346471021.0,7587,2023-11-30 17:30:00
1234,MTLR,5568,16563,938663374.0,938663374.0,3249346,14431576,288.88,292.53,17680922,5160294549.0,22131,5216,16361,915645967.0,915645967.0,3136075,14430185,291.97,292.74,17566260,5139952146.0,21577,2023-11-30 17:35:00
1235,MTLR,7077,5706,3537134877.0,3537134877.0,12099587,4705034,292.34,292.33,16804621,4912534309.0,12783,6721,5317,3509342688.0,3509342688.0,11980222,4573906,292.93,293.5,16554128,4851766508.0,12038,2023-11-30 17:40:00
1236,MTLR,5851,3382,2303018783.0,2303018783.0,7868707,2038932,292.68,292.13,9907639,2898650540.0,9233,5564,3022,2299322960.0,2299322960.0,7846205,1970291,293.05,293.8,9816496,2878187410.0,8586,2023-11-30 17:45:00
1237,MTLR,3246,3826,1256726342.0,1256726342.0,4299273,2978485,292.31,291.25,7277758,2124197649.0,7072,2806,3647,1249279063.0,1249279063.0,4270317,2943917,292.55,293.13,7214234,2112215919.0,6453,2023-11-30 17:50:00
1238,MTLR,2005,2377,753759756.0,753759756.0,2587008,1801972,291.36,291.28,4388980,1278632542.0,4382,1694,2153,744565325.0,744565325.0,2546743,1745551,292.36,293.06,4292294,1256113418.0,3847,2023-11-30 17:55:00
1239,MTLR,5024,3486,2620960401.0,2620960401.0,8975112,2684122,292.03,291.83,11659234,3404271990.0,8510,4788,3256,2610400278.0,2610400278.0,8928000,2657723,292.38,292.98,11585723,3389063781.0,8044,2023-11-30 18:00:00
1240,MTLR,8421,9963,3025715995.0,3025715995.0,10356433,7500470,292.16,292.4,17856903,5218863935.0,18384,8149,9749,3010706490.0,3010706490.0,10295145,7439383,292.44,292.88,17734528,5189553815.0,17898,2023-11-30 18:05:00
1241,MTLR,6121,12466,1550926970.0,1550926970.0,5322025,10907002,291.42,292.16,16229027,4737562794.0,18587,5908,12237,1545436886.0,1545436886.0,5290372,10858979,292.12,292.5,16149351,4721723860.0,18145,2023-11-30 18:10:00
1242,MTLR,3418,3485,948082274.0,948082274.0,3255487,4128217,291.23,292.63,7383704,2156111402.0,6903,3276,3334,951070716.0,951070716.0,3255177,4107078,292.17,292.78,7362255,2153551687.0,6610,2023-11-30 18:15:00
1243,MTLR,8697,5163,4725157418.0,4725157418.0,16162180,3789256,292.36,292.56,19951436,5833756574.0,13860,8357,4917,4695475385.0,4695475385.0,16045078,3796261,292.64,293.21,19841339,5808576100.0,13274,2023-11-30 18:20:00
1244,MTLR,14789,10502,7658122523.0,7658122523.0,26147549,6238407,292.88,293.21,32385956,9487260040.0,25291,14416,9679,7601198463.0,7601198463.0,25890157,6015369,293.59,294.4,31905526,9372100588.0,24095,2023-11-30 18:25:00
1245,MTLR,13601,9434,7176111429.0,7176111429.0,24475402,5956154,293.2,292.1,30431556,8915884257.0,23035,13139,8692,7155756774.0,7155756774.0,24340264,5756695,293.99,294.6,30096959,8851668672.0,21831,2023-11-30 18:30:00
1246,MTLR,7346,4058,3785479668.0,3785479668.0,12908483,3137921,293.26,291.0,16046404,4698612929.0,11404,7099,3781,3753820257.0,3753820257.0,12782521,3053114,293.67,294.5,15835635,4652956846.0,10880,2023-11-30 18:35:00
1247,MTLR,2911,5878,368468103.0,368468103.0,1263436,7182242,291.64,292.84,8445678,2471733920.0,8789,2661,5686,343897933.0,343897933.0,1174107,7063309,292.9,293.82,8237416,2419273573.0,8347,2023-11-30 18:40:00
